"Radio_Censal","Provincia","Cantidad_hogares","cloacas_conexion_red_publica","cloacas_conexion_camara_septica","cloacas_conexion_pozo_ciego","cloacas_conexion_hoyo_o_excavacion","cloacas_total_sin_conexion_a_red","cloacas_pje_hogares_red"
"820630114","SANTA FE",100,0,16,82,0,98,0
"820280310","SANTA FE",60,1,25,29,2,56,0.0166666666666667
"820490203","SANTA FE",34,0,1,28,0,29,0
"820490103","SANTA FE",157,0,70,58,9,137,0
"820844506","SANTA FE",180,176,3,1,0,4,0.977777777777778
"820421215","SANTA FE",31,0,19,11,1,31,0
"820847601","SANTA FE",29,0,8,21,0,29,0
"820421117","SANTA FE",91,0,42,48,0,90,0
"820211011","SANTA FE",50,0,19,27,3,49,0
"820211001","SANTA FE",75,0,35,36,4,75,0
"820700214","SANTA FE",167,21,51,89,4,144,0.125748502994012
"820843901","SANTA FE",175,175,0,0,0,0,1
"821260105","SANTA FE",126,3,58,59,3,120,0.0238095238095238
"821050504","SANTA FE",172,4,58,88,11,157,0.0232558139534884
"821050211","SANTA FE",92,0,18,72,0,90,0
"820910304","SANTA FE",482,32,290,129,20,439,0.0663900414937759
"820847902","SANTA FE",43,0,40,3,0,43,0
"820846402","SANTA FE",307,1,60,233,5,298,0.00325732899022801
"820630301","SANTA FE",177,1,51,95,9,155,0.00564971751412429
"820846401","SANTA FE",142,1,22,114,3,139,0.00704225352112676
"821330511","SANTA FE",74,0,2,50,10,62,0
"820847302","SANTA FE",108,0,40,65,1,106,0
"820630313","SANTA FE",227,3,96,114,3,213,0.013215859030837
"820630226","SANTA FE",74,0,24,48,1,73,0
"820140505","SANTA FE",88,1,54,31,0,85,0.0113636363636364
"820140502","SANTA FE",51,1,21,25,1,47,0.0196078431372549
"820280324","SANTA FE",264,0,114,142,3,259,0
"821191010","SANTA FE",166,164,0,2,0,2,0.987951807228916
"820770201","SANTA FE",166,0,80,62,3,145,0
"820070307","SANTA FE",97,0,43,54,0,97,0
"820842315","SANTA FE",238,228,0,0,0,0,0.957983193277311
"820846114","SANTA FE",354,6,44,273,3,320,0.0169491525423729
"820846111","SANTA FE",425,8,226,189,0,415,0.0188235294117647
"820846110","SANTA FE",420,18,161,240,0,401,0.0428571428571429
"820210616","SANTA FE",984,394,329,256,1,586,0.400406504065041
"821120308","SANTA FE",15,0,7,8,0,15,0
"820490112","SANTA FE",430,51,157,160,38,355,0.118604651162791
"820210713","SANTA FE",237,1,166,64,5,235,0.00421940928270042
"820210710","SANTA FE",269,2,194,65,7,266,0.00743494423791822
"820847704","SANTA FE",228,117,31,77,0,108,0.513157894736842
"821330403","SANTA FE",244,6,117,104,11,232,0.0245901639344262
"821330213","SANTA FE",266,3,91,139,18,248,0.0112781954887218
"821260404","SANTA FE",425,228,150,46,0,196,0.536470588235294
"821260303","SANTA FE",349,306,20,23,0,43,0.876790830945559
"821260209","SANTA FE",362,287,50,23,1,74,0.792817679558011
"821260109","SANTA FE",250,200,30,8,0,38,0.8
"821260108","SANTA FE",394,287,90,17,0,107,0.728426395939086
"580560204","NEUQUEN",8,0,6,1,0,7,0
"820980404","SANTA FE",215,1,48,140,8,196,0.00465116279069767
"820910603","SANTA FE",331,99,202,26,2,230,0.299093655589124
"820910512","SANTA FE",198,2,93,68,31,192,0.0101010101010101
"820910506","SANTA FE",342,188,141,12,0,153,0.549707602339181
"820910410","SANTA FE",294,1,105,148,37,290,0.00340136054421769
"820848005","SANTA FE",277,277,0,0,0,0,1
"820848003","SANTA FE",352,345,0,0,0,0,0.980113636363636
"820848001","SANTA FE",382,348,3,0,1,4,0.910994764397906
"820847102","SANTA FE",94,3,27,58,5,90,0.0319148936170213
"820632701","SANTA FE",232,4,123,103,0,226,0.0172413793103448
"820630327","SANTA FE",217,0,89,120,1,210,0
"820490311","SANTA FE",208,1,49,95,39,183,0.00480769230769231
"821120204","SANTA FE",108,0,32,66,4,102,0
"820846505","SANTA FE",638,17,273,340,0,613,0.0266457680250784
"820846906","SANTA FE",357,5,116,234,0,350,0.0140056022408964
"820846313","SANTA FE",412,4,29,356,3,388,0.00970873786407767
"820845907","SANTA FE",571,21,163,363,1,527,0.0367775831873905
"820845603","SANTA FE",23,0,2,20,1,23,0
"820845518","SANTA FE",303,203,23,62,4,89,0.66996699669967
"820845513","SANTA FE",445,273,24,127,2,153,0.613483146067416
"820632408","SANTA FE",230,229,0,0,0,0,0.995652173913044
"820845306","SANTA FE",386,384,1,1,0,2,0.994818652849741
"820843306","SANTA FE",359,52,94,212,0,306,0.144846796657382
"820632807","SANTA FE",425,189,164,72,0,236,0.444705882352941
"820560403","SANTA FE",329,329,0,0,0,0,1
"820630124","SANTA FE",271,0,178,86,1,265,0
"820490607","SANTA FE",291,5,72,209,0,281,0.0171821305841924
"821190519","SANTA FE",406,2,253,151,0,404,0.00492610837438424
"821190311","SANTA FE",267,10,150,104,0,254,0.0374531835205993
"821190120","SANTA FE",974,759,72,128,1,201,0.779260780287474
"821190201","SANTA FE",384,227,34,117,1,152,0.591145833333333
"821120219","SANTA FE",297,295,2,0,0,2,0.993265993265993
"820844504","SANTA FE",294,272,14,8,0,22,0.925170068027211
"821120218","SANTA FE",361,212,34,109,0,143,0.587257617728532
"821120202","SANTA FE",42,1,12,28,0,40,0.0238095238095238
"821120103","SANTA FE",325,223,12,88,0,100,0.686153846153846
"821050509","SANTA FE",218,2,93,99,4,196,0.00917431192660551
"821050505","SANTA FE",302,0,150,142,4,296,0
"821120411","SANTA FE",244,200,29,14,0,43,0.819672131147541
"820490605","SANTA FE",389,354,9,17,0,26,0.910025706940874
"820490521","SANTA FE",209,3,145,60,1,206,0.0143540669856459
"820490612","SANTA FE",231,231,0,0,0,0,1
"820070216","SANTA FE",330,252,18,45,5,68,0.763636363636364
"820700318","SANTA FE",501,34,253,197,1,451,0.0678642714570858
"820700313","SANTA FE",271,240,19,10,0,29,0.885608856088561
"820847715","SANTA FE",196,178,10,7,0,17,0.908163265306122
"820843703","SANTA FE",283,281,2,0,0,2,0.992932862190813
"820632905","SANTA FE",436,30,67,331,1,399,0.0688073394495413
"820632804","SANTA FE",16,14,1,1,0,2,0.875
"820841911","SANTA FE",264,264,0,0,0,0,1
"820841904","SANTA FE",189,188,1,0,0,1,0.994708994708995
"820844418","SANTA FE",280,272,8,0,0,8,0.971428571428571
"820844607","SANTA FE",438,421,2,14,0,16,0.961187214611872
"820844603","SANTA FE",323,294,5,20,1,26,0.910216718266254
"820844410","SANTA FE",273,259,2,12,0,14,0.948717948717949
"820844409","SANTA FE",282,280,2,0,0,2,0.99290780141844
"821260316","SANTA FE",194,165,20,9,0,29,0.850515463917526
"820844310","SANTA FE",236,232,3,0,0,3,0.983050847457627
"820842816","SANTA FE",300,300,0,0,0,0,1
"820844304","SANTA FE",276,276,0,0,0,0,1
"820844408","SANTA FE",221,214,6,1,0,7,0.968325791855204
"820842014","SANTA FE",246,246,0,0,0,0,1
"580420108","NEUQUEN",46,0,15,13,9,37,0
"820844106","SANTA FE",299,284,5,8,0,13,0.949832775919732
"820844102","SANTA FE",269,253,8,6,0,14,0.940520446096654
"820842815","SANTA FE",295,294,1,0,0,1,0.996610169491525
"820842512","SANTA FE",557,554,1,0,0,1,0.994614003590664
"820844011","SANTA FE",119,98,5,12,0,17,0.823529411764706
"820844008","SANTA FE",192,188,3,0,0,3,0.979166666666667
"820843808","SANTA FE",193,193,0,0,0,0,1
"820843213","SANTA FE",425,4,100,281,1,382,0.00941176470588235
"820843208","SANTA FE",519,191,75,220,2,297,0.368015414258189
"820843801","SANTA FE",431,430,1,0,0,1,0.997679814385151
"820843714","SANTA FE",312,311,1,0,0,1,0.996794871794872
"820848509","SANTA FE",268,126,28,107,3,138,0.470149253731343
"820843203","SANTA FE",341,300,19,20,0,39,0.879765395894428
"820842309","SANTA FE",244,244,0,0,0,0,1
"820846902","SANTA FE",346,3,196,123,21,340,0.00867052023121387
"820421216","SANTA FE",345,0,233,106,6,345,0
"820843102","SANTA FE",303,258,14,23,0,37,0.851485148514851
"820843011","SANTA FE",250,244,3,3,0,6,0.976
"820843004","SANTA FE",423,127,156,138,1,295,0.300236406619385
"820840609","SANTA FE",270,270,0,0,0,0,1
"820840415","SANTA FE",236,164,37,35,0,72,0.694915254237288
"820633505","SANTA FE",223,218,4,1,0,5,0.977578475336323
"820842911","SANTA FE",368,368,0,0,0,0,1
"820842910","SANTA FE",372,369,3,0,0,3,0.991935483870968
"820842909","SANTA FE",221,221,0,0,0,0,1
"820633006","SANTA FE",290,288,1,0,0,1,0.993103448275862
"820843117","SANTA FE",283,229,24,30,0,54,0.809187279151943
"820560101","SANTA FE",311,0,124,178,6,308,0
"580280105","NEUQUEN",25,0,5,9,7,21,0
"820700219","SANTA FE",485,302,100,82,0,182,0.622680412371134
"820842918","SANTA FE",298,283,3,0,0,3,0.949664429530201
"820842704","SANTA FE",184,184,0,0,0,0,1
"820842703","SANTA FE",176,175,0,0,0,0,0.994318181818182
"820842608","SANTA FE",293,293,0,0,0,0,1
"820842605","SANTA FE",200,200,0,0,0,0,1
"820560309","SANTA FE",269,106,31,123,2,156,0.394052044609665
"820842117","SANTA FE",201,201,0,0,0,0,1
"820842004","SANTA FE",212,212,0,0,0,0,1
"820841806","SANTA FE",232,231,1,0,0,1,0.995689655172414
"820841805","SANTA FE",295,292,0,0,0,0,0.989830508474576
"820841802","SANTA FE",161,160,1,0,0,1,0.993788819875776
"820841914","SANTA FE",174,174,0,0,0,0,1
"820842419","SANTA FE",217,217,0,0,0,0,1
"820420305","SANTA FE",110,1,39,38,1,78,0.00909090909090909
"820842418","SANTA FE",249,248,1,0,0,1,0.995983935742972
"820420202","SANTA FE",158,3,67,84,3,154,0.0189873417721519
"820280209","SANTA FE",114,0,39,70,4,113,0
"820210109","SANTA FE",36,0,28,8,0,36,0
"820140603","SANTA FE",224,223,1,0,0,1,0.995535714285714
"820841701","SANTA FE",165,157,0,0,0,0,0.951515151515152
"820841605","SANTA FE",353,349,4,0,0,4,0.988668555240793
"820632406","SANTA FE",175,175,0,0,0,0,1
"820841509","SANTA FE",236,155,24,49,0,73,0.656779661016949
"820841506","SANTA FE",261,261,0,0,0,0,1
"820841504","SANTA FE",268,263,4,1,0,5,0.98134328358209
"820841406","SANTA FE",342,337,2,2,0,4,0.985380116959064
"820841211","SANTA FE",315,287,13,7,0,20,0.911111111111111
"820841304","SANTA FE",589,196,58,274,7,339,0.33276740237691
"820841209","SANTA FE",313,271,21,9,2,32,0.865814696485623
"820841208","SANTA FE",232,21,93,117,1,211,0.0905172413793103
"820841303","SANTA FE",420,308,19,76,5,100,0.733333333333333
"820841220","SANTA FE",261,202,20,28,0,48,0.773946360153257
"820841202","SANTA FE",305,66,69,164,0,233,0.216393442622951
"820843412","SANTA FE",219,185,7,27,0,34,0.844748858447489
"820843411","SANTA FE",188,185,2,1,0,3,0.984042553191489
"820843318","SANTA FE",346,11,62,229,4,295,0.0317919075144509
"820210511","SANTA FE",277,275,2,0,0,2,0.992779783393502
"820841113","SANTA FE",181,3,117,60,0,177,0.0165745856353591
"820841913","SANTA FE",162,161,0,0,0,0,0.993827160493827
"820843516","SANTA FE",316,93,35,155,10,200,0.294303797468354
"820843514","SANTA FE",382,155,67,144,1,212,0.405759162303665
"820845114","SANTA FE",230,159,16,50,2,68,0.691304347826087
"820844904","SANTA FE",340,263,22,50,0,72,0.773529411764706
"820844822","SANTA FE",408,6,42,335,9,386,0.0147058823529412
"820844820","SANTA FE",333,262,35,35,0,70,0.786786786786787
"820845107","SANTA FE",361,324,17,18,0,35,0.897506925207756
"820841817","SANTA FE",198,196,1,1,0,2,0.98989898989899
"820210614","SANTA FE",380,328,29,23,0,52,0.863157894736842
"820210611","SANTA FE",350,339,2,7,0,9,0.968571428571429
"820210608","SANTA FE",400,382,9,8,0,17,0.955
"820210506","SANTA FE",333,316,11,3,1,15,0.948948948948949
"820845211","SANTA FE",441,305,21,70,2,93,0.691609977324263
"820210216","SANTA FE",334,305,17,10,1,28,0.913173652694611
"820210214","SANTA FE",343,279,22,20,1,43,0.813411078717201
"820210207","SANTA FE",399,350,19,28,1,48,0.87719298245614
"820210206","SANTA FE",319,309,5,4,0,9,0.968652037617555
"820210418","SANTA FE",435,18,180,226,0,406,0.0413793103448276
"820210417","SANTA FE",394,13,126,249,0,375,0.032994923857868
"820210413","SANTA FE",262,255,5,0,0,5,0.973282442748092
"820210412","SANTA FE",247,240,5,2,0,7,0.97165991902834
"820210409","SANTA FE",349,327,16,6,0,22,0.936962750716332
"821050417","SANTA FE",249,231,11,4,0,15,0.927710843373494
"820210124","SANTA FE",400,0,237,152,4,393,0
"820420914","SANTA FE",279,277,2,0,0,2,0.992831541218638
"820845917","SANTA FE",535,10,278,227,3,508,0.0186915887850467
"820848715","SANTA FE",208,179,15,14,0,29,0.860576923076923
"820848714","SANTA FE",238,183,35,20,0,55,0.76890756302521
"820140518","SANTA FE",210,0,107,100,3,210,0
"820140504","SANTA FE",364,1,174,187,0,361,0.00274725274725275
"820845915","SANTA FE",179,0,141,37,0,178,0
"820210113","SANTA FE",64,0,57,7,0,64,0
"820841917","SANTA FE",296,296,0,0,0,0,1
"820421108","SANTA FE",236,6,114,113,1,228,0.0254237288135593
"821050413","SANTA FE",355,187,41,121,0,162,0.526760563380282
"820421009","SANTA FE",227,1,78,133,11,222,0.00440528634361234
"820140508","SANTA FE",342,244,79,19,0,98,0.713450292397661
"820420912","SANTA FE",257,257,0,0,0,0,1
"820421004","SANTA FE",363,277,34,48,0,82,0.763085399449036
"820421003","SANTA FE",332,293,16,19,0,35,0.882530120481928
"820420903","SANTA FE",520,319,102,95,0,197,0.613461538461539
"820420711","SANTA FE",294,208,62,22,0,84,0.707482993197279
"820420709","SANTA FE",269,266,2,1,0,3,0.988847583643123
"820420703","SANTA FE",211,50,91,70,0,161,0.23696682464455
"820140406","SANTA FE",398,16,151,230,0,381,0.0402010050251256
"820140405","SANTA FE",309,45,102,162,0,264,0.145631067961165
"820632105","SANTA FE",343,342,1,0,0,1,0.997084548104956
"820140402","SANTA FE",331,225,46,59,0,105,0.6797583081571
"820420418","SANTA FE",298,12,166,120,0,286,0.0402684563758389
"820420412","SANTA FE",213,93,55,64,1,120,0.436619718309859
"820420409","SANTA FE",286,245,17,23,0,40,0.856643356643357
"820848607","SANTA FE",538,342,46,139,6,191,0.635687732342007
"820420324","SANTA FE",223,0,118,102,2,222,0
"820070210","SANTA FE",294,198,45,43,0,88,0.673469387755102
"820631116","SANTA FE",294,203,60,29,2,91,0.69047619047619
"820631115","SANTA FE",371,93,161,108,1,270,0.250673854447439
"821050405","SANTA FE",235,199,16,20,0,36,0.846808510638298
"820848512","SANTA FE",423,55,85,272,0,357,0.130023640661939
"820848809","SANTA FE",266,104,109,53,0,162,0.390977443609023
"821050307","SANTA FE",252,211,28,11,1,40,0.837301587301587
"820848511","SANTA FE",276,178,40,54,0,94,0.644927536231884
"820140107","SANTA FE",326,1,156,159,4,319,0.00306748466257669
"821050403","SANTA FE",299,296,2,0,1,3,0.989966555183946
"820848411","SANTA FE",477,189,243,42,3,288,0.39622641509434
"820840518","SANTA FE",413,407,3,3,0,6,0.98547215496368
"820420212","SANTA FE",282,2,141,132,1,274,0.00709219858156028
"820140209","SANTA FE",226,225,1,0,0,1,0.995575221238938
"820840515","SANTA FE",214,195,14,5,0,19,0.911214953271028
"820631013","SANTA FE",433,1,75,344,4,423,0.0023094688221709
"820631010","SANTA FE",358,11,249,97,0,346,0.0307262569832402
"820630910","SANTA FE",348,334,3,11,0,14,0.959770114942529
"820630904","SANTA FE",227,214,6,7,0,13,0.94273127753304
"820630901","SANTA FE",416,384,16,14,1,31,0.923076923076923
"821190413","SANTA FE",369,4,212,148,0,360,0.010840108401084
"820630804","SANTA FE",268,258,7,3,0,10,0.962686567164179
"820630712","SANTA FE",292,260,1,0,0,1,0.89041095890411
"820630705","SANTA FE",423,421,2,0,0,2,0.995271867612293
"820350111","SANTA FE",381,0,220,156,1,377,0
"820630610","SANTA FE",218,37,94,87,0,181,0.169724770642202
"820630513","SANTA FE",366,15,66,272,5,343,0.040983606557377
"820848405","SANTA FE",270,224,25,21,0,46,0.82962962962963
"820840509","SANTA FE",307,255,24,28,0,52,0.830618892508143
"820840409","SANTA FE",404,339,43,22,0,65,0.839108910891089
"820631002","SANTA FE",390,15,169,206,0,375,0.0384615384615385
"820840408","SANTA FE",279,222,29,27,0,56,0.795698924731183
"820841921","SANTA FE",155,155,0,0,0,0,1
"820632405","SANTA FE",186,186,0,0,0,0,1
"820840310","SANTA FE",299,6,160,126,0,286,0.020066889632107
"820840303","SANTA FE",332,17,84,219,3,306,0.0512048192771084
"820630506","SANTA FE",572,4,100,435,4,539,0.00699300699300699
"820840503","SANTA FE",397,340,37,17,0,54,0.856423173803526
"820560103","SANTA FE",330,6,157,146,3,306,0.0181818181818182
"820491018","SANTA FE",389,19,262,100,4,366,0.0488431876606684
"820630907","SANTA FE",243,233,6,4,0,10,0.958847736625514
"820280512","SANTA FE",522,479,13,21,0,34,0.917624521072797
"820280508","SANTA FE",425,237,70,113,2,185,0.557647058823529
"820280413","SANTA FE",382,361,4,3,0,7,0.945026178010471
"821050231","SANTA FE",275,145,34,75,4,113,0.527272727272727
"820632401","SANTA FE",301,290,2,0,0,2,0.963455149501661
"821330415","SANTA FE",529,34,157,292,16,465,0.0642722117202268
"820700603","SANTA FE",238,0,95,135,7,237,0
"821260506","SANTA FE",566,261,156,120,6,282,0.46113074204947
"820910318","SANTA FE",335,104,191,31,4,226,0.31044776119403
"820633413","SANTA FE",881,12,445,419,1,865,0.0136208853575482
"820633306","SANTA FE",346,335,8,2,0,10,0.968208092485549
"820848315","SANTA FE",297,252,18,27,0,45,0.848484848484849
"820633002","SANTA FE",381,376,4,1,0,5,0.986876640419947
"820633302","SANTA FE",276,6,42,220,0,262,0.0217391304347826
"820633301","SANTA FE",369,5,52,289,4,345,0.013550135501355
"820633207","SANTA FE",476,3,153,319,1,473,0.00630252100840336
"820910214","SANTA FE",320,0,108,153,32,293,0
"820490906","SANTA FE",508,183,161,136,5,302,0.360236220472441
"820633203","SANTA FE",435,3,145,280,1,426,0.00689655172413793
"820490702","SANTA FE",322,318,1,2,0,3,0.987577639751553
"820633103","SANTA FE",345,11,129,198,0,327,0.0318840579710145
"820490517","SANTA FE",283,260,7,12,0,19,0.918727915194346
"820633102","SANTA FE",188,1,78,108,0,186,0.00531914893617021
"820630207","SANTA FE",390,4,296,89,1,386,0.0102564102564103
"820700215","SANTA FE",41,0,28,13,0,41,0
"820630906","SANTA FE",340,321,7,12,0,19,0.944117647058824
"820633012","SANTA FE",263,182,56,25,0,81,0.692015209125475
"820632823","SANTA FE",211,1,96,112,1,209,0.004739336492891
"820070404","SANTA FE",213,200,4,6,2,12,0.938967136150235
"820070403","SANTA FE",326,306,8,10,0,18,0.938650306748466
"820700705","SANTA FE",308,132,46,125,3,174,0.428571428571429
"820848214","SANTA FE",387,12,293,82,0,375,0.0310077519379845
"820632816","SANTA FE",162,0,42,114,3,159,0
"820632712","SANTA FE",401,47,186,167,0,353,0.117206982543641
"820632611","SANTA FE",252,248,0,0,0,0,0.984126984126984
"820632418","SANTA FE",120,119,1,0,0,1,0.991666666666667
"820632417","SANTA FE",221,221,0,0,0,0,1
"820632410","SANTA FE",232,201,0,0,0,0,0.866379310344828
"820840901","SANTA FE",282,271,6,1,4,11,0.960992907801418
"820840910","SANTA FE",206,202,4,0,0,4,0.980582524271845
"820841815","SANTA FE",223,223,0,0,0,0,1
"820632301","SANTA FE",283,282,1,0,0,1,0.996466431095406
"820632001","SANTA FE",310,305,3,2,0,5,0.983870967741935
"820630110","SANTA FE",369,1,118,240,3,361,0.002710027100271
"820910509","SANTA FE",489,4,312,96,50,458,0.0081799591002045
"820840801","SANTA FE",255,249,3,3,0,6,0.976470588235294
"820631712","SANTA FE",285,283,1,0,1,2,0.992982456140351
"820631605","SANTA FE",229,224,3,2,0,5,0.978165938864629
"820631602","SANTA FE",330,321,2,7,0,9,0.972727272727273
"820631510","SANTA FE",348,325,12,11,0,23,0.933908045977011
"820490202","SANTA FE",316,104,36,153,11,200,0.329113924050633
"820631609","SANTA FE",231,218,5,8,0,13,0.943722943722944
"820631402","SANTA FE",382,363,7,11,0,18,0.950261780104712
"820631303","SANTA FE",177,87,57,32,1,90,0.491525423728814
"820631213","SANTA FE",373,129,122,120,0,242,0.345844504021448
"820631313","SANTA FE",365,340,14,11,0,25,0.931506849315068
"820631312","SANTA FE",300,279,11,10,0,21,0.93
"067490908","BUENOS AIRES",320,289,17,11,0,28,0.903125
"820631310","SANTA FE",233,23,93,115,1,209,0.0987124463519313
"820631713","SANTA FE",326,325,1,0,0,1,0.996932515337423
"820490123","SANTA FE",631,10,339,213,19,571,0.0158478605388273
"820490118","SANTA FE",391,138,161,86,4,251,0.352941176470588
"820631207","SANTA FE",365,18,131,213,2,346,0.0493150684931507
"820631210","SANTA FE",282,13,27,200,12,239,0.0460992907801418
"820700713","SANTA FE",295,82,125,88,0,213,0.277966101694915
"820840722","SANTA FE",206,98,12,68,16,96,0.475728155339806
"820841919","SANTA FE",161,161,0,0,0,0,1
"820840716","SANTA FE",217,215,1,1,0,2,0.990783410138249
"820910513","SANTA FE",325,162,122,33,7,162,0.498461538461538
"820842616","SANTA FE",348,347,0,0,0,0,0.997126436781609
"820840711","SANTA FE",261,200,49,12,0,61,0.766283524904215
"820840621","SANTA FE",287,286,1,0,0,1,0.996515679442509
"820840617","SANTA FE",297,41,100,150,0,250,0.138047138047138
"820848116","SANTA FE",350,291,35,24,0,59,0.831428571428571
"820848108","SANTA FE",233,208,15,5,1,21,0.892703862660944
"820560514","SANTA FE",320,263,27,29,0,56,0.821875
"820560508","SANTA FE",187,178,2,6,0,8,0.951871657754011
"820560506","SANTA FE",245,244,0,1,0,1,0.995918367346939
"820560504","SANTA FE",279,272,3,1,0,4,0.974910394265233
"820560503","SANTA FE",331,320,3,6,0,9,0.966767371601209
"820560412","SANTA FE",230,227,1,2,0,3,0.98695652173913
"820560510","SANTA FE",296,256,15,20,0,35,0.864864864864865
"820848017","SANTA FE",305,304,1,0,0,1,0.99672131147541
"820847804","SANTA FE",344,223,57,53,3,113,0.648255813953488
"820842807","SANTA FE",365,365,0,0,0,0,1
"820845712","SANTA FE",263,5,140,116,0,256,0.0190114068441065
"820910313","SANTA FE",310,117,176,12,4,192,0.37741935483871
"820980405","SANTA FE",263,19,146,92,3,241,0.0722433460076046
"820910310","SANTA FE",374,186,140,35,5,180,0.497326203208556
"820845416","SANTA FE",286,221,15,50,0,65,0.772727272727273
"821190911","SANTA FE",191,191,0,0,0,0,1
"820845402","SANTA FE",242,224,10,8,0,18,0.925619834710744
"820845322","SANTA FE",59,59,0,0,0,0,1
"820845315","SANTA FE",300,299,0,0,0,0,0.996666666666667
"821190812","SANTA FE",182,85,69,28,0,97,0.467032967032967
"820280204","SANTA FE",323,1,158,162,1,321,0.00309597523219814
"820841101","SANTA FE",238,8,211,19,0,230,0.0336134453781513
"820841019","SANTA FE",1329,280,242,737,20,999,0.210684725357412
"821190414","SANTA FE",554,9,252,282,0,534,0.0162454873646209
"380070302","JUJUY",48,4,1,6,22,29,0.0833333333333333
"820490109","SANTA FE",360,6,271,64,13,348,0.0166666666666667
"821190709","SANTA FE",297,14,143,132,3,278,0.0471380471380471
"821190710","SANTA FE",277,51,107,103,0,210,0.184115523465704
"821190701","SANTA FE",387,106,113,162,4,279,0.27390180878553
"820280114","SANTA FE",294,5,104,174,7,285,0.0170068027210884
"820847717","SANTA FE",243,222,10,8,0,18,0.91358024691358
"820280103","SANTA FE",220,158,24,37,1,62,0.718181818181818
"820846219","SANTA FE",287,92,114,81,0,195,0.320557491289199
"820210908","SANTA FE",58,58,0,0,0,0,1
"820210814","SANTA FE",386,357,15,10,0,25,0.924870466321243
"820210813","SANTA FE",284,238,13,22,0,35,0.838028169014085
"820210807","SANTA FE",400,370,4,20,0,24,0.925
"820210722","SANTA FE",567,4,443,98,13,554,0.00705467372134039
"820631708","SANTA FE",291,289,1,1,0,2,0.993127147766323
"821330624","SANTA FE",16,0,1,15,0,16,0
"821330615","SANTA FE",8,0,0,8,0,8,0
"821330506","SANTA FE",2,0,0,1,1,2,0
"821190116","SANTA FE",45,0,21,23,1,45,0
"820910510","SANTA FE",88,0,30,45,7,82,0
"820210330","SANTA FE",43,0,21,18,1,40,0
"380700501","JUJUY",218,34,69,66,23,158,0.155963302752294
"821190112","SANTA FE",47,0,22,25,0,47,0
"820910407","SANTA FE",37,0,12,16,7,35,0
"820910217","SANTA FE",125,0,54,63,4,121,0
"821330205","SANTA FE",4,0,1,1,2,4,0
"820210329","SANTA FE",49,0,13,34,0,47,0
"380630201","JUJUY",40,6,5,17,3,25,0.15
"821120303","SANTA FE",179,83,18,75,0,93,0.463687150837989
"820845902","SANTA FE",28,0,17,10,1,28,0
"820490503","SANTA FE",47,0,9,34,2,45,0
"820843918","SANTA FE",438,363,28,47,0,75,0.828767123287671
"821120201","SANTA FE",20,0,7,11,1,19,0
"820700107","SANTA FE",53,0,25,27,0,52,0
"820350203","SANTA FE",32,0,2,28,0,30,0
"820210325","SANTA FE",29,0,13,14,2,29,0
"821050501","SANTA FE",47,0,9,35,2,46,0
"820980312","SANTA FE",109,0,11,68,18,97,0
"820210303","SANTA FE",67,0,17,48,2,67,0
"820847805","SANTA FE",164,2,14,135,5,154,0.0121951219512195
"820846405","SANTA FE",82,1,27,48,1,76,0.0121951219512195
"820846002","SANTA FE",147,0,42,96,6,144,0
"420350301","LA PAMPA",3,0,2,1,0,3,0
"820632716","SANTA FE",132,0,31,91,5,127,0
"820700525","SANTA FE",427,360,44,23,0,67,0.843091334894614
"820140512","SANTA FE",17,1,9,7,0,16,0.0588235294117647
"820845714","SANTA FE",27,0,16,11,0,27,0
"820841810","SANTA FE",262,262,0,0,0,0,1
"821120215","SANTA FE",20,0,4,13,2,19,0
"820210314","SANTA FE",98,1,33,63,0,96,0.0102040816326531
"820140413","SANTA FE",19,0,11,8,0,19,0
"820140312","SANTA FE",39,0,13,26,0,39,0
"820140522","SANTA FE",9,0,0,8,0,8,0
"820420911","SANTA FE",251,246,3,1,1,5,0.9800796812749
"820490404","SANTA FE",113,1,62,37,7,106,0.00884955752212389
"820211003","SANTA FE",69,0,20,44,5,69,0
"820210708","SANTA FE",5,0,0,3,0,3,0
"821330530","SANTA FE",15,0,1,6,6,13,0
"820632906","SANTA FE",353,4,114,199,5,318,0.0113314447592068
"820070212","SANTA FE",97,0,31,65,1,97,0
"821120301","SANTA FE",52,0,18,26,4,48,0
"421470108","LA PAMPA",15,0,3,12,0,15,0
"820420304","SANTA FE",72,0,37,34,1,72,0
"820700522","SANTA FE",255,232,13,10,0,23,0.909803921568627
"820420301","SANTA FE",67,1,22,42,1,65,0.0149253731343284
"820210127","SANTA FE",41,0,7,32,1,40,0
"820210122","SANTA FE",52,0,23,29,0,52,0
"820210112","SANTA FE",145,0,71,66,4,141,0
"821260213","SANTA FE",66,1,26,37,0,63,0.0151515151515152
"820844903","SANTA FE",281,278,1,0,0,1,0.98932384341637
"820210108","SANTA FE",107,0,38,62,7,107,0
"820420201","SANTA FE",108,1,36,68,0,104,0.00925925925925926
"820420113","SANTA FE",54,0,27,26,0,53,0
"820420101","SANTA FE",43,0,18,25,0,43,0
"820560107","SANTA FE",13,9,1,2,1,4,0.692307692307692
"820350107","SANTA FE",28,0,7,20,1,28,0
"820770403","SANTA FE",49,0,13,28,3,44,0
"820421005","SANTA FE",262,135,53,70,1,124,0.515267175572519
"820490912","SANTA FE",75,0,12,37,5,54,0
"821330502","SANTA FE",22,0,7,8,4,19,0
"820490909","SANTA FE",77,0,50,24,2,76,0
"820490417","SANTA FE",8,0,6,2,0,8,0
"821199301","SANTA FE",21,0,6,14,0,20,0
"820421202","SANTA FE",74,2,31,40,0,71,0.027027027027027
"420210205","LA PAMPA",18,0,5,13,0,18,0
"820280315","SANTA FE",63,1,21,40,1,62,0.0158730158730159
"820846403","SANTA FE",223,1,82,129,8,219,0.00448430493273543
"820490807","SANTA FE",76,0,22,28,10,60,0
"820280219","SANTA FE",14,0,4,10,0,14,0
"820630314","SANTA FE",380,0,179,198,1,378,0
"820632822","SANTA FE",56,26,10,20,0,30,0.464285714285714
"820490122","SANTA FE",67,0,16,40,7,63,0
"820280323","SANTA FE",53,0,15,33,5,53,0
"820490814","SANTA FE",79,0,11,57,2,70,0
"820910401","SANTA FE",130,0,81,43,2,126,0
"820560219","SANTA FE",316,283,8,18,1,27,0.895569620253165
"820630108","SANTA FE",79,16,26,37,0,63,0.20253164556962
"820490323","SANTA FE",92,0,30,42,9,81,0
"420910102","LA PAMPA",40,0,8,22,5,35,0
"821330603","SANTA FE",110,5,30,67,4,101,0.0454545454545455
"820491006","SANTA FE",304,3,64,222,6,292,0.00986842105263158
"821330528","SANTA FE",54,0,6,40,6,52,0
"821330311","SANTA FE",122,0,13,94,0,107,0
"821260301","SANTA FE",84,5,31,43,3,77,0.0595238095238095
"820420804","SANTA FE",271,268,2,0,0,2,0.988929889298893
"820847705","SANTA FE",320,284,15,20,1,36,0.8875
"821190904","SANTA FE",267,40,128,99,0,227,0.149812734082397
"820700301","SANTA FE",210,1,78,110,7,195,0.00476190476190476
"820420308","SANTA FE",198,0,78,102,3,183,0
"820845923","SANTA FE",499,17,48,391,12,451,0.0340681362725451
"821260311","SANTA FE",384,328,27,26,1,54,0.854166666666667
"820630317","SANTA FE",314,0,16,272,8,296,0
"820849001","SANTA FE",188,1,123,63,1,187,0.00531914893617021
"820847702","SANTA FE",70,1,17,47,0,64,0.0142857142857143
"820140201","SANTA FE",54,18,13,23,0,36,0.333333333333333
"820140127","SANTA FE",32,0,20,12,0,32,0
"821190410","SANTA FE",359,6,247,103,0,350,0.0167130919220056
"820700310","SANTA FE",467,296,68,100,0,168,0.633832976445396
"820490116","SANTA FE",750,12,260,406,40,706,0.016
"820560207","SANTA FE",183,15,49,113,0,162,0.0819672131147541
"820846113","SANTA FE",287,10,158,118,0,276,0.0348432055749129
"820845924","SANTA FE",311,2,144,142,19,305,0.00643086816720257
"820280107","SANTA FE",148,20,59,66,2,127,0.135135135135135
"820630613","SANTA FE",266,258,3,5,0,8,0.969924812030075
"820421209","SANTA FE",120,1,52,64,1,117,0.00833333333333333
"821330412","SANTA FE",354,146,75,127,1,203,0.412429378531073
"821330409","SANTA FE",292,58,142,83,7,232,0.198630136986301
"821330408","SANTA FE",165,153,6,6,0,12,0.927272727272727
"821260406","SANTA FE",399,222,106,69,0,175,0.556390977443609
"821260312","SANTA FE",261,226,20,15,0,35,0.865900383141762
"821260304","SANTA FE",363,21,101,219,5,325,0.0578512396694215
"821260210","SANTA FE",472,134,115,207,3,325,0.283898305084746
"821260106","SANTA FE",411,311,67,24,9,100,0.75669099756691
"820910602","SANTA FE",322,79,196,42,4,242,0.245341614906832
"821191006","SANTA FE",281,74,86,111,0,197,0.263345195729537
"821050121","SANTA FE",205,0,76,127,1,204,0
"821050103","SANTA FE",266,0,96,130,7,233,0
"821120101","SANTA FE",164,1,45,114,2,161,0.00609756097560976
"820980402","SANTA FE",328,1,152,174,0,326,0.00304878048780488
"821120409","SANTA FE",287,220,43,22,1,66,0.766550522648084
"820980410","SANTA FE",291,40,91,137,14,242,0.13745704467354
"820980316","SANTA FE",792,6,221,495,33,749,0.00757575757575758
"821050224","SANTA FE",312,104,64,139,1,204,0.333333333333333
"820910609","SANTA FE",325,0,229,82,9,320,0
"820910606","SANTA FE",252,0,234,16,0,250,0
"820910508","SANTA FE",527,92,263,109,53,425,0.174573055028463
"820849005","SANTA FE",199,3,156,40,0,196,0.0150753768844221
"820848910","SANTA FE",555,15,111,406,3,520,0.027027027027027
"820848905","SANTA FE",413,6,170,184,1,355,0.0145278450363196
"820848502","SANTA FE",418,99,44,260,0,304,0.236842105263158
"820848414","SANTA FE",318,285,4,0,0,4,0.89622641509434
"820910309","SANTA FE",206,90,97,13,6,116,0.436893203883495
"820846102","SANTA FE",248,7,119,121,1,241,0.0282258064516129
"820280403","SANTA FE",363,204,23,121,2,146,0.56198347107438
"820848203","SANTA FE",380,18,157,202,1,360,0.0473684210526316
"820848202","SANTA FE",379,298,26,52,0,78,0.786279683377309
"820848010","SANTA FE",262,256,3,0,0,3,0.977099236641221
"820847807","SANTA FE",335,220,58,50,6,114,0.656716417910448
"820847301","SANTA FE",145,0,26,112,1,139,0
"820846903","SANTA FE",358,12,173,162,8,343,0.0335195530726257
"820560301","SANTA FE",376,243,45,79,2,126,0.646276595744681
"820847203","SANTA FE",359,288,21,47,1,69,0.802228412256267
"820847202","SANTA FE",470,386,36,45,1,82,0.821276595744681
"820847713","SANTA FE",390,367,11,7,1,19,0.941025641025641
"820846103","SANTA FE",260,8,84,165,1,250,0.0307692307692308
"821190313","SANTA FE",267,5,170,90,0,260,0.0187265917602996
"820846004","SANTA FE",389,57,191,138,2,331,0.146529562982005
"820845522","SANTA FE",439,17,35,303,55,393,0.0387243735763098
"820845521","SANTA FE",272,25,124,120,0,244,0.0919117647058824
"820845305","SANTA FE",187,121,17,45,0,62,0.647058823529412
"820843303","SANTA FE",487,24,104,352,1,457,0.0492813141683778
"820840203","SANTA FE",368,22,189,152,1,342,0.0597826086956522
"821190715","SANTA FE",499,46,149,293,0,442,0.0921843687374749
"821190612","SANTA FE",372,80,110,176,3,289,0.21505376344086
"821190608","SANTA FE",522,483,22,10,0,32,0.925287356321839
"821190503","SANTA FE",450,3,244,199,0,443,0.00666666666666667
"821190502","SANTA FE",401,4,117,270,3,390,0.00997506234413965
"821190307","SANTA FE",193,111,28,50,0,78,0.575129533678757
"821190204","SANTA FE",348,341,5,2,0,7,0.979885057471264
"821190108","SANTA FE",285,205,37,42,0,79,0.719298245614035
"821120405","SANTA FE",459,13,164,254,3,421,0.028322440087146
"821190314","SANTA FE",304,2,134,168,0,302,0.00657894736842105
"821050517","SANTA FE",198,5,74,105,6,185,0.0252525252525253
"821190207","SANTA FE",204,200,2,2,0,4,0.980392156862745
"821050512","SANTA FE",247,0,153,88,3,244,0
"820490606","SANTA FE",324,314,5,2,0,7,0.969135802469136
"820490522","SANTA FE",368,292,34,39,1,74,0.793478260869565
"820490514","SANTA FE",607,184,186,179,1,366,0.303130148270181
"820700117","SANTA FE",207,0,129,78,0,207,0
"420210103","LA PAMPA",21,0,14,7,0,21,0
"820632902","SANTA FE",236,1,87,136,3,226,0.00423728813559322
"820632805","SANTA FE",526,393,52,81,0,133,0.747148288973384
"820632704","SANTA FE",344,334,6,4,0,10,0.970930232558139
"820841910","SANTA FE",357,357,0,0,0,0,1
"820844705","SANTA FE",380,290,23,63,0,86,0.763157894736842
"820841907","SANTA FE",201,199,1,0,0,1,0.990049751243781
"820844601","SANTA FE",324,304,11,8,0,19,0.938271604938272
"820844909","SANTA FE",376,376,0,0,0,0,1
"820844511","SANTA FE",367,354,5,8,0,13,0.964577656675749
"820844507","SANTA FE",261,227,12,21,0,33,0.869731800766284
"820844614","SANTA FE",397,346,8,37,1,46,0.871536523929471
"820844613","SANTA FE",387,271,39,75,1,115,0.700258397932817
"820844611","SANTA FE",377,118,29,221,0,250,0.312997347480106
"820420712","SANTA FE",335,333,1,1,0,2,0.994029850746269
"820280322","SANTA FE",198,0,30,142,4,176,0
"820490901","SANTA FE",112,3,93,14,1,108,0.0267857142857143
"820280312","SANTA FE",111,37,51,20,0,71,0.333333333333333
"820700209","SANTA FE",276,189,55,25,6,86,0.684782608695652
"820700221","SANTA FE",353,192,92,69,0,161,0.543909348441926
"820700204","SANTA FE",345,193,108,44,0,152,0.559420289855072
"421540404","LA PAMPA",29,0,15,14,0,29,0
"820844606","SANTA FE",356,352,4,0,0,4,0.98876404494382
"820844605","SANTA FE",148,146,2,0,0,2,0.986486486486487
"820844411","SANTA FE",237,236,1,0,0,1,0.9957805907173
"820844407","SANTA FE",289,288,0,1,0,1,0.996539792387543
"820844405","SANTA FE",200,169,1,0,0,1,0.845
"820844313","SANTA FE",328,299,13,16,0,29,0.911585365853659
"820844312","SANTA FE",361,341,9,10,1,20,0.944598337950138
"820844307","SANTA FE",335,331,2,2,0,4,0.988059701492537
"820844214","SANTA FE",163,125,14,23,1,38,0.766871165644172
"820844111","SANTA FE",241,200,14,23,0,37,0.829875518672199
"820844014","SANTA FE",341,341,0,0,0,0,1
"820844013","SANTA FE",209,180,3,22,0,25,0.861244019138756
"821260511","SANTA FE",402,371,25,5,0,30,0.922885572139303
"821260307","SANTA FE",390,1,196,184,7,387,0.00256410256410256
"065950311","BUENOS AIRES",341,169,127,43,0,170,0.495601173020528
"820843209","SANTA FE",252,201,14,29,6,49,0.797619047619048
"820848313","SANTA FE",248,209,17,20,0,37,0.842741935483871
"820846802","SANTA FE",185,1,81,101,1,183,0.00540540540540541
"820842103","SANTA FE",296,281,0,0,0,0,0.949324324324324
"820843113","SANTA FE",295,268,20,7,0,27,0.908474576271186
"820843112","SANTA FE",312,274,22,16,0,38,0.878205128205128
"821120403","SANTA FE",208,158,28,22,0,50,0.759615384615385
"820843313","SANTA FE",288,284,2,2,0,4,0.986111111111111
"820843215","SANTA FE",305,18,85,198,1,284,0.059016393442623
"820843106","SANTA FE",305,245,32,27,0,59,0.80327868852459
"820843103","SANTA FE",290,250,27,12,0,39,0.862068965517241
"820843101","SANTA FE",385,326,33,26,0,59,0.846753246753247
"820841006","SANTA FE",496,49,79,330,20,429,0.0987903225806452
"820843002","SANTA FE",289,144,51,81,0,132,0.498269896193772
"820633007","SANTA FE",448,440,2,6,0,8,0.982142857142857
"820842105","SANTA FE",166,166,0,0,0,0,1
"820842709","SANTA FE",116,116,0,0,0,0,1
"820770103","SANTA FE",379,0,163,141,33,337,0
"820700609","SANTA FE",72,0,36,34,1,71,0
"820700405","SANTA FE",295,284,5,6,0,11,0.96271186440678
"820842606","SANTA FE",170,170,0,0,0,0,1
"820490406","SANTA FE",232,51,106,72,1,179,0.219827586206897
"820842603","SANTA FE",305,301,4,0,0,4,0.986885245901639
"820842515","SANTA FE",188,188,0,0,0,0,1
"820844902","SANTA FE",293,291,1,0,0,1,0.993174061433447
"820490128","SANTA FE",375,107,130,127,5,262,0.285333333333333
"820842510","SANTA FE",159,158,1,0,0,1,0.993710691823899
"820842904","SANTA FE",327,326,1,0,0,1,0.996941896024465
"820842901","SANTA FE",487,486,1,0,0,1,0.997946611909651
"820842817","SANTA FE",318,318,0,0,0,0,1
"820842802","SANTA FE",386,386,0,0,0,0,1
"820560310","SANTA FE",223,140,32,51,0,83,0.62780269058296
"820560307","SANTA FE",287,196,54,34,0,88,0.682926829268293
"820842114","SANTA FE",317,297,0,0,0,0,0.936908517350158
"060351207","BUENOS AIRES",160,159,1,0,0,1,0.99375
"820841501","SANTA FE",252,249,1,2,0,3,0.988095238095238
"820841924","SANTA FE",246,246,0,0,0,0,1
"820842302","SANTA FE",224,224,0,0,0,0,1
"820280318","SANTA FE",333,0,243,86,1,330,0
"820280304","SANTA FE",329,321,3,5,0,8,0.975683890577508
"820211014","SANTA FE",358,31,167,159,1,327,0.0865921787709497
"820842209","SANTA FE",256,255,0,0,0,0,0.99609375
"820210312","SANTA FE",40,0,23,14,1,38,0
"820210119","SANTA FE",506,0,315,169,18,502,0
"820210107","SANTA FE",293,212,35,45,0,80,0.723549488054608
"820140517","SANTA FE",389,0,159,224,5,388,0
"820841718","SANTA FE",284,283,0,0,0,0,0.996478873239437
"820841610","SANTA FE",253,250,2,1,0,3,0.988142292490119
"820841601","SANTA FE",319,316,2,1,0,3,0.990595611285266
"820841503","SANTA FE",240,238,1,0,0,1,0.991666666666667
"820841502","SANTA FE",263,257,5,0,0,5,0.977186311787072
"820420415","SANTA FE",341,43,131,153,0,284,0.126099706744868
"820841401","SANTA FE",284,255,14,12,1,27,0.897887323943662
"820841716","SANTA FE",174,159,1,1,0,2,0.913793103448276
"820841712","SANTA FE",262,262,0,0,0,0,1
"820841210","SANTA FE",263,42,105,114,0,219,0.159695817490494
"820841218","SANTA FE",400,47,81,258,7,346,0.1175
"820843610","SANTA FE",330,328,0,2,0,2,0.993939393939394
"820841203","SANTA FE",332,33,140,157,0,297,0.0993975903614458
"820845109","SANTA FE",317,252,26,39,0,65,0.794952681388013
"820841117","SANTA FE",349,126,162,61,0,223,0.361031518624642
"820843414","SANTA FE",294,268,8,16,0,24,0.91156462585034
"820843406","SANTA FE",353,337,4,11,0,15,0.954674220963173
"820843319","SANTA FE",293,23,194,75,0,269,0.0784982935153584
"820630607","SANTA FE",225,213,5,7,0,12,0.946666666666667
"820843609","SANTA FE",311,308,3,0,0,3,0.990353697749196
"820843604","SANTA FE",287,267,0,0,0,0,0.930313588850174
"820843603","SANTA FE",227,226,0,0,0,0,0.995594713656388
"820843315","SANTA FE",500,401,10,63,0,73,0.802
"820845002","SANTA FE",361,260,52,46,1,99,0.720221606648199
"820844905","SANTA FE",271,24,49,196,0,245,0.0885608856088561
"820845102","SANTA FE",313,293,13,7,0,20,0.936102236421725
"820845013","SANTA FE",336,31,161,143,1,305,0.0922619047619048
"820210613","SANTA FE",278,240,14,22,0,36,0.863309352517986
"820210610","SANTA FE",370,149,144,71,0,215,0.402702702702703
"820210609","SANTA FE",427,419,4,3,0,7,0.981264637002342
"820210602","SANTA FE",362,359,2,1,0,3,0.99171270718232
"820844817","SANTA FE",430,367,9,49,1,59,0.853488372093023
"820210321","SANTA FE",427,6,300,116,2,418,0.0140515222482436
"820210305","SANTA FE",444,0,271,157,6,434,0
"820210213","SANTA FE",206,202,3,1,0,4,0.980582524271845
"820846101","SANTA FE",206,4,83,117,0,200,0.0194174757281553
"820210210","SANTA FE",364,327,17,18,0,35,0.898351648351648
"820210501","SANTA FE",319,256,20,30,1,51,0.802507836990596
"820210422","SANTA FE",975,34,498,405,2,905,0.0348717948717949
"820210420","SANTA FE",246,209,7,27,0,34,0.849593495934959
"821050416","SANTA FE",326,211,30,75,0,105,0.647239263803681
"065950404","BUENOS AIRES",338,176,58,103,0,161,0.520710059171598
"820210115","SANTA FE",231,3,105,121,1,227,0.012987012987013
"820848901","SANTA FE",262,10,162,87,1,250,0.0381679389312977
"820848802","SANTA FE",342,2,94,241,0,335,0.00584795321637427
"820140602","SANTA FE",451,395,9,44,0,53,0.875831485587583
"820848713","SANTA FE",297,187,27,80,0,107,0.62962962962963
"820140523","SANTA FE",269,3,113,141,1,255,0.0111524163568773
"820140519","SANTA FE",273,0,123,149,0,272,0
"820140513","SANTA FE",231,0,136,85,5,226,0
"820845916","SANTA FE",186,0,148,38,0,186,0
"820421110","SANTA FE",194,7,92,94,0,186,0.0360824742268041
"820420704","SANTA FE",411,94,130,172,2,304,0.228710462287105
"820420701","SANTA FE",283,1,208,66,0,274,0.00353356890459364
"820420608","SANTA FE",348,341,4,3,0,7,0.979885057471264
"820420607","SANTA FE",329,286,18,24,0,42,0.869300911854103
"820420507","SANTA FE",335,132,93,109,0,202,0.394029850746269
"820848610","SANTA FE",670,443,48,149,4,201,0.661194029850746
"820280510","SANTA FE",230,219,7,1,1,9,0.952173913043478
"820140409","SANTA FE",231,27,69,134,1,204,0.116883116883117
"820140407","SANTA FE",290,22,90,174,1,265,0.0758620689655172
"820140401","SANTA FE",283,83,95,100,0,195,0.293286219081272
"820140310","SANTA FE",313,300,6,6,0,12,0.958466453674121
"820420421","SANTA FE",405,281,66,58,0,124,0.693827160493827
"820420420","SANTA FE",37,1,29,7,0,36,0.027027027027027
"820848605","SANTA FE",403,289,27,81,1,109,0.71712158808933
"820848514","SANTA FE",409,185,67,136,5,208,0.452322738386308
"820848513","SANTA FE",355,46,53,239,0,292,0.129577464788732
"820070206","SANTA FE",271,205,44,20,1,65,0.756457564575646
"820070205","SANTA FE",363,276,38,42,1,81,0.760330578512397
"820842412","SANTA FE",303,301,2,0,0,2,0.993399339933993
"820631117","SANTA FE",260,10,30,215,3,248,0.0384615384615385
"820840607","SANTA FE",265,265,0,0,0,0,1
"820280214","SANTA FE",222,0,117,103,2,222,0
"820140111","SANTA FE",345,0,104,228,4,336,0
"820140109","SANTA FE",451,0,168,283,0,451,0
"065951603","BUENOS AIRES",391,6,161,220,1,382,0.0153452685421995
"820070412","SANTA FE",391,336,28,24,1,53,0.859335038363171
"820842413","SANTA FE",318,318,0,0,0,0,1
"820420306","SANTA FE",84,0,6,68,5,79,0
"820840606","SANTA FE",374,28,136,208,2,346,0.0748663101604278
"820631111","SANTA FE",426,7,90,317,0,407,0.0164319248826291
"820631107","SANTA FE",708,0,164,484,11,659,0
"820280504","SANTA FE",306,304,1,1,0,2,0.993464052287582
"820631105","SANTA FE",359,45,105,206,0,311,0.125348189415042
"820560115","SANTA FE",261,2,137,114,4,255,0.00766283524904215
"820630604","SANTA FE",382,284,41,50,3,94,0.743455497382199
"820630510","SANTA FE",461,7,86,330,17,433,0.0151843817787419
"820840514","SANTA FE",354,273,31,27,0,58,0.771186440677966
"820840419","SANTA FE",72,64,6,2,0,8,0.888888888888889
"820560111","SANTA FE",262,2,178,78,0,256,0.00763358778625954
"820840519","SANTA FE",382,357,17,8,0,25,0.934554973821989
"820631103","SANTA FE",391,13,96,277,2,375,0.0332480818414322
"820631102","SANTA FE",304,16,46,231,5,282,0.0526315789473684
"820630812","SANTA FE",328,318,5,5,0,10,0.969512195121951
"820630808","SANTA FE",292,285,4,3,0,7,0.976027397260274
"820630806","SANTA FE",258,252,5,1,0,6,0.976744186046512
"820560108","SANTA FE",299,0,94,181,6,281,0
"820420221","SANTA FE",425,5,215,203,1,419,0.0117647058823529
"820840417","SANTA FE",94,85,6,3,0,9,0.904255319148936
"820840411","SANTA FE",307,258,29,19,0,48,0.840390879478827
"820840212","SANTA FE",315,4,125,177,5,307,0.0126984126984127
"821050314","SANTA FE",242,184,27,28,1,56,0.760330578512397
"821190419","SANTA FE",353,8,273,71,0,344,0.0226628895184136
"821050312","SANTA FE",261,220,30,11,0,41,0.842911877394636
"820770305","SANTA FE",455,3,202,169,26,397,0.00659340659340659
"821260516","SANTA FE",370,308,38,21,1,60,0.832432432432432
"820280326","SANTA FE",528,442,24,49,1,74,0.837121212121212
"820491014","SANTA FE",630,6,445,166,3,614,0.00952380952380952
"821260505","SANTA FE",322,293,24,4,0,28,0.909937888198758
"821260502","SANTA FE",305,186,49,59,4,112,0.60983606557377
"821260315","SANTA FE",280,230,25,22,0,47,0.821428571428571
"820630411","SANTA FE",301,4,31,249,4,284,0.0132890365448505
"821190304","SANTA FE",491,488,2,1,0,3,0.993890020366599
"820630408","SANTA FE",297,2,20,268,0,288,0.00673400673400673
"821050301","SANTA FE",619,8,205,315,31,551,0.012924071082391
"820630222","SANTA FE",420,92,121,196,1,318,0.219047619047619
"820770106","SANTA FE",267,0,90,133,17,240,0
"820280314","SANTA FE",173,0,94,78,0,172,0
"821260507","SANTA FE",312,293,17,2,0,19,0.939102564102564
"820910316","SANTA FE",4,0,0,4,0,4,0
"820700501","SANTA FE",397,273,33,84,2,119,0.687657430730479
"820700418","SANTA FE",237,233,3,0,1,4,0.983122362869198
"820848312","SANTA FE",247,210,29,8,0,37,0.850202429149798
"820700407","SANTA FE",233,227,5,0,1,6,0.974248927038627
"820700402","SANTA FE",567,366,119,76,0,195,0.645502645502645
"820633216","SANTA FE",298,101,47,150,0,197,0.338926174496644
"820633212","SANTA FE",597,14,165,402,9,576,0.0234505862646566
"820633209","SANTA FE",490,421,19,50,0,69,0.859183673469388
"820490910","SANTA FE",123,4,76,38,3,117,0.032520325203252
"820490908","SANTA FE",281,115,105,54,1,160,0.409252669039146
"820633206","SANTA FE",253,4,77,168,3,248,0.0158102766798419
"820490701","SANTA FE",307,153,42,87,5,134,0.498371335504886
"820420410","SANTA FE",218,185,18,15,0,33,0.848623853211009
"820633404","SANTA FE",255,13,90,141,3,234,0.0509803921568627
"820848302","SANTA FE",377,345,12,20,0,32,0.915119363395225
"820633013","SANTA FE",394,268,29,91,2,122,0.680203045685279
"820630211","SANTA FE",263,80,151,30,0,181,0.304182509505703
"820633110","SANTA FE",376,52,58,249,2,309,0.138297872340426
"820490408","SANTA FE",310,2,142,141,9,292,0.00645161290322581
"820633109","SANTA FE",667,14,439,211,2,652,0.0209895052473763
"820633108","SANTA FE",241,6,129,89,1,219,0.024896265560166
"820490718","SANTA FE",747,10,284,385,44,713,0.0133868808567604
"820280305","SANTA FE",268,265,2,1,0,3,0.988805970149254
"820630128","SANTA FE",378,10,41,292,5,338,0.0264550264550265
"820630120","SANTA FE",285,1,196,88,0,284,0.00350877192982456
"820632914","SANTA FE",215,188,25,2,0,27,0.874418604651163
"820632913","SANTA FE",332,329,3,0,0,3,0.990963855421687
"820848216","SANTA FE",357,15,300,42,0,342,0.0420168067226891
"820632827","SANTA FE",79,1,52,26,0,78,0.0126582278481013
"820632826","SANTA FE",198,8,86,103,0,189,0.0404040404040404
"820632819","SANTA FE",359,6,216,117,3,336,0.0167130919220056
"820842408","SANTA FE",219,217,1,1,0,2,0.990867579908676
"820632811","SANTA FE",671,15,189,442,8,639,0.022354694485842
"820631607","SANTA FE",177,173,3,1,0,4,0.977401129943503
"063574206","BUENOS AIRES",170,170,0,0,0,0,1
"820632714","SANTA FE",476,3,211,256,3,470,0.00630252100840336
"820632711","SANTA FE",376,267,50,59,0,109,0.710106382978723
"820632608","SANTA FE",332,317,8,5,1,14,0.954819277108434
"820840904","SANTA FE",269,268,1,0,0,1,0.996282527881041
"820632409","SANTA FE",249,249,0,0,0,0,1
"820632407","SANTA FE",136,136,0,0,0,0,1
"820632810","SANTA FE",467,8,224,228,2,454,0.0171306209850107
"820490305","SANTA FE",468,141,217,100,3,320,0.301282051282051
"820490304","SANTA FE",311,150,116,40,2,158,0.482315112540193
"820840805","SANTA FE",332,324,3,3,1,7,0.975903614457831
"820632311","SANTA FE",157,156,0,1,0,1,0.993630573248408
"820632310","SANTA FE",353,353,0,0,0,0,1
"820632206","SANTA FE",110,110,0,0,0,0,1
"820632204","SANTA FE",134,132,2,0,0,2,0.985074626865672
"820632107","SANTA FE",319,319,0,0,0,0,1
"020131411","CABA",284,284,0,0,0,0,1
"820631913","SANTA FE",636,31,93,440,14,547,0.0487421383647799
"820630109","SANTA FE",297,5,112,175,0,287,0.0168350168350168
"820631906","SANTA FE",167,163,2,2,0,4,0.976047904191617
"820631809","SANTA FE",227,224,3,0,0,3,0.986784140969163
"820631802","SANTA FE",392,391,1,0,0,1,0.997448979591837
"820631801","SANTA FE",332,319,8,4,0,12,0.960843373493976
"820631707","SANTA FE",242,239,3,0,0,3,0.987603305785124
"820631706","SANTA FE",311,305,3,3,0,6,0.980707395498392
"820842809","SANTA FE",340,339,1,0,0,1,0.997058823529412
"820631703","SANTA FE",224,156,23,32,5,60,0.696428571428571
"820631511","SANTA FE",357,320,24,11,1,36,0.896358543417367
"820631411","SANTA FE",326,326,0,0,0,0,1
"820631406","SANTA FE",277,270,0,7,0,7,0.974729241877256
"020131607","CABA",369,369,0,0,0,0,1
"820490127","SANTA FE",204,1,99,94,1,194,0.00490196078431373
"820631404","SANTA FE",358,334,7,17,0,24,0.932960893854749
"820631319","SANTA FE",222,12,111,98,0,209,0.0540540540540541
"820631318","SANTA FE",267,242,10,14,0,24,0.906367041198502
"820490125","SANTA FE",315,166,64,71,1,136,0.526984126984127
"820840708","SANTA FE",272,214,17,39,0,56,0.786764705882353
"820840704","SANTA FE",450,78,120,240,2,362,0.173333333333333
"820840703","SANTA FE",453,32,190,225,2,417,0.0706401766004415
"820840622","SANTA FE",344,342,2,0,0,2,0.994186046511628
"820840614","SANTA FE",475,57,180,193,1,374,0.12
"820210806","SANTA FE",205,199,3,2,0,5,0.970731707317073
"820840611","SANTA FE",347,347,0,0,0,0,1
"820840705","SANTA FE",619,470,71,76,0,147,0.759289176090469
"820630101","SANTA FE",221,23,120,77,0,197,0.104072398190045
"820848021","SANTA FE",235,230,1,0,0,1,0.978723404255319
"820560305","SANTA FE",415,197,112,102,1,215,0.474698795180723
"820845704","SANTA FE",249,2,171,76,0,247,0.00803212851405622
"820845508","SANTA FE",459,340,56,51,0,107,0.740740740740741
"820845708","SANTA FE",415,1,302,111,0,413,0.00240963855421687
"820845404","SANTA FE",307,243,36,28,0,64,0.791530944625407
"820845321","SANTA FE",201,199,2,0,0,2,0.990049751243781
"820845318","SANTA FE",537,533,4,0,0,4,0.992551210428305
"821191012","SANTA FE",367,361,3,1,0,4,0.983651226158038
"820280205","SANTA FE",490,1,146,333,4,483,0.00204081632653061
"820280124","SANTA FE",231,0,125,106,0,231,0
"820280121","SANTA FE",225,191,17,17,0,34,0.848888888888889
"820841105","SANTA FE",310,20,113,177,0,290,0.0645161290322581
"820841103","SANTA FE",300,32,228,40,0,268,0.106666666666667
"821190802","SANTA FE",466,4,340,116,1,457,0.00858369098712446
"820841014","SANTA FE",398,47,108,230,0,338,0.118090452261307
"820910101","SANTA FE",203,11,26,139,17,182,0.0541871921182266
"821190712","SANTA FE",284,119,72,92,0,164,0.419014084507042
"820841009","SANTA FE",490,21,117,335,3,455,0.0428571428571429
"820421121","SANTA FE",220,4,92,119,2,213,0.0181818181818182
"820421119","SANTA FE",253,2,148,100,0,248,0.00790513833992095
"820421206","SANTA FE",276,1,162,113,0,275,0.0036231884057971
"820421205","SANTA FE",298,1,188,109,0,297,0.00335570469798658
"821190511","SANTA FE",363,72,141,146,0,287,0.198347107438017
"820421204","SANTA FE",325,0,159,161,2,322,0
"820421116","SANTA FE",363,0,100,261,0,361,0
"820846309","SANTA FE",333,8,48,264,1,313,0.024024024024024
"820846301","SANTA FE",409,19,57,308,3,368,0.0464547677261614
"820280122","SANTA FE",263,0,153,108,0,261,0
"820846209","SANTA FE",392,23,84,249,28,361,0.0586734693877551
"820211009","SANTA FE",415,0,340,71,2,413,0
"820846221","SANTA FE",309,8,82,216,0,298,0.0258899676375405
"820846213","SANTA FE",426,352,43,29,1,73,0.826291079812207
"820210902","SANTA FE",358,313,24,13,1,38,0.874301675977654
"820210809","SANTA FE",318,299,13,5,0,18,0.940251572327044
"020021005","CABA",426,425,1,0,0,1,0.997652582159624
"821190422","SANTA FE",340,5,240,92,1,333,0.0147058823529412
"820842416","SANTA FE",241,241,0,0,0,0,1
"821330602","SANTA FE",74,0,12,26,4,42,0
"821330518","SANTA FE",54,3,31,17,3,51,0.0555555555555556
"821330507","SANTA FE",4,0,1,1,2,4,0
"821330301","SANTA FE",8,0,3,4,1,8,0
"821330218","SANTA FE",29,0,2,22,2,26,0
"821330627","SANTA FE",14,1,4,8,1,13,0.0714285714285714
"821330509","SANTA FE",59,0,11,35,11,57,0
"821190114","SANTA FE",2,0,0,0,0,0,0
"820980306","SANTA FE",53,0,17,32,4,53,0
"820420322","SANTA FE",26,0,10,15,1,26,0
"068051201","BUENOS AIRES",252,6,174,70,0,244,0.0238095238095238
"821330105","SANTA FE",18,0,0,11,5,16,0
"821330103","SANTA FE",11,0,0,8,1,9,0
"062800310","BUENOS AIRES",52,51,1,0,0,1,0.980769230769231
"821120211","SANTA FE",52,1,14,23,3,40,0.0192307692307692
"820420216","SANTA FE",106,1,42,63,0,105,0.00943396226415094
"820910611","SANTA FE",373,0,316,53,3,372,0
"020131613","CABA",223,223,0,0,0,0,1
"820980303","SANTA FE",15,0,0,9,0,9,0
"820910216","SANTA FE",29,0,10,18,1,29,0
"820847706","SANTA FE",18,0,2,13,2,17,0
"820847205","SANTA FE",76,41,10,20,2,32,0.539473684210526
"820845903","SANTA FE",20,0,5,13,1,19,0
"820845901","SANTA FE",18,0,4,12,2,18,0
"820490519","SANTA FE",4,0,0,0,0,0,0
"820770401","SANTA FE",81,1,27,50,1,78,0.0123456790123457
"821330606","SANTA FE",10,0,5,4,0,9,0
"820630321","SANTA FE",0,0,0,0,0,0,NA
"821330510","SANTA FE",16,0,4,9,0,13,0
"821330110","SANTA FE",0,0,0,0,0,0,NA
"820700520","SANTA FE",67,0,30,34,0,64,0
"820910305","SANTA FE",199,0,87,99,8,194,0
"820490210","SANTA FE",57,0,21,26,2,49,0
"820210324","SANTA FE",31,0,11,18,1,30,0
"820490318","SANTA FE",22,0,4,16,1,21,0
"820210306","SANTA FE",69,0,18,43,4,65,0
"820700205","SANTA FE",124,6,27,83,2,112,0.0483870967741935
"820140521","SANTA FE",5,0,2,3,0,5,0
"820421107","SANTA FE",34,0,23,11,0,34,0
"820842320","SANTA FE",191,189,2,0,0,2,0.989528795811518
"820630320","SANTA FE",2,0,1,1,0,2,0
"820140123","SANTA FE",6,0,1,5,0,6,0
"820910610","SANTA FE",430,1,327,76,13,416,0.00232558139534884
"062030801","BUENOS AIRES",12,0,0,11,0,11,0
"820070101","SANTA FE",77,0,31,46,0,77,0
"820420116","SANTA FE",96,0,53,42,1,96,0
"820420105","SANTA FE",35,0,20,12,1,33,0
"820350109","SANTA FE",77,0,32,44,0,76,0
"820280325","SANTA FE",38,0,13,25,0,38,0
"821330108","SANTA FE",24,0,1,16,2,19,0
"820630230","SANTA FE",28,0,13,12,1,26,0
"820490801","SANTA FE",138,0,85,43,6,134,0
"820700507","SANTA FE",62,0,13,49,0,62,0
"821120413","SANTA FE",591,76,111,373,7,491,0.128595600676819
"063711206","BUENOS AIRES",196,194,1,1,0,2,0.989795918367347
"820490804","SANTA FE",3,0,0,2,0,2,0
"820980115","SANTA FE",32,0,5,25,2,32,0
"820490813","SANTA FE",9,0,6,2,0,8,0
"821120404","SANTA FE",383,278,57,44,0,101,0.725848563968668
"820632820","SANTA FE",5,0,1,4,0,5,0
"820770102","SANTA FE",92,0,19,30,11,60,0
"820490812","SANTA FE",51,0,33,8,4,45,0
"820490325","SANTA FE",35,0,7,16,1,24,0
"820490324","SANTA FE",145,0,70,44,15,129,0
"820490205","SANTA FE",29,0,3,25,0,28,0
"820632702","SANTA FE",272,74,93,103,1,197,0.272058823529412
"820490115","SANTA FE",44,0,1,27,11,39,0
"820490104","SANTA FE",13,0,3,1,5,9,0
"820490314","SANTA FE",32,0,18,8,3,29,0
"820490114","SANTA FE",93,0,12,51,12,75,0
"820490113","SANTA FE",40,0,11,13,9,33,0
"068051204","BUENOS AIRES",266,14,198,54,0,252,0.0526315789473684
"821330517","SANTA FE",121,16,36,55,6,97,0.132231404958678
"821260306","SANTA FE",91,1,52,37,0,89,0.010989010989011
"821190713","SANTA FE",90,2,29,56,2,87,0.0222222222222222
"821260103","SANTA FE",123,31,50,40,2,92,0.252032520325203
"821190506","SANTA FE",69,0,34,33,0,67,0
"820910104","SANTA FE",138,0,40,79,5,124,0
"067562517","BUENOS AIRES",261,5,176,80,0,256,0.0191570881226054
"820700220","SANTA FE",162,38,57,63,0,120,0.234567901234568
"820560114","SANTA FE",80,0,58,22,0,80,0
"820210416","SANTA FE",925,47,422,440,6,868,0.0508108108108108
"820630116","SANTA FE",30,0,13,15,2,30,0
"820490806","SANTA FE",87,43,20,18,4,42,0.494252873563218
"820490403","SANTA FE",145,2,89,42,4,135,0.0137931034482759
"820844901","SANTA FE",158,67,29,47,5,81,0.424050632911392
"820844821","SANTA FE",553,28,56,428,10,494,0.0506329113924051
"820910502","SANTA FE",353,212,108,32,0,140,0.60056657223796
"020132103","CABA",233,233,0,0,0,0,1
"820280306","SANTA FE",418,273,65,73,4,142,0.65311004784689
"820420302","SANTA FE",169,21,60,81,0,141,0.124260355029586
"820420106","SANTA FE",57,1,16,38,1,55,0.0175438596491228
"820350207","SANTA FE",304,0,53,214,17,284,0
"820700711","SANTA FE",59,0,25,33,1,59,0
"821190407","SANTA FE",333,13,206,113,0,319,0.039039039039039
"063712213","BUENOS AIRES",213,210,1,2,0,3,0.985915492957746
"820490911","SANTA FE",104,0,82,15,4,101,0
"820842314","SANTA FE",285,285,0,0,0,0,1
"820846214","SANTA FE",238,46,99,91,0,190,0.19327731092437
"821190405","SANTA FE",70,60,10,0,0,10,0.857142857142857
"820280110","SANTA FE",81,0,50,31,0,81,0
"820490101","SANTA FE",434,4,214,145,25,384,0.00921658986175115
"821330630","SANTA FE",266,164,25,69,0,94,0.616541353383459
"821330618","SANTA FE",305,138,53,112,0,165,0.452459016393443
"820421111","SANTA FE",204,3,91,104,1,196,0.0147058823529412
"820211005","SANTA FE",52,0,30,20,1,51,0
"821330411","SANTA FE",248,185,42,10,0,52,0.745967741935484
"821330410","SANTA FE",410,53,192,151,2,345,0.129268292682927
"821330406","SANTA FE",297,5,86,184,1,271,0.0168350168350168
"821330402","SANTA FE",337,38,161,122,5,288,0.112759643916914
"821330401","SANTA FE",383,16,77,248,20,345,0.0417754569190601
"821260309","SANTA FE",356,98,86,165,2,253,0.275280898876405
"821260409","SANTA FE",517,344,94,73,4,171,0.665377176015474
"820980203","SANTA FE",228,0,92,97,33,222,0
"820210707","SANTA FE",290,0,156,124,3,283,0
"820980403","SANTA FE",231,0,163,67,0,230,0
"820630606","SANTA FE",257,167,33,53,3,89,0.649805447470817
"820846201","SANTA FE",232,11,64,127,19,210,0.0474137931034483
"821191014","SANTA FE",215,212,2,1,0,3,0.986046511627907
"062030303","BUENOS AIRES",8,0,6,1,0,7,0
"821050220","SANTA FE",225,162,30,29,1,60,0.72
"820910106","SANTA FE",108,0,81,17,4,102,0
"820848912","SANTA FE",715,13,109,579,4,692,0.0181818181818182
"820848911","SANTA FE",802,14,261,487,13,761,0.0174563591022444
"820848505","SANTA FE",242,232,5,5,0,10,0.958677685950413
"820848413","SANTA FE",483,263,28,158,9,195,0.544513457556936
"820848201","SANTA FE",472,81,134,234,4,372,0.171610169491525
"821190818","SANTA FE",251,184,42,25,0,67,0.733067729083665
"820847905","SANTA FE",313,1,172,134,4,310,0.00319488817891374
"821050503","SANTA FE",183,1,66,99,8,173,0.00546448087431694
"820847710","SANTA FE",338,301,10,22,1,33,0.890532544378698
"820847708","SANTA FE",356,326,16,13,0,29,0.915730337078652
"820847206","SANTA FE",252,198,15,39,0,54,0.785714285714286
"820846104","SANTA FE",325,8,44,241,1,286,0.0246153846153846
"820845909","SANTA FE",380,5,116,240,1,357,0.0131578947368421
"820845905","SANTA FE",444,1,86,328,2,416,0.00225225225225225
"820843304","SANTA FE",344,10,144,189,0,333,0.0290697674418605
"820843302","SANTA FE",339,61,29,246,0,275,0.179941002949853
"820841918","SANTA FE",330,329,1,0,0,1,0.996969696969697
"820700222","SANTA FE",346,245,43,56,1,100,0.708092485549133
"820700113","SANTA FE",37,0,23,14,0,37,0
"820843301","SANTA FE",309,67,45,193,0,238,0.216828478964401
"820842813","SANTA FE",234,234,0,0,0,0,1
"820840102","SANTA FE",447,3,301,138,1,440,0.00671140939597315
"820840204","SANTA FE",445,3,187,250,0,437,0.00674157303370787
"820770313","SANTA FE",390,69,169,133,5,307,0.176923076923077
"820700707","SANTA FE",308,152,68,84,1,153,0.493506493506494
"820632617","SANTA FE",446,108,67,267,0,334,0.242152466367713
"820632615","SANTA FE",272,198,13,46,0,59,0.727941176470588
"820630905","SANTA FE",237,229,5,3,0,8,0.966244725738397
"820842622","SANTA FE",169,169,0,0,0,0,1
"820842621","SANTA FE",331,329,2,0,0,2,0.993957703927492
"820631507","SANTA FE",285,245,10,30,0,40,0.859649122807018
"821190816","SANTA FE",334,4,166,139,18,323,0.0119760479041916
"821190417","SANTA FE",515,5,341,157,1,499,0.00970873786407767
"821120417","SANTA FE",217,161,18,38,0,56,0.741935483870968
"821050223","SANTA FE",213,153,36,24,0,60,0.71830985915493
"820490527","SANTA FE",512,444,37,25,0,62,0.8671875
"820490524","SANTA FE",449,304,68,68,5,141,0.677060133630289
"820490916","SANTA FE",295,192,75,27,0,102,0.650847457627119
"820070213","SANTA FE",246,189,19,35,2,56,0.768292682926829
"820070217","SANTA FE",249,123,31,90,0,121,0.493975903614458
"820070214","SANTA FE",232,164,30,36,0,66,0.706896551724138
"820846220","SANTA FE",252,122,63,60,2,125,0.484126984126984
"820842818","SANTA FE",209,209,0,0,0,0,1
"820700314","SANTA FE",342,229,66,46,0,112,0.669590643274854
"820844716","SANTA FE",511,410,5,84,4,93,0.802348336594912
"820700521","SANTA FE",184,159,6,18,0,24,0.864130434782609
"820844714","SANTA FE",233,167,9,53,0,62,0.716738197424893
"820842312","SANTA FE",320,314,6,0,0,6,0.98125
"820844707","SANTA FE",241,195,28,18,0,46,0.809128630705394
"820844706","SANTA FE",283,215,30,37,0,67,0.759717314487632
"820841908","SANTA FE",309,309,0,0,0,0,1
"820844602","SANTA FE",320,301,10,7,0,17,0.940625
"820844712","SANTA FE",236,199,10,25,1,36,0.843220338983051
"820844516","SANTA FE",316,76,32,190,3,225,0.240506329113924
"820844512","SANTA FE",327,313,5,9,0,14,0.957186544342508
"820844502","SANTA FE",176,155,3,18,0,21,0.880681818181818
"820844702","SANTA FE",241,193,13,33,0,46,0.800829875518672
"820844612","SANTA FE",210,144,14,52,0,66,0.685714285714286
"820490603","SANTA FE",480,449,12,9,0,21,0.935416666666667
"820844412","SANTA FE",264,262,1,1,0,2,0.992424242424242
"820844308","SANTA FE",165,164,0,1,0,1,0.993939393939394
"820844305","SANTA FE",234,232,2,0,0,2,0.991452991452991
"820633509","SANTA FE",307,305,2,0,0,2,0.993485342019544
"820844302","SANTA FE",206,202,3,1,0,4,0.980582524271845
"820844210","SANTA FE",361,339,6,14,0,20,0.939058171745152
"820844009","SANTA FE",282,256,6,11,2,19,0.907801418439716
"820844007","SANTA FE",268,268,0,0,0,0,1
"820843920","SANTA FE",216,215,0,1,0,1,0.99537037037037
"820980207","SANTA FE",419,2,201,194,16,411,0.00477326968973747
"820843807","SANTA FE",243,241,1,0,0,1,0.991769547325103
"820910612","SANTA FE",510,1,413,76,19,508,0.00196078431372549
"820843210","SANTA FE",338,213,33,78,0,111,0.630177514792899
"821190416","SANTA FE",308,1,190,106,3,299,0.00324675324675325
"820844212","SANTA FE",281,267,5,7,0,12,0.950177935943061
"820843716","SANTA FE",253,252,1,0,0,1,0.99604743083004
"820910109","SANTA FE",76,0,45,28,1,74,0
"820843310","SANTA FE",438,39,175,215,2,392,0.089041095890411
"820843206","SANTA FE",360,321,20,14,1,35,0.891666666666667
"820843710","SANTA FE",339,334,4,1,0,5,0.985250737463127
"820848810","SANTA FE",364,119,183,62,0,245,0.326923076923077
"820843707","SANTA FE",279,276,3,0,0,3,0.989247311827957
"820843202","SANTA FE",333,309,15,9,0,24,0.927927927927928
"820843702","SANTA FE",403,393,3,0,0,3,0.975186104218362
"820840619","SANTA FE",223,14,52,155,0,207,0.062780269058296
"820843211","SANTA FE",318,200,38,79,0,117,0.628930817610063
"820842308","SANTA FE",359,357,2,0,0,2,0.994428969359331
"820847002","SANTA FE",188,0,78,108,1,187,0
"820846502","SANTA FE",305,3,136,159,4,299,0.00983606557377049
"820842101","SANTA FE",272,271,0,0,0,0,0.996323529411765
"821190604","SANTA FE",297,2,155,138,1,294,0.00673400673400673
"820843903","SANTA FE",273,273,0,0,0,0,1
"820843813","SANTA FE",348,337,10,1,0,11,0.968390804597701
"821050218","SANTA FE",293,3,140,140,4,284,0.0102389078498294
"821050214","SANTA FE",421,1,264,143,5,412,0.00237529691211401
"820632111","SANTA FE",312,289,23,0,0,23,0.926282051282051
"821050111","SANTA FE",229,2,93,128,4,225,0.00873362445414847
"821050105","SANTA FE",299,2,168,127,2,297,0.00668896321070234
"820842812","SANTA FE",189,189,0,0,0,0,1
"820843214","SANTA FE",242,7,116,98,0,214,0.0289256198347107
"820843105","SANTA FE",172,155,11,6,0,17,0.901162790697674
"820843104","SANTA FE",292,256,22,14,0,36,0.876712328767123
"820841109","SANTA FE",19,1,10,8,0,18,0.0526315789473684
"820842913","SANTA FE",259,259,0,0,0,0,1
"820843201","SANTA FE",421,414,5,1,0,6,0.983372921615202
"820843121","SANTA FE",291,276,9,3,0,12,0.948453608247423
"820491015","SANTA FE",449,1,246,193,1,440,0.0022271714922049
"820842924","SANTA FE",281,279,0,0,0,0,0.99288256227758
"820490332","SANTA FE",335,229,57,44,1,102,0.683582089552239
"820842203","SANTA FE",237,229,0,0,0,0,0.966244725738397
"820842903","SANTA FE",323,321,1,0,0,1,0.993808049535604
"820842824","SANTA FE",285,283,1,0,0,1,0.992982456140351
"820842820","SANTA FE",282,282,0,0,0,0,1
"820560205","SANTA FE",389,382,4,2,0,6,0.982005141388175
"820842111","SANTA FE",248,246,2,0,0,2,0.991935483870968
"820842108","SANTA FE",258,255,1,0,0,1,0.988372093023256
"820842011","SANTA FE",228,226,2,0,0,2,0.991228070175439
"820842301","SANTA FE",289,272,0,0,0,0,0.941176470588235
"820210906","SANTA FE",255,246,3,6,0,9,0.964705882352941
"820842211","SANTA FE",325,319,0,0,0,0,0.981538461538462
"820210302","SANTA FE",545,1,335,190,6,531,0.0018348623853211
"820210301","SANTA FE",20,0,10,8,0,18,0
"820842205","SANTA FE",292,291,1,0,0,1,0.996575342465753
"820841409","SANTA FE",241,237,3,1,0,4,0.983402489626556
"820841719","SANTA FE",260,260,0,0,0,0,1
"820841612","SANTA FE",222,221,1,0,0,1,0.995495495495496
"820841609","SANTA FE",372,367,5,0,0,5,0.986559139784946
"820841606","SANTA FE",297,290,4,0,0,4,0.976430976430976
"820841403","SANTA FE",283,281,1,1,0,2,0.992932862190813
"820841311","SANTA FE",276,266,3,7,0,10,0.963768115942029
"820841310","SANTA FE",345,305,21,19,0,40,0.884057971014493
"820841216","SANTA FE",275,197,19,50,0,69,0.716363636363636
"820841713","SANTA FE",282,282,0,0,0,0,1
"820841708","SANTA FE",147,147,0,0,0,0,1
"820841706","SANTA FE",292,283,3,0,0,3,0.969178082191781
"820841703","SANTA FE",211,211,0,0,0,0,1
"820843614","SANTA FE",231,228,0,3,0,3,0.987012987012987
"820843611","SANTA FE",321,311,2,8,0,10,0.968847352024922
"820843509","SANTA FE",397,373,7,16,0,23,0.939546599496222
"820843507","SANTA FE",188,181,3,4,0,7,0.962765957446808
"820843503","SANTA FE",245,228,8,9,0,17,0.930612244897959
"820843501","SANTA FE",330,85,68,171,0,239,0.257575757575758
"820843419","SANTA FE",162,35,25,94,1,120,0.216049382716049
"820841108","SANTA FE",267,14,186,67,0,253,0.052434456928839
"820845201","SANTA FE",499,24,170,300,0,470,0.0480961923847695
"820845003","SANTA FE",321,213,62,44,1,107,0.663551401869159
"820844913","SANTA FE",384,9,96,260,3,359,0.0234375
"820842403","SANTA FE",174,173,0,0,0,0,0.994252873563218
"820843403","SANTA FE",139,73,47,18,0,65,0.525179856115108
"820845010","SANTA FE",206,20,116,67,0,183,0.0970873786407767
"820210815","SANTA FE",285,209,18,42,1,61,0.733333333333333
"820210513","SANTA FE",531,262,95,123,3,221,0.493408662900188
"820844818","SANTA FE",272,264,1,1,0,2,0.970588235294118
"820844910","SANTA FE",332,226,10,59,6,75,0.680722891566265
"820844816","SANTA FE",407,320,8,68,4,80,0.786240786240786
"820844814","SANTA FE",309,7,63,233,1,297,0.0226537216828479
"820844812","SANTA FE",302,8,158,136,0,294,0.0264900662251656
"820210311","SANTA FE",202,1,93,83,3,179,0.00495049504950495
"820210308","SANTA FE",91,0,53,36,0,89,0
"820210218","SANTA FE",379,334,18,20,2,40,0.881266490765171
"821190404","SANTA FE",311,2,200,107,0,307,0.00643086816720257
"820210204","SANTA FE",432,418,9,4,0,13,0.967592592592593
"820848813","SANTA FE",305,7,172,121,0,293,0.0229508196721311
"820210415","SANTA FE",331,325,2,4,0,6,0.981873111782477
"820630605","SANTA FE",226,90,18,118,0,136,0.398230088495575
"821050418","SANTA FE",263,233,6,22,0,28,0.885931558935361
"820848805","SANTA FE",302,24,162,114,1,277,0.0794701986754967
"820210134","SANTA FE",348,0,158,178,8,344,0
"820842405","SANTA FE",238,238,0,0,0,0,1
"820140610","SANTA FE",16,0,1,15,0,16,0
"820140607","SANTA FE",431,305,34,89,0,123,0.707656612529002
"820140605","SANTA FE",459,9,159,283,0,442,0.0196078431372549
"820848711","SANTA FE",228,159,36,32,0,68,0.697368421052632
"820140514","SANTA FE",326,0,211,108,2,321,0
"820845914","SANTA FE",304,1,207,96,0,303,0.00328947368421053
"820070409","SANTA FE",466,171,97,180,8,285,0.366952789699571
"820845910","SANTA FE",611,4,401,190,3,594,0.00654664484451719
"820770203","SANTA FE",334,1,174,126,28,328,0.0029940119760479
"820421109","SANTA FE",311,1,165,142,3,310,0.00321543408360129
"820070314","SANTA FE",243,166,51,26,0,77,0.683127572016461
"820421012","SANTA FE",313,207,56,45,0,101,0.661341853035144
"820140216","SANTA FE",211,210,0,1,0,1,0.995260663507109
"820140213","SANTA FE",203,202,0,0,0,0,0.995073891625616
"820421008","SANTA FE",418,8,178,207,5,390,0.0191387559808612
"820421001","SANTA FE",269,213,24,30,0,54,0.79182156133829
"060561008","BUENOS AIRES",325,323,1,0,0,1,0.993846153846154
"820420923","SANTA FE",518,400,63,47,2,112,0.772200772200772
"820420922","SANTA FE",417,214,69,127,2,198,0.513189448441247
"820420717","SANTA FE",408,0,189,202,6,397,0
"820420708","SANTA FE",251,247,3,1,0,4,0.98406374501992
"820420707","SANTA FE",391,380,5,6,0,11,0.971867007672634
"820420901","SANTA FE",444,101,158,176,5,339,0.227477477477477
"820848702","SANTA FE",274,254,14,4,0,18,0.927007299270073
"820420604","SANTA FE",382,234,42,104,2,148,0.612565445026178
"820420509","SANTA FE",193,19,67,100,2,169,0.0984455958549223
"820420506","SANTA FE",339,80,133,125,0,258,0.23598820058997
"820842618","SANTA FE",209,196,12,0,0,12,0.937799043062201
"820140217","SANTA FE",234,234,0,0,0,0,1
"820420401","SANTA FE",418,108,180,129,0,309,0.258373205741627
"063712309","BUENOS AIRES",271,270,1,0,0,1,0.996309963099631
"820420315","SANTA FE",304,3,164,118,13,295,0.00986842105263158
"820420312","SANTA FE",362,1,97,248,3,348,0.00276243093922652
"820070302","SANTA FE",396,323,46,19,1,66,0.815656565656566
"820842614","SANTA FE",300,296,4,0,0,4,0.986666666666667
"820420220","SANTA FE",336,2,259,75,0,334,0.00595238095238095
"820070204","SANTA FE",370,308,21,40,0,61,0.832432432432432
"820070103","SANTA FE",401,1,238,156,1,395,0.00249376558603491
"820280313","SANTA FE",158,1,70,86,0,156,0.00632911392405063
"820420123","SANTA FE",251,0,106,140,0,246,0
"820140116","SANTA FE",250,64,83,99,3,185,0.256
"820140105","SANTA FE",293,3,169,120,1,290,0.0102389078498294
"820140102","SANTA FE",419,2,183,222,3,408,0.00477326968973747
"820420122","SANTA FE",323,1,182,130,7,319,0.00309597523219814
"820631110","SANTA FE",554,27,127,374,11,512,0.0487364620938628
"820631108","SANTA FE",203,3,27,164,1,192,0.0147783251231527
"820842411","SANTA FE",178,177,0,1,0,1,0.99438202247191
"820631119","SANTA FE",242,9,43,179,7,229,0.0371900826446281
"820631008","SANTA FE",529,39,135,349,3,487,0.0737240075614367
"820630811","SANTA FE",273,263,4,6,0,10,0.963369963369963
"820630810","SANTA FE",303,296,4,3,0,7,0.976897689768977
"820630708","SANTA FE",248,247,1,0,0,1,0.995967741935484
"820350116","SANTA FE",144,0,74,67,1,142,0
"820280311","SANTA FE",276,2,156,110,0,266,0.0072463768115942
"820350113","SANTA FE",327,0,123,195,1,319,0
"820840507","SANTA FE",336,267,44,25,0,69,0.794642857142857
"820630508","SANTA FE",400,6,52,325,5,382,0.015
"820631001","SANTA FE",288,5,120,161,1,282,0.0173611111111111
"820280404","SANTA FE",379,273,42,61,0,103,0.720316622691293
"820840406","SANTA FE",348,292,37,19,0,56,0.839080459770115
"820840307","SANTA FE",620,176,352,91,0,443,0.283870967741935
"820840302","SANTA FE",395,31,57,299,1,357,0.0784810126582278
"820840210","SANTA FE",507,45,251,209,1,461,0.0887573964497041
"820770317","SANTA FE",282,23,171,72,9,252,0.0815602836879433
"820770315","SANTA FE",217,124,58,33,0,91,0.571428571428571
"820770307","SANTA FE",355,231,85,32,0,117,0.650704225352113
"820770306","SANTA FE",322,25,200,89,2,291,0.077639751552795
"820491019","SANTA FE",552,21,387,113,10,510,0.0380434782608696
"820280506","SANTA FE",553,531,5,15,1,21,0.960216998191682
"820280503","SANTA FE",296,289,4,3,0,7,0.976351351351351
"820280405","SANTA FE",368,203,30,126,1,157,0.551630434782609
"060561113","BUENOS AIRES",253,253,0,0,0,0,1
"820280401","SANTA FE",363,227,22,97,4,123,0.62534435261708
"821050230","SANTA FE",239,187,33,18,1,52,0.782426778242678
"821260512","SANTA FE",396,359,21,14,0,35,0.906565656565657
"820491011","SANTA FE",436,30,229,162,1,392,0.0688073394495413
"820491009","SANTA FE",361,26,234,98,0,332,0.07202216066482
"820491008","SANTA FE",387,0,235,148,0,383,0
"821190305","SANTA FE",231,229,1,0,0,1,0.991341991341991
"820280309","SANTA FE",729,9,435,275,2,712,0.0123456790123457
"820980408","SANTA FE",239,6,146,85,0,231,0.0251046025104603
"820980114","SANTA FE",395,41,185,163,0,348,0.10379746835443
"820700517","SANTA FE",302,273,15,14,0,29,0.903973509933775
"421051008","LA PAMPA",206,206,0,0,0,0,1
"821260411","SANTA FE",493,394,38,51,0,89,0.799188640973631
"821260317","SANTA FE",465,339,38,83,1,122,0.729032258064516
"820633307","SANTA FE",308,295,6,7,0,13,0.957792207792208
"820700511","SANTA FE",601,501,48,52,0,100,0.833610648918469
"820700510","SANTA FE",354,319,21,14,0,35,0.901129943502825
"820700509","SANTA FE",282,257,13,11,0,24,0.911347517730496
"820700508","SANTA FE",440,385,26,29,0,55,0.875
"820700503","SANTA FE",408,331,53,22,0,75,0.811274509803922
"820700413","SANTA FE",357,330,19,8,0,27,0.92436974789916
"820700411","SANTA FE",335,334,0,1,0,1,0.997014925373134
"820700401","SANTA FE",639,3,265,351,6,622,0.00469483568075117
"820633204","SANTA FE",253,1,76,168,2,246,0.00395256916996047
"820633201","SANTA FE",370,3,113,248,4,365,0.00810810810810811
"820490707","SANTA FE",510,200,153,148,2,303,0.392156862745098
"820848304","SANTA FE",356,291,29,36,0,65,0.817415730337079
"820633104","SANTA FE",677,15,401,256,1,658,0.0221565731166913
"820280220","SANTA FE",267,0,127,139,1,267,0
"820633009","SANTA FE",457,418,12,26,1,39,0.914660831509847
"820632915","SANTA FE",346,235,22,81,0,103,0.679190751445087
"820632911","SANTA FE",235,213,11,10,0,21,0.906382978723404
"821260318","SANTA FE",242,210,22,10,0,32,0.867768595041322
"820280302","SANTA FE",343,327,4,9,0,13,0.9533527696793
"820632910","SANTA FE",291,11,120,157,1,278,0.0378006872852234
"820633113","SANTA FE",373,251,60,60,0,120,0.672922252010724
"820070315","SANTA FE",323,50,107,159,0,266,0.154798761609907
"820632609","SANTA FE",392,365,11,12,0,23,0.931122448979592
"820632606","SANTA FE",277,94,62,115,4,181,0.339350180505415
"820632605","SANTA FE",372,15,76,270,5,351,0.0403225806451613
"820632602","SANTA FE",340,15,85,221,5,311,0.0441176470588235
"820632511","SANTA FE",252,156,51,43,0,94,0.619047619047619
"820632412","SANTA FE",259,255,2,0,0,2,0.984555984555985
"820632411","SANTA FE",244,243,1,0,0,1,0.995901639344262
"820840808","SANTA FE",337,332,4,0,0,4,0.985163204747775
"820700716","SANTA FE",273,157,36,63,0,99,0.575091575091575
"820632309","SANTA FE",298,298,0,0,0,0,1
"820840802","SANTA FE",314,313,1,0,0,1,0.996815286624204
"064340204","BUENOS AIRES",217,175,14,28,0,42,0.806451612903226
"820632304","SANTA FE",329,328,1,0,0,1,0.996960486322188
"820632212","SANTA FE",249,249,0,0,0,0,1
"820632211","SANTA FE",168,167,1,0,0,1,0.994047619047619
"820632203","SANTA FE",194,191,2,0,0,2,0.984536082474227
"820632102","SANTA FE",347,346,1,0,0,1,0.997118155619596
"820632011","SANTA FE",274,218,16,40,0,56,0.795620437956204
"820630122","SANTA FE",349,0,226,121,1,348,0
"820631904","SANTA FE",188,186,0,0,0,0,0.98936170212766
"820631810","SANTA FE",265,252,13,0,0,13,0.950943396226415
"820631705","SANTA FE",351,341,2,3,0,5,0.971509971509972
"820631601","SANTA FE",304,300,2,2,0,4,0.986842105263158
"820631502","SANTA FE",285,283,1,1,0,2,0.992982456140351
"820631611","SANTA FE",243,235,3,5,0,8,0.967078189300412
"820631403","SANTA FE",374,335,11,3,0,14,0.89572192513369
"820631309","SANTA FE",484,26,108,324,1,433,0.0537190082644628
"820280123","SANTA FE",204,6,77,117,3,197,0.0294117647058824
"820490117","SANTA FE",378,269,61,47,1,109,0.711640211640212
"820840720","SANTA FE",329,289,30,10,0,40,0.878419452887538
"820700612","SANTA FE",475,3,238,228,3,469,0.00631578947368421
"820840719","SANTA FE",269,268,1,0,0,1,0.996282527881041
"820840717","SANTA FE",348,248,26,65,1,92,0.71264367816092
"820840714","SANTA FE",279,238,30,11,0,41,0.853046594982079
"820840613","SANTA FE",386,10,167,208,0,375,0.0259067357512953
"820848113","SANTA FE",235,217,8,10,0,18,0.923404255319149
"820560515","SANTA FE",225,222,2,1,0,3,0.986666666666667
"820848121","SANTA FE",218,170,19,28,1,48,0.779816513761468
"820560411","SANTA FE",317,307,6,3,0,9,0.968454258675079
"820560512","SANTA FE",305,267,12,15,0,27,0.875409836065574
"820560406","SANTA FE",292,292,0,0,0,0,1
"820560304","SANTA FE",224,120,78,24,1,103,0.535714285714286
"820560303","SANTA FE",527,172,113,230,2,345,0.326375711574953
"820560414","SANTA FE",506,459,12,29,1,42,0.907114624505929
"820848018","SANTA FE",223,221,1,1,0,2,0.991031390134529
"820980407","SANTA FE",297,277,8,12,0,20,0.932659932659933
"820848020","SANTA FE",317,282,4,0,0,4,0.889589905362776
"820560210","SANTA FE",317,258,30,23,2,55,0.813880126182965
"820845709","SANTA FE",135,0,95,39,0,134,0
"820910311","SANTA FE",185,93,70,19,2,91,0.502702702702703
"820845602","SANTA FE",8,7,1,0,0,1,0.875
"820845504","SANTA FE",323,205,64,53,0,117,0.634674922600619
"820846216","SANTA FE",357,12,155,184,1,340,0.0336134453781513
"820845405","SANTA FE",228,134,60,34,0,94,0.587719298245614
"820841106","SANTA FE",319,19,209,89,1,299,0.0595611285266458
"820841104","SANTA FE",233,16,155,62,0,217,0.0686695278969957
"820841018","SANTA FE",538,76,177,276,0,453,0.141263940520446
"820841002","SANTA FE",513,42,79,350,11,440,0.0818713450292398
"820849013","SANTA FE",243,4,151,86,0,237,0.0164609053497942
"821190704","SANTA FE",331,25,130,171,2,303,0.0755287009063444
"821190518","SANTA FE",211,0,121,89,0,210,0
"821190703","SANTA FE",372,50,125,192,2,319,0.134408602150538
"821190614","SANTA FE",326,2,130,188,0,318,0.00613496932515337
"820421214","SANTA FE",394,1,269,121,1,391,0.00253807106598985
"420210801","LA PAMPA",170,169,1,0,0,1,0.994117647058824
"820421210","SANTA FE",477,3,214,241,2,457,0.00628930817610063
"821190516","SANTA FE",119,1,88,30,0,118,0.00840336134453781
"820280113","SANTA FE",360,2,134,222,1,357,0.00555555555555556
"820847722","SANTA FE",295,290,3,1,0,4,0.983050847457627
"820980406","SANTA FE",245,0,144,94,0,238,0
"820846305","SANTA FE",235,2,100,131,0,231,0.00851063829787234
"820842611","SANTA FE",187,187,0,0,0,0,1
"820849006","SANTA FE",99,0,79,20,0,99,0
"820848902","SANTA FE",434,7,155,258,1,414,0.0161290322580645
"820846210","SANTA FE",378,5,74,277,9,360,0.0132275132275132
"820842916","SANTA FE",186,186,0,0,0,0,1
"820211008","SANTA FE",439,1,383,53,0,436,0.00227790432801822
"820210904","SANTA FE",519,461,32,25,0,57,0.888246628131021
"820210811","SANTA FE",368,360,4,2,0,6,0.978260869565217
"820210709","SANTA FE",34,0,15,16,2,33,0
"820210704","SANTA FE",51,0,20,30,1,51,0
"821190412","SANTA FE",297,3,214,80,0,294,0.0101010101010101
"821330626","SANTA FE",18,0,2,15,1,18,0
"821330625","SANTA FE",9,0,2,7,0,9,0
"821330611","SANTA FE",8,0,1,7,0,8,0
"821330519","SANTA FE",0,0,0,0,0,0,NA
"820700108","SANTA FE",234,0,121,106,6,233,0
"821330309","SANTA FE",15,0,6,4,0,10,0
"820844110","SANTA FE",408,298,13,88,2,103,0.730392156862745
"820631407","SANTA FE",280,277,2,1,0,3,0.989285714285714
"821330532","SANTA FE",12,0,2,8,1,11,0
"821330514","SANTA FE",39,4,6,16,7,29,0.102564102564103
"821330306","SANTA FE",1,0,1,0,0,1,0
"821330525","SANTA FE",41,0,9,22,1,32,0
"821330531","SANTA FE",13,0,3,10,0,13,0
"821330216","SANTA FE",26,0,6,11,9,26,0
"820700103","SANTA FE",33,0,20,12,0,32,0
"820842708","SANTA FE",296,294,2,0,0,2,0.993243243243243
"821330208","SANTA FE",5,0,0,4,1,5,0
"821260403","SANTA FE",64,0,33,31,0,64,0
"821260402","SANTA FE",74,0,34,36,2,72,0
"820630117","SANTA FE",33,0,8,23,1,32,0
"820841801","SANTA FE",417,416,0,0,0,0,0.997601918465228
"820843906","SANTA FE",307,306,1,0,0,1,0.996742671009772
"821260204","SANTA FE",80,6,46,28,0,74,0.075
"821190606","SANTA FE",226,192,6,26,0,32,0.849557522123894
"820910415","SANTA FE",81,0,25,46,7,78,0
"820770406","SANTA FE",15,0,11,4,0,15,0
"821190605","SANTA FE",18,0,3,14,0,17,0
"820700304","SANTA FE",179,64,60,44,5,109,0.357541899441341
"820770301","SANTA FE",144,0,36,86,12,134,0
"821330109","SANTA FE",3,0,0,0,2,2,0
"821330101","SANTA FE",22,0,0,9,0,9,0
"820630229","SANTA FE",25,0,1,19,3,23,0
"820630228","SANTA FE",93,1,28,56,3,87,0.010752688172043
"821190115","SANTA FE",40,0,17,22,1,40,0
"821190315","SANTA FE",27,0,4,22,0,26,0
"821330521","SANTA FE",0,0,0,0,0,0,NA
"820770205","SANTA FE",62,0,19,43,0,62,0
"821260101","SANTA FE",210,0,153,42,8,203,0
"821120213","SANTA FE",57,1,17,36,1,54,0.0175438596491228
"820910511","SANTA FE",141,0,82,42,10,134,0
"820560215","SANTA FE",478,444,9,23,1,33,0.928870292887029
"820700208","SANTA FE",110,0,55,51,1,107,0
"820421104","SANTA FE",20,0,9,10,0,19,0
"821260308","SANTA FE",185,3,66,97,8,171,0.0162162162162162
"820700116","SANTA FE",47,0,9,37,0,46,0
"820140417","SANTA FE",56,0,13,42,0,55,0
"820490601","SANTA FE",256,241,2,10,0,12,0.94140625
"820700112","SANTA FE",79,0,32,36,5,73,0
"820210130","SANTA FE",60,0,20,39,1,60,0
"820630304","SANTA FE",1,0,0,0,1,1,0
"820210121","SANTA FE",53,0,13,39,1,53,0
"820700605","SANTA FE",245,0,124,109,6,239,0
"820560313","SANTA FE",102,0,32,63,5,100,0
"820490520","SANTA FE",1,0,0,1,0,1,0
"820420211","SANTA FE",107,2,41,61,2,104,0.0186915887850467
"820490523","SANTA FE",607,403,42,104,6,152,0.663920922570016
"060561207","BUENOS AIRES",203,203,0,0,0,0,1
"820490415","SANTA FE",67,0,28,18,13,59,0
"820420204","SANTA FE",83,0,26,48,1,75,0
"820350206","SANTA FE",128,0,46,71,6,123,0
"820842601","SANTA FE",282,281,0,0,0,0,0.99645390070922
"820070309","SANTA FE",84,0,35,45,1,81,0
"820980205","SANTA FE",166,0,34,93,30,157,0
"820211010","SANTA FE",16,0,6,10,0,16,0
"820210129","SANTA FE",39,0,21,17,1,39,0
"821330529","SANTA FE",10,0,0,10,0,10,0
"820770104","SANTA FE",138,0,16,75,13,104,0
"820490816","SANTA FE",19,0,5,7,4,16,0
"820490815","SANTA FE",44,0,10,26,4,40,0
"820490322","SANTA FE",23,0,8,5,4,17,0
"820847207","SANTA FE",345,292,17,34,0,51,0.846376811594203
"820490604","SANTA FE",476,465,2,9,0,11,0.976890756302521
"820490212","SANTA FE",25,0,2,20,3,25,0
"820700516","SANTA FE",51,0,12,37,2,51,0
"820490501","SANTA FE",23,0,4,8,4,16,0
"820700602","SANTA FE",98,1,34,59,0,93,0.0102040816326531
"820910414","SANTA FE",44,0,20,21,1,42,0
"820490207","SANTA FE",11,0,1,6,2,9,0
"820490204","SANTA FE",4,0,0,4,0,4,0
"820490126","SANTA FE",71,0,6,40,12,58,0
"820700709","SANTA FE",106,3,31,68,3,102,0.0283018867924528
"821260112","SANTA FE",93,2,55,27,1,83,0.021505376344086
"821199402","SANTA FE",5,0,0,5,0,5,0
"820910206","SANTA FE",134,0,54,73,0,127,0
"820280202","SANTA FE",44,0,8,32,0,40,0
"820420419","SANTA FE",273,270,3,0,0,3,0.989010989010989
"820490106","SANTA FE",31,0,4,17,4,25,0
"820845715","SANTA FE",16,0,5,7,2,14,0
"820490313","SANTA FE",117,2,33,31,12,76,0.0170940170940171
"820210715","SANTA FE",29,0,11,16,0,27,0
"820210702","SANTA FE",530,8,336,159,9,504,0.0150943396226415
"821330303","SANTA FE",59,0,19,31,6,56,0
"821260407","SANTA FE",205,108,49,45,2,96,0.526829268292683
"821190504","SANTA FE",81,1,41,39,0,80,0.0123456790123457
"821190101","SANTA FE",186,1,93,85,3,181,0.00537634408602151
"820847903","SANTA FE",31,1,7,19,0,26,0.032258064516129
"820630312","SANTA FE",470,6,223,209,16,448,0.0127659574468085
"821050507","SANTA FE",138,0,34,70,3,107,0
"820846601","SANTA FE",298,137,55,99,4,158,0.459731543624161
"820700302","SANTA FE",113,0,59,51,0,110,0
"820630315","SANTA FE",254,2,57,173,6,236,0.0078740157480315
"820630220","SANTA FE",307,21,93,186,2,281,0.0684039087947883
"821191003","SANTA FE",235,235,0,0,0,0,1
"820560213","SANTA FE",99,0,50,43,3,96,0
"820289201","SANTA FE",50,1,27,21,1,49,0.02
"820843907","SANTA FE",346,344,2,0,0,2,0.994219653179191
"820490510","SANTA FE",804,146,299,322,13,634,0.181592039800995
"820980311","SANTA FE",497,226,115,128,4,247,0.454728370221328
"820700523","SANTA FE",474,410,22,41,0,63,0.864978902953586
"820140415","SANTA FE",97,3,23,70,1,94,0.0309278350515464
"820210327","SANTA FE",184,2,87,92,0,179,0.0108695652173913
"820700308","SANTA FE",328,314,12,2,0,14,0.957317073170732
"820420110","SANTA FE",158,3,81,71,1,153,0.0189873417721519
"820842316","SANTA FE",242,240,2,0,0,2,0.991735537190083
"820490905","SANTA FE",104,0,50,46,2,98,0
"820490904","SANTA FE",93,1,24,58,4,86,0.010752688172043
"820490110","SANTA FE",216,2,136,58,12,206,0.00925925925925926
"820210712","SANTA FE",311,0,264,45,0,309,0
"821190409","SANTA FE",491,2,322,163,0,485,0.00407331975560081
"820280111","SANTA FE",50,0,19,30,0,49,0
"821330621","SANTA FE",289,267,8,10,1,19,0.923875432525952
"821330605","SANTA FE",419,78,124,188,5,317,0.186157517899761
"821330505","SANTA FE",65,4,4,43,7,54,0.0615384615384615
"821330405","SANTA FE",349,266,58,15,1,74,0.762177650429799
"821330404","SANTA FE",375,128,129,105,7,241,0.341333333333333
"821260110","SANTA FE",280,210,49,14,3,66,0.75
"821260107","SANTA FE",337,141,83,93,8,184,0.41839762611276
"821260102","SANTA FE",78,0,46,18,4,68,0
"821191009","SANTA FE",258,256,1,0,0,1,0.992248062015504
"821191001","SANTA FE",234,234,0,0,0,0,1
"821190913","SANTA FE",503,336,31,111,1,143,0.667992047713718
"821050112","SANTA FE",279,1,142,128,5,275,0.003584229390681
"821050102","SANTA FE",188,5,76,98,4,178,0.0265957446808511
"820980401","SANTA FE",342,3,138,188,5,331,0.0087719298245614
"820910505","SANTA FE",662,185,324,124,17,465,0.279456193353474
"821120407","SANTA FE",340,83,101,148,0,249,0.244117647058824
"820848907","SANTA FE",271,9,100,159,0,259,0.033210332103321
"820848506","SANTA FE",221,211,6,3,0,9,0.95475113122172
"820848207","SANTA FE",370,370,0,0,0,0,1
"820848206","SANTA FE",324,319,4,1,0,5,0.984567901234568
"820848205","SANTA FE",326,326,0,0,0,0,1
"820848004","SANTA FE",349,349,0,0,0,0,1
"820848009","SANTA FE",367,364,3,0,0,3,0.991825613079019
"820847712","SANTA FE",354,171,67,112,1,180,0.483050847457627
"820847709","SANTA FE",326,295,10,16,0,26,0.904907975460123
"820700306","SANTA FE",245,225,10,10,0,20,0.918367346938776
"065320107","BUENOS AIRES",246,244,1,1,0,2,0.991869918699187
"820846312","SANTA FE",264,2,15,227,1,243,0.00757575757575758
"820845908","SANTA FE",267,4,135,125,0,260,0.0149812734082397
"820845904","SANTA FE",549,4,127,380,3,510,0.00728597449908925
"820845517","SANTA FE",252,193,29,26,1,56,0.765873015873016
"820845304","SANTA FE",376,109,54,199,5,258,0.289893617021277
"820845303","SANTA FE",336,299,3,4,0,7,0.889880952380952
"820848012","SANTA FE",188,186,1,0,0,1,0.98936170212766
"820843308","SANTA FE",256,156,54,46,0,100,0.609375
"820840403","SANTA FE",345,315,24,6,0,30,0.91304347826087
"820840402","SANTA FE",253,206,29,18,0,47,0.814229249011858
"820700703","SANTA FE",281,181,33,67,0,100,0.644128113879004
"820632613","SANTA FE",617,205,54,340,2,396,0.3322528363047
"820630402","SANTA FE",378,374,4,0,0,4,0.989417989417989
"820630401","SANTA FE",19,1,0,10,7,17,0.0526315789473684
"821190901","SANTA FE",30,1,0,24,1,25,0.0333333333333333
"821190801","SANTA FE",330,6,174,147,0,321,0.0181818181818182
"821191011","SANTA FE",299,297,2,0,0,2,0.993311036789298
"821190121","SANTA FE",563,159,148,235,1,384,0.282415630550622
"821190111","SANTA FE",266,1,168,94,2,264,0.0037593984962406
"821190106","SANTA FE",399,335,37,24,0,61,0.839598997493734
"821190104","SANTA FE",264,199,27,37,1,65,0.753787878787879
"821120311","SANTA FE",304,4,171,128,1,300,0.0131578947368421
"821050118","SANTA FE",248,0,135,112,0,247,0
"820490511","SANTA FE",340,250,16,69,1,86,0.735294117647059
"067910411","BUENOS AIRES",224,222,2,0,0,2,0.991071428571429
"820280211","SANTA FE",342,5,171,163,1,335,0.0146198830409357
"820490613","SANTA FE",309,307,2,0,0,2,0.993527508090615
"820070310","SANTA FE",488,144,242,96,0,338,0.295081967213115
"820490610","SANTA FE",381,376,1,2,0,3,0.986876640419947
"820845406","SANTA FE",128,13,8,82,15,105,0.1015625
"820700211","SANTA FE",152,0,112,39,0,151,0
"820632415","SANTA FE",222,221,0,0,0,0,0.995495495495496
"820632907","SANTA FE",255,5,148,100,0,248,0.0196078431372549
"820632904","SANTA FE",431,377,18,36,0,54,0.874709976798144
"820632901","SANTA FE",519,117,221,163,4,388,0.225433526011561
"020131407","CABA",165,165,0,0,0,0,1
"820632806","SANTA FE",567,389,83,91,0,174,0.686067019400353
"820632802","SANTA FE",374,298,47,28,0,75,0.796791443850267
"820845205","SANTA FE",363,186,72,98,3,173,0.512396694214876
"820844519","SANTA FE",320,291,15,13,0,28,0.909375
"820844515","SANTA FE",258,216,18,24,0,42,0.837209302325581
"820841903","SANTA FE",359,359,0,0,0,0,1
"820844503","SANTA FE",367,349,16,2,0,18,0.950953678474114
"820844604","SANTA FE",319,310,4,4,0,8,0.971786833855799
"820844417","SANTA FE",279,259,13,6,1,20,0.92831541218638
"820841704","SANTA FE",278,262,4,0,0,4,0.942446043165468
"820844303","SANTA FE",247,240,6,1,0,7,0.97165991902834
"820844301","SANTA FE",255,255,0,0,0,0,1
"820844203","SANTA FE",124,36,3,54,5,62,0.290322580645161
"820844201","SANTA FE",183,172,9,2,0,11,0.939890710382514
"820844104","SANTA FE",288,266,11,11,0,22,0.923611111111111
"820844004","SANTA FE",328,258,14,46,6,66,0.786585365853659
"820843917","SANTA FE",187,187,0,0,0,0,1
"820910614","SANTA FE",241,110,112,17,2,131,0.45643153526971
"820910613","SANTA FE",199,0,137,47,9,193,0
"820843212","SANTA FE",393,151,97,141,1,239,0.384223918575064
"820843805","SANTA FE",284,281,3,0,0,3,0.98943661971831
"820910409","SANTA FE",148,0,96,50,2,148,0
"820910207","SANTA FE",105,0,13,75,12,100,0
"820843802","SANTA FE",309,306,3,0,0,3,0.990291262135922
"820910107","SANTA FE",253,2,204,28,13,245,0.00790513833992095
"820848906","SANTA FE",236,9,119,108,0,227,0.038135593220339
"820843709","SANTA FE",220,220,0,0,0,0,1
"820843705","SANTA FE",264,243,1,0,0,1,0.920454545454545
"820843114","SANTA FE",270,233,21,16,0,37,0.862962962962963
"821190209","SANTA FE",239,234,2,2,0,4,0.97907949790795
"820843314","SANTA FE",290,11,89,184,1,274,0.0379310344827586
"821120105","SANTA FE",290,132,25,123,2,150,0.455172413793103
"821050310","SANTA FE",489,71,197,174,26,397,0.14519427402863
"821050212","SANTA FE",295,171,64,57,1,122,0.579661016949153
"820980315","SANTA FE",101,0,37,54,5,96,0
"820842415","SANTA FE",226,224,2,0,0,2,0.991150442477876
"820843013","SANTA FE",242,6,59,170,2,231,0.0247933884297521
"820840416","SANTA FE",116,100,14,2,0,16,0.862068965517241
"820840404","SANTA FE",321,279,24,17,0,41,0.869158878504673
"820843001","SANTA FE",259,142,21,93,0,114,0.548262548262548
"820633506","SANTA FE",324,323,1,0,0,1,0.996913580246914
"820842914","SANTA FE",300,299,1,0,0,1,0.996666666666667
"820842106","SANTA FE",43,43,0,0,0,0,1
"820845511","SANTA FE",293,196,12,79,1,92,0.668941979522184
"820770316","SANTA FE",308,2,153,139,5,297,0.00649350649350649
"820770302","SANTA FE",287,5,101,153,16,270,0.0174216027874564
"820490119","SANTA FE",296,1,192,89,2,283,0.00337837837837838
"820842513","SANTA FE",334,329,1,0,0,1,0.985029940119761
"820420924","SANTA FE",232,231,1,0,0,1,0.995689655172414
"820140411","SANTA FE",327,166,52,109,0,161,0.507645259938838
"820632004","SANTA FE",0,0,0,0,0,0,NA
"820842823","SANTA FE",157,155,2,0,0,2,0.987261146496815
"820630404","SANTA FE",372,371,1,0,0,1,0.997311827956989
"820842819","SANTA FE",223,223,0,0,0,0,1
"820842805","SANTA FE",107,107,0,0,0,0,1
"820630225","SANTA FE",195,1,74,117,0,191,0.00512820512820513
"820842718","SANTA FE",157,157,0,0,0,0,1
"820140205","SANTA FE",297,293,0,4,0,4,0.986531986531986
"820842006","SANTA FE",240,240,0,0,0,0,1
"820070405","SANTA FE",275,253,20,2,0,22,0.92
"820070301","SANTA FE",302,221,27,52,0,79,0.731788079470199
"820842110","SANTA FE",249,249,0,0,0,0,1
"820842109","SANTA FE",247,238,0,0,0,0,0.963562753036437
"820841804","SANTA FE",444,444,0,0,0,0,1
"820841803","SANTA FE",173,172,1,0,0,1,0.994219653179191
"820420316","SANTA FE",440,6,268,153,8,429,0.0136363636363636
"820842417","SANTA FE",114,113,1,0,0,1,0.991228070175439
"820350117","SANTA FE",275,0,131,132,0,263,0
"820842303","SANTA FE",300,300,0,0,0,0,1
"820280502","SANTA FE",238,201,12,25,0,37,0.84453781512605
"820842210","SANTA FE",385,383,2,0,0,2,0.994805194805195
"820841717","SANTA FE",177,176,0,0,0,0,0.994350282485876
"820841604","SANTA FE",299,290,5,4,0,9,0.969899665551839
"820841507","SANTA FE",204,200,3,1,0,4,0.980392156862745
"820841314","SANTA FE",281,187,18,71,0,89,0.665480427046263
"820841308","SANTA FE",308,207,18,80,1,99,0.672077922077922
"820841707","SANTA FE",250,249,1,0,0,1,0.996
"820841407","SANTA FE",291,287,3,1,0,4,0.986254295532646
"820841212","SANTA FE",267,102,57,108,0,165,0.382022471910112
"062100109","BUENOS AIRES",174,172,1,1,0,2,0.988505747126437
"820843511","SANTA FE",395,109,78,197,6,281,0.275949367088608
"820841206","SANTA FE",461,203,33,191,14,238,0.440347071583514
"820843618","SANTA FE",202,202,0,0,0,0,1
"820841302","SANTA FE",574,402,30,117,3,150,0.700348432055749
"820841217","SANTA FE",281,172,29,75,0,104,0.612099644128114
"820841115","SANTA FE",214,23,113,78,0,191,0.107476635514019
"820843616","SANTA FE",382,374,8,0,0,8,0.979057591623037
"820843613","SANTA FE",292,284,1,6,0,7,0.972602739726027
"820843409","SANTA FE",368,350,2,12,0,14,0.951086956521739
"820490609","SANTA FE",128,118,2,5,0,7,0.921875
"820841112","SANTA FE",300,25,235,38,0,273,0.0833333333333333
"820841111","SANTA FE",371,40,272,58,0,330,0.107816711590297
"820843517","SANTA FE",721,142,41,499,2,542,0.196948682385576
"820845105","SANTA FE",302,298,4,0,0,4,0.986754966887417
"820845011","SANTA FE",366,66,72,223,0,295,0.180327868852459
"820210615","SANTA FE",133,14,72,47,0,119,0.105263157894737
"820210612","SANTA FE",403,340,21,35,0,56,0.843672456575682
"820210606","SANTA FE",329,318,8,3,0,11,0.966565349544073
"820210508","SANTA FE",365,357,1,6,0,7,0.978082191780822
"820844811","SANTA FE",473,176,70,224,3,297,0.372093023255814
"820210208","SANTA FE",368,363,3,2,0,5,0.986413043478261
"820210125","SANTA FE",25,0,6,9,9,24,0
"820210315","SANTA FE",65,0,24,40,0,64,0
"820210133","SANTA FE",360,0,193,146,15,354,0
"820700502","SANTA FE",198,165,18,13,1,32,0.833333333333333
"821190403","SANTA FE",357,7,192,154,3,349,0.0196078431372549
"820630703","SANTA FE",200,194,5,1,0,6,0.97
"820848817","SANTA FE",295,3,79,188,3,270,0.0101694915254237
"820848803","SANTA FE",272,8,167,79,0,246,0.0294117647058824
"820210103","SANTA FE",426,119,113,160,23,296,0.279342723004695
"820140609","SANTA FE",403,30,139,221,0,360,0.0744416873449131
"820140601","SANTA FE",765,61,179,466,10,655,0.0797385620915033
"820848709","SANTA FE",328,305,16,7,0,23,0.929878048780488
"820140511","SANTA FE",328,85,123,114,0,237,0.259146341463415
"820845913","SANTA FE",267,0,229,37,1,267,0
"820848707","SANTA FE",452,411,3,35,0,38,0.90929203539823
"820490518","SANTA FE",309,230,38,36,0,74,0.744336569579288
"820421105","SANTA FE",332,1,125,206,0,331,0.00301204819277108
"820630609","SANTA FE",442,417,8,12,2,22,0.943438914027149
"821050415","SANTA FE",284,217,8,57,0,65,0.764084507042254
"820421011","SANTA FE",684,434,88,143,5,236,0.634502923976608
"820140130","SANTA FE",266,112,65,88,0,153,0.421052631578947
"820420909","SANTA FE",408,406,2,0,0,2,0.995098039215686
"820420908","SANTA FE",253,250,2,1,0,3,0.988142292490119
"820420809","SANTA FE",333,330,1,2,0,3,0.990990990990991
"820420720","SANTA FE",235,45,97,90,0,187,0.191489361702128
"820420621","SANTA FE",246,157,24,60,1,85,0.638211382113821
"820420609","SANTA FE",124,120,2,2,0,4,0.967741935483871
"820420504","SANTA FE",188,41,103,44,0,147,0.218085106382979
"820420503","SANTA FE",459,11,243,198,2,443,0.0239651416122004
"064411615","BUENOS AIRES",89,89,0,0,0,0,1
"820140306","SANTA FE",94,18,28,47,0,75,0.191489361702128
"820140117","SANTA FE",278,2,197,72,5,274,0.00719424460431655
"820140218","SANTA FE",398,385,2,8,0,10,0.967336683417085
"820420501","SANTA FE",422,66,160,193,1,354,0.156398104265403
"820420417","SANTA FE",477,106,200,171,0,371,0.222222222222222
"820420615","SANTA FE",99,95,1,3,0,4,0.95959595959596
"820420611","SANTA FE",350,340,8,2,0,10,0.971428571428571
"820848604","SANTA FE",336,241,28,63,0,91,0.717261904761905
"820420311","SANTA FE",284,1,109,167,1,277,0.00352112676056338
"820842414","SANTA FE",182,182,0,0,0,0,1
"820848515","SANTA FE",278,200,26,43,1,70,0.719424460431655
"065683109","BUENOS AIRES",328,7,173,142,4,319,0.0213414634146341
"821050407","SANTA FE",389,365,5,17,1,23,0.938303341902314
"820631308","SANTA FE",245,6,81,152,2,235,0.0244897959183673
"820420214","SANTA FE",407,4,189,205,3,397,0.00982800982800983
"820420319","SANTA FE",178,0,130,43,3,176,0
"820840604","SANTA FE",468,137,117,204,3,324,0.292735042735043
"820350213","SANTA FE",311,0,120,173,7,300,0
"820631109","SANTA FE",255,1,55,192,1,248,0.00392156862745098
"820070408","SANTA FE",335,206,63,59,3,125,0.614925373134328
"820631202","SANTA FE",229,7,125,93,2,220,0.0305676855895196
"820070407","SANTA FE",361,193,38,115,8,161,0.534626038781163
"820631118","SANTA FE",301,9,69,204,9,282,0.0299003322259136
"020022402","CABA",377,377,0,0,0,0,1
"820420207","SANTA FE",247,4,143,100,0,243,0.0161943319838057
"821050315","SANTA FE",141,4,45,74,11,130,0.0283687943262411
"820842324","SANTA FE",190,190,0,0,0,0,1
"820630902","SANTA FE",251,237,6,8,0,14,0.944223107569721
"820840707","SANTA FE",301,183,25,80,0,105,0.60797342192691
"820840510","SANTA FE",246,201,32,13,0,45,0.817073170731707
"820630614","SANTA FE",331,317,7,6,0,13,0.957703927492447
"820848403","SANTA FE",491,11,346,130,1,477,0.0224032586558045
"820840305","SANTA FE",472,17,197,250,0,447,0.0360169491525424
"820848402","SANTA FE",342,30,153,151,2,306,0.087719298245614
"820630503","SANTA FE",400,12,147,222,3,372,0.03
"820770308","SANTA FE",419,0,89,270,27,386,0
"063574311","BUENOS AIRES",81,81,0,0,0,0,1
"820770303","SANTA FE",405,22,136,200,18,354,0.054320987654321
"820560104","SANTA FE",213,2,162,49,0,211,0.00938967136150235
"821330417","SANTA FE",374,88,141,118,2,261,0.235294117647059
"820491017","SANTA FE",527,2,294,219,10,523,0.00379506641366224
"820280513","SANTA FE",415,404,6,5,0,11,0.973493975903614
"820280507","SANTA FE",309,293,9,7,0,16,0.948220064724919
"820630310","SANTA FE",417,2,144,265,4,413,0.00479616306954436
"821050225","SANTA FE",141,117,11,13,0,24,0.829787234042553
"821260517","SANTA FE",411,400,9,2,0,11,0.97323600973236
"821260513","SANTA FE",268,231,10,27,0,37,0.861940298507463
"820848309","SANTA FE",203,170,22,7,0,29,0.83743842364532
"020030211","CABA",257,257,0,0,0,0,1
"821260509","SANTA FE",335,231,37,58,1,96,0.68955223880597
"821190302","SANTA FE",510,241,60,201,1,262,0.472549019607843
"820630409","SANTA FE",874,25,149,683,1,833,0.028604118993135
"821050306","SANTA FE",411,109,149,146,3,298,0.265206812652068
"820700420","SANTA FE",195,188,3,4,0,7,0.964102564102564
"820630311","SANTA FE",417,2,67,304,16,387,0.00479616306954436
"820280320","SANTA FE",226,1,115,100,5,220,0.00442477876106195
"820770107","SANTA FE",264,0,106,119,20,245,0
"820280409","SANTA FE",327,325,0,1,0,1,0.99388379204893
"820910403","SANTA FE",163,0,80,70,7,157,0
"820630216","SANTA FE",227,1,116,108,1,225,0.00440528634361234
"820910323","SANTA FE",225,126,78,19,0,97,0.56
"821260314","SANTA FE",344,244,46,50,0,96,0.709302325581395
"820633409","SANTA FE",263,1,40,209,1,250,0.00380228136882129
"820848808","SANTA FE",349,318,20,10,0,30,0.911174785100286
"820633403","SANTA FE",459,3,88,358,7,453,0.0065359477124183
"820633308","SANTA FE",300,295,1,3,0,4,0.983333333333333
"820633304","SANTA FE",295,34,49,203,4,256,0.115254237288136
"820700419","SANTA FE",338,307,12,2,0,14,0.908284023668639
"820700412","SANTA FE",299,294,3,2,0,5,0.983277591973244
"820633208","SANTA FE",379,9,236,133,0,369,0.0237467018469657
"820633115","SANTA FE",442,10,98,324,2,424,0.0226244343891403
"820490712","SANTA FE",471,445,17,7,0,24,0.9447983014862
"820490710","SANTA FE",280,278,0,1,0,1,0.992857142857143
"820490705","SANTA FE",270,44,91,123,1,215,0.162962962962963
"820632607","SANTA FE",416,408,2,4,1,7,0.980769230769231
"820632603","SANTA FE",303,208,19,71,2,92,0.686468646864686
"820633101","SANTA FE",574,16,252,303,0,555,0.0278745644599303
"820848303","SANTA FE",289,250,28,11,0,39,0.865051903114187
"820630210","SANTA FE",272,2,220,48,1,269,0.00735294117647059
"820630208","SANTA FE",493,2,292,188,3,483,0.00405679513184584
"820630205","SANTA FE",308,3,210,92,2,304,0.00974025974025974
"820490719","SANTA FE",532,14,157,299,30,486,0.0263157894736842
"820633001","SANTA FE",330,327,2,0,0,2,0.990909090909091
"820630127","SANTA FE",305,4,157,142,1,300,0.0131147540983607
"820490410","SANTA FE",120,0,96,17,6,119,0
"820632817","SANTA FE",240,4,138,94,0,232,0.0166666666666667
"820632509","SANTA FE",339,338,1,0,0,1,0.997050147492625
"820632416","SANTA FE",231,228,3,0,0,3,0.987012987012987
"820632828","SANTA FE",259,7,123,111,0,234,0.027027027027027
"820848215","SANTA FE",310,9,123,163,4,290,0.0290322580645161
"820848213","SANTA FE",517,36,134,338,3,475,0.0696324951644101
"820632809","SANTA FE",418,7,174,236,0,410,0.0167464114832536
"820632808","SANTA FE",313,20,145,144,0,289,0.0638977635782748
"820840909","SANTA FE",199,193,6,0,0,6,0.969849246231156
"820840908","SANTA FE",316,251,20,39,1,60,0.794303797468354
"820632713","SANTA FE",478,4,66,342,17,425,0.00836820083682008
"820632709","SANTA FE",508,125,156,222,1,379,0.246062992125984
"820490303","SANTA FE",316,250,51,13,0,64,0.791139240506329
"820840811","SANTA FE",438,74,15,262,17,294,0.168949771689498
"820840810","SANTA FE",277,256,2,19,0,21,0.924187725631769
"820700718","SANTA FE",305,189,52,63,0,115,0.619672131147541
"820700717","SANTA FE",321,224,47,50,0,97,0.697819314641745
"820840804","SANTA FE",304,291,11,2,0,13,0.957236842105263
"820632303","SANTA FE",262,262,0,0,0,0,1
"820632214","SANTA FE",252,248,4,0,0,4,0.984126984126984
"820632208","SANTA FE",326,326,0,0,0,0,1
"820632207","SANTA FE",327,325,1,1,0,2,0.99388379204893
"820632008","SANTA FE",312,302,5,5,0,10,0.967948717948718
"820632006","SANTA FE",236,234,2,0,0,2,0.991525423728814
"820632003","SANTA FE",206,154,38,14,0,52,0.747572815533981
"820631911","SANTA FE",247,4,34,207,0,241,0.0161943319838057
"820631909","SANTA FE",396,72,112,206,0,318,0.181818181818182
"820631805","SANTA FE",97,96,1,0,0,1,0.989690721649485
"820631603","SANTA FE",395,393,2,0,0,2,0.994936708860759
"820631512","SANTA FE",317,307,4,5,0,9,0.968454258675079
"820631505","SANTA FE",310,301,4,5,0,9,0.970967741935484
"820631606","SANTA FE",241,241,0,0,0,0,1
"820631410","SANTA FE",360,332,4,22,0,26,0.922222222222222
"820842317","SANTA FE",172,172,0,0,0,0,1
"820631214","SANTA FE",269,17,43,204,0,247,0.0631970260223048
"820631304","SANTA FE",296,276,8,12,0,20,0.932432432432432
"820631208","SANTA FE",377,11,154,212,0,366,0.0291777188328912
"820770207","SANTA FE",448,6,228,171,16,415,0.0133928571428571
"820840713","SANTA FE",197,182,9,6,0,15,0.923857868020305
"820840618","SANTA FE",301,10,93,193,1,287,0.0332225913621262
"820840616","SANTA FE",600,69,144,367,1,512,0.115
"820848114","SANTA FE",213,199,9,5,0,14,0.934272300469484
"068051402","BUENOS AIRES",278,1,165,105,0,270,0.00359712230215827
"820560501","SANTA FE",157,39,71,47,0,118,0.248407643312102
"820842623","SANTA FE",224,223,1,0,0,1,0.995535714285714
"820560511","SANTA FE",430,379,12,36,0,48,0.881395348837209
"820840610","SANTA FE",367,365,2,0,0,2,0.994550408719346
"820630104","SANTA FE",286,3,148,132,1,281,0.0104895104895105
"820630103","SANTA FE",332,0,206,125,1,332,0
"820560516","SANTA FE",259,198,13,41,1,55,0.764478764478765
"820560509","SANTA FE",427,264,47,97,2,146,0.618266978922717
"820848106","SANTA FE",251,246,5,0,0,5,0.9800796812749
"820848110","SANTA FE",318,275,18,14,0,32,0.864779874213837
"820848103","SANTA FE",231,217,8,2,0,10,0.939393939393939
"820420616","SANTA FE",262,232,12,16,1,29,0.885496183206107
"820560407","SANTA FE",180,180,0,0,0,0,1
"820560413","SANTA FE",178,175,2,1,0,3,0.98314606741573
"820910312","SANTA FE",482,146,217,65,29,311,0.302904564315353
"820845703","SANTA FE",297,6,190,92,5,287,0.0202020202020202
"820845601","SANTA FE",25,25,0,0,0,0,1
"820845506","SANTA FE",246,51,65,130,0,195,0.207317073170732
"820560204","SANTA FE",384,367,5,9,0,14,0.955729166666667
"821190705","SANTA FE",430,6,149,262,1,412,0.013953488372093
"062100112","BUENOS AIRES",161,159,1,1,0,2,0.987577639751553
"820560117","SANTA FE",314,2,224,85,0,309,0.00636942675159236
"820845503","SANTA FE",277,122,54,101,0,155,0.44043321299639
"821191008","SANTA FE",293,286,3,2,0,5,0.976109215017065
"820845501","SANTA FE",388,102,174,111,1,286,0.262886597938144
"820845418","SANTA FE",283,239,20,23,0,43,0.84452296819788
"821190912","SANTA FE",223,215,2,6,0,8,0.964125560538117
"820845317","SANTA FE",202,189,0,0,0,0,0.935643564356436
"821190910","SANTA FE",179,178,0,1,0,1,0.994413407821229
"821190803","SANTA FE",369,20,249,93,0,342,0.0542005420054201
"820841015","SANTA FE",247,23,70,152,1,223,0.0931174089068826
"821190711","SANTA FE",208,95,71,31,0,102,0.456730769230769
"820421207","SANTA FE",288,0,122,160,2,284,0
"821190513","SANTA FE",267,1,181,80,0,261,0.00374531835205993
"820848008","SANTA FE",432,428,2,0,0,2,0.990740740740741
"820847721","SANTA FE",378,370,4,3,0,7,0.978835978835979
"820421203","SANTA FE",455,3,176,257,6,439,0.00659340659340659
"820849011","SANTA FE",373,1,272,99,0,371,0.00268096514745308
"821190426","SANTA FE",351,1,80,248,3,331,0.00284900284900285
"820846306","SANTA FE",403,5,179,214,0,393,0.0124069478908189
"820280108","SANTA FE",258,1,115,135,1,251,0.00387596899224806
"820849009","SANTA FE",142,2,112,27,0,139,0.0140845070422535
"820849007","SANTA FE",526,3,324,193,0,517,0.00570342205323194
"820211007","SANTA FE",380,5,314,55,5,374,0.0131578947368421
"820280104","SANTA FE",451,39,158,246,2,406,0.0864745011086474
"820211006","SANTA FE",462,0,370,86,4,460,0
"820210803","SANTA FE",270,264,3,3,0,6,0.977777777777778
"820210726","SANTA FE",305,4,218,76,3,297,0.0131147540983607
"820210723","SANTA FE",7,0,5,2,0,7,0
"820210717","SANTA FE",420,15,331,67,0,398,0.0357142857142857
"820210714","SANTA FE",59,0,30,23,5,58,0
"821330623","SANTA FE",23,0,3,17,0,20,0
"820910110","SANTA FE",46,0,21,21,3,45,0
"540840801","MISIONES",11,0,0,4,5,9,0
"821330614","SANTA FE",40,0,19,20,1,40,0
"821330612","SANTA FE",11,0,6,3,1,10,0
"821330609","SANTA FE",10,0,5,4,0,9,0
"821330302","SANTA FE",0,0,0,0,0,0,NA
"821330220","SANTA FE",3,0,3,0,0,3,0
"821199701","SANTA FE",2,0,2,0,0,2,0
"821190613","SANTA FE",21,0,4,16,1,21,0
"820770101","SANTA FE",106,0,21,52,4,77,0
"821050204","SANTA FE",78,0,30,48,0,78,0
"821050203","SANTA FE",32,0,13,16,1,30,0
"821050202","SANTA FE",27,0,14,12,0,26,0
"821050104","SANTA FE",51,0,8,41,2,51,0
"820980313","SANTA FE",43,0,16,12,5,33,0
"820847901","SANTA FE",8,0,3,5,0,8,0
"820980309","SANTA FE",40,0,8,26,5,39,0
"820910209","SANTA FE",92,1,45,34,10,89,0.0108695652173913
"821330204","SANTA FE",155,0,18,91,2,111,0
"820910108","SANTA FE",128,0,45,63,14,122,0
"820980304","SANTA FE",121,0,25,80,8,113,0
"820980102","SANTA FE",19,0,9,10,0,19,0
"820700114","SANTA FE",36,0,8,23,0,31,0
"820490411","SANTA FE",132,0,21,66,31,118,0
"821330522","SANTA FE",41,0,3,28,7,38,0
"820210310","SANTA FE",137,0,47,85,3,135,0
"820149001","SANTA FE",23,1,9,13,0,22,0.0434782608695652
"820140501","SANTA FE",17,0,4,11,0,15,0
"820420303","SANTA FE",71,3,33,34,1,68,0.0422535211267606
"820140214","SANTA FE",208,208,0,0,0,0,1
"820280206","SANTA FE",39,0,12,27,0,39,0
"821330310","SANTA FE",43,0,10,21,5,36,0
"820770310","SANTA FE",97,0,37,48,5,90,0
"821330206","SANTA FE",85,0,14,57,10,81,0
"821330616","SANTA FE",6,0,0,6,0,6,0
"820210131","SANTA FE",57,0,14,36,3,53,0
"820210116","SANTA FE",109,0,34,74,1,109,0
"820210114","SANTA FE",53,0,28,22,3,53,0
"820700604","SANTA FE",54,0,14,40,0,54,0
"820280215","SANTA FE",22,0,14,8,0,22,0
"820350208","SANTA FE",84,0,15,59,5,79,0
"820632803","SANTA FE",418,403,3,10,0,13,0.964114832535885
"820560110","SANTA FE",108,0,32,68,5,105,0
"821330501","SANTA FE",41,0,5,22,2,29,0
"821330203","SANTA FE",6,0,0,5,0,5,0
"821330202","SANTA FE",26,0,1,17,8,26,0
"820630223","SANTA FE",140,1,44,86,1,131,0.00714285714285714
"821191004","SANTA FE",280,267,6,7,0,13,0.953571428571429
"820490809","SANTA FE",88,0,34,22,6,62,0
"820490310","SANTA FE",88,0,25,26,32,83,0
"820490307","SANTA FE",103,0,22,35,37,94,0
"064342811","BUENOS AIRES",230,7,113,110,0,223,0.0304347826086957
"820280317","SANTA FE",37,1,10,23,0,33,0.027027027027027
"820630217","SANTA FE",28,0,3,20,0,23,0
"820770105","SANTA FE",109,0,20,59,11,90,0
"821190907","SANTA FE",275,248,13,12,0,25,0.901818181818182
"820910413","SANTA FE",30,0,8,18,0,26,0
"820490507","SANTA FE",93,0,30,44,16,90,0
"820490504","SANTA FE",135,17,67,43,5,115,0.125925925925926
"821120410","SANTA FE",398,310,57,31,0,88,0.778894472361809
"820490414","SANTA FE",10,0,0,3,7,10,0
"820630608","SANTA FE",212,202,5,5,0,10,0.952830188679245
"820980101","SANTA FE",24,0,13,11,0,24,0
"820490402","SANTA FE",97,2,23,44,9,76,0.0206185567010309
"820490327","SANTA FE",87,0,30,30,5,65,0
"820490312","SANTA FE",36,0,4,22,4,30,0
"820280119","SANTA FE",42,0,9,30,3,42,0
"820490105","SANTA FE",94,0,28,51,6,85,0
"820980314","SANTA FE",46,1,13,30,1,44,0.0217391304347826
"820421201","SANTA FE",102,0,22,79,0,101,0
"820140126","SANTA FE",49,5,22,21,0,43,0.102040816326531
"820848408","SANTA FE",317,285,18,14,0,32,0.899053627760252
"820280217","SANTA FE",28,0,13,14,0,27,0
"820700610","SANTA FE",46,1,19,26,0,45,0.0217391304347826
"820847802","SANTA FE",109,7,27,70,0,97,0.0642201834862385
"821199401","SANTA FE",4,0,1,3,0,4,0
"820910301","SANTA FE",77,0,38,29,6,73,0
"821120104","SANTA FE",177,5,22,134,8,164,0.0282485875706215
"821050210","SANTA FE",72,0,29,40,0,69,0
"820632604","SANTA FE",307,197,33,64,1,98,0.641693811074919
"821260405","SANTA FE",345,43,119,158,15,292,0.12463768115942
"820980108","SANTA FE",111,0,39,61,10,110,0
"820910306","SANTA FE",356,4,217,98,10,325,0.0112359550561798
"820980122","SANTA FE",339,1,185,133,7,325,0.00294985250737463
"820910201","SANTA FE",68,0,22,41,5,68,0
"820846905","SANTA FE",209,2,100,105,0,205,0.00956937799043062
"820846501","SANTA FE",461,11,189,251,2,442,0.0238611713665944
"820980113","SANTA FE",284,35,200,47,0,247,0.123239436619718
"820910604","SANTA FE",223,36,177,9,0,186,0.161434977578475
"820700613","SANTA FE",196,3,49,129,12,190,0.0153061224489796
"820700303","SANTA FE",417,2,202,208,1,411,0.00479616306954436
"820630219","SANTA FE",53,2,15,31,0,46,0.0377358490566038
"060561420","BUENOS AIRES",114,114,0,0,0,0,1
"820490509","SANTA FE",306,60,141,96,5,242,0.196078431372549
"820910203","SANTA FE",145,0,53,72,9,134,0
"821330215","SANTA FE",51,0,13,20,9,42,0
"820140202","SANTA FE",33,1,6,26,0,32,0.0303030303030303
"068402405","BUENOS AIRES",269,142,16,96,1,113,0.527881040892193
"820140416","SANTA FE",101,1,8,89,1,98,0.0099009900990099
"820844807","SANTA FE",633,68,59,425,19,503,0.107424960505529
"820630302","SANTA FE",222,1,62,149,8,219,0.0045045045045045
"820140418","SANTA FE",80,1,43,34,2,79,0.0125
"820845801","SANTA FE",27,0,10,16,0,26,0
"820910321","SANTA FE",351,221,101,18,2,121,0.62962962962963
"820420218","SANTA FE",122,1,68,53,0,121,0.00819672131147541
"820420119","SANTA FE",114,2,43,49,16,108,0.0175438596491228
"821190408","SANTA FE",370,6,265,95,2,362,0.0162162162162162
"821190406","SANTA FE",268,1,183,82,1,266,0.00373134328358209
"820632821","SANTA FE",56,1,17,35,1,53,0.0178571428571429
"820846112","SANTA FE",341,13,100,219,5,324,0.0381231671554252
"820845922","SANTA FE",430,3,81,327,4,412,0.00697674418604651
"820843911","SANTA FE",233,223,3,6,1,10,0.957081545064378
"820910507","SANTA FE",744,151,432,109,37,578,0.202956989247312
"820849004","SANTA FE",290,11,169,110,0,279,0.0379310344827586
"820845920","SANTA FE",290,4,136,149,0,285,0.0137931034482759
"820210618","SANTA FE",441,361,45,34,0,79,0.81859410430839
"820210617","SANTA FE",259,255,2,1,0,3,0.984555984555985
"820847703","SANTA FE",100,8,30,56,3,89,0.08
"820211013","SANTA FE",450,0,278,155,15,448,0
"821190411","SANTA FE",92,80,9,3,0,12,0.869565217391304
"820846202","SANTA FE",181,2,27,146,5,178,0.0110497237569061
"821330407","SANTA FE",237,64,123,48,0,171,0.270042194092827
"821330209","SANTA FE",95,0,31,49,5,85,0
"820910408","SANTA FE",329,0,205,112,8,325,0
"821050110","SANTA FE",223,1,57,120,31,208,0.00448430493273543
"821260310","SANTA FE",259,207,36,16,0,52,0.799227799227799
"820849003","SANTA FE",467,0,265,197,1,463,0
"820848507","SANTA FE",275,251,6,14,1,21,0.912727272727273
"820848504","SANTA FE",253,30,36,186,0,222,0.118577075098814
"820848210","SANTA FE",496,15,127,335,5,467,0.030241935483871
"820847906","SANTA FE",336,3,135,195,2,332,0.00892857142857143
"820847806","SANTA FE",321,163,81,76,1,158,0.507788161993769
"820846005","SANTA FE",366,13,169,184,0,353,0.0355191256830601
"820845807","SANTA FE",397,0,154,242,0,396,0
"820845523","SANTA FE",247,185,11,51,0,62,0.748987854251012
"820843908","SANTA FE",420,412,6,0,1,7,0.980952380952381
"820845520","SANTA FE",412,384,13,15,0,28,0.932038834951456
"820845519","SANTA FE",195,140,32,22,0,54,0.717948717948718
"820845514","SANTA FE",414,301,24,54,0,78,0.727053140096618
"820845512","SANTA FE",325,12,53,248,5,306,0.0369230769230769
"820845310","SANTA FE",403,349,23,31,0,54,0.866004962779156
"820845307","SANTA FE",390,381,4,5,0,9,0.976923076923077
"820845302","SANTA FE",318,297,7,5,0,12,0.933962264150943
"820843305","SANTA FE",469,308,79,81,0,160,0.656716417910448
"820840422","SANTA FE",247,203,25,15,0,40,0.821862348178138
"820840202","SANTA FE",324,4,158,152,3,313,0.0123456790123457
"820700309","SANTA FE",330,326,2,2,0,4,0.987878787878788
"820630325","SANTA FE",368,2,151,210,1,362,0.00543478260869565
"821190205","SANTA FE",385,384,1,0,0,1,0.997402597402597
"820630324","SANTA FE",422,0,204,209,4,417,0
"820632707","SANTA FE",310,301,3,6,0,9,0.970967741935484
"820630306","SANTA FE",194,2,66,124,1,191,0.0103092783505155
"820560402","SANTA FE",378,365,5,4,0,9,0.965608465608466
"820560216","SANTA FE",236,150,57,24,0,81,0.635593220338983
"820490915","SANTA FE",335,77,110,132,6,248,0.229850746268657
"820491005","SANTA FE",454,434,10,7,0,17,0.955947136563877
"820491003","SANTA FE",293,293,0,0,0,0,1
"821190203","SANTA FE",450,382,25,38,0,63,0.848888888888889
"820843904","SANTA FE",232,231,1,0,0,1,0.995689655172414
"821120406","SANTA FE",399,22,121,247,3,371,0.0551378446115288
"068402410","BUENOS AIRES",189,189,0,0,0,0,1
"821190716","SANTA FE",369,22,93,240,5,338,0.0596205962059621
"821190609","SANTA FE",419,373,19,25,0,44,0.890214797136038
"821190514","SANTA FE",362,12,186,159,2,347,0.0331491712707182
"821190310","SANTA FE",170,2,75,91,0,166,0.0117647058823529
"821190309","SANTA FE",270,265,1,4,0,5,0.981481481481482
"821190119","SANTA FE",328,1,102,211,1,314,0.00304878048780488
"821190206","SANTA FE",373,359,12,2,0,14,0.962466487935657
"821190118","SANTA FE",248,147,33,63,0,96,0.592741935483871
"820843815","SANTA FE",233,231,2,0,0,2,0.991416309012876
"821120314","SANTA FE",406,1,172,226,4,402,0.00246305418719212
"821190208","SANTA FE",236,224,7,4,0,11,0.949152542372881
"821120412","SANTA FE",452,176,114,158,1,273,0.389380530973451
"821190122","SANTA FE",287,159,76,47,0,123,0.554006968641115
"821120108","SANTA FE",263,184,23,56,0,79,0.699619771863118
"821120419","SANTA FE",393,50,103,231,3,337,0.127226463104326
"821120210","SANTA FE",358,354,2,2,0,4,0.988826815642458
"821050514","SANTA FE",366,0,180,181,1,362,0
"821050511","SANTA FE",289,1,82,195,2,279,0.00346020761245675
"821050217","SANTA FE",297,2,174,117,1,292,0.00673400673400673
"820842610","SANTA FE",323,323,0,0,0,0,1
"820632706","SANTA FE",411,407,2,2,0,4,0.990267639902676
"821050213","SANTA FE",488,219,118,146,2,266,0.448770491803279
"821050221","SANTA FE",389,194,55,133,1,189,0.498714652956298
"821050117","SANTA FE",304,3,209,92,0,301,0.00986842105263158
"820490602","SANTA FE",288,261,6,20,0,26,0.90625
"820490526","SANTA FE",326,307,9,9,0,18,0.941717791411043
"820490525","SANTA FE",311,234,33,43,0,76,0.752411575562701
"820490616","SANTA FE",353,348,4,0,0,4,0.985835694050991
"820280210","SANTA FE",23,0,7,14,1,22,0
"821260216","SANTA FE",44,2,15,21,1,37,0.0454545454545455
"820845314","SANTA FE",232,227,4,0,1,5,0.978448275862069
"820700319","SANTA FE",368,190,65,113,0,178,0.516304347826087
"820700311","SANTA FE",418,12,217,185,0,402,0.0287081339712919
"820700201","SANTA FE",379,254,81,42,0,123,0.670184696569921
"820632903","SANTA FE",258,246,9,3,0,12,0.953488372093023
"540281703","MISIONES",15,0,4,3,8,15,0
"820845204","SANTA FE",378,94,86,176,7,269,0.248677248677249
"820844713","SANTA FE",236,207,9,20,0,29,0.877118644067797
"820844517","SANTA FE",328,280,10,32,0,42,0.853658536585366
"820844513","SANTA FE",130,116,3,11,0,14,0.892307692307692
"820844510","SANTA FE",292,276,11,2,0,13,0.945205479452055
"820844704","SANTA FE",513,345,43,104,0,147,0.672514619883041
"820844609","SANTA FE",541,302,42,172,1,215,0.55822550831793
"820844403","SANTA FE",361,343,13,4,0,17,0.950138504155125
"820844402","SANTA FE",179,178,0,1,0,1,0.994413407821229
"820844309","SANTA FE",245,245,0,0,0,0,1
"820844213","SANTA FE",414,290,50,73,0,123,0.70048309178744
"820844206","SANTA FE",114,94,1,16,0,17,0.824561403508772
"821120304","SANTA FE",16,1,5,10,0,15,0.0625
"820632113","SANTA FE",209,206,3,0,0,3,0.985645933014354
"820844205","SANTA FE",205,116,24,58,0,82,0.565853658536585
"820844202","SANTA FE",172,75,17,77,1,95,0.436046511627907
"821260401","SANTA FE",447,8,317,107,5,429,0.0178970917225951
"820980206","SANTA FE",284,1,105,157,10,272,0.00352112676056338
"820842811","SANTA FE",413,411,2,0,0,2,0.995157384987893
"820844211","SANTA FE",275,144,26,83,9,118,0.523636363636364
"820910205","SANTA FE",10,0,0,8,1,9,0
"820910103","SANTA FE",308,241,37,16,14,67,0.782467532467532
"820843708","SANTA FE",384,382,2,0,0,2,0.994791666666667
"820848406","SANTA FE",282,240,22,17,0,39,0.851063829787234
"820843619","SANTA FE",210,207,3,0,0,3,0.985714285714286
"820846310","SANTA FE",412,14,67,321,1,389,0.0339805825242718
"820843915","SANTA FE",219,219,0,0,0,0,1
"821190603","SANTA FE",495,1,175,305,4,484,0.00202020202020202
"820843311","SANTA FE",418,46,103,254,7,364,0.110047846889952
"820632112","SANTA FE",346,344,2,0,0,2,0.994219653179191
"820843814","SANTA FE",352,352,0,0,0,0,1
"820843811","SANTA FE",327,322,3,0,0,3,0.984709480122324
"820843810","SANTA FE",307,296,7,3,0,10,0.964169381107492
"820843110","SANTA FE",303,257,6,9,0,15,0.848184818481848
"820843014","SANTA FE",367,65,130,166,1,297,0.177111716621253
"820843008","SANTA FE",286,238,7,41,0,48,0.832167832167832
"820770404","SANTA FE",57,0,13,41,1,55,0
"820633105","SANTA FE",30,3,13,11,0,24,0.1
"820632612","SANTA FE",356,356,0,0,0,0,1
"820632402","SANTA FE",261,260,1,0,0,1,0.996168582375479
"820700701","SANTA FE",257,150,56,51,0,107,0.583657587548638
"820842923","SANTA FE",156,156,0,0,0,0,1
"820842016","SANTA FE",151,151,0,0,0,0,1
"820700514","SANTA FE",35,1,20,12,0,32,0.0285714285714286
"820700110","SANTA FE",186,0,123,61,2,186,0
"063711809","BUENOS AIRES",279,6,213,59,0,272,0.021505376344086
"820490405","SANTA FE",63,1,30,26,3,59,0.0158730158730159
"820842906","SANTA FE",175,175,0,0,0,0,1
"820842825","SANTA FE",222,221,1,0,0,1,0.995495495495496
"820842801","SANTA FE",164,164,0,0,0,0,1
"820630206","SANTA FE",332,2,248,80,2,330,0.00602409638554217
"820842721","SANTA FE",251,250,1,0,0,1,0.99601593625498
"820842720","SANTA FE",199,199,0,0,0,0,1
"820842715","SANTA FE",303,303,0,0,0,0,1
"820842713","SANTA FE",232,232,0,0,0,0,1
"820842007","SANTA FE",263,263,0,0,0,0,1
"820842005","SANTA FE",160,160,0,0,0,0,1
"820841808","SANTA FE",247,246,0,1,0,1,0.995951417004049
"820420219","SANTA FE",380,2,190,184,0,374,0.00526315789473684
"820420210","SANTA FE",169,0,85,68,5,158,0
"820420104","SANTA FE",110,0,63,43,3,109,0
"820842304","SANTA FE",189,189,0,0,0,0,1
"820842010","SANTA FE",167,167,0,0,0,0,1
"820842212","SANTA FE",355,350,0,0,0,0,0.985915492957746
"820280120","SANTA FE",173,159,10,4,0,14,0.919075144508671
"820280117","SANTA FE",334,2,143,184,1,328,0.00598802395209581
"820210313","SANTA FE",341,2,224,111,4,339,0.00586510263929619
"820210217","SANTA FE",467,359,48,56,0,104,0.768736616702355
"063711902","BUENOS AIRES",323,323,0,0,0,0,1
"821260114","SANTA FE",231,174,38,17,0,55,0.753246753246753
"820841410","SANTA FE",351,345,3,3,0,6,0.982905982905983
"820841611","SANTA FE",195,177,4,0,0,4,0.907692307692308
"820841607","SANTA FE",447,442,4,1,0,5,0.988814317673378
"820841402","SANTA FE",205,203,2,0,0,2,0.990243902439024
"820841215","SANTA FE",305,180,81,42,0,123,0.590163934426229
"820841214","SANTA FE",336,85,144,106,0,250,0.25297619047619
"820841213","SANTA FE",293,20,84,185,4,273,0.068259385665529
"820841714","SANTA FE",225,225,0,0,0,0,1
"820841711","SANTA FE",369,363,6,0,0,6,0.983739837398374
"820841702","SANTA FE",239,233,2,0,0,2,0.97489539748954
"820841404","SANTA FE",315,311,1,3,0,4,0.987301587301587
"820841207","SANTA FE",241,164,15,61,0,76,0.680497925311203
"820841305","SANTA FE",272,252,11,9,0,20,0.926470588235294
"820841116","SANTA FE",275,7,161,107,0,268,0.0254545454545455
"820843510","SANTA FE",368,89,63,191,11,265,0.241847826086957
"820843506","SANTA FE",257,253,2,2,0,4,0.98443579766537
"820843418","SANTA FE",154,151,3,0,0,3,0.980519480519481
"820841119","SANTA FE",323,44,214,64,0,278,0.136222910216718
"820843405","SANTA FE",361,347,6,8,0,14,0.961218836565097
"820843601","SANTA FE",250,249,1,0,0,1,0.996
"820841912","SANTA FE",266,265,0,0,0,0,0.996240601503759
"820843513","SANTA FE",261,28,89,143,1,233,0.10727969348659
"820845009","SANTA FE",195,8,59,128,0,187,0.041025641025641
"820845007","SANTA FE",391,45,47,296,1,344,0.115089514066496
"820845005","SANTA FE",346,155,89,102,0,191,0.447976878612717
"820844907","SANTA FE",473,4,50,385,13,448,0.00845665961945032
"821260203","SANTA FE",23,0,6,16,1,23,0
"820845208","SANTA FE",380,113,60,186,3,249,0.297368421052632
"820845106","SANTA FE",399,382,9,8,0,17,0.957393483709273
"820845012","SANTA FE",427,82,144,197,0,341,0.192037470725995
"820844819","SANTA FE",295,7,39,244,1,284,0.023728813559322
"820845209","SANTA FE",314,62,77,170,1,248,0.197452229299363
"820844809","SANTA FE",219,6,54,158,0,212,0.0273972602739726
"820844808","SANTA FE",231,3,69,155,1,225,0.012987012987013
"820210403","SANTA FE",216,209,5,2,0,7,0.967592592592593
"820210307","SANTA FE",64,0,28,34,2,64,0
"820210202","SANTA FE",382,365,11,6,0,17,0.955497382198953
"820210502","SANTA FE",355,241,22,81,1,104,0.67887323943662
"820210414","SANTA FE",320,302,8,10,0,18,0.94375
"062600406","BUENOS AIRES",331,2,223,105,0,328,0.00604229607250755
"820210405","SANTA FE",231,209,11,10,0,21,0.904761904761905
"820210333","SANTA FE",144,0,62,81,0,143,0
"820210123","SANTA FE",88,0,38,50,0,88,0
"820845918","SANTA FE",438,2,325,105,1,431,0.0045662100456621
"820210104","SANTA FE",332,183,72,63,11,146,0.551204819277108
"820848710","SANTA FE",376,342,11,19,1,31,0.909574468085106
"820848812","SANTA FE",378,10,173,188,3,364,0.0264550264550265
"820210110","SANTA FE",388,3,201,177,5,383,0.0077319587628866
"820848705","SANTA FE",290,275,0,13,0,13,0.948275862068966
"820070313","SANTA FE",264,78,87,99,0,186,0.295454545454545
"820421013","SANTA FE",290,210,26,50,2,78,0.724137931034483
"820140509","SANTA FE",231,86,88,57,0,145,0.372294372294372
"820842406","SANTA FE",226,225,1,0,0,1,0.995575221238938
"064691105","BUENOS AIRES",10,0,7,3,0,10,0
"820140207","SANTA FE",327,324,0,2,0,2,0.990825688073395
"820420913","SANTA FE",243,234,6,3,0,9,0.962962962962963
"820842619","SANTA FE",138,138,0,0,0,0,1
"820421002","SANTA FE",462,200,103,139,3,245,0.432900432900433
"820420905","SANTA FE",352,286,24,40,0,64,0.8125
"820420719","SANTA FE",209,196,11,2,0,13,0.937799043062201
"820420715","SANTA FE",441,0,149,252,3,404,0
"820420710","SANTA FE",334,325,2,4,0,6,0.973053892215569
"820848703","SANTA FE",260,254,1,1,0,2,0.976923076923077
"820420618","SANTA FE",265,40,40,171,2,213,0.150943396226415
"820420602","SANTA FE",269,34,72,158,1,231,0.12639405204461
"820420508","SANTA FE",456,16,135,280,13,428,0.0350877192982456
"820140309","SANTA FE",282,276,1,2,0,3,0.978723404255319
"820140302","SANTA FE",259,258,1,0,0,1,0.996138996138996
"820420414","SANTA FE",262,55,92,112,1,205,0.209923664122137
"820420413","SANTA FE",380,27,117,221,0,338,0.0710526315789474
"820420402","SANTA FE",561,5,164,354,9,527,0.0089126559714795
"820420613","SANTA FE",320,274,18,25,0,43,0.85625
"820070207","SANTA FE",243,191,18,19,0,37,0.786008230452675
"820070201","SANTA FE",332,258,35,38,0,73,0.77710843373494
"820420213","SANTA FE",305,3,150,148,2,300,0.00983606557377049
"820631113","SANTA FE",397,114,49,213,1,263,0.287153652392947
"820280216","SANTA FE",235,0,117,116,0,233,0
"821050404","SANTA FE",256,254,1,1,0,2,0.9921875
"820070411","SANTA FE",236,232,3,1,0,4,0.983050847457627
"820420404","SANTA FE",438,133,90,207,0,297,0.30365296803653
"820140115","SANTA FE",460,210,104,140,0,244,0.456521739130435
"820140110","SANTA FE",432,1,219,212,0,431,0.00231481481481481
"820140103","SANTA FE",281,70,84,127,0,211,0.249110320284698
"820070413","SANTA FE",294,37,58,181,7,246,0.125850340136054
"820070311","SANTA FE",324,218,51,49,0,100,0.672839506172839
"821050401","SANTA FE",355,206,46,96,0,142,0.580281690140845
"820420405","SANTA FE",219,187,18,14,0,32,0.853881278538813
"820420111","SANTA FE",344,1,139,201,1,341,0.00290697674418605
"820840605","SANTA FE",479,25,67,358,3,428,0.0521920668058455
"820350212","SANTA FE",382,0,132,245,0,377,0
"820840603","SANTA FE",287,286,1,0,0,1,0.996515679442509
"820840508","SANTA FE",312,263,36,13,0,49,0.842948717948718
"820420205","SANTA FE",352,1,197,146,6,349,0.00284090909090909
"820631104","SANTA FE",251,10,93,144,0,237,0.0398406374501992
"820631305","SANTA FE",259,60,65,134,0,199,0.231660231660232
"820070401","SANTA FE",254,121,24,104,1,129,0.476377952755905
"820630909","SANTA FE",285,275,4,6,0,10,0.964912280701754
"820631007","SANTA FE",433,10,108,300,4,412,0.023094688221709
"820630714","SANTA FE",216,215,1,0,0,1,0.99537037037037
"820560109","SANTA FE",278,8,168,100,0,268,0.0287769784172662
"820630707","SANTA FE",299,299,0,0,0,0,1
"820630618","SANTA FE",234,225,5,4,0,9,0.961538461538462
"820350114","SANTA FE",348,0,245,99,2,346,0
"820842322","SANTA FE",214,213,1,0,0,1,0.995327102803738
"820630617","SANTA FE",304,290,8,6,0,14,0.953947368421053
"821050226","SANTA FE",210,159,34,16,0,50,0.757142857142857
"820840410","SANTA FE",246,204,38,4,0,42,0.829268292682927
"820631003","SANTA FE",258,16,73,169,0,242,0.062015503875969
"820840407","SANTA FE",214,178,27,9,0,36,0.831775700934579
"820840309","SANTA FE",297,7,115,170,2,287,0.0235690235690236
"820840306","SANTA FE",480,25,163,283,1,447,0.0520833333333333
"820840304","SANTA FE",346,4,141,189,0,330,0.0115606936416185
"820841811","SANTA FE",341,341,0,0,0,0,1
"820840214","SANTA FE",435,5,210,212,0,422,0.0114942528735632
"820630507","SANTA FE",360,3,64,264,0,328,0.00833333333333333
"820630505","SANTA FE",290,3,52,231,0,283,0.0103448275862069
"820910317","SANTA FE",499,127,330,38,0,368,0.254509018036072
"821050120","SANTA FE",340,7,203,128,0,331,0.0205882352941176
"820630501","SANTA FE",535,15,211,273,10,494,0.0280373831775701
"820840420","SANTA FE",355,335,12,8,0,20,0.943661971830986
"820491016","SANTA FE",469,2,191,241,8,440,0.00426439232409382
"820280515","SANTA FE",387,7,175,197,0,372,0.0180878552971576
"820280509","SANTA FE",366,279,45,41,0,86,0.762295081967213
"820280505","SANTA FE",476,442,13,16,1,30,0.928571428571429
"820280501","SANTA FE",297,77,34,152,11,197,0.259259259259259
"820846304","SANTA FE",286,19,42,197,18,257,0.0664335664335664
"820280327","SANTA FE",105,2,63,36,0,99,0.019047619047619
"821260514","SANTA FE",290,172,76,30,4,110,0.593103448275862
"820630232","SANTA FE",392,29,191,165,0,356,0.0739795918367347
"820491007","SANTA FE",775,4,363,341,21,725,0.00516129032258065
"821050305","SANTA FE",290,247,32,9,1,42,0.851724137931035
"821050303","SANTA FE",352,287,37,25,1,63,0.815340909090909
"821050302","SANTA FE",329,245,41,42,1,84,0.74468085106383
"820280321","SANTA FE",228,1,111,113,0,224,0.0043859649122807
"820280308","SANTA FE",327,5,268,54,0,322,0.0152905198776758
"820910404","SANTA FE",108,1,70,27,7,104,0.00925925925925926
"063712314","BUENOS AIRES",314,304,4,5,0,9,0.968152866242038
"821260501","SANTA FE",222,199,17,5,1,23,0.896396396396396
"821260313","SANTA FE",458,123,79,249,1,329,0.268558951965066
"820633501","SANTA FE",237,146,13,73,2,88,0.616033755274262
"820700320","SANTA FE",325,40,169,111,0,280,0.123076923076923
"820848311","SANTA FE",334,278,37,19,0,56,0.832335329341317
"820633213","SANTA FE",530,452,33,44,0,77,0.852830188679245
"820633210","SANTA FE",301,297,1,2,1,4,0.98671096345515
"820490703","SANTA FE",226,226,0,0,0,0,1
"820633106","SANTA FE",329,9,142,173,1,316,0.027355623100304
"820633111","SANTA FE",311,17,40,228,18,286,0.0546623794212219
"820490716","SANTA FE",424,373,15,27,0,42,0.879716981132076
"820280221","SANTA FE",285,0,160,124,1,285,0
"820633005","SANTA FE",246,242,2,2,0,4,0.983739837398374
"820630121","SANTA FE",220,3,108,106,2,216,0.0136363636363636
"820846211","SANTA FE",309,19,104,177,0,281,0.0614886731391586
"820630119","SANTA FE",407,7,234,155,2,391,0.0171990171990172
"820490326","SANTA FE",638,59,281,235,15,531,0.0924764890282132
"820632502","SANTA FE",370,352,2,13,0,15,0.951351351351351
"820632912","SANTA FE",238,232,3,2,0,5,0.974789915966387
"820632512","SANTA FE",123,47,46,28,0,74,0.382113821138211
"820490306","SANTA FE",334,127,154,46,2,202,0.380239520958084
"820632306","SANTA FE",440,440,0,0,0,0,1
"820632210","SANTA FE",208,208,0,0,0,0,1
"820632115","SANTA FE",167,155,1,0,0,1,0.92814371257485
"820632106","SANTA FE",254,253,1,0,0,1,0.996062992125984
"820632010","SANTA FE",313,289,9,14,0,23,0.92332268370607
"820632007","SANTA FE",168,163,5,0,0,5,0.970238095238095
"820632005","SANTA FE",159,159,0,0,0,0,1
"820630123","SANTA FE",255,0,151,101,1,253,0
"820631908","SANTA FE",187,19,40,122,1,163,0.101604278074866
"820210718","SANTA FE",357,2,254,86,5,345,0.00560224089635854
"820631907","SANTA FE",368,339,6,22,0,28,0.921195652173913
"820631812","SANTA FE",197,197,0,0,0,0,1
"820631604","SANTA FE",251,245,2,4,0,6,0.97609561752988
"820631405","SANTA FE",286,266,9,11,0,20,0.93006993006993
"820631320","SANTA FE",217,3,135,79,0,214,0.0138248847926267
"820631209","SANTA FE",396,253,65,77,0,142,0.638888888888889
"820840721","SANTA FE",420,147,38,179,4,221,0.35
"820841920","SANTA FE",198,198,0,0,0,0,1
"820848119","SANTA FE",309,224,27,50,0,77,0.724919093851133
"820700611","SANTA FE",338,5,181,146,1,328,0.014792899408284
"820841003","SANTA FE",225,4,89,126,0,215,0.0177777777777778
"820840715","SANTA FE",292,280,6,3,0,9,0.958904109589041
"820840712","SANTA FE",273,244,22,7,0,29,0.893772893772894
"821120316","SANTA FE",297,200,40,56,0,96,0.673400673400673
"820848118","SANTA FE",277,248,17,12,0,29,0.895306859205776
"820840620","SANTA FE",299,292,6,1,0,7,0.976588628762542
"820840615","SANTA FE",289,258,10,18,2,30,0.892733564013841
"820848117","SANTA FE",271,243,5,20,1,26,0.896678966789668
"820840706","SANTA FE",671,119,171,364,1,536,0.177347242921013
"820848104","SANTA FE",232,211,10,11,0,21,0.90948275862069
"820848111","SANTA FE",228,208,15,4,0,19,0.912280701754386
"820560410","SANTA FE",254,250,0,2,0,2,0.984251968503937
"820848016","SANTA FE",297,296,1,0,0,1,0.996632996632997
"820845713","SANTA FE",280,4,137,137,0,274,0.0142857142857143
"820560209","SANTA FE",106,34,29,40,0,69,0.320754716981132
"820845711","SANTA FE",326,12,271,42,0,313,0.0368098159509202
"820845510","SANTA FE",374,215,45,111,0,156,0.574866310160428
"821120310","SANTA FE",106,2,37,56,1,94,0.0188679245283019
"820845507","SANTA FE",348,164,52,132,0,184,0.471264367816092
"820560203","SANTA FE",240,232,5,2,0,7,0.966666666666667
"820845502","SANTA FE",361,263,46,42,1,89,0.728531855955679
"820845417","SANTA FE",260,216,31,13,0,44,0.830769230769231
"820845415","SANTA FE",346,333,6,7,0,13,0.96242774566474
"821190815","SANTA FE",403,9,192,187,1,380,0.0223325062034739
"821190810","SANTA FE",344,200,93,50,0,143,0.581395348837209
"821190808","SANTA FE",375,5,247,121,0,368,0.0133333333333333
"820841020","SANTA FE",300,44,40,188,3,231,0.146666666666667
"820490107","SANTA FE",214,3,100,77,22,199,0.014018691588785
"821190804","SANTA FE",333,100,160,71,0,231,0.3003003003003
"820849008","SANTA FE",273,3,169,101,0,270,0.010989010989011
"820211017","SANTA FE",367,2,236,125,1,362,0.00544959128065395
"821120207","SANTA FE",188,1,84,100,1,185,0.00531914893617021
"820841001","SANTA FE",420,23,49,317,3,369,0.0547619047619048
"820841004","SANTA FE",498,71,79,277,8,364,0.142570281124498
"820421212","SANTA FE",390,5,310,74,0,384,0.0128205128205128
"820490102","SANTA FE",662,1,427,164,19,610,0.00151057401812689
"821190509","SANTA FE",263,32,122,108,0,230,0.121673003802281
"821190512","SANTA FE",218,90,68,60,0,128,0.412844036697248
"820280112","SANTA FE",360,1,177,180,1,358,0.00277777777777778
"820847725","SANTA FE",284,278,2,4,0,6,0.97887323943662
"820847724","SANTA FE",270,267,1,0,0,1,0.988888888888889
"820847723","SANTA FE",455,453,1,1,0,2,0.995604395604396
"820847718","SANTA FE",478,127,36,260,7,303,0.265690376569038
"820846207","SANTA FE",449,134,131,176,0,307,0.298440979955457
"820846217","SANTA FE",485,5,159,305,3,467,0.0103092783505155
"820211002","SANTA FE",205,0,160,41,4,205,0
"821190425","SANTA FE",274,7,187,80,0,267,0.0255474452554745
"820210907","SANTA FE",346,338,4,4,0,8,0.976878612716763
"820210905","SANTA FE",258,244,7,4,0,11,0.945736434108527
"820210903","SANTA FE",379,344,18,13,0,31,0.907651715039578
"820210901","SANTA FE",432,406,14,12,0,26,0.939814814814815
"821190423","SANTA FE",237,0,120,115,0,235,0
"820210914","SANTA FE",298,287,6,4,0,10,0.963087248322148
"820210913","SANTA FE",253,233,7,11,0,18,0.920948616600791
"820210911","SANTA FE",383,225,48,100,0,148,0.587467362924282
"821190420","SANTA FE",294,4,180,109,0,289,0.0136054421768707
"820210711","SANTA FE",37,0,22,15,0,37,0
"820846001","SANTA FE",52,0,19,32,1,52,0
"821260408","SANTA FE",294,273,11,8,2,21,0.928571428571429
"821330628","SANTA FE",9,0,5,4,0,9,0
"821330524","SANTA FE",34,0,1,24,7,32,0
"821330512","SANTA FE",21,0,4,11,5,20,0
"820490121","SANTA FE",671,8,351,260,15,626,0.0119225037257824
"821330307","SANTA FE",39,0,11,18,1,30,0
"820846703","SANTA FE",19,0,11,7,0,18,0
"821190610","SANTA FE",54,0,7,42,2,51,0
"820140305","SANTA FE",289,286,2,1,0,3,0.98961937716263
"821050201","SANTA FE",56,0,29,26,0,55,0
"820770409","SANTA FE",3,0,2,1,0,3,0
"821260205","SANTA FE",50,0,6,36,0,42,0
"821190607","SANTA FE",17,0,1,14,2,17,0
"820910303","SANTA FE",150,0,107,15,23,145,0
"820910113","SANTA FE",318,0,254,39,20,313,0
"821190601","SANTA FE",98,0,13,85,0,98,0
"821190113","SANTA FE",12,0,10,2,0,12,0
"821120315","SANTA FE",19,1,5,11,0,16,0.0526315789473684
"821330601","SANTA FE",12,3,3,3,3,9,0.25
"820632824","SANTA FE",2,0,0,2,0,2,0
"820632703","SANTA FE",271,186,53,32,0,85,0.686346863468635
"821120214","SANTA FE",18,0,7,9,2,18,0
"821120206","SANTA FE",110,3,26,78,0,104,0.0272727272727273
"821050510","SANTA FE",32,0,12,17,2,31,0
"821050208","SANTA FE",31,0,14,10,0,24,0
"820844012","SANTA FE",74,65,4,5,0,9,0.878378378378378
"820980201","SANTA FE",78,0,24,40,4,68,0
"820980106","SANTA FE",19,0,11,5,0,16,0
"820910411","SANTA FE",79,0,22,45,11,78,0
"820140301","SANTA FE",228,228,0,0,0,0,1
"820980307","SANTA FE",14,0,1,11,1,13,0
"820980301","SANTA FE",17,0,1,13,2,16,0
"820980202","SANTA FE",40,0,24,15,0,39,0
"820910210","SANTA FE",54,0,27,20,2,49,0
"820847101","SANTA FE",7,0,1,6,0,7,0
"820847501","SANTA FE",10,0,6,4,0,10,0
"820700210","SANTA FE",145,1,50,89,2,141,0.00689655172413793
"820420203","SANTA FE",58,0,23,32,0,55,0
"820844514","SANTA FE",354,310,28,16,0,44,0.875706214689266
"820700206","SANTA FE",69,0,25,42,1,68,0
"821330107","SANTA FE",65,2,9,38,11,58,0.0307692307692308
"820420209","SANTA FE",35,2,17,16,0,33,0.0571428571428571
"821260217","SANTA FE",387,3,274,95,12,381,0.00775193798449612
"820844414","SANTA FE",242,208,7,3,0,10,0.859504132231405
"820560312","SANTA FE",96,1,21,73,1,95,0.0104166666666667
"820490412","SANTA FE",134,1,36,63,19,118,0.00746268656716418
"820140515","SANTA FE",24,0,1,21,1,23,0
"821120302","SANTA FE",43,2,21,18,2,41,0.0465116279069767
"820490802","SANTA FE",64,0,0,26,23,49,0
"820210328","SANTA FE",47,0,7,39,1,47,0
"820140125","SANTA FE",20,0,6,14,0,20,0
"821190401","SANTA FE",43,3,5,30,3,38,0.0697674418604651
"820140520","SANTA FE",10,0,3,7,0,10,0
"820210120","SANTA FE",78,0,20,50,3,73,0
"820140122","SANTA FE",17,0,1,15,1,17,0
"820420320","SANTA FE",27,1,4,21,0,25,0.037037037037037
"820490317","SANTA FE",23,0,8,7,6,21,0
"820070104","SANTA FE",71,1,46,22,1,69,0.0140845070422535
"821050219","SANTA FE",56,1,19,31,3,53,0.0178571428571429
"820420124","SANTA FE",112,0,62,47,0,109,0
"820560201","SANTA FE",178,28,69,79,0,148,0.157303370786517
"820140120","SANTA FE",35,0,9,26,0,35,0
"820490811","SANTA FE",0,0,0,0,0,0,NA
"820844006","SANTA FE",265,262,3,0,0,3,0.988679245283019
"820910608","SANTA FE",476,3,275,152,25,452,0.00630252100840336
"820420307","SANTA FE",46,0,26,18,2,46,0
"820350201","SANTA FE",5,0,0,5,0,5,0
"820350106","SANTA FE",213,0,21,113,52,186,0
"820350103","SANTA FE",64,0,16,23,16,55,0
"820630218","SANTA FE",53,0,19,31,0,50,0
"821050114","SANTA FE",262,1,164,92,2,258,0.00381679389312977
"820630202","SANTA FE",37,0,17,17,1,35,0
"820490407","SANTA FE",33,13,0,3,7,10,0.393939393939394
"820490508","SANTA FE",60,0,18,33,4,55,0
"820490111","SANTA FE",68,1,11,40,11,62,0.0147058823529412
"820630203","SANTA FE",22,0,7,14,0,21,0
"820980104","SANTA FE",19,0,11,6,0,17,0
"820700519","SANTA FE",107,0,22,83,0,105,0
"821199601","SANTA FE",2,0,0,2,0,2,0
"820910218","SANTA FE",39,0,27,11,1,39,0
"820280118","SANTA FE",20,0,1,18,0,19,0
"820847701","SANTA FE",56,1,16,33,6,55,0.0178571428571429
"821050107","SANTA FE",145,2,87,47,5,139,0.0137931034482759
"820280106","SANTA FE",20,0,7,13,0,20,0
"821330617","SANTA FE",294,4,89,144,12,245,0.0136054421768707
"821050115","SANTA FE",307,2,84,169,37,290,0.00651465798045603
"820910202","SANTA FE",76,0,37,30,7,74,0
"820210331","SANTA FE",47,0,23,20,2,45,0
"820846701","SANTA FE",134,0,55,78,0,133,0
"820210126","SANTA FE",55,0,8,44,1,53,0
"820350202","SANTA FE",556,0,158,357,13,528,0
"820632801","SANTA FE",314,221,53,37,0,90,0.703821656050955
"820560308","SANTA FE",215,1,68,116,7,191,0.00465116279069767
"820140128","SANTA FE",64,0,39,25,0,64,0
"820070102","SANTA FE",118,0,36,77,2,115,0
"820420117","SANTA FE",121,1,55,60,2,117,0.00826446280991736
"820846115","SANTA FE",586,35,78,438,13,529,0.0597269624573379
"820846108","SANTA FE",389,12,47,316,1,364,0.0308483290488432
"820846106","SANTA FE",251,10,108,133,0,241,0.0398406374501992
"820210620","SANTA FE",406,305,61,40,0,101,0.751231527093596
"820210619","SANTA FE",452,345,36,66,1,103,0.763274336283186
"821330534","SANTA FE",251,35,71,136,7,214,0.139442231075697
"820844608","SANTA FE",303,285,16,2,0,18,0.940594059405941
"820848904","SANTA FE",350,4,103,219,2,324,0.0114285714285714
"820848007","SANTA FE",250,239,0,0,0,0,0.956
"820847711","SANTA FE",379,339,19,17,0,36,0.894459102902375
"820843309","SANTA FE",460,109,93,257,0,350,0.23695652173913
"820847716","SANTA FE",288,275,4,7,0,11,0.954861111111111
"820840405","SANTA FE",381,336,28,17,0,45,0.881889763779528
"820700708","SANTA FE",499,231,99,163,0,262,0.462925851703407
"820840206","SANTA FE",598,3,226,360,2,588,0.00501672240802676
"820630326","SANTA FE",311,0,155,148,2,305,0
"820844416","SANTA FE",327,313,6,6,0,12,0.957186544342508
"820840401","SANTA FE",162,78,7,76,0,83,0.481481481481481
"820840207","SANTA FE",252,2,147,100,0,247,0.00793650793650794
"820840103","SANTA FE",641,1,404,225,4,633,0.0015600624024961
"820770408","SANTA FE",44,0,19,19,5,43,0
"820630305","SANTA FE",208,3,94,108,1,203,0.0144230769230769
"820560113","SANTA FE",133,1,63,67,2,132,0.0075187969924812
"820491004","SANTA FE",349,341,7,0,0,7,0.977077363896848
"820491001","SANTA FE",280,279,1,0,0,1,0.996428571428571
"821190903","SANTA FE",279,13,153,104,6,263,0.046594982078853
"821191013","SANTA FE",278,271,2,4,0,6,0.974820143884892
"821190714","SANTA FE",268,89,93,86,0,179,0.332089552238806
"821190202","SANTA FE",446,350,25,68,0,93,0.7847533632287
"821120415","SANTA FE",477,272,135,69,0,204,0.570230607966457
"060561305","BUENOS AIRES",178,178,0,0,0,0,1
"821190102","SANTA FE",595,10,289,272,4,565,0.0168067226890756
"821120209","SANTA FE",463,450,2,5,0,7,0.971922246220302
"821120208","SANTA FE",237,1,94,135,1,230,0.00421940928270042
"821050216","SANTA FE",28,0,23,5,0,28,0
"820490513","SANTA FE",384,370,0,5,0,5,0.963541666666667
"820560404","SANTA FE",271,264,4,1,0,5,0.974169741697417
"820632610","SANTA FE",244,244,0,0,0,0,1
"820700316","SANTA FE",290,242,26,22,0,48,0.83448275862069
"820700315","SANTA FE",481,3,237,232,0,469,0.00623700623700624
"820844804","SANTA FE",282,231,16,20,0,36,0.819148936170213
"820844709","SANTA FE",236,214,2,15,0,17,0.906779661016949
"820844708","SANTA FE",270,215,16,23,2,41,0.796296296296296
"820841906","SANTA FE",208,200,0,0,7,7,0.961538461538462
"820841905","SANTA FE",197,196,1,0,0,1,0.99492385786802
"065950302","BUENOS AIRES",303,299,3,1,0,4,0.986798679867987
"820844401","SANTA FE",373,368,3,1,1,5,0.986595174262735
"820844314","SANTA FE",375,357,10,8,0,18,0.952
"820844311","SANTA FE",299,294,1,3,0,4,0.983277591973244
"820844209","SANTA FE",349,327,12,7,0,19,0.936962750716332
"820844204","SANTA FE",232,199,3,25,2,30,0.857758620689655
"820844107","SANTA FE",351,346,3,0,0,3,0.985754985754986
"820843919","SANTA FE",201,199,2,0,0,2,0.990049751243781
"820910503","SANTA FE",273,0,210,37,17,264,0
"820910501","SANTA FE",296,67,136,66,14,216,0.226351351351351
"820910406","SANTA FE",39,0,11,18,5,34,0
"820210101","SANTA FE",55,0,26,25,4,55,0
"820843803","SANTA FE",299,296,1,0,0,1,0.989966555183946
"820910208","SANTA FE",21,0,10,8,1,19,0
"820843715","SANTA FE",252,252,0,0,0,0,1
"820843713","SANTA FE",327,326,1,0,0,1,0.996941896024465
"820843712","SANTA FE",340,332,4,1,0,5,0.976470588235294
"820843809","SANTA FE",209,209,0,0,0,0,1
"820843207","SANTA FE",290,85,51,149,0,200,0.293103448275862
"820848609","SANTA FE",373,43,81,233,3,317,0.115281501340483
"820848314","SANTA FE",366,325,12,28,0,40,0.887978142076503
"820843205","SANTA FE",308,284,10,12,1,23,0.922077922077922
"820846602","SANTA FE",864,708,39,99,6,144,0.819444444444444
"820846406","SANTA FE",198,0,99,89,1,189,0
"820846308","SANTA FE",379,4,92,253,1,346,0.0105540897097625
"820844615","SANTA FE",223,105,23,88,2,113,0.47085201793722
"820843111","SANTA FE",328,267,26,25,0,51,0.814024390243902
"820843914","SANTA FE",149,149,0,0,0,0,1
"821190706","SANTA FE",327,167,70,89,1,160,0.510703363914373
"820843909","SANTA FE",212,212,0,0,0,0,1
"821120418","SANTA FE",240,4,50,180,1,231,0.0166666666666667
"820843312","SANTA FE",396,19,109,265,0,374,0.047979797979798
"820843109","SANTA FE",202,182,15,5,0,20,0.900990099009901
"820843108","SANTA FE",269,219,21,27,0,48,0.814126394052045
"820843107","SANTA FE",192,159,15,18,0,33,0.828125
"820843012","SANTA FE",277,28,79,167,0,246,0.101083032490975
"820843010","SANTA FE",368,326,34,7,0,41,0.885869565217391
"820843009","SANTA FE",367,286,44,36,0,80,0.779291553133515
"820843005","SANTA FE",319,179,62,77,0,139,0.561128526645768
"820843003","SANTA FE",613,246,186,168,1,355,0.401305057096248
"820840414","SANTA FE",279,225,33,21,0,54,0.806451612903226
"820840413","SANTA FE",333,66,94,167,2,263,0.198198198198198
"820633507","SANTA FE",318,317,1,0,0,1,0.99685534591195
"820633502","SANTA FE",268,244,8,14,0,22,0.91044776119403
"820845921","SANTA FE",494,5,82,387,2,471,0.0101214574898785
"820843119","SANTA FE",267,215,28,24,0,52,0.805243445692884
"820845410","SANTA FE",165,13,103,49,0,152,0.0787878787878788
"820843118","SANTA FE",271,222,32,14,0,46,0.819188191881919
"820843116","SANTA FE",328,299,19,9,0,28,0.911585365853659
"820845103","SANTA FE",310,305,4,1,0,5,0.983870967741935
"820842712","SANTA FE",353,353,0,0,0,0,1
"820842711","SANTA FE",226,226,0,0,0,0,1
"820490810","SANTA FE",238,7,55,134,30,219,0.0294117647058824
"820842710","SANTA FE",265,265,0,0,0,0,1
"820842922","SANTA FE",151,151,0,0,0,0,1
"820842921","SANTA FE",160,159,0,0,0,0,0.99375
"820842915","SANTA FE",315,313,2,0,0,2,0.993650793650794
"820842706","SANTA FE",151,151,0,0,0,0,1
"820842701","SANTA FE",311,308,2,0,1,3,0.990353697749196
"820842604","SANTA FE",334,330,1,0,0,1,0.988023952095808
"820490333","SANTA FE",338,192,65,68,7,140,0.568047337278107
"820842514","SANTA FE",86,86,0,0,0,0,1
"065950304","BUENOS AIRES",317,316,1,0,0,1,0.996845425867508
"820421112","SANTA FE",219,1,79,136,2,217,0.0045662100456621
"820842508","SANTA FE",337,321,1,0,0,1,0.952522255192878
"820842501","SANTA FE",244,244,0,0,0,0,1
"820140419","SANTA FE",352,170,52,129,1,182,0.482954545454545
"820842902","SANTA FE",359,357,1,1,0,2,0.994428969359331
"820630303","SANTA FE",167,0,81,85,0,166,0
"820842717","SANTA FE",156,156,0,0,0,0,1
"820842107","SANTA FE",294,241,3,0,0,3,0.819727891156463
"820842001","SANTA FE",212,212,0,0,0,0,1
"820842306","SANTA FE",258,258,0,0,0,0,1
"820842305","SANTA FE",276,274,2,0,0,2,0.992753623188406
"820280303","SANTA FE",359,341,7,9,0,16,0.949860724233983
"820842213","SANTA FE",190,190,0,0,0,0,1
"820842208","SANTA FE",303,303,0,0,0,0,1
"820210507","SANTA FE",242,235,3,3,0,6,0.971074380165289
"820842206","SANTA FE",304,304,0,0,0,0,1
"820842204","SANTA FE",4,0,0,0,0,0,0
"820841608","SANTA FE",215,211,2,0,0,2,0.981395348837209
"820841602","SANTA FE",344,343,1,0,0,1,0.997093023255814
"820841505","SANTA FE",244,240,4,0,0,4,0.983606557377049
"820841313","SANTA FE",449,410,27,11,0,38,0.913140311804009
"820841309","SANTA FE",212,185,8,19,0,27,0.872641509433962
"820841306","SANTA FE",328,249,22,42,0,64,0.759146341463415
"820841710","SANTA FE",287,285,1,0,0,1,0.993031358885017
"820841709","SANTA FE",314,312,2,0,0,2,0.993630573248408
"820841405","SANTA FE",270,262,5,1,0,6,0.97037037037037
"820841219","SANTA FE",240,69,91,75,0,166,0.2875
"820843617","SANTA FE",199,195,4,0,0,4,0.979899497487437
"820843615","SANTA FE",203,198,2,3,0,5,0.975369458128079
"820843505","SANTA FE",323,293,17,13,0,30,0.907120743034056
"820843608","SANTA FE",333,331,2,0,0,2,0.993993993993994
"820843607","SANTA FE",267,264,3,0,0,3,0.98876404494382
"820843602","SANTA FE",240,231,7,2,0,9,0.9625
"820843515","SANTA FE",416,274,76,64,0,140,0.658653846153846
"820843512","SANTA FE",467,48,102,301,2,405,0.102783725910064
"820845203","SANTA FE",392,19,171,200,0,371,0.048469387755102
"820845113","SANTA FE",189,151,9,29,0,38,0.798941798941799
"820843316","SANTA FE",368,37,103,223,0,326,0.10054347826087
"820845008","SANTA FE",373,30,131,203,0,334,0.0804289544235925
"820845006","SANTA FE",379,8,112,257,0,369,0.0211081794195251
"820844914","SANTA FE",391,9,72,261,41,374,0.0230179028132992
"820844912","SANTA FE",344,164,27,134,8,169,0.476744186046512
"820210607","SANTA FE",449,438,9,2,0,11,0.975501113585746
"820210605","SANTA FE",374,368,6,0,0,6,0.983957219251337
"820844813","SANTA FE",414,37,159,211,1,371,0.0893719806763285
"820845210","SANTA FE",278,251,1,21,4,26,0.902877697841727
"820210318","SANTA FE",366,0,173,174,10,357,0
"420210504","LA PAMPA",257,252,2,3,0,5,0.980544747081712
"820210209","SANTA FE",422,402,11,7,0,18,0.95260663507109
"820210205","SANTA FE",456,341,27,81,3,111,0.74780701754386
"820210402","SANTA FE",298,260,14,20,0,34,0.87248322147651
"820210201","SANTA FE",425,377,20,24,1,45,0.887058823529412
"821050419","SANTA FE",489,479,4,5,0,9,0.979550102249489
"820630511","SANTA FE",347,3,151,189,0,340,0.00864553314121038
"820848807","SANTA FE",475,11,102,340,6,448,0.0231578947368421
"820210421","SANTA FE",207,190,4,11,0,15,0.917874396135266
"820210407","SANTA FE",147,139,5,0,3,8,0.945578231292517
"820210406","SANTA FE",426,14,179,231,0,410,0.0328638497652582
"820210332","SANTA FE",89,0,79,10,0,89,0
"820210118","SANTA FE",249,1,185,55,5,245,0.00401606425702811
"820420502","SANTA FE",375,91,169,111,1,281,0.242666666666667
"820140606","SANTA FE",262,132,80,46,2,128,0.50381679389313
"820140604","SANTA FE",356,329,4,21,2,27,0.924157303370786
"820848706","SANTA FE",551,414,8,113,2,123,0.751361161524501
"821050414","SANTA FE",444,318,45,79,0,124,0.716216216216216
"820140507","SANTA FE",306,108,147,50,0,197,0.352941176470588
"820848708","SANTA FE",434,390,24,17,3,44,0.898617511520737
"820420920","SANTA FE",316,59,159,91,4,254,0.186708860759494
"820140210","SANTA FE",338,336,1,1,0,2,0.994082840236686
"820140206","SANTA FE",322,317,2,3,0,5,0.984472049689441
"820140204","SANTA FE",491,437,9,40,0,49,0.890020366598778
"820420916","SANTA FE",525,363,49,105,0,154,0.691428571428571
"820421006","SANTA FE",261,168,45,48,0,93,0.64367816091954
"065950305","BUENOS AIRES",261,259,2,0,0,2,0.992337164750958
"820420906","SANTA FE",545,213,95,230,1,326,0.390825688073395
"820420721","SANTA FE",232,182,23,23,2,48,0.78448275862069
"820420718","SANTA FE",258,243,7,8,0,15,0.941860465116279
"820420902","SANTA FE",292,140,92,58,0,150,0.479452054794521
"820420702","SANTA FE",262,11,78,162,2,242,0.0419847328244275
"820848701","SANTA FE",107,105,1,1,0,2,0.981308411214953
"820420605","SANTA FE",328,189,73,66,0,139,0.576219512195122
"820420603","SANTA FE",384,303,30,46,0,76,0.7890625
"820420601","SANTA FE",307,195,35,64,0,99,0.635179153094462
"820420505","SANTA FE",279,121,124,34,0,158,0.433691756272401
"820420919","SANTA FE",372,0,126,226,6,358,0
"820420917","SANTA FE",349,199,40,103,0,143,0.570200573065903
"820140311","SANTA FE",298,254,14,24,0,38,0.852348993288591
"820140308","SANTA FE",259,246,8,1,0,9,0.94980694980695
"820848611","SANTA FE",332,298,4,27,0,31,0.897590361445783
"820420614","SANTA FE",262,252,6,4,0,10,0.961832061068702
"820420612","SANTA FE",307,296,6,5,0,11,0.964169381107492
"820420610","SANTA FE",431,388,20,20,0,40,0.900232018561485
"820420318","SANTA FE",391,5,162,197,2,361,0.0127877237851662
"820420310","SANTA FE",232,0,146,85,0,231,0
"820848601","SANTA FE",275,31,150,93,0,243,0.112727272727273
"820848516","SANTA FE",235,194,28,13,0,41,0.825531914893617
"820070208","SANTA FE",520,342,73,87,2,162,0.657692307692308
"821050406","SANTA FE",266,266,0,0,0,0,1
"820840608","SANTA FE",294,294,0,0,0,0,1
"820631408","SANTA FE",312,309,2,1,0,3,0.990384615384615
"820140113","SANTA FE",313,86,127,98,0,225,0.274760383386581
"820140104","SANTA FE",230,143,56,31,0,87,0.621739130434783
"820848412","SANTA FE",586,357,84,132,1,217,0.609215017064846
"821050412","SANTA FE",409,391,5,12,0,17,0.9559902200489
"821050402","SANTA FE",291,273,0,18,0,18,0.938144329896907
"820420103","SANTA FE",283,0,158,122,1,281,0
"820350211","SANTA FE",546,0,182,349,4,535,0
"820840516","SANTA FE",311,291,9,2,0,11,0.935691318327974
"820070211","SANTA FE",392,294,41,51,0,92,0.75
"820420208","SANTA FE",243,1,83,139,1,223,0.00411522633744856
"820848409","SANTA FE",562,552,8,0,0,8,0.98220640569395
"820631106","SANTA FE",634,55,98,456,11,565,0.0867507886435331
"820630805","SANTA FE",241,235,3,3,0,6,0.975103734439834
"820630803","SANTA FE",257,241,11,4,0,15,0.937743190661479
"820630801","SANTA FE",241,233,4,4,0,8,0.966804979253112
"820630701","SANTA FE",302,118,15,126,14,155,0.390728476821192
"820630512","SANTA FE",233,2,66,157,6,229,0.00858369098712446
"820840513","SANTA FE",225,185,28,12,0,40,0.822222222222222
"820840511","SANTA FE",297,254,31,12,0,43,0.855218855218855
"820848407","SANTA FE",165,97,23,45,0,68,0.587878787878788
"820840311","SANTA FE",505,119,59,290,17,366,0.235643564356436
"820842321","SANTA FE",123,123,0,0,0,0,1
"820630502","SANTA FE",442,8,136,292,3,431,0.0180995475113122
"820840506","SANTA FE",334,295,33,6,0,39,0.883233532934132
"820840504","SANTA FE",131,109,17,4,0,21,0.83206106870229
"820848404","SANTA FE",525,38,226,255,0,481,0.0723809523809524
"820840209","SANTA FE",467,2,272,192,1,465,0.00428265524625268
"820848308","SANTA FE",364,303,31,24,5,60,0.832417582417582
"421330508","LA PAMPA",283,114,149,20,0,169,0.402826855123675
"820848401","SANTA FE",320,7,78,225,6,309,0.021875
"820280517","SANTA FE",436,421,5,5,0,10,0.965596330275229
"820280516","SANTA FE",258,247,8,2,0,10,0.957364341085271
"820280511","SANTA FE",457,442,5,7,1,13,0.967177242888403
"820280402","SANTA FE",283,216,6,53,1,60,0.763250883392226
"821050227","SANTA FE",250,0,178,65,5,248,0
"820630616","SANTA FE",291,276,9,5,0,14,0.948453608247423
"821260510","SANTA FE",333,290,34,7,1,42,0.870870870870871
"820491010","SANTA FE",377,31,183,159,0,342,0.0822281167108753
"821190303","SANTA FE",265,264,0,0,0,0,0.99622641509434
"820633411","SANTA FE",289,0,128,158,0,286,0
"820630316","SANTA FE",384,8,46,302,5,353,0.0208333333333333
"821050304","SANTA FE",248,210,25,13,0,38,0.846774193548387
"821330313","SANTA FE",504,10,257,177,24,458,0.0198412698412698
"820280411","SANTA FE",289,279,3,3,0,6,0.965397923875433
"820280410","SANTA FE",491,448,15,28,0,43,0.912423625254583
"820280307","SANTA FE",364,3,189,172,0,361,0.00824175824175824
"820910405","SANTA FE",24,0,9,13,2,24,0
"820842620","SANTA FE",198,198,0,0,0,0,1
"820910322","SANTA FE",438,157,187,86,3,276,0.358447488584475
"820910320","SANTA FE",237,45,149,32,6,187,0.189873417721519
"820848310","SANTA FE",205,183,15,7,0,22,0.892682926829268
"820700218","SANTA FE",353,122,131,96,0,227,0.345609065155807
"820842319","SANTA FE",218,218,0,0,0,0,1
"820633408","SANTA FE",218,0,101,114,2,217,0
"820633407","SANTA FE",264,0,152,108,2,262,0
"820633406","SANTA FE",545,9,225,309,1,535,0.0165137614678899
"820633401","SANTA FE",725,44,386,282,3,671,0.0606896551724138
"820633310","SANTA FE",276,4,81,179,4,264,0.0144927536231884
"420630107","LA PAMPA",98,0,20,50,3,73,0
"820633309","SANTA FE",226,21,86,115,1,202,0.0929203539823009
"820633305","SANTA FE",260,7,67,183,0,250,0.0269230769230769
"820700417","SANTA FE",633,25,357,243,2,602,0.0394944707740916
"820633202","SANTA FE",315,2,95,217,0,312,0.00634920634920635
"820490711","SANTA FE",264,260,0,4,0,4,0.984848484848485
"820490516","SANTA FE",419,389,13,10,2,25,0.928400954653938
"820630209","SANTA FE",275,4,206,53,0,259,0.0145454545454545
"820490903","SANTA FE",123,0,41,68,5,114,0
"820848115","SANTA FE",103,102,1,0,0,1,0.990291262135922
"820633107","SANTA FE",402,17,157,221,2,380,0.0422885572139304
"820490717","SANTA FE",484,7,282,190,2,474,0.0144628099173554
"820633010","SANTA FE",413,389,16,8,0,24,0.941888619854721
"820630201","SANTA FE",95,0,56,38,0,94,0
"820630129","SANTA FE",562,2,159,375,12,546,0.00355871886120996
"820632829","SANTA FE",292,5,134,147,2,283,0.0171232876712329
"820848212","SANTA FE",367,15,83,261,2,346,0.0408719346049046
"820490330","SANTA FE",319,227,45,35,0,80,0.711598746081505
"820632814","SANTA FE",468,0,187,273,3,463,0
"421330211","LA PAMPA",180,163,9,6,0,15,0.905555555555556
"820632715","SANTA FE",373,170,118,81,2,201,0.455764075067024
"820840907","SANTA FE",720,486,43,156,14,213,0.675
"820632504","SANTA FE",197,196,1,0,0,1,0.99492385786802
"820632503","SANTA FE",403,402,1,0,0,1,0.997518610421836
"820840902","SANTA FE",355,341,5,9,0,14,0.96056338028169
"820632404","SANTA FE",236,235,1,0,0,1,0.995762711864407
"420560505","LA PAMPA",27,0,12,15,0,27,0
"820490213","SANTA FE",247,34,75,111,12,198,0.137651821862348
"820840809","SANTA FE",312,309,3,0,0,3,0.990384615384615
"820840806","SANTA FE",314,307,2,4,0,6,0.977707006369427
"820632308","SANTA FE",372,372,0,0,0,0,1
"820840803","SANTA FE",303,300,3,0,0,3,0.99009900990099
"820632302","SANTA FE",314,312,2,0,0,2,0.993630573248408
"820632209","SANTA FE",273,272,1,0,0,1,0.996336996336996
"820632201","SANTA FE",221,218,3,0,0,3,0.986425339366516
"820632108","SANTA FE",258,256,1,0,1,2,0.992248062015504
"820632101","SANTA FE",328,325,3,0,0,3,0.990853658536585
"820632002","SANTA FE",121,121,0,0,0,0,1
"421330212","LA PAMPA",115,110,5,0,0,5,0.956521739130435
"820630107","SANTA FE",299,0,120,169,6,295,0
"820631902","SANTA FE",253,133,74,46,0,120,0.525691699604743
"820631714","SANTA FE",340,339,1,0,0,1,0.997058823529412
"820631704","SANTA FE",173,170,2,1,0,3,0.982658959537572
"820631509","SANTA FE",266,254,5,7,0,12,0.954887218045113
"421190210","LA PAMPA",10,0,9,1,0,10,0
"820631314","SANTA FE",282,268,7,7,0,14,0.950354609929078
"820631206","SANTA FE",161,12,55,72,17,144,0.0745341614906832
"820631212","SANTA FE",302,295,3,2,2,7,0.97682119205298
"820848120","SANTA FE",266,201,27,33,0,60,0.755639097744361
"820840701","SANTA FE",268,22,52,188,0,240,0.082089552238806
"820840624","SANTA FE",154,135,0,19,0,19,0.876623376623377
"820841814","SANTA FE",221,221,0,0,0,0,1
"820848105","SANTA FE",224,223,1,0,0,1,0.995535714285714
"820560505","SANTA FE",382,369,6,6,0,12,0.965968586387435
"820848101","SANTA FE",331,300,20,11,0,31,0.906344410876133
"820560409","SANTA FE",328,326,2,0,0,2,0.99390243902439
"820845707","SANTA FE",220,4,162,54,0,216,0.0181818181818182
"820845419","SANTA FE",170,160,6,4,0,10,0.941176470588235
"820845414","SANTA FE",350,280,48,16,6,70,0.8
"820845409","SANTA FE",276,59,70,146,0,216,0.213768115942029
"820845403","SANTA FE",209,197,10,2,0,12,0.942583732057416
"820845401","SANTA FE",134,126,6,2,0,8,0.940298507462687
"820845323","SANTA FE",562,526,5,1,0,6,0.935943060498221
"820845316","SANTA FE",259,248,5,6,0,11,0.957528957528958
"421330503","LA PAMPA",205,76,113,16,0,129,0.370731707317073
"820845212","SANTA FE",285,233,5,23,1,29,0.817543859649123
"821190908","SANTA FE",241,237,2,0,2,4,0.983402489626556
"820841013","SANTA FE",347,43,113,185,1,299,0.123919308357349
"820841012","SANTA FE",507,44,171,283,0,454,0.0867850098619329
"820841007","SANTA FE",670,68,90,474,5,569,0.101492537313433
"820841005","SANTA FE",338,30,51,229,4,284,0.0887573964497041
"821190517","SANTA FE",201,2,129,70,0,199,0.00995024875621891
"820421118","SANTA FE",307,0,170,130,3,303,0
"821190510","SANTA FE",417,48,165,196,0,361,0.115107913669065
"821190508","SANTA FE",300,2,123,173,1,297,0.00666666666666667
"821190507","SANTA FE",468,5,186,263,4,453,0.0106837606837607
"820846303","SANTA FE",401,6,94,287,1,382,0.0149625935162095
"820280109","SANTA FE",217,3,138,72,2,212,0.0138248847926267
"820848903","SANTA FE",526,10,127,362,2,491,0.0190114068441065
"421050204","LA PAMPA",13,0,6,7,0,13,0
"820280101","SANTA FE",535,405,59,59,0,118,0.757009345794392
"820211015","SANTA FE",397,4,237,155,1,393,0.0100755667506297
"820211012","SANTA FE",80,0,50,28,2,80,0
"820846205","SANTA FE",412,17,79,288,9,376,0.0412621359223301
"820210810","SANTA FE",364,325,13,21,0,34,0.892857142857143
"820210720","SANTA FE",294,1,209,75,1,285,0.00340136054421769
"820210705","SANTA FE",33,0,8,23,2,33,0
"821330102","SANTA FE",41,0,8,19,7,34,0
"421260207","LA PAMPA",85,0,61,24,0,85,0
"821330610","SANTA FE",21,0,9,6,4,19,0
"821330516","SANTA FE",12,0,0,9,1,10,0
"821330318","SANTA FE",44,0,15,18,8,41,0
"821330314","SANTA FE",66,0,14,48,2,64,0
"821190817","SANTA FE",59,1,23,34,0,57,0.0169491525423729
"821190103","SANTA FE",40,1,11,24,1,36,0.025
"820846003","SANTA FE",14,0,3,10,1,14,0
"820700106","SANTA FE",28,0,8,20,0,28,0
"821330211","SANTA FE",51,0,4,23,13,40,0
"821260212","SANTA FE",61,2,34,21,2,57,0.0327868852459016
"820630227","SANTA FE",84,0,34,39,7,80,0
"821120309","SANTA FE",30,0,2,24,3,29,0
"821120107","SANTA FE",57,0,14,34,1,49,0
"821050205","SANTA FE",53,38,9,6,0,15,0.716981132075472
"820845906","SANTA FE",203,57,47,84,4,135,0.280788177339901
"820980109","SANTA FE",11,0,7,4,0,11,0
"820910307","SANTA FE",98,0,49,39,9,97,0
"820910212","SANTA FE",36,0,18,16,0,34,0
"820847904","SANTA FE",4,0,0,4,0,4,0
"820847401","SANTA FE",96,0,61,32,3,96,0
"421050202","LA PAMPA",29,0,10,19,0,29,0
"820845806","SANTA FE",7,0,2,5,0,7,0
"820700212","SANTA FE",98,0,35,63,0,98,0
"820770311","SANTA FE",91,0,20,46,19,85,0
"820700202","SANTA FE",164,25,47,83,4,134,0.152439024390244
"820490208","SANTA FE",12,0,0,9,0,9,0
"820845919","SANTA FE",4,0,2,2,0,4,0
"820140611","SANTA FE",27,0,5,22,0,27,0
"820210102","SANTA FE",21,0,3,18,0,21,0
"821330104","SANTA FE",24,0,4,8,3,15,0
"420560516","LA PAMPA",245,238,6,1,0,7,0.971428571428571
"820280218","SANTA FE",13,0,2,11,0,13,0
"820560106","SANTA FE",109,4,41,55,3,99,0.036697247706422
"820350115","SANTA FE",21,0,3,13,0,16,0
"820350110","SANTA FE",151,0,42,90,2,134,0
"820350105","SANTA FE",16,0,1,13,0,14,0
"820980310","SANTA FE",180,0,25,126,12,163,0
"820490818","SANTA FE",138,2,59,66,5,130,0.0144927536231884
"820560302","SANTA FE",149,36,49,61,1,111,0.241610738255034
"820490211","SANTA FE",8,0,5,3,0,8,0
"820847801","SANTA FE",11,0,5,5,0,10,0
"820630115","SANTA FE",51,0,30,16,2,48,0
"820490309","SANTA FE",10,0,6,3,0,9,0
"820910315","SANTA FE",149,0,94,46,6,146,0
"820490506","SANTA FE",78,2,22,35,16,73,0.0256410256410256
"820490505","SANTA FE",77,0,30,40,0,70,0
"820490419","SANTA FE",3,0,1,0,0,1,0
"821199403","SANTA FE",5,0,1,3,0,4,0
"065950308","BUENOS AIRES",255,251,3,1,0,4,0.984313725490196
"820630113","SANTA FE",41,0,16,25,0,41,0
"820630112","SANTA FE",89,0,29,58,0,87,0
"820490209","SANTA FE",28,0,5,20,2,27,0
"820490206","SANTA FE",10,0,5,2,2,9,0
"820630111","SANTA FE",164,0,18,115,14,147,0
"820700608","SANTA FE",113,1,34,76,2,112,0.00884955752212389
"820560211","SANTA FE",81,1,43,35,1,79,0.0123456790123457
"421120312","LA PAMPA",296,7,120,136,9,265,0.0236486486486486
"421400202","LA PAMPA",199,115,37,39,1,77,0.577889447236181
"420560506","LA PAMPA",124,29,29,58,4,91,0.233870967741935
"420490103","LA PAMPA",161,0,64,77,9,150,0
"421540601","LA PAMPA",115,3,80,30,2,112,0.0260869565217391
"420280102","LA PAMPA",20,0,2,15,0,17,0
"063573405","BUENOS AIRES",176,176,0,0,0,0,1
"421540517","LA PAMPA",241,214,19,8,0,27,0.887966804979253
"421540504","LA PAMPA",212,60,49,94,0,143,0.283018867924528
"421470109","LA PAMPA",196,9,150,37,0,187,0.0459183673469388
"421400216","LA PAMPA",166,1,128,37,0,165,0.00602409638554217
"421400215","LA PAMPA",140,1,85,54,0,139,0.00714285714285714
"421400209","LA PAMPA",203,162,19,20,0,39,0.798029556650246
"421400205","LA PAMPA",174,133,20,20,0,40,0.764367816091954
"421400203","LA PAMPA",178,140,11,23,1,35,0.786516853932584
"068403104","BUENOS AIRES",227,218,4,3,0,7,0.960352422907489
"421260102","LA PAMPA",241,0,212,26,0,238,0
"421190101","LA PAMPA",212,0,168,42,2,212,0
"421120310","LA PAMPA",45,0,24,21,0,45,0
"421120309","LA PAMPA",181,175,4,0,0,4,0.966850828729282
"421050808","LA PAMPA",229,138,52,39,0,91,0.602620087336245
"421050805","LA PAMPA",316,316,0,0,0,0,1
"421050801","LA PAMPA",428,427,0,0,0,0,0.997663551401869
"421050713","LA PAMPA",280,265,5,5,0,10,0.946428571428571
"421050416","LA PAMPA",154,152,0,0,0,0,0.987012987012987
"421050414","LA PAMPA",235,232,2,1,0,3,0.987234042553191
"421050412","LA PAMPA",199,185,11,3,0,14,0.92964824120603
"421050411","LA PAMPA",212,210,1,1,0,2,0.990566037735849
"421050501","LA PAMPA",131,1,79,48,0,127,0.00763358778625954
"420980401","LA PAMPA",95,0,77,18,0,95,0
"420700201","LA PAMPA",354,1,295,56,2,353,0.00282485875706215
"420350701","LA PAMPA",113,2,85,26,0,111,0.0176991150442478
"420350411","LA PAMPA",141,23,94,23,0,117,0.163120567375887
"420350407","LA PAMPA",215,68,133,14,0,147,0.316279069767442
"420210907","LA PAMPA",331,327,2,2,0,4,0.987915407854985
"420210902","LA PAMPA",301,300,1,0,0,1,0.996677740863787
"420210823","LA PAMPA",149,113,19,17,0,36,0.758389261744966
"420210821","LA PAMPA",299,291,6,2,0,8,0.973244147157191
"420210811","LA PAMPA",201,197,2,0,0,2,0.980099502487562
"420210807","LA PAMPA",259,253,4,0,0,4,0.976833976833977
"420210723","LA PAMPA",254,19,154,70,0,224,0.0748031496062992
"420210717","LA PAMPA",218,217,1,0,0,1,0.995412844036697
"420210601","LA PAMPA",209,179,11,16,0,27,0.856459330143541
"420210509","LA PAMPA",210,199,2,1,0,3,0.947619047619048
"420210408","LA PAMPA",263,261,1,1,0,2,0.992395437262357
"068403107","BUENOS AIRES",303,301,1,1,0,2,0.993399339933993
"420210402","LA PAMPA",225,223,1,0,0,1,0.991111111111111
"420210310","LA PAMPA",292,278,11,3,0,14,0.952054794520548
"420770301","LA PAMPA",241,0,181,57,2,240,0
"420210303","LA PAMPA",275,209,37,25,0,62,0.76
"420210117","LA PAMPA",119,59,24,35,0,59,0.495798319327731
"420210112","LA PAMPA",276,7,161,108,0,269,0.0253623188405797
"420210111","LA PAMPA",272,267,2,2,0,4,0.981617647058823
"420070403","LA PAMPA",177,117,36,24,0,60,0.661016949152542
"420700507","LA PAMPA",282,1,250,30,1,281,0.00354609929078014
"420210610","LA PAMPA",2,2,0,0,0,0,1
"420210818","LA PAMPA",209,199,5,3,0,8,0.952153110047847
"420210817","LA PAMPA",212,210,0,0,0,0,0.990566037735849
"420211006","LA PAMPA",272,270,1,0,0,1,0.992647058823529
"420210614","LA PAMPA",296,294,2,0,0,2,0.993243243243243
"420210612","LA PAMPA",191,191,0,0,0,0,1
"421120303","LA PAMPA",272,269,1,0,0,1,0.988970588235294
"421051005","LA PAMPA",309,307,1,0,0,1,0.993527508090615
"420980106","LA PAMPA",135,4,94,37,0,131,0.0296296296296296
"421470210","LA PAMPA",32,2,13,16,0,29,0.0625
"421330507","LA PAMPA",24,1,14,9,0,23,0.0416666666666667
"421330206","LA PAMPA",19,0,14,5,0,19,0
"421330103","LA PAMPA",13,0,12,1,0,13,0
"421260303","LA PAMPA",8,0,4,2,0,6,0
"421260205","LA PAMPA",109,0,89,19,1,109,0
"421190309","LA PAMPA",1,0,0,1,0,1,0
"421120319","LA PAMPA",5,0,1,0,0,1,0
"421120308","LA PAMPA",286,283,1,0,0,1,0.989510489510489
"420560503","LA PAMPA",197,165,21,11,0,32,0.83756345177665
"420840207","LA PAMPA",4,0,3,1,0,4,0
"421120316","LA PAMPA",9,0,2,3,1,6,0
"421120201","LA PAMPA",25,0,2,15,1,18,0
"421051012","LA PAMPA",348,319,7,3,0,10,0.916666666666667
"421051011","LA PAMPA",254,245,3,3,0,6,0.964566929133858
"420350202","LA PAMPA",78,0,25,47,1,73,0
"420210208","LA PAMPA",14,0,10,4,0,14,0
"420210207","LA PAMPA",12,0,2,10,0,12,0
"420070505","LA PAMPA",15,0,11,3,0,14,0
"420070408","LA PAMPA",9,0,2,7,0,9,0
"420070407","LA PAMPA",17,0,3,14,0,17,0
"420770204","LA PAMPA",17,0,11,5,1,17,0
"420770107","LA PAMPA",21,0,13,8,0,21,0
"420770105","LA PAMPA",10,0,2,8,0,10,0
"420700402","LA PAMPA",51,0,26,20,3,49,0
"420700103","LA PAMPA",89,0,39,48,2,89,0
"420560507","LA PAMPA",25,0,23,2,0,25,0
"420210107","LA PAMPA",28,1,5,20,0,25,0.0357142857142857
"420910105","LA PAMPA",69,0,46,21,0,67,0
"420420305","LA PAMPA",1,0,0,1,0,1,0
"420420104","LA PAMPA",2,0,0,1,0,1,0
"421330210","LA PAMPA",1,0,0,1,0,1,0
"421050203","LA PAMPA",51,0,31,14,1,46,0
"421400223","LA PAMPA",58,0,35,18,5,58,0
"420700505","LA PAMPA",147,0,107,37,0,144,0
"421051010","LA PAMPA",242,236,5,1,0,6,0.975206611570248
"421051007","LA PAMPA",181,174,7,0,0,7,0.961325966850829
"421050711","LA PAMPA",284,250,8,20,0,28,0.880281690140845
"421540511","LA PAMPA",224,135,56,30,0,86,0.602678571428571
"421400204","LA PAMPA",234,180,21,33,0,54,0.769230769230769
"421330703","LA PAMPA",15,0,10,5,0,15,0
"421330601","LA PAMPA",185,1,162,22,0,184,0.00540540540540541
"421330505","LA PAMPA",181,54,99,26,0,125,0.298342541436464
"421260502","LA PAMPA",70,0,67,2,1,70,0
"421260201","LA PAMPA",273,0,213,54,2,269,0
"421260111","LA PAMPA",197,0,150,45,2,197,0
"421190303","LA PAMPA",15,0,8,7,0,15,0
"421190204","LA PAMPA",246,0,204,40,0,244,0
"421050418","LA PAMPA",190,187,1,2,0,3,0.984210526315789
"420350501","LA PAMPA",75,0,52,23,0,75,0
"420350413","LA PAMPA",237,91,93,52,1,146,0.383966244725738
"420350403","LA PAMPA",263,84,152,25,0,177,0.319391634980989
"420350401","LA PAMPA",178,26,114,37,0,151,0.146067415730337
"420211002","LA PAMPA",337,332,3,0,0,3,0.985163204747775
"420210912","LA PAMPA",367,359,2,2,0,4,0.978201634877384
"420210904","LA PAMPA",336,332,3,0,0,3,0.988095238095238
"420210901","LA PAMPA",138,138,0,0,0,0,1
"420210808","LA PAMPA",339,331,7,1,0,8,0.976401179941003
"420210802","LA PAMPA",193,191,2,0,0,2,0.989637305699482
"420210715","LA PAMPA",319,317,2,0,0,2,0.993730407523511
"420210507","LA PAMPA",372,364,5,1,0,6,0.978494623655914
"420210502","LA PAMPA",366,353,3,6,1,10,0.96448087431694
"420210405","LA PAMPA",210,204,5,1,0,6,0.971428571428571
"420140201","LA PAMPA",209,0,173,36,0,209,0
"420070402","LA PAMPA",269,184,66,19,0,85,0.684014869888476
"420070201","LA PAMPA",134,1,95,36,2,133,0.00746268656716418
"420770102","LA PAMPA",3,0,1,2,0,3,0
"420700508","LA PAMPA",214,5,154,54,0,208,0.0233644859813084
"420700503","LA PAMPA",230,0,176,54,0,230,0
"420210609","LA PAMPA",163,163,0,0,0,0,1
"420211003","LA PAMPA",196,190,1,5,0,6,0.969387755102041
"420210705","LA PAMPA",301,301,0,0,0,0,1
"421330214","LA PAMPA",200,171,22,7,0,29,0.855
"420980110","LA PAMPA",190,3,137,49,0,186,0.0157894736842105
"420980108","LA PAMPA",151,1,126,23,0,149,0.00662251655629139
"420770302","LA PAMPA",169,0,142,26,0,168,0
"420070104","LA PAMPA",20,0,12,5,0,17,0
"421540102","LA PAMPA",39,0,20,18,0,38,0
"421470104","LA PAMPA",11,0,2,9,0,11,0
"421400302","LA PAMPA",54,0,10,43,1,54,0
"421330102","LA PAMPA",8,0,3,5,0,8,0
"421260404","LA PAMPA",14,0,5,9,0,14,0
"421190310","LA PAMPA",3,0,1,2,0,3,0
"421190208","LA PAMPA",12,0,5,7,0,12,0
"421190206","LA PAMPA",18,0,18,0,0,18,0
"421120318","LA PAMPA",3,0,0,2,0,2,0
"421120317","LA PAMPA",1,0,1,0,0,1,0
"421050602","LA PAMPA",35,0,19,14,0,33,0
"421050503","LA PAMPA",50,0,30,20,0,50,0
"420350503","LA PAMPA",18,0,3,14,0,17,0
"420210203","LA PAMPA",3,0,1,2,0,3,0
"420210108","LA PAMPA",19,0,10,8,0,18,0
"421330502","LA PAMPA",189,54,126,9,0,135,0.285714285714286
"420560102","LA PAMPA",36,0,17,16,0,33,0
"420420303","LA PAMPA",3,0,1,1,0,2,0
"420140205","LA PAMPA",32,0,16,15,0,31,0
"420210101","LA PAMPA",46,0,15,30,0,45,0
"420070109","LA PAMPA",16,0,7,9,0,16,0
"420770406","LA PAMPA",13,0,8,4,0,12,0
"420770104","LA PAMPA",5,0,2,2,1,5,0
"420700203","LA PAMPA",1,0,0,1,0,1,0
"420560402","LA PAMPA",33,0,19,12,0,31,0
"420560302","LA PAMPA",58,0,34,18,2,54,0
"421260208","LA PAMPA",150,0,117,31,0,148,0
"420420106","LA PAMPA",2,0,0,2,0,2,0
"420350307","LA PAMPA",8,0,5,3,0,8,0
"420770209","LA PAMPA",5,0,2,3,0,5,0
"421330207","LA PAMPA",334,77,233,20,0,253,0.230538922155689
"420630103","LA PAMPA",126,0,57,55,5,117,0
"421050304","LA PAMPA",234,220,7,7,0,14,0.94017094017094
"421540513","LA PAMPA",294,213,53,27,0,80,0.724489795918367
"421540301","LA PAMPA",242,2,170,69,1,240,0.00826446280991736
"421540201","LA PAMPA",148,0,95,53,0,148,0
"420210415","LA PAMPA",209,205,3,0,1,4,0.980861244019139
"421190302","LA PAMPA",290,0,243,46,1,290,0
"421190203","LA PAMPA",295,0,262,31,0,293,0
"421120306","LA PAMPA",321,316,0,0,0,0,0.984423676012461
"421050901","LA PAMPA",239,128,48,62,0,110,0.535564853556485
"421050804","LA PAMPA",366,366,0,0,0,0,1
"421050709","LA PAMPA",301,288,4,9,0,13,0.956810631229236
"421050419","LA PAMPA",187,84,65,36,0,101,0.449197860962567
"421050314","LA PAMPA",156,154,1,1,0,2,0.987179487179487
"421050313","LA PAMPA",192,188,2,2,0,4,0.979166666666667
"421050311","LA PAMPA",212,201,6,5,0,11,0.94811320754717
"420980201","LA PAMPA",217,1,157,56,3,216,0.00460829493087558
"420770203","LA PAMPA",146,0,116,30,0,146,0
"420700104","LA PAMPA",148,5,117,26,0,143,0.0337837837837838
"420560511","LA PAMPA",225,200,17,7,0,24,0.888888888888889
"420560501","LA PAMPA",301,237,46,18,0,64,0.787375415282392
"420560401","LA PAMPA",102,0,81,20,0,101,0
"420560304","LA PAMPA",106,0,82,21,0,103,0
"420560303","LA PAMPA",295,0,265,26,2,293,0
"420350601","LA PAMPA",217,1,171,44,0,215,0.00460829493087558
"420350412","LA PAMPA",263,82,143,38,0,181,0.311787072243346
"420350201","LA PAMPA",143,0,106,32,3,141,0
"420280302","LA PAMPA",215,3,157,55,0,212,0.013953488372093
"420280101","LA PAMPA",148,99,26,22,0,48,0.668918918918919
"420211001","LA PAMPA",329,319,5,1,0,6,0.969604863221885
"420210913","LA PAMPA",263,246,7,10,0,17,0.935361216730038
"420280305","LA PAMPA",221,0,118,100,1,219,0
"420210819","LA PAMPA",208,191,10,7,0,17,0.918269230769231
"420210814","LA PAMPA",261,260,1,0,0,1,0.996168582375479
"421050312","LA PAMPA",243,239,2,2,0,4,0.983539094650206
"420210724","LA PAMPA",185,1,132,43,0,175,0.00540540540540541
"420210815","LA PAMPA",277,261,6,7,1,14,0.942238267148014
"420210721","LA PAMPA",277,258,8,3,0,11,0.931407942238267
"420210719","LA PAMPA",298,281,5,5,1,11,0.942953020134228
"420210718","LA PAMPA",183,183,0,0,0,0,1
"420210716","LA PAMPA",187,187,0,0,0,0,1
"420210714","LA PAMPA",291,289,2,0,0,2,0.993127147766323
"420210605","LA PAMPA",186,185,0,0,0,0,0.994623655913978
"420210515","LA PAMPA",339,337,0,2,0,2,0.994100294985251
"420210506","LA PAMPA",392,387,3,0,0,3,0.987244897959184
"420210704","LA PAMPA",275,273,1,0,0,1,0.992727272727273
"420210414","LA PAMPA",314,309,4,1,0,5,0.984076433121019
"060560113","BUENOS AIRES",241,241,0,0,0,0,1
"420210409","LA PAMPA",16,8,6,2,0,8,0.5
"420210404","LA PAMPA",235,233,0,0,0,0,0.991489361702128
"420210403","LA PAMPA",200,199,0,1,0,1,0.995
"420210311","LA PAMPA",349,339,4,6,0,10,0.97134670487106
"420210209","LA PAMPA",236,2,142,87,0,229,0.00847457627118644
"420210201","LA PAMPA",124,1,100,21,0,121,0.00806451612903226
"420070401","LA PAMPA",272,190,52,27,1,80,0.698529411764706
"420770202","LA PAMPA",184,0,173,10,1,184,0
"420700506","LA PAMPA",37,1,19,17,0,36,0.027027027027027
"420140210","LA PAMPA",235,0,185,50,0,235,0
"421190211","LA PAMPA",180,0,147,33,0,180,0
"421051001","LA PAMPA",298,289,0,9,0,9,0.969798657718121
"421050717","LA PAMPA",332,314,3,15,0,18,0.94578313253012
"420980112","LA PAMPA",24,1,21,2,0,23,0.0416666666666667
"420980103","LA PAMPA",172,4,148,19,1,168,0.0232558139534884
"420980101","LA PAMPA",193,5,130,50,6,186,0.0259067357512953
"421260206","LA PAMPA",8,0,3,5,0,8,0
"420070410","LA PAMPA",4,0,2,2,0,4,0
"420070103","LA PAMPA",8,0,1,7,0,8,0
"421540401","LA PAMPA",38,0,31,7,0,38,0
"421470106","LA PAMPA",16,0,1,13,1,15,0
"421470105","LA PAMPA",7,0,4,3,0,7,0
"421470103","LA PAMPA",3,0,1,2,0,3,0
"421400303","LA PAMPA",4,0,0,4,0,4,0
"421330705","LA PAMPA",11,0,2,9,0,11,0
"421330605","LA PAMPA",8,0,6,2,0,8,0
"421330603","LA PAMPA",6,0,3,3,0,6,0
"421260109","LA PAMPA",17,0,9,7,1,17,0
"421260107","LA PAMPA",20,0,9,11,0,20,0
"421260104","LA PAMPA",8,0,8,0,0,8,0
"421190304","LA PAMPA",3,0,1,2,0,3,0
"421190207","LA PAMPA",5,0,4,1,0,5,0
"421190104","LA PAMPA",14,0,7,7,0,14,0
"420770404","LA PAMPA",11,0,5,4,2,11,0
"420700302","LA PAMPA",28,0,1,25,0,26,0
"420630104","LA PAMPA",1,0,0,1,0,1,0
"420560508","LA PAMPA",14,0,4,8,1,13,0
"060561201","BUENOS AIRES",310,310,0,0,0,0,1
"421120311","LA PAMPA",10,0,0,6,1,7,0
"420910103","LA PAMPA",32,0,5,19,4,28,0
"420350304","LA PAMPA",5,0,1,4,0,5,0
"420350106","LA PAMPA",9,0,6,2,0,8,0
"420210202","LA PAMPA",19,0,6,13,0,19,0
"420140206","LA PAMPA",8,0,4,4,0,8,0
"420140203","LA PAMPA",48,0,32,13,0,45,0
"420140101","LA PAMPA",13,0,12,1,0,13,0
"420070506","LA PAMPA",2,0,0,2,0,2,0
"420070502","LA PAMPA",5,0,2,3,0,5,0
"420070411","LA PAMPA",10,0,3,7,0,10,0
"420840202","LA PAMPA",28,0,9,17,0,26,0
"060352109","BUENOS AIRES",249,236,5,7,0,12,0.947791164658635
"421260405","LA PAMPA",32,0,16,15,1,32,0
"420280202","LA PAMPA",101,0,77,23,1,101,0
"421050410","LA PAMPA",207,206,1,0,0,1,0.995169082125604
"420210909","LA PAMPA",197,197,0,0,0,0,1
"421540503","LA PAMPA",236,160,54,21,1,76,0.677966101694915
"421400214","LA PAMPA",56,52,4,0,0,4,0.928571428571429
"421400212","LA PAMPA",195,104,38,50,1,89,0.533333333333333
"421470216","LA PAMPA",215,143,53,18,0,71,0.665116279069767
"421400210","LA PAMPA",243,132,70,41,0,111,0.54320987654321
"421400207","LA PAMPA",182,130,16,32,0,48,0.714285714285714
"421330701","LA PAMPA",244,5,195,44,0,239,0.0204918032786885
"421330501","LA PAMPA",175,63,98,13,0,111,0.36
"421330401","LA PAMPA",57,0,45,12,0,57,0
"421330205","LA PAMPA",269,234,28,4,0,32,0.869888475836431
"421330203","LA PAMPA",242,220,19,3,0,22,0.909090909090909
"421260112","LA PAMPA",135,0,112,22,0,134,0
"421190401","LA PAMPA",283,0,173,106,1,280,0
"421190202","LA PAMPA",113,0,42,66,2,110,0
"421050905","LA PAMPA",249,249,0,0,0,0,1
"421050904","LA PAMPA",226,213,8,5,0,13,0.942477876106195
"420070203","LA PAMPA",22,0,10,12,0,22,0
"420070106","LA PAMPA",13,0,9,3,0,12,0
"421050708","LA PAMPA",208,207,1,0,0,1,0.995192307692308
"421050408","LA PAMPA",222,209,10,3,0,13,0.941441441441441
"421050403","LA PAMPA",282,277,3,2,0,5,0.982269503546099
"421050402","LA PAMPA",319,316,1,2,0,3,0.990595611285266
"421050310","LA PAMPA",232,228,2,2,0,4,0.982758620689655
"420770410","LA PAMPA",191,0,152,37,1,190,0
"420700106","LA PAMPA",175,2,153,19,0,172,0.0114285714285714
"420560517","LA PAMPA",168,136,13,18,1,32,0.80952380952381
"420560514","LA PAMPA",200,165,20,14,0,34,0.825
"420490102","LA PAMPA",264,0,184,80,0,264,0
"420420301","LA PAMPA",113,0,85,17,3,105,0
"420350406","LA PAMPA",180,54,97,29,0,126,0.3
"420210914","LA PAMPA",175,170,4,1,0,5,0.971428571428571
"420210803","LA PAMPA",193,190,3,0,0,3,0.984455958549223
"420070105","LA PAMPA",7,0,4,2,0,6,0
"420210510","LA PAMPA",294,283,6,3,0,9,0.962585034013605
"420210420","LA PAMPA",257,221,31,4,0,35,0.859922178988327
"420210410","LA PAMPA",141,141,0,0,0,0,1
"420910104","LA PAMPA",21,0,9,10,0,19,0
"420210407","LA PAMPA",378,374,1,2,0,3,0.989417989417989
"420210306","LA PAMPA",288,123,43,118,0,161,0.427083333333333
"420070406","LA PAMPA",247,154,60,32,0,92,0.623481781376518
"420070301","LA PAMPA",100,3,77,20,0,97,0.03
"420070207","LA PAMPA",218,1,169,45,3,217,0.00458715596330275
"420210816","LA PAMPA",301,285,7,6,0,13,0.946843853820598
"420211005","LA PAMPA",290,290,0,0,0,0,1
"420210702","LA PAMPA",162,161,1,0,0,1,0.993827160493827
"420210616","LA PAMPA",167,167,0,0,0,0,1
"420210707","LA PAMPA",244,243,1,0,0,1,0.995901639344262
"420770407","LA PAMPA",3,0,3,0,0,3,0
"420700101","LA PAMPA",186,1,125,60,0,185,0.00537634408602151
"421330213","LA PAMPA",111,49,58,2,1,61,0.441441441441441
"421051002","LA PAMPA",302,295,4,1,0,5,0.97682119205298
"420980111","LA PAMPA",190,1,136,46,7,189,0.00526315789473684
"420980105","LA PAMPA",159,3,127,27,1,155,0.0188679245283019
"420980104","LA PAMPA",143,5,116,3,0,119,0.034965034965035
"421470203","LA PAMPA",14,1,2,9,0,11,0.0714285714285714
"421400221","LA PAMPA",35,2,4,28,0,32,0.0571428571428571
"420350603","LA PAMPA",14,0,10,4,0,14,0
"420070412","LA PAMPA",0,0,0,0,0,0,NA
"421540202","LA PAMPA",88,0,46,38,0,84,0
"421470211","LA PAMPA",9,0,1,7,1,9,0
"421470207","LA PAMPA",7,0,1,5,0,6,0
"421470205","LA PAMPA",7,0,0,7,0,7,0
"421400101","LA PAMPA",13,0,0,12,0,12,0
"421260403","LA PAMPA",12,0,6,6,0,12,0
"421190405","LA PAMPA",13,0,2,10,1,13,0
"421260505","LA PAMPA",8,0,5,3,0,8,0
"420980302","LA PAMPA",67,0,39,24,1,64,0
"421400301","LA PAMPA",1,0,0,1,0,1,0
"420980113","LA PAMPA",39,0,8,23,1,32,0
"420280103","LA PAMPA",54,1,23,26,1,50,0.0185185185185185
"420140209","LA PAMPA",9,0,2,5,1,8,0
"420140208","LA PAMPA",0,0,0,0,0,0,NA
"420140102","LA PAMPA",15,0,7,8,0,15,0
"420070504","LA PAMPA",7,0,2,5,0,7,0
"420770305","LA PAMPA",23,0,4,17,0,21,0
"420560510","LA PAMPA",27,0,4,23,0,27,0
"420420302","LA PAMPA",14,0,4,7,1,12,0
"420420105","LA PAMPA",0,0,0,0,0,0,NA
"421330101","LA PAMPA",102,0,75,25,1,101,0
"420350608","LA PAMPA",60,0,25,35,0,60,0
"420350605","LA PAMPA",23,0,3,18,0,21,0
"420350502","LA PAMPA",26,0,5,20,1,26,0
"421540602","LA PAMPA",13,0,4,9,0,13,0
"421050502","LA PAMPA",11,0,6,5,0,11,0
"420280402","LA PAMPA",28,0,16,8,0,24,0
"420770208","LA PAMPA",15,0,4,11,0,15,0
"421540403","LA PAMPA",56,0,25,27,4,56,0
"421330704","LA PAMPA",39,0,29,7,1,37,0
"421400219","LA PAMPA",139,0,110,29,0,139,0
"420350306","LA PAMPA",189,62,80,46,0,126,0.328042328042328
"420210106","LA PAMPA",33,0,25,8,0,33,0
"420210105","LA PAMPA",113,82,10,14,3,27,0.725663716814159
"421540515","LA PAMPA",264,202,43,18,0,61,0.765151515151515
"421540514","LA PAMPA",215,117,55,42,0,97,0.544186046511628
"421540508","LA PAMPA",213,154,38,21,0,59,0.723004694835681
"421540506","LA PAMPA",207,125,61,20,0,81,0.603864734299517
"421470215","LA PAMPA",291,221,19,49,2,70,0.759450171821306
"421470101","LA PAMPA",166,1,105,56,1,162,0.00602409638554217
"421400217","LA PAMPA",153,4,125,24,0,149,0.0261437908496732
"421330201","LA PAMPA",279,231,32,14,0,46,0.827956989247312
"421260509","LA PAMPA",181,0,129,51,1,181,0
"421190402","LA PAMPA",35,0,25,9,0,34,0
"421190311","LA PAMPA",276,0,235,38,1,274,0
"421051006","LA PAMPA",226,225,0,1,0,1,0.995575221238938
"421050803","LA PAMPA",229,228,1,0,0,1,0.995633187772926
"421050707","LA PAMPA",108,95,4,7,1,12,0.87962962962963
"421050703","LA PAMPA",289,274,5,10,0,15,0.948096885813149
"421050417","LA PAMPA",192,190,2,0,0,2,0.989583333333333
"421050415","LA PAMPA",185,183,2,0,0,2,0.989189189189189
"421050413","LA PAMPA",208,198,8,1,0,9,0.951923076923077
"421050407","LA PAMPA",32,32,0,0,0,0,1
"421050303","LA PAMPA",225,210,13,2,0,15,0.933333333333333
"421050302","LA PAMPA",194,187,5,2,0,7,0.963917525773196
"420980107","LA PAMPA",166,4,118,41,1,160,0.0240963855421687
"421050207","LA PAMPA",177,4,137,36,0,173,0.0225988700564972
"420910101","LA PAMPA",27,0,5,21,0,26,0
"420630102","LA PAMPA",118,0,73,39,0,112,0
"420560515","LA PAMPA",326,270,21,24,1,46,0.828220858895706
"420560513","LA PAMPA",132,116,13,3,0,16,0.878787878787879
"420560101","LA PAMPA",241,0,176,64,0,240,0
"420350602","LA PAMPA",207,4,138,65,0,203,0.0193236714975845
"420280301","LA PAMPA",275,4,179,91,0,270,0.0145454545454545
"420210917","LA PAMPA",199,128,28,41,0,69,0.64321608040201
"420210911","LA PAMPA",240,236,3,1,0,4,0.983333333333333
"420210910","LA PAMPA",207,201,6,0,0,6,0.971014492753623
"420210406","LA PAMPA",255,251,4,0,0,4,0.984313725490196
"420350702","LA PAMPA",8,0,3,4,1,8,0
"420210820","LA PAMPA",206,193,11,1,0,12,0.936893203883495
"420210813","LA PAMPA",205,205,0,0,0,0,1
"420210809","LA PAMPA",254,252,1,1,0,2,0.992125984251969
"420210804","LA PAMPA",241,239,1,1,0,2,0.991701244813278
"420210713","LA PAMPA",241,238,2,0,0,2,0.987551867219917
"420210602","LA PAMPA",215,150,19,37,1,57,0.697674418604651
"420210516","LA PAMPA",434,429,3,2,0,5,0.988479262672811
"420210421","LA PAMPA",166,127,34,5,0,39,0.765060240963855
"420210419","LA PAMPA",188,175,11,2,0,13,0.930851063829787
"420210417","LA PAMPA",217,217,0,0,0,0,1
"420210312","LA PAMPA",362,362,0,0,0,0,1
"420210309","LA PAMPA",241,220,12,9,0,21,0.912863070539419
"420210307","LA PAMPA",251,239,9,2,0,11,0.952191235059761
"420210305","LA PAMPA",265,100,68,88,0,156,0.377358490566038
"420140202","LA PAMPA",7,0,7,0,0,7,0
"420070413","LA PAMPA",183,155,10,17,0,27,0.846994535519126
"420070208","LA PAMPA",176,0,139,37,0,176,0
"420070110","LA PAMPA",188,6,167,15,0,182,0.0319148936170213
"420770201","LA PAMPA",198,0,191,7,0,198,0
"420070101","LA PAMPA",215,2,192,17,4,213,0.00930232558139535
"420210709","LA PAMPA",199,196,3,0,0,3,0.984924623115578
"420210703","LA PAMPA",278,276,2,0,0,2,0.992805755395683
"421540701","LA PAMPA",28,0,15,13,0,28,0
"421470301","LA PAMPA",162,2,99,60,0,159,0.0123456790123457
"421051003","LA PAMPA",333,324,7,1,0,8,0.972972972972973
"421470302","LA PAMPA",8,0,3,5,0,8,0
"421470102","LA PAMPA",2,0,2,0,0,2,0
"421400102","LA PAMPA",33,0,0,28,0,28,0
"421330707","LA PAMPA",5,0,1,3,0,4,0
"421330402","LA PAMPA",18,0,7,11,0,18,0
"421260406","LA PAMPA",16,0,7,9,0,16,0
"421260504","LA PAMPA",11,0,4,6,0,10,0
"421190305","LA PAMPA",16,0,10,6,0,16,0
"421190209","LA PAMPA",10,0,5,5,0,10,0
"421190205","LA PAMPA",23,0,10,13,0,23,0
"421120321","LA PAMPA",4,0,2,2,0,4,0
"420210116","LA PAMPA",0,0,0,0,0,0,NA
"420560202","LA PAMPA",16,0,8,8,0,16,0
"421400211","LA PAMPA",312,214,45,51,0,96,0.685897435897436
"421120320","LA PAMPA",5,0,0,5,0,5,0
"421120313","LA PAMPA",16,0,1,6,0,7,0
"420350303","LA PAMPA",8,0,8,0,0,8,0
"420350103","LA PAMPA",8,0,4,4,0,8,0
"420350102","LA PAMPA",1,0,0,1,0,1,0
"420350504","LA PAMPA",16,0,5,10,1,16,0
"420210204","LA PAMPA",14,0,9,3,0,12,0
"420210109","LA PAMPA",11,0,6,5,0,11,0
"420070503","LA PAMPA",2,0,0,2,0,2,0
"420070303","LA PAMPA",5,0,3,2,0,5,0
"420070302","LA PAMPA",23,0,13,10,0,23,0
"420070108","LA PAMPA",23,0,19,4,0,23,0
"420770408","LA PAMPA",5,0,2,3,0,5,0
"420560509","LA PAMPA",17,0,6,11,0,17,0
"062742003","BUENOS AIRES",346,6,185,146,2,333,0.0173410404624277
"420420304","LA PAMPA",0,0,0,0,0,0,NA
"420350607","LA PAMPA",13,0,7,6,0,13,0
"420210102","LA PAMPA",13,0,12,1,0,13,0
"421050103","LA PAMPA",41,0,18,23,0,41,0
"421050206","LA PAMPA",207,3,129,69,2,200,0.0144927536231884
"421540101","LA PAMPA",70,1,47,22,0,69,0.0142857142857143
"420210615","LA PAMPA",193,192,1,0,0,1,0.994818652849741
"421540512","LA PAMPA",295,149,54,89,1,144,0.505084745762712
"421540510","LA PAMPA",201,139,37,25,0,62,0.691542288557214
"421540509","LA PAMPA",233,175,54,4,0,58,0.751072961373391
"421470214","LA PAMPA",233,187,24,21,0,45,0.802575107296137
"421400213","LA PAMPA",54,46,3,5,0,8,0.851851851851852
"421400206","LA PAMPA",212,178,27,6,1,34,0.839622641509434
"421330702","LA PAMPA",221,5,190,26,0,216,0.0226244343891403
"421330602","LA PAMPA",242,0,220,21,0,241,0
"421330510","LA PAMPA",196,127,52,15,0,67,0.647959183673469
"421330509","LA PAMPA",148,17,80,48,1,129,0.114864864864865
"421330504","LA PAMPA",181,49,109,11,0,120,0.270718232044199
"421260511","LA PAMPA",140,0,132,8,0,140,0
"421260402","LA PAMPA",12,0,4,8,0,12,0
"421260101","LA PAMPA",234,0,199,32,1,232,0
"421190312","LA PAMPA",256,0,191,63,1,255,0
"421190301","LA PAMPA",254,0,206,45,2,253,0
"421190201","LA PAMPA",159,0,114,44,0,158,0
"421190212","LA PAMPA",287,0,242,43,0,285,0
"421120305","LA PAMPA",310,294,5,5,0,10,0.948387096774194
"421120302","LA PAMPA",185,178,4,0,0,4,0.962162162162162
"421120301","LA PAMPA",220,213,3,1,0,4,0.968181818181818
"421051009","LA PAMPA",168,167,1,0,0,1,0.994047619047619
"421050903","LA PAMPA",103,102,0,0,0,0,0.990291262135922
"421050706","LA PAMPA",276,266,7,1,0,8,0.963768115942029
"421050701","LA PAMPA",290,274,4,8,0,12,0.944827586206897
"421050404","LA PAMPA",349,294,24,25,0,49,0.842406876790831
"421050401","LA PAMPA",318,277,33,8,0,41,0.871069182389937
"421050301","LA PAMPA",265,253,10,2,0,12,0.954716981132075
"420840101","LA PAMPA",68,0,40,27,0,67,0
"420770306","LA PAMPA",80,0,74,6,0,80,0
"420700105","LA PAMPA",183,114,51,18,0,69,0.622950819672131
"420560502","LA PAMPA",301,248,31,22,0,53,0.823920265780731
"420560301","LA PAMPA",131,1,98,30,1,129,0.00763358778625954
"420350609","LA PAMPA",217,3,141,73,0,214,0.0138248847926267
"420350409","LA PAMPA",182,81,78,22,0,100,0.445054945054945
"420350404","LA PAMPA",194,60,116,18,0,134,0.309278350515464
"420350310","LA PAMPA",317,129,139,49,0,188,0.406940063091483
"420280201","LA PAMPA",337,3,208,123,1,332,0.00890207715133531
"420210908","LA PAMPA",386,381,3,1,0,4,0.987046632124352
"420210805","LA PAMPA",303,301,2,0,0,2,0.993399339933993
"420210418","LA PAMPA",204,194,7,2,0,9,0.950980392156863
"420210412","LA PAMPA",203,200,2,1,0,3,0.985221674876847
"420210413","LA PAMPA",284,284,0,0,0,0,1
"420210308","LA PAMPA",256,31,102,115,0,217,0.12109375
"420210304","LA PAMPA",258,192,26,35,1,62,0.744186046511628
"420210210","LA PAMPA",155,0,92,63,0,155,0
"420350105","LA PAMPA",17,0,9,8,0,17,0
"421260203","LA PAMPA",134,0,115,17,1,133,0
"420210118","LA PAMPA",201,1,141,54,1,196,0.00497512437810945
"420070501","LA PAMPA",134,0,108,25,0,133,0
"420070202","LA PAMPA",161,2,101,57,0,158,0.0124223602484472
"420140211","LA PAMPA",141,0,116,25,0,141,0
"420070404","LA PAMPA",171,126,33,9,0,42,0.736842105263158
"420070102","LA PAMPA",146,15,113,18,0,131,0.102739726027397
"420210611","LA PAMPA",206,206,0,0,0,0,1
"420210608","LA PAMPA",149,149,0,0,0,0,1
"420210505","LA PAMPA",300,296,4,0,0,4,0.986666666666667
"420560504","LA PAMPA",187,140,29,17,0,46,0.748663101604278
"420210722","LA PAMPA",296,264,16,14,1,31,0.891891891891892
"420210706","LA PAMPA",202,201,1,0,0,1,0.995049504950495
"420210701","LA PAMPA",190,188,2,0,0,2,0.989473684210526
"420210708","LA PAMPA",269,269,0,0,0,0,1
"420770210","LA PAMPA",163,0,155,7,1,163,0
"063573507","BUENOS AIRES",231,231,0,0,0,0,1
"421050715","LA PAMPA",225,198,19,6,0,25,0.88
"421050716","LA PAMPA",232,205,12,2,0,14,0.883620689655172
"420980109","LA PAMPA",216,65,145,6,0,151,0.300925925925926
"421540302","LA PAMPA",53,0,24,28,0,52,0
"421470212","LA PAMPA",6,0,3,3,0,6,0
"421470209","LA PAMPA",16,0,6,10,0,16,0
"421400103","LA PAMPA",17,0,0,16,0,16,0
"421330706","LA PAMPA",7,0,2,4,1,7,0
"421260507","LA PAMPA",4,0,0,4,0,4,0
"421260301","LA PAMPA",8,0,3,5,0,8,0
"421260204","LA PAMPA",6,0,3,3,0,6,0
"421260110","LA PAMPA",23,0,16,7,0,23,0
"421190308","LA PAMPA",24,0,19,5,0,24,0
"421120315","LA PAMPA",18,0,1,12,3,16,0
"060141201","BUENOS AIRES",17,0,3,12,0,15,0
"420210603","LA PAMPA",331,324,2,2,0,4,0.978851963746224
"420980402","LA PAMPA",98,0,52,46,0,98,0
"420840206","LA PAMPA",6,0,6,0,0,6,0
"420210206","LA PAMPA",27,0,9,17,0,26,0
"420420308","LA PAMPA",4,0,4,0,0,4,0
"060561613","BUENOS AIRES",341,339,2,0,0,2,0.994134897360704
"420140204","LA PAMPA",0,0,0,0,0,0,NA
"420070206","LA PAMPA",6,0,5,1,0,6,0
"420070205","LA PAMPA",8,0,5,3,0,8,0
"420070204","LA PAMPA",37,0,18,19,0,37,0
"420770403","LA PAMPA",7,0,6,1,0,7,0
"420700504","LA PAMPA",208,0,4,118,8,130,0
"420700202","LA PAMPA",47,1,16,28,0,44,0.0212765957446809
"420490106","LA PAMPA",38,0,24,7,2,33,0
"421260108","LA PAMPA",47,0,31,14,2,47,0
"063573905","BUENOS AIRES",138,136,0,0,0,0,0.985507246376812
"420420307","LA PAMPA",3,0,1,1,1,3,0
"420420202","LA PAMPA",55,0,24,20,6,50,0
"420420107","LA PAMPA",7,0,0,4,3,7,0
"420420102","LA PAMPA",1,0,1,0,0,1,0
"420420101","LA PAMPA",2,0,0,2,0,2,0
"420350703","LA PAMPA",7,0,5,2,0,7,0
"420840203","LA PAMPA",12,0,5,7,0,12,0
"420630105","LA PAMPA",7,0,2,2,2,6,0
"420280401","LA PAMPA",36,0,10,24,0,34,0
"421050205","LA PAMPA",9,0,3,6,0,9,0
"420770303","LA PAMPA",9,0,1,8,0,9,0
"421400222","LA PAMPA",175,41,56,71,2,129,0.234285714285714
"421050409","LA PAMPA",260,257,0,3,0,3,0.988461538461539
"421330302","LA PAMPA",13,0,7,5,0,12,0
"421540516","LA PAMPA",261,189,60,12,0,72,0.724137931034483
"421540507","LA PAMPA",235,131,64,38,0,102,0.557446808510638
"421540505","LA PAMPA",286,156,76,48,2,126,0.545454545454545
"421400208","LA PAMPA",184,115,40,28,0,68,0.625
"421330204","LA PAMPA",199,173,16,9,1,26,0.869346733668342
"421330202","LA PAMPA",152,138,11,2,0,13,0.907894736842105
"421260510","LA PAMPA",227,0,177,46,2,225,0
"421260103","LA PAMPA",252,0,198,52,0,250,0
"421120101","LA PAMPA",108,3,61,41,0,102,0.0277777777777778
"421050906","LA PAMPA",238,238,0,0,0,0,1
"421050806","LA PAMPA",244,244,0,0,0,0,1
"421050714","LA PAMPA",268,225,22,19,0,41,0.83955223880597
"421050710","LA PAMPA",255,239,2,14,0,16,0.937254901960784
"421050705","LA PAMPA",321,310,8,3,0,11,0.965732087227414
"420770409","LA PAMPA",208,0,183,25,0,208,0
"420770402","LA PAMPA",209,0,184,23,1,208,0
"420770401","LA PAMPA",298,0,265,32,1,298,0
"420700401","LA PAMPA",179,0,126,50,1,177,0
"420560601","LA PAMPA",243,5,183,55,0,238,0.0205761316872428
"420560512","LA PAMPA",133,96,25,10,0,35,0.721804511278195
"420490101","LA PAMPA",170,0,97,71,0,168,0
"420350410","LA PAMPA",160,27,82,51,0,133,0.16875
"420350405","LA PAMPA",259,81,155,23,0,178,0.312741312741313
"420350402","LA PAMPA",172,75,73,24,0,97,0.436046511627907
"420350309","LA PAMPA",149,87,55,7,0,62,0.583892617449664
"420350101","LA PAMPA",78,0,51,21,3,75,0
"420210513","LA PAMPA",243,232,8,0,0,8,0.954732510288066
"420280105","LA PAMPA",151,102,21,28,0,49,0.675496688741722
"420210916","LA PAMPA",322,300,10,9,0,19,0.93167701863354
"420210915","LA PAMPA",219,219,0,0,0,0,1
"420210905","LA PAMPA",322,290,23,2,0,25,0.900621118012422
"420210824","LA PAMPA",207,170,22,15,0,37,0.821256038647343
"420210810","LA PAMPA",295,283,6,4,0,10,0.959322033898305
"420210806","LA PAMPA",250,248,1,1,0,2,0.992
"420210725","LA PAMPA",144,1,83,59,0,142,0.00694444444444444
"420210720","LA PAMPA",265,234,10,16,1,27,0.883018867924528
"420210710","LA PAMPA",178,178,0,0,0,0,1
"064273204","BUENOS AIRES",249,229,8,11,0,19,0.919678714859438
"420210511","LA PAMPA",245,214,14,15,0,29,0.873469387755102
"420210503","LA PAMPA",349,324,8,12,0,20,0.92836676217765
"420210416","LA PAMPA",184,184,0,0,0,0,1
"420210401","LA PAMPA",223,221,1,0,0,1,0.991031390134529
"420210115","LA PAMPA",0,0,0,0,0,0,NA
"420210110","LA PAMPA",37,0,19,17,0,36,0
"420070508","LA PAMPA",100,1,87,12,0,99,0.01
"420210302","LA PAMPA",253,251,1,1,0,2,0.992094861660079
"420280304","LA PAMPA",249,5,154,84,1,239,0.0200803212851406
"420210113","LA PAMPA",243,34,101,108,0,209,0.139917695473251
"420770211","LA PAMPA",154,0,116,36,1,153,0
"420210613","LA PAMPA",291,291,0,0,0,0,1
"421190102","LA PAMPA",3,0,0,3,0,3,0
"421330301","LA PAMPA",98,0,87,10,1,98,0
"421050718","LA PAMPA",216,206,6,4,0,10,0.953703703703704
"421050201","LA PAMPA",15,0,3,12,0,15,0
"420980102","LA PAMPA",130,3,91,36,0,127,0.0230769230769231
"421050504","LA PAMPA",15,0,10,5,0,15,0
"420490104","LA PAMPA",11,0,0,9,1,10,0
"421540702","LA PAMPA",36,0,20,13,1,34,0
"421540402","LA PAMPA",24,0,13,10,0,23,0
"421540103","LA PAMPA",46,0,17,27,0,44,0
"421470213","LA PAMPA",3,0,0,3,0,3,0
"421470208","LA PAMPA",9,1,6,2,0,8,0.111111111111111
"421470204","LA PAMPA",1,0,1,0,0,1,0
"421470107","LA PAMPA",14,0,4,10,0,14,0
"421400104","LA PAMPA",2,0,0,2,0,2,0
"421330506","LA PAMPA",9,0,1,8,0,9,0
"421330403","LA PAMPA",11,0,1,10,0,11,0
"421260508","LA PAMPA",4,0,3,1,0,4,0
"421330208","LA PAMPA",0,0,0,0,0,0,NA
"421260106","LA PAMPA",10,0,5,5,0,10,0
"421190404","LA PAMPA",15,0,3,12,0,15,0
"421190307","LA PAMPA",20,0,13,7,0,20,0
"421120322","LA PAMPA",4,0,0,1,2,3,0
"421120102","LA PAMPA",149,0,50,53,3,106,0
"420980114","LA PAMPA",20,0,4,16,0,20,0
"420350302","LA PAMPA",10,0,0,10,0,10,0
"420070107","LA PAMPA",8,0,8,0,0,8,0
"420560602","LA PAMPA",21,0,4,16,0,20,0
"420420103","LA PAMPA",1,0,1,0,0,1,0
"420350705","LA PAMPA",16,0,5,11,0,16,0
"420350606","LA PAMPA",15,0,5,10,0,15,0
"420350604","LA PAMPA",20,0,4,16,0,20,0
"420350308","LA PAMPA",22,1,2,19,0,21,0.0454545454545455
"421050102","LA PAMPA",2,0,2,0,0,2,0
"420630106","LA PAMPA",31,0,9,22,0,31,0
"421120314","LA PAMPA",9,0,1,4,2,7,0
"420210104","LA PAMPA",9,0,2,7,0,9,0
"420700102","LA PAMPA",7,0,5,2,0,7,0
"420840204","LA PAMPA",0,0,0,0,0,0,NA
"420840201","LA PAMPA",16,0,8,8,0,16,0
"420770304","LA PAMPA",25,0,19,5,0,24,0
"420770108","LA PAMPA",41,0,20,20,0,40,0
"420770106","LA PAMPA",8,0,5,3,0,8,0
"420770103","LA PAMPA",6,0,4,2,0,6,0
"421400201","LA PAMPA",196,104,36,55,0,91,0.530612244897959
"421330604","LA PAMPA",49,0,44,5,0,49,0
"420280303","LA PAMPA",333,17,214,101,0,315,0.0510510510510511
"420070409","LA PAMPA",251,202,28,21,0,49,0.804780876494024
"420630101","LA PAMPA",93,0,64,29,0,93,0
"420420201","LA PAMPA",143,0,95,46,0,141,0
"421540502","LA PAMPA",273,192,47,29,1,77,0.703296703296703
"421540501","LA PAMPA",90,40,24,26,0,50,0.444444444444444
"421470202","LA PAMPA",173,109,21,42,0,63,0.630057803468208
"421470201","LA PAMPA",224,164,41,17,0,58,0.732142857142857
"421400218","LA PAMPA",144,1,108,33,0,141,0.00694444444444444
"063573505","BUENOS AIRES",269,269,0,0,0,0,1
"065683001","BUENOS AIRES",376,8,218,144,0,362,0.0212765957446809
"421260501","LA PAMPA",159,0,117,38,1,156,0
"421260407","LA PAMPA",170,0,114,55,1,170,0
"421260401","LA PAMPA",165,0,88,73,1,162,0
"421260202","LA PAMPA",156,0,128,26,2,156,0
"421120307","LA PAMPA",243,243,0,0,0,0,1
"421120304","LA PAMPA",65,61,4,0,0,4,0.938461538461538
"421050902","LA PAMPA",114,55,9,50,0,59,0.482456140350877
"421050807","LA PAMPA",388,306,28,52,0,80,0.788659793814433
"421050802","LA PAMPA",178,125,45,8,0,53,0.702247191011236
"421050712","LA PAMPA",320,290,14,14,0,28,0.90625
"421050704","LA PAMPA",249,243,4,2,0,6,0.975903614457831
"421050702","LA PAMPA",205,184,3,18,0,21,0.897560975609756
"421050601","LA PAMPA",99,3,59,36,0,95,0.0303030303030303
"420210301","LA PAMPA",240,211,5,23,0,28,0.879166666666667
"421050406","LA PAMPA",395,390,3,2,0,5,0.987341772151899
"421050309","LA PAMPA",210,205,1,4,0,5,0.976190476190476
"420980303","LA PAMPA",203,7,142,52,1,195,0.0344827586206897
"420980301","LA PAMPA",190,0,136,51,2,189,0
"420770307","LA PAMPA",133,0,126,7,0,133,0
"420700502","LA PAMPA",283,8,219,56,0,275,0.0282685512367491
"420700501","LA PAMPA",343,1,241,100,0,341,0.00291545189504373
"420700301","LA PAMPA",10,0,2,8,0,10,0
"420560201","LA PAMPA",53,0,20,26,1,47,0
"420490108","LA PAMPA",91,0,49,39,1,89,0
"420490107","LA PAMPA",158,0,127,27,0,154,0
"065683112","BUENOS AIRES",384,16,257,100,0,357,0.0416666666666667
"420350610","LA PAMPA",164,0,100,62,0,162,0
"420350408","LA PAMPA",156,49,94,12,0,106,0.314102564102564
"420280203","LA PAMPA",193,24,97,69,0,166,0.124352331606218
"420210906","LA PAMPA",136,116,13,3,0,16,0.852941176470588
"420210903","LA PAMPA",352,347,5,0,0,5,0.985795454545455
"420210822","LA PAMPA",184,184,0,0,0,0,1
"420210812","LA PAMPA",189,188,1,0,0,1,0.994708994708995
"420210712","LA PAMPA",213,208,3,0,0,3,0.976525821596244
"420210711","LA PAMPA",152,67,46,38,0,84,0.440789473684211
"420210606","LA PAMPA",178,177,1,0,0,1,0.99438202247191
"420210604","LA PAMPA",325,323,1,1,0,2,0.993846153846154
"420210512","LA PAMPA",273,255,4,2,0,6,0.934065934065934
"420210508","LA PAMPA",2,2,0,0,0,0,1
"420210501","LA PAMPA",231,217,2,10,2,14,0.939393939393939
"420210411","LA PAMPA",169,168,0,1,0,1,0.994082840236686
"420210114","LA PAMPA",177,40,78,59,0,137,0.225988700564972
"420770101","LA PAMPA",109,0,93,16,0,109,0
"420070405","LA PAMPA",173,136,25,12,0,37,0.786127167630058
"420210607","LA PAMPA",236,234,1,1,0,2,0.991525423728814
"420350505","LA PAMPA",89,1,56,32,0,88,0.0112359550561798
"420211004","LA PAMPA",294,293,0,0,0,0,0.996598639455782
"421330216","LA PAMPA",214,35,155,23,1,179,0.163551401869159
"421330215","LA PAMPA",212,182,27,3,0,30,0.858490566037736
"421051004","LA PAMPA",217,216,0,0,0,0,0.995391705069124
"420770212","LA PAMPA",141,0,124,16,0,140,0
"420490105","LA PAMPA",54,0,14,30,3,47,0
"420140207","LA PAMPA",1,0,1,0,0,1,0
"421470206","LA PAMPA",12,0,4,6,1,11,0
"421400220","LA PAMPA",80,0,30,46,0,76,0
"421260506","LA PAMPA",72,0,57,13,0,70,0
"065682901","BUENOS AIRES",338,1,253,73,1,327,0.0029585798816568
"421260503","LA PAMPA",35,0,18,15,1,34,0
"421260304","LA PAMPA",7,0,6,1,0,7,0
"421260302","LA PAMPA",20,0,9,11,0,20,0
"421330209","LA PAMPA",2,0,1,1,0,2,0
"421260105","LA PAMPA",17,0,9,8,0,17,0
"421190403","LA PAMPA",23,0,13,10,0,23,0
"421190306","LA PAMPA",16,0,13,3,0,16,0
"421190103","LA PAMPA",9,0,3,6,0,9,0
"420980202","LA PAMPA",26,0,11,13,0,24,0
"060420501","BUENOS AIRES",99,0,16,83,0,99,0
"060700302","BUENOS AIRES",81,1,54,24,0,78,0.0123456790123457
"060980403","BUENOS AIRES",179,0,72,103,2,177,0
"065740412","BUENOS AIRES",275,37,83,141,1,225,0.134545454545455
"420840205","LA PAMPA",3,0,3,0,0,3,0
"420350305","LA PAMPA",3,0,0,3,0,3,0
"420350104","LA PAMPA",13,0,1,12,0,13,0
"420280104","LA PAMPA",28,1,10,16,0,26,0.0357142857142857
"420140103","LA PAMPA",23,0,18,5,0,23,0
"420070507","LA PAMPA",4,0,1,3,0,4,0
"420840102","LA PAMPA",45,0,23,19,0,42,0
"420770405","LA PAMPA",4,0,3,1,0,4,0
"420770205","LA PAMPA",11,0,1,10,0,11,0
"060630706","BUENOS AIRES",366,191,64,103,0,167,0.521857923497268
"065810105","BUENOS AIRES",420,412,4,4,0,8,0.980952380952381
"420420306","LA PAMPA",9,0,2,4,0,6,0
"420350704","LA PAMPA",17,0,12,5,0,17,0
"420770207","LA PAMPA",25,0,14,7,0,21,0
"420770206","LA PAMPA",17,0,10,7,0,17,0
"068821704","BUENOS AIRES",485,30,133,298,0,431,0.0618556701030928
"060210206","BUENOS AIRES",58,0,13,45,0,58,0
"060070107","BUENOS AIRES",64,4,47,12,0,59,0.0625
"060210609","BUENOS AIRES",26,14,8,4,0,12,0.538461538461538
"060421102","BUENOS AIRES",158,4,38,112,3,153,0.0253164556962025
"061190206","BUENOS AIRES",17,0,14,3,0,17,0
"061190406","BUENOS AIRES",39,1,24,14,0,38,0.0256410256410256
"060562708","BUENOS AIRES",155,89,26,37,1,64,0.574193548387097
"060630802","BUENOS AIRES",60,0,20,40,0,60,0
"060980612","BUENOS AIRES",192,1,113,63,3,179,0.00520833333333333
"061051002","BUENOS AIRES",52,0,11,35,0,46,0
"061051201","BUENOS AIRES",40,0,17,23,0,40,0
"061260917","BUENOS AIRES",74,0,49,23,0,72,0
"061260919","BUENOS AIRES",81,1,45,30,1,76,0.0123456790123457
"061340109","BUENOS AIRES",163,0,93,69,1,163,0
"062240908","BUENOS AIRES",281,105,80,85,1,166,0.373665480427046
"066382102","BUENOS AIRES",56,0,36,20,0,56,0
"062031601","BUENOS AIRES",428,137,229,59,0,288,0.320093457943925
"062100501","BUENOS AIRES",123,12,66,43,0,109,0.0975609756097561
"062100808","BUENOS AIRES",818,567,39,195,3,237,0.693154034229829
"062100810","BUENOS AIRES",352,146,28,174,1,203,0.414772727272727
"062310803","BUENOS AIRES",229,1,95,131,1,227,0.00436681222707424
"064480101","BUENOS AIRES",112,1,37,70,4,111,0.00892857142857143
"063360701","BUENOS AIRES",62,0,30,32,0,62,0
"062241301","BUENOS AIRES",71,0,40,29,1,70,0
"062310302","BUENOS AIRES",25,0,13,12,0,25,0
"062380702","BUENOS AIRES",45,0,31,14,0,45,0
"062600301","BUENOS AIRES",703,183,78,377,12,467,0.260312944523471
"062660506","BUENOS AIRES",76,0,51,25,0,76,0
"064620203","BUENOS AIRES",7,0,3,3,0,6,0
"065810106","BUENOS AIRES",243,240,3,0,0,3,0.987654320987654
"062660601","BUENOS AIRES",142,3,55,81,0,136,0.0211267605633803
"062700103","BUENOS AIRES",144,114,24,6,0,30,0.791666666666667
"062701104","BUENOS AIRES",111,3,70,37,1,108,0.027027027027027
"064760705","BUENOS AIRES",51,0,21,29,0,50,0
"063290402","BUENOS AIRES",72,0,43,26,0,69,0
"066091909","BUENOS AIRES",255,186,22,46,0,68,0.729411764705882
"063640205","BUENOS AIRES",318,1,176,124,0,300,0.00314465408805031
"063640504","BUENOS AIRES",103,0,19,84,0,103,0
"064131202","BUENOS AIRES",0,0,0,0,0,0,NA
"064131506","BUENOS AIRES",7,0,5,2,0,7,0
"065250303","BUENOS AIRES",449,8,129,293,2,424,0.0178173719376392
"064415703","BUENOS AIRES",192,31,115,42,0,157,0.161458333333333
"066381403","BUENOS AIRES",429,2,204,199,2,405,0.00466200466200466
"064830401","BUENOS AIRES",512,326,87,97,0,184,0.63671875
"065952201","BUENOS AIRES",71,0,15,54,2,71,0
"065682802","BUENOS AIRES",367,3,332,32,0,364,0.00817438692098093
"065682803","BUENOS AIRES",500,2,415,73,0,488,0.004
"064551301","BUENOS AIRES",147,5,38,98,2,138,0.0340136054421769
"066020304","BUENOS AIRES",179,11,97,64,3,164,0.0614525139664804
"066091005","BUENOS AIRES",29,0,13,11,3,27,0
"064761105","BUENOS AIRES",19,1,4,12,0,16,0.0526315789473684
"065810303","BUENOS AIRES",294,279,12,3,0,15,0.948979591836735
"065810407","BUENOS AIRES",214,206,6,1,1,8,0.962616822429907
"063573506","BUENOS AIRES",217,217,0,0,0,0,1
"064830602","BUENOS AIRES",119,1,68,49,0,117,0.00840336134453781
"064830906","BUENOS AIRES",28,0,26,2,0,28,0
"067420409","BUENOS AIRES",33,0,6,27,0,33,0
"068331405","BUENOS AIRES",35,0,30,5,0,35,0
"066382106","BUENOS AIRES",16,0,9,7,0,16,0
"066480316","BUENOS AIRES",111,0,38,59,2,99,0
"068051605","BUENOS AIRES",281,6,171,95,0,266,0.0213523131672598
"065811707","BUENOS AIRES",216,216,0,0,0,0,1
"065811711","BUENOS AIRES",264,241,12,10,1,23,0.912878787878788
"065250501","BUENOS AIRES",516,2,215,279,9,503,0.00387596899224806
"065320901","BUENOS AIRES",490,254,122,109,0,231,0.518367346938776
"065393107","BUENOS AIRES",462,3,205,227,6,438,0.00649350649350649
"065470501","BUENOS AIRES",27,0,14,13,0,27,0
"065682010","BUENOS AIRES",305,277,20,7,0,27,0.908196721311475
"065682102","BUENOS AIRES",147,142,3,1,0,4,0.965986394557823
"066650402","BUENOS AIRES",47,20,10,17,0,27,0.425531914893617
"066791102","BUENOS AIRES",41,0,16,23,2,41,0
"067630703","BUENOS AIRES",353,240,26,75,0,101,0.679886685552408
"067780301","BUENOS AIRES",52,1,24,26,0,50,0.0192307692307692
"068680502","BUENOS AIRES",352,14,184,145,0,329,0.0397727272727273
"065811304","BUENOS AIRES",275,236,10,29,0,39,0.858181818181818
"065881705","BUENOS AIRES",322,299,9,13,0,22,0.928571428571429
"065950212","BUENOS AIRES",255,255,0,0,0,0,1
"067780603","BUENOS AIRES",135,0,62,73,0,135,0
"067980707","BUENOS AIRES",178,137,14,24,1,39,0.769662921348315
"068260706","BUENOS AIRES",383,310,44,26,0,70,0.809399477806789
"068330802","BUENOS AIRES",32,0,10,15,7,32,0
"065950303","BUENOS AIRES",300,299,1,0,0,1,0.996666666666667
"068680504","BUENOS AIRES",194,12,121,48,6,175,0.0618556701030928
"068820702","BUENOS AIRES",148,0,61,81,2,144,0
"060980406","BUENOS AIRES",169,2,94,54,10,158,0.0118343195266272
"065681607","BUENOS AIRES",254,240,12,2,0,14,0.94488188976378
"065681608","BUENOS AIRES",228,110,108,10,0,118,0.482456140350877
"065681703","BUENOS AIRES",251,2,155,92,1,248,0.00796812749003984
"065681801","BUENOS AIRES",229,228,0,1,0,1,0.995633187772926
"065683105","BUENOS AIRES",344,12,204,127,0,331,0.0348837209302326
"065683106","BUENOS AIRES",322,15,164,141,1,306,0.046583850931677
"065683108","BUENOS AIRES",225,7,134,84,0,218,0.0311111111111111
"063574104","BUENOS AIRES",207,207,0,0,0,0,1
"068050108","BUENOS AIRES",163,146,15,0,0,15,0.895705521472393
"065682302","BUENOS AIRES",231,227,3,0,0,3,0.982683982683983
"065682408","BUENOS AIRES",399,363,15,18,0,33,0.909774436090226
"065682501","BUENOS AIRES",177,172,3,2,0,5,0.971751412429379
"065682506","BUENOS AIRES",463,185,163,112,0,275,0.399568034557235
"065682507","BUENOS AIRES",434,47,280,102,0,382,0.108294930875576
"065682611","BUENOS AIRES",365,7,298,57,0,355,0.0191780821917808
"065682701","BUENOS AIRES",15,0,15,0,0,15,0
"065682706","BUENOS AIRES",292,0,218,61,1,280,0
"066583712","BUENOS AIRES",512,19,137,334,0,471,0.037109375
"065811501","BUENOS AIRES",126,4,5,113,0,118,0.0317460317460317
"065811511","BUENOS AIRES",281,269,6,6,0,12,0.95729537366548
"065811704","BUENOS AIRES",189,188,0,1,0,1,0.994708994708995
"065880114","BUENOS AIRES",247,209,15,22,0,37,0.846153846153846
"065880201","BUENOS AIRES",342,308,13,20,0,33,0.900584795321637
"065880901","BUENOS AIRES",266,252,11,3,0,14,0.947368421052632
"065880902","BUENOS AIRES",342,283,30,28,0,58,0.827485380116959
"065880906","BUENOS AIRES",122,1,52,68,1,121,0.00819672131147541
"065880907","BUENOS AIRES",190,49,68,72,0,140,0.257894736842105
"065950603","BUENOS AIRES",109,1,55,52,0,107,0.00917431192660551
"065951605","BUENOS AIRES",38,1,28,9,0,37,0.0263157894736842
"065951608","BUENOS AIRES",468,5,324,133,0,457,0.0106837606837607
"065951908","BUENOS AIRES",205,2,126,76,0,202,0.00975609756097561
"065951914","BUENOS AIRES",350,79,138,129,1,268,0.225714285714286
"065952501","BUENOS AIRES",367,360,5,2,0,7,0.980926430517711
"065952712","BUENOS AIRES",186,7,88,90,1,179,0.0376344086021505
"066021107","BUENOS AIRES",261,252,7,2,0,9,0.96551724137931
"066021109","BUENOS AIRES",437,403,21,9,0,30,0.922196796338673
"066090106","BUENOS AIRES",217,13,152,51,0,203,0.0599078341013825
"068400508","BUENOS AIRES",433,433,0,0,0,0,1
"066090902","BUENOS AIRES",242,3,169,67,0,236,0.012396694214876
"066091501","BUENOS AIRES",73,0,46,27,0,73,0
"066480514","BUENOS AIRES",296,2,192,101,0,293,0.00675675675675676
"066160305","BUENOS AIRES",227,196,11,16,0,27,0.863436123348018
"066230101","BUENOS AIRES",257,115,54,86,0,140,0.447470817120623
"066230201","BUENOS AIRES",258,212,18,27,0,45,0.821705426356589
"066230203","BUENOS AIRES",309,303,3,3,0,6,0.980582524271845
"066230301","BUENOS AIRES",184,170,5,9,0,14,0.923913043478261
"066230403","BUENOS AIRES",301,297,4,0,0,4,0.98671096345515
"066380214","BUENOS AIRES",255,0,138,109,0,247,0
"066230507","BUENOS AIRES",393,268,2,119,0,121,0.681933842239186
"067491407","BUENOS AIRES",365,352,6,4,0,10,0.964383561643836
"066230801","BUENOS AIRES",58,0,28,27,3,58,0
"067491408","BUENOS AIRES",325,300,11,5,0,16,0.923076923076923
"066231802","BUENOS AIRES",125,0,92,31,2,125,0
"064200705","BUENOS AIRES",54,52,1,1,0,2,0.962962962962963
"066232003","BUENOS AIRES",299,270,8,19,0,27,0.903010033444816
"066232006","BUENOS AIRES",258,177,16,61,2,79,0.686046511627907
"066232009","BUENOS AIRES",364,204,23,109,1,133,0.56043956043956
"066232012","BUENOS AIRES",158,22,14,114,4,132,0.139240506329114
"068540102","BUENOS AIRES",295,277,9,6,1,16,0.938983050847458
"066232506","BUENOS AIRES",102,2,44,55,0,99,0.0196078431372549
"066232805","BUENOS AIRES",341,335,1,5,0,6,0.982404692082111
"066232809","BUENOS AIRES",371,274,57,33,5,95,0.738544474393531
"066380211","BUENOS AIRES",472,7,365,92,1,458,0.0148305084745763
"066232812","BUENOS AIRES",379,201,78,92,1,171,0.530343007915567
"066232813","BUENOS AIRES",449,411,23,11,2,36,0.915367483296214
"066380212","BUENOS AIRES",254,3,185,65,0,250,0.0118110236220472
"066510111","BUENOS AIRES",182,6,135,41,0,176,0.032967032967033
"066380111","BUENOS AIRES",645,229,249,154,1,404,0.355038759689922
"066380508","BUENOS AIRES",280,1,99,172,0,271,0.00357142857142857
"066380703","BUENOS AIRES",314,28,112,163,1,276,0.089171974522293
"066380713","BUENOS AIRES",281,6,191,66,14,271,0.0213523131672598
"066380801","BUENOS AIRES",227,216,11,0,0,11,0.951541850220264
"066381002","BUENOS AIRES",331,0,182,126,1,309,0
"066381005","BUENOS AIRES",270,1,220,49,0,269,0.0037037037037037
"066381006","BUENOS AIRES",440,1,212,219,0,431,0.00227272727272727
"066381803","BUENOS AIRES",395,6,229,154,4,387,0.0151898734177215
"066381110","BUENOS AIRES",461,2,131,311,3,445,0.00433839479392625
"066381303","BUENOS AIRES",264,1,100,140,0,240,0.00378787878787879
"066381511","BUENOS AIRES",275,192,17,58,3,78,0.698181818181818
"066381611","BUENOS AIRES",357,182,77,95,1,173,0.509803921568627
"066381713","BUENOS AIRES",413,391,14,7,0,21,0.946731234866828
"066440106","BUENOS AIRES",52,10,41,1,0,42,0.192307692307692
"066382304","BUENOS AIRES",205,3,165,36,1,202,0.0146341463414634
"066440105","BUENOS AIRES",33,33,0,0,0,0,1
"066440107","BUENOS AIRES",48,26,19,3,0,22,0.541666666666667
"066440111","BUENOS AIRES",29,23,5,0,0,5,0.793103448275862
"066440208","BUENOS AIRES",80,42,30,8,0,38,0.525
"066583011","BUENOS AIRES",397,3,193,196,0,389,0.00755667506297229
"066440301","BUENOS AIRES",234,3,189,39,0,228,0.0128205128205128
"066440408","BUENOS AIRES",35,29,6,0,0,6,0.828571428571429
"066440612","BUENOS AIRES",294,5,153,130,3,286,0.0170068027210884
"066480114","BUENOS AIRES",458,4,195,238,2,435,0.00873362445414847
"066480210","BUENOS AIRES",407,2,275,118,0,393,0.00491400491400491
"066480212","BUENOS AIRES",364,3,276,80,0,356,0.00824175824175824
"066480305","BUENOS AIRES",257,0,124,108,1,233,0
"066480306","BUENOS AIRES",291,1,153,117,5,275,0.00343642611683849
"066480313","BUENOS AIRES",178,2,161,15,0,176,0.0112359550561798
"066480403","BUENOS AIRES",309,0,104,190,3,297,0
"066480410","BUENOS AIRES",43,0,27,16,0,43,0
"066480513","BUENOS AIRES",445,2,281,145,1,427,0.00449438202247191
"066510110","BUENOS AIRES",277,18,201,57,0,258,0.0649819494584837
"066580108","BUENOS AIRES",252,250,0,0,0,0,0.992063492063492
"066550303","BUENOS AIRES",43,0,18,23,1,42,0
"066580101","BUENOS AIRES",2,2,0,0,0,0,1
"066580105","BUENOS AIRES",307,298,3,6,0,9,0.970684039087948
"066580106","BUENOS AIRES",319,310,4,5,0,9,0.971786833855799
"066580110","BUENOS AIRES",508,389,44,30,4,78,0.765748031496063
"066580205","BUENOS AIRES",231,8,84,124,8,216,0.0346320346320346
"066580311","BUENOS AIRES",259,256,2,1,0,3,0.988416988416988
"066580812","BUENOS AIRES",218,218,0,0,0,0,1
"066580904","BUENOS AIRES",53,53,0,0,0,0,1
"066581010","BUENOS AIRES",288,267,18,3,0,21,0.927083333333333
"066580401","BUENOS AIRES",187,96,6,48,8,62,0.513368983957219
"066580409","BUENOS AIRES",345,343,1,0,0,1,0.994202898550725
"066580410","BUENOS AIRES",326,323,1,1,0,2,0.99079754601227
"066580505","BUENOS AIRES",229,226,0,3,0,3,0.986899563318777
"066580612","BUENOS AIRES",282,280,2,0,0,2,0.99290780141844
"066580510","BUENOS AIRES",180,176,3,1,0,4,0.977777777777778
"066580602","BUENOS AIRES",275,272,2,0,0,2,0.989090909090909
"066580611","BUENOS AIRES",346,340,5,1,0,6,0.982658959537572
"066580701","BUENOS AIRES",263,261,1,0,0,1,0.992395437262357
"066580806","BUENOS AIRES",205,205,0,0,0,0,1
"066580807","BUENOS AIRES",208,206,2,0,0,2,0.990384615384615
"066581109","BUENOS AIRES",301,300,0,1,0,1,0.996677740863787
"066581112","BUENOS AIRES",286,286,0,0,0,0,1
"066581509","BUENOS AIRES",348,348,0,0,0,0,1
"066581607","BUENOS AIRES",231,231,0,0,0,0,1
"066581802","BUENOS AIRES",150,150,0,0,0,0,1
"066581809","BUENOS AIRES",310,302,2,0,0,2,0.974193548387097
"066581810","BUENOS AIRES",211,211,0,0,0,0,1
"066581905","BUENOS AIRES",207,200,2,5,0,7,0.966183574879227
"066581909","BUENOS AIRES",241,236,1,3,0,4,0.979253112033195
"066582305","BUENOS AIRES",329,308,11,10,0,21,0.936170212765957
"066582306","BUENOS AIRES",213,194,7,12,0,19,0.910798122065728
"066582409","BUENOS AIRES",270,269,1,0,0,1,0.996296296296296
"066582510","BUENOS AIRES",354,344,1,6,0,7,0.971751412429379
"066582716","BUENOS AIRES",217,4,21,172,3,196,0.0184331797235023
"066582902","BUENOS AIRES",273,259,4,10,0,14,0.948717948717949
"066582912","BUENOS AIRES",452,146,74,225,0,299,0.323008849557522
"066583010","BUENOS AIRES",351,2,156,183,0,339,0.0056980056980057
"066583209","BUENOS AIRES",148,133,4,11,0,15,0.898648648648649
"066583206","BUENOS AIRES",107,93,5,7,0,12,0.869158878504673
"066583211","BUENOS AIRES",195,183,5,1,0,6,0.938461538461538
"066583212","BUENOS AIRES",516,485,12,10,3,25,0.939922480620155
"066583213","BUENOS AIRES",315,291,9,6,0,15,0.923809523809524
"066583309","BUENOS AIRES",430,391,10,20,0,30,0.909302325581395
"066583313","BUENOS AIRES",276,44,82,148,0,230,0.159420289855072
"066583510","BUENOS AIRES",468,47,118,274,8,400,0.10042735042735
"066583605","BUENOS AIRES",345,8,163,173,0,336,0.0231884057971014
"066583611","BUENOS AIRES",466,7,167,273,3,443,0.0150214592274678
"066583701","BUENOS AIRES",491,7,84,377,4,465,0.0142566191446029
"066583713","BUENOS AIRES",524,10,172,326,2,500,0.0190839694656489
"066583804","BUENOS AIRES",367,19,42,278,1,321,0.0517711171662125
"066583809","BUENOS AIRES",221,4,17,167,3,187,0.0180995475113122
"066583909","BUENOS AIRES",240,11,144,75,0,219,0.0458333333333333
"066584104","BUENOS AIRES",466,11,327,122,1,450,0.0236051502145923
"066584114","BUENOS AIRES",320,159,72,63,6,141,0.496875
"066584211","BUENOS AIRES",276,159,73,37,0,110,0.576086956521739
"066584408","BUENOS AIRES",432,29,194,200,1,395,0.0671296296296296
"066650311","BUENOS AIRES",33,0,15,17,1,33,0
"066651007","BUENOS AIRES",328,157,62,104,1,167,0.478658536585366
"066721205","BUENOS AIRES",347,329,10,8,0,18,0.948126801152738
"066860107","BUENOS AIRES",237,226,3,6,0,9,0.953586497890295
"066860110","BUENOS AIRES",347,287,13,41,0,54,0.827089337175792
"066861101","BUENOS AIRES",321,0,136,183,2,321,0
"066930311","BUENOS AIRES",396,182,129,82,0,211,0.45959595959596
"066930319","BUENOS AIRES",281,153,72,53,1,126,0.544483985765125
"060561209","BUENOS AIRES",242,242,0,0,0,0,1
"067350103","BUENOS AIRES",256,211,22,21,1,44,0.82421875
"067350108","BUENOS AIRES",234,183,23,27,0,50,0.782051282051282
"067001004","BUENOS AIRES",4,0,2,2,0,4,0
"067070107","BUENOS AIRES",278,266,4,8,0,12,0.956834532374101
"067070109","BUENOS AIRES",303,283,11,8,1,20,0.933993399339934
"067070113","BUENOS AIRES",244,19,66,152,1,219,0.0778688524590164
"067070604","BUENOS AIRES",157,0,84,70,1,155,0
"067071103","BUENOS AIRES",248,83,46,119,0,165,0.334677419354839
"067140603","BUENOS AIRES",136,30,55,49,0,104,0.220588235294118
"067210101","BUENOS AIRES",227,4,170,52,1,223,0.0176211453744493
"067210207","BUENOS AIRES",272,101,120,51,0,171,0.371323529411765
"067280101","BUENOS AIRES",305,2,190,110,2,302,0.00655737704918033
"060561210","BUENOS AIRES",145,145,0,0,0,0,1
"067281009","BUENOS AIRES",182,83,38,60,0,98,0.456043956043956
"067281016","BUENOS AIRES",207,121,46,38,1,85,0.584541062801932
"067490301","BUENOS AIRES",319,318,0,1,0,1,0.996865203761755
"067350702","BUENOS AIRES",345,7,158,180,0,338,0.0202898550724638
"067350709","BUENOS AIRES",316,13,113,187,0,300,0.0411392405063291
"067420701","BUENOS AIRES",19,0,1,18,0,19,0
"067490102","BUENOS AIRES",378,118,44,179,15,238,0.312169312169312
"067490204","BUENOS AIRES",354,346,4,4,0,8,0.977401129943503
"067490208","BUENOS AIRES",297,281,7,9,0,16,0.946127946127946
"067490402","BUENOS AIRES",98,64,9,19,1,29,0.653061224489796
"067490403","BUENOS AIRES",228,226,2,0,0,2,0.991228070175439
"067490404","BUENOS AIRES",317,309,8,0,0,8,0.974763406940063
"067490504","BUENOS AIRES",309,306,3,0,0,3,0.990291262135922
"067490506","BUENOS AIRES",303,299,0,0,0,0,0.986798679867987
"067490509","BUENOS AIRES",240,238,1,1,0,2,0.991666666666667
"067490513","BUENOS AIRES",125,125,0,0,0,0,1
"067490604","BUENOS AIRES",216,209,5,2,0,7,0.967592592592593
"067490803","BUENOS AIRES",236,17,97,122,0,219,0.0720338983050847
"067490806","BUENOS AIRES",310,104,46,156,1,203,0.335483870967742
"067490809","BUENOS AIRES",331,280,22,21,0,43,0.845921450151057
"067491008","BUENOS AIRES",174,166,7,1,0,8,0.954022988505747
"067491010","BUENOS AIRES",227,203,17,3,0,20,0.894273127753304
"067491104","BUENOS AIRES",206,21,92,85,2,179,0.101941747572816
"067491202","BUENOS AIRES",342,150,55,134,0,189,0.43859649122807
"067491209","BUENOS AIRES",246,196,18,25,0,43,0.796747967479675
"067491301","BUENOS AIRES",333,215,46,31,4,81,0.645645645645646
"067491305","BUENOS AIRES",418,258,83,51,0,134,0.617224880382775
"067491413","BUENOS AIRES",410,388,15,2,1,18,0.946341463414634
"067491418","BUENOS AIRES",156,152,3,1,0,4,0.974358974358974
"067560507","BUENOS AIRES",248,247,1,0,0,1,0.995967741935484
"067560104","BUENOS AIRES",307,252,45,10,0,55,0.820846905537459
"067560105","BUENOS AIRES",275,271,3,1,0,4,0.985454545454545
"067560110","BUENOS AIRES",404,390,12,2,0,14,0.965346534653465
"068401409","BUENOS AIRES",291,291,0,0,0,0,1
"067560113","BUENOS AIRES",308,301,4,3,0,7,0.977272727272727
"067560205","BUENOS AIRES",296,267,7,16,1,24,0.902027027027027
"067560302","BUENOS AIRES",133,133,0,0,0,0,1
"067560307","BUENOS AIRES",400,400,0,0,0,0,1
"067560801","BUENOS AIRES",316,310,5,0,0,5,0.981012658227848
"067560802","BUENOS AIRES",309,303,4,0,1,5,0.980582524271845
"067560904","BUENOS AIRES",367,362,4,1,0,5,0.986376021798365
"067560916","BUENOS AIRES",287,287,0,0,0,0,1
"067561007","BUENOS AIRES",246,245,1,0,0,1,0.995934959349594
"067561009","BUENOS AIRES",139,139,0,0,0,0,1
"067600315","BUENOS AIRES",278,273,5,0,0,5,0.982014388489209
"067561101","BUENOS AIRES",204,197,7,0,0,7,0.965686274509804
"067562514","BUENOS AIRES",295,11,176,108,0,284,0.0372881355932203
"067561302","BUENOS AIRES",193,190,2,1,0,3,0.984455958549223
"067561404","BUENOS AIRES",238,229,7,2,0,9,0.96218487394958
"067561409","BUENOS AIRES",405,352,18,26,0,44,0.869135802469136
"067561411","BUENOS AIRES",319,117,13,170,13,196,0.366771159874608
"067561609","BUENOS AIRES",304,261,35,8,0,43,0.858552631578947
"067561510","BUENOS AIRES",303,185,93,25,0,118,0.610561056105611
"067561511","BUENOS AIRES",331,281,32,18,0,50,0.848942598187311
"067561707","BUENOS AIRES",357,342,11,2,0,13,0.957983193277311
"067561709","BUENOS AIRES",398,388,8,2,0,10,0.974874371859296
"063574105","BUENOS AIRES",208,208,0,0,0,0,1
"067561801","BUENOS AIRES",269,266,2,1,0,3,0.988847583643123
"067561809","BUENOS AIRES",229,227,1,1,0,2,0.991266375545852
"067561904","BUENOS AIRES",224,214,4,5,0,9,0.955357142857143
"067561905","BUENOS AIRES",431,424,3,2,0,5,0.983758700696056
"067561910","BUENOS AIRES",288,282,3,3,0,6,0.979166666666667
"067600117","BUENOS AIRES",220,215,4,1,0,5,0.977272727272727
"067562111","BUENOS AIRES",290,10,262,17,0,279,0.0344827586206897
"067562006","BUENOS AIRES",194,133,43,17,0,60,0.685567010309278
"067562108","BUENOS AIRES",332,10,256,66,0,322,0.0301204819277108
"067562208","BUENOS AIRES",230,11,177,41,0,218,0.0478260869565217
"067562211","BUENOS AIRES",351,5,257,89,0,346,0.0142450142450142
"067562412","BUENOS AIRES",423,407,6,7,0,13,0.962174940898345
"067562503","BUENOS AIRES",208,2,144,61,0,205,0.00961538461538462
"067562518","BUENOS AIRES",396,5,266,125,0,391,0.0126262626262626
"067562609","BUENOS AIRES",229,212,14,2,0,16,0.925764192139738
"060210601","BUENOS AIRES",123,74,15,33,0,48,0.601626016260163
"067600112","BUENOS AIRES",225,206,12,7,0,19,0.915555555555556
"067600113","BUENOS AIRES",311,229,70,12,0,82,0.736334405144695
"067600202","BUENOS AIRES",410,406,2,1,0,3,0.990243902439024
"067600209","BUENOS AIRES",166,164,2,0,0,2,0.987951807228916
"067600214","BUENOS AIRES",231,227,4,0,0,4,0.982683982683983
"067600217","BUENOS AIRES",219,218,0,1,0,1,0.995433789954338
"067600301","BUENOS AIRES",214,211,1,0,0,1,0.985981308411215
"067600305","BUENOS AIRES",368,327,28,7,0,35,0.888586956521739
"067600307","BUENOS AIRES",97,64,4,21,0,25,0.65979381443299
"067600308","BUENOS AIRES",266,255,6,5,0,11,0.958646616541353
"067600916","BUENOS AIRES",263,0,227,34,0,261,0
"067601003","BUENOS AIRES",185,2,135,41,0,176,0.0108108108108108
"067601011","BUENOS AIRES",120,6,85,26,0,111,0.05
"060561308","BUENOS AIRES",311,311,0,0,0,0,1
"067600401","BUENOS AIRES",223,219,1,1,0,2,0.982062780269058
"067600808","BUENOS AIRES",214,40,125,47,1,173,0.186915887850467
"068401702","BUENOS AIRES",438,434,4,0,0,4,0.990867579908676
"067600802","BUENOS AIRES",465,443,15,5,0,20,0.952688172043011
"067600807","BUENOS AIRES",495,2,413,79,0,492,0.00404040404040404
"067600809","BUENOS AIRES",368,30,299,38,1,338,0.0815217391304348
"067600904","BUENOS AIRES",265,255,8,0,1,9,0.962264150943396
"067600906","BUENOS AIRES",219,213,5,1,0,6,0.972602739726027
"067600915","BUENOS AIRES",184,2,137,45,0,182,0.0108695652173913
"067601208","BUENOS AIRES",234,0,158,73,1,232,0
"067601211","BUENOS AIRES",295,35,193,62,1,256,0.11864406779661
"067601213","BUENOS AIRES",7,2,3,2,0,5,0.285714285714286
"067601217","BUENOS AIRES",401,2,180,199,1,380,0.00498753117206983
"067601303","BUENOS AIRES",164,0,95,68,1,164,0
"067601304","BUENOS AIRES",230,1,171,56,0,227,0.00434782608695652
"067601405","BUENOS AIRES",295,1,158,120,0,278,0.00338983050847458
"067601408","BUENOS AIRES",297,2,194,100,1,295,0.00673400673400673
"067601504","BUENOS AIRES",250,9,133,100,0,233,0.036
"067601506","BUENOS AIRES",223,4,106,105,3,214,0.0179372197309417
"067601507","BUENOS AIRES",314,4,199,100,0,299,0.0127388535031847
"067601508","BUENOS AIRES",364,2,212,138,1,351,0.00549450549450549
"067601510","BUENOS AIRES",202,15,35,140,2,177,0.0742574257425743
"067601801","BUENOS AIRES",292,3,167,108,2,277,0.0102739726027397
"060561412","BUENOS AIRES",176,174,1,1,0,2,0.988636363636364
"067601804","BUENOS AIRES",439,3,177,233,1,411,0.00683371298405467
"067601810","BUENOS AIRES",291,0,188,93,5,286,0
"067630102","BUENOS AIRES",328,318,7,2,0,9,0.969512195121951
"067630113","BUENOS AIRES",286,251,23,12,0,35,0.877622377622378
"067630114","BUENOS AIRES",269,223,33,12,0,45,0.828996282527881
"067630303","BUENOS AIRES",228,227,1,0,0,1,0.995614035087719
"067630309","BUENOS AIRES",405,392,6,5,0,11,0.967901234567901
"067701009","BUENOS AIRES",335,327,4,3,0,7,0.976119402985075
"067630502","BUENOS AIRES",302,110,25,120,18,163,0.364238410596026
"067630516","BUENOS AIRES",224,116,83,24,0,107,0.517857142857143
"067630605","BUENOS AIRES",314,1,118,181,5,304,0.00318471337579618
"067630612","BUENOS AIRES",257,4,146,100,1,247,0.0155642023346304
"067630704","BUENOS AIRES",309,19,234,55,0,289,0.0614886731391586
"067630710","BUENOS AIRES",418,282,108,21,0,129,0.674641148325359
"067630810","BUENOS AIRES",248,9,48,181,2,231,0.0362903225806452
"067631702","BUENOS AIRES",289,287,1,0,0,1,0.993079584775087
"067631806","BUENOS AIRES",201,38,55,107,0,162,0.189054726368159
"067631809","BUENOS AIRES",212,211,0,0,1,1,0.995283018867924
"067631811","BUENOS AIRES",305,305,0,0,0,0,1
"067700901","BUENOS AIRES",197,164,9,21,0,30,0.83248730964467
"067702212","BUENOS AIRES",326,325,0,0,0,0,0.996932515337423
"067702102","BUENOS AIRES",301,294,5,2,0,7,0.976744186046512
"067702109","BUENOS AIRES",257,257,0,0,0,0,1
"067702201","BUENOS AIRES",291,59,36,143,4,183,0.202749140893471
"067780111","BUENOS AIRES",53,1,44,8,0,52,0.0188679245283019
"060561413","BUENOS AIRES",282,282,0,0,0,0,1
"067780208","BUENOS AIRES",239,224,11,4,0,15,0.937238493723849
"067780902","BUENOS AIRES",127,4,66,53,0,119,0.031496062992126
"067910407","BUENOS AIRES",209,209,0,0,0,0,1
"067911203","BUENOS AIRES",433,207,60,154,5,219,0.478060046189376
"067911210","BUENOS AIRES",334,303,16,14,0,30,0.907185628742515
"067780903","BUENOS AIRES",262,3,149,102,3,254,0.0114503816793893
"067780908","BUENOS AIRES",113,1,38,66,1,105,0.00884955752212389
"068050511","BUENOS AIRES",510,5,267,200,0,467,0.00980392156862745
"067781014","BUENOS AIRES",283,28,72,141,3,216,0.0989399293286219
"067840802","BUENOS AIRES",85,1,17,60,1,78,0.0117647058823529
"067840811","BUENOS AIRES",333,146,88,98,0,186,0.438438438438438
"067910102","BUENOS AIRES",178,176,1,1,0,2,0.98876404494382
"067910103","BUENOS AIRES",232,226,3,2,1,6,0.974137931034483
"067910104","BUENOS AIRES",172,167,3,2,0,5,0.970930232558139
"067910202","BUENOS AIRES",304,293,5,5,0,10,0.963815789473684
"067911301","BUENOS AIRES",499,172,105,214,1,320,0.344689378757515
"067911809","BUENOS AIRES",265,255,6,2,0,8,0.962264150943396
"067911902","BUENOS AIRES",234,234,0,0,0,0,1
"067911911","BUENOS AIRES",243,242,1,0,0,1,0.995884773662551
"067912008","BUENOS AIRES",171,1,141,28,0,169,0.00584795321637427
"068050704","BUENOS AIRES",275,204,39,32,0,71,0.741818181818182
"067912203","BUENOS AIRES",207,4,165,38,0,203,0.0193236714975845
"067912115","BUENOS AIRES",119,2,39,72,3,114,0.0168067226890756
"067912202","BUENOS AIRES",148,22,45,80,0,125,0.148648648648649
"067912208","BUENOS AIRES",403,332,31,40,0,71,0.823821339950372
"068051209","BUENOS AIRES",213,9,170,34,0,204,0.0422535211267606
"068401704","BUENOS AIRES",266,266,0,0,0,0,1
"067912216","BUENOS AIRES",311,170,68,72,0,140,0.546623794212219
"067980701","BUENOS AIRES",198,58,51,89,0,140,0.292929292929293
"068050201","BUENOS AIRES",112,1,30,75,3,108,0.00892857142857143
"068401209","BUENOS AIRES",273,266,6,1,0,7,0.974358974358974
"068050411","BUENOS AIRES",429,411,6,1,0,7,0.958041958041958
"068050508","BUENOS AIRES",381,12,229,140,0,369,0.031496062992126
"068051317","BUENOS AIRES",269,3,204,62,0,266,0.0111524163568773
"068050301","BUENOS AIRES",88,87,1,0,0,1,0.988636363636364
"068050402","BUENOS AIRES",246,0,78,155,2,235,0
"068050406","BUENOS AIRES",347,15,88,235,2,325,0.0432276657060519
"068051013","BUENOS AIRES",228,220,8,0,0,8,0.964912280701754
"060561416","BUENOS AIRES",328,327,1,0,0,1,0.996951219512195
"068050705","BUENOS AIRES",295,231,34,25,1,60,0.783050847457627
"068050801","BUENOS AIRES",137,93,26,17,0,43,0.678832116788321
"068050802","BUENOS AIRES",91,85,4,2,0,6,0.934065934065934
"068050813","BUENOS AIRES",562,32,114,379,11,504,0.0569395017793594
"068051001","BUENOS AIRES",501,10,341,143,3,487,0.0199600798403194
"068051005","BUENOS AIRES",277,3,186,86,0,272,0.0108303249097473
"068051101","BUENOS AIRES",367,7,145,204,0,349,0.0190735694822888
"068051107","BUENOS AIRES",386,15,190,150,0,340,0.038860103626943
"068051301","BUENOS AIRES",392,381,10,0,1,11,0.971938775510204
"068051305","BUENOS AIRES",362,6,234,117,0,351,0.0165745856353591
"068051308","BUENOS AIRES",597,11,359,211,2,572,0.0184254606365159
"068051309","BUENOS AIRES",304,12,122,143,7,272,0.0394736842105263
"068051403","BUENOS AIRES",373,13,180,177,0,357,0.0348525469168901
"068051410","BUENOS AIRES",304,2,143,126,0,269,0.00657894736842105
"068051511","BUENOS AIRES",299,5,139,124,1,264,0.0167224080267559
"068051512","BUENOS AIRES",244,2,194,48,0,242,0.00819672131147541
"068051704","BUENOS AIRES",267,0,226,40,0,266,0
"068051906","BUENOS AIRES",491,8,338,140,0,478,0.0162932790224033
"068051912","BUENOS AIRES",403,3,331,65,0,396,0.00744416873449132
"068052002","BUENOS AIRES",278,8,178,88,2,268,0.0287769784172662
"068052006","BUENOS AIRES",329,104,149,69,0,218,0.316109422492401
"068052101","BUENOS AIRES",334,1,73,226,9,308,0.0029940119760479
"068052105","BUENOS AIRES",353,8,198,136,0,334,0.0226628895184136
"068261610","BUENOS AIRES",207,174,10,22,0,32,0.840579710144927
"068402309","BUENOS AIRES",238,231,3,4,0,7,0.970588235294118
"068052307","BUENOS AIRES",456,1,233,214,1,448,0.00219298245614035
"068052309","BUENOS AIRES",204,0,81,94,0,175,0
"068052502","BUENOS AIRES",307,0,129,168,0,297,0
"068052505","BUENOS AIRES",420,1,210,189,2,401,0.00238095238095238
"060280207","BUENOS AIRES",310,1,130,168,0,298,0.0032258064516129
"068120502","BUENOS AIRES",174,0,157,15,0,172,0
"068190402","BUENOS AIRES",428,390,18,14,1,33,0.911214953271028
"068190910","BUENOS AIRES",157,1,129,25,1,155,0.00636942675159236
"068260108","BUENOS AIRES",321,303,13,4,0,17,0.94392523364486
"068260120","BUENOS AIRES",276,253,9,12,0,21,0.916666666666667
"068260202","BUENOS AIRES",404,401,1,2,0,3,0.992574257425743
"068260212","BUENOS AIRES",291,279,7,5,0,12,0.958762886597938
"068261902","BUENOS AIRES",308,298,6,4,0,10,0.967532467532468
"068330103","BUENOS AIRES",266,265,1,0,0,1,0.996240601503759
"068330115","BUENOS AIRES",78,18,11,49,0,60,0.230769230769231
"068330208","BUENOS AIRES",333,331,2,0,0,2,0.993993993993994
"068331012","BUENOS AIRES",523,289,98,124,2,224,0.552581261950287
"068331701","BUENOS AIRES",141,1,72,61,0,133,0.00709219858156028
"068331806","BUENOS AIRES",52,2,31,19,0,50,0.0384615384615385
"068401408","BUENOS AIRES",159,158,1,0,0,1,0.993710691823899
"068331908","BUENOS AIRES",296,154,60,75,1,136,0.52027027027027
"068400206","BUENOS AIRES",329,141,114,74,0,188,0.428571428571429
"068400106","BUENOS AIRES",409,4,163,234,1,398,0.0097799511002445
"068400201","BUENOS AIRES",398,0,224,171,0,395,0
"068400202","BUENOS AIRES",437,4,256,171,0,427,0.0091533180778032
"068400311","BUENOS AIRES",475,46,184,236,1,421,0.0968421052631579
"064901006","BUENOS AIRES",210,207,1,2,0,3,0.985714285714286
"068400402","BUENOS AIRES",459,179,52,197,0,249,0.389978213507625
"068400412","BUENOS AIRES",212,170,23,17,0,40,0.80188679245283
"068400501","BUENOS AIRES",346,12,213,114,0,327,0.0346820809248555
"068400503","BUENOS AIRES",318,6,148,160,0,308,0.0188679245283019
"068400608","BUENOS AIRES",211,199,4,7,0,11,0.943127962085308
"068400611","BUENOS AIRES",204,198,2,3,0,5,0.970588235294118
"068400614","BUENOS AIRES",369,356,7,3,0,10,0.964769647696477
"068400615","BUENOS AIRES",309,299,4,6,0,10,0.967637540453074
"068400710","BUENOS AIRES",391,383,3,4,0,7,0.979539641943734
"068400803","BUENOS AIRES",177,173,4,0,0,4,0.977401129943503
"068401707","BUENOS AIRES",237,237,0,0,0,0,1
"068401901","BUENOS AIRES",203,203,0,0,0,0,1
"068401902","BUENOS AIRES",228,224,3,0,0,3,0.982456140350877
"068401911","BUENOS AIRES",332,322,8,2,0,10,0.969879518072289
"068402010","BUENOS AIRES",245,231,9,4,0,13,0.942857142857143
"068402306","BUENOS AIRES",191,188,1,0,0,1,0.984293193717278
"068402308","BUENOS AIRES",444,423,2,15,0,17,0.952702702702703
"068402401","BUENOS AIRES",346,331,9,4,0,13,0.956647398843931
"068402502","BUENOS AIRES",59,13,8,38,0,46,0.220338983050847
"068402503","BUENOS AIRES",170,7,10,147,0,157,0.0411764705882353
"068402509","BUENOS AIRES",160,138,5,4,0,9,0.8625
"068402707","BUENOS AIRES",275,270,3,1,0,4,0.981818181818182
"068402811","BUENOS AIRES",344,339,3,1,0,4,0.98546511627907
"068402908","BUENOS AIRES",302,291,8,3,0,11,0.963576158940397
"068403006","BUENOS AIRES",230,221,3,1,0,4,0.960869565217391
"068403011","BUENOS AIRES",296,276,13,7,0,20,0.932432432432432
"068403204","BUENOS AIRES",321,319,1,0,1,2,0.993769470404984
"068470115","BUENOS AIRES",164,0,133,31,0,164,0
"068120201","BUENOS AIRES",8,0,2,6,0,8,0
"068540106","BUENOS AIRES",257,249,3,5,0,8,0.968871595330739
"068261804","BUENOS AIRES",42,0,16,26,0,42,0
"068331810","BUENOS AIRES",11,0,0,10,0,10,0
"068190408","BUENOS AIRES",59,0,35,24,0,59,0
"068331707","BUENOS AIRES",13,0,7,6,0,13,0
"064273210","BUENOS AIRES",222,222,0,0,0,0,1
"068190502","BUENOS AIRES",24,0,19,5,0,24,0
"068540114","BUENOS AIRES",210,94,20,96,0,116,0.447619047619048
"068260302","BUENOS AIRES",6,0,1,4,1,6,0
"068260602","BUENOS AIRES",26,0,13,11,2,26,0
"068260801","BUENOS AIRES",65,1,35,25,2,62,0.0153846153846154
"068260901","BUENOS AIRES",20,0,18,2,0,20,0
"068261001","BUENOS AIRES",47,0,18,27,1,46,0
"068261002","BUENOS AIRES",33,0,16,16,0,32,0
"068261502","BUENOS AIRES",25,1,2,20,1,23,0.04
"068330704","BUENOS AIRES",18,0,7,9,2,18,0
"068330901","BUENOS AIRES",11,0,3,8,0,11,0
"068330902","BUENOS AIRES",14,0,1,12,0,13,0
"068611005","BUENOS AIRES",324,321,1,2,0,3,0.990740740740741
"068611307","BUENOS AIRES",251,251,0,0,0,0,1
"068611412","BUENOS AIRES",229,229,0,0,0,0,1
"068820209","BUENOS AIRES",308,307,1,0,0,1,0.996753246753247
"068540601","BUENOS AIRES",64,0,16,48,0,64,0
"068540702","BUENOS AIRES",31,0,10,21,0,31,0
"068750607","BUENOS AIRES",24,0,15,9,0,24,0
"068540802","BUENOS AIRES",79,1,30,45,2,77,0.0126582278481013
"068820701","BUENOS AIRES",59,24,7,25,0,32,0.406779661016949
"068611601","BUENOS AIRES",211,210,1,0,0,1,0.995260663507109
"065680202","BUENOS AIRES",204,184,13,7,0,20,0.901960784313726
"068821401","BUENOS AIRES",160,1,70,86,0,156,0.00625
"068541001","BUENOS AIRES",172,78,43,50,0,93,0.453488372093023
"064202008","BUENOS AIRES",25,25,0,0,0,0,1
"068610107","BUENOS AIRES",253,252,1,0,0,1,0.99604743083004
"068610109","BUENOS AIRES",245,245,0,0,0,0,1
"068610204","BUENOS AIRES",340,340,0,0,0,0,1
"068610410","BUENOS AIRES",258,258,0,0,0,0,1
"068610608","BUENOS AIRES",164,164,0,0,0,0,1
"068610605","BUENOS AIRES",133,133,0,0,0,0,1
"068610611","BUENOS AIRES",150,150,0,0,0,0,1
"068610803","BUENOS AIRES",200,200,0,0,0,0,1
"068611003","BUENOS AIRES",366,365,1,0,0,1,0.997267759562842
"068750604","BUENOS AIRES",417,15,312,87,1,400,0.0359712230215827
"068611605","BUENOS AIRES",292,290,2,0,0,2,0.993150684931507
"068611706","BUENOS AIRES",257,252,4,0,0,4,0.980544747081712
"068611805","BUENOS AIRES",205,204,0,0,0,0,0.995121951219512
"068611808","BUENOS AIRES",305,303,2,0,0,2,0.99344262295082
"068611906","BUENOS AIRES",296,296,0,0,0,0,1
"068611912","BUENOS AIRES",360,359,0,1,0,1,0.997222222222222
"068612001","BUENOS AIRES",362,337,19,0,0,19,0.930939226519337
"068612002","BUENOS AIRES",270,257,10,0,0,10,0.951851851851852
"068612006","BUENOS AIRES",368,339,22,0,0,22,0.921195652173913
"068612204","BUENOS AIRES",309,307,2,0,0,2,0.993527508090615
"068612206","BUENOS AIRES",319,317,1,1,0,2,0.993730407523511
"068612305","BUENOS AIRES",404,311,4,40,0,44,0.76980198019802
"068612411","BUENOS AIRES",429,423,5,1,0,6,0.986013986013986
"068612610","BUENOS AIRES",309,309,0,0,0,0,1
"068612808","BUENOS AIRES",190,188,1,1,0,2,0.989473684210526
"068612912","BUENOS AIRES",193,193,0,0,0,0,1
"068613106","BUENOS AIRES",341,331,8,1,0,9,0.970674486803519
"068613205","BUENOS AIRES",163,157,0,0,0,0,0.96319018404908
"068613208","BUENOS AIRES",254,246,6,0,0,6,0.968503937007874
"068613310","BUENOS AIRES",392,356,27,0,0,27,0.908163265306122
"064273308","BUENOS AIRES",288,283,3,2,0,5,0.982638888888889
"068680104","BUENOS AIRES",204,67,113,24,0,137,0.32843137254902
"068680202","BUENOS AIRES",50,50,0,0,0,0,1
"068680203","BUENOS AIRES",78,75,3,0,0,3,0.961538461538462
"068680210","BUENOS AIRES",71,70,1,0,0,1,0.985915492957746
"068680303","BUENOS AIRES",196,175,10,11,0,21,0.892857142857143
"068680304","BUENOS AIRES",182,146,31,5,0,36,0.802197802197802
"068680610","BUENOS AIRES",24,23,1,0,0,1,0.958333333333333
"068680710","BUENOS AIRES",21,20,1,0,0,1,0.952380952380952
"068680804","BUENOS AIRES",177,105,44,28,0,72,0.593220338983051
"068750609","BUENOS AIRES",176,54,94,27,0,121,0.306818181818182
"068750802","BUENOS AIRES",159,1,103,53,2,158,0.00628930817610063
"068751603","BUENOS AIRES",525,260,107,122,8,237,0.495238095238095
"068820103","BUENOS AIRES",403,380,8,12,0,20,0.942928039702233
"068820108","BUENOS AIRES",333,328,5,0,0,5,0.984984984984985
"068820507","BUENOS AIRES",166,126,18,21,0,39,0.759036144578313
"068820508","BUENOS AIRES",352,212,57,70,0,127,0.602272727272727
"068820901","BUENOS AIRES",465,14,125,312,5,442,0.0301075268817204
"068821001","BUENOS AIRES",277,276,1,0,0,1,0.996389891696751
"068821008","BUENOS AIRES",272,59,52,161,0,213,0.216911764705882
"065601402","BUENOS AIRES",413,4,205,186,6,397,0.00968523002421308
"065601403","BUENOS AIRES",341,3,67,263,4,334,0.00879765395894428
"065601409","BUENOS AIRES",236,2,85,145,1,231,0.00847457627118644
"065601503","BUENOS AIRES",293,3,158,130,0,288,0.0102389078498294
"065150903","BUENOS AIRES",267,0,201,62,1,264,0
"065601511","BUENOS AIRES",395,2,163,216,3,382,0.00506329113924051
"065601515","BUENOS AIRES",408,4,178,219,1,398,0.00980392156862745
"065680304","BUENOS AIRES",259,21,159,77,0,236,0.0810810810810811
"020131710","CABA",398,398,0,0,0,0,1
"065601601","BUENOS AIRES",334,1,131,177,7,315,0.0029940119760479
"065601614","BUENOS AIRES",417,3,244,156,4,404,0.00719424460431655
"065601814","BUENOS AIRES",448,3,293,141,0,434,0.00669642857142857
"067702207","BUENOS AIRES",280,233,5,31,1,37,0.832142857142857
"067702210","BUENOS AIRES",288,282,4,2,0,6,0.979166666666667
"065601711","BUENOS AIRES",176,111,57,7,0,64,0.630681818181818
"065601715","BUENOS AIRES",180,0,125,48,0,173,0
"065680201","BUENOS AIRES",299,224,54,21,0,75,0.749163879598662
"065601815","BUENOS AIRES",364,0,275,84,0,359,0
"065680508","BUENOS AIRES",359,357,1,0,0,1,0.994428969359331
"065601919","BUENOS AIRES",182,2,56,104,4,164,0.010989010989011
"065602104","BUENOS AIRES",199,0,79,103,2,184,0
"067780905","BUENOS AIRES",393,107,145,111,4,260,0.272264631043257
"065602106","BUENOS AIRES",264,42,76,140,1,217,0.159090909090909
"065602102","BUENOS AIRES",211,1,124,81,2,207,0.004739336492891
"065602205","BUENOS AIRES",404,353,35,14,0,49,0.873762376237624
"065602208","BUENOS AIRES",399,391,5,3,0,8,0.979949874686717
"065602312","BUENOS AIRES",189,187,1,1,0,2,0.989417989417989
"065602314","BUENOS AIRES",219,211,8,0,0,8,0.963470319634703
"065602412","BUENOS AIRES",191,188,1,2,0,3,0.984293193717278
"065680208","BUENOS AIRES",351,17,286,47,0,333,0.0484330484330484
"060282913","BUENOS AIRES",274,0,187,78,3,268,0
"065680510","BUENOS AIRES",210,206,3,0,0,3,0.980952380952381
"067911314","BUENOS AIRES",287,257,9,19,0,28,0.895470383275261
"065680701","BUENOS AIRES",310,0,237,73,0,310,0
"065681005","BUENOS AIRES",299,28,235,35,0,270,0.0936454849498328
"065681009","BUENOS AIRES",309,5,226,61,0,287,0.0161812297734628
"065681014","BUENOS AIRES",277,275,1,1,0,2,0.992779783393502
"065681108","BUENOS AIRES",343,343,0,0,0,0,1
"065681206","BUENOS AIRES",398,394,3,0,0,3,0.989949748743719
"060070516","BUENOS AIRES",3,0,1,2,0,3,0
"062170903","BUENOS AIRES",24,0,7,16,1,24,0
"067000109","BUENOS AIRES",2,0,0,2,0,2,0
"064904902","BUENOS AIRES",336,326,6,4,0,10,0.970238095238095
"064905005","BUENOS AIRES",221,216,5,0,0,5,0.97737556561086
"064905104","BUENOS AIRES",192,4,133,54,0,187,0.0208333333333333
"064905106","BUENOS AIRES",358,3,179,175,0,354,0.00837988826815642
"066583411","BUENOS AIRES",391,311,43,12,0,55,0.79539641943734
"064970303","BUENOS AIRES",231,2,136,91,1,228,0.00865800865800866
"064970311","BUENOS AIRES",283,2,123,143,0,266,0.00706713780918728
"065151911","BUENOS AIRES",502,0,336,146,0,482,0
"064970312","BUENOS AIRES",371,2,208,157,2,367,0.00539083557951483
"064970510","BUENOS AIRES",429,161,116,144,0,260,0.375291375291375
"067070111","BUENOS AIRES",145,0,36,107,0,143,0
"064970501","BUENOS AIRES",230,182,37,8,0,45,0.791304347826087
"064970506","BUENOS AIRES",374,2,85,265,8,358,0.0053475935828877
"064970509","BUENOS AIRES",409,365,30,14,0,44,0.89242053789731
"064970611","BUENOS AIRES",189,0,165,24,0,189,0
"065150512","BUENOS AIRES",479,6,311,160,0,471,0.0125260960334029
"060910206","BUENOS AIRES",202,199,1,2,0,3,0.985148514851485
"065150612","BUENOS AIRES",227,1,195,21,1,217,0.00440528634361234
"060351110","BUENOS AIRES",350,350,0,0,0,0,1
"064970701","BUENOS AIRES",297,293,1,3,0,4,0.986531986531986
"064970809","BUENOS AIRES",297,0,151,140,1,292,0
"064971101","BUENOS AIRES",359,346,7,6,0,13,0.963788300835655
"064971105","BUENOS AIRES",356,351,2,3,0,5,0.985955056179775
"065152007","BUENOS AIRES",249,0,152,94,0,246,0
"065152011","BUENOS AIRES",232,3,147,76,0,223,0.0129310344827586
"065050321","BUENOS AIRES",162,22,76,62,0,138,0.135802469135802
"066721216","BUENOS AIRES",286,274,6,6,0,12,0.958041958041958
"065110506","BUENOS AIRES",238,230,5,3,0,8,0.966386554621849
"067070801","BUENOS AIRES",81,0,37,44,0,81,0
"065180710","BUENOS AIRES",103,2,91,10,0,101,0.0194174757281553
"060910205","BUENOS AIRES",269,266,3,0,0,3,0.988847583643123
"065150103","BUENOS AIRES",468,3,262,182,3,447,0.00641025641025641
"065150111","BUENOS AIRES",426,7,178,221,1,400,0.0164319248826291
"065150113","BUENOS AIRES",579,1,274,281,0,555,0.00172711571675302
"065150211","BUENOS AIRES",351,2,246,93,3,342,0.0056980056980057
"065150303","BUENOS AIRES",368,5,113,241,0,354,0.0135869565217391
"065150308","BUENOS AIRES",277,1,214,62,0,276,0.0036101083032491
"065150309","BUENOS AIRES",253,0,181,65,1,247,0
"065150313","BUENOS AIRES",229,1,194,32,0,226,0.00436681222707424
"065150410","BUENOS AIRES",289,2,147,112,1,260,0.0069204152249135
"065150508","BUENOS AIRES",214,0,186,27,1,214,0
"065150913","BUENOS AIRES",434,5,196,179,0,375,0.0115207373271889
"060351206","BUENOS AIRES",227,227,0,0,0,0,1
"060492002","BUENOS AIRES",357,248,80,28,1,109,0.694677871148459
"060492501","BUENOS AIRES",272,173,21,76,1,98,0.636029411764706
"065151007","BUENOS AIRES",80,2,63,15,0,78,0.025
"060560711","BUENOS AIRES",374,320,21,27,0,48,0.855614973262032
"065151008","BUENOS AIRES",413,2,319,86,1,406,0.00484261501210654
"060562001","BUENOS AIRES",414,412,2,0,0,2,0.995169082125604
"060563006","BUENOS AIRES",73,1,51,20,0,71,0.0136986301369863
"065151108","BUENOS AIRES",261,4,191,58,1,250,0.0153256704980843
"065151201","BUENOS AIRES",237,2,183,51,0,234,0.00843881856540084
"060912206","BUENOS AIRES",414,55,140,207,1,348,0.132850241545894
"061260914","BUENOS AIRES",245,2,32,191,4,227,0.00816326530612245
"060070805","BUENOS AIRES",176,103,28,41,0,69,0.585227272727273
"060070801","BUENOS AIRES",32,1,7,23,0,30,0.03125
"060210603","BUENOS AIRES",296,288,5,2,0,7,0.972972972972973
"061821001","BUENOS AIRES",195,193,0,2,0,2,0.98974358974359
"061821002","BUENOS AIRES",158,156,2,0,0,2,0.987341772151899
"060210602","BUENOS AIRES",422,412,3,7,0,10,0.976303317535545
"060280201","BUENOS AIRES",456,9,102,270,41,413,0.0197368421052632
"060280302","BUENOS AIRES",430,2,136,263,1,400,0.00465116279069767
"060280407","BUENOS AIRES",422,8,153,217,6,376,0.018957345971564
"060281706","BUENOS AIRES",456,455,1,0,0,1,0.99780701754386
"060280408","BUENOS AIRES",401,2,148,209,9,366,0.00498753117206983
"060280411","BUENOS AIRES",380,11,166,179,1,346,0.0289473684210526
"060280506","BUENOS AIRES",198,0,108,83,0,191,0
"060280604","BUENOS AIRES",1165,5,602,498,2,1102,0.00429184549356223
"060280709","BUENOS AIRES",361,5,189,153,1,343,0.0138504155124654
"060280804","BUENOS AIRES",60,0,27,32,0,59,0
"060280808","BUENOS AIRES",337,8,168,155,0,323,0.0237388724035608
"060280907","BUENOS AIRES",316,3,128,176,2,306,0.00949367088607595
"060281008","BUENOS AIRES",442,10,270,154,0,424,0.0226244343891403
"060281110","BUENOS AIRES",475,104,228,141,0,369,0.218947368421053
"060281112","BUENOS AIRES",254,4,199,48,0,247,0.015748031496063
"060281310","BUENOS AIRES",392,5,298,87,0,385,0.0127551020408163
"060281408","BUENOS AIRES",306,5,195,100,2,297,0.0163398692810458
"060281506","BUENOS AIRES",259,2,185,67,0,252,0.00772200772200772
"061961201","BUENOS AIRES",4,0,1,2,1,4,0
"060281808","BUENOS AIRES",438,39,162,227,1,390,0.089041095890411
"060281809","BUENOS AIRES",295,84,111,90,0,201,0.284745762711864
"060281908","BUENOS AIRES",361,148,112,90,2,204,0.409972299168975
"060281909","BUENOS AIRES",407,399,8,0,0,8,0.98034398034398
"060281910","BUENOS AIRES",255,217,32,4,0,36,0.850980392156863
"060282014","BUENOS AIRES",352,1,224,116,2,342,0.00284090909090909
"060282101","BUENOS AIRES",213,0,196,17,0,213,0
"060282204","BUENOS AIRES",263,6,131,122,0,253,0.0228136882129278
"060282305","BUENOS AIRES",241,3,215,22,0,237,0.012448132780083
"060282601","BUENOS AIRES",157,155,1,1,0,2,0.987261146496815
"060282611","BUENOS AIRES",149,79,39,30,0,69,0.530201342281879
"060282704","BUENOS AIRES",316,3,194,119,0,313,0.00949367088607595
"060282806","BUENOS AIRES",523,4,248,265,0,513,0.00764818355640535
"060282809","BUENOS AIRES",339,1,154,175,0,329,0.00294985250737463
"060282911","BUENOS AIRES",308,0,177,118,0,295,0
"060630113","BUENOS AIRES",272,267,5,0,0,5,0.981617647058823
"060283003","BUENOS AIRES",236,35,96,89,3,188,0.148305084745763
"060283005","BUENOS AIRES",284,17,139,123,1,263,0.0598591549295775
"060283101","BUENOS AIRES",288,3,223,62,0,285,0.0104166666666667
"060283105","BUENOS AIRES",258,2,176,79,0,255,0.00775193798449612
"060283304","BUENOS AIRES",270,64,174,31,0,205,0.237037037037037
"060283307","BUENOS AIRES",403,0,210,180,1,391,0
"060283402","BUENOS AIRES",389,0,292,96,0,388,0
"060283405","BUENOS AIRES",275,1,211,55,0,266,0.00363636363636364
"060283407","BUENOS AIRES",223,0,203,19,0,222,0
"060283408","BUENOS AIRES",335,0,314,21,0,335,0
"060283603","BUENOS AIRES",280,116,152,9,3,164,0.414285714285714
"060283610","BUENOS AIRES",316,0,240,67,1,308,0
"060283612","BUENOS AIRES",381,0,70,262,9,341,0
"060351301","BUENOS AIRES",306,295,4,6,0,10,0.964052287581699
"060351208","BUENOS AIRES",342,338,3,0,0,3,0.988304093567251
"060283712","BUENOS AIRES",394,8,263,114,2,379,0.0203045685279188
"060283809","BUENOS AIRES",287,2,190,88,0,278,0.00696864111498258
"060283901","BUENOS AIRES",317,0,152,151,1,304,0
"060283903","BUENOS AIRES",299,0,160,120,0,280,0
"060283914","BUENOS AIRES",227,0,145,77,2,224,0
"060350402","BUENOS AIRES",273,24,149,99,1,249,0.0879120879120879
"060350411","BUENOS AIRES",430,374,35,20,0,55,0.869767441860465
"060350506","BUENOS AIRES",445,23,210,201,1,412,0.051685393258427
"060350508","BUENOS AIRES",343,303,24,14,0,38,0.883381924198251
"060350601","BUENOS AIRES",336,230,47,58,0,105,0.68452380952381
"060350702","BUENOS AIRES",347,312,18,13,1,32,0.899135446685879
"060350707","BUENOS AIRES",199,142,37,20,0,57,0.71356783919598
"060350712","BUENOS AIRES",98,74,13,10,0,23,0.755102040816326
"060350803","BUENOS AIRES",344,336,1,0,0,1,0.976744186046512
"060350914","BUENOS AIRES",254,229,5,20,0,25,0.901574803149606
"060351006","BUENOS AIRES",310,301,3,0,0,3,0.970967741935484
"060351009","BUENOS AIRES",140,140,0,0,0,0,1
"060351106","BUENOS AIRES",350,349,1,0,0,1,0.997142857142857
"062171211","BUENOS AIRES",195,160,15,19,0,34,0.82051282051282
"060351306","BUENOS AIRES",235,160,49,26,0,75,0.680851063829787
"060351401","BUENOS AIRES",262,260,1,0,0,1,0.99236641221374
"060351404","BUENOS AIRES",302,300,2,0,0,2,0.993377483443709
"060351406","BUENOS AIRES",225,224,0,1,0,1,0.995555555555556
"060351410","BUENOS AIRES",333,329,1,1,0,2,0.987987987987988
"060351507","BUENOS AIRES",291,140,106,45,0,151,0.481099656357388
"060351510","BUENOS AIRES",240,146,53,41,0,94,0.608333333333333
"060351607","BUENOS AIRES",206,23,122,61,0,183,0.111650485436893
"060351802","BUENOS AIRES",309,59,124,126,0,250,0.190938511326861
"060352010","BUENOS AIRES",314,249,31,33,0,64,0.792993630573248
"060352011","BUENOS AIRES",281,225,33,21,1,55,0.800711743772242
"060352105","BUENOS AIRES",184,184,0,0,0,0,1
"060352208","BUENOS AIRES",215,213,0,2,0,2,0.990697674418605
"060352301","BUENOS AIRES",165,140,9,16,0,25,0.848484848484849
"060352307","BUENOS AIRES",326,272,13,29,0,42,0.834355828220859
"060352310","BUENOS AIRES",325,297,17,11,0,28,0.913846153846154
"060352408","BUENOS AIRES",350,193,61,94,0,155,0.551428571428571
"060352503","BUENOS AIRES",447,145,160,137,0,297,0.324384787472036
"060352506","BUENOS AIRES",330,209,48,73,0,121,0.633333333333333
"060352510","BUENOS AIRES",555,359,73,119,0,192,0.646846846846847
"060352602","BUENOS AIRES",414,382,11,12,1,24,0.922705314009662
"060352711","BUENOS AIRES",469,40,85,323,1,409,0.0852878464818763
"060352807","BUENOS AIRES",261,49,148,64,0,212,0.187739463601533
"060352901","BUENOS AIRES",223,153,44,25,0,69,0.68609865470852
"060352905","BUENOS AIRES",254,141,77,36,0,113,0.55511811023622
"060353003","BUENOS AIRES",301,218,53,29,0,82,0.724252491694352
"060353005","BUENOS AIRES",262,195,49,18,0,67,0.744274809160305
"060353103","BUENOS AIRES",271,260,7,4,0,11,0.959409594095941
"060353107","BUENOS AIRES",152,115,19,16,0,35,0.756578947368421
"060353108","BUENOS AIRES",251,32,161,58,0,219,0.127490039840637
"060353304","BUENOS AIRES",289,284,3,2,0,5,0.982698961937716
"060353307","BUENOS AIRES",295,291,3,1,0,4,0.986440677966102
"065151302","BUENOS AIRES",333,1,246,81,0,327,0.003003003003003
"060490109","BUENOS AIRES",274,268,2,4,0,6,0.978102189781022
"060490208","BUENOS AIRES",304,262,21,20,0,41,0.861842105263158
"060490213","BUENOS AIRES",235,73,30,129,1,160,0.31063829787234
"060490406","BUENOS AIRES",154,146,3,5,0,8,0.948051948051948
"060490507","BUENOS AIRES",315,268,28,17,0,45,0.850793650793651
"060490604","BUENOS AIRES",289,251,11,27,0,38,0.868512110726644
"060490610","BUENOS AIRES",156,120,19,16,0,35,0.769230769230769
"060490701","BUENOS AIRES",4,0,1,3,0,4,0
"060491006","BUENOS AIRES",117,48,26,43,0,69,0.41025641025641
"062450408","BUENOS AIRES",139,3,115,21,0,136,0.0215827338129496
"060560103","BUENOS AIRES",391,388,2,1,0,3,0.9923273657289
"060560108","BUENOS AIRES",479,479,0,0,0,0,1
"060560117","BUENOS AIRES",220,219,1,0,0,1,0.995454545454545
"060560201","BUENOS AIRES",302,4,58,223,5,286,0.0132450331125828
"060561506","BUENOS AIRES",319,288,11,16,0,27,0.90282131661442
"060560307","BUENOS AIRES",221,217,3,1,0,4,0.981900452488688
"060560308","BUENOS AIRES",184,182,1,1,0,2,0.989130434782609
"060560408","BUENOS AIRES",258,256,1,1,0,2,0.992248062015504
"060560503","BUENOS AIRES",407,276,55,69,0,124,0.678132678132678
"060560605","BUENOS AIRES",412,387,3,20,0,23,0.939320388349515
"060560809","BUENOS AIRES",509,173,39,279,1,319,0.339882121807466
"060560810","BUENOS AIRES",218,82,12,112,1,125,0.376146788990826
"060560907","BUENOS AIRES",226,226,0,0,0,0,1
"060561003","BUENOS AIRES",288,288,0,0,0,0,1
"060561208","BUENOS AIRES",233,233,0,0,0,0,1
"060561303","BUENOS AIRES",313,312,1,0,0,1,0.996805111821086
"060561306","BUENOS AIRES",260,259,1,0,0,1,0.996153846153846
"060561310","BUENOS AIRES",242,242,0,0,0,0,1
"064273010","BUENOS AIRES",306,248,13,2,1,16,0.810457516339869
"060561411","BUENOS AIRES",206,206,0,0,0,0,1
"060561510","BUENOS AIRES",212,211,0,1,0,1,0.995283018867924
"060561804","BUENOS AIRES",233,231,1,0,0,1,0.991416309012876
"060561809","BUENOS AIRES",309,297,5,5,0,10,0.961165048543689
"060561903","BUENOS AIRES",440,431,6,1,0,7,0.979545454545454
"060561909","BUENOS AIRES",248,208,7,22,0,29,0.838709677419355
"060562306","BUENOS AIRES",309,308,1,0,0,1,0.996763754045307
"060562307","BUENOS AIRES",272,260,3,9,0,12,0.955882352941177
"060562503","BUENOS AIRES",278,8,165,99,1,265,0.0287769784172662
"060562504","BUENOS AIRES",405,4,216,183,0,399,0.00987654320987654
"060562511","BUENOS AIRES",343,341,2,0,0,2,0.994169096209913
"060562615","BUENOS AIRES",257,62,59,116,6,181,0.24124513618677
"060562704","BUENOS AIRES",290,12,158,119,0,277,0.0413793103448276
"060562705","BUENOS AIRES",126,1,94,31,0,125,0.00793650793650794
"060630116","BUENOS AIRES",241,206,17,17,0,34,0.854771784232365
"060563005","BUENOS AIRES",106,0,61,41,2,104,0
"060563205","BUENOS AIRES",342,47,203,91,0,294,0.137426900584795
"060563209","BUENOS AIRES",375,4,257,113,1,371,0.0106666666666667
"060563211","BUENOS AIRES",320,19,213,86,1,300,0.059375
"060630205","BUENOS AIRES",361,348,6,6,0,12,0.96398891966759
"060630401","BUENOS AIRES",7,0,5,2,0,7,0
"060630709","BUENOS AIRES",265,143,64,56,0,120,0.539622641509434
"060631305","BUENOS AIRES",333,331,0,0,1,1,0.993993993993994
"060700105","BUENOS AIRES",217,217,0,0,0,0,1
"060700109","BUENOS AIRES",301,299,2,0,0,2,0.993355481727575
"060700112","BUENOS AIRES",125,123,1,1,0,2,0.984
"060700218","BUENOS AIRES",143,51,54,37,0,91,0.356643356643357
"060770103","BUENOS AIRES",229,226,0,3,0,3,0.986899563318777
"060770105","BUENOS AIRES",304,284,8,12,0,20,0.934210526315789
"060770108","BUENOS AIRES",210,207,2,1,0,3,0.985714285714286
"060770501","BUENOS AIRES",398,305,29,63,0,92,0.766331658291457
"060771404","BUENOS AIRES",358,344,6,8,0,14,0.960893854748603
"060771408","BUENOS AIRES",432,278,60,87,1,148,0.643518518518518
"060771409","BUENOS AIRES",343,212,56,73,2,131,0.618075801749271
"064270607","BUENOS AIRES",241,238,1,1,0,2,0.987551867219917
"060840704","BUENOS AIRES",320,252,24,40,0,64,0.7875
"063573203","BUENOS AIRES",245,245,0,0,0,0,1
"060840705","BUENOS AIRES",170,112,22,32,0,54,0.658823529411765
"060840709","BUENOS AIRES",245,225,14,6,0,20,0.918367346938776
"062741004","BUENOS AIRES",272,3,104,150,1,255,0.0110294117647059
"060840801","BUENOS AIRES",43,0,13,18,0,31,0
"060840902","BUENOS AIRES",238,7,213,18,0,231,0.0294117647058824
"060910302","BUENOS AIRES",414,409,4,1,0,5,0.98792270531401
"060841209","BUENOS AIRES",199,55,37,101,3,141,0.276381909547739
"060841210","BUENOS AIRES",306,216,33,56,0,89,0.705882352941177
"060910102","BUENOS AIRES",433,79,66,265,4,335,0.182448036951501
"060910105","BUENOS AIRES",233,227,5,0,0,5,0.974248927038627
"060910107","BUENOS AIRES",391,355,11,22,2,35,0.907928388746803
"060911503","BUENOS AIRES",299,292,3,3,0,6,0.976588628762542
"020120811","CABA",262,262,0,0,0,0,1
"060910201","BUENOS AIRES",375,310,22,43,0,65,0.826666666666667
"060910405","BUENOS AIRES",465,399,29,31,0,60,0.858064516129032
"060910406","BUENOS AIRES",402,175,54,149,1,204,0.435323383084577
"060910505","BUENOS AIRES",407,309,62,35,0,97,0.759213759213759
"060910508","BUENOS AIRES",223,135,23,60,0,83,0.605381165919282
"065151401","BUENOS AIRES",284,7,120,140,1,261,0.0246478873239437
"060910602","BUENOS AIRES",318,240,41,36,0,77,0.754716981132076
"060910806","BUENOS AIRES",299,275,11,7,0,18,0.919732441471572
"060910903","BUENOS AIRES",418,406,7,3,0,10,0.971291866028708
"060911011","BUENOS AIRES",419,365,18,31,1,50,0.871121718377088
"060911101","BUENOS AIRES",454,437,5,7,0,12,0.962555066079295
"060911204","BUENOS AIRES",381,312,25,36,0,61,0.818897637795276
"060911401","BUENOS AIRES",480,315,37,106,0,143,0.65625
"060911403","BUENOS AIRES",277,252,4,15,0,19,0.909747292418773
"060911413","BUENOS AIRES",290,227,15,24,0,39,0.782758620689655
"062742209","BUENOS AIRES",148,0,44,96,1,141,0
"060911507","BUENOS AIRES",245,236,2,6,0,8,0.963265306122449
"060911509","BUENOS AIRES",238,234,3,0,0,3,0.983193277310924
"020031701","CABA",267,267,0,0,0,0,1
"060911609","BUENOS AIRES",258,174,36,39,1,76,0.674418604651163
"060911702","BUENOS AIRES",434,371,23,28,0,51,0.854838709677419
"065151403","BUENOS AIRES",345,10,130,182,0,312,0.0289855072463768
"060911811","BUENOS AIRES",485,97,158,218,2,378,0.2
"060911902","BUENOS AIRES",440,409,12,16,0,28,0.929545454545455
"060911910","BUENOS AIRES",302,271,12,16,0,28,0.897350993377483
"060912002","BUENOS AIRES",370,268,52,46,1,99,0.724324324324324
"060912007","BUENOS AIRES",356,259,61,36,0,97,0.72752808988764
"060912008","BUENOS AIRES",215,209,6,0,0,6,0.972093023255814
"060912009","BUENOS AIRES",228,75,71,81,1,153,0.328947368421053
"062242206","BUENOS AIRES",354,351,3,0,0,3,0.991525423728814
"060912106","BUENOS AIRES",254,4,30,197,0,227,0.015748031496063
"060912108","BUENOS AIRES",243,14,111,114,0,225,0.0576131687242798
"060912109","BUENOS AIRES",291,289,2,0,0,2,0.993127147766323
"060912216","BUENOS AIRES",415,7,198,201,0,399,0.0168674698795181
"060912217","BUENOS AIRES",211,183,19,0,7,26,0.867298578199052
"060912406","BUENOS AIRES",285,1,118,160,1,279,0.00350877192982456
"060980109","BUENOS AIRES",254,176,57,21,0,78,0.692913385826772
"060912410","BUENOS AIRES",241,232,7,2,0,9,0.962655601659751
"060980102","BUENOS AIRES",293,158,91,44,0,135,0.539249146757679
"062801003","BUENOS AIRES",79,65,14,0,0,14,0.822784810126582
"060980213","BUENOS AIRES",214,138,56,19,0,75,0.644859813084112
"065151408","BUENOS AIRES",488,6,323,146,0,469,0.0122950819672131
"060980302","BUENOS AIRES",128,126,1,1,0,2,0.984375
"060980310","BUENOS AIRES",492,416,22,15,2,39,0.845528455284553
"060980311","BUENOS AIRES",234,7,137,86,0,223,0.0299145299145299
"060980814","BUENOS AIRES",306,146,92,66,0,158,0.477124183006536
"062450210","BUENOS AIRES",186,134,24,27,0,51,0.720430107526882
"060980509","BUENOS AIRES",279,175,51,48,0,99,0.627240143369176
"060980614","BUENOS AIRES",261,11,165,71,4,240,0.0421455938697318
"061050107","BUENOS AIRES",302,294,5,1,0,6,0.973509933774834
"061050202","BUENOS AIRES",340,327,5,8,0,13,0.961764705882353
"061050403","BUENOS AIRES",79,0,20,56,2,78,0
"061050802","BUENOS AIRES",179,73,23,74,4,101,0.407821229050279
"061051106","BUENOS AIRES",100,1,52,42,2,96,0.01
"061051107","BUENOS AIRES",113,0,29,77,3,109,0
"061340104","BUENOS AIRES",94,0,36,57,0,93,0
"061051411","BUENOS AIRES",165,155,1,9,0,10,0.939393939393939
"061120112","BUENOS AIRES",440,241,60,136,1,197,0.547727272727273
"061120205","BUENOS AIRES",342,285,33,24,0,57,0.833333333333333
"061120211","BUENOS AIRES",470,426,36,7,0,43,0.906382978723404
"061120710","BUENOS AIRES",79,1,23,54,0,77,0.0126582278481013
"061121101","BUENOS AIRES",195,68,57,70,0,127,0.348717948717949
"061121102","BUENOS AIRES",74,0,35,39,0,74,0
"061121404","BUENOS AIRES",317,309,4,4,0,8,0.974763406940063
"061121406","BUENOS AIRES",276,273,1,2,0,3,0.989130434782609
"063220603","BUENOS AIRES",191,35,103,53,0,156,0.183246073298429
"061190307","BUENOS AIRES",284,23,169,88,0,257,0.0809859154929577
"061190702","BUENOS AIRES",364,4,200,157,0,357,0.010989010989011
"061340106","BUENOS AIRES",248,2,113,118,2,233,0.00806451612903226
"061191003","BUENOS AIRES",340,19,161,149,3,313,0.0558823529411765
"061191007","BUENOS AIRES",275,243,24,8,0,32,0.883636363636364
"061260103","BUENOS AIRES",299,169,42,88,0,130,0.565217391304348
"061260309","BUENOS AIRES",301,296,3,2,0,5,0.983388704318937
"061260513","BUENOS AIRES",257,4,134,113,0,247,0.0155642023346304
"061260503","BUENOS AIRES",317,191,6,107,3,116,0.602523659305994
"061260507","BUENOS AIRES",263,5,27,227,0,254,0.0190114068441065
"061260509","BUENOS AIRES",502,3,35,435,0,470,0.00597609561752988
"060561309","BUENOS AIRES",172,171,1,0,0,1,0.994186046511628
"061260515","BUENOS AIRES",321,1,70,236,2,308,0.00311526479750779
"061260704","BUENOS AIRES",298,3,47,241,1,289,0.0100671140939597
"063574904","BUENOS AIRES",232,226,0,0,0,0,0.974137931034483
"061260910","BUENOS AIRES",420,36,73,308,0,381,0.0857142857142857
"061400304","BUENOS AIRES",275,249,5,3,0,8,0.905454545454545
"062520807","BUENOS AIRES",313,2,199,111,0,310,0.00638977635782748
"061340204","BUENOS AIRES",438,411,15,10,0,25,0.938356164383562
"061340306","BUENOS AIRES",308,301,4,3,0,7,0.977272727272727
"061340401","BUENOS AIRES",43,0,22,19,0,41,0
"061470701","BUENOS AIRES",228,51,86,90,1,177,0.223684210526316
"061471201","BUENOS AIRES",349,333,6,10,0,16,0.954154727793696
"061471206","BUENOS AIRES",252,251,0,0,0,0,0.996031746031746
"061471207","BUENOS AIRES",285,281,3,0,0,3,0.985964912280702
"061540402","BUENOS AIRES",141,0,81,57,1,139,0
"061610101","BUENOS AIRES",184,55,31,95,0,126,0.298913043478261
"061610106","BUENOS AIRES",266,142,48,75,0,123,0.533834586466165
"063576002","BUENOS AIRES",226,220,3,2,0,5,0.973451327433628
"065151411","BUENOS AIRES",310,2,237,63,0,300,0.00645161290322581
"061680903","BUENOS AIRES",220,206,7,3,0,10,0.936363636363636
"062241201","BUENOS AIRES",47,0,19,28,0,47,0
"020132001","CABA",301,301,0,0,0,0,1
"061680906","BUENOS AIRES",223,176,17,30,0,47,0.789237668161435
"061750101","BUENOS AIRES",79,0,24,53,0,77,0
"061750606","BUENOS AIRES",185,168,5,12,0,17,0.908108108108108
"061820101","BUENOS AIRES",251,235,15,1,0,16,0.936254980079681
"061820110","BUENOS AIRES",313,312,1,0,0,1,0.996805111821086
"061820113","BUENOS AIRES",250,249,1,0,0,1,0.996
"061820203","BUENOS AIRES",278,273,0,5,0,5,0.982014388489209
"063573308","BUENOS AIRES",240,240,0,0,0,0,1
"061820206","BUENOS AIRES",260,251,6,3,0,9,0.965384615384615
"061820211","BUENOS AIRES",218,212,1,5,0,6,0.972477064220184
"061820503","BUENOS AIRES",149,3,98,37,1,136,0.0201342281879195
"061820607","BUENOS AIRES",408,265,92,51,0,143,0.649509803921569
"063577701","BUENOS AIRES",195,2,108,84,1,193,0.0102564102564103
"061820904","BUENOS AIRES",71,2,59,10,0,69,0.028169014084507
"061820905","BUENOS AIRES",39,4,31,4,0,35,0.102564102564103
"061821009","BUENOS AIRES",378,373,3,2,0,5,0.986772486772487
"061821010","BUENOS AIRES",320,295,7,7,0,14,0.921875
"061821106","BUENOS AIRES",253,225,3,25,0,28,0.889328063241107
"061821109","BUENOS AIRES",308,237,36,33,0,69,0.769480519480519
"061890301","BUENOS AIRES",24,1,22,1,0,23,0.0416666666666667
"061891401","BUENOS AIRES",5,0,0,4,1,5,0
"063573310","BUENOS AIRES",137,137,0,0,0,0,1
"061891702","BUENOS AIRES",173,98,49,24,1,74,0.566473988439306
"061891707","BUENOS AIRES",328,297,19,10,1,30,0.905487804878049
"061960107","BUENOS AIRES",117,73,5,39,0,44,0.623931623931624
"061960113","BUENOS AIRES",233,215,7,9,1,17,0.92274678111588
"064273310","BUENOS AIRES",316,309,7,0,0,7,0.977848101265823
"061960201","BUENOS AIRES",77,0,12,62,1,75,0
"061960207","BUENOS AIRES",237,230,5,2,0,7,0.970464135021097
"061961508","BUENOS AIRES",98,0,68,27,1,96,0
"062030102","BUENOS AIRES",256,247,7,2,0,9,0.96484375
"062030105","BUENOS AIRES",269,245,15,9,0,24,0.910780669144981
"062030111","BUENOS AIRES",293,47,126,117,1,244,0.160409556313993
"062030809","BUENOS AIRES",333,311,7,15,0,22,0.933933933933934
"062100118","BUENOS AIRES",274,266,6,1,0,7,0.970802919708029
"062100202","BUENOS AIRES",392,353,20,17,0,37,0.900510204081633
"062100604","BUENOS AIRES",51,0,29,22,0,51,0
"062100607","BUENOS AIRES",126,0,73,51,2,126,0
"062170105","BUENOS AIRES",302,270,20,12,0,32,0.894039735099338
"062170106","BUENOS AIRES",171,168,3,0,0,3,0.982456140350877
"062600315","BUENOS AIRES",286,5,189,92,0,281,0.0174825174825175
"062170110","BUENOS AIRES",237,236,0,1,0,1,0.9957805907173
"063572207","BUENOS AIRES",193,193,0,0,0,0,1
"063712308","BUENOS AIRES",296,287,5,4,0,9,0.969594594594595
"062170413","BUENOS AIRES",418,7,116,291,1,408,0.0167464114832536
"063572209","BUENOS AIRES",247,247,0,0,0,0,1
"062171206","BUENOS AIRES",249,232,7,9,0,16,0.931726907630522
"063990304","BUENOS AIRES",226,5,106,115,0,221,0.0221238938053097
"062240105","BUENOS AIRES",335,222,20,90,1,111,0.662686567164179
"062240107","BUENOS AIRES",320,297,18,4,0,22,0.928125
"062240115","BUENOS AIRES",178,10,24,138,3,165,0.0561797752808989
"020031801","CABA",256,247,5,4,0,9,0.96484375
"062240116","BUENOS AIRES",173,13,90,70,0,160,0.0751445086705202
"062240302","BUENOS AIRES",304,159,38,107,0,145,0.523026315789474
"062310102","BUENOS AIRES",167,2,74,85,2,161,0.0119760479041916
"062242209","BUENOS AIRES",219,84,44,89,0,133,0.383561643835616
"062242210","BUENOS AIRES",227,58,34,127,3,164,0.255506607929515
"062311212","BUENOS AIRES",176,103,15,58,0,73,0.585227272727273
"062380105","BUENOS AIRES",362,250,69,43,0,112,0.69060773480663
"062380212","BUENOS AIRES",336,5,118,207,3,328,0.0148809523809524
"062380301","BUENOS AIRES",100,0,13,87,0,100,0
"062450101","BUENOS AIRES",404,19,320,60,1,381,0.047029702970297
"063573402","BUENOS AIRES",197,197,0,0,0,0,1
"062450311","BUENOS AIRES",317,301,8,3,0,11,0.949526813880126
"062520403","BUENOS AIRES",177,3,99,73,0,172,0.0169491525423729
"062520504","BUENOS AIRES",434,424,4,5,0,9,0.976958525345622
"062520112","BUENOS AIRES",413,84,194,133,1,328,0.203389830508475
"062521312","BUENOS AIRES",332,3,226,99,1,326,0.00903614457831325
"020132202","CABA",221,221,0,0,0,0,1
"062520204","BUENOS AIRES",231,0,189,32,0,221,0
"065151504","BUENOS AIRES",356,1,217,119,2,338,0.00280898876404494
"062520215","BUENOS AIRES",430,71,167,174,8,349,0.165116279069767
"062520307","BUENOS AIRES",83,0,54,28,0,82,0
"062520407","BUENOS AIRES",225,145,58,15,0,73,0.644444444444444
"062520408","BUENOS AIRES",475,309,89,75,0,164,0.650526315789474
"062520610","BUENOS AIRES",36,0,22,12,1,35,0
"064120904","BUENOS AIRES",357,1,181,163,1,345,0.00280112044817927
"063574103","BUENOS AIRES",261,261,0,0,0,0,1
"062520613","BUENOS AIRES",185,7,83,68,2,153,0.0378378378378378
"062600402","BUENOS AIRES",364,0,197,162,1,360,0
"062521403","BUENOS AIRES",501,1,179,288,7,474,0.00199600798403194
"062521501","BUENOS AIRES",4,0,3,1,0,4,0
"062521502","BUENOS AIRES",2,0,1,1,0,2,0
"062521506","BUENOS AIRES",392,1,247,131,2,380,0.00255102040816327
"062521509","BUENOS AIRES",411,201,127,75,1,203,0.489051094890511
"062521511","BUENOS AIRES",380,98,144,132,1,277,0.257894736842105
"062521515","BUENOS AIRES",579,577,2,0,0,2,0.996545768566494
"062600119","BUENOS AIRES",406,11,183,204,3,390,0.0270935960591133
"062600205","BUENOS AIRES",468,13,141,299,2,442,0.0277777777777778
"062600210","BUENOS AIRES",390,12,160,211,1,372,0.0307692307692308
"062600216","BUENOS AIRES",364,2,251,103,0,354,0.00549450549450549
"062600306","BUENOS AIRES",293,2,124,158,0,282,0.0068259385665529
"020140305","CABA",407,382,2,0,0,2,0.938574938574939
"062600507","BUENOS AIRES",321,0,194,120,3,317,0
"062600510","BUENOS AIRES",297,0,174,115,1,290,0
"062600607","BUENOS AIRES",247,0,190,56,0,246,0
"062600609","BUENOS AIRES",247,20,190,36,0,226,0.0809716599190283
"062600610","BUENOS AIRES",193,128,48,15,0,63,0.663212435233161
"062600613","BUENOS AIRES",341,136,176,29,0,205,0.398826979472141
"062600701","BUENOS AIRES",488,105,326,55,0,381,0.215163934426229
"062600703","BUENOS AIRES",417,129,256,32,0,288,0.309352517985612
"062600704","BUENOS AIRES",319,67,230,22,0,252,0.210031347962382
"062600707","BUENOS AIRES",351,6,294,47,0,341,0.0170940170940171
"064201703","BUENOS AIRES",25,25,0,0,0,0,1
"062600804","BUENOS AIRES",433,3,216,191,5,412,0.0069284064665127
"062600808","BUENOS AIRES",369,1,208,154,2,364,0.002710027100271
"064132202","BUENOS AIRES",117,8,19,88,0,107,0.0683760683760684
"062600905","BUENOS AIRES",304,245,34,18,0,52,0.805921052631579
"064271406","BUENOS AIRES",146,113,15,12,0,27,0.773972602739726
"062601010","BUENOS AIRES",260,26,150,75,1,226,0.1
"062601012","BUENOS AIRES",291,92,109,86,0,195,0.316151202749141
"062601103","BUENOS AIRES",366,364,0,2,0,2,0.994535519125683
"062601105","BUENOS AIRES",292,61,197,34,0,231,0.208904109589041
"062601108","BUENOS AIRES",365,2,280,50,0,330,0.00547945205479452
"062601212","BUENOS AIRES",341,2,193,138,1,332,0.00586510263929619
"062601309","BUENOS AIRES",329,33,238,56,0,294,0.100303951367781
"062601313","BUENOS AIRES",228,223,5,0,0,5,0.978070175438597
"062601406","BUENOS AIRES",453,385,53,14,1,68,0.849889624724062
"062601509","BUENOS AIRES",368,4,164,183,2,349,0.0108695652173913
"062601517","BUENOS AIRES",483,29,241,202,2,445,0.0600414078674948
"062601612","BUENOS AIRES",345,0,190,146,2,338,0
"063572906","BUENOS AIRES",280,277,3,0,0,3,0.989285714285714
"062660502","BUENOS AIRES",177,2,95,78,0,173,0.0112994350282486
"064201508","BUENOS AIRES",156,129,12,13,0,25,0.826923076923077
"062660708","BUENOS AIRES",340,193,63,81,0,144,0.567647058823529
"062700215","BUENOS AIRES",277,0,119,144,6,269,0
"062700201","BUENOS AIRES",501,71,215,197,4,416,0.141716566866267
"062700202","BUENOS AIRES",251,6,132,105,2,239,0.0239043824701195
"062700206","BUENOS AIRES",472,275,114,74,0,188,0.582627118644068
"062700309","BUENOS AIRES",412,13,264,132,0,396,0.0315533980582524
"062700314","BUENOS AIRES",305,248,45,10,0,55,0.813114754098361
"062700316","BUENOS AIRES",262,224,17,20,0,37,0.854961832061069
"062700406","BUENOS AIRES",480,170,228,77,0,305,0.354166666666667
"062700412","BUENOS AIRES",370,296,49,21,1,71,0.8
"062700908","BUENOS AIRES",208,3,145,53,1,199,0.0144230769230769
"062700414","BUENOS AIRES",335,1,217,107,0,324,0.00298507462686567
"062700601","BUENOS AIRES",291,0,194,92,2,288,0
"062700604","BUENOS AIRES",145,1,113,31,0,144,0.00689655172413793
"062700605","BUENOS AIRES",361,3,225,123,2,350,0.00831024930747922
"064273306","BUENOS AIRES",182,176,3,3,0,6,0.967032967032967
"062700611","BUENOS AIRES",420,4,134,253,4,391,0.00952380952380952
"062700612","BUENOS AIRES",117,0,91,26,0,117,0
"062700615","BUENOS AIRES",201,16,73,101,1,175,0.0796019900497512
"062700712","BUENOS AIRES",476,1,245,194,0,439,0.00210084033613445
"062700811","BUENOS AIRES",334,9,255,65,0,320,0.0269461077844311
"062700904","BUENOS AIRES",296,2,262,31,0,293,0.00675675675675676
"064201802","BUENOS AIRES",15,15,0,0,0,0,1
"062740213","BUENOS AIRES",323,302,8,10,0,18,0.934984520123839
"062740215","BUENOS AIRES",408,370,21,6,1,28,0.906862745098039
"062740304","BUENOS AIRES",452,15,232,197,0,429,0.0331858407079646
"062741109","BUENOS AIRES",525,4,211,295,0,506,0.00761904761904762
"062740305","BUENOS AIRES",399,8,158,225,1,384,0.0200501253132832
"062740312","BUENOS AIRES",394,34,113,231,0,344,0.0862944162436548
"062740313","BUENOS AIRES",377,57,122,185,2,309,0.151193633952255
"062740405","BUENOS AIRES",329,7,101,198,3,302,0.0212765957446809
"062740407","BUENOS AIRES",266,10,89,157,0,246,0.037593984962406
"062740502","BUENOS AIRES",269,15,126,121,0,247,0.0557620817843866
"064273002","BUENOS AIRES",423,385,18,13,0,31,0.91016548463357
"062740511","BUENOS AIRES",366,8,128,219,0,347,0.0218579234972678
"062740608","BUENOS AIRES",245,4,124,112,0,236,0.0163265306122449
"062740612","BUENOS AIRES",274,14,135,123,0,258,0.0510948905109489
"062740702","BUENOS AIRES",252,0,117,132,0,249,0
"062740711","BUENOS AIRES",239,2,62,169,1,232,0.00836820083682008
"062741113","BUENOS AIRES",274,3,115,150,4,269,0.0109489051094891
"062741206","BUENOS AIRES",222,211,5,4,0,9,0.95045045045045
"062740808","BUENOS AIRES",261,63,99,82,6,187,0.241379310344828
"062740911","BUENOS AIRES",226,5,36,172,3,211,0.0221238938053097
"062740817","BUENOS AIRES",247,0,84,154,0,238,0
"062740907","BUENOS AIRES",231,8,72,135,1,208,0.0346320346320346
"062741001","BUENOS AIRES",336,7,90,230,1,321,0.0208333333333333
"062741006","BUENOS AIRES",229,8,55,150,2,207,0.0349344978165939
"062741008","BUENOS AIRES",349,2,163,171,0,334,0.00573065902578797
"062741101","BUENOS AIRES",293,278,5,2,1,8,0.948805460750853
"062741107","BUENOS AIRES",324,1,121,193,0,314,0.00308641975308642
"064278801","BUENOS AIRES",373,5,279,84,1,364,0.0134048257372654
"065392917","BUENOS AIRES",21,0,10,10,0,20,0
"062741208","BUENOS AIRES",447,405,15,17,0,32,0.906040268456376
"062741311","BUENOS AIRES",273,222,13,36,0,49,0.813186813186813
"062741515","BUENOS AIRES",254,223,18,9,0,27,0.877952755905512
"062741808","BUENOS AIRES",236,222,2,1,0,3,0.940677966101695
"062741811","BUENOS AIRES",411,1,32,339,15,386,0.0024330900243309
"062741813","BUENOS AIRES",303,5,39,242,4,285,0.0165016501650165
"062741816","BUENOS AIRES",405,35,128,220,6,354,0.0864197530864197
"062741901","BUENOS AIRES",317,10,172,116,2,290,0.0315457413249211
"062741902","BUENOS AIRES",414,42,166,180,3,349,0.101449275362319
"062870403","BUENOS AIRES",91,55,7,29,0,36,0.604395604395604
"062741912","BUENOS AIRES",396,10,107,257,8,372,0.0252525252525253
"062742112","BUENOS AIRES",234,28,42,158,1,201,0.11965811965812
"062742205","BUENOS AIRES",259,2,82,164,0,246,0.00772200772200772
"063573101","BUENOS AIRES",272,272,0,0,0,0,1
"062800208","BUENOS AIRES",169,168,1,0,0,1,0.994082840236686
"062800302","BUENOS AIRES",50,50,0,0,0,0,1
"062800615","BUENOS AIRES",44,1,18,25,0,43,0.0227272727272727
"062800801","BUENOS AIRES",97,72,17,8,0,25,0.742268041237113
"062800902","BUENOS AIRES",12,1,8,3,0,11,0.0833333333333333
"062800911","BUENOS AIRES",11,2,7,2,0,9,0.181818181818182
"062940603","BUENOS AIRES",216,3,112,99,0,211,0.0138888888888889
"062940808","BUENOS AIRES",248,154,47,46,1,94,0.620967741935484
"063010509","BUENOS AIRES",259,67,122,69,0,191,0.258687258687259
"063510901","BUENOS AIRES",412,12,290,107,1,398,0.029126213592233
"020131911","CABA",193,193,0,0,0,0,1
"063010803","BUENOS AIRES",57,0,36,20,1,57,0
"063150111","BUENOS AIRES",453,340,57,53,2,112,0.750551876379691
"063150113","BUENOS AIRES",333,160,90,78,1,169,0.48048048048048
"063150116","BUENOS AIRES",199,53,69,68,3,140,0.266331658291457
"063220606","BUENOS AIRES",140,5,75,59,0,134,0.0357142857142857
"063360203","BUENOS AIRES",89,63,11,15,0,26,0.707865168539326
"063360204","BUENOS AIRES",14,0,6,6,0,12,0
"063430602","BUENOS AIRES",97,0,52,45,0,97,0
"063430101","BUENOS AIRES",234,0,123,108,0,231,0
"063570603","BUENOS AIRES",247,241,6,0,0,6,0.975708502024291
"063430710","BUENOS AIRES",340,250,48,36,1,85,0.735294117647059
"063570104","BUENOS AIRES",375,373,2,0,0,2,0.994666666666667
"064343303","BUENOS AIRES",345,22,133,190,0,323,0.063768115942029
"063570105","BUENOS AIRES",344,340,2,2,0,4,0.988372093023256
"063570107","BUENOS AIRES",255,253,0,2,0,2,0.992156862745098
"063570304","BUENOS AIRES",209,168,15,24,0,39,0.803827751196172
"063570308","BUENOS AIRES",343,341,2,0,0,2,0.994169096209913
"063570410","BUENOS AIRES",223,214,5,2,0,7,0.959641255605381
"063570512","BUENOS AIRES",191,191,0,0,0,0,1
"063570514","BUENOS AIRES",116,116,0,0,0,0,1
"063573202","BUENOS AIRES",260,260,0,0,0,0,1
"063570609","BUENOS AIRES",373,370,0,3,0,3,0.991957104557641
"063573508","BUENOS AIRES",273,273,0,0,0,0,1
"063570711","BUENOS AIRES",241,186,22,23,0,45,0.771784232365145
"064273007","BUENOS AIRES",354,295,26,28,0,54,0.833333333333333
"063570811","BUENOS AIRES",371,365,6,0,0,6,0.983827493261456
"063573605","BUENOS AIRES",57,57,0,0,0,0,1
"063571012","BUENOS AIRES",302,149,89,59,0,148,0.493377483443709
"063571015","BUENOS AIRES",235,211,12,11,0,23,0.897872340425532
"063571111","BUENOS AIRES",289,266,9,13,0,22,0.920415224913495
"063571112","BUENOS AIRES",342,297,12,30,1,43,0.868421052631579
"063571212","BUENOS AIRES",305,264,15,19,2,36,0.865573770491803
"063571301","BUENOS AIRES",281,271,7,1,1,9,0.9644128113879
"063571406","BUENOS AIRES",302,300,2,0,0,2,0.993377483443709
"063571909","BUENOS AIRES",123,123,0,0,0,0,1
"063572302","BUENOS AIRES",199,198,1,0,0,1,0.994974874371859
"063572305","BUENOS AIRES",93,93,0,0,0,0,1
"063572401","BUENOS AIRES",68,68,0,0,0,0,1
"063572402","BUENOS AIRES",52,51,0,0,0,0,0.980769230769231
"063572404","BUENOS AIRES",144,144,0,0,0,0,1
"063572601","BUENOS AIRES",243,243,0,0,0,0,1
"063572704","BUENOS AIRES",163,163,0,0,0,0,1
"063574202","BUENOS AIRES",128,128,0,0,0,0,1
"063575503","BUENOS AIRES",365,361,4,0,0,4,0.989041095890411
"063711904","BUENOS AIRES",308,307,1,0,0,1,0.996753246753247
"063574309","BUENOS AIRES",103,102,0,0,0,0,0.990291262135922
"063574503","BUENOS AIRES",222,222,0,0,0,0,1
"063574505","BUENOS AIRES",151,151,0,0,0,0,1
"063574514","BUENOS AIRES",97,97,0,0,0,0,1
"063574605","BUENOS AIRES",282,282,0,0,0,0,1
"063710408","BUENOS AIRES",209,196,8,5,0,13,0.937799043062201
"063574702","BUENOS AIRES",279,276,2,0,0,2,0.989247311827957
"063574707","BUENOS AIRES",173,173,0,0,0,0,1
"063574906","BUENOS AIRES",245,244,1,0,0,1,0.995918367346939
"063575005","BUENOS AIRES",349,343,4,2,0,6,0.982808022922636
"063575006","BUENOS AIRES",348,343,2,3,0,5,0.985632183908046
"064413103","BUENOS AIRES",216,213,1,1,0,2,0.986111111111111
"063575202","BUENOS AIRES",398,226,71,92,3,166,0.5678391959799
"063575210","BUENOS AIRES",478,373,46,50,0,96,0.780334728033473
"063575310","BUENOS AIRES",368,337,10,6,0,16,0.915760869565217
"063575601","BUENOS AIRES",340,340,0,0,0,0,1
"063575801","BUENOS AIRES",272,266,3,2,0,5,0.977941176470588
"063575906","BUENOS AIRES",414,414,0,0,0,0,1
"063576103","BUENOS AIRES",162,160,2,0,0,2,0.987654320987654
"063576108","BUENOS AIRES",11,11,0,0,0,0,1
"063576210","BUENOS AIRES",102,100,1,1,0,2,0.980392156862745
"063576502","BUENOS AIRES",226,193,10,22,1,33,0.853982300884956
"063576512","BUENOS AIRES",202,176,17,8,1,26,0.871287128712871
"063576705","BUENOS AIRES",324,310,7,2,0,9,0.95679012345679
"063576802","BUENOS AIRES",382,348,11,21,0,32,0.910994764397906
"063576906","BUENOS AIRES",284,249,2,0,0,2,0.876760563380282
"063577101","BUENOS AIRES",234,143,8,73,0,81,0.611111111111111
"063577102","BUENOS AIRES",306,291,12,3,0,15,0.950980392156863
"063577205","BUENOS AIRES",369,323,18,21,1,40,0.875338753387534
"063577208","BUENOS AIRES",211,211,0,0,0,0,1
"063577301","BUENOS AIRES",67,2,10,52,0,62,0.0298507462686567
"063576211","BUENOS AIRES",216,216,0,0,0,0,1
"063576308","BUENOS AIRES",83,80,3,0,0,3,0.963855421686747
"063576402","BUENOS AIRES",358,338,9,8,0,17,0.94413407821229
"063577304","BUENOS AIRES",63,1,26,35,1,62,0.0158730158730159
"063577309","BUENOS AIRES",160,1,87,69,1,157,0.00625
"063577402","BUENOS AIRES",318,2,186,126,0,312,0.00628930817610063
"064415203","BUENOS AIRES",204,201,3,0,0,3,0.985294117647059
"063577404","BUENOS AIRES",279,24,77,160,3,240,0.0860215053763441
"063577408","BUENOS AIRES",257,1,122,133,0,255,0.00389105058365759
"063577409","BUENOS AIRES",178,2,121,54,0,175,0.0112359550561798
"063577410","BUENOS AIRES",182,7,128,46,0,174,0.0384615384615385
"063577417","BUENOS AIRES",193,4,137,52,0,189,0.0207253886010363
"063577502","BUENOS AIRES",71,44,13,14,0,27,0.619718309859155
"063577717","BUENOS AIRES",34,0,19,15,0,34,0
"063577811","BUENOS AIRES",355,2,100,247,4,351,0.00563380281690141
"063577504","BUENOS AIRES",115,5,94,16,0,110,0.0434782608695652
"063577605","BUENOS AIRES",93,1,76,15,0,91,0.010752688172043
"063577714","BUENOS AIRES",63,0,49,14,0,63,0
"063577815","BUENOS AIRES",194,4,60,125,1,186,0.0206185567010309
"020140903","CABA",525,523,1,0,0,1,0.996190476190476
"063578001","BUENOS AIRES",353,222,43,81,3,127,0.628895184135977
"064416512","BUENOS AIRES",99,0,23,71,3,97,0
"063578106","BUENOS AIRES",139,2,69,64,0,133,0.0143884892086331
"063578113","BUENOS AIRES",154,0,67,86,0,153,0
"063640116","BUENOS AIRES",207,200,7,0,0,7,0.966183574879227
"063640304","BUENOS AIRES",202,0,119,78,1,198,0
"063640306","BUENOS AIRES",301,214,53,34,0,87,0.710963455149502
"063640308","BUENOS AIRES",305,13,159,122,3,284,0.0426229508196721
"063640309","BUENOS AIRES",156,8,50,88,2,140,0.0512820512820513
"063712204","BUENOS AIRES",328,328,0,0,0,0,1
"063710204","BUENOS AIRES",387,29,152,192,4,348,0.0749354005167959
"063640411","BUENOS AIRES",163,1,94,61,3,158,0.00613496932515337
"063640405","BUENOS AIRES",337,2,158,153,8,319,0.00593471810089021
"063640412","BUENOS AIRES",217,0,70,131,2,203,0
"064620705","BUENOS AIRES",312,302,4,6,0,10,0.967948717948718
"063640706","BUENOS AIRES",309,300,5,4,0,9,0.970873786407767
"063640712","BUENOS AIRES",420,397,14,9,0,23,0.945238095238095
"063640714","BUENOS AIRES",274,230,26,16,0,42,0.839416058394161
"063640802","BUENOS AIRES",148,0,59,78,5,142,0
"063640803","BUENOS AIRES",190,0,94,83,1,178,0
"063640815","BUENOS AIRES",188,0,110,70,4,184,0
"063711010","BUENOS AIRES",357,348,4,5,0,9,0.974789915966387
"063712206","BUENOS AIRES",190,187,0,3,0,3,0.984210526315789
"065151701","BUENOS AIRES",363,6,213,140,0,353,0.0165289256198347
"063710109","BUENOS AIRES",323,36,110,163,6,279,0.111455108359133
"063710302","BUENOS AIRES",265,100,130,35,0,165,0.377358490566038
"063710311","BUENOS AIRES",349,89,198,62,0,260,0.255014326647564
"063710315","BUENOS AIRES",360,313,30,17,0,47,0.869444444444444
"064760501","BUENOS AIRES",21,0,11,10,0,21,0
"063710407","BUENOS AIRES",384,354,19,10,0,29,0.921875
"063710602","BUENOS AIRES",260,254,5,0,0,5,0.976923076923077
"063710709","BUENOS AIRES",402,383,12,3,0,15,0.95273631840796
"063710801","BUENOS AIRES",440,339,26,61,0,87,0.770454545454546
"063710807","BUENOS AIRES",276,268,7,1,0,8,0.971014492753623
"063710902","BUENOS AIRES",398,386,7,5,0,12,0.969849246231156
"063710914","BUENOS AIRES",345,337,5,3,0,8,0.976811594202899
"063710916","BUENOS AIRES",223,205,16,2,0,18,0.919282511210762
"063710917","BUENOS AIRES",332,322,6,4,0,10,0.969879518072289
"063711007","BUENOS AIRES",453,444,6,2,0,8,0.980132450331126
"063711009","BUENOS AIRES",309,299,7,3,0,10,0.967637540453074
"020020609","CABA",276,271,0,0,0,0,0.981884057971015
"063711013","BUENOS AIRES",416,399,10,5,0,15,0.959134615384615
"063711107","BUENOS AIRES",356,356,0,0,0,0,1
"063711305","BUENOS AIRES",321,287,16,18,0,34,0.894080996884735
"063711306","BUENOS AIRES",370,315,37,16,0,53,0.851351351351351
"063711405","BUENOS AIRES",202,5,46,143,1,190,0.0247524752475248
"063711501","BUENOS AIRES",70,4,38,26,0,64,0.0571428571428571
"063711503","BUENOS AIRES",382,28,100,225,6,331,0.0732984293193717
"063711506","BUENOS AIRES",460,1,7,409,4,420,0.00217391304347826
"063711507","BUENOS AIRES",203,3,21,162,1,184,0.0147783251231527
"063711513","BUENOS AIRES",251,0,103,145,0,248,0
"063711514","BUENOS AIRES",289,0,195,91,0,286,0
"063711602","BUENOS AIRES",185,45,44,78,17,139,0.243243243243243
"063711609","BUENOS AIRES",374,21,278,60,10,348,0.0561497326203209
"063711710","BUENOS AIRES",412,178,179,54,0,233,0.432038834951456
"020121405","CABA",421,421,0,0,0,0,1
"063712603","BUENOS AIRES",322,317,2,2,0,4,0.984472049689441
"063712402","BUENOS AIRES",227,216,7,4,0,11,0.951541850220264
"063712503","BUENOS AIRES",200,192,6,1,0,7,0.96
"063712704","BUENOS AIRES",379,357,13,8,1,22,0.941952506596306
"063712707","BUENOS AIRES",197,193,3,1,0,4,0.979695431472081
"063712802","BUENOS AIRES",47,45,1,1,0,2,0.957446808510638
"063712901","BUENOS AIRES",307,303,1,3,0,4,0.986970684039088
"063712907","BUENOS AIRES",501,459,30,8,0,38,0.916167664670659
"063713102","BUENOS AIRES",218,0,162,52,1,215,0
"063713202","BUENOS AIRES",442,8,198,231,1,430,0.0180995475113122
"063713204","BUENOS AIRES",358,3,174,174,0,348,0.00837988826815642
"063713212","BUENOS AIRES",370,9,221,136,0,357,0.0243243243243243
"063713214","BUENOS AIRES",463,6,135,313,0,448,0.0129589632829374
"063713215","BUENOS AIRES",290,19,93,173,1,267,0.0655172413793104
"064900501","BUENOS AIRES",264,25,102,124,6,232,0.0946969696969697
"063713501","BUENOS AIRES",373,7,257,107,2,366,0.0187667560321716
"063713509","BUENOS AIRES",40,20,7,12,0,19,0.5
"064343207","BUENOS AIRES",323,278,27,18,0,45,0.860681114551084
"064276503","BUENOS AIRES",405,20,235,140,0,375,0.0493827160493827
"063713514","BUENOS AIRES",227,8,155,61,0,216,0.0352422907488987
"063713602","BUENOS AIRES",345,9,142,182,0,324,0.0260869565217391
"063713605","BUENOS AIRES",296,22,157,117,0,274,0.0743243243243243
"063713701","BUENOS AIRES",302,6,44,221,5,270,0.0198675496688742
"063713710","BUENOS AIRES",448,15,91,309,21,421,0.0334821428571429
"063713712","BUENOS AIRES",371,4,87,259,1,347,0.0107816711590297
"063850713","BUENOS AIRES",241,2,110,125,1,236,0.00829875518672199
"063920110","BUENOS AIRES",308,132,53,121,0,174,0.428571428571429
"063920706","BUENOS AIRES",120,94,5,19,1,25,0.783333333333333
"063920707","BUENOS AIRES",113,77,27,8,0,35,0.68141592920354
"063990501","BUENOS AIRES",417,2,259,153,0,412,0.00479616306954436
"064060201","BUENOS AIRES",280,216,40,23,0,63,0.771428571428571
"064276601","BUENOS AIRES",341,2,267,60,1,328,0.00586510263929619
"064060205","BUENOS AIRES",349,233,88,27,0,115,0.667621776504298
"064080116","BUENOS AIRES",195,0,174,21,0,195,0
"064080117","BUENOS AIRES",305,100,186,19,0,205,0.327868852459016
"064080209","BUENOS AIRES",510,0,400,100,0,500,0
"064080307","BUENOS AIRES",505,2,388,105,2,495,0.00396039603960396
"064080407","BUENOS AIRES",388,0,243,124,0,367,0
"064080411","BUENOS AIRES",322,0,251,64,0,315,0
"064080502","BUENOS AIRES",312,1,212,93,2,307,0.00320512820512821
"064200707","BUENOS AIRES",68,62,5,1,0,6,0.911764705882353
"064080701","BUENOS AIRES",333,118,173,41,0,214,0.354354354354354
"064080702","BUENOS AIRES",267,66,100,90,5,195,0.247191011235955
"064080706","BUENOS AIRES",323,211,77,35,0,112,0.653250773993808
"064080710","BUENOS AIRES",260,16,163,72,3,238,0.0615384615384615
"064080812","BUENOS AIRES",202,2,174,22,0,196,0.0099009900990099
"064080902","BUENOS AIRES",225,7,177,35,2,214,0.0311111111111111
"064080905","BUENOS AIRES",351,12,292,47,0,339,0.0341880341880342
"064081008","BUENOS AIRES",244,0,194,46,0,240,0
"064081107","BUENOS AIRES",83,0,57,25,0,82,0
"064970201","BUENOS AIRES",167,0,99,66,0,165,0
"064081202","BUENOS AIRES",250,242,6,0,1,7,0.968
"064081206","BUENOS AIRES",623,2,472,130,0,602,0.00321027287319422
"064081503","BUENOS AIRES",51,7,34,9,0,43,0.137254901960784
"064100108","BUENOS AIRES",421,2,364,50,1,415,0.00475059382422803
"064270103","BUENOS AIRES",558,558,0,0,0,0,1
"064970704","BUENOS AIRES",142,141,1,0,0,1,0.992957746478873
"064100301","BUENOS AIRES",385,0,326,57,0,383,0
"064100303","BUENOS AIRES",251,1,229,21,0,250,0.00398406374501992
"064100311","BUENOS AIRES",244,0,188,54,2,244,0
"064100401","BUENOS AIRES",381,2,288,89,1,378,0.005249343832021
"064100404","BUENOS AIRES",254,1,229,23,0,252,0.00393700787401575
"064100602","BUENOS AIRES",331,0,194,134,0,328,0
"064101101","BUENOS AIRES",360,12,305,43,0,348,0.0333333333333333
"064100716","BUENOS AIRES",457,3,359,91,1,451,0.00656455142231947
"064100802","BUENOS AIRES",252,1,233,15,0,248,0.00396825396825397
"065050311","BUENOS AIRES",256,238,14,4,0,18,0.9296875
"064101008","BUENOS AIRES",308,0,246,60,0,306,0
"064101109","BUENOS AIRES",393,99,278,16,0,294,0.251908396946565
"064278013","BUENOS AIRES",209,13,69,112,1,182,0.062200956937799
"064101204","BUENOS AIRES",242,0,189,52,0,241,0
"064101207","BUENOS AIRES",271,0,260,11,0,271,0
"064101308","BUENOS AIRES",273,0,194,79,0,273,0
"064120107","BUENOS AIRES",103,1,77,23,0,100,0.00970873786407767
"064120109","BUENOS AIRES",329,0,222,106,1,329,0
"064120111","BUENOS AIRES",206,0,93,105,1,199,0
"064120115","BUENOS AIRES",313,0,205,92,0,297,0
"064120205","BUENOS AIRES",421,1,336,79,1,416,0.00237529691211401
"064120206","BUENOS AIRES",272,2,199,66,0,265,0.00735294117647059
"064120301","BUENOS AIRES",380,1,227,142,2,371,0.00263157894736842
"065150209","BUENOS AIRES",355,0,272,74,0,346,0
"064120311","BUENOS AIRES",348,7,251,90,0,341,0.0201149425287356
"064121117","BUENOS AIRES",211,2,115,87,1,203,0.00947867298578199
"064120501","BUENOS AIRES",238,0,222,12,1,235,0
"064120509","BUENOS AIRES",401,1,257,129,3,389,0.00249376558603491
"064120604","BUENOS AIRES",265,2,245,16,1,262,0.00754716981132075
"064120612","BUENOS AIRES",382,2,321,56,0,377,0.00523560209424084
"064120711","BUENOS AIRES",396,1,288,101,0,389,0.00252525252525253
"064120807","BUENOS AIRES",275,1,165,100,0,265,0.00363636363636364
"064120809","BUENOS AIRES",347,2,196,140,0,336,0.00576368876080692
"064120813","BUENOS AIRES",372,21,185,151,1,337,0.0564516129032258
"064120905","BUENOS AIRES",349,1,195,136,5,336,0.00286532951289398
"064121010","BUENOS AIRES",302,2,126,172,0,298,0.00662251655629139
"064121011","BUENOS AIRES",331,0,140,154,2,296,0
"064121018","BUENOS AIRES",372,369,3,0,0,3,0.991935483870968
"064121112","BUENOS AIRES",236,7,131,93,1,225,0.0296610169491525
"064121205","BUENOS AIRES",441,2,340,88,0,428,0.00453514739229025
"064121403","BUENOS AIRES",485,3,307,163,4,474,0.00618556701030928
"064130101","BUENOS AIRES",279,17,25,229,1,255,0.0609318996415771
"064130202","BUENOS AIRES",291,262,17,12,0,29,0.900343642611684
"064130306","BUENOS AIRES",274,272,0,2,0,2,0.992700729927007
"064130406","BUENOS AIRES",292,291,1,0,0,1,0.996575342465753
"064130509","BUENOS AIRES",327,327,0,0,0,0,1
"064130602","BUENOS AIRES",277,271,4,1,0,5,0.978339350180505
"064130605","BUENOS AIRES",340,336,3,0,0,3,0.988235294117647
"065180209","BUENOS AIRES",79,21,8,49,0,57,0.265822784810127
"064131308","BUENOS AIRES",140,2,29,105,1,135,0.0142857142857143
"064131403","BUENOS AIRES",85,0,4,80,0,84,0
"064131501","BUENOS AIRES",108,1,42,61,0,103,0.00925925925925926
"064270704","BUENOS AIRES",362,356,5,1,0,6,0.983425414364641
"064132108","BUENOS AIRES",438,420,7,9,1,17,0.958904109589041
"064132206","BUENOS AIRES",108,22,35,49,0,84,0.203703703703704
"064132211","BUENOS AIRES",204,200,0,2,0,2,0.980392156862745
"064200102","BUENOS AIRES",155,59,55,39,1,95,0.380645161290323
"064200201","BUENOS AIRES",29,26,3,0,0,3,0.896551724137931
"064200112","BUENOS AIRES",58,50,8,0,0,8,0.862068965517241
"064270308","BUENOS AIRES",257,253,4,0,0,4,0.98443579766537
"064200204","BUENOS AIRES",47,47,0,0,0,0,1
"064200405","BUENOS AIRES",79,66,4,9,0,13,0.835443037974684
"064200311","BUENOS AIRES",135,4,97,27,2,126,0.0296296296296296
"065250107","BUENOS AIRES",322,268,40,13,0,53,0.832298136645963
"064270706","BUENOS AIRES",283,257,17,3,0,20,0.908127208480565
"064270708","BUENOS AIRES",289,282,6,1,0,7,0.975778546712803
"064200314","BUENOS AIRES",49,1,33,15,0,48,0.0204081632653061
"064200410","BUENOS AIRES",117,8,94,15,0,109,0.0683760683760684
"064200703","BUENOS AIRES",13,13,0,0,0,0,1
"064200801","BUENOS AIRES",267,87,120,56,3,179,0.325842696629214
"064200806","BUENOS AIRES",92,89,0,3,0,3,0.967391304347826
"064200911","BUENOS AIRES",64,28,21,15,0,36,0.4375
"064201101","BUENOS AIRES",67,19,26,22,0,48,0.283582089552239
"064201105","BUENOS AIRES",59,56,1,1,1,3,0.949152542372881
"064201109","BUENOS AIRES",39,36,3,0,0,3,0.923076923076923
"064201202","BUENOS AIRES",14,0,5,7,2,14,0
"064201204","BUENOS AIRES",45,1,38,5,0,43,0.0222222222222222
"064201309","BUENOS AIRES",47,41,3,2,0,5,0.872340425531915
"064201501","BUENOS AIRES",12,12,0,0,0,0,1
"064201506","BUENOS AIRES",56,56,0,0,0,0,1
"064201611","BUENOS AIRES",171,141,23,6,0,29,0.824561403508772
"064201704","BUENOS AIRES",33,30,2,1,0,3,0.909090909090909
"064271708","BUENOS AIRES",516,377,86,45,1,132,0.73062015503876
"064201710","BUENOS AIRES",117,27,44,45,0,89,0.230769230769231
"064201805","BUENOS AIRES",23,23,0,0,0,0,1
"064201808","BUENOS AIRES",114,102,7,5,0,12,0.894736842105263
"064201811","BUENOS AIRES",10,9,1,0,0,1,0.9
"064201901","BUENOS AIRES",10,10,0,0,0,0,1
"064271007","BUENOS AIRES",414,395,8,10,0,18,0.954106280193237
"064202001","BUENOS AIRES",207,202,4,0,0,4,0.975845410628019
"064202007","BUENOS AIRES",32,32,0,0,0,0,1
"064202104","BUENOS AIRES",145,115,14,15,0,29,0.793103448275862
"064202210","BUENOS AIRES",63,1,28,34,0,62,0.0158730158730159
"064270201","BUENOS AIRES",222,220,1,1,0,2,0.990990990990991
"064270502","BUENOS AIRES",276,271,3,2,0,5,0.981884057971015
"064270504","BUENOS AIRES",417,409,3,2,0,5,0.980815347721823
"064270611","BUENOS AIRES",230,228,0,0,0,0,0.991304347826087
"064270613","BUENOS AIRES",302,295,5,2,0,7,0.97682119205298
"064270702","BUENOS AIRES",413,388,13,11,0,24,0.939467312348668
"064270711","BUENOS AIRES",340,335,1,3,0,4,0.985294117647059
"064270809","BUENOS AIRES",218,215,2,0,0,2,0.986238532110092
"064270904","BUENOS AIRES",585,479,13,90,1,104,0.818803418803419
"065390902","BUENOS AIRES",154,0,74,74,1,149,0
"064270906","BUENOS AIRES",525,393,9,115,0,124,0.748571428571429
"064270910","BUENOS AIRES",302,64,5,221,1,227,0.211920529801325
"064271010","BUENOS AIRES",230,223,0,6,0,6,0.969565217391304
"064271207","BUENOS AIRES",246,241,3,2,0,5,0.979674796747967
"064271301","BUENOS AIRES",429,422,5,2,0,7,0.983682983682984
"064271303","BUENOS AIRES",332,330,0,2,0,2,0.993975903614458
"064271401","BUENOS AIRES",355,317,20,14,1,35,0.892957746478873
"064271404","BUENOS AIRES",312,242,27,31,2,60,0.775641025641026
"064271414","BUENOS AIRES",179,175,3,1,0,4,0.977653631284916
"064271415","BUENOS AIRES",301,290,4,6,0,10,0.963455149501661
"064271418","BUENOS AIRES",257,236,8,11,0,19,0.918287937743191
"064271505","BUENOS AIRES",254,249,4,1,0,5,0.980314960629921
"064271610","BUENOS AIRES",236,233,1,2,0,3,0.98728813559322
"064271611","BUENOS AIRES",411,400,9,2,0,11,0.97323600973236
"064273012","BUENOS AIRES",241,220,15,5,0,20,0.912863070539419
"064271813","BUENOS AIRES",1166,586,190,358,13,561,0.502572898799314
"064271908","BUENOS AIRES",422,417,1,4,0,5,0.988151658767773
"064272005","BUENOS AIRES",184,179,5,0,0,5,0.972826086956522
"064275310","BUENOS AIRES",468,450,6,8,0,14,0.961538461538462
"064272009","BUENOS AIRES",350,339,7,4,0,11,0.968571428571429
"064272013","BUENOS AIRES",200,193,2,5,0,7,0.965
"064272104","BUENOS AIRES",483,462,8,7,0,15,0.956521739130435
"064272309","BUENOS AIRES",602,577,17,8,0,25,0.958471760797342
"065321510","BUENOS AIRES",244,205,22,17,0,39,0.840163934426229
"064272604","BUENOS AIRES",419,412,7,0,0,7,0.983293556085919
"064272703","BUENOS AIRES",264,262,1,1,0,2,0.992424242424242
"064272704","BUENOS AIRES",267,258,6,3,0,9,0.966292134831461
"064272708","BUENOS AIRES",393,352,7,3,0,10,0.895674300254453
"064272802","BUENOS AIRES",259,259,0,0,0,0,1
"064272803","BUENOS AIRES",274,246,18,1,2,21,0.897810218978102
"064273001","BUENOS AIRES",322,313,5,3,0,8,0.972049689440994
"064273005","BUENOS AIRES",181,161,8,8,0,16,0.889502762430939
"064273314","BUENOS AIRES",391,385,5,1,0,6,0.9846547314578
"064273406","BUENOS AIRES",569,563,5,1,0,6,0.989455184534271
"064275408","BUENOS AIRES",401,378,8,7,0,15,0.942643391521197
"064273415","BUENOS AIRES",433,428,3,1,0,4,0.988452655889146
"064273601","BUENOS AIRES",237,232,3,1,1,5,0.978902953586498
"064273603","BUENOS AIRES",283,279,2,2,0,4,0.985865724381625
"064273605","BUENOS AIRES",247,174,32,40,0,72,0.704453441295547
"064273608","BUENOS AIRES",92,44,21,19,3,43,0.478260869565217
"064273612","BUENOS AIRES",179,178,1,0,0,1,0.994413407821229
"064273707","BUENOS AIRES",414,363,15,33,0,48,0.876811594202899
"064273806","BUENOS AIRES",304,288,9,3,1,13,0.947368421052632
"064273810","BUENOS AIRES",410,387,15,4,0,19,0.94390243902439
"064274007","BUENOS AIRES",741,735,5,1,0,6,0.991902834008097
"064274301","BUENOS AIRES",430,426,4,0,0,4,0.990697674418605
"064274305","BUENOS AIRES",460,448,6,4,0,10,0.973913043478261
"064274306","BUENOS AIRES",500,490,6,2,0,8,0.98
"064274409","BUENOS AIRES",237,224,1,11,0,12,0.945147679324895
"064275607","BUENOS AIRES",221,211,6,2,0,8,0.95475113122172
"064274506","BUENOS AIRES",268,260,4,2,0,6,0.970149253731343
"064274603","BUENOS AIRES",579,422,95,61,0,156,0.728842832469775
"064274607","BUENOS AIRES",378,6,170,191,0,361,0.0158730158730159
"064274702","BUENOS AIRES",242,110,61,63,1,125,0.454545454545455
"064274802","BUENOS AIRES",578,364,69,136,0,205,0.629757785467128
"064275009","BUENOS AIRES",302,278,7,4,0,11,0.920529801324503
"064275101","BUENOS AIRES",313,285,19,9,0,28,0.910543130990415
"064275113","BUENOS AIRES",392,352,19,14,0,33,0.897959183673469
"064275114","BUENOS AIRES",500,478,11,4,3,18,0.956
"020021001","CABA",519,516,1,1,0,2,0.994219653179191
"064275209","BUENOS AIRES",450,9,123,290,9,422,0.02
"064275211","BUENOS AIRES",294,22,98,161,4,263,0.0748299319727891
"064275302","BUENOS AIRES",256,36,30,181,1,212,0.140625
"065951610","BUENOS AIRES",194,194,0,0,0,0,1
"064275902","BUENOS AIRES",182,4,125,51,0,176,0.021978021978022
"064275904","BUENOS AIRES",257,3,165,77,1,243,0.0116731517509728
"064275911","BUENOS AIRES",355,18,204,122,0,326,0.0507042253521127
"064276015","BUENOS AIRES",272,1,144,120,0,264,0.00367647058823529
"064276016","BUENOS AIRES",460,12,287,152,2,441,0.0260869565217391
"064276102","BUENOS AIRES",555,395,102,36,0,138,0.711711711711712
"064276109","BUENOS AIRES",507,172,174,150,1,325,0.339250493096647
"064276303","BUENOS AIRES",325,13,201,104,0,305,0.04
"064276312","BUENOS AIRES",375,38,191,136,1,328,0.101333333333333
"065600714","BUENOS AIRES",445,0,223,213,3,439,0
"064276406","BUENOS AIRES",319,10,211,83,1,295,0.0313479623824451
"064276411","BUENOS AIRES",261,5,194,61,0,255,0.0191570881226054
"064276417","BUENOS AIRES",290,134,136,2,0,138,0.462068965517241
"020152107","CABA",175,175,0,0,0,0,1
"064276701","BUENOS AIRES",358,5,158,174,6,338,0.0139664804469274
"064276707","BUENOS AIRES",355,14,209,119,2,330,0.0394366197183099
"064276712","BUENOS AIRES",428,8,301,110,1,412,0.0186915887850467
"020120508","CABA",421,421,0,0,0,0,1
"064276717","BUENOS AIRES",353,8,146,162,9,317,0.0226628895184136
"064276903","BUENOS AIRES",354,3,286,64,0,350,0.00847457627118644
"064276908","BUENOS AIRES",325,4,232,82,0,314,0.0123076923076923
"064277001","BUENOS AIRES",362,36,225,83,0,308,0.0994475138121547
"064277012","BUENOS AIRES",390,1,254,123,2,379,0.00256410256410256
"064277016","BUENOS AIRES",269,8,194,63,0,257,0.0297397769516729
"064277103","BUENOS AIRES",277,15,160,101,0,261,0.0541516245487365
"064277108","BUENOS AIRES",237,3,106,125,0,231,0.0126582278481013
"064277111","BUENOS AIRES",291,10,201,66,0,267,0.0343642611683849
"064277301","BUENOS AIRES",441,42,220,152,0,372,0.0952380952380952
"064277312","BUENOS AIRES",325,11,128,166,0,294,0.0338461538461538
"064340305","BUENOS AIRES",324,259,28,37,0,65,0.799382716049383
"064277313","BUENOS AIRES",410,14,176,196,2,374,0.0341463414634146
"064277401","BUENOS AIRES",421,13,262,131,2,395,0.0308788598574822
"064277415","BUENOS AIRES",342,20,167,138,1,306,0.0584795321637427
"064277603","BUENOS AIRES",637,59,213,312,3,528,0.0926216640502355
"064343304","BUENOS AIRES",237,110,70,56,0,126,0.464135021097046
"064277605","BUENOS AIRES",512,7,297,191,0,488,0.013671875
"064277609","BUENOS AIRES",452,11,304,118,1,423,0.0243362831858407
"064277618","BUENOS AIRES",298,10,176,107,0,283,0.0335570469798658
"064277701","BUENOS AIRES",388,0,288,85,0,373,0
"065601717","BUENOS AIRES",237,1,176,55,1,232,0.00421940928270042
"064277709","BUENOS AIRES",268,8,170,83,0,253,0.0298507462686567
"064277710","BUENOS AIRES",448,3,293,144,2,439,0.00669642857142857
"064277712","BUENOS AIRES",506,5,355,128,1,484,0.00988142292490119
"064277904","BUENOS AIRES",343,1,219,116,0,335,0.00291545189504373
"064277907","BUENOS AIRES",246,1,165,57,1,223,0.0040650406504065
"064411509","BUENOS AIRES",329,327,2,0,0,2,0.993920972644377
"064278110","BUENOS AIRES",117,1,28,69,10,107,0.00854700854700855
"064278111","BUENOS AIRES",280,1,111,144,6,261,0.00357142857142857
"064278210","BUENOS AIRES",360,13,229,101,3,333,0.0361111111111111
"064278302","BUENOS AIRES",367,5,226,133,1,360,0.0136239782016349
"064278307","BUENOS AIRES",302,2,87,196,8,291,0.00662251655629139
"064278312","BUENOS AIRES",367,6,203,134,2,339,0.0163487738419619
"064278407","BUENOS AIRES",385,5,148,212,2,362,0.012987012987013
"064278409","BUENOS AIRES",550,25,215,288,1,504,0.0454545454545455
"064278503","BUENOS AIRES",403,10,214,167,2,383,0.0248138957816377
"064278510","BUENOS AIRES",282,1,197,81,0,278,0.00354609929078014
"064278604","BUENOS AIRES",373,3,282,77,2,361,0.00804289544235925
"064278607","BUENOS AIRES",436,17,309,99,1,409,0.0389908256880734
"064278813","BUENOS AIRES",399,5,322,68,0,390,0.012531328320802
"064278804","BUENOS AIRES",561,36,312,178,2,492,0.0641711229946524
"064278806","BUENOS AIRES",292,1,221,57,1,279,0.00342465753424658
"064411510","BUENOS AIRES",270,270,0,0,0,0,1
"064278903","BUENOS AIRES",549,5,289,237,0,526,0.00910746812386157
"064279007","BUENOS AIRES",300,10,221,66,2,289,0.0333333333333333
"064278909","BUENOS AIRES",262,1,127,124,2,253,0.00381679389312977
"064278911","BUENOS AIRES",545,4,356,176,0,532,0.0073394495412844
"064279001","BUENOS AIRES",492,11,344,125,1,470,0.0223577235772358
"064279005","BUENOS AIRES",276,10,115,145,2,262,0.036231884057971
"064279101","BUENOS AIRES",531,18,253,222,10,485,0.0338983050847458
"064340211","BUENOS AIRES",359,329,20,10,0,30,0.916434540389972
"064279215","BUENOS AIRES",249,7,147,83,2,232,0.0281124497991968
"064279202","BUENOS AIRES",416,1,206,190,6,402,0.00240384615384615
"064279211","BUENOS AIRES",397,271,98,27,1,126,0.682619647355164
"064279302","BUENOS AIRES",406,4,168,197,5,370,0.00985221674876847
"064279603","BUENOS AIRES",409,3,160,230,3,393,0.00733496332518337
"020140803","CABA",169,169,0,0,0,0,1
"064279611","BUENOS AIRES",312,2,141,145,1,287,0.00641025641025641
"064279704","BUENOS AIRES",447,37,239,154,1,394,0.0827740492170022
"064279706","BUENOS AIRES",492,124,236,120,2,358,0.252032520325203
"064340809","BUENOS AIRES",259,13,31,204,0,235,0.0501930501930502
"064279708","BUENOS AIRES",387,24,203,137,5,345,0.062015503875969
"064279709","BUENOS AIRES",278,73,85,108,7,200,0.262589928057554
"064340210","BUENOS AIRES",211,190,10,11,0,21,0.900473933649289
"064340101","BUENOS AIRES",531,335,102,62,21,185,0.630885122410546
"064340107","BUENOS AIRES",263,246,9,4,1,14,0.935361216730038
"064340201","BUENOS AIRES",260,191,30,39,0,69,0.734615384615385
"064340203","BUENOS AIRES",291,258,9,24,0,33,0.88659793814433
"020141704","CABA",208,208,0,0,0,0,1
"064279305","BUENOS AIRES",391,1,119,227,18,364,0.00255754475703325
"064279307","BUENOS AIRES",448,1,197,229,2,428,0.00223214285714286
"064340212","BUENOS AIRES",299,273,14,11,0,25,0.91304347826087
"064279311","BUENOS AIRES",486,1,228,226,3,457,0.00205761316872428
"064279413","BUENOS AIRES",399,1,191,198,2,391,0.0025062656641604
"064279601","BUENOS AIRES",452,5,200,222,0,422,0.0110619469026549
"064340308","BUENOS AIRES",454,355,59,38,1,98,0.781938325991189
"064340501","BUENOS AIRES",427,314,75,38,0,113,0.73536299765808
"064340702","BUENOS AIRES",270,164,81,18,0,99,0.607407407407407
"064340801","BUENOS AIRES",209,54,83,71,0,154,0.258373205741627
"064340802","BUENOS AIRES",443,161,108,170,1,279,0.363431151241535
"064340804","BUENOS AIRES",341,17,135,180,1,316,0.0498533724340176
"064340810","BUENOS AIRES",352,6,30,290,6,326,0.0170454545454545
"064340812","BUENOS AIRES",463,96,77,266,4,347,0.207343412526998
"064340814","BUENOS AIRES",223,5,104,110,1,215,0.0224215246636771
"064340903","BUENOS AIRES",353,28,108,204,0,312,0.0793201133144476
"064340904","BUENOS AIRES",228,24,60,134,0,194,0.105263157894737
"064340907","BUENOS AIRES",270,13,53,194,2,249,0.0481481481481481
"064341003","BUENOS AIRES",196,14,41,140,0,181,0.0714285714285714
"064341104","BUENOS AIRES",269,155,48,65,0,113,0.576208178438662
"064341106","BUENOS AIRES",239,96,34,104,2,140,0.401673640167364
"064341301","BUENOS AIRES",342,289,31,22,0,53,0.845029239766082
"064341303","BUENOS AIRES",285,110,87,87,0,174,0.385964912280702
"064341304","BUENOS AIRES",190,162,18,10,0,28,0.852631578947368
"067910305","BUENOS AIRES",161,157,1,3,0,4,0.975155279503106
"064341307","BUENOS AIRES",298,104,91,103,0,194,0.348993288590604
"064341403","BUENOS AIRES",237,22,119,96,0,215,0.0928270042194093
"064341407","BUENOS AIRES",337,13,117,206,0,323,0.0385756676557863
"064341507","BUENOS AIRES",246,241,3,2,0,5,0.979674796747967
"064341515","BUENOS AIRES",297,188,68,41,0,109,0.632996632996633
"064341604","BUENOS AIRES",224,220,3,1,0,4,0.982142857142857
"064341705","BUENOS AIRES",298,268,21,9,0,30,0.899328859060403
"064341801","BUENOS AIRES",357,270,48,38,0,86,0.756302521008403
"065810202","BUENOS AIRES",239,235,1,2,0,3,0.98326359832636
"064341805","BUENOS AIRES",317,308,7,2,0,9,0.971608832807571
"020142501","CABA",383,382,1,0,0,1,0.997389033942559
"064341903","BUENOS AIRES",357,14,174,168,0,342,0.0392156862745098
"064342111","BUENOS AIRES",210,18,152,40,0,192,0.0857142857142857
"064342202","BUENOS AIRES",303,52,43,193,0,236,0.171617161716172
"064342203","BUENOS AIRES",190,9,128,49,0,177,0.0473684210526316
"064342208","BUENOS AIRES",313,140,121,49,0,170,0.447284345047923
"064342209","BUENOS AIRES",340,83,99,141,2,242,0.244117647058824
"064342314","BUENOS AIRES",235,16,81,121,3,205,0.0680851063829787
"064342517","BUENOS AIRES",253,17,145,88,1,234,0.0671936758893281
"064342602","BUENOS AIRES",193,2,29,129,9,167,0.0103626943005181
"064902107","BUENOS AIRES",313,313,0,0,0,0,1
"064342610","BUENOS AIRES",343,51,82,199,1,282,0.14868804664723
"064342709","BUENOS AIRES",372,19,150,196,0,346,0.0510752688172043
"064342802","BUENOS AIRES",392,11,176,195,1,372,0.0280612244897959
"064342903","BUENOS AIRES",315,10,163,142,0,305,0.0317460317460317
"064342904","BUENOS AIRES",305,4,176,122,0,298,0.0131147540983607
"064343001","BUENOS AIRES",252,6,88,157,1,246,0.0238095238095238
"064343004","BUENOS AIRES",326,41,201,83,1,285,0.125766871165644
"064343007","BUENOS AIRES",347,200,57,90,0,147,0.576368876080692
"064343105","BUENOS AIRES",378,332,26,20,0,46,0.878306878306878
"064343109","BUENOS AIRES",237,235,1,1,0,2,0.991561181434599
"064343111","BUENOS AIRES",191,190,1,0,0,1,0.994764397905759
"064343406","BUENOS AIRES",260,10,163,86,0,249,0.0384615384615385
"064343511","BUENOS AIRES",334,46,101,185,0,286,0.137724550898204
"064343909","BUENOS AIRES",240,78,53,99,1,153,0.325
"064344203","BUENOS AIRES",206,6,101,97,1,199,0.029126213592233
"064344304","BUENOS AIRES",306,70,117,119,0,236,0.228758169934641
"064344306","BUENOS AIRES",290,20,77,189,3,269,0.0689655172413793
"064344401","BUENOS AIRES",156,3,43,107,0,150,0.0192307692307692
"064344506","BUENOS AIRES",226,13,72,133,1,206,0.0575221238938053
"064344509","BUENOS AIRES",246,8,104,132,2,238,0.032520325203252
"064344510","BUENOS AIRES",249,22,98,124,0,222,0.0883534136546185
"064410113","BUENOS AIRES",181,180,0,0,0,0,0.994475138121547
"064410201","BUENOS AIRES",212,211,0,1,0,1,0.995283018867924
"064410203","BUENOS AIRES",281,280,1,0,0,1,0.99644128113879
"064410205","BUENOS AIRES",242,242,0,0,0,0,1
"064410208","BUENOS AIRES",45,44,0,0,0,0,0.977777777777778
"064410304","BUENOS AIRES",247,247,0,0,0,0,1
"064410405","BUENOS AIRES",199,199,0,0,0,0,1
"064412912","BUENOS AIRES",180,180,0,0,0,0,1
"064410406","BUENOS AIRES",252,235,0,0,0,0,0.932539682539683
"064410501","BUENOS AIRES",303,303,0,0,0,0,1
"064410913","BUENOS AIRES",234,234,0,0,0,0,1
"064411010","BUENOS AIRES",195,195,0,0,0,0,1
"064411014","BUENOS AIRES",191,191,0,0,0,0,1
"064411110","BUENOS AIRES",183,182,1,0,0,1,0.994535519125683
"064411208","BUENOS AIRES",131,130,1,0,0,1,0.99236641221374
"064411403","BUENOS AIRES",190,189,1,0,0,1,0.994736842105263
"064411408","BUENOS AIRES",231,231,0,0,0,0,1
"064411506","BUENOS AIRES",212,212,0,0,0,0,1
"020050108","CABA",323,322,1,0,0,1,0.996904024767802
"064411605","BUENOS AIRES",181,181,0,0,0,0,1
"064411611","BUENOS AIRES",356,352,2,1,0,3,0.98876404494382
"064411612","BUENOS AIRES",268,267,1,0,0,1,0.996268656716418
"064411709","BUENOS AIRES",196,195,0,1,0,1,0.994897959183674
"064411713","BUENOS AIRES",211,200,2,8,0,10,0.947867298578199
"064411803","BUENOS AIRES",172,172,0,0,0,0,1
"064411901","BUENOS AIRES",275,273,2,0,0,2,0.992727272727273
"064411902","BUENOS AIRES",317,314,2,0,0,2,0.990536277602524
"064411904","BUENOS AIRES",226,225,1,0,0,1,0.995575221238938
"064412005","BUENOS AIRES",214,214,0,0,0,0,1
"065951602","BUENOS AIRES",357,6,177,172,0,349,0.0168067226890756
"064412104","BUENOS AIRES",371,366,5,0,0,5,0.986522911051213
"064412110","BUENOS AIRES",225,223,2,0,0,2,0.991111111111111
"064412114","BUENOS AIRES",203,200,2,0,1,3,0.985221674876847
"064412204","BUENOS AIRES",378,371,7,0,0,7,0.981481481481482
"064412301","BUENOS AIRES",256,254,2,0,0,2,0.9921875
"064412309","BUENOS AIRES",165,165,0,0,0,0,1
"064412404","BUENOS AIRES",212,211,1,0,0,1,0.995283018867924
"064412408","BUENOS AIRES",193,193,0,0,0,0,1
"064903409","BUENOS AIRES",267,6,91,148,7,246,0.0224719101123595
"064412507","BUENOS AIRES",215,214,1,0,0,1,0.995348837209302
"064412608","BUENOS AIRES",170,169,0,1,0,1,0.994117647058824
"064412611","BUENOS AIRES",219,219,0,0,0,0,1
"064412612","BUENOS AIRES",249,247,1,1,0,2,0.991967871485944
"064412701","BUENOS AIRES",331,330,0,1,0,1,0.996978851963746
"064412804","BUENOS AIRES",171,170,1,0,0,1,0.994152046783626
"064412807","BUENOS AIRES",171,168,2,1,0,3,0.982456140350877
"064412808","BUENOS AIRES",217,216,1,0,0,1,0.995391705069124
"064412810","BUENOS AIRES",274,271,2,0,1,3,0.989051094890511
"064412812","BUENOS AIRES",371,369,2,0,0,2,0.994609164420485
"064412904","BUENOS AIRES",189,186,1,2,0,3,0.984126984126984
"064413206","BUENOS AIRES",309,299,7,0,1,8,0.967637540453074
"064413305","BUENOS AIRES",268,253,10,3,0,13,0.944029850746269
"064413406","BUENOS AIRES",247,244,3,0,0,3,0.987854251012146
"064413407","BUENOS AIRES",248,241,6,0,0,6,0.971774193548387
"064413410","BUENOS AIRES",239,201,24,11,0,35,0.841004184100418
"062601203","BUENOS AIRES",170,169,1,0,0,1,0.994117647058824
"064413502","BUENOS AIRES",388,379,9,0,0,9,0.97680412371134
"064413602","BUENOS AIRES",271,264,4,0,0,4,0.974169741697417
"064413706","BUENOS AIRES",358,297,16,29,2,47,0.829608938547486
"064413711","BUENOS AIRES",388,208,93,73,4,170,0.536082474226804
"064413714","BUENOS AIRES",353,4,145,140,1,286,0.0113314447592068
"064413802","BUENOS AIRES",250,15,28,197,2,227,0.06
"064413804","BUENOS AIRES",224,14,65,139,1,205,0.0625
"064413903","BUENOS AIRES",232,230,1,1,0,2,0.991379310344828
"064413905","BUENOS AIRES",280,274,3,0,0,3,0.978571428571429
"064414112","BUENOS AIRES",184,21,95,62,1,158,0.114130434782609
"064414202","BUENOS AIRES",206,19,82,87,5,174,0.0922330097087379
"064414203","BUENOS AIRES",357,39,179,127,0,306,0.109243697478992
"064414205","BUENOS AIRES",360,0,215,130,0,345,0
"064416002","BUENOS AIRES",225,199,20,5,0,25,0.884444444444444
"064414215","BUENOS AIRES",447,1,88,336,6,430,0.00223713646532438
"064414303","BUENOS AIRES",241,238,2,1,0,3,0.987551867219917
"064414310","BUENOS AIRES",423,281,37,87,1,125,0.664302600472813
"064414312","BUENOS AIRES",216,179,23,12,1,36,0.828703703703704
"064414403","BUENOS AIRES",368,8,151,204,0,355,0.0217391304347826
"064414405","BUENOS AIRES",300,156,100,40,0,140,0.52
"064414407","BUENOS AIRES",387,11,209,99,1,309,0.0284237726098191
"064414511","BUENOS AIRES",382,7,144,205,3,352,0.0183246073298429
"064414605","BUENOS AIRES",253,131,72,42,0,114,0.517786561264822
"064414609","BUENOS AIRES",322,105,102,111,0,213,0.326086956521739
"064415710","BUENOS AIRES",240,41,126,60,4,190,0.170833333333333
"067910302","BUENOS AIRES",206,202,3,1,0,4,0.980582524271845
"064416004","BUENOS AIRES",382,240,81,50,4,135,0.628272251308901
"064416005","BUENOS AIRES",401,100,153,134,0,287,0.249376558603491
"067911904","BUENOS AIRES",303,303,0,0,0,0,1
"064414709","BUENOS AIRES",590,24,244,303,4,551,0.0406779661016949
"064414907","BUENOS AIRES",282,279,3,0,0,3,0.98936170212766
"064415002","BUENOS AIRES",204,189,14,1,0,15,0.926470588235294
"064415101","BUENOS AIRES",596,400,63,107,10,180,0.671140939597315
"064415111","BUENOS AIRES",247,245,2,0,0,2,0.991902834008097
"064415113","BUENOS AIRES",213,211,1,1,0,2,0.990610328638498
"064415208","BUENOS AIRES",283,245,17,7,12,36,0.865724381625442
"064415301","BUENOS AIRES",214,205,5,2,0,7,0.957943925233645
"064415403","BUENOS AIRES",288,256,17,14,0,31,0.888888888888889
"064415416","BUENOS AIRES",240,1,167,66,0,233,0.00416666666666667
"064415505","BUENOS AIRES",321,142,134,42,0,176,0.442367601246106
"064415507","BUENOS AIRES",243,233,8,2,0,10,0.958847736625514
"064415511","BUENOS AIRES",205,3,128,62,2,192,0.0146341463414634
"064416010","BUENOS AIRES",291,94,160,37,0,197,0.323024054982818
"064416309","BUENOS AIRES",140,0,83,56,1,140,0
"064416411","BUENOS AIRES",185,0,142,35,2,179,0
"066232906","BUENOS AIRES",337,203,60,67,2,129,0.602373887240356
"064416507","BUENOS AIRES",64,1,28,35,0,63,0.015625
"064416611","BUENOS AIRES",372,349,15,7,0,22,0.938172043010753
"064416615","BUENOS AIRES",399,31,103,225,2,330,0.0776942355889724
"064416616","BUENOS AIRES",266,4,159,96,0,255,0.0150375939849624
"064690208","BUENOS AIRES",394,272,51,68,1,120,0.690355329949239
"064416617","BUENOS AIRES",353,7,144,169,8,321,0.0198300283286119
"064275604","BUENOS AIRES",260,236,9,7,0,16,0.907692307692308
"064416805","BUENOS AIRES",356,227,90,34,3,127,0.637640449438202
"064416806","BUENOS AIRES",162,0,93,62,3,158,0
"064416808","BUENOS AIRES",146,0,126,19,1,146,0
"064416810","BUENOS AIRES",72,2,52,18,0,70,0.0277777777777778
"064416904","BUENOS AIRES",402,13,206,155,1,362,0.0323383084577114
"064550101","BUENOS AIRES",314,219,20,69,6,95,0.697452229299363
"066381109","BUENOS AIRES",342,0,149,188,0,337,0
"064551409","BUENOS AIRES",77,26,15,25,0,40,0.337662337662338
"064551411","BUENOS AIRES",216,78,55,77,0,132,0.361111111111111
"064690112","BUENOS AIRES",218,213,3,2,0,5,0.977064220183486
"064900602","BUENOS AIRES",368,308,29,30,0,59,0.83695652173913
"064760106","BUENOS AIRES",260,245,2,8,1,11,0.942307692307692
"064830104","BUENOS AIRES",253,242,4,6,0,10,0.956521739130435
"064830101","BUENOS AIRES",456,227,123,95,3,221,0.49780701754386
"064830114","BUENOS AIRES",300,10,170,119,0,289,0.0333333333333333
"064830118","BUENOS AIRES",239,7,144,85,1,230,0.0292887029288703
"066480211","BUENOS AIRES",234,4,138,87,0,225,0.0170940170940171
"064830405","BUENOS AIRES",274,4,186,83,1,270,0.0145985401459854
"064830417","BUENOS AIRES",118,0,79,36,3,118,0
"064830501","BUENOS AIRES",341,2,237,88,1,326,0.00586510263929619
"064900109","BUENOS AIRES",243,16,109,107,0,216,0.065843621399177
"064900114","BUENOS AIRES",214,18,86,104,0,190,0.0841121495327103
"064900201","BUENOS AIRES",458,48,128,265,1,394,0.104803493449782
"064900207","BUENOS AIRES",441,123,95,200,4,299,0.27891156462585
"064900506","BUENOS AIRES",300,15,150,127,0,277,0.05
"064900511","BUENOS AIRES",329,46,165,104,0,269,0.139817629179331
"064900604","BUENOS AIRES",343,31,193,117,0,310,0.0903790087463557
"064902101","BUENOS AIRES",390,387,2,1,0,3,0.992307692307692
"064900701","BUENOS AIRES",242,8,108,121,1,230,0.0330578512396694
"064900908","BUENOS AIRES",262,258,4,0,0,4,0.984732824427481
"064900909","BUENOS AIRES",215,214,1,0,0,1,0.995348837209302
"064901010","BUENOS AIRES",317,146,94,77,0,171,0.460567823343849
"064901108","BUENOS AIRES",169,161,4,3,1,8,0.952662721893491
"064901110","BUENOS AIRES",216,215,1,0,0,1,0.99537037037037
"064901113","BUENOS AIRES",296,284,4,8,0,12,0.959459459459459
"064901114","BUENOS AIRES",315,309,5,1,0,6,0.980952380952381
"064901201","BUENOS AIRES",284,267,14,3,0,17,0.940140845070423
"064901305","BUENOS AIRES",229,22,107,97,0,204,0.0960698689956332
"064901310","BUENOS AIRES",393,15,193,184,0,377,0.0381679389312977
"064901311","BUENOS AIRES",379,12,211,150,0,361,0.0316622691292876
"064901601","BUENOS AIRES",420,4,200,205,1,406,0.00952380952380952
"064901607","BUENOS AIRES",268,6,184,78,0,262,0.0223880597014925
"064901803","BUENOS AIRES",365,339,20,5,0,25,0.928767123287671
"064901812","BUENOS AIRES",413,9,286,113,2,401,0.0217917675544794
"064901902","BUENOS AIRES",298,261,22,15,0,37,0.875838926174497
"064901904","BUENOS AIRES",217,209,5,3,0,8,0.963133640552995
"064901911","BUENOS AIRES",235,218,16,1,0,17,0.927659574468085
"064902207","BUENOS AIRES",173,172,1,0,0,1,0.994219653179191
"064902211","BUENOS AIRES",237,236,1,0,0,1,0.9957805907173
"064902212","BUENOS AIRES",46,46,0,0,0,0,1
"064902310","BUENOS AIRES",169,169,0,0,0,0,1
"064902312","BUENOS AIRES",209,209,0,0,0,0,1
"064902406","BUENOS AIRES",259,256,2,0,0,2,0.988416988416988
"064902501","BUENOS AIRES",323,218,62,42,1,105,0.674922600619195
"064902503","BUENOS AIRES",278,248,16,14,0,30,0.892086330935252
"064902703","BUENOS AIRES",334,24,178,131,0,309,0.0718562874251497
"064902706","BUENOS AIRES",319,6,225,88,0,313,0.0188087774294671
"064902807","BUENOS AIRES",241,2,146,92,0,238,0.00829875518672199
"064902901","BUENOS AIRES",372,10,203,155,2,360,0.0268817204301075
"064902910","BUENOS AIRES",361,32,184,136,0,320,0.0886426592797784
"064902911","BUENOS AIRES",452,9,218,220,0,438,0.0199115044247788
"064903306","BUENOS AIRES",347,4,138,181,0,319,0.0115273775216138
"064903308","BUENOS AIRES",304,6,84,200,2,286,0.0197368421052632
"064903309","BUENOS AIRES",351,3,169,165,0,334,0.00854700854700855
"064903402","BUENOS AIRES",427,15,94,283,4,381,0.0351288056206089
"064903505","BUENOS AIRES",408,4,31,210,33,274,0.00980392156862745
"064903516","BUENOS AIRES",224,5,83,129,0,212,0.0223214285714286
"064903604","BUENOS AIRES",337,17,172,135,1,308,0.0504451038575668
"066581807","BUENOS AIRES",225,224,0,0,0,0,0.995555555555556
"064903710","BUENOS AIRES",424,25,184,158,1,343,0.0589622641509434
"064903711","BUENOS AIRES",548,52,242,230,0,472,0.0948905109489051
"064903712","BUENOS AIRES",338,7,174,143,0,317,0.0207100591715976
"064903801","BUENOS AIRES",216,3,75,127,0,202,0.0138888888888889
"064904606","BUENOS AIRES",186,174,7,5,0,12,0.935483870967742
"064903804","BUENOS AIRES",222,10,68,137,4,209,0.045045045045045
"064903809","BUENOS AIRES",286,50,82,144,6,232,0.174825174825175
"064903911","BUENOS AIRES",465,37,92,327,4,423,0.0795698924731183
"064903912","BUENOS AIRES",287,16,86,178,0,264,0.0557491289198606
"064903916","BUENOS AIRES",405,21,108,257,2,367,0.0518518518518519
"064904010","BUENOS AIRES",402,12,68,288,23,379,0.0298507462686567
"060071107","BUENOS AIRES",5,0,0,5,0,5,0
"064904207","BUENOS AIRES",354,9,235,110,0,345,0.0254237288135593
"064904208","BUENOS AIRES",285,4,201,74,2,277,0.0140350877192982
"064904307","BUENOS AIRES",250,234,6,6,0,12,0.936
"064904310","BUENOS AIRES",357,2,271,80,1,352,0.00560224089635854
"064904314","BUENOS AIRES",226,11,137,76,1,214,0.0486725663716814
"064904410","BUENOS AIRES",256,8,149,96,0,245,0.03125
"064904506","BUENOS AIRES",364,17,201,142,3,346,0.0467032967032967
"064904602","BUENOS AIRES",262,246,15,1,0,16,0.938931297709924
"064904608","BUENOS AIRES",251,189,15,7,0,22,0.752988047808765
"064904709","BUENOS AIRES",238,2,156,80,0,236,0.00840336134453781
"064904710","BUENOS AIRES",247,7,166,74,0,240,0.0283400809716599
"064904803","BUENOS AIRES",248,246,2,0,0,2,0.991935483870968
"065391209","BUENOS AIRES",340,7,154,155,5,314,0.0205882352941176
"067561102","BUENOS AIRES",211,211,0,0,0,0,1
"067561108","BUENOS AIRES",234,234,0,0,0,0,1
"060070611","BUENOS AIRES",7,0,3,4,0,7,0
"065391309","BUENOS AIRES",212,1,131,74,1,206,0.00471698113207547
"065391402","BUENOS AIRES",203,189,11,3,0,14,0.931034482758621
"065391405","BUENOS AIRES",234,132,79,17,0,96,0.564102564102564
"065391409","BUENOS AIRES",470,138,289,42,0,331,0.293617021276596
"065810501","BUENOS AIRES",77,77,0,0,0,0,1
"060771202","BUENOS AIRES",13,0,4,8,0,12,0
"065391508","BUENOS AIRES",246,243,0,1,0,1,0.98780487804878
"061120606","BUENOS AIRES",8,0,5,3,0,8,0
"061400502","BUENOS AIRES",14,0,2,12,0,14,0
"061680102","BUENOS AIRES",10,0,6,4,0,10,0
"060070201","BUENOS AIRES",8,1,7,0,0,7,0.125
"065391602","BUENOS AIRES",429,359,40,28,0,68,0.836829836829837
"060070308","BUENOS AIRES",11,0,1,9,0,10,0
"060070511","BUENOS AIRES",4,0,2,2,0,4,0
"065391604","BUENOS AIRES",191,187,4,0,0,4,0.979057591623037
"060071004","BUENOS AIRES",4,0,4,0,0,4,0
"060071012","BUENOS AIRES",5,0,2,3,0,5,0
"060071104","BUENOS AIRES",9,0,3,6,0,9,0
"060140502","BUENOS AIRES",37,0,20,16,0,36,0
"060141401","BUENOS AIRES",7,0,3,4,0,7,0
"060210701","BUENOS AIRES",6,0,0,6,0,6,0
"061891203","BUENOS AIRES",7,0,6,1,0,7,0
"061960403","BUENOS AIRES",6,0,3,3,0,6,0
"062170905","BUENOS AIRES",11,0,3,8,0,11,0
"065391611","BUENOS AIRES",351,350,0,1,0,1,0.997150997150997
"062241702","BUENOS AIRES",17,0,3,14,0,17,0
"060421001","BUENOS AIRES",52,0,12,35,4,51,0
"065951613","BUENOS AIRES",189,189,0,0,0,0,1
"067630201","BUENOS AIRES",119,119,0,0,0,0,1
"060420301","BUENOS AIRES",68,0,13,53,1,67,0
"060490301","BUENOS AIRES",54,5,14,34,1,49,0.0925925925925926
"067561403","BUENOS AIRES",221,213,5,3,0,8,0.963800904977376
"065391704","BUENOS AIRES",307,83,146,71,0,217,0.270358306188925
"065391803","BUENOS AIRES",416,353,32,28,0,60,0.848557692307692
"061050401","BUENOS AIRES",46,1,15,29,1,45,0.0217391304347826
"061050806","BUENOS AIRES",31,0,8,23,0,31,0
"060490302","BUENOS AIRES",31,0,3,26,0,29,0
"060491801","BUENOS AIRES",92,14,37,39,2,78,0.152173913043478
"060492005","BUENOS AIRES",16,1,2,13,0,15,0.0625
"060630301","BUENOS AIRES",14,0,13,1,0,14,0
"060630306","BUENOS AIRES",22,0,12,9,0,21,0
"061610302","BUENOS AIRES",8,0,5,3,0,8,0
"060630707","BUENOS AIRES",240,31,55,150,1,206,0.129166666666667
"060631001","BUENOS AIRES",20,4,11,5,0,16,0.2
"060700602","BUENOS AIRES",43,0,21,22,0,43,0
"060700803","BUENOS AIRES",9,1,3,5,0,8,0.111111111111111
"065391705","BUENOS AIRES",355,166,114,70,0,184,0.467605633802817
"060701004","BUENOS AIRES",9,0,3,6,0,9,0
"065391707","BUENOS AIRES",234,116,60,52,0,112,0.495726495726496
"065391708","BUENOS AIRES",247,192,30,22,0,52,0.777327935222672
"060840305","BUENOS AIRES",13,0,2,10,1,13,0
"060701202","BUENOS AIRES",21,0,2,14,2,18,0
"060771001","BUENOS AIRES",4,0,3,1,0,4,0
"060771002","BUENOS AIRES",10,0,6,4,0,10,0
"060771101","BUENOS AIRES",5,0,2,2,0,4,0
"060771302","BUENOS AIRES",19,0,3,16,0,19,0
"060840302","BUENOS AIRES",18,0,6,12,0,18,0
"060840501","BUENOS AIRES",34,0,15,19,0,34,0
"061051409","BUENOS AIRES",30,1,17,12,0,29,0.0333333333333333
"061120402","BUENOS AIRES",6,0,0,6,0,6,0
"061120505","BUENOS AIRES",9,0,1,8,0,9,0
"061120707","BUENOS AIRES",6,0,0,6,0,6,0
"061121201","BUENOS AIRES",10,0,5,5,0,10,0
"061121205","BUENOS AIRES",5,0,2,3,0,5,0
"061190310","BUENOS AIRES",64,0,37,27,0,64,0
"061190802","BUENOS AIRES",12,0,8,4,0,12,0
"063221202","BUENOS AIRES",4,0,2,2,0,4,0
"063430501","BUENOS AIRES",16,0,1,14,1,16,0
"067561605","BUENOS AIRES",209,202,7,0,0,7,0.966507177033493
"065392003","BUENOS AIRES",282,9,201,70,0,271,0.0319148936170213
"061340912","BUENOS AIRES",44,2,18,20,3,41,0.0454545454545455
"061261005","BUENOS AIRES",42,0,7,10,13,30,0
"065391908","BUENOS AIRES",282,249,19,9,2,30,0.882978723404255
"065391909","BUENOS AIRES",290,251,20,15,0,35,0.86551724137931
"065392005","BUENOS AIRES",291,0,215,73,1,289,0
"061400103","BUENOS AIRES",29,0,15,14,0,29,0
"061400201","BUENOS AIRES",9,0,0,9,0,9,0
"061400503","BUENOS AIRES",14,0,4,10,0,14,0
"061400601","BUENOS AIRES",6,0,6,0,0,6,0
"061470401","BUENOS AIRES",8,0,4,4,0,8,0
"061470402","BUENOS AIRES",15,0,7,8,0,15,0
"068052608","BUENOS AIRES",82,0,35,39,2,76,0
"061470703","BUENOS AIRES",76,1,43,32,0,75,0.0131578947368421
"061470802","BUENOS AIRES",12,0,3,7,0,10,0
"061470804","BUENOS AIRES",15,0,0,15,0,15,0
"061540501","BUENOS AIRES",14,0,7,7,0,14,0
"061540701","BUENOS AIRES",22,0,12,9,0,21,0
"061540901","BUENOS AIRES",27,0,5,22,0,27,0
"068331602","BUENOS AIRES",9,0,6,2,1,9,0
"065681708","BUENOS AIRES",369,189,149,31,0,180,0.51219512195122
"061610602","BUENOS AIRES",10,0,0,9,1,10,0
"061610702","BUENOS AIRES",20,0,0,19,0,19,0
"061680101","BUENOS AIRES",12,0,1,11,0,12,0
"061680301","BUENOS AIRES",16,0,0,13,1,14,0
"061680601","BUENOS AIRES",4,0,0,4,0,4,0
"061680604","BUENOS AIRES",7,0,0,7,0,7,0
"061891103","BUENOS AIRES",5,0,3,1,0,4,0
"061261002","BUENOS AIRES",46,0,8,27,5,40,0
"061891107","BUENOS AIRES",3,0,2,1,0,3,0
"061680805","BUENOS AIRES",38,0,10,27,0,37,0
"061680806","BUENOS AIRES",9,0,0,9,0,9,0
"061681101","BUENOS AIRES",25,0,11,14,0,25,0
"061890102","BUENOS AIRES",10,0,6,4,0,10,0
"061890402","BUENOS AIRES",5,0,1,2,0,3,0
"061890603","BUENOS AIRES",5,0,5,0,0,5,0
"061890608","BUENOS AIRES",7,0,7,0,0,7,0
"061891010","BUENOS AIRES",17,1,12,2,1,15,0.0588235294117647
"062031504","BUENOS AIRES",8,0,1,7,0,8,0
"065392201","BUENOS AIRES",478,12,302,157,0,459,0.0251046025104603
"066584007","BUENOS AIRES",429,21,115,262,10,387,0.048951048951049
"061891205","BUENOS AIRES",6,0,4,2,0,6,0
"061891210","BUENOS AIRES",9,0,8,1,0,9,0
"061891302","BUENOS AIRES",7,0,4,3,0,7,0
"061891303","BUENOS AIRES",12,0,7,4,1,12,0
"061891304","BUENOS AIRES",6,0,4,2,0,6,0
"061960603","BUENOS AIRES",7,0,1,6,0,7,0
"061960705","BUENOS AIRES",12,0,4,6,0,10,0
"061960707","BUENOS AIRES",21,0,5,15,1,21,0
"061960803","BUENOS AIRES",11,0,6,4,0,10,0
"061960805","BUENOS AIRES",1,0,1,0,0,1,0
"062100602","BUENOS AIRES",20,1,13,6,0,19,0.05
"061960904","BUENOS AIRES",15,0,10,5,0,15,0
"065392107","BUENOS AIRES",281,4,197,80,0,277,0.0142348754448399
"067701704","BUENOS AIRES",6,0,0,5,0,5,0
"061961104","BUENOS AIRES",7,0,4,3,0,7,0
"061961107","BUENOS AIRES",6,0,1,5,0,6,0
"061961303","BUENOS AIRES",10,0,6,3,0,9,0
"061961502","BUENOS AIRES",9,0,3,6,0,9,0
"062030603","BUENOS AIRES",5,0,4,1,0,5,0
"062030702","BUENOS AIRES",5,0,4,1,0,5,0
"062030706","BUENOS AIRES",3,0,2,1,0,3,0
"065392208","BUENOS AIRES",481,2,352,123,0,475,0.00415800415800416
"062031001","BUENOS AIRES",1,0,0,1,0,1,0
"062031103","BUENOS AIRES",0,0,0,0,0,0,NA
"062031403","BUENOS AIRES",7,0,4,2,0,6,0
"062031204","BUENOS AIRES",12,0,2,10,0,12,0
"062031405","BUENOS AIRES",22,0,5,17,0,22,0
"068470108","BUENOS AIRES",3,0,2,1,0,3,0
"062100807","BUENOS AIRES",76,30,27,15,1,43,0.394736842105263
"062241601","BUENOS AIRES",9,0,1,7,0,8,0
"062101001","BUENOS AIRES",49,0,20,28,0,48,0
"062170202","BUENOS AIRES",24,0,14,10,0,24,0
"062170901","BUENOS AIRES",18,0,7,11,0,18,0
"062242007","BUENOS AIRES",11,0,4,7,0,11,0
"065392608","BUENOS AIRES",395,3,153,227,0,380,0.00759493670886076
"062310203","BUENOS AIRES",13,0,6,5,0,11,0
"062310702","BUENOS AIRES",10,0,10,0,0,10,0
"062170904","BUENOS AIRES",24,0,18,6,0,24,0
"065392413","BUENOS AIRES",260,7,157,93,0,250,0.0269230769230769
"065392503","BUENOS AIRES",481,8,307,149,0,456,0.0166320166320166
"065392504","BUENOS AIRES",250,1,174,71,0,245,0.004
"062171010","BUENOS AIRES",74,5,27,38,1,66,0.0675675675675676
"065392602","BUENOS AIRES",450,2,260,178,0,438,0.00444444444444444
"065392603","BUENOS AIRES",279,2,155,112,2,269,0.00716845878136201
"062170907","BUENOS AIRES",18,0,2,15,0,17,0
"062800507","BUENOS AIRES",8,0,3,5,0,8,0
"062240909","BUENOS AIRES",83,1,11,61,7,79,0.0120481927710843
"062241401","BUENOS AIRES",12,0,12,0,0,12,0
"062241402","BUENOS AIRES",24,0,10,9,5,24,0
"060910803","BUENOS AIRES",248,227,10,8,0,18,0.915322580645161
"065392701","BUENOS AIRES",471,28,156,268,1,425,0.059447983014862
"062660202","BUENOS AIRES",38,1,22,15,0,37,0.0263157894736842
"062701102","BUENOS AIRES",11,0,6,5,0,11,0
"062770105","BUENOS AIRES",7,0,6,1,0,7,0
"062770206","BUENOS AIRES",34,0,22,10,1,33,0
"020140909","CABA",363,360,3,0,0,3,0.991735537190083
"062800601","BUENOS AIRES",5,0,0,5,0,5,0
"063430604","BUENOS AIRES",11,0,6,5,0,11,0
"063510501","BUENOS AIRES",15,0,13,2,0,15,0
"062800709","BUENOS AIRES",19,0,9,8,1,18,0
"062800905","BUENOS AIRES",17,0,7,9,0,16,0
"065392810","BUENOS AIRES",434,3,268,147,0,415,0.00691244239631336
"063010815","BUENOS AIRES",9,0,2,5,0,7,0
"063080801","BUENOS AIRES",12,0,0,12,0,12,0
"063081003","BUENOS AIRES",27,0,3,24,0,27,0
"065110701","BUENOS AIRES",25,0,9,14,2,25,0
"062800906","BUENOS AIRES",22,0,14,7,0,21,0
"062870302","BUENOS AIRES",14,0,3,11,0,14,0
"063511002","BUENOS AIRES",9,0,4,4,1,9,0
"063010401","BUENOS AIRES",60,0,44,14,0,58,0
"063221201","BUENOS AIRES",10,0,7,3,0,10,0
"062870201","BUENOS AIRES",57,0,20,31,2,53,0
"062940210","BUENOS AIRES",10,0,3,6,1,10,0
"062940103","BUENOS AIRES",0,0,0,0,0,0,NA
"062940207","BUENOS AIRES",8,0,0,8,0,8,0
"065392704","BUENOS AIRES",348,316,14,17,0,31,0.908045977011494
"062940704","BUENOS AIRES",8,0,5,3,0,8,0
"062940813","BUENOS AIRES",1,0,1,0,0,1,0
"063511003","BUENOS AIRES",12,0,2,10,0,12,0
"063221303","BUENOS AIRES",12,0,6,6,0,12,0
"063150501","BUENOS AIRES",78,0,45,30,1,76,0
"063577916","BUENOS AIRES",64,0,13,48,0,61,0
"063220101","BUENOS AIRES",2,0,0,2,0,2,0
"063220302","BUENOS AIRES",19,0,9,10,0,19,0
"063221006","BUENOS AIRES",9,0,3,6,0,9,0
"063221007","BUENOS AIRES",44,0,11,31,1,43,0
"063290403","BUENOS AIRES",80,2,24,52,0,76,0.025
"063290503","BUENOS AIRES",36,0,17,19,0,36,0
"063430104","BUENOS AIRES",21,0,10,11,0,21,0
"063430201","BUENOS AIRES",44,0,31,12,0,43,0
"063578102","BUENOS AIRES",18,0,18,0,0,18,0
"065600903","BUENOS AIRES",49,8,16,22,1,39,0.163265306122449
"063578301","BUENOS AIRES",87,0,48,25,1,74,0
"064550802","BUENOS AIRES",26,0,5,18,1,24,0
"065600806","BUENOS AIRES",321,16,205,96,1,302,0.0498442367601246
"063640604","BUENOS AIRES",19,0,5,10,0,15,0
"065393109","BUENOS AIRES",335,0,130,191,2,323,0
"064761003","BUENOS AIRES",10,0,2,8,0,10,0
"063850405","BUENOS AIRES",5,0,3,1,0,4,0
"063920302","BUENOS AIRES",10,0,2,7,1,10,0
"063920604","BUENOS AIRES",27,0,16,10,0,26,0
"063920704","BUENOS AIRES",17,0,5,12,0,17,0
"063921204","BUENOS AIRES",42,0,20,20,1,41,0
"063921205","BUENOS AIRES",16,0,9,7,0,16,0
"063990401","BUENOS AIRES",21,0,10,11,0,21,0
"064691306","BUENOS AIRES",17,0,10,7,0,17,0
"064691502","BUENOS AIRES",13,0,11,2,0,13,0
"063990802","BUENOS AIRES",27,0,15,12,0,27,0
"064060107","BUENOS AIRES",1,0,0,1,0,1,0
"064060212","BUENOS AIRES",6,0,1,5,0,6,0
"064060301","BUENOS AIRES",10,0,5,5,0,10,0
"065110202","BUENOS AIRES",26,0,3,23,0,26,0
"064130902","BUENOS AIRES",9,4,0,4,0,4,0.444444444444444
"065320501","BUENOS AIRES",11,0,7,4,0,11,0
"066160106","BUENOS AIRES",1,0,1,0,0,1,0
"064480202","BUENOS AIRES",6,0,1,5,0,6,0
"064480403","BUENOS AIRES",0,0,0,0,0,0,NA
"064480502","BUENOS AIRES",8,0,3,5,0,8,0
"064480801","BUENOS AIRES",5,0,0,5,0,5,0
"064481206","BUENOS AIRES",4,0,4,0,0,4,0
"066860706","BUENOS AIRES",7,0,7,0,0,7,0
"064550201","BUENOS AIRES",32,0,27,4,1,32,0
"060561417","BUENOS AIRES",280,280,0,0,0,0,1
"064550603","BUENOS AIRES",40,0,11,29,0,40,0
"064550605","BUENOS AIRES",22,0,2,20,0,22,0
"064690802","BUENOS AIRES",49,0,32,14,0,46,0
"064690902","BUENOS AIRES",10,0,10,0,0,10,0
"064690907","BUENOS AIRES",14,0,9,5,0,14,0
"064691102","BUENOS AIRES",10,0,9,0,1,10,0
"064760202","BUENOS AIRES",55,4,42,9,0,51,0.0727272727272727
"064760203","BUENOS AIRES",42,0,25,15,1,41,0
"064761204","BUENOS AIRES",21,0,13,8,0,21,0
"066020701","BUENOS AIRES",10,0,0,9,1,10,0
"064760602","BUENOS AIRES",12,0,6,6,0,12,0
"064970202","BUENOS AIRES",22,0,11,11,0,22,0
"067070701","BUENOS AIRES",1,0,0,0,1,1,0
"064341609","BUENOS AIRES",339,231,50,58,0,108,0.68141592920354
"064760603","BUENOS AIRES",37,0,15,21,1,37,0
"064760804","BUENOS AIRES",17,0,1,13,2,16,0
"067210103","BUENOS AIRES",17,0,6,10,0,16,0
"066090301","BUENOS AIRES",5,0,4,1,0,5,0
"066090602","BUENOS AIRES",6,0,0,6,0,6,0
"064830705","BUENOS AIRES",17,0,11,5,0,16,0
"064970304","BUENOS AIRES",24,0,18,6,0,24,0
"064970401","BUENOS AIRES",34,0,16,18,0,34,0
"064970612","BUENOS AIRES",64,0,36,20,5,61,0
"064971003","BUENOS AIRES",17,0,7,10,0,17,0
"060561418","BUENOS AIRES",217,212,2,0,0,2,0.976958525345622
"065050105","BUENOS AIRES",33,0,14,19,0,33,0
"065050202","BUENOS AIRES",24,0,17,7,0,24,0
"065050407","BUENOS AIRES",46,4,30,12,0,42,0.0869565217391304
"020142403","CABA",269,269,0,0,0,0,1
"065180207","BUENOS AIRES",18,0,11,7,0,18,0
"065180304","BUENOS AIRES",42,0,16,25,0,41,0
"067140304","BUENOS AIRES",6,0,3,3,0,6,0
"065180411","BUENOS AIRES",3,0,0,2,1,3,0
"065250410","BUENOS AIRES",14,0,3,9,2,14,0
"065320401","BUENOS AIRES",81,0,34,45,0,79,0
"065320502","BUENOS AIRES",30,2,20,8,0,28,0.0666666666666667
"065881102","BUENOS AIRES",14,0,0,14,0,14,0
"020142103","CABA",145,145,0,0,0,0,1
"065320603","BUENOS AIRES",13,0,4,9,0,13,0
"065321301","BUENOS AIRES",13,0,1,12,0,13,0
"065600901","BUENOS AIRES",228,176,26,26,0,52,0.771929824561403
"065470202","BUENOS AIRES",30,0,14,16,0,30,0
"066091604","BUENOS AIRES",0,0,0,0,0,0,NA
"060561419","BUENOS AIRES",256,256,0,0,0,0,1
"065470203","BUENOS AIRES",44,0,25,19,0,44,0
"065470313","BUENOS AIRES",63,0,30,32,1,63,0
"065600902","BUENOS AIRES",93,45,18,29,1,48,0.483870967741935
"065881203","BUENOS AIRES",34,0,14,20,0,34,0
"067491503","BUENOS AIRES",34,0,11,11,10,32,0
"065470102","BUENOS AIRES",22,0,8,14,0,22,0
"066091708","BUENOS AIRES",13,0,10,1,0,11,0
"060910804","BUENOS AIRES",308,276,13,8,0,21,0.896103896103896
"065470502","BUENOS AIRES",32,0,23,8,0,31,0
"065470702","BUENOS AIRES",20,0,15,5,0,20,0
"067840204","BUENOS AIRES",5,0,3,2,0,5,0
"065740602","BUENOS AIRES",25,0,11,14,0,25,0
"066160110","BUENOS AIRES",28,0,9,19,0,28,0
"065810603","BUENOS AIRES",31,0,17,14,0,31,0
"065392915","BUENOS AIRES",150,0,52,90,1,143,0
"065392916","BUENOS AIRES",385,0,179,194,3,376,0
"065393003","BUENOS AIRES",300,238,27,34,0,61,0.793333333333333
"065810604","BUENOS AIRES",11,0,6,4,1,11,0
"065601007","BUENOS AIRES",448,31,258,145,0,403,0.0691964285714286
"065601011","BUENOS AIRES",377,190,55,123,2,180,0.503978779840849
"065601105","BUENOS AIRES",236,0,101,127,2,230,0
"065601110","BUENOS AIRES",453,6,190,247,0,437,0.0132450331125828
"065880503","BUENOS AIRES",12,0,4,6,1,11,0
"020141312","CABA",247,247,0,0,0,0,1
"065810705","BUENOS AIRES",14,0,7,7,0,14,0
"065600911","BUENOS AIRES",57,22,4,18,7,29,0.385964912280702
"065601001","BUENOS AIRES",163,57,84,21,0,105,0.349693251533742
"065601006","BUENOS AIRES",387,170,108,103,0,211,0.439276485788114
"065392912","BUENOS AIRES",73,0,24,47,2,73,0
"065951804","BUENOS AIRES",3,0,0,3,0,3,0
"065952601","BUENOS AIRES",107,2,27,75,2,104,0.0186915887850467
"066510703","BUENOS AIRES",8,0,8,0,0,8,0
"067701104","BUENOS AIRES",15,1,12,2,0,14,0.0666666666666667
"066231202","BUENOS AIRES",9,0,2,7,0,9,0
"066231702","BUENOS AIRES",6,0,1,4,0,5,0
"066231703","BUENOS AIRES",12,0,3,9,0,12,0
"066231901","BUENOS AIRES",6,0,4,2,0,6,0
"066232403","BUENOS AIRES",16,0,6,10,0,16,0
"066720601","BUENOS AIRES",7,0,0,7,0,7,0
"066581804","BUENOS AIRES",279,271,8,0,0,8,0.971326164874552
"066440303","BUENOS AIRES",5,0,3,2,0,5,0
"066510404","BUENOS AIRES",10,0,8,2,0,10,0
"066510407","BUENOS AIRES",14,0,1,13,0,14,0
"066510711","BUENOS AIRES",5,0,2,3,0,5,0
"066510804","BUENOS AIRES",7,0,3,4,0,7,0
"066510806","BUENOS AIRES",3,0,1,2,0,3,0
"066510811","BUENOS AIRES",4,0,3,1,0,4,0
"066510814","BUENOS AIRES",4,0,1,3,0,4,0
"066511003","BUENOS AIRES",11,0,6,4,1,11,0
"066511304","BUENOS AIRES",11,0,7,3,1,11,0
"067700502","BUENOS AIRES",1,0,1,0,0,1,0
"066650403","BUENOS AIRES",26,0,16,10,0,26,0
"066651005","BUENOS AIRES",7,2,1,4,0,5,0.285714285714286
"066721002","BUENOS AIRES",20,0,11,9,0,20,0
"065393205","BUENOS AIRES",386,3,138,215,5,358,0.0077720207253886
"066790102","BUENOS AIRES",21,0,10,11,0,21,0
"066790201","BUENOS AIRES",18,0,13,1,2,16,0
"066790301","BUENOS AIRES",21,0,9,12,0,21,0
"066791206","BUENOS AIRES",28,0,12,13,0,25,0
"066860208","BUENOS AIRES",5,1,4,0,0,4,0.2
"066860209","BUENOS AIRES",10,0,5,5,0,10,0
"066860303","BUENOS AIRES",13,0,6,7,0,13,0
"066860402","BUENOS AIRES",7,0,5,2,0,7,0
"066860501","BUENOS AIRES",10,0,3,7,0,10,0
"066861201","BUENOS AIRES",10,0,3,7,0,10,0
"066860903","BUENOS AIRES",9,0,7,2,0,9,0
"066930102","BUENOS AIRES",23,0,11,11,0,22,0
"067701105","BUENOS AIRES",28,2,14,12,0,26,0.0714285714285714
"066930201","BUENOS AIRES",32,0,14,18,0,32,0
"066930315","BUENOS AIRES",4,0,1,3,0,4,0
"066930402","BUENOS AIRES",46,0,27,17,1,45,0
"065393301","BUENOS AIRES",332,1,187,128,2,317,0.00301204819277108
"067280203","BUENOS AIRES",22,0,20,2,0,22,0
"066930604","BUENOS AIRES",19,0,17,2,0,19,0
"067000703","BUENOS AIRES",10,0,2,8,0,10,0
"067000904","BUENOS AIRES",9,0,6,3,0,9,0
"067701202","BUENOS AIRES",38,0,2,30,2,34,0
"067070202","BUENOS AIRES",34,0,13,19,0,32,0
"067280501","BUENOS AIRES",17,0,0,17,0,17,0
"020010609","CABA",419,419,0,0,0,0,1
"065393306","BUENOS AIRES",295,0,156,127,7,290,0
"067140303","BUENOS AIRES",3,0,0,3,0,3,0
"067140401","BUENOS AIRES",13,0,5,6,2,13,0
"067140402","BUENOS AIRES",17,0,6,11,0,17,0
"067140502","BUENOS AIRES",14,0,3,11,0,14,0
"067140703","BUENOS AIRES",10,0,4,6,0,10,0
"020021302","CABA",418,415,2,0,0,2,0.992822966507177
"067210211","BUENOS AIRES",12,0,0,12,0,12,0
"067280202","BUENOS AIRES",74,1,40,33,0,73,0.0135135135135135
"020021602","CABA",308,306,0,0,0,0,0.993506493506494
"067280701","BUENOS AIRES",12,0,5,7,0,12,0
"067281103","BUENOS AIRES",25,0,10,10,2,22,0
"067281404","BUENOS AIRES",26,0,3,21,1,25,0
"067281603","BUENOS AIRES",18,0,9,9,0,18,0
"065393311","BUENOS AIRES",150,0,68,74,5,147,0
"067350402","BUENOS AIRES",53,0,10,43,0,53,0
"067701205","BUENOS AIRES",12,0,0,12,0,12,0
"067701303","BUENOS AIRES",19,0,2,15,0,17,0
"067701502","BUENOS AIRES",7,0,6,1,0,7,0
"062241902","BUENOS AIRES",9,0,3,5,0,8,0
"067911501","BUENOS AIRES",63,0,44,19,0,63,0
"067911505","BUENOS AIRES",20,0,8,11,1,20,0
"067911602","BUENOS AIRES",43,0,33,9,1,43,0
"020010608","CABA",296,296,0,0,0,0,1
"067421002","BUENOS AIRES",63,0,41,21,0,62,0
"065393410","BUENOS AIRES",322,0,181,140,0,321,0
"065393412","BUENOS AIRES",304,4,223,73,0,296,0.0131578947368421
"065393413","BUENOS AIRES",379,1,287,83,2,372,0.00263852242744063
"064201407","BUENOS AIRES",23,23,0,0,0,0,1
"067491511","BUENOS AIRES",131,0,23,85,14,122,0
"060140601","BUENOS AIRES",19,0,12,7,0,19,0
"065470306","BUENOS AIRES",410,248,88,72,0,160,0.604878048780488
"067700201","BUENOS AIRES",8,4,2,0,0,2,0.5
"067700303","BUENOS AIRES",7,0,5,2,0,7,0
"067700702","BUENOS AIRES",2,0,0,2,0,2,0
"067700703","BUENOS AIRES",1,0,1,0,0,1,0
"067700804","BUENOS AIRES",7,0,3,4,0,7,0
"067700904","BUENOS AIRES",3,0,0,3,0,3,0
"067700907","BUENOS AIRES",13,0,11,2,0,13,0
"067702001","BUENOS AIRES",10,1,4,2,0,6,0.1
"067780505","BUENOS AIRES",27,0,20,6,0,26,0
"067840102","BUENOS AIRES",12,0,0,12,0,12,0
"067840503","BUENOS AIRES",9,0,4,5,0,9,0
"067840701","BUENOS AIRES",11,0,0,10,0,10,0
"067910501","BUENOS AIRES",35,0,13,19,1,33,0
"065530305","BUENOS AIRES",100,83,9,7,0,16,0.83
"067910702","BUENOS AIRES",38,0,10,24,3,37,0
"067911001","BUENOS AIRES",34,0,18,16,0,34,0
"067980203","BUENOS AIRES",30,0,10,19,1,30,0
"067980505","BUENOS AIRES",22,0,10,9,3,22,0
"068120303","BUENOS AIRES",2,0,2,0,0,2,0
"068052602","BUENOS AIRES",75,2,22,38,7,67,0.0266666666666667
"065470910","BUENOS AIRES",283,252,13,18,0,31,0.890459363957597
"065530110","BUENOS AIRES",37,35,2,0,0,2,0.945945945945946
"020020410","CABA",430,429,1,0,0,1,0.997674418604651
"065600104","BUENOS AIRES",322,0,206,105,0,311,0
"065600113","BUENOS AIRES",299,290,5,1,0,6,0.969899665551839
"065682012","BUENOS AIRES",333,325,4,1,1,6,0.975975975975976
"065600206","BUENOS AIRES",433,3,195,216,3,414,0.0069284064665127
"065600207","BUENOS AIRES",372,22,213,124,0,337,0.0591397849462366
"067630206","BUENOS AIRES",362,355,2,5,0,7,0.980662983425414
"065600210","BUENOS AIRES",412,2,247,153,1,401,0.00485436893203883
"065600404","BUENOS AIRES",455,6,239,196,1,436,0.0131868131868132
"065600215","BUENOS AIRES",408,3,228,149,2,379,0.00735294117647059
"065601202","BUENOS AIRES",307,3,141,161,0,302,0.00977198697068404
"065321101","BUENOS AIRES",62,0,26,35,0,61,0
"065390105","BUENOS AIRES",401,11,264,124,0,388,0.027431421446384
"065390108","BUENOS AIRES",335,67,138,101,0,239,0.2
"062601705","BUENOS AIRES",62,25,22,10,1,33,0.403225806451613
"065600216","BUENOS AIRES",691,3,134,459,22,615,0.00434153400868307
"065600407","BUENOS AIRES",216,6,156,52,0,208,0.0277777777777778
"065600416","BUENOS AIRES",301,2,189,100,0,289,0.00664451827242525
"065600503","BUENOS AIRES",187,0,125,59,0,184,0
"065600603","BUENOS AIRES",446,5,240,177,1,418,0.0112107623318386
"065180614","BUENOS AIRES",96,0,73,22,0,95,0
"066860302","BUENOS AIRES",24,0,9,12,1,22,0
"065681709","BUENOS AIRES",268,252,14,2,0,16,0.940298507462687
"065390305","BUENOS AIRES",366,360,3,3,0,6,0.983606557377049
"065180810","BUENOS AIRES",54,0,45,9,0,54,0
"065250411","BUENOS AIRES",81,0,10,62,1,73,0
"065250610","BUENOS AIRES",360,156,127,71,1,199,0.433333333333333
"065320304","BUENOS AIRES",225,159,28,31,1,60,0.706666666666667
"065320309","BUENOS AIRES",422,198,62,157,0,219,0.469194312796209
"060560109","BUENOS AIRES",185,184,0,0,0,0,0.994594594594595
"065320912","BUENOS AIRES",104,0,64,37,0,101,0
"065390307","BUENOS AIRES",342,325,14,3,0,17,0.950292397660819
"067560303","BUENOS AIRES",200,198,1,1,0,2,0.99
"065390609","BUENOS AIRES",284,2,251,31,0,282,0.00704225352112676
"065390707","BUENOS AIRES",207,12,91,101,0,192,0.0579710144927536
"065390809","BUENOS AIRES",384,0,208,166,1,375,0
"065390904","BUENOS AIRES",382,2,262,104,0,366,0.00523560209424084
"065391001","BUENOS AIRES",370,2,234,124,0,358,0.00540540540540541
"065391005","BUENOS AIRES",231,0,161,66,0,227,0
"065391012","BUENOS AIRES",508,3,332,159,2,493,0.00590551181102362
"065391203","BUENOS AIRES",356,9,229,105,0,334,0.0252808988764045
"063573008","BUENOS AIRES",111,100,0,0,0,0,0.900900900900901
"063711104","BUENOS AIRES",337,325,0,0,0,0,0.964391691394659
"064410414","BUENOS AIRES",245,245,0,0,0,0,1
"064621202","BUENOS AIRES",444,259,96,83,1,180,0.583333333333333
"064411903","BUENOS AIRES",230,230,0,0,0,0,1
"060980705","BUENOS AIRES",309,101,159,39,0,198,0.326860841423948
"060420701","BUENOS AIRES",64,1,26,30,2,58,0.015625
"060700404","BUENOS AIRES",111,0,59,52,0,111,0
"060770510","BUENOS AIRES",587,559,13,15,0,28,0.952299829642249
"061260602","BUENOS AIRES",17,0,11,6,0,17,0
"061260603","BUENOS AIRES",32,15,9,7,1,17,0.46875
"061260606","BUENOS AIRES",116,0,87,28,0,115,0
"062311201","BUENOS AIRES",315,246,29,38,1,68,0.780952380952381
"061400309","BUENOS AIRES",251,172,21,52,1,74,0.685258964143426
"061610604","BUENOS AIRES",13,0,8,5,0,13,0
"061821110","BUENOS AIRES",76,1,30,45,0,75,0.0131578947368421
"062310603","BUENOS AIRES",33,0,2,30,0,32,0
"064480612","BUENOS AIRES",32,32,0,0,0,0,1
"062601714","BUENOS AIRES",52,4,38,9,0,47,0.0769230769230769
"064690304","BUENOS AIRES",27,0,15,11,1,27,0
"065682912","BUENOS AIRES",352,3,236,105,0,341,0.00852272727272727
"062660403","BUENOS AIRES",90,1,48,39,1,88,0.0111111111111111
"062660501","BUENOS AIRES",412,2,221,175,7,403,0.00485436893203883
"063081002","BUENOS AIRES",283,0,126,152,2,280,0
"065681901","BUENOS AIRES",255,248,5,2,0,7,0.972549019607843
"062660706","BUENOS AIRES",80,0,46,32,1,79,0
"062701101","BUENOS AIRES",402,348,26,26,2,54,0.865671641791045
"062940606","BUENOS AIRES",17,0,4,13,0,17,0
"062800816","BUENOS AIRES",38,5,14,18,0,32,0.131578947368421
"064550701","BUENOS AIRES",66,0,26,39,0,65,0
"063850101","BUENOS AIRES",251,10,86,150,1,237,0.0398406374501992
"065952508","BUENOS AIRES",299,149,93,56,0,149,0.498327759197324
"062940608","BUENOS AIRES",71,0,31,36,4,71,0
"063150303","BUENOS AIRES",143,2,66,74,0,140,0.013986013986014
"063577909","BUENOS AIRES",377,3,190,177,1,368,0.00795755968169761
"063640204","BUENOS AIRES",223,2,63,132,4,199,0.00896860986547085
"063920605","BUENOS AIRES",54,0,11,43,0,54,0
"065952509","BUENOS AIRES",255,240,7,8,0,15,0.941176470588235
"063921503","BUENOS AIRES",58,0,27,28,0,55,0
"063990503","BUENOS AIRES",46,0,26,19,1,46,0
"063990703","BUENOS AIRES",275,222,21,28,1,50,0.807272727272727
"064131803","BUENOS AIRES",14,0,12,2,0,14,0
"064690301","BUENOS AIRES",39,0,13,22,2,37,0
"065682708","BUENOS AIRES",273,8,191,74,0,265,0.0293040293040293
"064690606","BUENOS AIRES",362,171,81,103,0,184,0.472375690607735
"064830413","BUENOS AIRES",397,2,195,184,6,385,0.00503778337531486
"064830706","BUENOS AIRES",30,0,12,18,0,30,0
"064970803","BUENOS AIRES",232,3,150,77,1,228,0.0129310344827586
"064971210","BUENOS AIRES",127,57,34,34,0,68,0.448818897637795
"065250413","BUENOS AIRES",73,7,37,27,1,65,0.0958904109589041
"065952510","BUENOS AIRES",267,40,116,111,0,227,0.149812734082397
"064971305","BUENOS AIRES",77,0,59,18,0,77,0
"065050306","BUENOS AIRES",337,117,85,133,0,218,0.347181008902077
"063573404","BUENOS AIRES",365,365,0,0,0,0,1
"065250203","BUENOS AIRES",305,0,158,141,1,300,0
"065250302","BUENOS AIRES",35,0,23,9,0,32,0
"065320908","BUENOS AIRES",131,2,76,52,1,129,0.0152671755725191
"065391015","BUENOS AIRES",283,0,252,30,0,282,0
"065952707","BUENOS AIRES",214,35,83,91,2,176,0.163551401869159
"066090608","BUENOS AIRES",80,25,27,26,1,54,0.3125
"066232102","BUENOS AIRES",82,1,47,32,0,79,0.0121951219512195
"065682005","BUENOS AIRES",274,272,0,0,0,0,0.992700729927007
"064277410","BUENOS AIRES",384,32,130,203,4,337,0.0833333333333333
"066232208","BUENOS AIRES",390,285,4,101,0,105,0.730769230769231
"066232903","BUENOS AIRES",292,141,42,71,4,117,0.482876712328767
"065681903","BUENOS AIRES",427,415,7,4,0,11,0.971896955503513
"063573408","BUENOS AIRES",98,98,0,0,0,0,1
"066232908","BUENOS AIRES",198,79,25,71,2,98,0.398989898989899
"066380101","BUENOS AIRES",49,0,14,33,0,47,0
"066550204","BUENOS AIRES",306,241,46,18,0,64,0.787581699346405
"065682104","BUENOS AIRES",266,260,6,0,0,6,0.977443609022556
"067001003","BUENOS AIRES",55,0,19,35,0,54,0
"067630601","BUENOS AIRES",420,347,30,37,0,67,0.826190476190476
"065682107","BUENOS AIRES",41,41,0,0,0,0,1
"065682109","BUENOS AIRES",167,163,2,1,0,3,0.976047904191617
"065682208","BUENOS AIRES",197,149,42,6,0,48,0.756345177664975
"065682212","BUENOS AIRES",172,147,22,3,0,25,0.854651162790698
"065682215","BUENOS AIRES",160,127,29,4,0,33,0.79375
"065682810","BUENOS AIRES",398,0,282,103,0,385,0
"067630809","BUENOS AIRES",358,4,186,148,1,335,0.0111731843575419
"067701013","BUENOS AIRES",513,15,76,316,66,458,0.0292397660818713
"065681702","BUENOS AIRES",321,2,248,70,0,318,0.00623052959501558
"065681705","BUENOS AIRES",388,1,347,39,0,386,0.00257731958762887
"065682301","BUENOS AIRES",201,197,3,1,0,4,0.980099502487562
"065682603","BUENOS AIRES",356,340,11,3,0,14,0.955056179775281
"065682604","BUENOS AIRES",212,203,7,2,0,9,0.957547169811321
"065682605","BUENOS AIRES",175,170,4,1,0,5,0.971428571428571
"065682610","BUENOS AIRES",379,135,199,41,0,240,0.356200527704486
"067780502","BUENOS AIRES",76,0,19,54,0,73,0
"067780704","BUENOS AIRES",14,0,4,10,0,14,0
"060980407","BUENOS AIRES",76,0,33,23,1,57,0
"065681408","BUENOS AIRES",242,242,0,0,0,0,1
"065681501","BUENOS AIRES",272,41,197,34,0,231,0.150735294117647
"065681504","BUENOS AIRES",410,314,46,18,0,64,0.765853658536585
"065681506","BUENOS AIRES",332,297,17,6,0,23,0.894578313253012
"065681509","BUENOS AIRES",220,218,0,0,0,0,0.990909090909091
"065681601","BUENOS AIRES",372,274,61,29,1,91,0.736559139784946
"020010404","CABA",604,602,1,0,0,1,0.996688741721854
"065682913","BUENOS AIRES",280,0,248,29,0,277,0
"065683006","BUENOS AIRES",289,28,164,64,31,259,0.0968858131487889
"065683008","BUENOS AIRES",380,4,295,77,0,372,0.0105263157894737
"065740403","BUENOS AIRES",356,53,92,207,1,300,0.148876404494382
"063573504","BUENOS AIRES",196,196,0,0,0,0,1
"065740409","BUENOS AIRES",259,227,22,9,1,32,0.876447876447876
"065740414","BUENOS AIRES",318,84,88,140,1,229,0.264150943396226
"065810102","BUENOS AIRES",374,321,10,43,0,53,0.858288770053476
"065810103","BUENOS AIRES",393,347,12,28,0,40,0.88295165394402
"065810206","BUENOS AIRES",298,296,2,0,0,2,0.993288590604027
"065810208","BUENOS AIRES",289,281,2,6,0,8,0.972318339100346
"065810211","BUENOS AIRES",261,138,18,95,4,117,0.528735632183908
"065810301","BUENOS AIRES",304,294,0,9,0,9,0.967105263157895
"065810302","BUENOS AIRES",325,310,4,11,0,15,0.953846153846154
"065810402","BUENOS AIRES",209,202,7,0,0,7,0.966507177033493
"065810708","BUENOS AIRES",186,2,110,68,4,182,0.010752688172043
"065811708","BUENOS AIRES",142,142,0,0,0,0,1
"065811709","BUENOS AIRES",82,82,0,0,0,0,1
"065950105","BUENOS AIRES",359,345,5,9,0,14,0.96100278551532
"065950214","BUENOS AIRES",205,186,10,9,0,19,0.907317073170732
"065950215","BUENOS AIRES",201,199,1,1,0,2,0.990049751243781
"065950401","BUENOS AIRES",227,34,109,82,0,191,0.149779735682819
"065811401","BUENOS AIRES",96,10,20,64,1,85,0.104166666666667
"065811403","BUENOS AIRES",333,200,18,111,1,130,0.600600600600601
"065811502","BUENOS AIRES",332,196,24,104,0,128,0.590361445783133
"065811912","BUENOS AIRES",256,187,14,26,0,40,0.73046875
"065880102","BUENOS AIRES",294,285,1,0,0,1,0.969387755102041
"065880105","BUENOS AIRES",314,312,1,1,0,2,0.993630573248408
"065880112","BUENOS AIRES",240,183,44,12,0,56,0.7625
"020142507","CABA",373,370,0,0,0,0,0.991957104557641
"065880802","BUENOS AIRES",29,0,6,19,1,26,0
"065880910","BUENOS AIRES",277,8,102,163,1,266,0.0288808664259928
"068190401","BUENOS AIRES",320,254,38,27,0,65,0.79375
"068190601","BUENOS AIRES",30,0,18,11,0,29,0
"067490307","BUENOS AIRES",216,211,5,0,0,5,0.976851851851852
"065951801","BUENOS AIRES",6,0,0,6,0,6,0
"068260213","BUENOS AIRES",101,100,1,0,0,1,0.99009900990099
"065951902","BUENOS AIRES",196,5,97,94,0,191,0.0255102040816327
"065951903","BUENOS AIRES",317,4,196,116,0,312,0.0126182965299685
"065951906","BUENOS AIRES",94,0,39,55,0,94,0
"065952105","BUENOS AIRES",285,3,207,74,0,281,0.0105263157894737
"067490308","BUENOS AIRES",255,255,0,0,0,0,1
"066090207","BUENOS AIRES",209,3,139,67,0,206,0.0143540669856459
"065952412","BUENOS AIRES",272,52,67,152,0,219,0.191176470588235
"020020904","CABA",461,461,0,0,0,0,1
"065952512","BUENOS AIRES",213,5,104,101,2,207,0.0234741784037559
"065952603","BUENOS AIRES",239,1,55,170,3,228,0.00418410041841004
"065952610","BUENOS AIRES",325,10,156,157,1,314,0.0307692307692308
"065952612","BUENOS AIRES",391,3,225,159,2,386,0.00767263427109974
"065952703","BUENOS AIRES",198,0,83,112,2,197,0
"066020302","BUENOS AIRES",207,2,81,108,0,189,0.00966183574879227
"066020803","BUENOS AIRES",117,2,92,20,0,112,0.0170940170940171
"066021603","BUENOS AIRES",411,333,31,32,0,63,0.81021897810219
"066090104","BUENOS AIRES",272,248,13,11,0,24,0.911764705882353
"066090607","BUENOS AIRES",87,1,68,17,1,86,0.0114942528735632
"066091001","BUENOS AIRES",178,1,57,115,4,176,0.00561797752808989
"066581808","BUENOS AIRES",269,269,0,0,0,0,1
"066091002","BUENOS AIRES",138,0,91,46,1,138,0
"068400706","BUENOS AIRES",292,288,1,1,1,3,0.986301369863014
"066091702","BUENOS AIRES",284,0,206,75,0,281,0
"066091906","BUENOS AIRES",338,315,16,7,0,23,0.931952662721893
"066230112","BUENOS AIRES",242,153,37,51,1,89,0.632231404958678
"066230208","BUENOS AIRES",291,288,2,1,0,3,0.989690721649485
"066230304","BUENOS AIRES",215,215,0,0,0,0,1
"066230306","BUENOS AIRES",287,287,0,0,0,0,1
"066230410","BUENOS AIRES",282,215,24,37,0,61,0.762411347517731
"066230508","BUENOS AIRES",327,246,10,71,0,81,0.752293577981651
"068402205","BUENOS AIRES",284,274,4,4,0,8,0.964788732394366
"066380605","BUENOS AIRES",423,12,197,207,0,404,0.0283687943262411
"066231501","BUENOS AIRES",79,1,15,62,1,78,0.0126582278481013
"066480506","BUENOS AIRES",474,10,227,216,3,446,0.0210970464135021
"066232007","BUENOS AIRES",446,375,29,39,0,68,0.840807174887892
"066232011","BUENOS AIRES",538,218,82,215,1,298,0.405204460966543
"066232104","BUENOS AIRES",239,231,8,0,0,8,0.96652719665272
"066232201","BUENOS AIRES",267,206,41,20,0,61,0.771535580524345
"066232206","BUENOS AIRES",298,213,38,47,0,85,0.714765100671141
"066232701","BUENOS AIRES",143,0,76,65,1,142,0
"066232802","BUENOS AIRES",378,232,58,77,0,135,0.613756613756614
"066232804","BUENOS AIRES",330,325,2,3,0,5,0.984848484848485
"066380112","BUENOS AIRES",729,585,89,45,3,137,0.802469135802469
"066380806","BUENOS AIRES",197,2,142,52,0,194,0.0101522842639594
"066380208","BUENOS AIRES",253,1,170,77,0,247,0.00395256916996047
"066381007","BUENOS AIRES",441,1,211,224,2,437,0.00226757369614512
"066380401","BUENOS AIRES",366,5,145,209,2,356,0.0136612021857923
"066380403","BUENOS AIRES",318,4,158,139,2,299,0.0125786163522013
"066380407","BUENOS AIRES",335,0,186,141,3,330,0
"020032404","CABA",311,309,2,0,0,2,0.993569131832797
"066380501","BUENOS AIRES",90,0,68,22,0,90,0
"066380607","BUENOS AIRES",384,1,187,175,2,364,0.00260416666666667
"066380610","BUENOS AIRES",429,1,245,172,2,419,0.00233100233100233
"066380613","BUENOS AIRES",387,5,205,168,1,374,0.0129198966408269
"066380706","BUENOS AIRES",158,3,127,28,0,155,0.0189873417721519
"066380712","BUENOS AIRES",313,2,219,89,0,308,0.00638977635782748
"066380913","BUENOS AIRES",436,2,196,224,0,420,0.00458715596330275
"066381101","BUENOS AIRES",163,0,40,105,3,148,0
"066381202","BUENOS AIRES",52,21,24,7,0,31,0.403846153846154
"066381205","BUENOS AIRES",497,402,46,49,0,95,0.808853118712274
"066381207","BUENOS AIRES",11,11,0,0,0,0,1
"066381311","BUENOS AIRES",309,0,82,205,2,289,0
"068612804","BUENOS AIRES",311,308,3,0,0,3,0.990353697749196
"066381501","BUENOS AIRES",129,1,95,31,0,126,0.00775193798449612
"068612910","BUENOS AIRES",351,351,0,0,0,0,1
"066381608","BUENOS AIRES",283,271,7,4,0,11,0.957597173144876
"066381704","BUENOS AIRES",293,146,75,70,0,145,0.498293515358362
"066381801","BUENOS AIRES",925,3,249,561,53,863,0.00324324324324324
"066930312","BUENOS AIRES",241,192,35,14,0,49,0.796680497925311
"066381804","BUENOS AIRES",413,242,149,21,0,170,0.585956416464891
"066510508","BUENOS AIRES",363,196,118,49,0,167,0.539944903581267
"064902205","BUENOS AIRES",223,223,0,0,0,0,1
"066381904","BUENOS AIRES",178,0,61,104,1,166,0
"068680609","BUENOS AIRES",76,73,2,1,0,3,0.960526315789474
"066382105","BUENOS AIRES",60,19,37,4,0,41,0.316666666666667
"066382214","BUENOS AIRES",410,3,223,160,0,383,0.00731707317073171
"066440110","BUENOS AIRES",34,33,0,0,0,0,0.970588235294118
"020142104","CABA",254,253,1,0,0,1,0.996062992125984
"068751401","BUENOS AIRES",53,2,34,14,2,50,0.0377358490566038
"066440201","BUENOS AIRES",201,19,146,28,1,175,0.0945273631840796
"066440304","BUENOS AIRES",171,3,143,25,0,168,0.0175438596491228
"066510715","BUENOS AIRES",255,4,207,42,0,249,0.0156862745098039
"066550310","BUENOS AIRES",272,159,43,65,0,108,0.584558823529412
"066581113","BUENOS AIRES",215,213,1,1,0,2,0.990697674418605
"066440309","BUENOS AIRES",40,2,35,3,0,38,0.05
"066440310","BUENOS AIRES",30,0,26,4,0,30,0
"064341611","BUENOS AIRES",320,282,25,13,0,38,0.88125
"066440503","BUENOS AIRES",206,183,8,15,0,23,0.888349514563107
"066440506","BUENOS AIRES",398,383,10,5,0,15,0.962311557788945
"066440618","BUENOS AIRES",69,6,51,11,0,62,0.0869565217391304
"066440621","BUENOS AIRES",96,4,82,10,0,92,0.0416666666666667
"066480104","BUENOS AIRES",336,6,250,77,0,327,0.0178571428571429
"066581108","BUENOS AIRES",276,274,0,0,0,0,0.992753623188406
"066580111","BUENOS AIRES",3,0,0,1,2,3,0
"066580208","BUENOS AIRES",326,5,34,261,6,301,0.0153374233128834
"066580211","BUENOS AIRES",385,19,54,240,35,329,0.0493506493506494
"066580212","BUENOS AIRES",287,233,19,34,0,53,0.81184668989547
"066580303","BUENOS AIRES",362,298,15,43,0,58,0.823204419889503
"066580504","BUENOS AIRES",203,203,0,0,0,0,1
"066580513","BUENOS AIRES",281,279,0,1,0,1,0.99288256227758
"066580710","BUENOS AIRES",464,131,72,221,3,296,0.282327586206897
"066580801","BUENOS AIRES",163,163,0,0,0,0,1
"066580802","BUENOS AIRES",205,205,0,0,0,0,1
"066580811","BUENOS AIRES",292,291,0,0,0,0,0.996575342465753
"066580814","BUENOS AIRES",199,199,0,0,0,0,1
"066580906","BUENOS AIRES",263,263,0,0,0,0,1
"066581002","BUENOS AIRES",363,119,36,188,3,227,0.327823691460055
"066581007","BUENOS AIRES",379,373,4,0,0,4,0.984168865435356
"066581101","BUENOS AIRES",315,293,14,8,0,22,0.93015873015873
"066581103","BUENOS AIRES",232,232,0,0,0,0,1
"066581201","BUENOS AIRES",440,427,8,4,0,12,0.970454545454545
"066581301","BUENOS AIRES",170,6,30,125,4,159,0.0352941176470588
"066581508","BUENOS AIRES",277,275,0,2,0,2,0.992779783393502
"066581511","BUENOS AIRES",207,202,3,2,0,5,0.975845410628019
"066581609","BUENOS AIRES",292,288,2,0,0,2,0.986301369863014
"066581611","BUENOS AIRES",227,225,0,1,0,1,0.991189427312775
"066581706","BUENOS AIRES",345,345,0,0,0,0,1
"066582104","BUENOS AIRES",353,305,15,20,0,35,0.864022662889518
"066582301","BUENOS AIRES",262,258,2,1,0,3,0.984732824427481
"066582410","BUENOS AIRES",236,234,2,0,0,2,0.991525423728814
"066582307","BUENOS AIRES",198,198,0,0,0,0,1
"066582312","BUENOS AIRES",278,257,2,16,0,18,0.924460431654676
"066582403","BUENOS AIRES",439,424,8,3,0,11,0.965831435079727
"066582801","BUENOS AIRES",218,212,4,2,0,6,0.972477064220184
"066584002","BUENOS AIRES",329,4,24,271,11,306,0.0121580547112462
"066582806","BUENOS AIRES",368,31,116,215,1,332,0.0842391304347826
"066582810","BUENOS AIRES",388,383,3,1,0,4,0.987113402061856
"066583001","BUENOS AIRES",389,371,12,6,0,18,0.953727506426735
"066583003","BUENOS AIRES",311,10,105,195,0,300,0.0321543408360129
"066583105","BUENOS AIRES",323,297,17,8,0,25,0.919504643962848
"066583107","BUENOS AIRES",314,311,2,1,0,3,0.990445859872611
"066583302","BUENOS AIRES",360,11,46,287,3,336,0.0305555555555556
"066583303","BUENOS AIRES",343,11,47,265,3,315,0.032069970845481
"061120908","BUENOS AIRES",3,0,0,3,0,3,0
"066583306","BUENOS AIRES",447,385,12,37,1,50,0.861297539149888
"066583412","BUENOS AIRES",376,336,20,17,1,38,0.893617021276596
"066583509","BUENOS AIRES",332,256,38,29,0,67,0.771084337349398
"066583805","BUENOS AIRES",447,58,101,256,1,358,0.129753914988814
"066583806","BUENOS AIRES",438,26,55,295,3,353,0.0593607305936073
"066583815","BUENOS AIRES",451,360,28,56,0,84,0.798226164079823
"066583905","BUENOS AIRES",411,19,155,225,1,381,0.0462287104622871
"066583908","BUENOS AIRES",292,2,109,169,1,279,0.00684931506849315
"066580705","BUENOS AIRES",269,267,2,0,0,2,0.992565055762082
"066584014","BUENOS AIRES",296,8,116,157,1,274,0.027027027027027
"066584206","BUENOS AIRES",273,32,179,49,0,228,0.117216117216117
"066584301","BUENOS AIRES",290,11,125,150,0,275,0.0379310344827586
"066584302","BUENOS AIRES",420,5,202,206,0,408,0.0119047619047619
"066584305","BUENOS AIRES",315,8,47,234,4,285,0.0253968253968254
"066584306","BUENOS AIRES",370,24,98,214,9,321,0.0648648648648649
"066584404","BUENOS AIRES",558,38,270,225,2,497,0.0681003584229391
"020142702","CABA",570,544,0,0,0,0,0.954385964912281
"066584405","BUENOS AIRES",361,19,152,177,1,330,0.0526315789473684
"066650204","BUENOS AIRES",339,328,6,5,0,11,0.967551622418879
"066650501","BUENOS AIRES",11,0,7,3,0,10,0
"066651002","BUENOS AIRES",338,191,35,92,0,127,0.56508875739645
"066651306","BUENOS AIRES",425,359,9,47,0,56,0.844705882352941
"066721215","BUENOS AIRES",294,243,17,31,2,50,0.826530612244898
"066790105","BUENOS AIRES",91,0,64,26,0,90,0
"063571704","BUENOS AIRES",199,193,5,0,0,5,0.969849246231156
"066790601","BUENOS AIRES",365,203,96,60,2,158,0.556164383561644
"066790613","BUENOS AIRES",239,199,40,0,0,40,0.832635983263598
"066791201","BUENOS AIRES",94,0,44,50,0,94,0
"066860101","BUENOS AIRES",199,175,13,10,0,23,0.879396984924623
"066861309","BUENOS AIRES",301,272,10,19,0,29,0.903654485049834
"066930305","BUENOS AIRES",154,2,64,74,1,139,0.012987012987013
"066930318","BUENOS AIRES",239,118,85,33,0,118,0.493723849372385
"067490305","BUENOS AIRES",292,287,3,2,0,5,0.982876712328767
"067000205","BUENOS AIRES",194,148,32,13,1,46,0.762886597938144
"067000501","BUENOS AIRES",66,0,30,35,0,65,0
"067001204","BUENOS AIRES",234,222,6,5,0,11,0.948717948717949
"067001207","BUENOS AIRES",307,301,2,3,0,5,0.980456026058632
"067070106","BUENOS AIRES",403,392,5,6,0,11,0.972704714640198
"067070605","BUENOS AIRES",147,2,70,73,0,143,0.0136054421768707
"067070405","BUENOS AIRES",278,180,33,65,0,98,0.647482014388489
"067070607","BUENOS AIRES",158,0,103,55,0,158,0
"067140103","BUENOS AIRES",311,291,2,18,0,20,0.935691318327974
"067140105","BUENOS AIRES",369,353,12,3,0,15,0.956639566395664
"067140501","BUENOS AIRES",217,1,108,107,0,215,0.00460829493087558
"067140609","BUENOS AIRES",265,129,34,91,2,127,0.486792452830189
"067140614","BUENOS AIRES",7,0,1,6,0,7,0
"067140617","BUENOS AIRES",293,7,105,175,0,280,0.0238907849829352
"067210203","BUENOS AIRES",223,156,60,7,0,67,0.699551569506726
"067210204","BUENOS AIRES",409,143,147,119,0,266,0.349633251833741
"067491113","BUENOS AIRES",408,354,13,6,0,19,0.867647058823529
"067210217","BUENOS AIRES",247,126,62,58,0,120,0.510121457489879
"067280201","BUENOS AIRES",102,0,50,48,1,99,0
"067281001","BUENOS AIRES",216,7,75,128,0,203,0.0324074074074074
"067281002","BUENOS AIRES",162,53,53,55,1,109,0.327160493827161
"067281006","BUENOS AIRES",141,84,26,30,0,56,0.595744680851064
"020020502","CABA",319,308,3,0,0,3,0.96551724137931
"067281020","BUENOS AIRES",257,80,77,97,1,175,0.311284046692607
"067350102","BUENOS AIRES",172,64,59,46,0,105,0.372093023255814
"067350105","BUENOS AIRES",387,348,23,15,0,38,0.89922480620155
"067350710","BUENOS AIRES",249,1,110,128,0,238,0.00401606425702811
"067420401","BUENOS AIRES",339,314,13,11,0,24,0.926253687315634
"067420405","BUENOS AIRES",229,212,7,10,0,17,0.925764192139738
"067910208","BUENOS AIRES",309,298,6,5,0,11,0.964401294498382
"067420408","BUENOS AIRES",194,184,2,7,1,10,0.948453608247423
"067490304","BUENOS AIRES",344,341,1,2,0,3,0.991279069767442
"067490103","BUENOS AIRES",335,202,37,90,0,127,0.602985074626866
"067490202","BUENOS AIRES",362,321,15,25,0,40,0.886740331491713
"067490206","BUENOS AIRES",121,121,0,0,0,0,1
"067490211","BUENOS AIRES",263,257,5,0,0,5,0.977186311787072
"067490310","BUENOS AIRES",257,253,4,0,0,4,0.98443579766537
"067490312","BUENOS AIRES",364,359,3,1,0,4,0.986263736263736
"067490405","BUENOS AIRES",100,58,11,24,0,35,0.58
"067490501","BUENOS AIRES",157,155,1,0,0,1,0.987261146496815
"067490601","BUENOS AIRES",204,188,11,5,0,16,0.92156862745098
"067490901","BUENOS AIRES",322,299,13,9,0,22,0.928571428571429
"067491012","BUENOS AIRES",300,185,26,87,0,113,0.616666666666667
"067491105","BUENOS AIRES",289,268,5,10,0,15,0.927335640138408
"062740104","BUENOS AIRES",215,206,3,6,0,9,0.958139534883721
"067491201","BUENOS AIRES",327,158,80,86,0,166,0.483180428134557
"067491310","BUENOS AIRES",272,250,9,8,0,17,0.919117647058823
"067560108","BUENOS AIRES",197,195,2,0,0,2,0.989847715736041
"067560114","BUENOS AIRES",390,387,2,1,0,3,0.992307692307692
"067562404","BUENOS AIRES",227,219,4,4,0,8,0.964757709251101
"067560116","BUENOS AIRES",356,317,17,20,0,37,0.890449438202247
"067560208","BUENOS AIRES",225,225,0,0,0,0,1
"067560504","BUENOS AIRES",301,301,0,0,0,0,1
"067560603","BUENOS AIRES",188,188,0,0,0,0,1
"067560606","BUENOS AIRES",248,248,0,0,0,0,1
"067560607","BUENOS AIRES",341,341,0,0,0,0,1
"067560610","BUENOS AIRES",346,346,0,0,0,0,1
"067560612","BUENOS AIRES",219,218,1,0,0,1,0.995433789954338
"067560808","BUENOS AIRES",362,359,3,0,0,3,0.99171270718232
"067560809","BUENOS AIRES",313,312,1,0,0,1,0.996805111821086
"067560909","BUENOS AIRES",337,333,3,1,0,4,0.98813056379822
"067560915","BUENOS AIRES",339,336,2,0,0,2,0.991150442477876
"067561113","BUENOS AIRES",254,253,1,0,0,1,0.996062992125984
"067561202","BUENOS AIRES",234,232,1,1,0,2,0.991452991452991
"067910405","BUENOS AIRES",159,158,0,1,0,1,0.993710691823899
"067561205","BUENOS AIRES",310,247,32,31,0,63,0.796774193548387
"067561210","BUENOS AIRES",281,262,11,8,0,19,0.932384341637011
"067561303","BUENOS AIRES",409,403,1,1,0,2,0.985330073349633
"067561401","BUENOS AIRES",617,500,39,53,1,93,0.810372771474878
"067561601","BUENOS AIRES",345,284,40,18,1,59,0.823188405797101
"067561604","BUENOS AIRES",309,259,17,33,0,50,0.838187702265372
"067561703","BUENOS AIRES",338,321,9,8,0,17,0.949704142011834
"067562004","BUENOS AIRES",187,180,4,3,0,7,0.962566844919786
"067562308","BUENOS AIRES",352,323,17,11,1,29,0.917613636363636
"067562403","BUENOS AIRES",214,198,11,4,0,15,0.925233644859813
"067562406","BUENOS AIRES",325,306,12,7,0,19,0.941538461538462
"067562519","BUENOS AIRES",369,6,243,120,0,363,0.016260162601626
"067562603","BUENOS AIRES",189,174,12,3,0,15,0.920634920634921
"067562706","BUENOS AIRES",498,465,11,12,0,23,0.933734939759036
"067562709","BUENOS AIRES",220,7,97,114,0,211,0.0318181818181818
"067600101","BUENOS AIRES",338,5,200,126,0,326,0.014792899408284
"067600105","BUENOS AIRES",485,424,40,16,1,57,0.874226804123711
"067600106","BUENOS AIRES",287,278,4,4,0,8,0.968641114982578
"067600115","BUENOS AIRES",296,274,14,6,0,20,0.925675675675676
"067600210","BUENOS AIRES",414,411,3,0,0,3,0.992753623188406
"067600310","BUENOS AIRES",74,49,11,14,0,25,0.662162162162162
"067600512","BUENOS AIRES",364,328,28,8,0,36,0.901098901098901
"063712110","BUENOS AIRES",324,308,8,7,0,15,0.950617283950617
"067600703","BUENOS AIRES",472,372,43,57,0,100,0.788135593220339
"067600708","BUENOS AIRES",319,9,291,18,0,309,0.0282131661442006
"067600811","BUENOS AIRES",266,221,28,14,0,42,0.830827067669173
"067600907","BUENOS AIRES",421,407,2,7,0,9,0.966745843230404
"067601004","BUENOS AIRES",250,1,188,53,0,241,0.004
"067601101","BUENOS AIRES",237,11,159,65,0,224,0.0464135021097046
"067601105","BUENOS AIRES",197,42,120,34,1,155,0.213197969543147
"067601201","BUENOS AIRES",216,1,179,33,0,212,0.00462962962962963
"067601202","BUENOS AIRES",232,2,149,75,2,226,0.00862068965517241
"067601205","BUENOS AIRES",266,3,242,20,0,262,0.0112781954887218
"067601212","BUENOS AIRES",311,3,146,154,2,302,0.00964630225080386
"067601307","BUENOS AIRES",259,1,156,96,2,254,0.00386100386100386
"067601309","BUENOS AIRES",431,4,80,334,3,417,0.00928074245939675
"067601812","BUENOS AIRES",411,2,257,116,1,374,0.0048661800486618
"067601314","BUENOS AIRES",446,3,110,323,1,434,0.00672645739910314
"067630105","BUENOS AIRES",318,250,22,42,0,64,0.786163522012579
"067601316","BUENOS AIRES",207,1,139,65,0,204,0.00483091787439614
"067601414","BUENOS AIRES",248,4,106,133,2,241,0.0161290322580645
"067601503","BUENOS AIRES",187,0,146,33,1,180,0
"067601603","BUENOS AIRES",359,2,218,131,1,350,0.00557103064066852
"067601604","BUENOS AIRES",324,1,191,127,1,319,0.00308641975308642
"067601606","BUENOS AIRES",383,2,191,167,2,360,0.00522193211488251
"067601612","BUENOS AIRES",183,3,149,31,0,180,0.0163934426229508
"067601703","BUENOS AIRES",295,0,181,112,0,293,0
"067601704","BUENOS AIRES",305,4,197,96,0,293,0.0131147540983607
"067601803","BUENOS AIRES",370,4,248,109,0,357,0.0108108108108108
"065680903","BUENOS AIRES",408,8,350,48,0,398,0.0196078431372549
"067601811","BUENOS AIRES",312,0,151,145,4,300,0
"067601814","BUENOS AIRES",317,2,172,134,0,306,0.00630914826498423
"067630209","BUENOS AIRES",322,320,2,0,0,2,0.993788819875776
"067630504","BUENOS AIRES",164,156,6,2,0,8,0.951219512195122
"067630602","BUENOS AIRES",264,6,114,141,2,257,0.0227272727272727
"067630706","BUENOS AIRES",445,19,203,220,0,423,0.0426966292134831
"067630801","BUENOS AIRES",240,4,135,99,0,234,0.0166666666666667
"067630902","BUENOS AIRES",189,97,21,67,0,88,0.513227513227513
"067631808","BUENOS AIRES",169,169,0,0,0,0,1
"067632002","BUENOS AIRES",85,0,54,30,1,85,0
"067701001","BUENOS AIRES",255,241,2,7,2,11,0.945098039215686
"067702211","BUENOS AIRES",286,281,2,2,0,4,0.982517482517482
"067702213","BUENOS AIRES",199,193,5,1,0,6,0.969849246231156
"067910211","BUENOS AIRES",333,325,1,7,0,8,0.975975975975976
"067702203","BUENOS AIRES",428,411,5,9,1,15,0.960280373831776
"067702204","BUENOS AIRES",490,408,9,25,12,46,0.83265306122449
"067780101","BUENOS AIRES",279,261,10,6,0,16,0.935483870967742
"067780105","BUENOS AIRES",368,267,45,34,4,83,0.72554347826087
"067780216","BUENOS AIRES",172,7,56,76,1,133,0.0406976744186047
"067910214","BUENOS AIRES",279,263,12,4,0,16,0.942652329749104
"067781009","BUENOS AIRES",419,276,70,55,0,125,0.658711217183771
"067840804","BUENOS AIRES",332,123,40,166,1,207,0.370481927710843
"067840807","BUENOS AIRES",290,191,61,38,0,99,0.658620689655172
"067910108","BUENOS AIRES",203,203,0,0,0,0,1
"067910111","BUENOS AIRES",210,204,5,0,0,5,0.971428571428571
"067910204","BUENOS AIRES",268,229,18,21,0,39,0.854477611940298
"067910404","BUENOS AIRES",215,208,6,1,0,7,0.967441860465116
"067911002","BUENOS AIRES",84,1,45,37,0,82,0.0119047619047619
"067911008","BUENOS AIRES",147,0,34,111,1,146,0
"067911302","BUENOS AIRES",270,139,42,82,1,125,0.514814814814815
"067911309","BUENOS AIRES",246,112,63,71,0,134,0.455284552845528
"067911310","BUENOS AIRES",264,77,28,151,1,180,0.291666666666667
"067911910","BUENOS AIRES",202,202,0,0,0,0,1
"067912001","BUENOS AIRES",301,251,6,44,0,50,0.833887043189369
"067912006","BUENOS AIRES",388,374,11,2,0,13,0.963917525773196
"067912214","BUENOS AIRES",229,229,0,0,0,0,1
"067912217","BUENOS AIRES",159,10,95,52,0,147,0.0628930817610063
"067980502","BUENOS AIRES",28,0,14,13,1,28,0
"068051315","BUENOS AIRES",278,14,199,63,0,262,0.0503597122302158
"061470710","BUENOS AIRES",7,0,1,6,0,7,0
"068050505","BUENOS AIRES",266,12,112,123,1,236,0.0451127819548872
"068050608","BUENOS AIRES",340,339,1,0,0,1,0.997058823529412
"068050306","BUENOS AIRES",402,387,13,1,1,15,0.962686567164179
"068050607","BUENOS AIRES",122,120,1,1,0,2,0.983606557377049
"068050410","BUENOS AIRES",519,27,200,278,0,478,0.0520231213872832
"068050509","BUENOS AIRES",271,2,192,76,1,269,0.00738007380073801
"068050602","BUENOS AIRES",300,252,15,32,0,47,0.84
"068050604","BUENOS AIRES",401,195,128,78,0,206,0.486284289276808
"068050707","BUENOS AIRES",148,104,14,29,0,43,0.702702702702703
"068050710","BUENOS AIRES",28,13,2,12,0,14,0.464285714285714
"068050808","BUENOS AIRES",575,20,240,306,0,546,0.0347826086956522
"068050903","BUENOS AIRES",301,6,142,140,1,283,0.0199335548172757
"068051106","BUENOS AIRES",347,9,144,173,0,317,0.0259365994236311
"068051311","BUENOS AIRES",438,15,246,160,2,408,0.0342465753424658
"068051312","BUENOS AIRES",405,0,227,155,0,382,0
"068051909","BUENOS AIRES",325,3,205,110,0,315,0.00923076923076923
"068051318","BUENOS AIRES",488,13,366,102,0,468,0.0266393442622951
"068051406","BUENOS AIRES",313,4,159,141,0,300,0.012779552715655
"068051505","BUENOS AIRES",340,26,195,89,0,284,0.0764705882352941
"068051701","BUENOS AIRES",393,1,235,143,3,381,0.00254452926208651
"068051804","BUENOS AIRES",430,0,337,88,0,425,0
"068051809","BUENOS AIRES",404,0,296,106,0,402,0
"068051904","BUENOS AIRES",229,2,189,35,0,224,0.00873362445414847
"068051905","BUENOS AIRES",300,0,196,102,0,298,0
"068051914","BUENOS AIRES",287,18,202,52,0,254,0.0627177700348432
"068052001","BUENOS AIRES",170,2,107,61,0,168,0.0117647058823529
"068052004","BUENOS AIRES",550,3,374,169,0,543,0.00545454545454545
"068052009","BUENOS AIRES",351,0,217,125,1,343,0
"020071106","CABA",267,265,1,0,0,1,0.99250936329588
"068052205","BUENOS AIRES",543,8,280,238,0,518,0.0147329650092081
"068052206","BUENOS AIRES",412,9,298,96,1,395,0.0218446601941748
"068052303","BUENOS AIRES",479,1,241,198,0,439,0.00208768267223382
"068052407","BUENOS AIRES",186,82,96,6,1,103,0.440860215053763
"068190405","BUENOS AIRES",293,265,12,16,0,28,0.904436860068259
"068260102","BUENOS AIRES",283,267,11,5,0,16,0.943462897526502
"068260116","BUENOS AIRES",159,152,2,3,0,5,0.955974842767296
"068260203","BUENOS AIRES",231,221,4,4,0,8,0.956709956709957
"068260207","BUENOS AIRES",154,149,4,1,0,5,0.967532467532468
"068261605","BUENOS AIRES",113,89,18,6,0,24,0.787610619469027
"068330107","BUENOS AIRES",364,360,3,1,0,4,0.989010989010989
"068330108","BUENOS AIRES",317,316,1,0,0,1,0.996845425867508
"068330701","BUENOS AIRES",9,0,5,4,0,9,0
"068331008","BUENOS AIRES",488,234,90,150,1,241,0.479508196721311
"068331101","BUENOS AIRES",192,0,90,96,5,191,0
"068331408","BUENOS AIRES",137,0,90,46,1,137,0
"068331703","BUENOS AIRES",185,0,109,76,0,185,0
"068400105","BUENOS AIRES",503,3,341,148,0,489,0.00596421471172962
"068400112","BUENOS AIRES",357,2,183,137,0,320,0.00560224089635854
"068400212","BUENOS AIRES",399,86,215,96,0,311,0.215538847117794
"068400307","BUENOS AIRES",415,31,239,141,0,380,0.0746987951807229
"068400401","BUENOS AIRES",489,30,192,229,8,429,0.0613496932515337
"068400604","BUENOS AIRES",306,281,11,13,0,24,0.918300653594771
"068401604","BUENOS AIRES",311,310,1,0,0,1,0.996784565916399
"068400704","BUENOS AIRES",316,314,0,2,0,2,0.993670886075949
"068400707","BUENOS AIRES",316,305,6,4,0,10,0.965189873417722
"066583504","BUENOS AIRES",378,13,203,159,1,363,0.0343915343915344
"068610606","BUENOS AIRES",258,258,0,0,0,0,1
"068400901","BUENOS AIRES",302,302,0,0,0,0,1
"068401004","BUENOS AIRES",320,318,2,0,0,2,0.99375
"068401013","BUENOS AIRES",232,218,12,1,0,13,0.939655172413793
"068401101","BUENOS AIRES",282,280,0,1,1,2,0.99290780141844
"068401102","BUENOS AIRES",236,230,4,1,0,5,0.974576271186441
"068401204","BUENOS AIRES",200,196,2,2,0,4,0.98
"068401403","BUENOS AIRES",251,245,2,4,0,6,0.97609561752988
"068401301","BUENOS AIRES",333,316,13,4,0,17,0.948948948948949
"068401304","BUENOS AIRES",347,331,8,8,0,16,0.953890489913545
"068401308","BUENOS AIRES",222,222,0,0,0,0,1
"068401310","BUENOS AIRES",431,427,3,1,0,4,0.990719257540603
"068401510","BUENOS AIRES",376,375,0,0,0,0,0.997340425531915
"068401601","BUENOS AIRES",254,252,0,2,0,2,0.992125984251969
"068401803","BUENOS AIRES",190,189,1,0,0,1,0.994736842105263
"068401806","BUENOS AIRES",390,388,1,0,0,1,0.994871794871795
"068401811","BUENOS AIRES",229,226,2,1,0,3,0.986899563318777
"068401912","BUENOS AIRES",304,283,16,4,1,21,0.930921052631579
"068402005","BUENOS AIRES",334,317,10,7,0,17,0.949101796407186
"068402108","BUENOS AIRES",305,283,10,3,0,13,0.927868852459016
"068402202","BUENOS AIRES",327,325,1,1,0,2,0.99388379204893
"068402404","BUENOS AIRES",241,206,6,28,0,34,0.854771784232365
"068402605","BUENOS AIRES",319,317,1,0,0,1,0.993730407523511
"068402809","BUENOS AIRES",297,287,7,2,0,9,0.966329966329966
"068403009","BUENOS AIRES",241,239,1,0,0,1,0.991701244813278
"068403013","BUENOS AIRES",216,214,1,1,0,2,0.990740740740741
"068403208","BUENOS AIRES",314,310,2,1,0,3,0.987261146496815
"068470102","BUENOS AIRES",350,0,292,57,1,350,0
"068120601","BUENOS AIRES",4,0,0,4,0,4,0
"068540101","BUENOS AIRES",177,17,23,134,1,158,0.096045197740113
"064904910","BUENOS AIRES",333,305,11,17,0,28,0.915915915915916
"068540108","BUENOS AIRES",297,257,14,26,0,40,0.865319865319865
"068540110","BUENOS AIRES",393,284,53,54,0,107,0.72264631043257
"065680904","BUENOS AIRES",233,7,172,54,0,226,0.0300429184549356
"068190602","BUENOS AIRES",44,0,33,5,6,44,0
"068260301","BUENOS AIRES",14,0,10,3,0,13,0
"068260902","BUENOS AIRES",24,0,16,5,0,21,0
"068261301","BUENOS AIRES",33,1,3,27,2,32,0.0303030303030303
"060351102","BUENOS AIRES",259,253,1,1,0,2,0.976833976833977
"068052618","BUENOS AIRES",74,4,43,14,9,66,0.0540540540540541
"068120101","BUENOS AIRES",20,0,7,13,0,20,0
"068261601","BUENOS AIRES",49,0,8,39,0,47,0
"068331202","BUENOS AIRES",10,0,7,3,0,10,0
"068330305","BUENOS AIRES",5,0,2,3,0,5,0
"068330401","BUENOS AIRES",31,0,12,19,0,31,0
"068330604","BUENOS AIRES",8,0,4,4,0,8,0
"068330702","BUENOS AIRES",13,0,1,11,0,12,0
"068331403","BUENOS AIRES",5,0,4,1,0,5,0
"068330706","BUENOS AIRES",20,0,7,12,0,19,0
"068610304","BUENOS AIRES",363,363,0,0,0,0,1
"068331013","BUENOS AIRES",49,3,15,31,0,46,0.0612244897959184
"068331103","BUENOS AIRES",9,0,4,5,0,9,0
"068331201","BUENOS AIRES",12,0,10,2,0,12,0
"063712114","BUENOS AIRES",292,285,5,1,0,6,0.976027397260274
"068331503","BUENOS AIRES",11,0,3,8,0,11,0
"068331604","BUENOS AIRES",2,0,2,0,0,2,0
"068331808","BUENOS AIRES",26,0,17,9,0,26,0
"068470202","BUENOS AIRES",7,0,6,0,0,6,0
"068540701","BUENOS AIRES",26,0,11,15,0,26,0
"068541014","BUENOS AIRES",179,2,80,97,0,177,0.0111731843575419
"068610205","BUENOS AIRES",222,222,0,0,0,0,1
"068541011","BUENOS AIRES",46,0,22,22,2,46,0
"068541103","BUENOS AIRES",23,1,5,17,0,22,0.0434782608695652
"068750701","BUENOS AIRES",42,0,28,12,2,42,0
"068820402","BUENOS AIRES",28,0,9,19,0,28,0
"068541003","BUENOS AIRES",287,178,59,50,0,109,0.620209059233449
"068541005","BUENOS AIRES",270,123,67,79,0,146,0.455555555555556
"068541009","BUENOS AIRES",62,0,38,23,0,61,0
"068610404","BUENOS AIRES",167,167,0,0,0,0,1
"068610503","BUENOS AIRES",228,228,0,0,0,0,1
"068610507","BUENOS AIRES",240,240,0,0,0,0,1
"068610601","BUENOS AIRES",104,85,5,11,0,16,0.817307692307692
"060280602","BUENOS AIRES",667,1,399,259,3,661,0.00149925037481259
"068610706","BUENOS AIRES",180,180,0,0,0,0,1
"068610805","BUENOS AIRES",186,186,0,0,0,0,1
"068610901","BUENOS AIRES",346,345,0,0,1,1,0.997109826589595
"068611004","BUENOS AIRES",337,335,2,0,0,2,0.99406528189911
"068611101","BUENOS AIRES",335,324,10,1,0,11,0.967164179104478
"068611106","BUENOS AIRES",333,327,5,1,0,6,0.981981981981982
"068611110","BUENOS AIRES",249,248,0,0,1,1,0.995983935742972
"068611301","BUENOS AIRES",167,166,1,0,0,1,0.994011976047904
"068611304","BUENOS AIRES",282,282,0,0,0,0,1
"068611401","BUENOS AIRES",260,260,0,0,0,0,1
"064201505","BUENOS AIRES",26,25,1,0,0,1,0.961538461538462
"068611404","BUENOS AIRES",290,286,3,1,0,4,0.986206896551724
"068611501","BUENOS AIRES",274,274,0,0,0,0,1
"068611506","BUENOS AIRES",278,276,2,0,0,2,0.992805755395683
"068611508","BUENOS AIRES",417,417,0,0,0,0,1
"068611604","BUENOS AIRES",332,330,2,0,0,2,0.993975903614458
"060910805","BUENOS AIRES",244,216,11,11,0,22,0.885245901639344
"068611606","BUENOS AIRES",312,309,3,0,0,3,0.990384615384615
"068611701","BUENOS AIRES",326,322,4,0,0,4,0.987730061349693
"068611702","BUENOS AIRES",308,308,0,0,0,0,1
"068611707","BUENOS AIRES",344,341,1,0,0,1,0.991279069767442
"068611902","BUENOS AIRES",119,119,0,0,0,0,1
"068611907","BUENOS AIRES",325,323,2,0,0,2,0.993846153846154
"068611910","BUENOS AIRES",274,271,2,1,0,3,0.989051094890511
"068612004","BUENOS AIRES",329,311,14,0,0,14,0.945288753799392
"068612105","BUENOS AIRES",306,305,1,0,0,1,0.996732026143791
"020022309","CABA",463,463,0,0,0,0,1
"068612201","BUENOS AIRES",322,320,2,0,0,2,0.993788819875776
"068612209","BUENOS AIRES",212,207,1,4,0,5,0.976415094339623
"068612301","BUENOS AIRES",424,409,6,6,0,12,0.964622641509434
"068612408","BUENOS AIRES",383,378,5,0,0,5,0.986945169712794
"068612502","BUENOS AIRES",441,435,4,1,0,5,0.986394557823129
"068612503","BUENOS AIRES",382,365,6,2,0,8,0.955497382198953
"068612506","BUENOS AIRES",288,284,4,0,0,4,0.986111111111111
"068612508","BUENOS AIRES",390,386,3,1,0,4,0.98974358974359
"068612606","BUENOS AIRES",337,334,3,0,0,3,0.991097922848665
"068612709","BUENOS AIRES",270,267,2,1,0,3,0.988888888888889
"068612802","BUENOS AIRES",351,344,5,2,0,7,0.98005698005698
"068612805","BUENOS AIRES",255,253,2,0,0,2,0.992156862745098
"068612806","BUENOS AIRES",285,282,3,0,0,3,0.989473684210526
"068612901","BUENOS AIRES",515,513,1,1,0,2,0.996116504854369
"068612902","BUENOS AIRES",288,284,2,1,0,3,0.986111111111111
"060351810","BUENOS AIRES",254,14,118,122,0,240,0.0551181102362205
"068612905","BUENOS AIRES",296,282,4,0,0,4,0.952702702702703
"068612906","BUENOS AIRES",184,181,2,1,0,3,0.983695652173913
"068613107","BUENOS AIRES",441,412,27,2,0,29,0.934240362811791
"068613204","BUENOS AIRES",107,95,6,0,0,6,0.88785046728972
"068680213","BUENOS AIRES",460,34,281,140,0,421,0.0739130434782609
"068680307","BUENOS AIRES",168,163,4,1,0,5,0.970238095238095
"060910905","BUENOS AIRES",210,209,0,1,0,1,0.995238095238095
"068680410","BUENOS AIRES",29,15,12,1,1,14,0.517241379310345
"068680507","BUENOS AIRES",94,5,79,10,0,89,0.0531914893617021
"068680606","BUENOS AIRES",19,19,0,0,0,0,1
"068680702","BUENOS AIRES",245,161,63,20,1,84,0.657142857142857
"068820101","BUENOS AIRES",360,340,2,11,0,13,0.944444444444444
"068680803","BUENOS AIRES",119,14,61,42,0,103,0.117647058823529
"068680807","BUENOS AIRES",25,24,0,1,0,1,0.96
"020021305","CABA",647,647,0,0,0,0,1
"068750605","BUENOS AIRES",270,3,186,71,5,262,0.0111111111111111
"068750601","BUENOS AIRES",258,7,200,49,0,249,0.0271317829457364
"068751608","BUENOS AIRES",255,243,5,7,0,12,0.952941176470588
"068751503","BUENOS AIRES",112,15,55,34,6,95,0.133928571428571
"068820202","BUENOS AIRES",275,262,6,6,0,12,0.952727272727273
"065680704","BUENOS AIRES",244,2,217,25,0,242,0.00819672131147541
"068820211","BUENOS AIRES",391,385,3,3,0,6,0.9846547314578
"068820503","BUENOS AIRES",456,325,60,70,0,130,0.712719298245614
"068820806","BUENOS AIRES",336,335,1,0,0,1,0.99702380952381
"068820907","BUENOS AIRES",487,24,99,347,2,448,0.0492813141683778
"068820914","BUENOS AIRES",305,215,22,65,0,87,0.704918032786885
"068821010","BUENOS AIRES",555,26,106,409,3,518,0.0468468468468468
"068821602","BUENOS AIRES",398,388,7,1,0,8,0.974874371859296
"065601401","BUENOS AIRES",476,27,161,234,18,413,0.0567226890756303
"065601404","BUENOS AIRES",326,21,140,153,1,294,0.0644171779141104
"063572213","BUENOS AIRES",136,136,0,0,0,0,1
"065601509","BUENOS AIRES",499,6,240,233,1,474,0.0120240480961924
"065601610","BUENOS AIRES",353,13,219,116,0,335,0.0368271954674221
"065601613","BUENOS AIRES",385,3,198,177,1,376,0.00779220779220779
"067702205","BUENOS AIRES",353,324,4,12,0,16,0.917847025495751
"062800313","BUENOS AIRES",29,28,1,0,0,1,0.96551724137931
"065601801","BUENOS AIRES",215,0,142,69,2,213,0
"065601803","BUENOS AIRES",222,1,141,74,2,217,0.0045045045045045
"065601808","BUENOS AIRES",185,0,144,40,0,184,0
"065601809","BUENOS AIRES",405,0,285,106,1,392,0
"067780406","BUENOS AIRES",105,2,41,60,2,103,0.019047619047619
"065601910","BUENOS AIRES",379,0,218,142,5,365,0
"064279217","BUENOS AIRES",229,4,127,92,3,222,0.0174672489082969
"065601916","BUENOS AIRES",201,0,108,79,7,194,0
"065602012","BUENOS AIRES",297,250,28,19,0,47,0.841750841750842
"065602109","BUENOS AIRES",395,20,211,155,1,367,0.0506329113924051
"065602203","BUENOS AIRES",357,4,298,54,1,353,0.0112044817927171
"060280904","BUENOS AIRES",533,7,224,273,3,500,0.0131332082551595
"065602207","BUENOS AIRES",249,201,26,22,0,48,0.807228915662651
"065602302","BUENOS AIRES",295,0,212,82,1,295,0
"065602305","BUENOS AIRES",345,3,229,111,0,340,0.00869565217391304
"065602315","BUENOS AIRES",258,254,3,1,0,4,0.984496124031008
"065602505","BUENOS AIRES",217,189,13,14,1,28,0.870967741935484
"065602512","BUENOS AIRES",261,185,56,18,1,75,0.708812260536398
"065680802","BUENOS AIRES",327,12,251,61,0,312,0.036697247706422
"065680806","BUENOS AIRES",355,7,259,88,0,347,0.0197183098591549
"065681008","BUENOS AIRES",339,5,246,86,0,332,0.0147492625368732
"065681202","BUENOS AIRES",334,329,4,0,0,4,0.985029940119761
"065681208","BUENOS AIRES",232,232,0,0,0,0,1
"065681305","BUENOS AIRES",330,325,3,1,0,4,0.984848484848485
"067702301","BUENOS AIRES",25,0,0,0,21,21,0
"064904901","BUENOS AIRES",263,262,1,0,0,1,0.996197718631179
"064904907","BUENOS AIRES",275,262,11,2,0,13,0.952727272727273
"065680101","BUENOS AIRES",134,4,85,43,0,128,0.0298507462686567
"067911007","BUENOS AIRES",137,1,57,72,3,132,0.0072992700729927
"065680210","BUENOS AIRES",230,4,178,47,0,225,0.0173913043478261
"065680301","BUENOS AIRES",339,3,266,69,0,335,0.00884955752212389
"065680403","BUENOS AIRES",231,228,3,0,0,3,0.987012987012987
"065680405","BUENOS AIRES",341,340,1,0,0,1,0.997067448680352
"065680504","BUENOS AIRES",229,228,0,0,0,0,0.995633187772926
"065680605","BUENOS AIRES",316,312,3,1,0,4,0.987341772151899
"065680610","BUENOS AIRES",227,225,2,0,0,2,0.991189427312775
"065680702","BUENOS AIRES",302,1,240,61,0,301,0.0033112582781457
"064905004","BUENOS AIRES",101,6,22,68,1,91,0.0594059405940594
"064905101","BUENOS AIRES",251,5,148,96,2,246,0.0199203187250996
"064905102","BUENOS AIRES",280,7,201,70,0,271,0.025
"064905103","BUENOS AIRES",203,4,137,58,0,195,0.0197044334975369
"064905108","BUENOS AIRES",363,3,220,138,0,358,0.00826446280991736
"064905110","BUENOS AIRES",189,104,23,62,0,85,0.55026455026455
"064970108","BUENOS AIRES",229,170,39,20,0,59,0.74235807860262
"065680314","BUENOS AIRES",602,581,6,1,0,7,0.965116279069767
"064970309","BUENOS AIRES",165,0,47,113,3,163,0
"064970406","BUENOS AIRES",182,1,80,88,2,170,0.00549450549450549
"064970409","BUENOS AIRES",218,1,107,102,2,211,0.00458715596330275
"064970604","BUENOS AIRES",295,268,21,6,0,27,0.908474576271186
"064970613","BUENOS AIRES",199,0,66,129,1,196,0
"064970802","BUENOS AIRES",275,1,123,148,2,273,0.00363636363636364
"064971107","BUENOS AIRES",308,274,21,12,0,33,0.88961038961039
"064971108","BUENOS AIRES",265,243,17,5,0,22,0.916981132075472
"064971205","BUENOS AIRES",370,307,40,21,0,61,0.82972972972973
"064971212","BUENOS AIRES",91,0,49,41,0,90,0
"065050212","BUENOS AIRES",147,93,30,23,0,53,0.63265306122449
"065050302","BUENOS AIRES",63,0,48,15,0,63,0
"065050309","BUENOS AIRES",235,124,61,48,0,109,0.527659574468085
"065050315","BUENOS AIRES",281,169,69,41,0,110,0.601423487544484
"065110504","BUENOS AIRES",277,174,36,64,1,101,0.628158844765343
"064410707","BUENOS AIRES",269,269,0,0,0,0,1
"065152113","BUENOS AIRES",298,3,261,32,0,293,0.0100671140939597
"065180202","BUENOS AIRES",194,116,34,41,1,76,0.597938144329897
"065180205","BUENOS AIRES",359,341,8,8,1,17,0.949860724233983
"065180212","BUENOS AIRES",164,47,30,83,1,114,0.286585365853659
"065150108","BUENOS AIRES",498,0,234,244,1,479,0
"065150109","BUENOS AIRES",276,1,184,84,0,268,0.0036231884057971
"065180504","BUENOS AIRES",237,0,116,117,2,235,0
"065180706","BUENOS AIRES",52,0,38,14,0,52,0
"065150708","BUENOS AIRES",394,4,267,99,4,370,0.0101522842639594
"060283308","BUENOS AIRES",405,69,194,136,2,332,0.17037037037037
"065150905","BUENOS AIRES",424,1,320,92,1,413,0.00235849056603774
"060283908","BUENOS AIRES",269,0,134,130,0,264,0
"060353301","BUENOS AIRES",320,295,21,4,0,25,0.921875
"065151106","BUENOS AIRES",241,7,167,64,1,232,0.029045643153527
"060562313","BUENOS AIRES",250,236,3,3,0,6,0.944
"060280710","BUENOS AIRES",342,0,255,85,1,341,0
"065150201","BUENOS AIRES",90,1,47,42,0,89,0.0111111111111111
"065150406","BUENOS AIRES",416,0,215,176,2,393,0
"060070513","BUENOS AIRES",2,0,2,0,0,2,0
"065150411","BUENOS AIRES",187,5,93,74,1,168,0.0267379679144385
"065150504","BUENOS AIRES",458,0,315,124,2,441,0
"065150609","BUENOS AIRES",436,3,328,96,0,424,0.00688073394495413
"065150702","BUENOS AIRES",323,13,149,147,1,297,0.0402476780185759
"060351203","BUENOS AIRES",166,166,0,0,0,0,1
"060562609","BUENOS AIRES",196,0,161,35,0,196,0
"060700104","BUENOS AIRES",145,143,0,2,0,2,0.986206896551724
"065151105","BUENOS AIRES",229,2,191,32,0,223,0.00873362445414847
"065151107","BUENOS AIRES",248,1,143,101,1,245,0.00403225806451613
"060911607","BUENOS AIRES",174,173,1,0,0,1,0.994252873563218
"060912403","BUENOS AIRES",273,1,122,141,3,266,0.00366300366300366
"065151206","BUENOS AIRES",287,2,202,76,0,278,0.00696864111498258
"065151209","BUENOS AIRES",420,1,321,89,0,410,0.00238095238095238
"061260705","BUENOS AIRES",340,2,80,250,1,331,0.00588235294117647
"061260706","BUENOS AIRES",233,4,71,153,0,224,0.0171673819742489
"061470108","BUENOS AIRES",285,269,8,8,0,16,0.943859649122807
"060280312","BUENOS AIRES",266,5,113,138,1,252,0.018796992481203
"065151212","BUENOS AIRES",344,3,272,66,0,338,0.00872093023255814
"060070402","BUENOS AIRES",56,0,25,31,0,56,0
"060070502","BUENOS AIRES",0,0,0,0,0,0,NA
"060070802","BUENOS AIRES",110,1,56,47,5,108,0.00909090909090909
"060070811","BUENOS AIRES",222,185,16,20,0,36,0.833333333333333
"060070812","BUENOS AIRES",187,60,69,53,4,126,0.320855614973262
"060141010","BUENOS AIRES",354,268,65,19,0,84,0.757062146892655
"061891006","BUENOS AIRES",308,299,4,4,0,8,0.970779220779221
"060211002","BUENOS AIRES",49,0,3,45,1,49,0
"060280104","BUENOS AIRES",295,84,168,34,9,211,0.284745762711864
"060280106","BUENOS AIRES",266,6,157,95,1,253,0.0225563909774436
"060280204","BUENOS AIRES",429,4,140,258,2,400,0.00932400932400932
"060280612","BUENOS AIRES",256,0,112,125,4,241,0
"060280701","BUENOS AIRES",608,5,224,336,4,564,0.00822368421052632
"060280708","BUENOS AIRES",307,1,202,90,3,295,0.00325732899022801
"060280813","BUENOS AIRES",377,6,268,102,1,371,0.0159151193633952
"060281014","BUENOS AIRES",347,135,110,96,0,206,0.389048991354467
"060281016","BUENOS AIRES",309,281,15,11,0,26,0.909385113268608
"060281109","BUENOS AIRES",472,280,153,39,0,192,0.593220338983051
"060281205","BUENOS AIRES",314,292,18,4,0,22,0.929936305732484
"060281206","BUENOS AIRES",190,190,0,0,0,0,1
"060281405","BUENOS AIRES",372,0,265,100,1,366,0
"060281406","BUENOS AIRES",465,2,316,141,0,457,0.0043010752688172
"060281501","BUENOS AIRES",250,4,123,111,2,236,0.016
"060281502","BUENOS AIRES",256,6,189,55,0,244,0.0234375
"060281509","BUENOS AIRES",546,4,458,80,0,538,0.00732600732600733
"063570806","BUENOS AIRES",266,256,9,1,0,10,0.962406015037594
"060281510","BUENOS AIRES",353,3,181,160,0,341,0.0084985835694051
"060281607","BUENOS AIRES",234,234,0,0,0,0,1
"060281702","BUENOS AIRES",341,316,0,1,0,1,0.926686217008798
"060281709","BUENOS AIRES",288,288,0,0,0,0,1
"060281903","BUENOS AIRES",377,375,0,1,1,2,0.994694960212202
"060281904","BUENOS AIRES",378,223,62,81,0,143,0.58994708994709
"060281905","BUENOS AIRES",170,1,40,119,2,161,0.00588235294117647
"060282005","BUENOS AIRES",418,0,163,231,5,399,0
"060282006","BUENOS AIRES",382,90,144,142,2,288,0.235602094240838
"060282103","BUENOS AIRES",408,6,233,126,1,360,0.0147058823529412
"060282110","BUENOS AIRES",247,0,143,98,0,241,0
"060282112","BUENOS AIRES",292,0,195,90,1,286,0
"063573706","BUENOS AIRES",170,170,0,0,0,0,1
"060282217","BUENOS AIRES",208,2,155,45,2,202,0.00961538461538462
"060282307","BUENOS AIRES",333,14,206,112,0,318,0.042042042042042
"060282404","BUENOS AIRES",397,393,2,2,0,4,0.98992443324937
"060282503","BUENOS AIRES",189,189,0,0,0,0,1
"060282705","BUENOS AIRES",248,6,176,65,0,241,0.0241935483870968
"062940807","BUENOS AIRES",218,177,17,24,0,41,0.811926605504587
"060282708","BUENOS AIRES",443,1,306,127,1,434,0.00225733634311512
"060282711","BUENOS AIRES",238,4,196,38,0,234,0.0168067226890756
"060282802","BUENOS AIRES",266,31,153,82,0,235,0.116541353383459
"060282902","BUENOS AIRES",229,1,181,44,1,226,0.00436681222707424
"060283001","BUENOS AIRES",263,6,168,83,0,251,0.0228136882129278
"060283015","BUENOS AIRES",295,1,152,134,3,289,0.00338983050847458
"062100108","BUENOS AIRES",224,222,2,0,0,2,0.991071428571429
"060283102","BUENOS AIRES",254,7,160,85,1,246,0.0275590551181102
"060283108","BUENOS AIRES",215,0,142,70,0,212,0
"060283110","BUENOS AIRES",420,1,306,105,0,411,0.00238095238095238
"060283111","BUENOS AIRES",359,3,300,55,0,355,0.00835654596100279
"060283313","BUENOS AIRES",396,0,256,129,0,385,0
"060283403","BUENOS AIRES",416,2,310,100,0,410,0.00480769230769231
"060283409","BUENOS AIRES",392,0,333,59,0,392,0
"060283503","BUENOS AIRES",348,1,203,133,2,338,0.0028735632183908
"060351212","BUENOS AIRES",218,218,0,0,0,0,1
"060283614","BUENOS AIRES",422,0,202,204,3,409,0
"060283704","BUENOS AIRES",317,2,234,76,0,310,0.00630914826498423
"060283707","BUENOS AIRES",245,0,159,77,0,236,0
"060283812","BUENOS AIRES",304,0,205,93,2,300,0
"060283913","BUENOS AIRES",495,1,238,241,1,480,0.00202020202020202
"060350102","BUENOS AIRES",418,362,22,25,0,47,0.866028708133971
"060350203","BUENOS AIRES",299,16,64,189,12,265,0.0535117056856187
"060350307","BUENOS AIRES",317,315,0,0,0,0,0.993690851735016
"060350315","BUENOS AIRES",330,306,13,11,0,24,0.927272727272727
"060350410","BUENOS AIRES",248,180,42,26,0,68,0.725806451612903
"060350415","BUENOS AIRES",253,250,1,2,0,3,0.988142292490119
"060350501","BUENOS AIRES",193,16,88,86,1,175,0.0829015544041451
"020131503","CABA",349,349,0,0,0,0,1
"060350612","BUENOS AIRES",299,260,25,14,0,39,0.869565217391304
"060350703","BUENOS AIRES",264,222,13,26,0,39,0.840909090909091
"060350706","BUENOS AIRES",363,257,63,39,0,102,0.707988980716253
"060351103","BUENOS AIRES",157,156,1,0,0,1,0.993630573248408
"060351104","BUENOS AIRES",320,311,6,1,0,7,0.971875
"060351108","BUENOS AIRES",365,361,0,0,0,0,0.989041095890411
"060351205","BUENOS AIRES",261,235,12,12,0,24,0.900383141762452
"063573708","BUENOS AIRES",127,125,0,0,0,0,0.984251968503937
"060351308","BUENOS AIRES",245,227,7,11,0,18,0.926530612244898
"060351502","BUENOS AIRES",312,312,0,0,0,0,1
"060351503","BUENOS AIRES",340,339,1,0,0,1,0.997058823529412
"060351506","BUENOS AIRES",480,390,47,39,1,87,0.8125
"060351512","BUENOS AIRES",239,199,22,16,2,40,0.832635983263598
"060351603","BUENOS AIRES",288,49,143,96,0,239,0.170138888888889
"060351611","BUENOS AIRES",245,12,139,93,0,232,0.0489795918367347
"020131310","CABA",358,358,0,0,0,0,1
"060351705","BUENOS AIRES",352,72,189,88,2,279,0.204545454545455
"060351804","BUENOS AIRES",268,43,100,125,0,225,0.16044776119403
"060351805","BUENOS AIRES",277,19,114,144,0,258,0.0685920577617329
"060351806","BUENOS AIRES",321,54,135,132,0,267,0.168224299065421
"060351903","BUENOS AIRES",325,203,67,55,0,122,0.624615384615385
"060352004","BUENOS AIRES",242,179,21,19,0,40,0.739669421487603
"060352612","BUENOS AIRES",228,16,81,128,1,210,0.0701754385964912
"060352108","BUENOS AIRES",280,275,3,2,0,5,0.982142857142857
"060352203","BUENOS AIRES",200,200,0,0,0,0,1
"060352211","BUENOS AIRES",186,184,1,1,0,2,0.989247311827957
"060352306","BUENOS AIRES",363,267,30,63,0,93,0.735537190082645
"060352405","BUENOS AIRES",248,217,17,14,0,31,0.875
"060352409","BUENOS AIRES",352,43,139,164,1,304,0.122159090909091
"060352604","BUENOS AIRES",90,86,3,1,0,4,0.955555555555556
"060352703","BUENOS AIRES",285,85,81,102,8,191,0.298245614035088
"060352705","BUENOS AIRES",246,86,54,100,0,154,0.349593495934959
"060352710","BUENOS AIRES",282,59,110,111,0,221,0.209219858156028
"060353002","BUENOS AIRES",311,276,12,17,0,29,0.887459807073955
"060353004","BUENOS AIRES",359,263,51,38,0,89,0.732590529247911
"060353105","BUENOS AIRES",373,214,72,84,1,157,0.57372654155496
"060353106","BUENOS AIRES",207,118,44,43,0,87,0.570048309178744
"060281105","BUENOS AIRES",238,220,6,4,0,10,0.92436974789916
"060353206","BUENOS AIRES",310,273,24,7,0,31,0.880645161290323
"060353207","BUENOS AIRES",343,294,20,29,0,49,0.857142857142857
"060353303","BUENOS AIRES",405,392,12,0,1,13,0.967901234567901
"060353305","BUENOS AIRES",183,180,2,0,0,2,0.983606557377049
"060353503","BUENOS AIRES",273,261,8,3,0,11,0.956043956043956
"060421901","BUENOS AIRES",329,296,11,22,0,33,0.899696048632219
"060490206","BUENOS AIRES",301,262,14,24,1,39,0.870431893687708
"060490209","BUENOS AIRES",318,203,47,66,1,114,0.638364779874214
"060490403","BUENOS AIRES",92,0,51,41,0,92,0
"060490405","BUENOS AIRES",142,95,42,5,0,47,0.669014084507042
"060490505","BUENOS AIRES",329,269,31,29,0,60,0.817629179331307
"060490613","BUENOS AIRES",423,367,16,40,0,56,0.867612293144208
"060491004","BUENOS AIRES",111,58,29,22,0,51,0.522522522522523
"060491005","BUENOS AIRES",97,50,28,19,0,47,0.515463917525773
"060491008","BUENOS AIRES",177,53,46,78,0,124,0.299435028248588
"062520106","BUENOS AIRES",493,4,256,219,1,476,0.00811359026369168
"060492505","BUENOS AIRES",240,109,26,95,0,121,0.454166666666667
"060560210","BUENOS AIRES",294,285,5,4,0,9,0.969387755102041
"060560304","BUENOS AIRES",273,266,6,1,0,7,0.974358974358974
"060560407","BUENOS AIRES",315,312,2,1,0,3,0.990476190476191
"060560508","BUENOS AIRES",216,215,1,0,0,1,0.99537037037037
"060560701","BUENOS AIRES",394,392,1,0,0,1,0.99492385786802
"060560806","BUENOS AIRES",252,233,7,9,0,16,0.924603174603175
"060561102","BUENOS AIRES",146,144,2,0,0,2,0.986301369863014
"060561109","BUENOS AIRES",187,187,0,0,0,0,1
"060561111","BUENOS AIRES",236,235,1,0,0,1,0.995762711864407
"060561112","BUENOS AIRES",279,276,2,1,0,3,0.989247311827957
"060561402","BUENOS AIRES",221,219,1,1,0,2,0.990950226244344
"060561405","BUENOS AIRES",217,215,2,0,0,2,0.990783410138249
"060561406","BUENOS AIRES",409,402,6,1,0,7,0.982885085574572
"062521419","BUENOS AIRES",412,0,302,105,0,407,0
"060563003","BUENOS AIRES",207,3,159,44,1,204,0.0144927536231884
"060561602","BUENOS AIRES",202,200,2,0,0,2,0.99009900990099
"060561607","BUENOS AIRES",190,190,0,0,0,0,1
"060561608","BUENOS AIRES",315,314,1,0,0,1,0.996825396825397
"060561614","BUENOS AIRES",251,249,1,0,0,1,0.99203187250996
"060561704","BUENOS AIRES",214,210,3,0,0,3,0.981308411214953
"060561805","BUENOS AIRES",311,308,1,1,0,2,0.990353697749196
"060561905","BUENOS AIRES",383,264,11,104,3,118,0.689295039164491
"060561908","BUENOS AIRES",240,88,46,90,4,140,0.366666666666667
"063573804","BUENOS AIRES",111,109,2,0,0,2,0.981981981981982
"060561912","BUENOS AIRES",397,374,4,16,0,20,0.942065491183879
"060562002","BUENOS AIRES",387,387,0,0,0,0,1
"060562103","BUENOS AIRES",209,204,1,2,0,3,0.976076555023923
"060562105","BUENOS AIRES",351,349,2,0,0,2,0.994301994301994
"060562107","BUENOS AIRES",352,233,47,58,3,108,0.661931818181818
"064410803","BUENOS AIRES",119,119,0,0,0,0,1
"060910802","BUENOS AIRES",213,204,2,7,0,9,0.957746478873239
"060562111","BUENOS AIRES",341,268,20,51,0,71,0.785923753665689
"060562214","BUENOS AIRES",309,298,5,3,1,9,0.964401294498382
"060562309","BUENOS AIRES",378,311,26,35,2,63,0.822751322751323
"060562310","BUENOS AIRES",284,273,8,3,0,11,0.961267605633803
"060562412","BUENOS AIRES",413,368,19,22,2,43,0.891041162227603
"060562416","BUENOS AIRES",356,8,93,242,0,335,0.0224719101123595
"060562604","BUENOS AIRES",128,33,68,27,0,95,0.2578125
"065151314","BUENOS AIRES",263,1,144,107,0,251,0.00380228136882129
"060562617","BUENOS AIRES",468,106,92,218,7,317,0.226495726495726
"060910707","BUENOS AIRES",424,280,57,82,1,140,0.660377358490566
"060562501","BUENOS AIRES",389,57,293,36,3,332,0.146529562982005
"060562502","BUENOS AIRES",487,352,90,37,0,127,0.722792607802875
"060562616","BUENOS AIRES",256,194,38,19,0,57,0.7578125
"060562512","BUENOS AIRES",348,333,7,8,0,15,0.956896551724138
"060562603","BUENOS AIRES",313,187,56,64,1,121,0.597444089456869
"060630208","BUENOS AIRES",330,315,7,7,0,14,0.954545454545455
"062700102","BUENOS AIRES",185,185,0,0,0,0,1
"060631301","BUENOS AIRES",282,281,1,0,0,1,0.99645390070922
"060700202","BUENOS AIRES",314,92,93,112,4,209,0.292993630573248
"060700204","BUENOS AIRES",355,334,3,17,0,20,0.940845070422535
"060700205","BUENOS AIRES",357,336,2,18,0,20,0.941176470588235
"060700208","BUENOS AIRES",286,9,89,182,0,271,0.0314685314685315
"060700215","BUENOS AIRES",296,193,43,34,0,77,0.652027027027027
"060701001","BUENOS AIRES",58,0,27,31,0,58,0
"062740805","BUENOS AIRES",243,240,3,0,0,3,0.987654320987654
"060771401","BUENOS AIRES",354,76,53,206,0,259,0.214689265536723
"060840301","BUENOS AIRES",57,2,23,32,0,55,0.0350877192982456
"060840710","BUENOS AIRES",285,241,28,15,0,43,0.845614035087719
"060910305","BUENOS AIRES",236,225,4,7,0,11,0.953389830508475
"064900704","BUENOS AIRES",260,24,146,84,2,232,0.0923076923076923
"060841206","BUENOS AIRES",413,263,51,77,2,130,0.63680387409201
"060841207","BUENOS AIRES",200,176,20,4,0,24,0.88
"060910307","BUENOS AIRES",403,365,16,17,0,33,0.905707196029777
"060910104","BUENOS AIRES",255,250,4,0,0,4,0.980392156862745
"060910109","BUENOS AIRES",449,373,15,58,0,73,0.830734966592428
"060910202","BUENOS AIRES",297,258,0,7,0,7,0.868686868686869
"060910204","BUENOS AIRES",327,326,0,0,0,0,0.996941896024465
"060910310","BUENOS AIRES",402,398,4,0,0,4,0.990049751243781
"060910410","BUENOS AIRES",520,341,28,141,0,169,0.655769230769231
"060910412","BUENOS AIRES",398,294,37,57,1,95,0.738693467336683
"062741711","BUENOS AIRES",238,24,93,103,3,199,0.100840336134454
"060910604","BUENOS AIRES",267,191,34,36,0,70,0.715355805243446
"060910608","BUENOS AIRES",473,2,108,334,3,445,0.00422832980972516
"060910704","BUENOS AIRES",305,244,15,40,0,55,0.8
"063576602","BUENOS AIRES",289,285,3,1,0,4,0.986159169550173
"060911004","BUENOS AIRES",242,241,0,1,0,1,0.995867768595041
"060911005","BUENOS AIRES",453,435,8,7,0,15,0.960264900662252
"060911108","BUENOS AIRES",426,405,14,4,0,18,0.950704225352113
"060911109","BUENOS AIRES",428,411,9,6,0,15,0.960280373831776
"060911205","BUENOS AIRES",335,270,17,42,0,59,0.805970149253731
"060911301","BUENOS AIRES",363,298,25,11,1,37,0.820936639118457
"060911306","BUENOS AIRES",362,339,7,11,0,18,0.93646408839779
"060911309","BUENOS AIRES",469,408,15,42,0,57,0.869936034115139
"062742118","BUENOS AIRES",355,9,93,245,2,340,0.0253521126760563
"060911405","BUENOS AIRES",364,161,24,172,1,197,0.442307692307692
"060911410","BUENOS AIRES",522,449,12,19,0,31,0.860153256704981
"060911504","BUENOS AIRES",446,438,4,4,0,8,0.982062780269058
"060911510","BUENOS AIRES",285,273,2,2,0,4,0.957894736842105
"060911602","BUENOS AIRES",436,432,4,0,0,4,0.990825688073395
"060911614","BUENOS AIRES",373,329,19,19,0,38,0.882037533512064
"060911703","BUENOS AIRES",470,404,17,43,0,60,0.859574468085106
"060911802","BUENOS AIRES",244,10,161,68,2,231,0.040983606557377
"060911804","BUENOS AIRES",414,377,14,19,0,33,0.910628019323672
"060911807","BUENOS AIRES",417,98,94,213,1,308,0.235011990407674
"060911907","BUENOS AIRES",236,229,4,2,0,6,0.970338983050847
"060911911","BUENOS AIRES",280,251,7,19,0,26,0.896428571428571
"060912010","BUENOS AIRES",317,8,99,199,0,298,0.0252365930599369
"060912011","BUENOS AIRES",373,129,177,63,1,241,0.345844504021448
"060912116","BUENOS AIRES",314,4,128,162,2,292,0.0127388535031847
"060912202","BUENOS AIRES",317,271,30,14,0,44,0.854889589905363
"060912210","BUENOS AIRES",493,41,185,234,4,423,0.0831643002028398
"060980603","BUENOS AIRES",491,55,351,82,0,433,0.112016293279022
"020020504","CABA",226,226,0,0,0,0,1
"060912301","BUENOS AIRES",266,6,92,166,0,258,0.0225563909774436
"060912302","BUENOS AIRES",301,7,130,159,1,290,0.0232558139534884
"060912304","BUENOS AIRES",400,9,256,126,0,382,0.0225
"060912315","BUENOS AIRES",232,0,62,133,4,199,0
"060912401","BUENOS AIRES",204,0,78,115,1,194,0
"060912402","BUENOS AIRES",223,4,125,87,0,212,0.0179372197309417
"060912408","BUENOS AIRES",136,5,69,59,1,129,0.0367647058823529
"062801006","BUENOS AIRES",30,30,0,0,0,0,1
"060980212","BUENOS AIRES",449,20,229,181,0,410,0.044543429844098
"062801205","BUENOS AIRES",438,156,108,169,1,278,0.356164383561644
"060980306","BUENOS AIRES",364,57,204,93,1,298,0.156593406593407
"060980607","BUENOS AIRES",300,26,213,60,0,273,0.0866666666666667
"060980503","BUENOS AIRES",311,116,106,83,0,189,0.372990353697749
"060980703","BUENOS AIRES",165,136,21,8,0,29,0.824242424242424
"060980811","BUENOS AIRES",260,187,53,18,0,71,0.719230769230769
"061050205","BUENOS AIRES",304,298,5,0,0,5,0.980263157894737
"062940501","BUENOS AIRES",27,0,3,21,1,25,0
"061120105","BUENOS AIRES",229,220,3,0,0,3,0.960698689956332
"065151407","BUENOS AIRES",235,1,137,81,0,218,0.00425531914893617
"061120110","BUENOS AIRES",492,131,110,248,0,358,0.266260162601626
"061120204","BUENOS AIRES",178,58,48,71,0,119,0.325842696629214
"061120210","BUENOS AIRES",297,250,14,32,0,46,0.841750841750842
"061120703","BUENOS AIRES",78,1,15,60,2,77,0.0128205128205128
"061121002","BUENOS AIRES",162,65,70,27,0,97,0.401234567901235
"062310605","BUENOS AIRES",7,0,3,4,0,7,0
"061121104","BUENOS AIRES",53,7,4,40,1,45,0.132075471698113
"061121407","BUENOS AIRES",274,273,1,0,0,1,0.996350364963504
"061190303","BUENOS AIRES",368,349,16,2,0,18,0.948369565217391
"061190304","BUENOS AIRES",447,190,125,129,0,254,0.425055928411633
"061190707","BUENOS AIRES",238,49,133,53,0,186,0.205882352941176
"061191002","BUENOS AIRES",357,67,132,150,1,283,0.187675070028011
"061191005","BUENOS AIRES",294,108,148,37,1,186,0.36734693877551
"061191009","BUENOS AIRES",267,78,98,86,0,184,0.292134831460674
"061260111","BUENOS AIRES",253,252,1,0,0,1,0.99604743083004
"061260208","BUENOS AIRES",286,131,72,82,0,154,0.458041958041958
"061260307","BUENOS AIRES",319,314,5,0,0,5,0.984326018808777
"020020307","CABA",353,353,0,0,0,0,1
"061340911","BUENOS AIRES",272,0,149,114,3,266,0
"061260803","BUENOS AIRES",219,213,4,2,0,6,0.972602739726027
"061260807","BUENOS AIRES",269,263,6,0,0,6,0.977695167286245
"020131910","CABA",312,312,0,0,0,0,1
"061260911","BUENOS AIRES",343,342,0,0,0,0,0.997084548104956
"063571604","BUENOS AIRES",321,320,1,0,0,1,0.996884735202492
"061340103","BUENOS AIRES",224,4,118,95,4,217,0.0178571428571429
"061340304","BUENOS AIRES",385,357,18,8,0,26,0.927272727272727
"061340402","BUENOS AIRES",185,0,118,65,0,183,0
"063571305","BUENOS AIRES",255,249,2,4,0,6,0.976470588235294
"061340904","BUENOS AIRES",141,1,39,82,3,124,0.00709219858156028
"061341006","BUENOS AIRES",297,253,9,14,0,23,0.851851851851852
"061341007","BUENOS AIRES",193,98,49,40,2,91,0.507772020725389
"061341009","BUENOS AIRES",502,50,128,299,1,428,0.099601593625498
"061400303","BUENOS AIRES",284,248,17,13,0,30,0.873239436619718
"061400307","BUENOS AIRES",299,291,6,2,0,8,0.973244147157191
"061400315","BUENOS AIRES",350,343,3,4,0,7,0.98
"061400318","BUENOS AIRES",251,239,1,8,0,9,0.952191235059761
"063574102","BUENOS AIRES",267,266,1,0,0,1,0.99625468164794
"061471203","BUENOS AIRES",330,188,57,85,0,142,0.56969696969697
"061471209","BUENOS AIRES",305,262,7,35,1,43,0.859016393442623
"061540102","BUENOS AIRES",108,0,63,45,0,108,0
"061610107","BUENOS AIRES",164,127,13,24,0,37,0.774390243902439
"063572107","BUENOS AIRES",196,196,0,0,0,0,1
"061750404","BUENOS AIRES",187,121,22,44,0,66,0.647058823529412
"061750607","BUENOS AIRES",203,170,5,25,3,33,0.83743842364532
"061820102","BUENOS AIRES",375,262,50,61,0,111,0.698666666666667
"061820105","BUENOS AIRES",359,358,1,0,0,1,0.997214484679666
"061820107","BUENOS AIRES",305,267,25,13,0,38,0.875409836065574
"020142509","CABA",405,404,0,0,0,0,0.997530864197531
"061820112","BUENOS AIRES",324,316,1,7,0,8,0.975308641975309
"061820114","BUENOS AIRES",326,315,10,0,0,10,0.966257668711656
"061820201","BUENOS AIRES",218,218,0,0,0,0,1
"061820309","BUENOS AIRES",193,191,2,0,0,2,0.989637305699482
"061820604","BUENOS AIRES",342,163,127,52,0,179,0.476608187134503
"061820605","BUENOS AIRES",442,43,270,125,1,396,0.0972850678733032
"061820704","BUENOS AIRES",238,233,4,1,0,5,0.978991596638655
"061821011","BUENOS AIRES",288,277,11,0,0,11,0.961805555555556
"061821101","BUENOS AIRES",216,205,7,4,0,11,0.949074074074074
"061821102","BUENOS AIRES",322,314,7,0,0,7,0.975155279503106
"061821105","BUENOS AIRES",199,196,2,1,0,3,0.984924623115578
"061891001","BUENOS AIRES",209,183,8,17,0,25,0.875598086124402
"061891202","BUENOS AIRES",7,0,3,4,0,7,0
"063572205","BUENOS AIRES",180,180,0,0,0,0,1
"061891501","BUENOS AIRES",156,0,126,30,0,156,0
"061891503","BUENOS AIRES",63,0,46,17,0,63,0
"061891509","BUENOS AIRES",179,4,124,51,0,175,0.0223463687150838
"061891703","BUENOS AIRES",314,280,15,18,0,33,0.89171974522293
"061891706","BUENOS AIRES",225,219,4,1,0,5,0.973333333333333
"061960103","BUENOS AIRES",266,186,30,49,0,79,0.699248120300752
"061960114","BUENOS AIRES",202,194,4,4,0,8,0.96039603960396
"020071007","CABA",339,323,2,0,0,2,0.952802359882006
"061960116","BUENOS AIRES",339,310,12,16,0,28,0.914454277286136
"061960204","BUENOS AIRES",243,169,21,52,0,73,0.695473251028807
"061961102","BUENOS AIRES",19,13,1,5,0,6,0.684210526315789
"062030109","BUENOS AIRES",220,106,61,52,0,113,0.481818181818182
"062030204","BUENOS AIRES",181,3,67,107,2,176,0.0165745856353591
"062030213","BUENOS AIRES",127,43,40,41,0,81,0.338582677165354
"062030215","BUENOS AIRES",195,57,49,89,0,138,0.292307692307692
"062030402","BUENOS AIRES",5,0,1,4,0,5,0
"062030806","BUENOS AIRES",392,278,74,40,0,114,0.709183673469388
"062100105","BUENOS AIRES",178,176,2,0,0,2,0.98876404494382
"062100114","BUENOS AIRES",150,140,4,4,0,8,0.933333333333333
"062380206","BUENOS AIRES",274,241,24,9,0,33,0.87956204379562
"062100613","BUENOS AIRES",68,1,34,33,0,67,0.0147058823529412
"062101301","BUENOS AIRES",355,354,0,1,0,1,0.997183098591549
"064342102","BUENOS AIRES",252,46,141,65,0,206,0.182539682539683
"062101309","BUENOS AIRES",332,300,8,22,0,30,0.903614457831325
"062170416","BUENOS AIRES",255,232,7,12,1,20,0.909803921568627
"062170504","BUENOS AIRES",5,0,0,5,0,5,0
"062171212","BUENOS AIRES",299,144,102,52,1,155,0.481605351170569
"062171214","BUENOS AIRES",178,162,14,2,0,16,0.910112359550562
"062171205","BUENOS AIRES",325,131,63,118,2,183,0.403076923076923
"062171210","BUENOS AIRES",432,412,13,6,0,19,0.953703703703704
"062240110","BUENOS AIRES",294,245,18,8,0,26,0.833333333333333
"062240201","BUENOS AIRES",222,100,46,76,0,122,0.45045045045045
"062240202","BUENOS AIRES",248,210,27,11,0,38,0.846774193548387
"062240204","BUENOS AIRES",408,87,91,225,0,316,0.213235294117647
"062240214","BUENOS AIRES",238,208,9,20,0,29,0.873949579831933
"062240305","BUENOS AIRES",214,40,84,89,0,173,0.186915887850467
"062240306","BUENOS AIRES",237,1,116,120,0,236,0.00421940928270042
"062240401","BUENOS AIRES",248,3,90,147,1,238,0.0120967741935484
"062240403","BUENOS AIRES",383,275,84,23,0,107,0.718015665796345
"062240412","BUENOS AIRES",150,34,45,69,0,114,0.226666666666667
"062240416","BUENOS AIRES",168,37,41,87,1,129,0.220238095238095
"062240505","BUENOS AIRES",16,0,2,14,0,16,0
"063713503","BUENOS AIRES",255,18,158,76,0,234,0.0705882352941176
"062240915","BUENOS AIRES",176,1,57,115,0,172,0.00568181818181818
"062241901","BUENOS AIRES",48,0,34,14,0,48,0
"062242205","BUENOS AIRES",296,294,0,2,0,2,0.993243243243243
"062242208","BUENOS AIRES",278,262,7,8,0,15,0.942446043165468
"063572702","BUENOS AIRES",182,182,0,0,0,0,1
"062311203","BUENOS AIRES",223,202,13,7,0,20,0.905829596412556
"062311205","BUENOS AIRES",297,281,9,7,0,16,0.946127946127946
"062311211","BUENOS AIRES",356,201,53,100,0,153,0.564606741573034
"062380106","BUENOS AIRES",247,236,2,9,0,11,0.955465587044534
"062380108","BUENOS AIRES",236,148,53,34,0,87,0.627118644067797
"062380205","BUENOS AIRES",242,238,1,3,0,4,0.983471074380165
"062380208","BUENOS AIRES",336,102,92,141,0,233,0.303571428571429
"062380210","BUENOS AIRES",228,3,30,191,3,224,0.0131578947368421
"062380608","BUENOS AIRES",4,0,0,4,0,4,0
"062450111","BUENOS AIRES",301,278,20,3,0,23,0.92358803986711
"062450307","BUENOS AIRES",272,254,14,3,0,17,0.933823529411765
"062450206","BUENOS AIRES",494,388,68,30,1,99,0.785425101214575
"062450310","BUENOS AIRES",317,309,7,1,0,8,0.974763406940063
"062450401","BUENOS AIRES",210,6,101,87,10,198,0.0285714285714286
"062600806","BUENOS AIRES",320,1,184,123,0,307,0.003125
"062450403","BUENOS AIRES",256,15,152,78,3,233,0.05859375
"062520503","BUENOS AIRES",357,353,3,1,0,4,0.988795518207283
"062450502","BUENOS AIRES",206,116,50,33,6,89,0.563106796116505
"062520103","BUENOS AIRES",176,0,55,104,6,165,0
"064101311","BUENOS AIRES",304,0,241,57,1,299,0
"062520108","BUENOS AIRES",524,170,182,157,3,342,0.324427480916031
"020021607","CABA",359,359,0,0,0,0,1
"062520109","BUENOS AIRES",251,235,9,4,0,13,0.936254980079681
"062520201","BUENOS AIRES",104,2,94,8,0,102,0.0192307692307692
"062520202","BUENOS AIRES",141,136,5,0,0,5,0.964539007092199
"062521001","BUENOS AIRES",172,160,10,2,0,12,0.930232558139535
"063713108","BUENOS AIRES",304,76,182,45,0,227,0.25
"062520205","BUENOS AIRES",133,2,111,20,0,131,0.0150375939849624
"062520612","BUENOS AIRES",154,1,124,26,0,150,0.00649350649350649
"062520701","BUENOS AIRES",335,13,132,182,0,314,0.0388059701492537
"062520705","BUENOS AIRES",482,0,162,310,2,474,0
"063711015","BUENOS AIRES",339,338,1,0,0,1,0.997050147492625
"062520208","BUENOS AIRES",69,2,26,39,0,65,0.0289855072463768
"064120405","BUENOS AIRES",274,2,160,108,0,268,0.0072992700729927
"062520306","BUENOS AIRES",379,0,212,150,3,365,0
"062520402","BUENOS AIRES",410,4,166,231,0,397,0.00975609756097561
"065151507","BUENOS AIRES",409,1,261,131,1,393,0.00244498777506112
"062521009","BUENOS AIRES",317,2,253,60,2,315,0.00630914826498423
"062520611","BUENOS AIRES",112,46,39,24,0,63,0.410714285714286
"062520707","BUENOS AIRES",352,2,120,222,1,343,0.00568181818181818
"062520709","BUENOS AIRES",288,2,175,111,0,286,0.00694444444444444
"062600214","BUENOS AIRES",359,6,183,160,6,349,0.0167130919220056
"062520806","BUENOS AIRES",415,1,332,79,1,412,0.00240963855421687
"062520909","BUENOS AIRES",310,2,162,142,0,304,0.00645161290322581
"062520911","BUENOS AIRES",493,0,243,244,0,487,0
"062600505","BUENOS AIRES",372,3,213,143,3,359,0.00806451612903226
"062521109","BUENOS AIRES",166,1,122,42,0,164,0.00602409638554217
"062521201","BUENOS AIRES",350,2,162,179,1,342,0.00571428571428571
"062521308","BUENOS AIRES",251,4,153,76,0,229,0.0159362549800797
"062521407","BUENOS AIRES",310,2,113,185,0,298,0.00645161290322581
"062521508","BUENOS AIRES",419,0,167,233,0,400,0
"063576203","BUENOS AIRES",169,167,1,1,0,2,0.988165680473373
"062600101","BUENOS AIRES",446,14,108,306,2,416,0.031390134529148
"062600106","BUENOS AIRES",520,20,157,317,5,479,0.0384615384615385
"062600114","BUENOS AIRES",352,6,166,166,4,336,0.0170454545454545
"062600211","BUENOS AIRES",385,8,235,125,0,360,0.0207792207792208
"062600309","BUENOS AIRES",222,21,60,134,0,194,0.0945945945945946
"064131407","BUENOS AIRES",371,355,3,2,0,5,0.956873315363881
"062600409","BUENOS AIRES",311,147,88,74,0,162,0.472668810289389
"062600809","BUENOS AIRES",352,0,253,90,1,344,0
"062600908","BUENOS AIRES",438,4,253,174,1,428,0.0091324200913242
"062600909","BUENOS AIRES",249,63,142,41,0,183,0.253012048192771
"062600912","BUENOS AIRES",309,0,183,123,0,306,0
"063572901","BUENOS AIRES",149,149,0,0,0,0,1
"062601101","BUENOS AIRES",130,129,1,0,0,1,0.992307692307692
"062601104","BUENOS AIRES",336,326,8,2,0,10,0.970238095238095
"065151601","BUENOS AIRES",294,9,247,38,0,285,0.0306122448979592
"062601402","BUENOS AIRES",297,18,177,100,0,277,0.0606060606060606
"062601405","BUENOS AIRES",370,172,142,55,0,197,0.464864864864865
"062601411","BUENOS AIRES",345,3,255,83,0,338,0.00869565217391304
"062601501","BUENOS AIRES",443,10,208,207,2,417,0.0225733634311512
"062601503","BUENOS AIRES",200,5,118,76,0,194,0.025
"062601505","BUENOS AIRES",348,7,177,158,0,335,0.0201149425287356
"062601507","BUENOS AIRES",292,1,114,171,0,285,0.00342465753424658
"062601508","BUENOS AIRES",264,2,131,124,1,256,0.00757575757575758
"062601601","BUENOS AIRES",412,1,326,77,1,404,0.00242718446601942
"062601607","BUENOS AIRES",377,1,136,220,4,360,0.0026525198938992
"062660611","BUENOS AIRES",114,1,97,16,0,113,0.0087719298245614
"063573001","BUENOS AIRES",172,172,0,0,0,0,1
"062660301","BUENOS AIRES",304,109,82,107,0,189,0.358552631578947
"062740310","BUENOS AIRES",403,8,214,169,0,383,0.0198511166253102
"062660509","BUENOS AIRES",75,1,66,8,0,74,0.0133333333333333
"062740609","BUENOS AIRES",252,5,130,109,1,240,0.0198412698412698
"062660606","BUENOS AIRES",61,1,42,18,0,60,0.0163934426229508
"064202204","BUENOS AIRES",65,63,1,1,0,2,0.969230769230769
"062660711","BUENOS AIRES",159,102,39,16,1,56,0.641509433962264
"062700204","BUENOS AIRES",288,208,43,34,0,77,0.722222222222222
"062700303","BUENOS AIRES",435,36,211,175,1,387,0.0827586206896552
"062700310","BUENOS AIRES",383,1,222,152,3,377,0.00261096605744125
"062700408","BUENOS AIRES",180,156,19,4,0,23,0.866666666666667
"062700411","BUENOS AIRES",478,52,238,174,0,412,0.108786610878661
"062700510","BUENOS AIRES",418,4,283,120,3,406,0.00956937799043062
"064270909","BUENOS AIRES",180,17,17,141,0,158,0.0944444444444444
"062700512","BUENOS AIRES",235,73,89,64,1,154,0.31063829787234
"062740401","BUENOS AIRES",362,16,155,182,1,338,0.0441988950276243
"062700602","BUENOS AIRES",186,14,127,44,0,171,0.0752688172043011
"062700606","BUENOS AIRES",442,7,210,206,8,424,0.0158371040723982
"062700609","BUENOS AIRES",363,0,215,133,6,354,0
"062700718","BUENOS AIRES",522,0,213,288,3,504,0
"062700719","BUENOS AIRES",445,16,116,286,6,408,0.0359550561797753
"062700802","BUENOS AIRES",43,2,35,6,0,41,0.0465116279069767
"064271901","BUENOS AIRES",235,220,10,5,0,15,0.936170212765957
"062701006","BUENOS AIRES",385,5,203,160,1,364,0.012987012987013
"062740109","BUENOS AIRES",261,230,23,6,0,29,0.881226053639847
"062740115","BUENOS AIRES",530,483,24,14,0,38,0.911320754716981
"020030108","CABA",188,140,1,0,0,1,0.74468085106383
"062740414","BUENOS AIRES",300,10,41,233,7,281,0.0333333333333333
"062740506","BUENOS AIRES",225,9,79,122,1,202,0.04
"062740509","BUENOS AIRES",268,14,146,104,1,251,0.0522388059701493
"062740516","BUENOS AIRES",315,16,129,155,0,284,0.0507936507936508
"062740605","BUENOS AIRES",396,16,177,194,0,371,0.0404040404040404
"062740709","BUENOS AIRES",339,3,141,180,3,324,0.00884955752212389
"062740712","BUENOS AIRES",277,1,105,154,2,261,0.0036101083032491
"062740802","BUENOS AIRES",269,114,37,115,0,152,0.423791821561338
"062740818","BUENOS AIRES",300,4,134,146,10,290,0.0133333333333333
"062741809","BUENOS AIRES",306,182,9,102,1,112,0.594771241830065
"062740901","BUENOS AIRES",344,6,67,240,5,312,0.0174418604651163
"062740904","BUENOS AIRES",292,5,109,161,4,274,0.0171232876712329
"062740905","BUENOS AIRES",256,0,63,174,6,243,0
"062740922","BUENOS AIRES",282,3,149,112,2,263,0.0106382978723404
"062741002","BUENOS AIRES",302,17,53,207,2,262,0.0562913907284768
"062741112","BUENOS AIRES",301,2,96,185,1,282,0.00664451827242525
"062741114","BUENOS AIRES",299,2,111,177,1,289,0.00668896321070234
"062741201","BUENOS AIRES",455,430,11,13,1,25,0.945054945054945
"062741203","BUENOS AIRES",312,291,4,12,0,16,0.932692307692308
"062741204","BUENOS AIRES",186,183,0,2,0,2,0.983870967741935
"062741207","BUENOS AIRES",232,229,3,0,0,3,0.987068965517241
"062741212","BUENOS AIRES",398,87,88,208,0,296,0.218592964824121
"062741304","BUENOS AIRES",250,226,0,13,0,13,0.904
"062741310","BUENOS AIRES",242,7,128,104,1,233,0.0289256198347107
"062741312","BUENOS AIRES",387,370,10,1,0,11,0.956072351421189
"062741317","BUENOS AIRES",440,423,8,5,0,13,0.961363636363636
"062741404","BUENOS AIRES",298,293,2,2,0,4,0.983221476510067
"062741407","BUENOS AIRES",241,241,0,0,0,0,1
"062741517","BUENOS AIRES",366,66,95,175,0,270,0.180327868852459
"062741613","BUENOS AIRES",384,10,156,208,0,364,0.0260416666666667
"062741608","BUENOS AIRES",290,4,116,163,0,279,0.0137931034482759
"062741609","BUENOS AIRES",238,7,127,93,1,221,0.0294117647058824
"062741707","BUENOS AIRES",245,178,7,56,0,63,0.726530612244898
"064279213","BUENOS AIRES",347,3,244,92,1,337,0.00864553314121038
"062741710","BUENOS AIRES",331,7,127,187,0,314,0.0211480362537764
"062741803","BUENOS AIRES",280,0,111,145,2,258,0
"062741805","BUENOS AIRES",252,77,56,104,0,160,0.305555555555556
"064275201","BUENOS AIRES",453,329,28,86,0,114,0.726269315673289
"062742005","BUENOS AIRES",494,6,125,333,5,463,0.0121457489878543
"062742012","BUENOS AIRES",343,6,161,153,0,314,0.0174927113702624
"062742109","BUENOS AIRES",263,1,97,154,0,251,0.00380228136882129
"062742111","BUENOS AIRES",260,1,125,114,2,241,0.00384615384615385
"062742117","BUENOS AIRES",394,70,117,198,1,316,0.177664974619289
"062742206","BUENOS AIRES",315,7,119,172,3,294,0.0222222222222222
"062742211","BUENOS AIRES",402,1,78,280,5,363,0.00248756218905473
"062770109","BUENOS AIRES",213,141,22,47,3,72,0.661971830985915
"062770111","BUENOS AIRES",429,308,49,67,2,118,0.717948717948718
"063290304","BUENOS AIRES",247,119,73,54,0,127,0.481781376518219
"062800102","BUENOS AIRES",177,48,49,77,0,126,0.271186440677966
"062800109","BUENOS AIRES",129,3,43,79,0,122,0.0232558139534884
"062800308","BUENOS AIRES",48,48,0,0,0,0,1
"062800404","BUENOS AIRES",13,13,0,0,0,0,1
"062800603","BUENOS AIRES",33,0,14,18,0,32,0
"062800604","BUENOS AIRES",24,0,17,7,0,24,0
"062800617","BUENOS AIRES",26,2,17,6,0,23,0.0769230769230769
"064276705","BUENOS AIRES",312,5,109,175,8,292,0.016025641025641
"062801005","BUENOS AIRES",95,94,0,1,0,1,0.989473684210526
"063010507","BUENOS AIRES",187,1,88,96,0,184,0.0053475935828877
"020070909","CABA",298,274,0,0,0,0,0.919463087248322
"062800910","BUENOS AIRES",10,1,7,2,0,9,0.1
"064279306","BUENOS AIRES",543,42,303,165,1,469,0.0773480662983425
"063576702","BUENOS AIRES",242,234,3,4,0,7,0.966942148760331
"062800912","BUENOS AIRES",57,1,39,17,0,56,0.0175438596491228
"062801103","BUENOS AIRES",363,350,6,7,0,13,0.964187327823691
"062801210","BUENOS AIRES",193,93,43,50,2,95,0.481865284974093
"062870413","BUENOS AIRES",350,209,50,88,1,139,0.597142857142857
"063571602","BUENOS AIRES",264,259,3,0,0,3,0.981060606060606
"062940203","BUENOS AIRES",383,245,78,59,0,137,0.639686684073107
"062940407","BUENOS AIRES",9,0,7,2,0,9,0
"062940609","BUENOS AIRES",123,2,48,68,0,116,0.016260162601626
"064278715","BUENOS AIRES",230,3,135,88,0,223,0.0130434782608696
"062940610","BUENOS AIRES",133,0,47,84,0,131,0
"063570206","BUENOS AIRES",276,274,2,0,0,2,0.992753623188406
"020101807","CABA",365,364,0,0,0,0,0.997260273972603
"063010805","BUENOS AIRES",191,5,111,74,0,185,0.0261780104712042
"063574007","BUENOS AIRES",268,268,0,0,0,0,1
"063080603","BUENOS AIRES",31,0,11,20,0,31,0
"063150112","BUENOS AIRES",304,5,172,111,1,284,0.0164473684210526
"063150118","BUENOS AIRES",289,74,138,74,1,213,0.256055363321799
"063150301","BUENOS AIRES",261,1,128,120,3,251,0.00383141762452107
"063573107","BUENOS AIRES",302,302,0,0,0,0,1
"063220601","BUENOS AIRES",388,3,160,217,1,378,0.0077319587628866
"063220604","BUENOS AIRES",197,21,125,50,1,176,0.106598984771574
"063220617","BUENOS AIRES",255,1,155,96,3,254,0.00392156862745098
"063221002","BUENOS AIRES",25,0,0,25,0,25,0
"063290201","BUENOS AIRES",60,0,21,34,1,56,0
"063430701","BUENOS AIRES",101,40,31,29,1,61,0.396039603960396
"063430702","BUENOS AIRES",179,130,16,33,0,49,0.726256983240223
"063510601","BUENOS AIRES",157,93,19,44,0,63,0.592356687898089
"063510602","BUENOS AIRES",101,40,31,29,0,60,0.396039603960396
"063570201","BUENOS AIRES",287,263,15,6,1,22,0.916376306620209
"063570302","BUENOS AIRES",171,161,6,4,0,10,0.941520467836257
"063570311","BUENOS AIRES",355,348,6,1,0,7,0.980281690140845
"063570504","BUENOS AIRES",244,243,0,1,0,1,0.995901639344262
"063570601","BUENOS AIRES",307,294,6,6,0,12,0.957654723127036
"063570804","BUENOS AIRES",249,236,9,4,0,13,0.947791164658635
"063570812","BUENOS AIRES",356,352,1,3,0,4,0.98876404494382
"063571003","BUENOS AIRES",382,22,236,123,0,359,0.0575916230366492
"063571009","BUENOS AIRES",243,6,108,129,0,237,0.0246913580246914
"063573701","BUENOS AIRES",213,213,0,0,0,0,1
"063571014","BUENOS AIRES",266,239,13,12,0,25,0.898496240601504
"063571101","BUENOS AIRES",213,8,160,44,0,204,0.0375586854460094
"063571107","BUENOS AIRES",314,11,114,178,0,292,0.035031847133758
"063571109","BUENOS AIRES",417,368,34,11,3,48,0.882494004796163
"063571201","BUENOS AIRES",322,293,8,19,0,27,0.909937888198758
"063571208","BUENOS AIRES",375,301,23,44,0,67,0.802666666666667
"063571308","BUENOS AIRES",282,280,2,0,0,2,0.99290780141844
"063571404","BUENOS AIRES",326,323,3,0,0,3,0.99079754601227
"063571503","BUENOS AIRES",272,266,6,0,0,6,0.977941176470588
"063571509","BUENOS AIRES",294,293,0,0,0,0,0.996598639455782
"063571701","BUENOS AIRES",266,258,4,0,0,4,0.969924812030075
"063571703","BUENOS AIRES",183,180,1,0,0,1,0.983606557377049
"063571706","BUENOS AIRES",195,189,2,0,0,2,0.969230769230769
"063571805","BUENOS AIRES",321,321,0,0,0,0,1
"063571806","BUENOS AIRES",255,254,1,0,0,1,0.996078431372549
"063572004","BUENOS AIRES",151,151,0,0,0,0,1
"063572405","BUENOS AIRES",238,238,0,0,0,0,1
"063572602","BUENOS AIRES",323,323,0,0,0,0,1
"063574001","BUENOS AIRES",24,24,0,0,0,0,1
"063574005","BUENOS AIRES",143,143,0,0,0,0,1
"063574409","BUENOS AIRES",84,84,0,0,0,0,1
"063574507","BUENOS AIRES",283,280,1,0,0,1,0.989399293286219
"063574510","BUENOS AIRES",278,255,0,0,0,0,0.91726618705036
"063574511","BUENOS AIRES",126,126,0,0,0,0,1
"063574604","BUENOS AIRES",149,149,0,0,0,0,1
"063574607","BUENOS AIRES",197,197,0,0,0,0,1
"063574703","BUENOS AIRES",317,316,1,0,0,1,0.996845425867508
"063574907","BUENOS AIRES",291,291,0,0,0,0,1
"063575004","BUENOS AIRES",343,336,5,2,0,7,0.979591836734694
"063575106","BUENOS AIRES",296,269,3,19,0,22,0.908783783783784
"063575707","BUENOS AIRES",223,222,0,1,0,1,0.995515695067265
"063575307","BUENOS AIRES",385,368,8,9,0,17,0.955844155844156
"063575406","BUENOS AIRES",247,224,1,1,0,2,0.906882591093117
"063575407","BUENOS AIRES",241,240,0,0,0,0,0.995850622406639
"063575604","BUENOS AIRES",373,373,0,0,0,0,1
"063575607","BUENOS AIRES",346,344,0,2,0,2,0.994219653179191
"063576713","BUENOS AIRES",213,201,0,4,0,4,0.943661971830986
"063577003","BUENOS AIRES",447,427,11,7,0,18,0.955257270693512
"063575701","BUENOS AIRES",473,411,6,53,0,59,0.86892177589852
"063575905","BUENOS AIRES",286,284,2,0,0,2,0.993006993006993
"063575909","BUENOS AIRES",181,181,0,0,0,0,1
"063575910","BUENOS AIRES",192,191,1,0,0,1,0.994791666666667
"063575911","BUENOS AIRES",318,313,3,2,0,5,0.984276729559748
"063576003","BUENOS AIRES",292,292,0,0,0,0,1
"063576004","BUENOS AIRES",205,203,1,1,0,2,0.990243902439024
"063576008","BUENOS AIRES",240,233,7,0,0,7,0.970833333333333
"063576201","BUENOS AIRES",334,321,11,2,0,13,0.961077844311377
"063576401","BUENOS AIRES",352,347,1,3,0,4,0.985795454545455
"063576405","BUENOS AIRES",204,197,5,2,0,7,0.965686274509804
"063576411","BUENOS AIRES",118,102,1,5,0,6,0.864406779661017
"063576501","BUENOS AIRES",178,174,1,2,0,3,0.97752808988764
"063576507","BUENOS AIRES",252,248,3,1,0,4,0.984126984126984
"063576510","BUENOS AIRES",187,182,5,0,0,5,0.973262032085562
"063576513","BUENOS AIRES",70,62,8,0,0,8,0.885714285714286
"064900209","BUENOS AIRES",455,20,212,212,0,424,0.043956043956044
"063577009","BUENOS AIRES",232,227,5,0,0,5,0.978448275862069
"063577014","BUENOS AIRES",286,264,5,13,0,18,0.923076923076923
"063577207","BUENOS AIRES",341,317,10,13,1,24,0.929618768328446
"065151609","BUENOS AIRES",268,1,201,60,2,263,0.00373134328358209
"063710503","BUENOS AIRES",186,178,6,2,0,8,0.956989247311828
"063577712","BUENOS AIRES",58,0,40,17,1,58,0
"063577715","BUENOS AIRES",48,0,36,12,0,48,0
"063577804","BUENOS AIRES",289,41,136,107,0,243,0.141868512110727
"063577904","BUENOS AIRES",231,2,75,144,0,219,0.00865800865800866
"063577906","BUENOS AIRES",219,1,79,136,0,215,0.0045662100456621
"063577907","BUENOS AIRES",199,8,13,165,4,182,0.0402010050251256
"063578002","BUENOS AIRES",249,119,86,42,0,128,0.477911646586345
"063578003","BUENOS AIRES",291,62,143,80,3,226,0.213058419243986
"063578004","BUENOS AIRES",296,1,110,182,1,293,0.00337837837837838
"063578016","BUENOS AIRES",230,1,166,61,0,227,0.00434782608695652
"064416613","BUENOS AIRES",204,126,32,41,0,73,0.617647058823529
"063578110","BUENOS AIRES",176,1,118,56,1,175,0.00568181818181818
"063578212","BUENOS AIRES",153,4,124,25,0,149,0.0261437908496732
"063578213","BUENOS AIRES",123,0,63,57,0,120,0
"063710209","BUENOS AIRES",398,20,218,158,0,376,0.050251256281407
"063640305","BUENOS AIRES",187,0,76,108,1,185,0
"063640211","BUENOS AIRES",116,2,37,72,0,109,0.0172413793103448
"063640214","BUENOS AIRES",116,1,81,33,1,115,0.00862068965517241
"063640312","BUENOS AIRES",273,272,1,0,0,1,0.996336996336996
"063640401","BUENOS AIRES",375,2,234,128,3,365,0.00533333333333333
"063640409","BUENOS AIRES",240,0,84,135,3,222,0
"063640702","BUENOS AIRES",264,0,201,55,1,257,0
"063640707","BUENOS AIRES",251,216,18,16,0,34,0.860557768924303
"063640713","BUENOS AIRES",277,252,15,10,0,25,0.909747292418773
"063640808","BUENOS AIRES",199,1,113,82,2,197,0.0050251256281407
"063710803","BUENOS AIRES",319,304,6,0,0,6,0.952978056426332
"063640816","BUENOS AIRES",221,0,129,88,0,217,0
"063640819","BUENOS AIRES",267,2,119,137,3,259,0.00749063670411985
"063710103","BUENOS AIRES",405,18,194,156,20,370,0.0444444444444444
"063710205","BUENOS AIRES",524,33,159,314,2,475,0.0629770992366412
"063710303","BUENOS AIRES",176,13,82,81,0,163,0.0738636363636364
"063710307","BUENOS AIRES",336,213,84,37,2,123,0.633928571428571
"063710310","BUENOS AIRES",238,30,153,53,0,206,0.126050420168067
"063710509","BUENOS AIRES",394,381,11,2,0,13,0.967005076142132
"063710603","BUENOS AIRES",302,289,8,2,1,11,0.956953642384106
"063710609","BUENOS AIRES",372,114,36,205,0,241,0.306451612903226
"063710611","BUENOS AIRES",434,188,65,164,1,230,0.433179723502304
"063710702","BUENOS AIRES",461,396,52,12,1,65,0.859002169197397
"063710901","BUENOS AIRES",391,384,6,1,0,7,0.982097186700767
"063710805","BUENOS AIRES",303,294,4,3,0,7,0.97029702970297
"063710903","BUENOS AIRES",258,254,3,1,0,4,0.984496124031008
"063710907","BUENOS AIRES",308,301,4,2,0,6,0.977272727272727
"063711201","BUENOS AIRES",384,373,5,6,0,11,0.971354166666667
"063711205","BUENOS AIRES",227,227,0,0,0,0,1
"063711307","BUENOS AIRES",393,102,139,152,0,291,0.259541984732824
"063711309","BUENOS AIRES",429,265,109,53,0,162,0.617715617715618
"063711409","BUENOS AIRES",246,7,26,184,16,226,0.0284552845528455
"063711504","BUENOS AIRES",145,5,80,55,0,135,0.0344827586206897
"063711508","BUENOS AIRES",182,0,12,139,0,151,0
"063711801","BUENOS AIRES",399,20,265,114,0,379,0.050125313283208
"063711811","BUENOS AIRES",434,8,252,174,0,426,0.0184331797235023
"063711815","BUENOS AIRES",451,9,260,177,0,437,0.0199556541019956
"063711905","BUENOS AIRES",330,325,4,1,0,5,0.984848484848485
"063711908","BUENOS AIRES",339,335,4,0,0,4,0.988200589970501
"063712004","BUENOS AIRES",404,60,191,144,1,336,0.148514851485149
"063712007","BUENOS AIRES",405,326,58,21,0,79,0.804938271604938
"063712104","BUENOS AIRES",176,173,2,1,0,3,0.982954545454545
"063712106","BUENOS AIRES",119,118,0,1,0,1,0.991596638655462
"063712201","BUENOS AIRES",314,294,8,12,0,20,0.936305732484076
"063712207","BUENOS AIRES",335,325,4,4,0,8,0.970149253731343
"063712310","BUENOS AIRES",200,195,4,1,0,5,0.975
"063712403","BUENOS AIRES",411,396,8,4,0,12,0.963503649635037
"063712501","BUENOS AIRES",271,262,6,3,0,9,0.966789667896679
"063712502","BUENOS AIRES",296,290,4,2,0,6,0.97972972972973
"063712602","BUENOS AIRES",236,228,4,1,0,5,0.966101694915254
"063712705","BUENOS AIRES",306,293,5,6,1,12,0.957516339869281
"063712706","BUENOS AIRES",179,174,5,0,0,5,0.972067039106145
"063712803","BUENOS AIRES",32,30,0,2,0,2,0.9375
"063712804","BUENOS AIRES",104,42,38,24,0,62,0.403846153846154
"063712904","BUENOS AIRES",326,310,10,6,0,16,0.950920245398773
"063713003","BUENOS AIRES",348,12,208,118,0,326,0.0344827586206897
"063713007","BUENOS AIRES",222,4,141,69,0,210,0.018018018018018
"063713008","BUENOS AIRES",256,178,37,41,0,78,0.6953125
"063713201","BUENOS AIRES",66,59,7,0,0,7,0.893939393939394
"063713305","BUENOS AIRES",424,16,246,162,0,408,0.0377358490566038
"063713310","BUENOS AIRES",199,3,93,103,0,196,0.0150753768844221
"063713402","BUENOS AIRES",392,12,272,103,0,375,0.0306122448979592
"063713407","BUENOS AIRES",330,27,200,103,0,303,0.0818181818181818
"063713705","BUENOS AIRES",182,3,54,113,5,172,0.0164835164835165
"063850702","BUENOS AIRES",289,160,59,68,2,129,0.55363321799308
"063850703","BUENOS AIRES",204,62,71,67,0,138,0.303921568627451
"063850705","BUENOS AIRES",311,267,21,22,1,44,0.858520900321543
"063850716","BUENOS AIRES",215,210,2,2,0,4,0.976744186046512
"063920114","BUENOS AIRES",304,229,28,44,0,72,0.753289473684211
"063920401","BUENOS AIRES",124,1,54,67,2,123,0.00806451612903226
"063920708","BUENOS AIRES",150,109,24,13,0,37,0.726666666666667
"063920906","BUENOS AIRES",130,1,76,50,1,127,0.00769230769230769
"063920907","BUENOS AIRES",177,0,74,96,2,172,0
"064080804","BUENOS AIRES",205,4,174,27,0,201,0.0195121951219512
"063921201","BUENOS AIRES",284,17,88,132,5,225,0.0598591549295775
"064344408","BUENOS AIRES",224,22,71,131,0,202,0.0982142857142857
"063990109","BUENOS AIRES",182,119,25,37,0,62,0.653846153846154
"063990303","BUENOS AIRES",134,0,74,59,1,134,0
"064903310","BUENOS AIRES",378,6,114,246,0,360,0.0158730158730159
"064344409","BUENOS AIRES",207,20,81,105,0,186,0.0966183574879227
"064080113","BUENOS AIRES",411,1,343,65,0,408,0.0024330900243309
"064080211","BUENOS AIRES",332,1,252,79,0,331,0.00301204819277108
"064080304","BUENOS AIRES",307,29,198,76,0,274,0.0944625407166124
"064080402","BUENOS AIRES",626,1,354,237,2,593,0.00159744408945687
"064080506","BUENOS AIRES",240,2,166,61,0,227,0.00833333333333333
"064080509","BUENOS AIRES",304,0,202,99,0,301,0
"064080604","BUENOS AIRES",274,16,250,8,0,258,0.0583941605839416
"064080608","BUENOS AIRES",284,1,254,27,0,281,0.00352112676056338
"065151702","BUENOS AIRES",365,0,240,121,0,361,0
"064201104","BUENOS AIRES",67,65,1,1,0,2,0.970149253731343
"064080808","BUENOS AIRES",336,4,285,45,0,330,0.0119047619047619
"064273307","BUENOS AIRES",212,202,5,5,0,10,0.952830188679245
"064080906","BUENOS AIRES",363,9,311,42,0,353,0.0247933884297521
"064081102","BUENOS AIRES",331,18,237,76,0,313,0.054380664652568
"064970112","BUENOS AIRES",252,130,76,42,0,118,0.515873015873016
"064081208","BUENOS AIRES",474,5,374,90,1,465,0.0105485232067511
"064081301","BUENOS AIRES",452,0,387,62,0,449,0
"064081303","BUENOS AIRES",320,3,229,76,1,306,0.009375
"064081407","BUENOS AIRES",248,68,126,53,0,179,0.274193548387097
"064081409","BUENOS AIRES",262,40,145,75,0,220,0.152671755725191
"064081509","BUENOS AIRES",352,103,215,28,1,244,0.292613636363636
"064100102","BUENOS AIRES",381,0,273,88,1,362,0
"064100103","BUENOS AIRES",384,0,297,78,0,375,0
"064100104","BUENOS AIRES",447,2,373,66,1,440,0.00447427293064877
"064100111","BUENOS AIRES",817,49,549,195,4,748,0.0599755201958384
"020140902","CABA",303,302,1,0,0,1,0.996699669966997
"064100205","BUENOS AIRES",397,3,233,156,0,389,0.00755667506297229
"064270104","BUENOS AIRES",117,117,0,0,0,0,1
"064100409","BUENOS AIRES",476,14,352,99,0,451,0.0294117647058824
"064100410","BUENOS AIRES",246,2,211,31,1,243,0.00813008130081301
"064120712","BUENOS AIRES",359,0,249,105,0,354,0
"064971306","BUENOS AIRES",319,5,206,108,0,314,0.0156739811912226
"064100605","BUENOS AIRES",323,3,268,49,0,317,0.00928792569659443
"064100702","BUENOS AIRES",195,4,161,30,0,191,0.0205128205128205
"064100804","BUENOS AIRES",259,1,202,54,0,256,0.00386100386100386
"064100806","BUENOS AIRES",420,4,355,61,0,416,0.00952380952380952
"064100901","BUENOS AIRES",398,294,98,6,0,104,0.738693467336683
"064100907","BUENOS AIRES",306,91,193,20,2,215,0.297385620915033
"064101103","BUENOS AIRES",294,64,207,23,0,230,0.217687074829932
"064101307","BUENOS AIRES",495,3,408,82,0,490,0.00606060606060606
"064120910","BUENOS AIRES",379,3,139,227,2,368,0.0079155672823219
"064120207","BUENOS AIRES",331,3,226,100,0,326,0.00906344410876133
"064120208","BUENOS AIRES",385,2,289,91,0,380,0.00519480519480519
"064270105","BUENOS AIRES",138,138,0,0,0,0,1
"064120308","BUENOS AIRES",311,3,213,95,0,308,0.00964630225080386
"064120309","BUENOS AIRES",291,0,239,51,0,290,0
"064120510","BUENOS AIRES",399,0,260,98,2,360,0
"064120511","BUENOS AIRES",313,3,230,78,0,308,0.00958466453674121
"064120512","BUENOS AIRES",325,0,248,74,0,322,0
"064120606","BUENOS AIRES",410,5,343,59,2,404,0.0121951219512195
"064120607","BUENOS AIRES",395,0,260,132,0,392,0
"065150703","BUENOS AIRES",284,1,196,81,0,277,0.00352112676056338
"064120710","BUENOS AIRES",416,1,304,108,0,412,0.00240384615384615
"064120802","BUENOS AIRES",400,2,299,97,0,396,0.005
"064120810","BUENOS AIRES",303,2,164,135,0,299,0.0066006600660066
"064270107","BUENOS AIRES",446,439,4,2,1,7,0.984304932735426
"064120903","BUENOS AIRES",377,1,142,210,5,357,0.0026525198938992
"064411812","BUENOS AIRES",210,209,1,0,0,1,0.995238095238095
"065150909","BUENOS AIRES",419,4,277,129,1,407,0.00954653937947494
"064120912","BUENOS AIRES",226,0,70,145,3,218,0
"064121016","BUENOS AIRES",335,305,26,3,0,29,0.91044776119403
"064270108","BUENOS AIRES",280,280,0,0,0,0,1
"064121101","BUENOS AIRES",359,151,100,95,3,198,0.420612813370474
"064121104","BUENOS AIRES",238,1,115,116,1,232,0.00420168067226891
"064121108","BUENOS AIRES",274,4,143,114,0,257,0.0145985401459854
"064270312","BUENOS AIRES",406,400,5,1,0,6,0.985221674876847
"064121113","BUENOS AIRES",255,2,152,83,2,237,0.00784313725490196
"064121119","BUENOS AIRES",411,0,148,245,0,393,0
"064121311","BUENOS AIRES",314,0,174,125,1,300,0
"064121404","BUENOS AIRES",280,0,134,137,1,272,0
"064121407","BUENOS AIRES",395,283,74,38,0,112,0.716455696202532
"064121501","BUENOS AIRES",250,2,178,68,0,246,0.008
"064121505","BUENOS AIRES",254,0,181,70,0,251,0
"064130107","BUENOS AIRES",331,298,1,1,0,2,0.900302114803625
"064130109","BUENOS AIRES",285,278,5,1,0,6,0.975438596491228
"064130201","BUENOS AIRES",408,276,53,68,0,121,0.676470588235294
"064130310","BUENOS AIRES",292,252,10,23,1,34,0.863013698630137
"064130511","BUENOS AIRES",330,330,0,0,0,0,1
"064131305","BUENOS AIRES",158,62,24,69,1,94,0.392405063291139
"064341610","BUENOS AIRES",378,322,35,21,0,56,0.851851851851852
"064131502","BUENOS AIRES",27,0,0,27,0,27,0
"064132205","BUENOS AIRES",178,8,41,115,6,162,0.0449438202247191
"064131802","BUENOS AIRES",39,2,25,8,0,33,0.0512820512820513
"064132109","BUENOS AIRES",473,433,11,15,0,26,0.915433403805497
"064132110","BUENOS AIRES",392,374,7,3,0,10,0.954081632653061
"064200202","BUENOS AIRES",37,36,1,0,0,1,0.972972972972973
"064200109","BUENOS AIRES",134,70,44,17,2,63,0.522388059701492
"064200115","BUENOS AIRES",69,64,5,0,0,5,0.927536231884058
"064200211","BUENOS AIRES",63,61,2,0,0,2,0.968253968253968
"064200216","BUENOS AIRES",227,177,32,16,0,48,0.779735682819383
"064200304","BUENOS AIRES",104,14,66,24,0,90,0.134615384615385
"064200310","BUENOS AIRES",72,10,31,28,0,59,0.138888888888889
"064200406","BUENOS AIRES",102,75,25,1,0,26,0.735294117647059
"064200319","BUENOS AIRES",58,0,29,29,0,58,0
"064274105","BUENOS AIRES",386,355,7,15,0,22,0.919689119170985
"064200402","BUENOS AIRES",71,57,4,8,0,12,0.802816901408451
"064201112","BUENOS AIRES",98,19,44,32,0,76,0.193877551020408
"064200403","BUENOS AIRES",133,9,57,62,0,119,0.0676691729323308
"064200409","BUENOS AIRES",46,42,4,0,0,4,0.91304347826087
"064200507","BUENOS AIRES",174,148,20,6,0,26,0.850574712643678
"064200512","BUENOS AIRES",79,75,4,0,0,4,0.949367088607595
"064200601","BUENOS AIRES",79,77,2,0,0,2,0.974683544303797
"064200710","BUENOS AIRES",41,40,0,1,0,1,0.975609756097561
"064200711","BUENOS AIRES",41,39,2,0,0,2,0.951219512195122
"064200808","BUENOS AIRES",86,86,0,0,0,0,1
"064200906","BUENOS AIRES",60,37,20,3,0,23,0.616666666666667
"064200908","BUENOS AIRES",82,36,25,21,0,46,0.439024390243902
"064201004","BUENOS AIRES",72,31,23,18,0,41,0.430555555555556
"064201009","BUENOS AIRES",59,37,16,6,0,22,0.627118644067797
"064201010","BUENOS AIRES",96,50,33,13,0,46,0.520833333333333
"064201012","BUENOS AIRES",58,25,25,8,0,33,0.431034482758621
"065320305","BUENOS AIRES",307,56,34,195,5,234,0.182410423452769
"064201212","BUENOS AIRES",46,0,21,25,0,46,0
"064201302","BUENOS AIRES",44,36,6,1,0,7,0.818181818181818
"064201409","BUENOS AIRES",33,32,1,0,0,1,0.96969696969697
"064201509","BUENOS AIRES",100,91,7,1,1,9,0.91
"064201602","BUENOS AIRES",19,17,2,0,0,2,0.894736842105263
"064202010","BUENOS AIRES",70,70,0,0,0,0,1
"064201806","BUENOS AIRES",21,21,0,0,0,0,1
"064270102","BUENOS AIRES",207,207,0,0,0,0,1
"064201907","BUENOS AIRES",148,131,7,10,0,17,0.885135135135135
"064201911","BUENOS AIRES",107,88,14,5,0,19,0.822429906542056
"064202004","BUENOS AIRES",44,44,0,0,0,0,1
"064202006","BUENOS AIRES",51,49,2,0,0,2,0.96078431372549
"064202103","BUENOS AIRES",149,144,3,2,0,5,0.966442953020134
"064202107","BUENOS AIRES",226,199,21,5,0,26,0.880530973451327
"064202202","BUENOS AIRES",237,151,49,37,0,86,0.637130801687764
"064270112","BUENOS AIRES",281,276,4,1,0,5,0.98220640569395
"064270311","BUENOS AIRES",314,303,7,3,0,10,0.964968152866242
"064270405","BUENOS AIRES",356,353,2,1,0,3,0.991573033707865
"064270407","BUENOS AIRES",344,327,9,6,0,15,0.950581395348837
"064270501","BUENOS AIRES",518,495,17,4,0,21,0.955598455598456
"064273212","BUENOS AIRES",214,213,1,0,0,1,0.995327102803738
"064270505","BUENOS AIRES",459,455,1,2,0,3,0.991285403050109
"064270606","BUENOS AIRES",249,243,2,3,0,5,0.975903614457831
"064270610","BUENOS AIRES",239,230,4,2,0,6,0.96234309623431
"064270705","BUENOS AIRES",356,347,7,2,0,9,0.974719101123595
"064270901","BUENOS AIRES",437,339,9,80,0,89,0.775743707093821
"064270905","BUENOS AIRES",445,356,8,71,0,79,0.8
"064270908","BUENOS AIRES",339,288,10,37,0,47,0.849557522123894
"064271002","BUENOS AIRES",255,243,0,7,0,7,0.952941176470588
"064271106","BUENOS AIRES",423,387,8,1,0,9,0.914893617021277
"064271408","BUENOS AIRES",870,405,136,271,6,413,0.46551724137931
"064271409","BUENOS AIRES",393,284,40,51,7,98,0.72264631043257
"064271515","BUENOS AIRES",320,317,0,0,0,0,0.990625
"064271613","BUENOS AIRES",146,146,0,0,0,0,1
"020131204","CABA",352,352,0,0,0,0,1
"064271801","BUENOS AIRES",449,272,82,82,6,170,0.605790645879733
"064271802","BUENOS AIRES",475,310,44,107,0,151,0.652631578947368
"064271808","BUENOS AIRES",530,53,227,219,18,464,0.1
"064271904","BUENOS AIRES",268,260,6,2,0,8,0.970149253731343
"064271906","BUENOS AIRES",370,359,7,2,0,9,0.97027027027027
"020132310","CABA",243,243,0,0,0,0,1
"064272008","BUENOS AIRES",309,309,0,0,0,0,1
"064272106","BUENOS AIRES",366,257,20,79,0,99,0.702185792349727
"064272207","BUENOS AIRES",442,432,7,2,0,9,0.97737556561086
"064272208","BUENOS AIRES",309,296,10,1,0,11,0.957928802588997
"064272307","BUENOS AIRES",406,380,21,4,0,25,0.935960591133005
"064272310","BUENOS AIRES",540,523,6,8,0,14,0.968518518518519
"064272407","BUENOS AIRES",542,523,10,4,0,14,0.964944649446494
"064272409","BUENOS AIRES",378,363,10,1,1,12,0.96031746031746
"064272410","BUENOS AIRES",250,128,52,53,3,108,0.512
"064272502","BUENOS AIRES",285,281,3,0,0,3,0.985964912280702
"064272606","BUENOS AIRES",240,235,4,0,0,4,0.979166666666667
"064272706","BUENOS AIRES",374,366,4,3,0,7,0.978609625668449
"064272806","BUENOS AIRES",385,375,0,8,0,8,0.974025974025974
"064272908","BUENOS AIRES",420,388,18,14,0,32,0.923809523809524
"064273004","BUENOS AIRES",341,326,9,5,0,14,0.956011730205279
"064273009","BUENOS AIRES",202,173,17,11,0,28,0.856435643564356
"064273013","BUENOS AIRES",318,268,37,13,0,50,0.842767295597484
"064273107","BUENOS AIRES",283,251,22,10,0,32,0.886925795053004
"064273201","BUENOS AIRES",252,251,1,0,0,1,0.996031746031746
"064273211","BUENOS AIRES",265,262,0,3,0,3,0.988679245283019
"064273402","BUENOS AIRES",268,267,1,0,0,1,0.996268656716418
"064273410","BUENOS AIRES",237,237,0,0,0,0,1
"064273501","BUENOS AIRES",401,366,13,21,0,34,0.912718204488778
"064273511","BUENOS AIRES",417,403,9,4,0,13,0.966426858513189
"064273512","BUENOS AIRES",399,396,3,0,0,3,0.992481203007519
"064273606","BUENOS AIRES",203,82,74,40,1,115,0.403940886699507
"064273607","BUENOS AIRES",165,164,0,1,0,1,0.993939393939394
"064273804","BUENOS AIRES",235,121,20,73,1,94,0.514893617021277
"064273809","BUENOS AIRES",188,187,0,0,0,0,0.99468085106383
"064273903","BUENOS AIRES",257,219,21,9,0,30,0.852140077821012
"064273910","BUENOS AIRES",322,199,22,95,1,118,0.618012422360248
"064274005","BUENOS AIRES",376,364,7,1,0,8,0.968085106382979
"064274108","BUENOS AIRES",667,107,187,353,0,540,0.160419790104948
"064274211","BUENOS AIRES",297,282,6,6,0,12,0.94949494949495
"065393405","BUENOS AIRES",361,2,193,150,0,343,0.00554016620498615
"064274309","BUENOS AIRES",379,358,3,3,0,6,0.944591029023747
"064274310","BUENOS AIRES",313,309,2,2,0,4,0.987220447284345
"064274402","BUENOS AIRES",295,256,13,24,0,37,0.867796610169492
"064274405","BUENOS AIRES",214,195,8,11,0,19,0.911214953271028
"064274406","BUENOS AIRES",266,240,19,6,0,25,0.902255639097744
"064274408","BUENOS AIRES",248,226,11,11,0,22,0.911290322580645
"064274609","BUENOS AIRES",1228,503,377,315,4,696,0.409609120521173
"064274712","BUENOS AIRES",511,307,104,87,2,193,0.600782778864971
"064274908","BUENOS AIRES",375,34,62,253,1,316,0.0906666666666667
"064274808","BUENOS AIRES",527,487,12,9,0,21,0.924098671726755
"064274810","BUENOS AIRES",475,216,152,88,2,242,0.454736842105263
"064274814","BUENOS AIRES",487,459,9,2,0,11,0.942505133470226
"064341704","BUENOS AIRES",297,248,23,26,0,49,0.835016835016835
"064274905","BUENOS AIRES",378,349,5,13,1,19,0.923280423280423
"064274912","BUENOS AIRES",262,141,26,73,5,104,0.538167938931298
"064275007","BUENOS AIRES",405,370,20,15,0,35,0.91358024691358
"064275008","BUENOS AIRES",301,262,20,12,0,32,0.870431893687708
"064275112","BUENOS AIRES",383,344,17,20,0,37,0.898172323759791
"064275203","BUENOS AIRES",337,247,41,43,0,84,0.732937685459941
"064275204","BUENOS AIRES",419,269,78,68,0,146,0.64200477326969
"064275308","BUENOS AIRES",452,394,22,22,5,49,0.871681415929204
"064275309","BUENOS AIRES",211,208,2,1,0,3,0.985781990521327
"064275406","BUENOS AIRES",272,258,4,4,0,8,0.948529411764706
"064275507","BUENOS AIRES",268,252,8,7,0,15,0.940298507462687
"064275602","BUENOS AIRES",512,86,305,114,1,420,0.16796875
"064275608","BUENOS AIRES",381,361,11,8,0,19,0.94750656167979
"020050804","CABA",454,449,3,0,0,3,0.988986784140969
"064275701","BUENOS AIRES",388,17,235,117,0,352,0.0438144329896907
"065600408","BUENOS AIRES",284,0,160,119,0,279,0
"064275907","BUENOS AIRES",243,15,143,84,0,227,0.0617283950617284
"064275908","BUENOS AIRES",336,8,195,127,0,322,0.0238095238095238
"064275910","BUENOS AIRES",362,10,218,125,0,343,0.0276243093922652
"064276002","BUENOS AIRES",391,26,278,74,0,352,0.0664961636828645
"064276003","BUENOS AIRES",315,11,195,103,0,298,0.0349206349206349
"020022508","CABA",523,523,0,0,0,0,1
"064276011","BUENOS AIRES",437,30,292,110,0,402,0.068649885583524
"064276107","BUENOS AIRES",413,47,220,110,2,332,0.113801452784504
"064276204","BUENOS AIRES",335,248,54,25,0,79,0.740298507462687
"064276207","BUENOS AIRES",335,42,223,63,1,287,0.125373134328358
"064276211","BUENOS AIRES",314,111,130,59,4,193,0.353503184713376
"064276214","BUENOS AIRES",240,10,126,101,0,227,0.0416666666666667
"064276402","BUENOS AIRES",254,13,111,120,2,233,0.0511811023622047
"064276407","BUENOS AIRES",445,9,182,227,1,410,0.0202247191011236
"064276415","BUENOS AIRES",372,42,149,174,0,323,0.112903225806452
"064277417","BUENOS AIRES",331,8,156,151,2,309,0.0241691842900302
"064276416","BUENOS AIRES",422,55,229,123,1,353,0.130331753554502
"064276516","BUENOS AIRES",496,13,295,137,3,435,0.0262096774193548
"064276517","BUENOS AIRES",534,13,282,226,1,509,0.0243445692883895
"064276706","BUENOS AIRES",416,19,199,184,1,384,0.0456730769230769
"064277010","BUENOS AIRES",293,5,218,57,1,276,0.0170648464163823
"064277017","BUENOS AIRES",262,5,163,90,0,253,0.0190839694656489
"064277106","BUENOS AIRES",273,9,165,94,0,259,0.032967032967033
"064277114","BUENOS AIRES",410,3,330,58,0,388,0.00731707317073171
"064277115","BUENOS AIRES",367,23,276,56,0,332,0.0626702997275204
"064277203","BUENOS AIRES",247,15,170,58,1,229,0.0607287449392713
"064277205","BUENOS AIRES",406,6,224,166,4,394,0.0147783251231527
"064277208","BUENOS AIRES",266,7,156,85,0,241,0.0263157894736842
"064277210","BUENOS AIRES",312,20,125,156,0,281,0.0641025641025641
"064277212","BUENOS AIRES",373,3,218,147,0,365,0.00804289544235925
"064277306","BUENOS AIRES",435,26,260,143,0,403,0.0597701149425287
"064277309","BUENOS AIRES",509,17,272,201,2,475,0.0333988212180747
"020050307","CABA",297,293,4,0,0,4,0.986531986531986
"064277501","BUENOS AIRES",520,26,198,267,2,467,0.05
"064277512","BUENOS AIRES",356,26,140,183,2,325,0.0730337078651685
"064277811","BUENOS AIRES",302,8,187,88,1,276,0.0264900662251656
"064277801","BUENOS AIRES",653,103,309,211,2,522,0.157733537519142
"064277806","BUENOS AIRES",316,8,159,141,0,300,0.0253164556962025
"064277808","BUENOS AIRES",267,0,134,125,1,260,0
"064277812","BUENOS AIRES",411,4,266,121,4,391,0.0097323600973236
"064277813","BUENOS AIRES",438,18,282,118,1,401,0.0410958904109589
"064277908","BUENOS AIRES",264,7,179,75,0,254,0.0265151515151515
"064278304","BUENOS AIRES",477,11,283,162,5,450,0.0230607966457023
"064278309","BUENOS AIRES",334,8,138,170,1,309,0.0239520958083832
"064278501","BUENOS AIRES",546,10,278,248,2,528,0.0183150183150183
"064278506","BUENOS AIRES",416,1,314,87,3,404,0.00240384615384615
"064278511","BUENOS AIRES",441,4,341,83,0,424,0.0090702947845805
"064278611","BUENOS AIRES",329,1,231,93,0,324,0.00303951367781155
"064278703","BUENOS AIRES",271,4,209,50,1,260,0.014760147601476
"064341509","BUENOS AIRES",189,185,2,2,0,4,0.978835978835979
"064278705","BUENOS AIRES",495,2,350,141,0,491,0.00404040404040404
"064278803","BUENOS AIRES",543,8,359,153,1,513,0.0147329650092081
"064278805","BUENOS AIRES",644,27,341,239,4,584,0.0419254658385093
"064278901","BUENOS AIRES",812,13,320,448,10,778,0.0160098522167488
"064278913","BUENOS AIRES",546,3,213,298,3,514,0.00549450549450549
"064279002","BUENOS AIRES",520,6,304,188,4,496,0.0115384615384615
"064279004","BUENOS AIRES",325,17,164,122,3,289,0.0523076923076923
"064279013","BUENOS AIRES",248,4,123,102,2,227,0.0161290322580645
"064279105","BUENOS AIRES",283,3,194,62,17,273,0.0106007067137809
"064279115","BUENOS AIRES",111,2,72,35,0,107,0.018018018018018
"065680602","BUENOS AIRES",316,314,1,1,0,2,0.993670886075949
"064279206","BUENOS AIRES",492,6,298,164,8,470,0.0121951219512195
"064279207","BUENOS AIRES",526,6,290,203,7,500,0.0114068441064639
"064279210","BUENOS AIRES",421,126,116,154,4,274,0.299287410926366
"064279304","BUENOS AIRES",393,1,146,230,5,381,0.00254452926208651
"064279308","BUENOS AIRES",446,2,221,207,1,429,0.00448430493273543
"064279314","BUENOS AIRES",463,126,170,149,1,320,0.272138228941685
"064279412","BUENOS AIRES",435,4,236,192,0,428,0.00919540229885057
"064279509","BUENOS AIRES",386,3,196,166,0,362,0.0077720207253886
"064279713","BUENOS AIRES",273,1,190,78,2,270,0.00366300366300366
"064201507","BUENOS AIRES",32,29,1,0,0,1,0.90625
"064279607","BUENOS AIRES",326,3,160,135,4,299,0.00920245398773006
"064279703","BUENOS AIRES",475,34,229,183,2,414,0.071578947368421
"064279718","BUENOS AIRES",193,0,61,125,0,186,0
"064279722","BUENOS AIRES",205,1,65,112,7,184,0.0048780487804878
"064340209","BUENOS AIRES",53,52,1,0,0,1,0.981132075471698
"064340302","BUENOS AIRES",294,231,28,35,0,63,0.785714285714286
"064340401","BUENOS AIRES",362,286,56,20,0,76,0.790055248618785
"064340503","BUENOS AIRES",283,238,29,15,0,44,0.840989399293286
"064340505","BUENOS AIRES",333,242,57,34,0,91,0.726726726726727
"064340606","BUENOS AIRES",382,315,28,24,0,52,0.824607329842932
"064340607","BUENOS AIRES",329,275,31,22,0,53,0.835866261398176
"064340711","BUENOS AIRES",165,13,40,110,0,150,0.0787878787878788
"064340808","BUENOS AIRES",88,45,17,22,1,40,0.511363636363636
"064340901","BUENOS AIRES",248,22,33,181,1,215,0.0887096774193548
"064340902","BUENOS AIRES",353,14,59,272,1,332,0.0396600566572238
"064340912","BUENOS AIRES",249,42,92,111,0,203,0.168674698795181
"064340913","BUENOS AIRES",266,14,42,202,1,245,0.0526315789473684
"064341103","BUENOS AIRES",247,202,25,20,0,45,0.817813765182186
"064341110","BUENOS AIRES",189,37,64,83,0,147,0.195767195767196
"064341206","BUENOS AIRES",350,134,93,122,0,215,0.382857142857143
"064341311","BUENOS AIRES",431,7,145,274,0,419,0.0162412993039443
"064341401","BUENOS AIRES",286,11,135,140,0,275,0.0384615384615385
"064341405","BUENOS AIRES",251,15,156,80,0,236,0.0597609561752988
"064341707","BUENOS AIRES",160,117,36,7,0,43,0.73125
"064341711","BUENOS AIRES",265,217,19,29,0,48,0.818867924528302
"064341901","BUENOS AIRES",341,26,203,112,0,315,0.0762463343108504
"064342008","BUENOS AIRES",342,16,198,126,0,324,0.0467836257309941
"064342210","BUENOS AIRES",487,344,128,15,0,143,0.706365503080082
"064342213","BUENOS AIRES",388,28,272,87,0,359,0.0721649484536082
"064342410","BUENOS AIRES",283,14,174,95,0,269,0.049469964664311
"064342505","BUENOS AIRES",233,11,159,60,2,221,0.0472103004291846
"064342507","BUENOS AIRES",283,34,133,82,0,215,0.120141342756184
"065810709","BUENOS AIRES",214,2,120,92,0,212,0.00934579439252336
"065810710","BUENOS AIRES",175,5,105,65,0,170,0.0285714285714286
"064342518","BUENOS AIRES",195,74,86,34,0,120,0.379487179487179
"064342615","BUENOS AIRES",195,12,103,77,1,181,0.0615384615384615
"064342708","BUENOS AIRES",280,6,142,131,0,273,0.0214285714285714
"064342710","BUENOS AIRES",423,5,197,207,2,406,0.0118203309692671
"064342805","BUENOS AIRES",271,11,125,135,0,260,0.040590405904059
"064342808","BUENOS AIRES",479,18,264,194,0,458,0.0375782881002088
"064343009","BUENOS AIRES",307,26,157,124,0,281,0.0846905537459283
"064343106","BUENOS AIRES",293,267,24,2,0,26,0.911262798634812
"064343202","BUENOS AIRES",315,311,4,0,0,4,0.987301587301587
"064343203","BUENOS AIRES",215,208,6,1,0,7,0.967441860465116
"064343205","BUENOS AIRES",184,177,3,4,0,7,0.96195652173913
"064343206","BUENOS AIRES",161,156,4,1,0,5,0.968944099378882
"064343401","BUENOS AIRES",329,30,167,132,0,299,0.0911854103343465
"064343407","BUENOS AIRES",274,7,160,105,0,265,0.0255474452554745
"064343506","BUENOS AIRES",285,32,123,130,0,253,0.112280701754386
"064343608","BUENOS AIRES",253,6,118,128,1,247,0.0237154150197628
"064343806","BUENOS AIRES",320,287,16,17,0,33,0.896875
"064481102","BUENOS AIRES",10,0,3,6,0,9,0
"064343905","BUENOS AIRES",310,27,113,170,0,283,0.0870967741935484
"064343907","BUENOS AIRES",279,24,147,107,0,254,0.0860215053763441
"064344003","BUENOS AIRES",206,15,68,123,0,191,0.0728155339805825
"064344008","BUENOS AIRES",372,285,33,54,0,87,0.766129032258065
"064344102","BUENOS AIRES",267,12,77,178,0,255,0.0449438202247191
"064344108","BUENOS AIRES",339,28,181,125,0,306,0.0825958702064897
"020152010","CABA",319,318,0,0,0,0,0.996865203761755
"064344302","BUENOS AIRES",267,6,137,120,1,258,0.0224719101123595
"064344410","BUENOS AIRES",276,13,132,129,0,261,0.0471014492753623
"064344412","BUENOS AIRES",378,38,139,201,0,340,0.100529100529101
"064344511","BUENOS AIRES",363,13,168,180,0,348,0.0358126721763085
"064344512","BUENOS AIRES",489,12,228,247,1,476,0.0245398773006135
"064410202","BUENOS AIRES",233,233,0,0,0,0,1
"064410306","BUENOS AIRES",297,297,0,0,0,0,1
"064410401","BUENOS AIRES",377,374,0,0,0,0,0.992042440318302
"064410404","BUENOS AIRES",191,191,0,0,0,0,1
"064410602","BUENOS AIRES",172,172,0,0,0,0,1
"064410606","BUENOS AIRES",204,204,0,0,0,0,1
"064410608","BUENOS AIRES",190,189,1,0,0,1,0.994736842105263
"064410804","BUENOS AIRES",141,141,0,0,0,0,1
"064410908","BUENOS AIRES",212,212,0,0,0,0,1
"064410914","BUENOS AIRES",195,194,1,0,0,1,0.994871794871795
"064411003","BUENOS AIRES",222,217,3,2,0,5,0.977477477477477
"064411004","BUENOS AIRES",209,207,0,2,0,2,0.990430622009569
"064411013","BUENOS AIRES",242,241,1,0,0,1,0.995867768595041
"064411106","BUENOS AIRES",180,179,1,0,0,1,0.994444444444444
"064411112","BUENOS AIRES",373,364,6,0,0,6,0.975871313672922
"064411201","BUENOS AIRES",215,215,0,0,0,0,1
"064411211","BUENOS AIRES",265,265,0,0,0,0,1
"064411215","BUENOS AIRES",157,154,2,0,0,2,0.980891719745223
"064411303","BUENOS AIRES",100,100,0,0,0,0,1
"064411309","BUENOS AIRES",257,255,1,1,0,2,0.992217898832685
"064411602","BUENOS AIRES",206,205,1,0,0,1,0.995145631067961
"064411604","BUENOS AIRES",216,213,2,1,0,3,0.986111111111111
"064411704","BUENOS AIRES",203,201,1,0,0,1,0.990147783251232
"064411910","BUENOS AIRES",184,184,0,0,0,0,1
"064412002","BUENOS AIRES",226,226,0,0,0,0,1
"064412106","BUENOS AIRES",197,197,0,0,0,0,1
"064412111","BUENOS AIRES",189,189,0,0,0,0,1
"064412201","BUENOS AIRES",263,259,2,2,0,4,0.984790874524715
"064412203","BUENOS AIRES",362,360,1,1,0,2,0.994475138121547
"064412302","BUENOS AIRES",186,185,0,1,0,1,0.994623655913978
"064412307","BUENOS AIRES",254,251,1,1,0,2,0.988188976377953
"064412402","BUENOS AIRES",208,208,0,0,0,0,1
"064412707","BUENOS AIRES",238,237,1,0,0,1,0.995798319327731
"061470906","BUENOS AIRES",12,0,3,9,0,12,0
"064412809","BUENOS AIRES",243,242,1,0,0,1,0.995884773662551
"064412906","BUENOS AIRES",197,192,5,0,0,5,0.974619289340102
"064413009","BUENOS AIRES",312,288,12,7,0,19,0.923076923076923
"064413101","BUENOS AIRES",377,355,7,14,0,21,0.941644562334218
"064413109","BUENOS AIRES",235,232,3,0,0,3,0.987234042553191
"064413202","BUENOS AIRES",183,179,1,1,0,2,0.978142076502732
"064413203","BUENOS AIRES",407,391,12,2,0,14,0.960687960687961
"064413209","BUENOS AIRES",248,224,9,14,0,23,0.903225806451613
"064413301","BUENOS AIRES",345,344,1,0,0,1,0.997101449275362
"064413307","BUENOS AIRES",243,239,2,2,0,4,0.983539094650206
"067001209","BUENOS AIRES",175,172,2,0,0,2,0.982857142857143
"065952614","BUENOS AIRES",175,0,77,96,0,173,0
"064413507","BUENOS AIRES",285,204,19,58,0,77,0.715789473684211
"064413514","BUENOS AIRES",300,299,1,0,0,1,0.996666666666667
"064413515","BUENOS AIRES",434,38,117,252,1,370,0.0875576036866359
"064413709","BUENOS AIRES",376,372,2,0,0,2,0.98936170212766
"064413712","BUENOS AIRES",413,320,32,49,2,83,0.774818401937046
"064413803","BUENOS AIRES",270,10,67,186,0,253,0.037037037037037
"064413910","BUENOS AIRES",435,367,40,19,0,59,0.84367816091954
"064414003","BUENOS AIRES",238,236,2,0,0,2,0.991596638655462
"064414012","BUENOS AIRES",332,92,64,154,3,221,0.27710843373494
"066021403","BUENOS AIRES",50,0,39,10,0,49,0
"065151902","BUENOS AIRES",295,5,159,120,2,281,0.0169491525423729
"064414206","BUENOS AIRES",449,3,157,262,4,423,0.0066815144766147
"064414207","BUENOS AIRES",381,6,134,208,14,356,0.015748031496063
"064414211","BUENOS AIRES",298,17,153,120,0,273,0.0570469798657718
"064414218","BUENOS AIRES",395,306,58,29,0,87,0.774683544303797
"064414307","BUENOS AIRES",229,9,138,80,0,218,0.0393013100436681
"064414313","BUENOS AIRES",244,103,67,70,1,138,0.422131147540984
"064414314","BUENOS AIRES",328,11,152,160,1,313,0.0335365853658537
"064414408","BUENOS AIRES",229,3,126,91,0,217,0.0131004366812227
"064760103","BUENOS AIRES",194,185,4,5,0,9,0.95360824742268
"064414503","BUENOS AIRES",298,11,100,186,0,286,0.0369127516778524
"064414507","BUENOS AIRES",310,5,159,139,0,298,0.0161290322580645
"064414703","BUENOS AIRES",315,174,67,66,0,133,0.552380952380952
"064414706","BUENOS AIRES",288,170,77,36,1,114,0.590277777777778
"064690807","BUENOS AIRES",188,1,103,82,0,185,0.00531914893617021
"064414710","BUENOS AIRES",257,33,59,162,0,221,0.1284046692607
"064414801","BUENOS AIRES",329,70,174,83,0,257,0.212765957446809
"064414905","BUENOS AIRES",190,187,3,0,0,3,0.984210526315789
"064415006","BUENOS AIRES",235,233,2,0,0,2,0.991489361702128
"064415102","BUENOS AIRES",260,176,17,57,5,79,0.676923076923077
"064415103","BUENOS AIRES",211,207,3,1,0,4,0.981042654028436
"064415115","BUENOS AIRES",213,211,0,2,0,2,0.990610328638498
"064415117","BUENOS AIRES",421,411,5,2,0,7,0.97624703087886
"064415404","BUENOS AIRES",250,238,11,1,0,12,0.952
"064415405","BUENOS AIRES",387,347,35,5,0,40,0.896640826873385
"064690909","BUENOS AIRES",249,3,124,107,1,232,0.0120481927710843
"064691501","BUENOS AIRES",324,1,258,65,0,323,0.00308641975308642
"064830103","BUENOS AIRES",388,262,84,41,0,125,0.675257731958763
"064830102","BUENOS AIRES",368,227,99,40,1,140,0.616847826086957
"064690604","BUENOS AIRES",148,1,40,105,1,146,0.00675675675675676
"064900703","BUENOS AIRES",381,32,133,214,1,348,0.083989501312336
"064415502","BUENOS AIRES",496,9,257,201,1,459,0.0181451612903226
"064415601","BUENOS AIRES",269,258,8,2,0,10,0.95910780669145
"064415603","BUENOS AIRES",192,181,10,1,0,11,0.942708333333333
"066230702","BUENOS AIRES",219,1,133,80,0,213,0.0045662100456621
"064415808","BUENOS AIRES",193,191,2,0,0,2,0.989637305699482
"064415908","BUENOS AIRES",337,30,201,98,0,299,0.0890207715133531
"064416106","BUENOS AIRES",370,194,138,34,0,172,0.524324324324324
"066440305","BUENOS AIRES",89,4,76,7,2,85,0.0449438202247191
"064201604","BUENOS AIRES",15,15,0,0,0,0,1
"065392406","BUENOS AIRES",285,8,212,55,1,268,0.0280701754385965
"064416111","BUENOS AIRES",264,7,244,12,0,256,0.0265151515151515
"064416202","BUENOS AIRES",259,226,18,11,0,29,0.872586872586873
"064416204","BUENOS AIRES",281,265,9,3,0,12,0.943060498220641
"064416212","BUENOS AIRES",177,2,127,45,2,174,0.0112994350282486
"064416310","BUENOS AIRES",222,1,172,46,1,219,0.0045045045045045
"064416404","BUENOS AIRES",158,6,35,110,1,146,0.0379746835443038
"064416410","BUENOS AIRES",37,2,24,11,0,35,0.0540540540540541
"064416419","BUENOS AIRES",329,2,183,120,2,305,0.0060790273556231
"064416803","BUENOS AIRES",238,3,184,50,0,234,0.0126050420168067
"064416804","BUENOS AIRES",233,15,125,92,0,217,0.0643776824034335
"064416612","BUENOS AIRES",337,298,18,16,1,35,0.884272997032641
"064416807","BUENOS AIRES",166,0,71,91,3,165,0
"064416809","BUENOS AIRES",141,0,97,43,0,140,0
"066380305","BUENOS AIRES",221,1,142,72,2,216,0.00452488687782805
"064690109","BUENOS AIRES",435,302,72,61,0,133,0.694252873563218
"064690213","BUENOS AIRES",182,161,5,14,0,19,0.884615384615385
"020022002","CABA",449,446,1,0,0,1,0.993318485523385
"064416903","BUENOS AIRES",326,28,199,94,3,296,0.0858895705521472
"064416909","BUENOS AIRES",350,8,86,239,4,329,0.0228571428571429
"064417002","BUENOS AIRES",260,33,124,99,1,224,0.126923076923077
"064480603","BUENOS AIRES",250,65,59,125,0,184,0.26
"064480604","BUENOS AIRES",255,204,25,26,0,51,0.8
"064480614","BUENOS AIRES",246,146,17,81,0,98,0.59349593495935
"064550113","BUENOS AIRES",211,162,13,35,0,48,0.767772511848341
"064551414","BUENOS AIRES",242,238,2,2,0,4,0.983471074380165
"064620403","BUENOS AIRES",392,206,69,114,1,184,0.525510204081633
"064690103","BUENOS AIRES",236,193,16,27,0,43,0.817796610169492
"064690105","BUENOS AIRES",246,194,33,16,0,49,0.788617886178862
"060070205","BUENOS AIRES",7,0,0,7,0,7,0
"064761401","BUENOS AIRES",242,134,22,82,1,105,0.553719008264463
"064761408","BUENOS AIRES",312,260,23,26,0,49,0.833333333333333
"064830108","BUENOS AIRES",237,232,3,2,0,5,0.978902953586498
"064830109","BUENOS AIRES",280,261,14,4,0,18,0.932142857142857
"064830407","BUENOS AIRES",372,82,165,122,0,287,0.220430107526882
"064830409","BUENOS AIRES",292,9,185,94,0,279,0.0308219178082192
"064830806","BUENOS AIRES",137,2,73,60,2,135,0.0145985401459854
"064900204","BUENOS AIRES",328,6,70,242,3,315,0.0182926829268293
"064900108","BUENOS AIRES",207,19,64,119,0,183,0.0917874396135266
"064900309","BUENOS AIRES",352,16,167,158,0,325,0.0454545454545455
"064900312","BUENOS AIRES",315,30,136,146,1,283,0.0952380952380952
"064900402","BUENOS AIRES",318,13,152,142,1,295,0.0408805031446541
"064900407","BUENOS AIRES",414,11,50,314,8,372,0.0265700483091787
"064900606","BUENOS AIRES",210,16,90,104,0,194,0.0761904761904762
"064900611","BUENOS AIRES",284,13,160,106,0,266,0.0457746478873239
"020010610","CABA",193,193,0,0,0,0,1
"064900614","BUENOS AIRES",355,340,14,1,0,15,0.957746478873239
"064900708","BUENOS AIRES",219,11,87,94,0,181,0.0502283105022831
"064900715","BUENOS AIRES",301,12,171,93,0,264,0.0398671096345515
"064901007","BUENOS AIRES",207,202,1,4,0,5,0.975845410628019
"064901013","BUENOS AIRES",331,331,0,0,0,0,1
"064901015","BUENOS AIRES",258,257,1,0,0,1,0.996124031007752
"064902605","BUENOS AIRES",236,197,9,10,0,19,0.834745762711864
"064901103","BUENOS AIRES",305,291,8,6,0,14,0.954098360655738
"064901104","BUENOS AIRES",315,303,11,1,0,12,0.961904761904762
"064901106","BUENOS AIRES",172,167,5,0,0,5,0.970930232558139
"064901203","BUENOS AIRES",341,272,42,27,0,69,0.797653958944281
"064901204","BUENOS AIRES",189,184,2,3,0,5,0.973544973544973
"064901210","BUENOS AIRES",332,97,144,91,0,235,0.292168674698795
"064901309","BUENOS AIRES",394,65,163,160,0,323,0.16497461928934
"064901402","BUENOS AIRES",341,12,142,181,2,325,0.0351906158357771
"064901409","BUENOS AIRES",258,18,73,165,0,238,0.0697674418604651
"064901507","BUENOS AIRES",237,9,72,152,0,224,0.0379746835443038
"064901901","BUENOS AIRES",341,295,31,15,0,46,0.865102639296188
"060070304","BUENOS AIRES",12,0,6,5,0,11,0
"064901701","BUENOS AIRES",388,25,119,218,0,337,0.0644329896907216
"064903201","BUENOS AIRES",455,22,187,233,0,420,0.0483516483516484
"064901801","BUENOS AIRES",393,12,179,199,0,378,0.0305343511450382
"064901802","BUENOS AIRES",322,72,158,92,0,250,0.22360248447205
"064901906","BUENOS AIRES",296,255,26,10,0,36,0.861486486486487
"064902001","BUENOS AIRES",308,127,149,32,0,181,0.412337662337662
"064902008","BUENOS AIRES",247,55,157,35,0,192,0.222672064777328
"064902109","BUENOS AIRES",213,210,1,2,0,3,0.985915492957746
"064902208","BUENOS AIRES",102,101,1,0,0,1,0.990196078431373
"064902303","BUENOS AIRES",303,266,23,14,0,37,0.877887788778878
"064902306","BUENOS AIRES",296,293,1,0,0,1,0.989864864864865
"064902308","BUENOS AIRES",112,112,0,0,0,0,1
"064902309","BUENOS AIRES",255,252,3,0,0,3,0.988235294117647
"064902401","BUENOS AIRES",265,256,6,3,0,9,0.966037735849057
"064902504","BUENOS AIRES",269,220,28,20,0,48,0.817843866171004
"064902506","BUENOS AIRES",288,285,3,0,0,3,0.989583333333333
"064902608","BUENOS AIRES",244,215,19,10,0,29,0.881147540983607
"064902612","BUENOS AIRES",290,256,24,10,0,34,0.882758620689655
"064902713","BUENOS AIRES",182,4,100,76,0,176,0.021978021978022
"064902904","BUENOS AIRES",359,8,161,184,2,347,0.0222841225626741
"064903109","BUENOS AIRES",328,9,114,196,1,311,0.0274390243902439
"064903208","BUENOS AIRES",422,7,207,197,3,407,0.0165876777251185
"064903411","BUENOS AIRES",354,4,84,258,2,344,0.0112994350282486
"064903503","BUENOS AIRES",429,1,10,262,36,308,0.00233100233100233
"064903504","BUENOS AIRES",462,4,29,259,34,322,0.00865800865800866
"064903506","BUENOS AIRES",519,2,35,251,37,323,0.00385356454720617
"064903514","BUENOS AIRES",395,5,152,216,1,369,0.0126582278481013
"064903518","BUENOS AIRES",395,6,219,161,0,380,0.0151898734177215
"064903601","BUENOS AIRES",446,16,159,251,2,412,0.0358744394618834
"064903607","BUENOS AIRES",315,37,67,180,18,265,0.117460317460317
"064903610","BUENOS AIRES",426,10,227,168,0,395,0.0234741784037559
"064903704","BUENOS AIRES",252,7,134,105,0,239,0.0277777777777778
"064903708","BUENOS AIRES",250,5,55,180,0,235,0.02
"060840605","BUENOS AIRES",9,1,6,2,0,8,0.111111111111111
"064903713","BUENOS AIRES",482,25,176,242,3,421,0.0518672199170125
"064903806","BUENOS AIRES",300,22,24,239,5,268,0.0733333333333333
"064903814","BUENOS AIRES",221,12,45,157,2,204,0.0542986425339367
"064904001","BUENOS AIRES",240,4,18,196,0,214,0.0166666666666667
"064201607","BUENOS AIRES",16,15,1,0,0,1,0.9375
"064904005","BUENOS AIRES",291,3,52,214,1,267,0.0103092783505155
"064904007","BUENOS AIRES",377,8,48,309,5,362,0.0212201591511936
"064904011","BUENOS AIRES",322,14,70,234,2,306,0.0434782608695652
"064904012","BUENOS AIRES",516,3,61,373,10,444,0.00581395348837209
"064904102","BUENOS AIRES",32,13,10,9,0,19,0.40625
"064904205","BUENOS AIRES",254,2,177,75,0,252,0.0078740157480315
"064904306","BUENOS AIRES",315,313,0,0,0,0,0.993650793650794
"064904404","BUENOS AIRES",378,127,180,68,1,249,0.335978835978836
"064904409","BUENOS AIRES",439,12,277,134,0,411,0.0273348519362187
"064904504","BUENOS AIRES",412,5,173,223,6,402,0.0121359223300971
"064904805","BUENOS AIRES",177,173,3,1,0,4,0.977401129943503
"065391210","BUENOS AIRES",337,0,192,106,1,299,0
"065391301","BUENOS AIRES",472,0,363,100,0,463,0
"065391302","BUENOS AIRES",276,3,179,92,1,272,0.0108695652173913
"065391304","BUENOS AIRES",378,5,126,231,1,358,0.0132275132275132
"065391307","BUENOS AIRES",319,0,191,126,0,317,0
"065391414","BUENOS AIRES",271,3,202,62,0,264,0.011070110701107
"065391502","BUENOS AIRES",274,273,1,0,0,1,0.996350364963504
"065391503","BUENOS AIRES",195,185,7,3,0,10,0.948717948717949
"065391506","BUENOS AIRES",245,242,2,0,1,3,0.987755102040816
"060631201","BUENOS AIRES",15,0,4,11,0,15,0
"060840908","BUENOS AIRES",6,0,2,4,0,6,0
"060070106","BUENOS AIRES",5,0,0,5,0,5,0
"060070409","BUENOS AIRES",4,0,1,3,0,4,0
"060070503","BUENOS AIRES",4,0,2,2,0,4,0
"063430105","BUENOS AIRES",25,1,4,16,2,22,0.04
"062310801","BUENOS AIRES",14,0,3,11,0,14,0
"060070506","BUENOS AIRES",4,0,3,1,0,4,0
"060070701","BUENOS AIRES",9,0,0,9,0,9,0
"060070902","BUENOS AIRES",9,0,8,0,1,9,0
"060071003","BUENOS AIRES",5,0,4,1,0,5,0
"060210902","BUENOS AIRES",10,0,2,6,0,8,0
"060071005","BUENOS AIRES",13,0,3,10,0,13,0
"060140302","BUENOS AIRES",34,0,11,14,9,34,0
"061610402","BUENOS AIRES",25,0,8,15,0,23,0
"060140801","BUENOS AIRES",30,0,17,11,2,30,0
"060141002","BUENOS AIRES",29,1,12,15,0,27,0.0344827586206897
"060210205","BUENOS AIRES",3,0,3,0,0,3,0
"061890605","BUENOS AIRES",1,0,0,1,0,1,0
"060210702","BUENOS AIRES",5,0,2,3,0,5,0
"061890801","BUENOS AIRES",2,0,2,0,0,2,0
"060210903","BUENOS AIRES",13,0,13,0,0,13,0
"062171102","BUENOS AIRES",18,1,1,9,2,12,0.0555555555555556
"060420801","BUENOS AIRES",42,0,10,32,0,42,0
"060421201","BUENOS AIRES",52,1,7,41,1,49,0.0192307692307692
"060421301","BUENOS AIRES",44,0,29,11,2,42,0
"062380606","BUENOS AIRES",18,0,2,16,0,18,0
"060490702","BUENOS AIRES",35,2,7,26,0,33,0.0571428571428571
"063080101","BUENOS AIRES",19,0,2,17,0,19,0
"060631102","BUENOS AIRES",46,1,16,26,0,42,0.0217391304347826
"060631105","BUENOS AIRES",40,0,3,37,0,40,0
"060700904","BUENOS AIRES",5,0,3,2,0,5,0
"060492301","BUENOS AIRES",64,0,14,45,3,62,0
"060630604","BUENOS AIRES",24,0,16,8,0,24,0
"065392407","BUENOS AIRES",276,4,198,70,0,268,0.0144927536231884
"060700804","BUENOS AIRES",15,0,7,8,0,15,0
"060700806","BUENOS AIRES",4,0,3,1,0,4,0
"065391711","BUENOS AIRES",243,125,90,26,0,116,0.51440329218107
"060630606","BUENOS AIRES",18,0,3,15,0,18,0
"061540103","BUENOS AIRES",14,0,8,6,0,14,0
"065391703","BUENOS AIRES",310,20,166,119,1,286,0.0645161290322581
"060630905","BUENOS AIRES",9,1,3,4,1,8,0.111111111111111
"062031406","BUENOS AIRES",5,0,3,2,0,5,0
"060631004","BUENOS AIRES",23,0,13,10,0,23,0
"061610701","BUENOS AIRES",26,1,6,19,0,25,0.0384615384615385
"060701102","BUENOS AIRES",5,0,5,0,0,5,0
"065391714","BUENOS AIRES",238,208,23,3,0,26,0.873949579831933
"060771303","BUENOS AIRES",13,0,10,3,0,13,0
"060840403","BUENOS AIRES",16,0,5,11,0,16,0
"061540207","BUENOS AIRES",15,0,6,9,0,15,0
"060840701","BUENOS AIRES",67,1,18,48,0,66,0.0149253731343284
"060841001","BUENOS AIRES",12,1,2,9,0,11,0.0833333333333333
"065391805","BUENOS AIRES",393,301,53,34,0,87,0.765903307888041
"061121106","BUENOS AIRES",36,2,9,25,0,34,0.0555555555555556
"060980405","BUENOS AIRES",10,0,5,5,0,10,0
"061050402","BUENOS AIRES",22,0,11,11,0,22,0
"061050805","BUENOS AIRES",70,0,26,42,0,68,0
"061050809","BUENOS AIRES",35,0,8,25,1,34,0
"061051101","BUENOS AIRES",59,0,21,35,0,56,0
"061120506","BUENOS AIRES",7,0,6,1,0,7,0
"061120705","BUENOS AIRES",8,0,4,4,0,8,0
"061120905","BUENOS AIRES",6,0,3,3,0,6,0
"061120907","BUENOS AIRES",10,0,1,9,0,10,0
"061190202","BUENOS AIRES",18,0,5,12,1,18,0
"061190804","BUENOS AIRES",7,0,4,3,0,7,0
"061260517","BUENOS AIRES",17,0,0,12,2,14,0
"061340602","BUENOS AIRES",45,0,8,34,3,45,0
"061400203","BUENOS AIRES",20,0,13,7,0,20,0
"020010607","CABA",227,226,1,0,0,1,0.995594713656388
"068052609","BUENOS AIRES",299,5,198,74,17,289,0.0167224080267559
"061340205","BUENOS AIRES",48,4,28,14,1,43,0.0833333333333333
"061340701","BUENOS AIRES",24,0,9,15,0,24,0
"061680204","BUENOS AIRES",4,0,2,2,0,4,0
"061400402","BUENOS AIRES",23,0,14,9,0,23,0
"061470307","BUENOS AIRES",17,0,0,17,0,17,0
"061470705","BUENOS AIRES",4,0,0,4,0,4,0
"061261003","BUENOS AIRES",203,39,65,79,16,160,0.192118226600985
"061540403","BUENOS AIRES",10,0,5,4,0,9,0
"061540702","BUENOS AIRES",22,0,0,22,0,22,0
"061540806","BUENOS AIRES",35,0,24,10,0,34,0
"061891104","BUENOS AIRES",4,0,4,0,0,4,0
"065392009","BUENOS AIRES",441,7,297,130,2,429,0.0158730158730159
"065392010","BUENOS AIRES",446,1,239,186,1,426,0.00224215246636771
"061750303","BUENOS AIRES",5,0,2,3,0,5,0
"061750503","BUENOS AIRES",5,0,4,1,0,5,0
"065392013","BUENOS AIRES",260,2,165,88,0,253,0.00769230769230769
"065392014","BUENOS AIRES",254,1,113,134,1,248,0.00393700787401575
"061890201","BUENOS AIRES",1,0,0,1,0,1,0
"061890202","BUENOS AIRES",2,0,1,1,0,2,0
"061890204","BUENOS AIRES",1,0,1,0,0,1,0
"061890401","BUENOS AIRES",2,0,1,1,0,2,0
"065392408","BUENOS AIRES",243,11,148,79,0,227,0.0452674897119342
"062241303","BUENOS AIRES",13,0,1,10,2,13,0
"020020706","CABA",271,271,0,0,0,0,1
"061890602","BUENOS AIRES",10,0,3,7,0,10,0
"061890705","BUENOS AIRES",6,0,2,4,0,6,0
"061890901","BUENOS AIRES",7,0,7,0,0,7,0
"061891209","BUENOS AIRES",3,0,3,0,0,3,0
"061891403","BUENOS AIRES",7,0,7,0,0,7,0
"061891505","BUENOS AIRES",18,0,6,11,0,17,0
"061960302","BUENOS AIRES",10,0,4,5,0,9,0
"061960304","BUENOS AIRES",4,0,2,1,0,3,0
"061960501","BUENOS AIRES",6,0,1,5,0,6,0
"061961202","BUENOS AIRES",16,0,11,5,0,16,0
"061961402","BUENOS AIRES",13,0,6,6,0,12,0
"061960901","BUENOS AIRES",1,0,0,1,0,1,0
"061960905","BUENOS AIRES",11,0,7,4,0,11,0
"061961003","BUENOS AIRES",3,0,0,3,0,3,0
"061961105","BUENOS AIRES",16,0,0,16,0,16,0
"020021906","CABA",424,424,0,0,0,0,1
"061961106","BUENOS AIRES",8,0,5,3,0,8,0
"061961503","BUENOS AIRES",6,0,0,5,0,5,0
"062030301","BUENOS AIRES",14,0,9,5,0,14,0
"062030902","BUENOS AIRES",14,0,4,10,0,14,0
"062030906","BUENOS AIRES",1,0,1,0,0,1,0
"062031104","BUENOS AIRES",4,0,1,3,0,4,0
"066020501","BUENOS AIRES",11,0,7,2,0,9,0
"065392312","BUENOS AIRES",426,3,153,263,0,416,0.00704225352112676
"062031302","BUENOS AIRES",5,0,2,3,0,5,0
"062100601","BUENOS AIRES",25,0,13,11,1,25,0
"062100801","BUENOS AIRES",119,0,24,91,2,117,0
"062170301","BUENOS AIRES",48,1,6,38,0,44,0.0208333333333333
"062170506","BUENOS AIRES",15,0,6,9,0,15,0
"065392401","BUENOS AIRES",476,3,337,132,0,469,0.00630252100840336
"062170803","BUENOS AIRES",22,0,4,18,0,22,0
"065392510","BUENOS AIRES",349,19,230,89,0,319,0.0544412607449857
"062310903","BUENOS AIRES",15,0,5,8,0,13,0
"062171104","BUENOS AIRES",9,0,5,4,0,9,0
"062171101","BUENOS AIRES",57,0,27,26,4,57,0
"062311002","BUENOS AIRES",3,0,0,3,0,3,0
"065392609","BUENOS AIRES",358,1,237,111,0,348,0.00279329608938547
"064480613","BUENOS AIRES",2,0,2,0,0,2,0
"062241903","BUENOS AIRES",14,0,5,9,0,14,0
"062242006","BUENOS AIRES",6,0,1,5,0,6,0
"068052615","BUENOS AIRES",121,0,98,19,3,120,0
"063990301","BUENOS AIRES",43,0,23,18,2,43,0
"062310103","BUENOS AIRES",16,0,6,9,0,15,0
"062240701","BUENOS AIRES",2,0,2,0,0,2,0
"062240702","BUENOS AIRES",14,0,8,6,0,14,0
"062240906","BUENOS AIRES",70,3,35,32,0,67,0.0428571428571429
"065392607","BUENOS AIRES",479,3,231,223,0,454,0.00626304801670146
"062310106","BUENOS AIRES",29,0,16,13,0,29,0
"062310304","BUENOS AIRES",8,0,7,1,0,8,0
"062450507","BUENOS AIRES",54,0,32,18,3,53,0
"062800708","BUENOS AIRES",23,0,10,13,0,23,0
"062800808","BUENOS AIRES",6,0,1,5,0,6,0
"062800814","BUENOS AIRES",7,0,5,2,0,7,0
"064690503","BUENOS AIRES",8,0,2,6,0,8,0
"020151503","CABA",401,401,0,0,0,0,1
"062521601","BUENOS AIRES",175,0,86,59,25,170,0
"062770116","BUENOS AIRES",20,0,11,7,0,18,0
"062800509","BUENOS AIRES",7,0,6,1,0,7,0
"062800602","BUENOS AIRES",7,0,0,6,0,6,0
"062800702","BUENOS AIRES",9,0,8,1,0,9,0
"062800818","BUENOS AIRES",4,0,0,3,0,3,0
"063510304","BUENOS AIRES",13,0,2,11,0,13,0
"065392702","BUENOS AIRES",352,22,109,196,4,309,0.0625
"062801203","BUENOS AIRES",3,0,0,3,0,3,0
"062870502","BUENOS AIRES",60,0,33,26,0,59,0
"062940505","BUENOS AIRES",13,0,5,8,0,13,0
"062940605","BUENOS AIRES",4,0,4,0,0,4,0
"020051307","CABA",323,314,0,0,0,0,0.972136222910217
"062940705","BUENOS AIRES",9,0,1,8,0,9,0
"063010501","BUENOS AIRES",5,0,1,4,0,5,0
"065392707","BUENOS AIRES",361,310,30,18,0,48,0.858725761772853
"063010601","BUENOS AIRES",78,0,28,45,2,75,0
"063010701","BUENOS AIRES",78,0,33,44,0,77,0
"063080701","BUENOS AIRES",28,0,3,25,0,28,0
"064900413","BUENOS AIRES",283,17,112,137,0,249,0.0600706713780919
"063150201","BUENOS AIRES",56,0,26,28,1,55,0
"063510801","BUENOS AIRES",21,0,0,20,0,20,0
"063510802","BUENOS AIRES",11,0,10,1,0,11,0
"066090501","BUENOS AIRES",10,0,4,6,0,10,0
"063220505","BUENOS AIRES",11,0,5,5,0,10,0
"063220705","BUENOS AIRES",10,0,6,3,1,10,0
"063221103","BUENOS AIRES",10,0,1,9,0,10,0
"063290103","BUENOS AIRES",24,0,2,22,0,24,0
"063430402","BUENOS AIRES",30,0,13,16,1,30,0
"063921303","BUENOS AIRES",26,0,25,0,1,26,0
"065392801","BUENOS AIRES",268,1,142,115,2,259,0.00373134328358209
"063430502","BUENOS AIRES",20,0,10,4,6,20,0
"063510104","BUENOS AIRES",11,0,1,10,0,11,0
"063510202","BUENOS AIRES",22,1,10,10,1,21,0.0454545454545455
"063510803","BUENOS AIRES",26,0,11,15,0,26,0
"063577706","BUENOS AIRES",21,0,16,5,0,21,0
"063577807","BUENOS AIRES",112,0,40,63,5,108,0
"063990804","BUENOS AIRES",25,0,11,13,1,25,0
"020031803","CABA",189,187,1,1,0,2,0.989417989417989
"063578103","BUENOS AIRES",10,0,9,1,0,10,0
"063920405","BUENOS AIRES",11,0,5,6,0,11,0
"063920503","BUENOS AIRES",11,0,2,9,0,11,0
"063920701","BUENOS AIRES",12,0,0,10,2,12,0
"063920710","BUENOS AIRES",24,0,1,19,2,22,0
"063921209","BUENOS AIRES",19,0,16,3,0,19,0
"064060209","BUENOS AIRES",5,0,3,2,0,5,0
"064060213","BUENOS AIRES",18,0,11,7,0,18,0
"064060304","BUENOS AIRES",24,0,23,1,0,24,0
"064060306","BUENOS AIRES",14,0,0,14,0,14,0
"065110510","BUENOS AIRES",7,0,2,3,2,7,0
"064690908","BUENOS AIRES",18,0,6,12,0,18,0
"063640601","BUENOS AIRES",12,0,4,8,0,12,0
"064690502","BUENOS AIRES",4,0,2,2,0,4,0
"064760803","BUENOS AIRES",14,0,7,7,0,14,0
"063850103","BUENOS AIRES",15,0,9,6,0,15,0
"063850301","BUENOS AIRES",6,0,0,6,0,6,0
"063920805","BUENOS AIRES",27,2,15,6,0,21,0.0740740740740741
"064130702","BUENOS AIRES",0,0,0,0,0,0,NA
"064130903","BUENOS AIRES",0,0,0,0,0,0,NA
"066091003","BUENOS AIRES",10,0,3,6,1,10,0
"065180408","BUENOS AIRES",10,0,5,4,0,9,0
"064200315","BUENOS AIRES",20,0,15,5,0,20,0
"064202214","BUENOS AIRES",26,1,18,7,0,25,0.0384615384615385
"065810908","BUENOS AIRES",2,0,0,2,0,2,0
"065810910","BUENOS AIRES",4,0,0,4,0,4,0
"065811101","BUENOS AIRES",2,0,1,1,0,2,0
"066020307","BUENOS AIRES",8,0,2,6,0,8,0
"064416503","BUENOS AIRES",178,0,33,134,1,168,0
"064416510","BUENOS AIRES",442,6,221,190,8,419,0.0135746606334842
"066300201","BUENOS AIRES",11,0,3,8,0,11,0
"064621101","BUENOS AIRES",16,0,9,7,0,16,0
"064621207","BUENOS AIRES",22,0,4,18,0,22,0
"064416701","BUENOS AIRES",122,0,43,75,1,119,0
"064416702","BUENOS AIRES",42,0,9,32,1,42,0
"064416817","BUENOS AIRES",39,0,12,24,1,37,0
"064480103","BUENOS AIRES",14,0,4,9,0,13,0
"064480401","BUENOS AIRES",9,0,0,8,0,8,0
"064481103","BUENOS AIRES",6,0,4,2,0,6,0
"064481202","BUENOS AIRES",5,0,0,5,0,5,0
"064481203","BUENOS AIRES",8,0,0,8,0,8,0
"064481205","BUENOS AIRES",16,0,6,10,0,16,0
"064550606","BUENOS AIRES",15,0,8,7,0,15,0
"064690403","BUENOS AIRES",9,0,3,6,0,9,0
"064550607","BUENOS AIRES",55,0,25,30,0,55,0
"064550901","BUENOS AIRES",36,0,6,29,0,35,0
"065600808","BUENOS AIRES",393,100,170,119,0,289,0.254452926208651
"064620101","BUENOS AIRES",12,0,5,7,0,12,0
"064691006","BUENOS AIRES",4,0,4,0,0,4,0
"064691303","BUENOS AIRES",31,0,19,10,2,31,0
"064691304","BUENOS AIRES",11,0,2,8,0,10,0
"064691503","BUENOS AIRES",4,0,2,1,1,4,0
"064691504","BUENOS AIRES",2,0,0,1,0,1,0
"064691505","BUENOS AIRES",4,0,3,1,0,4,0
"064760205","BUENOS AIRES",36,0,17,19,0,36,0
"064760206","BUENOS AIRES",23,0,8,15,0,23,0
"065602401","BUENOS AIRES",229,226,3,0,0,3,0.986899563318777
"064760403","BUENOS AIRES",7,0,2,5,0,7,0
"065600810","BUENOS AIRES",318,241,42,26,0,68,0.757861635220126
"064761206","BUENOS AIRES",27,0,14,9,3,26,0
"064902603","BUENOS AIRES",326,248,58,18,1,77,0.760736196319018
"064830506","BUENOS AIRES",9,0,5,4,0,9,0
"064970608","BUENOS AIRES",26,1,14,11,0,25,0.0384615384615385
"065050207","BUENOS AIRES",13,0,10,3,0,13,0
"065110402","BUENOS AIRES",6,0,0,5,1,6,0
"065180110","BUENOS AIRES",3,0,1,2,0,3,0
"065180404","BUENOS AIRES",21,0,5,15,1,21,0
"065320306","BUENOS AIRES",296,197,37,56,0,93,0.665540540540541
"065180503","BUENOS AIRES",18,0,5,9,2,16,0
"065180507","BUENOS AIRES",8,0,3,5,0,8,0
"065740901","BUENOS AIRES",15,0,3,12,0,15,0
"067631701","BUENOS AIRES",393,384,6,3,0,9,0.977099236641221
"063710208","BUENOS AIRES",289,4,155,127,0,282,0.013840830449827
"065180510","BUENOS AIRES",22,0,6,15,1,22,0
"065180511","BUENOS AIRES",34,0,17,16,0,33,0
"068401405","BUENOS AIRES",304,295,4,3,0,7,0.970394736842105
"065180801","BUENOS AIRES",3,0,2,0,0,2,0
"065740502","BUENOS AIRES",39,1,11,27,0,38,0.0256410256410256
"065740706","BUENOS AIRES",29,1,13,13,0,26,0.0344827586206897
"068402007","BUENOS AIRES",295,277,9,5,0,14,0.938983050847458
"065810601","BUENOS AIRES",11,0,4,5,2,11,0
"065811202","BUENOS AIRES",8,0,3,5,0,8,0
"065811204","BUENOS AIRES",21,0,9,11,1,21,0
"065250202","BUENOS AIRES",40,4,11,25,0,36,0.1
"067420411","BUENOS AIRES",1,0,1,0,0,1,0
"065320805","BUENOS AIRES",43,0,19,24,0,43,0
"065321303","BUENOS AIRES",6,0,5,1,0,6,0
"065470303","BUENOS AIRES",27,0,20,6,0,26,0
"065470601","BUENOS AIRES",73,0,49,24,0,73,0
"066091709","BUENOS AIRES",8,0,2,5,0,7,0
"067631908","BUENOS AIRES",43,0,8,34,0,42,0
"067700302","BUENOS AIRES",4,0,1,3,0,4,0
"067841101","BUENOS AIRES",5,0,1,4,0,5,0
"065740102","BUENOS AIRES",28,0,6,19,1,26,0
"065393011","BUENOS AIRES",335,1,247,81,0,328,0.00298507462686567
"065810804","BUENOS AIRES",28,0,13,14,0,27,0
"065601108","BUENOS AIRES",396,4,233,151,2,386,0.0101010101010101
"065601109","BUENOS AIRES",382,0,227,146,2,375,0
"065811106","BUENOS AIRES",4,0,1,3,0,4,0
"065811108","BUENOS AIRES",11,0,6,3,0,9,0
"065601303","BUENOS AIRES",474,12,202,244,1,447,0.0253164556962025
"065811201","BUENOS AIRES",12,0,3,6,2,11,0
"020142311","CABA",462,462,0,0,0,0,1
"060351708","BUENOS AIRES",288,17,131,140,0,271,0.0590277777777778
"065811206","BUENOS AIRES",42,0,7,35,0,42,0
"065880401","BUENOS AIRES",22,0,2,19,0,21,0
"065880504","BUENOS AIRES",8,0,3,5,0,8,0
"065880801","BUENOS AIRES",59,0,16,42,1,59,0
"066020203","BUENOS AIRES",73,0,40,24,5,69,0
"066020305","BUENOS AIRES",12,0,5,5,0,10,0
"065390813","BUENOS AIRES",331,0,181,114,1,296,0
"065880904","BUENOS AIRES",127,1,36,86,2,124,0.0078740157480315
"065881007","BUENOS AIRES",29,0,21,7,1,29,0
"065881303","BUENOS AIRES",24,0,10,13,1,24,0
"065950701","BUENOS AIRES",64,1,27,35,1,63,0.015625
"065950901","BUENOS AIRES",65,0,24,40,1,65,0
"065951201","BUENOS AIRES",34,0,8,26,0,34,0
"065393007","BUENOS AIRES",197,0,101,92,0,193,0
"065601113","BUENOS AIRES",421,3,268,150,0,418,0.00712589073634204
"066021201","BUENOS AIRES",43,0,14,28,0,42,0
"064344007","BUENOS AIRES",228,203,16,9,0,25,0.890350877192982
"065390912","BUENOS AIRES",371,1,216,147,0,363,0.00269541778975741
"066021301","BUENOS AIRES",69,1,52,15,0,67,0.0144927536231884
"068331505","BUENOS AIRES",9,0,8,1,0,9,0
"065393104","BUENOS AIRES",479,4,265,201,0,466,0.00835073068893528
"066090802","BUENOS AIRES",3,0,3,0,0,3,0
"066090803","BUENOS AIRES",1,0,1,0,0,1,0
"066091202","BUENOS AIRES",15,0,5,10,0,15,0
"066091303","BUENOS AIRES",4,0,3,1,0,4,0
"066091502","BUENOS AIRES",7,0,6,1,0,7,0
"065393206","BUENOS AIRES",395,1,167,204,0,371,0.00253164556962025
"066230704","BUENOS AIRES",16,0,1,15,0,16,0
"064201705","BUENOS AIRES",34,33,1,0,0,1,0.970588235294118
"065390911","BUENOS AIRES",191,42,83,57,3,143,0.219895287958115
"066230901","BUENOS AIRES",20,0,11,8,0,19,0
"066231603","BUENOS AIRES",15,0,3,12,0,15,0
"066232302","BUENOS AIRES",12,0,10,1,1,12,0
"066300301","BUENOS AIRES",43,0,3,35,3,41,0
"068402102","BUENOS AIRES",218,216,0,1,0,1,0.990825688073395
"020050204","CABA",461,460,1,0,0,1,0.997830802603037
"065390701","BUENOS AIRES",410,73,270,66,0,336,0.178048780487805
"066382001","BUENOS AIRES",24,0,10,14,0,24,0
"067700403","BUENOS AIRES",7,0,1,6,0,7,0
"066480405","BUENOS AIRES",19,2,4,11,0,15,0.105263157894737
"067700404","BUENOS AIRES",5,0,2,3,0,5,0
"066510302","BUENOS AIRES",9,0,3,5,0,8,0
"066510402","BUENOS AIRES",9,0,6,1,0,7,0
"066510403","BUENOS AIRES",15,0,0,15,0,15,0
"066511101","BUENOS AIRES",9,0,5,3,1,9,0
"066511103","BUENOS AIRES",7,0,4,3,0,7,0
"066511311","BUENOS AIRES",15,0,10,5,0,15,0
"066650304","BUENOS AIRES",17,0,0,17,0,17,0
"066650502","BUENOS AIRES",27,0,11,15,1,27,0
"067281026","BUENOS AIRES",13,0,0,13,0,13,0
"066720102","BUENOS AIRES",21,0,2,19,0,21,0
"066720103","BUENOS AIRES",8,0,1,6,0,7,0
"066720602","BUENOS AIRES",9,0,4,5,0,9,0
"066721103","BUENOS AIRES",15,0,2,13,0,15,0
"066721211","BUENOS AIRES",20,0,5,15,0,20,0
"066721303","BUENOS AIRES",19,0,6,13,0,19,0
"066721401","BUENOS AIRES",9,0,1,8,0,9,0
"066721402","BUENOS AIRES",51,0,25,25,0,50,0
"066790402","BUENOS AIRES",12,0,3,9,0,12,0
"066790405","BUENOS AIRES",6,0,5,1,0,6,0
"066790702","BUENOS AIRES",13,0,2,10,0,12,0
"066791204","BUENOS AIRES",31,0,7,22,0,29,0
"066860605","BUENOS AIRES",19,0,9,9,0,18,0
"065393212","BUENOS AIRES",44,1,26,14,0,40,0.0227272727272727
"066930202","BUENOS AIRES",40,0,20,20,0,40,0
"066930302","BUENOS AIRES",32,0,19,12,0,31,0
"066930303","BUENOS AIRES",58,1,36,19,0,55,0.0172413793103448
"066930304","BUENOS AIRES",58,0,32,25,0,57,0
"066930601","BUENOS AIRES",15,0,7,8,0,15,0
"066930602","BUENOS AIRES",15,0,12,3,0,15,0
"067000103","BUENOS AIRES",7,0,4,2,1,7,0
"067000301","BUENOS AIRES",7,0,3,4,0,7,0
"067000302","BUENOS AIRES",10,0,10,0,0,10,0
"067281102","BUENOS AIRES",31,0,0,23,2,25,0
"067281408","BUENOS AIRES",28,0,17,10,0,27,0
"067000401","BUENOS AIRES",16,0,8,7,0,15,0
"067000402","BUENOS AIRES",14,0,10,4,0,14,0
"067000601","BUENOS AIRES",3,0,2,1,0,3,0
"067000602","BUENOS AIRES",12,1,4,7,0,11,0.0833333333333333
"067000702","BUENOS AIRES",7,0,6,1,0,7,0
"067001102","BUENOS AIRES",5,0,5,0,0,5,0
"067070402","BUENOS AIRES",101,1,38,60,1,99,0.0099009900990099
"067700301","BUENOS AIRES",13,0,2,11,0,13,0
"067070502","BUENOS AIRES",32,0,13,18,1,32,0
"067070503","BUENOS AIRES",34,1,11,21,0,32,0.0294117647058824
"067140204","BUENOS AIRES",7,0,4,3,0,7,0
"065393307","BUENOS AIRES",425,1,182,222,2,406,0.00235294117647059
"067140504","BUENOS AIRES",59,0,36,19,2,57,0
"067140701","BUENOS AIRES",6,0,3,3,0,6,0
"067140803","BUENOS AIRES",8,0,0,8,0,8,0
"067280602","BUENOS AIRES",14,0,7,7,0,14,0
"067280603","BUENOS AIRES",4,0,0,4,0,4,0
"067210208","BUENOS AIRES",7,0,0,7,0,7,0
"067281023","BUENOS AIRES",55,0,16,35,2,53,0
"020152110","CABA",278,260,0,0,0,0,0.935251798561151
"067350205","BUENOS AIRES",43,0,30,13,0,43,0
"065393312","BUENOS AIRES",338,0,285,49,0,334,0
"067420201","BUENOS AIRES",57,1,14,42,0,56,0.0175438596491228
"067420412","BUENOS AIRES",3,0,2,1,0,3,0
"065393313","BUENOS AIRES",396,0,320,73,0,393,0
"020051601","CABA",404,401,3,0,0,3,0.992574257425743
"065393406","BUENOS AIRES",337,1,152,165,8,325,0.0029673590504451
"065393408","BUENOS AIRES",382,1,189,149,0,338,0.00261780104712042
"067491505","BUENOS AIRES",80,0,23,40,7,70,0
"067701301","BUENOS AIRES",12,0,5,7,0,12,0
"065390802","BUENOS AIRES",294,0,214,78,0,292,0
"067491510","BUENOS AIRES",120,0,60,44,13,117,0
"060210503","BUENOS AIRES",5,0,1,3,1,5,0
"067631203","BUENOS AIRES",22,0,6,16,0,22,0
"067631301","BUENOS AIRES",6,0,0,6,0,6,0
"067631501","BUENOS AIRES",24,0,6,16,2,24,0
"067631907","BUENOS AIRES",17,3,8,6,0,14,0.176470588235294
"068052613","BUENOS AIRES",84,0,44,35,4,83,0
"067700208","BUENOS AIRES",15,1,3,10,0,13,0.0666666666666667
"067701705","BUENOS AIRES",14,0,11,3,0,14,0
"067701903","BUENOS AIRES",8,0,2,6,0,8,0
"067780503","BUENOS AIRES",14,0,10,4,0,14,0
"067840404","BUENOS AIRES",6,0,2,4,0,6,0
"067840704","BUENOS AIRES",11,0,5,6,0,11,0
"067841203","BUENOS AIRES",26,2,3,21,0,24,0.0769230769230769
"067910905","BUENOS AIRES",30,0,16,11,2,29,0
"067911105","BUENOS AIRES",34,0,15,19,0,34,0
"067911601","BUENOS AIRES",29,0,10,19,0,29,0
"065470308","BUENOS AIRES",116,35,51,26,0,77,0.301724137931034
"065470309","BUENOS AIRES",261,140,44,75,1,120,0.53639846743295
"068052601","BUENOS AIRES",49,0,19,23,7,49,0
"065470904","BUENOS AIRES",446,339,52,54,0,106,0.760089686098655
"065530103","BUENOS AIRES",147,142,2,3,0,5,0.965986394557823
"065530107","BUENOS AIRES",58,51,7,0,0,7,0.879310344827586
"068120302","BUENOS AIRES",7,0,3,4,0,7,0
"065530108","BUENOS AIRES",86,85,0,1,0,1,0.988372093023256
"065530309","BUENOS AIRES",42,40,2,0,0,2,0.952380952380952
"065600101","BUENOS AIRES",394,4,185,190,1,376,0.0101522842639594
"065600201","BUENOS AIRES",397,1,203,184,0,387,0.00251889168765743
"065600203","BUENOS AIRES",414,0,189,205,4,398,0
"065600611","BUENOS AIRES",422,3,334,85,0,419,0.00710900473933649
"065600212","BUENOS AIRES",324,3,171,130,2,303,0.00925925925925926
"065600213","BUENOS AIRES",333,0,102,191,4,297,0
"065600405","BUENOS AIRES",322,15,221,74,0,295,0.046583850931677
"065600309","BUENOS AIRES",421,0,251,153,3,407,0
"065600410","BUENOS AIRES",363,6,232,119,2,353,0.0165289256198347
"065600504","BUENOS AIRES",357,5,166,177,2,345,0.0140056022408964
"065600601","BUENOS AIRES",375,2,238,129,1,368,0.00533333333333333
"065601215","BUENOS AIRES",262,4,198,58,1,257,0.0152671755725191
"065600602","BUENOS AIRES",431,0,230,198,0,428,0
"065600604","BUENOS AIRES",271,0,202,63,2,267,0
"065600607","BUENOS AIRES",1225,2,797,408,2,1207,0.00163265306122449
"065600618","BUENOS AIRES",288,1,122,147,9,278,0.00347222222222222
"068052616","BUENOS AIRES",57,0,36,12,7,55,0
"065180610","BUENOS AIRES",38,0,22,15,0,37,0
"065390808","BUENOS AIRES",544,4,338,180,1,519,0.00735294117647059
"065180612","BUENOS AIRES",75,0,63,12,0,75,0
"065600703","BUENOS AIRES",364,349,8,6,0,14,0.958791208791209
"065180713","BUENOS AIRES",130,0,104,26,0,130,0
"065180802","BUENOS AIRES",42,0,24,18,0,42,0
"065600706","BUENOS AIRES",454,280,48,115,0,163,0.616740088105727
"065600710","BUENOS AIRES",209,0,99,102,1,202,0
"065250105","BUENOS AIRES",284,134,85,59,0,144,0.471830985915493
"065250409","BUENOS AIRES",338,335,3,0,0,3,0.99112426035503
"065320204","BUENOS AIRES",282,277,3,2,0,5,0.982269503546099
"065390905","BUENOS AIRES",389,3,212,152,1,365,0.0077120822622108
"065321402","BUENOS AIRES",287,273,12,2,0,14,0.951219512195122
"065321501","BUENOS AIRES",262,213,35,14,0,49,0.812977099236641
"065390107","BUENOS AIRES",308,54,89,125,1,215,0.175324675324675
"065390204","BUENOS AIRES",437,211,162,58,0,220,0.482837528604119
"065390208","BUENOS AIRES",433,400,5,3,0,8,0.92378752886836
"065390304","BUENOS AIRES",335,2,249,76,0,325,0.00597014925373134
"065390308","BUENOS AIRES",191,188,2,1,0,3,0.984293193717278
"065390410","BUENOS AIRES",267,267,0,0,0,0,1
"065390506","BUENOS AIRES",270,196,58,14,0,72,0.725925925925926
"065390602","BUENOS AIRES",250,7,204,36,0,240,0.028
"065390908","BUENOS AIRES",447,0,298,133,3,434,0
"065391013","BUENOS AIRES",425,2,288,125,1,414,0.00470588235294118
"065391108","BUENOS AIRES",528,4,387,127,0,514,0.00757575757575758
"065391110","BUENOS AIRES",374,0,225,139,0,364,0
"065391111","BUENOS AIRES",378,3,237,125,0,362,0.00793650793650794
"065391113","BUENOS AIRES",336,1,228,104,1,333,0.00297619047619048
"065391115","BUENOS AIRES",404,0,257,130,4,391,0
"067561005","BUENOS AIRES",197,197,0,0,0,0,1
"064131404","BUENOS AIRES",24,24,0,0,0,0,1
"064200511","BUENOS AIRES",83,79,2,1,0,3,0.951807228915663
"064275504","BUENOS AIRES",271,252,10,8,0,18,0.929889298892989
"065810107","BUENOS AIRES",278,270,4,4,0,8,0.971223021582734
"066580809","BUENOS AIRES",292,292,0,0,0,0,1
"067490902","BUENOS AIRES",372,346,18,7,0,25,0.93010752688172
"060350101","BUENOS AIRES",731,101,129,394,54,577,0.138166894664843
"061260916","BUENOS AIRES",60,19,26,15,0,41,0.316666666666667
"063920303","BUENOS AIRES",18,0,3,15,0,18,0
"060420901","BUENOS AIRES",93,1,18,71,0,89,0.010752688172043
"020031906","CABA",336,333,2,0,0,2,0.991071428571429
"060700301","BUENOS AIRES",53,0,31,22,0,53,0
"061190501","BUENOS AIRES",73,0,66,6,0,72,0
"061260601","BUENOS AIRES",117,0,72,45,0,117,0
"061260605","BUENOS AIRES",102,0,83,19,0,102,0
"061680804","BUENOS AIRES",6,0,4,2,0,6,0
"062870416","BUENOS AIRES",28,0,10,18,0,28,0
"020021808","CABA",335,335,0,0,0,0,1
"065682404","BUENOS AIRES",384,359,20,5,0,25,0.934895833333333
"065681814","BUENOS AIRES",223,1,205,17,0,222,0.00448430493273543
"061750102","BUENOS AIRES",30,0,6,22,1,29,0
"061750204","BUENOS AIRES",2,0,2,0,0,2,0
"061750417","BUENOS AIRES",97,12,32,48,0,80,0.123711340206186
"061750613","BUENOS AIRES",592,425,37,127,1,165,0.717905405405405
"062171201","BUENOS AIRES",245,0,144,101,0,245,0
"062600310","BUENOS AIRES",471,463,3,5,0,8,0.983014861995754
"062700806","BUENOS AIRES",32,6,17,9,0,26,0.1875
"063220611","BUENOS AIRES",53,1,18,32,0,50,0.0188679245283019
"065392903","BUENOS AIRES",77,12,24,37,0,61,0.155844155844156
"064416815","BUENOS AIRES",147,0,79,60,2,141,0
"063921207","BUENOS AIRES",109,0,62,44,1,107,0
"064131402","BUENOS AIRES",36,0,7,29,0,36,0
"064131201","BUENOS AIRES",0,0,0,0,0,0,NA
"063640317","BUENOS AIRES",94,5,39,50,0,89,0.0531914893617021
"064416520","BUENOS AIRES",209,1,63,108,19,190,0.00478468899521531
"064416812","BUENOS AIRES",96,1,61,32,1,94,0.0104166666666667
"064620404","BUENOS AIRES",38,0,2,36,0,38,0
"066790904","BUENOS AIRES",79,0,36,43,0,79,0
"063640413","BUENOS AIRES",200,0,68,121,1,190,0
"066650208","BUENOS AIRES",284,131,84,65,2,151,0.461267605633803
"065950601","BUENOS AIRES",83,13,35,33,1,69,0.156626506024096
"065681904","BUENOS AIRES",241,241,0,0,0,0,1
"063640501","BUENOS AIRES",309,0,120,167,4,291,0
"063851002","BUENOS AIRES",465,288,72,101,1,174,0.619354838709677
"067840202","BUENOS AIRES",160,5,43,95,16,154,0.03125
"068261803","BUENOS AIRES",30,0,19,9,0,28,0
"063920903","BUENOS AIRES",102,0,39,54,1,94,0
"064970609","BUENOS AIRES",188,100,54,32,1,87,0.531914893617021
"068331304","BUENOS AIRES",54,0,41,13,0,54,0
"065180113","BUENOS AIRES",17,3,10,4,0,14,0.176470588235294
"065250504","BUENOS AIRES",118,2,51,64,1,116,0.0169491525423729
"065320904","BUENOS AIRES",196,2,98,88,0,186,0.0102040816326531
"065320910","BUENOS AIRES",828,12,276,490,1,767,0.0144927536231884
"065391007","BUENOS AIRES",717,1,318,355,16,689,0.00139470013947001
"065740802","BUENOS AIRES",28,0,12,16,0,28,0
"065811307","BUENOS AIRES",88,2,23,58,1,82,0.0227272727272727
"065682310","BUENOS AIRES",254,253,1,0,0,1,0.996062992125984
"065880903","BUENOS AIRES",149,70,51,28,0,79,0.469798657718121
"065682405","BUENOS AIRES",359,342,12,5,0,17,0.952646239554318
"066860203","BUENOS AIRES",28,1,11,16,0,27,0.0357142857142857
"066860603","BUENOS AIRES",24,0,10,14,0,24,0
"066860701","BUENOS AIRES",21,0,7,14,0,21,0
"067140804","BUENOS AIRES",41,0,6,34,1,41,0
"067350404","BUENOS AIRES",124,7,82,35,0,117,0.0564516129032258
"068331302","BUENOS AIRES",106,0,83,23,0,106,0
"068331809","BUENOS AIRES",127,1,58,68,0,126,0.0078740157480315
"068750801","BUENOS AIRES",66,1,45,15,0,60,0.0151515151515152
"065681910","BUENOS AIRES",222,174,24,24,0,48,0.783783783783784
"065682014","BUENOS AIRES",244,235,4,4,0,8,0.963114754098361
"065682105","BUENOS AIRES",142,142,0,0,0,0,1
"065682113","BUENOS AIRES",371,336,23,12,0,35,0.905660377358491
"065682210","BUENOS AIRES",188,132,49,7,0,56,0.702127659574468
"065682308","BUENOS AIRES",412,408,3,1,0,4,0.990291262135922
"065682309","BUENOS AIRES",336,326,4,5,0,9,0.970238095238095
"068820813","BUENOS AIRES",433,124,41,231,0,272,0.286374133949192
"062170505","BUENOS AIRES",56,0,29,26,1,56,0
"065681409","BUENOS AIRES",348,348,0,0,0,0,1
"065681810","BUENOS AIRES",318,99,170,49,0,219,0.311320754716981
"065681603","BUENOS AIRES",267,18,204,44,0,248,0.0674157303370786
"065681610","BUENOS AIRES",374,166,194,14,0,208,0.443850267379679
"065681701","BUENOS AIRES",346,9,286,50,0,336,0.0260115606936416
"065682505","BUENOS AIRES",216,209,2,5,0,7,0.967592592592593
"065682601","BUENOS AIRES",233,230,3,0,0,3,0.987124463519313
"065682608","BUENOS AIRES",227,104,109,13,0,122,0.458149779735683
"068050307","BUENOS AIRES",411,406,4,0,0,4,0.987834549878346
"065682703","BUENOS AIRES",305,0,223,67,0,290,0
"065682801","BUENOS AIRES",445,1,341,101,0,442,0.00224719101123596
"065682805","BUENOS AIRES",445,2,287,148,1,436,0.00449438202247191
"065682904","BUENOS AIRES",287,1,181,94,0,275,0.00348432055749129
"065682910","BUENOS AIRES",281,2,175,96,0,271,0.00711743772241993
"065683110","BUENOS AIRES",296,7,170,100,1,271,0.0236486486486486
"065740402","BUENOS AIRES",374,50,125,199,0,324,0.133689839572193
"065740410","BUENOS AIRES",370,296,20,35,0,55,0.8
"065950403","BUENOS AIRES",298,184,29,85,0,114,0.61744966442953
"020031706","CABA",327,322,0,2,0,2,0.984709480122324
"065810108","BUENOS AIRES",265,202,30,31,0,61,0.762264150943396
"065810109","BUENOS AIRES",277,235,2,39,0,41,0.848375451263538
"065810204","BUENOS AIRES",253,250,0,3,0,3,0.988142292490119
"065810707","BUENOS AIRES",39,0,13,25,0,38,0
"065811705","BUENOS AIRES",274,273,1,0,0,1,0.996350364963504
"065811302","BUENOS AIRES",223,221,1,0,0,1,0.991031390134529
"065811305","BUENOS AIRES",281,277,0,4,0,4,0.98576512455516
"068052501","BUENOS AIRES",309,2,198,98,3,299,0.00647249190938511
"065811508","BUENOS AIRES",282,253,8,17,1,26,0.897163120567376
"065811607","BUENOS AIRES",263,226,22,13,2,37,0.859315589353612
"065811805","BUENOS AIRES",111,110,0,0,0,0,0.990990990990991
"065811809","BUENOS AIRES",102,102,0,0,0,0,1
"065811904","BUENOS AIRES",138,96,22,20,0,42,0.695652173913043
"065811910","BUENOS AIRES",166,137,9,20,0,29,0.825301204819277
"220211101","CHACO",51,1,9,20,14,43,0.0196078431372549
"065880101","BUENOS AIRES",357,326,13,16,1,30,0.913165266106443
"065880107","BUENOS AIRES",234,215,10,9,0,19,0.918803418803419
"065880116","BUENOS AIRES",242,165,28,47,1,76,0.681818181818182
"065880117","BUENOS AIRES",237,115,60,62,0,122,0.485232067510549
"065880203","BUENOS AIRES",243,201,19,22,0,41,0.827160493827161
"065880206","BUENOS AIRES",198,198,0,0,0,0,1
"065880301","BUENOS AIRES",153,44,28,77,0,105,0.287581699346405
"065880908","BUENOS AIRES",310,23,118,165,2,285,0.0741935483870968
"065880909","BUENOS AIRES",291,187,66,38,0,104,0.642611683848797
"065880912","BUENOS AIRES",346,80,97,162,1,260,0.23121387283237
"065881501","BUENOS AIRES",122,1,61,59,1,121,0.00819672131147541
"065881701","BUENOS AIRES",298,289,5,4,0,9,0.969798657718121
"065950106","BUENOS AIRES",272,262,4,6,0,10,0.963235294117647
"065950202","BUENOS AIRES",315,300,10,4,0,14,0.952380952380952
"065950204","BUENOS AIRES",324,324,0,0,0,0,1
"900141221","TUCUMAN",159,0,73,73,2,148,0
"065951904","BUENOS AIRES",134,9,79,43,1,123,0.0671641791044776
"065951909","BUENOS AIRES",132,1,72,58,0,130,0.00757575757575758
"065952406","BUENOS AIRES",276,260,9,6,0,15,0.942028985507246
"065952706","BUENOS AIRES",60,1,46,13,0,59,0.0166666666666667
"065952607","BUENOS AIRES",326,187,47,86,1,134,0.573619631901841
"066020201","BUENOS AIRES",152,3,97,34,11,142,0.0197368421052632
"066090210","BUENOS AIRES",255,236,11,7,0,18,0.925490196078431
"066021406","BUENOS AIRES",44,2,23,17,1,41,0.0454545454545455
"068331904","BUENOS AIRES",256,168,48,36,1,85,0.65625
"066021608","BUENOS AIRES",255,231,18,5,0,23,0.905882352941176
"066021610","BUENOS AIRES",314,265,32,14,0,46,0.843949044585987
"066090103","BUENOS AIRES",330,187,86,57,0,143,0.566666666666667
"066090105","BUENOS AIRES",285,269,14,2,0,16,0.943859649122807
"066090211","BUENOS AIRES",339,12,188,137,2,327,0.0353982300884956
"066091701","BUENOS AIRES",325,6,233,84,0,317,0.0184615384615385
"066091707","BUENOS AIRES",23,0,13,10,0,23,0
"067491405","BUENOS AIRES",317,301,3,3,0,6,0.949526813880126
"066091907","BUENOS AIRES",372,178,149,45,0,194,0.478494623655914
"068401009","BUENOS AIRES",187,186,1,0,0,1,0.994652406417112
"066160302","BUENOS AIRES",289,192,41,54,0,95,0.664359861591695
"066160303","BUENOS AIRES",256,197,21,37,0,58,0.76953125
"066230102","BUENOS AIRES",379,314,37,25,0,62,0.828496042216359
"066230108","BUENOS AIRES",389,359,9,20,1,30,0.922879177377892
"066230109","BUENOS AIRES",282,248,16,15,0,31,0.879432624113475
"066230204","BUENOS AIRES",313,309,2,2,0,4,0.987220447284345
"066230305","BUENOS AIRES",255,255,0,0,0,0,1
"066230402","BUENOS AIRES",320,316,2,2,0,4,0.9875
"066582504","BUENOS AIRES",234,229,3,1,0,4,0.978632478632479
"066231104","BUENOS AIRES",179,0,56,118,5,179,0
"066231803","BUENOS AIRES",215,1,134,78,0,212,0.00465116279069767
"066232101","BUENOS AIRES",139,0,81,56,1,138,0
"066232204","BUENOS AIRES",294,209,20,65,0,85,0.710884353741497
"066232811","BUENOS AIRES",179,72,40,64,1,105,0.402234636871508
"066232904","BUENOS AIRES",184,131,5,37,0,42,0.71195652173913
"066232907","BUENOS AIRES",328,23,64,228,2,294,0.0701219512195122
"066300202","BUENOS AIRES",280,250,21,8,0,29,0.892857142857143
"066380110","BUENOS AIRES",449,1,195,227,4,426,0.0022271714922049
"066380213","BUENOS AIRES",294,1,213,77,0,290,0.00340136054421769
"066381306","BUENOS AIRES",527,1,203,302,4,509,0.00189753320683112
"060561006","BUENOS AIRES",171,170,1,0,0,1,0.994152046783626
"066380202","BUENOS AIRES",386,33,315,38,0,353,0.0854922279792746
"066380402","BUENOS AIRES",451,3,278,160,0,438,0.00665188470066519
"066380404","BUENOS AIRES",235,1,152,82,0,234,0.00425531914893617
"066380502","BUENOS AIRES",65,28,37,0,0,37,0.430769230769231
"066380512","BUENOS AIRES",296,4,173,114,0,287,0.0135135135135135
"066380603","BUENOS AIRES",412,8,252,145,2,399,0.0194174757281553
"066380612","BUENOS AIRES",306,7,213,85,1,299,0.0228758169934641
"066380614","BUENOS AIRES",446,1,331,107,0,438,0.00224215246636771
"066380704","BUENOS AIRES",339,3,207,123,0,330,0.00884955752212389
"066440622","BUENOS AIRES",158,2,91,64,1,156,0.0126582278481013
"066380711","BUENOS AIRES",237,0,173,63,0,236,0
"020012006","CABA",336,335,1,0,0,1,0.99702380952381
"066380803","BUENOS AIRES",295,243,44,8,0,52,0.823728813559322
"066380807","BUENOS AIRES",167,5,128,33,0,161,0.029940119760479
"066380813","BUENOS AIRES",125,9,80,34,1,115,0.072
"066380903","BUENOS AIRES",287,1,196,82,1,279,0.00348432055749129
"066380907","BUENOS AIRES",575,1,254,305,0,559,0.00173913043478261
"066381203","BUENOS AIRES",388,5,301,77,1,379,0.0128865979381443
"066480507","BUENOS AIRES",466,9,254,190,4,448,0.01931330472103
"066480109","BUENOS AIRES",258,1,155,95,1,251,0.00387596899224806
"066381210","BUENOS AIRES",105,0,49,55,0,104,0
"066480508","BUENOS AIRES",263,2,155,103,0,258,0.00760456273764259
"066381312","BUENOS AIRES",239,232,6,1,0,7,0.97071129707113
"066381316","BUENOS AIRES",190,0,53,111,1,165,0
"066381409","BUENOS AIRES",356,5,135,198,2,335,0.0140449438202247
"066381508","BUENOS AIRES",464,237,109,114,0,223,0.510775862068966
"066381510","BUENOS AIRES",405,92,105,194,1,300,0.22716049382716
"066381602","BUENOS AIRES",203,199,4,0,0,4,0.980295566502463
"066381604","BUENOS AIRES",229,216,2,11,0,13,0.943231441048035
"066381605","BUENOS AIRES",199,137,46,16,0,62,0.688442211055276
"066381701","BUENOS AIRES",308,113,113,79,1,193,0.366883116883117
"066381809","BUENOS AIRES",313,13,107,192,0,299,0.0415335463258786
"066382301","BUENOS AIRES",207,0,93,95,2,190,0
"066440205","BUENOS AIRES",36,30,5,1,0,6,0.833333333333333
"066381901","BUENOS AIRES",301,6,198,91,4,293,0.0199335548172757
"067630306","BUENOS AIRES",308,305,0,0,0,0,0.99025974025974
"066382201","BUENOS AIRES",582,14,284,277,0,561,0.0240549828178694
"066382003","BUENOS AIRES",304,61,164,78,0,242,0.200657894736842
"066382009","BUENOS AIRES",230,1,153,64,2,219,0.00434782608695652
"066440613","BUENOS AIRES",241,8,156,73,3,232,0.033195020746888
"066382107","BUENOS AIRES",260,249,5,6,0,11,0.957692307692308
"066382207","BUENOS AIRES",230,5,128,95,0,223,0.0217391304347826
"066382212","BUENOS AIRES",153,3,91,53,0,144,0.0196078431372549
"066581704","BUENOS AIRES",291,291,0,0,0,0,1
"066440308","BUENOS AIRES",34,2,27,5,0,32,0.0588235294117647
"066440312","BUENOS AIRES",31,1,25,5,0,30,0.032258064516129
"066440602","BUENOS AIRES",154,2,78,70,4,152,0.012987012987013
"068751614","BUENOS AIRES",294,2,114,153,7,274,0.00680272108843537
"066440407","BUENOS AIRES",47,33,12,2,0,14,0.702127659574468
"066440508","BUENOS AIRES",101,97,2,1,0,3,0.96039603960396
"066440607","BUENOS AIRES",179,6,94,77,0,171,0.0335195530726257
"066580605","BUENOS AIRES",314,313,1,0,0,1,0.996815286624204
"066480118","BUENOS AIRES",299,7,106,168,1,275,0.0234113712374582
"066480201","BUENOS AIRES",391,4,163,209,3,375,0.010230179028133
"066480205","BUENOS AIRES",299,2,101,146,12,259,0.00668896321070234
"066480207","BUENOS AIRES",410,1,216,166,2,384,0.0024390243902439
"066480208","BUENOS AIRES",375,36,170,154,3,327,0.096
"066480401","BUENOS AIRES",290,0,148,128,4,280,0
"066480509","BUENOS AIRES",457,8,330,113,1,444,0.0175054704595186
"066510106","BUENOS AIRES",205,7,123,72,2,197,0.0341463414634146
"066510714","BUENOS AIRES",254,4,176,67,2,245,0.015748031496063
"066510818","BUENOS AIRES",155,2,113,40,0,153,0.0129032258064516
"066511310","BUENOS AIRES",75,0,55,18,1,74,0
"066580603","BUENOS AIRES",314,314,0,0,0,0,1
"066580608","BUENOS AIRES",174,172,2,0,0,2,0.988505747126437
"066580708","BUENOS AIRES",376,162,44,165,4,213,0.430851063829787
"066580804","BUENOS AIRES",328,328,0,0,0,0,1
"066580908","BUENOS AIRES",166,166,0,0,0,0,1
"066580911","BUENOS AIRES",188,187,1,0,0,1,0.99468085106383
"066550304","BUENOS AIRES",41,1,21,19,0,40,0.024390243902439
"066550211","BUENOS AIRES",176,20,104,51,0,155,0.113636363636364
"066580302","BUENOS AIRES",329,4,20,243,16,279,0.0121580547112462
"066580402","BUENOS AIRES",336,203,59,74,0,133,0.604166666666667
"066580408","BUENOS AIRES",401,393,4,2,0,6,0.980049875311721
"540282021","MISIONES",290,4,128,117,26,271,0.0137931034482759
"066550302","BUENOS AIRES",33,1,22,7,1,30,0.0303030303030303
"066580103","BUENOS AIRES",350,341,9,0,0,9,0.974285714285714
"066581003","BUENOS AIRES",264,256,4,2,0,6,0.96969696969697
"066581705","BUENOS AIRES",322,319,1,0,0,1,0.990683229813665
"066580301","BUENOS AIRES",313,8,31,252,2,285,0.0255591054313099
"066582405","BUENOS AIRES",309,304,4,1,0,5,0.983818770226537
"066580413","BUENOS AIRES",239,228,5,5,0,10,0.95397489539749
"066580506","BUENOS AIRES",307,286,1,1,0,2,0.931596091205212
"020061701","CABA",416,416,0,0,0,0,1
"066581006","BUENOS AIRES",229,228,1,0,0,1,0.995633187772926
"066581104","BUENOS AIRES",206,204,0,1,0,1,0.990291262135922
"066581106","BUENOS AIRES",272,256,11,5,0,16,0.941176470588235
"067071112","BUENOS AIRES",205,100,52,48,0,100,0.48780487804878
"066581203","BUENOS AIRES",411,407,2,2,0,4,0.990267639902676
"066581204","BUENOS AIRES",398,395,2,0,0,2,0.992462311557789
"066581206","BUENOS AIRES",307,307,0,0,0,0,1
"066581208","BUENOS AIRES",308,308,0,0,0,0,1
"066581212","BUENOS AIRES",337,337,0,0,0,0,1
"066582411","BUENOS AIRES",245,239,5,1,0,6,0.975510204081633
"066581307","BUENOS AIRES",273,27,52,177,2,231,0.0989010989010989
"066581407","BUENOS AIRES",261,54,44,148,4,196,0.206896551724138
"066581603","BUENOS AIRES",241,241,0,0,0,0,1
"066581610","BUENOS AIRES",221,220,0,1,0,1,0.995475113122172
"064902407","BUENOS AIRES",211,210,1,0,0,1,0.995260663507109
"066581801","BUENOS AIRES",132,130,2,0,0,2,0.984848484848485
"066581907","BUENOS AIRES",187,185,1,1,0,2,0.989304812834225
"066582003","BUENOS AIRES",421,395,10,11,0,21,0.938242280285036
"066582004","BUENOS AIRES",349,325,13,7,0,20,0.931232091690544
"066582005","BUENOS AIRES",361,322,12,18,1,31,0.89196675900277
"066582116","BUENOS AIRES",283,50,41,178,4,223,0.176678445229682
"066582202","BUENOS AIRES",329,328,1,0,0,1,0.996960486322188
"066582205","BUENOS AIRES",232,230,0,2,0,2,0.991379310344828
"066582311","BUENOS AIRES",325,290,6,20,0,26,0.892307692307692
"066582508","BUENOS AIRES",331,310,7,14,0,21,0.936555891238671
"066582606","BUENOS AIRES",341,292,24,22,1,47,0.856304985337243
"066582609","BUENOS AIRES",241,238,1,2,0,3,0.987551867219917
"066582713","BUENOS AIRES",307,33,54,216,0,270,0.107491856677524
"066582903","BUENOS AIRES",219,211,3,5,0,8,0.963470319634703
"066582907","BUENOS AIRES",374,13,112,236,2,350,0.0347593582887701
"066583103","BUENOS AIRES",658,620,20,18,0,38,0.942249240121581
"066583106","BUENOS AIRES",1053,980,21,48,0,69,0.930674264007597
"066583108","BUENOS AIRES",230,155,42,32,0,74,0.673913043478261
"066583113","BUENOS AIRES",199,5,103,90,0,193,0.0251256281407035
"066583305","BUENOS AIRES",637,29,100,472,7,579,0.0455259026687598
"066583307","BUENOS AIRES",408,373,16,8,0,24,0.91421568627451
"066583308","BUENOS AIRES",204,190,3,9,0,12,0.931372549019608
"066583405","BUENOS AIRES",314,192,60,58,0,118,0.611464968152866
"066583406","BUENOS AIRES",400,388,7,5,0,12,0.97
"066583503","BUENOS AIRES",281,14,146,118,0,264,0.0498220640569395
"066583702","BUENOS AIRES",633,22,44,507,20,571,0.0347551342812006
"066583813","BUENOS AIRES",329,282,23,20,0,43,0.857142857142857
"066583902","BUENOS AIRES",418,330,45,36,1,82,0.789473684210526
"066583910","BUENOS AIRES",521,16,191,298,3,492,0.0307101727447217
"020061206","CABA",243,241,0,0,0,0,0.991769547325103
"066584004","BUENOS AIRES",456,8,92,313,23,428,0.0175438596491228
"066584012","BUENOS AIRES",389,10,160,209,0,369,0.025706940874036
"066584017","BUENOS AIRES",487,15,196,239,2,437,0.0308008213552361
"066584105","BUENOS AIRES",426,37,188,191,0,379,0.0868544600938967
"066584106","BUENOS AIRES",475,125,157,187,0,344,0.263157894736842
"066584115","BUENOS AIRES",310,114,47,122,1,170,0.367741935483871
"066584401","BUENOS AIRES",329,13,178,101,31,310,0.0395136778115502
"066584407","BUENOS AIRES",229,8,164,54,0,218,0.0349344978165939
"066650302","BUENOS AIRES",285,191,19,71,1,91,0.670175438596491
"068402403","BUENOS AIRES",202,181,3,16,0,19,0.896039603960396
"066650309","BUENOS AIRES",286,215,10,53,0,63,0.751748251748252
"066650310","BUENOS AIRES",457,443,10,4,0,14,0.969365426695842
"066651303","BUENOS AIRES",308,256,12,37,1,50,0.831168831168831
"066651305","BUENOS AIRES",419,355,17,36,0,53,0.847255369928401
"066651308","BUENOS AIRES",255,190,27,35,1,63,0.745098039215686
"067911307","BUENOS AIRES",246,129,49,68,0,117,0.524390243902439
"066651309","BUENOS AIRES",377,256,13,92,0,105,0.679045092838196
"066721202","BUENOS AIRES",263,253,5,5,0,10,0.961977186311787
"066721204","BUENOS AIRES",376,354,13,7,1,21,0.941489361702128
"066790303","BUENOS AIRES",159,0,126,31,1,158,0
"066790905","BUENOS AIRES",165,1,77,84,1,162,0.00606060606060606
"066860102","BUENOS AIRES",418,372,12,11,0,23,0.889952153110048
"067350308","BUENOS AIRES",182,0,85,91,0,176,0
"066860108","BUENOS AIRES",254,247,4,3,0,7,0.97244094488189
"067071113","BUENOS AIRES",341,139,108,90,0,198,0.407624633431085
"067281019","BUENOS AIRES",303,101,95,106,1,202,0.333333333333333
"066861310","BUENOS AIRES",299,278,9,12,0,21,0.929765886287625
"066930703","BUENOS AIRES",92,0,58,34,0,92,0
"067000603","BUENOS AIRES",152,2,121,29,0,150,0.0131578947368421
"067210201","BUENOS AIRES",232,137,56,39,0,95,0.59051724137931
"067001213","BUENOS AIRES",199,186,9,4,0,13,0.934673366834171
"067070104","BUENOS AIRES",227,145,25,54,1,80,0.638766519823789
"067070105","BUENOS AIRES",396,338,16,39,2,57,0.853535353535353
"067070110","BUENOS AIRES",237,159,20,55,3,78,0.670886075949367
"067070115","BUENOS AIRES",247,31,133,80,2,215,0.125506072874494
"540282020","MISIONES",200,2,152,37,6,195,0.01
"067070116","BUENOS AIRES",178,10,78,87,1,166,0.0561797752808989
"067070117","BUENOS AIRES",295,5,90,196,1,287,0.0169491525423729
"067070501","BUENOS AIRES",77,0,33,43,0,76,0
"067071104","BUENOS AIRES",377,247,47,82,0,129,0.655172413793103
"067140104","BUENOS AIRES",321,299,14,8,0,22,0.931464174454829
"067140611","BUENOS AIRES",328,121,99,104,3,206,0.36890243902439
"067140801","BUENOS AIRES",138,0,72,63,2,137,0
"067490508","BUENOS AIRES",170,170,0,0,0,0,1
"067210202","BUENOS AIRES",108,75,25,8,0,33,0.694444444444444
"067490306","BUENOS AIRES",167,163,3,1,0,4,0.976047904191617
"067281021","BUENOS AIRES",267,67,107,92,1,200,0.250936329588015
"067281301","BUENOS AIRES",156,0,60,95,0,155,0
"067350201","BUENOS AIRES",184,0,61,120,2,183,0
"067350701","BUENOS AIRES",229,49,70,109,0,179,0.213973799126638
"067350704","BUENOS AIRES",149,2,54,92,0,146,0.0134228187919463
"067420414","BUENOS AIRES",192,100,30,58,1,89,0.520833333333333
"067490104","BUENOS AIRES",132,3,31,82,1,114,0.0227272727272727
"067490210","BUENOS AIRES",347,339,6,2,0,8,0.976945244956772
"067490602","BUENOS AIRES",331,330,1,0,0,1,0.996978851963746
"067490704","BUENOS AIRES",369,187,118,64,0,182,0.506775067750677
"067490705","BUENOS AIRES",451,334,54,61,0,115,0.740576496674058
"067490807","BUENOS AIRES",453,391,20,37,0,57,0.863134657836645
"067490904","BUENOS AIRES",429,406,17,6,0,23,0.946386946386946
"067491005","BUENOS AIRES",418,397,12,7,0,19,0.949760765550239
"067491108","BUENOS AIRES",182,170,6,0,0,6,0.934065934065934
"067491208","BUENOS AIRES",340,340,0,0,0,0,1
"060351709","BUENOS AIRES",273,11,88,173,1,262,0.0402930402930403
"067491401","BUENOS AIRES",199,160,8,6,0,14,0.804020100502513
"067491403","BUENOS AIRES",285,255,8,6,0,14,0.894736842105263
"067491404","BUENOS AIRES",289,268,6,11,0,17,0.927335640138408
"067560209","BUENOS AIRES",302,301,1,0,0,1,0.996688741721854
"067560401","BUENOS AIRES",265,254,4,5,2,11,0.958490566037736
"067560503","BUENOS AIRES",243,241,2,0,0,2,0.991769547325103
"067600211","BUENOS AIRES",267,263,4,0,0,4,0.98501872659176
"067562704","BUENOS AIRES",320,298,2,5,0,7,0.93125
"067560508","BUENOS AIRES",279,279,0,0,0,0,1
"067560509","BUENOS AIRES",245,243,0,0,0,0,0.991836734693878
"067560510","BUENOS AIRES",261,261,0,0,0,0,1
"067560707","BUENOS AIRES",304,303,1,0,0,1,0.996710526315789
"067560902","BUENOS AIRES",184,178,4,2,0,6,0.967391304347826
"067560903","BUENOS AIRES",336,330,4,2,0,6,0.982142857142857
"067560907","BUENOS AIRES",415,406,6,3,0,9,0.978313253012048
"067561001","BUENOS AIRES",221,220,1,0,0,1,0.995475113122172
"067561010","BUENOS AIRES",322,320,2,0,0,2,0.993788819875776
"067561105","BUENOS AIRES",357,357,0,0,0,0,1
"067561112","BUENOS AIRES",335,334,0,0,0,0,0.997014925373134
"067561208","BUENOS AIRES",355,353,1,1,0,2,0.994366197183099
"067561314","BUENOS AIRES",512,501,6,3,0,9,0.978515625
"067561406","BUENOS AIRES",252,231,15,6,0,21,0.916666666666667
"067561506","BUENOS AIRES",293,266,20,6,0,26,0.907849829351536
"067561512","BUENOS AIRES",209,178,17,14,0,31,0.851674641148325
"067561606","BUENOS AIRES",191,165,23,3,0,26,0.863874345549738
"067561607","BUENOS AIRES",279,276,3,0,0,3,0.989247311827957
"067600306","BUENOS AIRES",228,219,6,3,0,9,0.960526315789474
"067561608","BUENOS AIRES",286,244,24,18,0,42,0.853146853146853
"067561708","BUENOS AIRES",407,396,7,3,0,10,0.972972972972973
"067561802","BUENOS AIRES",394,391,3,0,0,3,0.99238578680203
"067561810","BUENOS AIRES",301,300,1,0,0,1,0.996677740863787
"067561906","BUENOS AIRES",432,429,1,2,0,3,0.993055555555556
"067561908","BUENOS AIRES",439,428,4,7,0,11,0.9749430523918
"067561909","BUENOS AIRES",393,380,7,6,0,13,0.966921119592875
"067562711","BUENOS AIRES",453,4,365,82,0,447,0.00883002207505519
"060911103","BUENOS AIRES",206,204,1,1,0,2,0.990291262135922
"067562105","BUENOS AIRES",252,204,32,16,0,48,0.80952380952381
"067600311","BUENOS AIRES",351,341,9,1,0,10,0.971509971509972
"067600312","BUENOS AIRES",76,55,12,9,0,21,0.723684210526316
"300280809","ENTRE RIOS",307,295,2,3,1,6,0.960912052117264
"067562109","BUENOS AIRES",298,3,264,31,0,295,0.0100671140939597
"067562110","BUENOS AIRES",77,4,53,20,0,73,0.051948051948052
"067562205","BUENOS AIRES",345,10,158,175,0,333,0.0289855072463768
"067562301","BUENOS AIRES",600,552,7,2,0,9,0.92
"067562304","BUENOS AIRES",412,387,11,12,0,23,0.939320388349515
"067562410","BUENOS AIRES",257,256,1,0,0,1,0.996108949416342
"067562508","BUENOS AIRES",190,9,131,45,0,176,0.0473684210526316
"067562602","BUENOS AIRES",255,240,14,0,0,14,0.941176470588235
"067562607","BUENOS AIRES",393,368,22,2,0,24,0.936386768447837
"067562701","BUENOS AIRES",456,420,6,13,0,19,0.921052631578947
"067600104","BUENOS AIRES",304,220,50,25,0,75,0.723684210526316
"067600304","BUENOS AIRES",294,276,12,3,0,15,0.938775510204082
"067600509","BUENOS AIRES",460,406,40,8,0,48,0.882608695652174
"067600511","BUENOS AIRES",782,697,67,16,0,83,0.891304347826087
"067600609","BUENOS AIRES",425,1,196,209,2,407,0.00235294117647059
"067600702","BUENOS AIRES",559,398,58,93,3,154,0.711985688729875
"067600706","BUENOS AIRES",254,1,222,26,0,248,0.00393700787401575
"067600709","BUENOS AIRES",367,0,326,41,0,367,0
"067600801","BUENOS AIRES",338,317,13,7,0,20,0.937869822485207
"067600806","BUENOS AIRES",363,303,51,9,0,60,0.834710743801653
"067601006","BUENOS AIRES",61,0,34,26,0,60,0
"067630115","BUENOS AIRES",391,356,22,13,0,35,0.910485933503836
"067601108","BUENOS AIRES",595,4,415,169,0,584,0.00672268907563025
"067601207","BUENOS AIRES",111,28,76,7,0,83,0.252252252252252
"067601215","BUENOS AIRES",312,2,227,73,1,301,0.00641025641025641
"067601218","BUENOS AIRES",237,1,32,182,3,217,0.00421940928270042
"067601301","BUENOS AIRES",196,0,140,56,0,196,0
"067601312","BUENOS AIRES",331,0,258,71,1,330,0
"067601403","BUENOS AIRES",302,3,142,151,3,296,0.00993377483443709
"067601411","BUENOS AIRES",308,2,147,149,1,297,0.00649350649350649
"067601413","BUENOS AIRES",415,0,164,220,5,389,0
"067601602","BUENOS AIRES",283,5,168,102,0,270,0.0176678445229682
"067601710","BUENOS AIRES",307,9,206,84,1,291,0.0293159609120521
"067601715","BUENOS AIRES",342,2,184,149,0,333,0.00584795321637427
"067630101","BUENOS AIRES",354,218,118,17,0,135,0.615819209039548
"067630112","BUENOS AIRES",229,228,1,0,0,1,0.995633187772926
"067630202","BUENOS AIRES",78,10,15,41,2,58,0.128205128205128
"067630501","BUENOS AIRES",231,220,6,4,0,10,0.952380952380952
"067630510","BUENOS AIRES",239,209,9,14,0,23,0.874476987447699
"067630603","BUENOS AIRES",288,3,117,168,0,285,0.0104166666666667
"067630606","BUENOS AIRES",353,5,169,159,5,333,0.0141643059490085
"067630607","BUENOS AIRES",400,5,162,227,1,390,0.0125
"067630611","BUENOS AIRES",267,5,120,138,2,260,0.0187265917602996
"067630712","BUENOS AIRES",165,1,78,85,1,164,0.00606060606060606
"067630803","BUENOS AIRES",235,5,198,31,0,229,0.0212765957446809
"067630812","BUENOS AIRES",135,2,29,90,5,124,0.0148148148148148
"067630901","BUENOS AIRES",246,242,4,0,0,4,0.983739837398374
"067631101","BUENOS AIRES",376,233,62,78,1,141,0.61968085106383
"067631201","BUENOS AIRES",149,1,91,55,0,146,0.00671140939597315
"067631709","BUENOS AIRES",249,91,100,53,1,154,0.365461847389558
"060350602","BUENOS AIRES",385,301,43,40,0,83,0.781818181818182
"067631807","BUENOS AIRES",182,175,5,2,0,7,0.961538461538462
"067910306","BUENOS AIRES",202,199,2,1,0,3,0.985148514851485
"068402002","BUENOS AIRES",275,270,5,0,0,5,0.981818181818182
"067631810","BUENOS AIRES",370,370,0,0,0,0,1
"067631905","BUENOS AIRES",349,279,37,30,0,67,0.799426934097421
"067631906","BUENOS AIRES",180,139,19,21,0,40,0.772222222222222
"067632012","BUENOS AIRES",240,225,2,6,0,8,0.9375
"067700203","BUENOS AIRES",44,1,11,30,2,43,0.0227272727272727
"067701006","BUENOS AIRES",365,324,8,30,1,39,0.887671232876712
"067910217","BUENOS AIRES",294,288,2,3,0,5,0.979591836734694
"067702106","BUENOS AIRES",266,266,0,0,0,0,1
"067702108","BUENOS AIRES",244,238,1,5,0,6,0.975409836065574
"067780103","BUENOS AIRES",233,193,26,13,0,39,0.828326180257511
"067780106","BUENOS AIRES",349,245,46,49,0,95,0.702005730659026
"067911213","BUENOS AIRES",405,359,19,26,0,45,0.88641975308642
"060351310","BUENOS AIRES",243,237,3,3,0,6,0.975308641975309
"067911814","BUENOS AIRES",326,287,24,13,0,37,0.880368098159509
"067911908","BUENOS AIRES",223,223,0,0,0,0,1
"067780110","BUENOS AIRES",37,0,14,21,1,36,0
"067780201","BUENOS AIRES",211,0,90,117,1,208,0
"067780203","BUENOS AIRES",165,9,63,83,0,146,0.0545454545454545
"067780214","BUENOS AIRES",290,219,28,21,1,50,0.755172413793103
"067780218","BUENOS AIRES",220,18,84,109,2,195,0.0818181818181818
"067780506","BUENOS AIRES",329,192,59,58,1,118,0.583586626139818
"067781005","BUENOS AIRES",321,304,8,7,0,15,0.947040498442368
"067781011","BUENOS AIRES",270,242,11,9,1,21,0.896296296296296
"067840810","BUENOS AIRES",232,148,35,48,0,83,0.637931034482759
"067910109","BUENOS AIRES",226,221,2,3,0,5,0.97787610619469
"067910303","BUENOS AIRES",241,224,7,10,0,17,0.929460580912863
"067912112","BUENOS AIRES",338,3,116,206,7,329,0.00887573964497041
"067912206","BUENOS AIRES",354,302,21,28,0,49,0.853107344632768
"067912209","BUENOS AIRES",293,282,8,2,0,10,0.962457337883959
"067912215","BUENOS AIRES",265,250,14,0,1,15,0.943396226415094
"067980702","BUENOS AIRES",400,255,58,85,1,144,0.6375
"067980711","BUENOS AIRES",261,200,31,30,0,61,0.766283524904215
"068050105","BUENOS AIRES",110,109,1,0,0,1,0.990909090909091
"068051416","BUENOS AIRES",556,21,260,235,1,496,0.0377697841726619
"068400409","BUENOS AIRES",286,174,48,60,0,108,0.608391608391608
"068051702","BUENOS AIRES",433,0,326,103,1,430,0
"068051404","BUENOS AIRES",414,14,249,140,0,389,0.0338164251207729
"068050204","BUENOS AIRES",395,3,166,205,3,374,0.00759493670886076
"068050205","BUENOS AIRES",469,7,296,157,1,454,0.0149253731343284
"068050408","BUENOS AIRES",297,7,149,137,0,286,0.0235690235690236
"068050501","BUENOS AIRES",347,335,11,1,0,12,0.965417867435158
"068050512","BUENOS AIRES",462,20,122,299,2,423,0.0432900432900433
"068050706","BUENOS AIRES",156,126,7,16,0,23,0.807692307692308
"068050811","BUENOS AIRES",477,40,105,311,2,418,0.0838574423480084
"068051104","BUENOS AIRES",510,9,416,83,0,499,0.0176470588235294
"068051205","BUENOS AIRES",301,16,241,43,0,284,0.053156146179402
"068261607","BUENOS AIRES",195,134,33,28,0,61,0.687179487179487
"068051707","BUENOS AIRES",472,3,343,115,0,458,0.00635593220338983
"068051801","BUENOS AIRES",227,0,171,53,0,224,0
"068051911","BUENOS AIRES",475,9,366,96,0,462,0.0189473684210526
"068052005","BUENOS AIRES",423,260,132,25,0,157,0.614657210401891
"068052014","BUENOS AIRES",312,5,235,68,0,303,0.016025641025641
"068052102","BUENOS AIRES",289,6,150,115,3,268,0.0207612456747405
"068052110","BUENOS AIRES",329,11,172,122,0,294,0.033434650455927
"068052204","BUENOS AIRES",523,3,279,204,1,484,0.00573613766730402
"068052304","BUENOS AIRES",462,2,266,186,1,453,0.00432900432900433
"068052405","BUENOS AIRES",506,2,346,126,0,472,0.00395256916996047
"068260702","BUENOS AIRES",183,179,4,0,0,4,0.978142076502732
"068052313","BUENOS AIRES",350,186,161,3,0,164,0.531428571428571
"068052314","BUENOS AIRES",457,5,165,237,9,411,0.0109409190371991
"068052409","BUENOS AIRES",401,2,147,244,1,392,0.00498753117206983
"068052504","BUENOS AIRES",139,0,110,29,0,139,0
"060281804","BUENOS AIRES",231,1,110,110,1,221,0.00432900432900433
"068190902","BUENOS AIRES",70,0,56,10,4,70,0
"068260118","BUENOS AIRES",214,191,12,6,0,18,0.892523364485981
"068190906","BUENOS AIRES",106,1,80,23,2,105,0.00943396226415094
"068260103","BUENOS AIRES",326,303,14,6,0,20,0.929447852760736
"068260106","BUENOS AIRES",252,240,8,4,0,12,0.952380952380952
"068260115","BUENOS AIRES",248,236,8,2,0,10,0.951612903225806
"068260204","BUENOS AIRES",189,178,8,3,0,11,0.941798941798942
"068261901","BUENOS AIRES",284,269,11,4,0,15,0.947183098591549
"068261903","BUENOS AIRES",194,184,5,5,0,10,0.948453608247423
"068261906","BUENOS AIRES",220,219,0,0,1,1,0.995454545454545
"068261908","BUENOS AIRES",215,189,15,10,0,25,0.87906976744186
"068261910","BUENOS AIRES",251,245,4,2,0,6,0.97609561752988
"068330105","BUENOS AIRES",225,182,25,18,0,43,0.808888888888889
"068330111","BUENOS AIRES",311,309,2,0,0,2,0.993569131832797
"068330113","BUENOS AIRES",450,410,11,29,0,40,0.911111111111111
"068330116","BUENOS AIRES",210,208,2,0,0,2,0.990476190476191
"068330206","BUENOS AIRES",196,192,2,1,0,3,0.979591836734694
"068331002","BUENOS AIRES",229,109,14,99,3,116,0.475982532751092
"068331003","BUENOS AIRES",6,0,2,4,0,6,0
"068331004","BUENOS AIRES",427,366,39,21,0,60,0.857142857142857
"068331702","BUENOS AIRES",212,2,145,64,0,209,0.00943396226415094
"068331804","BUENOS AIRES",68,0,45,23,0,68,0
"068470113","BUENOS AIRES",198,0,130,62,4,196,0
"068331802","BUENOS AIRES",164,2,79,80,0,159,0.0121951219512195
"068331905","BUENOS AIRES",446,159,113,169,1,283,0.356502242152466
"068331907","BUENOS AIRES",306,1,100,195,3,298,0.00326797385620915
"068331910","BUENOS AIRES",238,107,63,33,1,97,0.449579831932773
"068331912","BUENOS AIRES",222,2,89,129,0,218,0.00900900900900901
"068400108","BUENOS AIRES",198,35,27,124,4,155,0.176767676767677
"068400203","BUENOS AIRES",331,2,251,69,2,322,0.00604229607250755
"068400306","BUENOS AIRES",363,89,126,142,1,269,0.245179063360882
"068400309","BUENOS AIRES",292,3,191,91,0,282,0.0102739726027397
"068400403","BUENOS AIRES",279,19,182,71,0,253,0.0681003584229391
"068400410","BUENOS AIRES",433,319,52,59,0,111,0.736720554272517
"068401105","BUENOS AIRES",266,260,3,2,0,5,0.977443609022556
"068401205","BUENOS AIRES",317,307,9,1,0,10,0.968454258675079
"068401813","BUENOS AIRES",350,333,12,5,0,17,0.951428571428571
"068401909","BUENOS AIRES",243,237,2,4,0,6,0.975308641975309
"068400414","BUENOS AIRES",342,341,1,0,0,1,0.997076023391813
"068400416","BUENOS AIRES",399,399,0,0,0,0,1
"068400701","BUENOS AIRES",418,404,8,4,0,12,0.966507177033493
"068400709","BUENOS AIRES",355,337,16,1,0,17,0.949295774647887
"068400808","BUENOS AIRES",237,232,2,1,0,3,0.978902953586498
"068400903","BUENOS AIRES",327,325,2,0,0,2,0.99388379204893
"068400909","BUENOS AIRES",242,241,0,0,0,0,0.995867768595041
"068401906","BUENOS AIRES",398,391,5,2,0,7,0.982412060301508
"068401010","BUENOS AIRES",250,248,0,0,0,0,0.992
"068401103","BUENOS AIRES",170,170,0,0,0,0,1
"020062010","CABA",385,385,0,0,0,0,1
"068401206","BUENOS AIRES",4,1,2,1,0,3,0.25
"068401207","BUENOS AIRES",214,213,1,0,0,1,0.995327102803738
"068401302","BUENOS AIRES",205,202,1,2,0,3,0.985365853658537
"068401305","BUENOS AIRES",282,275,6,0,0,6,0.975177304964539
"068401307","BUENOS AIRES",210,206,1,3,0,4,0.980952380952381
"068401309","BUENOS AIRES",337,335,1,1,0,2,0.99406528189911
"068401503","BUENOS AIRES",261,255,5,1,0,6,0.977011494252874
"068401504","BUENOS AIRES",256,255,1,0,0,1,0.99609375
"068401508","BUENOS AIRES",249,249,0,0,0,0,1
"068401511","BUENOS AIRES",182,182,0,0,0,0,1
"068401514","BUENOS AIRES",335,327,8,0,0,8,0.976119402985075
"068401708","BUENOS AIRES",306,304,2,0,0,2,0.993464052287582
"068401711","BUENOS AIRES",196,195,0,1,0,1,0.994897959183674
"068401712","BUENOS AIRES",217,213,4,0,0,4,0.981566820276498
"068401713","BUENOS AIRES",215,210,4,1,0,5,0.976744186046512
"068401809","BUENOS AIRES",347,331,13,2,0,15,0.953890489913545
"068402109","BUENOS AIRES",362,357,2,0,0,2,0.986187845303867
"068402305","BUENOS AIRES",367,360,4,2,0,6,0.980926430517711
"068402407","BUENOS AIRES",298,292,4,2,0,6,0.979865771812081
"068402504","BUENOS AIRES",248,58,54,119,6,179,0.233870967741935
"068402604","BUENOS AIRES",162,160,2,0,0,2,0.987654320987654
"068402606","BUENOS AIRES",938,916,6,0,1,7,0.976545842217484
"068402708","BUENOS AIRES",277,273,0,4,0,4,0.985559566787004
"068402710","BUENOS AIRES",351,347,3,0,0,3,0.988603988603989
"068402711","BUENOS AIRES",240,224,15,0,0,15,0.933333333333333
"068402712","BUENOS AIRES",324,323,1,0,0,1,0.996913580246914
"068402802","BUENOS AIRES",313,294,6,11,0,17,0.939297124600639
"068402806","BUENOS AIRES",277,256,11,8,0,19,0.924187725631769
"068402905","BUENOS AIRES",389,378,6,3,0,9,0.97172236503856
"068403005","BUENOS AIRES",170,168,1,1,0,2,0.988235294117647
"068403202","BUENOS AIRES",305,304,1,0,0,1,0.99672131147541
"068540202","BUENOS AIRES",455,31,132,276,2,410,0.0681318681318681
"068052617","BUENOS AIRES",18,2,8,1,4,13,0.111111111111111
"068470101","BUENOS AIRES",158,0,125,31,2,158,0
"068610912","BUENOS AIRES",302,301,0,0,0,0,0.996688741721854
"068052620","BUENOS AIRES",179,1,115,56,2,173,0.00558659217877095
"068052621","BUENOS AIRES",72,0,46,23,0,69,0
"068120403","BUENOS AIRES",9,0,3,6,0,9,0
"068540112","BUENOS AIRES",287,187,61,37,1,99,0.651567944250871
"068610602","BUENOS AIRES",221,221,0,0,0,0,1
"068190701","BUENOS AIRES",24,2,3,18,1,22,0.0833333333333333
"068190802","BUENOS AIRES",32,6,16,10,0,26,0.1875
"068261101","BUENOS AIRES",32,0,12,18,1,31,0
"068261401","BUENOS AIRES",22,0,18,4,0,22,0
"068261501","BUENOS AIRES",40,0,18,22,0,40,0
"068261602","BUENOS AIRES",42,0,23,19,0,42,0
"068261805","BUENOS AIRES",17,0,6,11,0,17,0
"068330502","BUENOS AIRES",9,0,0,7,0,7,0
"068610903","BUENOS AIRES",224,220,4,0,0,4,0.982142857142857
"068330903","BUENOS AIRES",26,0,13,13,0,26,0
"068331605","BUENOS AIRES",19,0,16,3,0,19,0
"068331705","BUENOS AIRES",79,0,24,53,0,77,0
"068470204","BUENOS AIRES",32,0,2,30,0,32,0
"068540803","BUENOS AIRES",31,0,5,25,1,31,0
"068751302","BUENOS AIRES",70,0,39,25,1,65,0
"068540301","BUENOS AIRES",91,0,29,61,1,91,0
"068541010","BUENOS AIRES",52,0,26,26,0,52,0
"068541101","BUENOS AIRES",31,0,10,21,0,31,0
"068680501","BUENOS AIRES",14,0,13,1,0,14,0
"068750301","BUENOS AIRES",58,1,18,39,0,57,0.0172413793103448
"068750502","BUENOS AIRES",47,0,27,17,1,45,0
"068750606","BUENOS AIRES",98,0,39,41,8,88,0
"068610409","BUENOS AIRES",234,232,2,0,0,2,0.991452991452991
"068751701","BUENOS AIRES",153,2,63,65,6,134,0.0130718954248366
"068820601","BUENOS AIRES",54,1,36,14,0,50,0.0185185185185185
"068610301","BUENOS AIRES",328,326,1,0,0,1,0.99390243902439
"068610502","BUENOS AIRES",223,217,2,4,0,6,0.973094170403587
"068541007","BUENOS AIRES",101,1,46,52,2,100,0.0099009900990099
"068541008","BUENOS AIRES",112,1,53,56,2,111,0.00892857142857143
"068541015","BUENOS AIRES",124,1,61,41,3,105,0.00806451612903226
"068610106","BUENOS AIRES",222,221,1,0,0,1,0.995495495495496
"068541402","BUENOS AIRES",98,0,26,70,2,98,0
"068541406","BUENOS AIRES",153,1,72,78,0,150,0.0065359477124183
"068610102","BUENOS AIRES",168,168,0,0,0,0,1
"068610211","BUENOS AIRES",246,246,0,0,0,0,1
"068610110","BUENOS AIRES",236,232,3,1,0,4,0.983050847457627
"068610206","BUENOS AIRES",173,171,2,0,0,2,0.988439306358382
"068610210","BUENOS AIRES",301,300,1,0,0,1,0.996677740863787
"068610307","BUENOS AIRES",248,246,0,0,0,0,0.991935483870968
"068610308","BUENOS AIRES",281,281,0,0,0,0,1
"068610401","BUENOS AIRES",286,279,6,1,0,7,0.975524475524476
"068611006","BUENOS AIRES",314,312,1,1,0,2,0.993630573248408
"068611104","BUENOS AIRES",236,235,1,0,0,1,0.995762711864407
"068611108","BUENOS AIRES",236,234,1,1,0,2,0.991525423728814
"068611302","BUENOS AIRES",238,238,0,0,0,0,1
"068611602","BUENOS AIRES",201,201,0,0,0,0,1
"068611611","BUENOS AIRES",280,278,2,0,0,2,0.992857142857143
"068611708","BUENOS AIRES",323,317,5,0,0,5,0.981424148606811
"068611802","BUENOS AIRES",351,349,2,0,0,2,0.994301994301994
"068611903","BUENOS AIRES",303,302,1,0,0,1,0.996699669966997
"068611911","BUENOS AIRES",341,337,3,1,0,4,0.988269794721408
"068612303","BUENOS AIRES",399,387,9,1,0,10,0.969924812030075
"068612401","BUENOS AIRES",410,403,5,1,1,7,0.982926829268293
"068612410","BUENOS AIRES",352,349,1,0,0,1,0.991477272727273
"068612504","BUENOS AIRES",206,190,12,4,0,16,0.922330097087379
"061120206","BUENOS AIRES",307,242,15,29,0,44,0.788273615635179
"068612509","BUENOS AIRES",360,357,3,0,0,3,0.991666666666667
"068612703","BUENOS AIRES",280,275,1,0,0,1,0.982142857142857
"068612807","BUENOS AIRES",268,265,3,0,0,3,0.988805970149254
"068612908","BUENOS AIRES",502,475,11,12,0,23,0.946215139442231
"068612909","BUENOS AIRES",183,182,1,0,0,1,0.994535519125683
"068613004","BUENOS AIRES",492,101,31,350,2,383,0.205284552845528
"068613006","BUENOS AIRES",259,61,10,181,1,192,0.235521235521236
"068613011","BUENOS AIRES",283,281,2,0,0,2,0.992932862190813
"068613101","BUENOS AIRES",442,410,17,1,0,18,0.927601809954751
"068613109","BUENOS AIRES",320,307,6,5,0,11,0.959375
"068613201","BUENOS AIRES",213,208,0,0,0,0,0.976525821596244
"068613207","BUENOS AIRES",383,352,22,3,0,25,0.919060052219321
"068613209","BUENOS AIRES",203,199,3,0,0,3,0.980295566502463
"065680306","BUENOS AIRES",254,30,114,109,0,223,0.118110236220472
"068613210","BUENOS AIRES",364,336,21,0,0,21,0.923076923076923
"068613302","BUENOS AIRES",350,334,12,0,0,12,0.954285714285714
"068680206","BUENOS AIRES",211,195,10,6,0,16,0.924170616113744
"068680204","BUENOS AIRES",179,157,14,3,0,17,0.877094972067039
"068680211","BUENOS AIRES",34,34,0,0,0,0,1
"068680308","BUENOS AIRES",44,42,0,1,0,1,0.954545454545455
"068680401","BUENOS AIRES",28,24,2,2,0,4,0.857142857142857
"068680404","BUENOS AIRES",5,5,0,0,0,0,1
"068680503","BUENOS AIRES",373,25,153,190,0,343,0.0670241286863271
"068680604","BUENOS AIRES",90,81,8,1,0,9,0.9
"068680704","BUENOS AIRES",90,69,20,1,0,21,0.766666666666667
"068680712","BUENOS AIRES",47,13,10,22,0,32,0.276595744680851
"068680802","BUENOS AIRES",252,14,165,71,2,238,0.0555555555555556
"068680810","BUENOS AIRES",45,33,9,3,0,12,0.733333333333333
"065680503","BUENOS AIRES",245,244,0,1,0,1,0.995918367346939
"068750603","BUENOS AIRES",114,3,73,38,0,111,0.0263157894736842
"068751507","BUENOS AIRES",303,3,162,118,4,284,0.0099009900990099
"068820214","BUENOS AIRES",215,135,7,66,0,73,0.627906976744186
"068820308","BUENOS AIRES",388,383,2,1,0,3,0.987113402061856
"068820502","BUENOS AIRES",460,205,60,184,3,247,0.445652173913043
"068820509","BUENOS AIRES",436,274,51,109,0,160,0.628440366972477
"068820803","BUENOS AIRES",397,355,11,27,0,38,0.894206549118388
"068820807","BUENOS AIRES",305,302,1,0,0,1,0.99016393442623
"068821009","BUENOS AIRES",429,354,8,64,1,73,0.825174825174825
"068821607","BUENOS AIRES",311,23,56,227,1,284,0.0739549839228296
"068821711","BUENOS AIRES",300,2,98,190,2,290,0.00666666666666667
"065601410","BUENOS AIRES",236,0,112,117,2,231,0
"065601505","BUENOS AIRES",266,1,133,121,0,254,0.0037593984962406
"065601514","BUENOS AIRES",384,3,114,255,1,370,0.0078125
"065601704","BUENOS AIRES",188,0,77,105,3,185,0
"065601705","BUENOS AIRES",238,161,40,33,0,73,0.676470588235294
"067702209","BUENOS AIRES",236,221,5,5,1,11,0.936440677966102
"065601713","BUENOS AIRES",240,2,105,115,8,228,0.00833333333333333
"065601804","BUENOS AIRES",225,0,170,54,1,225,0
"065601813","BUENOS AIRES",275,0,187,83,2,272,0
"065601902","BUENOS AIRES",291,0,160,116,3,279,0
"065601911","BUENOS AIRES",262,2,193,66,0,259,0.00763358778625954
"065602001","BUENOS AIRES",468,392,17,57,0,74,0.837606837606838
"065602005","BUENOS AIRES",274,0,71,190,2,263,0
"065602014","BUENOS AIRES",344,6,224,108,1,333,0.0174418604651163
"065602316","BUENOS AIRES",298,251,36,10,1,47,0.842281879194631
"065602402","BUENOS AIRES",186,183,2,0,0,2,0.983870967741935
"065602407","BUENOS AIRES",308,251,39,13,0,52,0.814935064935065
"065602502","BUENOS AIRES",265,259,5,1,0,6,0.977358490566038
"065602503","BUENOS AIRES",374,297,55,21,1,77,0.794117647058823
"065602510","BUENOS AIRES",507,478,16,8,0,24,0.942800788954635
"065602511","BUENOS AIRES",264,172,41,12,2,55,0.651515151515151
"065680207","BUENOS AIRES",338,99,160,79,0,239,0.292899408284024
"065680315","BUENOS AIRES",558,530,21,2,0,23,0.949820788530466
"065680204","BUENOS AIRES",252,214,15,22,0,37,0.849206349206349
"065680505","BUENOS AIRES",369,366,2,1,0,3,0.991869918699187
"065680604","BUENOS AIRES",334,331,1,2,0,3,0.991017964071856
"064273102","BUENOS AIRES",309,308,1,0,0,1,0.996763754045307
"065680608","BUENOS AIRES",292,289,1,2,0,3,0.98972602739726
"065680803","BUENOS AIRES",241,4,164,72,0,236,0.016597510373444
"065680905","BUENOS AIRES",208,5,163,40,0,203,0.0240384615384615
"065680906","BUENOS AIRES",277,4,214,59,0,273,0.0144404332129964
"065680909","BUENOS AIRES",263,6,210,46,0,256,0.0228136882129278
"065681004","BUENOS AIRES",298,16,213,68,1,282,0.0536912751677852
"065681010","BUENOS AIRES",225,160,50,15,0,65,0.711111111111111
"065681011","BUENOS AIRES",224,149,51,24,0,75,0.665178571428571
"065681015","BUENOS AIRES",265,264,1,0,0,1,0.99622641509434
"065681102","BUENOS AIRES",368,360,4,2,0,6,0.978260869565217
"065681107","BUENOS AIRES",277,276,0,1,0,1,0.996389891696751
"065681112","BUENOS AIRES",322,318,2,1,0,3,0.987577639751553
"065681304","BUENOS AIRES",330,324,2,3,1,6,0.981818181818182
"064904809","BUENOS AIRES",212,210,1,1,0,2,0.990566037735849
"066583202","BUENOS AIRES",384,380,3,1,0,4,0.989583333333333
"064904911","BUENOS AIRES",328,319,8,1,0,9,0.972560975609756
"064905006","BUENOS AIRES",379,378,0,0,0,0,0.997361477572559
"064905007","BUENOS AIRES",341,339,1,1,0,2,0.994134897360704
"064970308","BUENOS AIRES",350,1,142,192,2,336,0.00285714285714286
"065151912","BUENOS AIRES",257,3,109,141,0,250,0.0116731517509728
"064970504","BUENOS AIRES",334,2,88,210,17,315,0.00598802395209581
"064970702","BUENOS AIRES",127,127,0,0,0,0,1
"064970709","BUENOS AIRES",207,173,20,14,0,34,0.835748792270531
"065390412","BUENOS AIRES",273,268,3,2,0,5,0.981684981684982
"064971103","BUENOS AIRES",328,308,7,12,0,19,0.939024390243902
"064971201","BUENOS AIRES",302,2,150,148,1,299,0.00662251655629139
"064971206","BUENOS AIRES",296,208,77,10,0,87,0.702702702702703
"064971307","BUENOS AIRES",261,7,165,89,0,254,0.0268199233716475
"064971407","BUENOS AIRES",162,153,6,3,0,9,0.944444444444444
"064971409","BUENOS AIRES",311,21,173,115,0,288,0.067524115755627
"066651312","BUENOS AIRES",508,400,15,84,0,99,0.78740157480315
"065150611","BUENOS AIRES",206,1,116,82,1,199,0.00485436893203883
"065050211","BUENOS AIRES",179,126,16,29,0,45,0.70391061452514
"065152003","BUENOS AIRES",323,3,173,133,0,306,0.00928792569659443
"065152004","BUENOS AIRES",257,1,172,77,1,250,0.00389105058365759
"065152006","BUENOS AIRES",233,1,177,54,1,232,0.00429184549356223
"065152008","BUENOS AIRES",315,2,190,119,0,309,0.00634920634920635
"065152014","BUENOS AIRES",485,1,325,142,0,467,0.00206185567010309
"065050308","BUENOS AIRES",259,223,9,25,0,34,0.861003861003861
"065050318","BUENOS AIRES",106,43,43,19,0,62,0.405660377358491
"065050401","BUENOS AIRES",95,0,59,35,0,94,0
"065110502","BUENOS AIRES",302,169,50,81,0,131,0.559602649006622
"065110507","BUENOS AIRES",297,255,16,24,1,41,0.858585858585859
"065110508","BUENOS AIRES",322,178,48,93,1,142,0.552795031055901
"065110601","BUENOS AIRES",133,2,65,65,0,130,0.0150375939849624
"065152104","BUENOS AIRES",227,3,150,65,0,215,0.013215859030837
"065152106","BUENOS AIRES",294,9,227,58,0,285,0.0306122448979592
"065152112","BUENOS AIRES",252,4,173,70,2,245,0.0158730158730159
"065152114","BUENOS AIRES",224,0,193,28,0,221,0
"065180115","BUENOS AIRES",197,182,9,6,0,15,0.923857868020305
"065180603","BUENOS AIRES",79,2,53,24,0,77,0.0253164556962025
"065180605","BUENOS AIRES",75,0,72,2,0,74,0
"060283912","BUENOS AIRES",422,3,251,150,2,403,0.00710900473933649
"065150204","BUENOS AIRES",33,0,25,8,0,33,0
"065150405","BUENOS AIRES",275,26,130,117,0,247,0.0945454545454545
"065150501","BUENOS AIRES",241,0,138,96,1,235,0
"065150704","BUENOS AIRES",537,2,276,237,0,513,0.0037243947858473
"065150709","BUENOS AIRES",464,3,347,95,0,442,0.00646551724137931
"065150711","BUENOS AIRES",169,2,116,48,0,164,0.0118343195266272
"065150802","BUENOS AIRES",312,1,235,75,0,310,0.00320512820512821
"065150806","BUENOS AIRES",243,0,150,78,2,230,0
"065150807","BUENOS AIRES",362,0,252,107,1,360,0
"065150901","BUENOS AIRES",255,2,184,65,1,250,0.00784313725490196
"060282904","BUENOS AIRES",290,2,221,64,0,285,0.00689655172413793
"060283602","BUENOS AIRES",186,91,91,4,0,95,0.489247311827957
"060350304","BUENOS AIRES",357,357,0,0,0,0,1
"060351508","BUENOS AIRES",324,28,244,51,0,295,0.0864197530864197
"065151003","BUENOS AIRES",416,0,359,53,0,412,0
"065151004","BUENOS AIRES",273,0,231,40,0,271,0
"060560309","BUENOS AIRES",218,210,5,1,0,6,0.963302752293578
"060283705","BUENOS AIRES",371,3,275,77,3,355,0.00808625336927224
"060560801","BUENOS AIRES",476,404,27,35,1,63,0.848739495798319
"065151113","BUENOS AIRES",301,2,220,64,0,284,0.00664451827242525
"060980313","BUENOS AIRES",140,140,0,0,0,0,1
"060980706","BUENOS AIRES",368,304,11,35,10,56,0.826086956521739
"065151207","BUENOS AIRES",485,2,250,196,2,448,0.00412371134020619
"065151208","BUENOS AIRES",251,5,170,65,0,235,0.0199203187250996
"061260108","BUENOS AIRES",265,264,1,0,0,1,0.99622641509434
"060070413","BUENOS AIRES",6,0,3,3,0,6,0
"060070809","BUENOS AIRES",358,295,31,30,0,61,0.824022346368715
"060141005","BUENOS AIRES",221,60,69,92,0,161,0.271493212669683
"060071001","BUENOS AIRES",12,0,0,12,0,12,0
"061820212","BUENOS AIRES",225,215,2,1,0,3,0.955555555555556
"061820306","BUENOS AIRES",1,1,0,0,0,0,1
"060140501","BUENOS AIRES",153,3,101,49,0,150,0.0196078431372549
"063573311","BUENOS AIRES",170,170,0,0,0,0,1
"060141014","BUENOS AIRES",212,89,38,81,1,120,0.419811320754717
"060210501","BUENOS AIRES",138,15,35,87,0,122,0.108695652173913
"060210605","BUENOS AIRES",261,257,3,1,0,4,0.984674329501916
"060210607","BUENOS AIRES",395,350,20,18,0,38,0.886075949367089
"060280101","BUENOS AIRES",360,7,150,180,0,330,0.0194444444444444
"060280102","BUENOS AIRES",290,4,92,178,2,272,0.0137931034482759
"060280107","BUENOS AIRES",326,9,197,111,2,310,0.0276073619631902
"060280111","BUENOS AIRES",395,6,282,104,0,386,0.0151898734177215
"060280301","BUENOS AIRES",473,16,247,188,2,437,0.0338266384778013
"060280308","BUENOS AIRES",525,10,242,256,2,500,0.019047619047619
"060280311","BUENOS AIRES",251,3,73,167,0,240,0.0119521912350598
"060281107","BUENOS AIRES",208,197,11,0,0,11,0.947115384615385
"060280410","BUENOS AIRES",361,2,170,168,6,344,0.00554016620498615
"060280503","BUENOS AIRES",11,0,6,5,0,11,0
"060280608","BUENOS AIRES",226,0,96,114,0,210,0
"060280613","BUENOS AIRES",244,223,21,0,0,21,0.913934426229508
"060280704","BUENOS AIRES",417,2,265,145,1,411,0.00479616306954436
"060280805","BUENOS AIRES",324,3,144,158,4,306,0.00925925925925926
"060280906","BUENOS AIRES",395,5,281,109,0,390,0.0126582278481013
"060281003","BUENOS AIRES",369,17,218,130,0,348,0.046070460704607
"060281004","BUENOS AIRES",249,3,132,103,0,235,0.0120481927710843
"060281005","BUENOS AIRES",283,15,164,99,0,263,0.0530035335689046
"060281010","BUENOS AIRES",311,0,156,142,2,300,0
"060281011","BUENOS AIRES",302,12,143,142,2,287,0.0397350993377483
"060281013","BUENOS AIRES",528,6,243,253,3,499,0.0113636363636364
"060281113","BUENOS AIRES",227,2,166,59,0,225,0.00881057268722467
"060282002","BUENOS AIRES",330,272,44,14,0,58,0.824242424242424
"060281307","BUENOS AIRES",255,5,150,87,1,238,0.0196078431372549
"060281312","BUENOS AIRES",290,1,198,89,0,287,0.00344827586206897
"060281504","BUENOS AIRES",269,2,158,95,6,259,0.00743494423791822
"060281505","BUENOS AIRES",300,3,148,139,0,287,0.01
"060351211","BUENOS AIRES",329,327,1,0,0,1,0.993920972644377
"060281601","BUENOS AIRES",274,269,5,0,0,5,0.981751824817518
"060561401","BUENOS AIRES",208,207,1,0,0,1,0.995192307692308
"060281803","BUENOS AIRES",440,10,250,167,1,418,0.0227272727272727
"060282003","BUENOS AIRES",194,0,115,67,0,182,0
"060282007","BUENOS AIRES",293,1,121,157,4,282,0.00341296928327645
"060282106","BUENOS AIRES",212,0,173,39,0,212,0
"060282208","BUENOS AIRES",262,31,86,140,0,226,0.118320610687023
"060282209","BUENOS AIRES",385,7,286,88,1,375,0.0181818181818182
"060282210","BUENOS AIRES",495,20,352,116,0,468,0.0404040404040404
"060282214","BUENOS AIRES",246,5,117,124,0,241,0.0203252032520325
"060282301","BUENOS AIRES",453,8,273,167,0,440,0.0176600441501104
"020032009","CABA",458,457,1,0,0,1,0.997816593886463
"062030501","BUENOS AIRES",38,0,6,31,0,37,0
"060282304","BUENOS AIRES",379,13,280,86,0,366,0.0343007915567282
"060282604","BUENOS AIRES",241,235,5,1,0,6,0.975103734439834
"060282608","BUENOS AIRES",171,169,1,1,0,2,0.988304093567251
"060282709","BUENOS AIRES",141,79,29,33,0,62,0.560283687943262
"060282801","BUENOS AIRES",354,11,195,146,1,342,0.0310734463276836
"060283608","BUENOS AIRES",284,0,260,24,0,284,0
"060282804","BUENOS AIRES",307,2,164,109,3,276,0.00651465798045603
"060282905","BUENOS AIRES",256,1,147,101,0,248,0.00390625
"060282906","BUENOS AIRES",222,0,149,71,2,222,0
"060282910","BUENOS AIRES",246,2,144,85,9,238,0.00813008130081301
"060283008","BUENOS AIRES",490,19,149,305,3,457,0.0387755102040816
"060283014","BUENOS AIRES",304,2,166,132,3,301,0.00657894736842105
"060350314","BUENOS AIRES",277,270,6,1,0,7,0.974729241877256
"020031809","CABA",395,392,2,0,0,2,0.992405063291139
"060283016","BUENOS AIRES",284,5,138,138,1,277,0.0176056338028169
"060283310","BUENOS AIRES",297,3,264,29,1,294,0.0101010101010101
"060283207","BUENOS AIRES",309,2,221,84,0,305,0.00647249190938511
"060283410","BUENOS AIRES",355,3,293,59,0,352,0.00845070422535211
"060283505","BUENOS AIRES",449,1,235,198,5,438,0.0022271714922049
"060283507","BUENOS AIRES",438,90,180,157,2,339,0.205479452054795
"060561409","BUENOS AIRES",170,169,1,0,0,1,0.994117647058824
"060283709","BUENOS AIRES",279,0,205,71,0,276,0
"060283710","BUENOS AIRES",356,0,195,152,2,349,0
"060283802","BUENOS AIRES",347,0,197,144,0,341,0
"060283805","BUENOS AIRES",392,2,324,66,0,390,0.00510204081632653
"060283808","BUENOS AIRES",386,6,277,101,1,379,0.0155440414507772
"060283811","BUENOS AIRES",269,1,215,50,0,265,0.00371747211895911
"060350201","BUENOS AIRES",321,12,55,206,12,273,0.0373831775700935
"060350406","BUENOS AIRES",342,276,27,39,0,66,0.807017543859649
"060350409","BUENOS AIRES",435,358,33,40,0,73,0.822988505747126
"060350414","BUENOS AIRES",258,254,4,0,0,4,0.984496124031008
"060350502","BUENOS AIRES",465,429,18,18,0,36,0.92258064516129
"060350605","BUENOS AIRES",316,286,13,17,0,30,0.905063291139241
"060350609","BUENOS AIRES",315,311,2,1,1,4,0.987301587301587
"060350611","BUENOS AIRES",218,153,33,24,5,62,0.701834862385321
"060350705","BUENOS AIRES",286,189,38,55,0,93,0.660839160839161
"060350807","BUENOS AIRES",227,187,10,6,0,16,0.823788546255507
"060350809","BUENOS AIRES",267,196,24,29,0,53,0.734082397003745
"060352308","BUENOS AIRES",212,202,7,1,1,9,0.952830188679245
"060350202","BUENOS AIRES",278,22,56,186,4,246,0.079136690647482
"060350303","BUENOS AIRES",287,60,122,101,0,223,0.209059233449477
"060351811","BUENOS AIRES",320,13,169,136,1,306,0.040625
"060350815","BUENOS AIRES",501,329,89,61,0,150,0.656686626746507
"060350902","BUENOS AIRES",179,130,14,0,0,14,0.726256983240223
"060350906","BUENOS AIRES",190,109,38,35,0,73,0.573684210526316
"060350907","BUENOS AIRES",285,142,45,45,9,99,0.498245614035088
"060350910","BUENOS AIRES",402,318,23,39,5,67,0.791044776119403
"060350911","BUENOS AIRES",336,213,63,23,11,97,0.633928571428571
"060351105","BUENOS AIRES",547,383,91,64,0,155,0.70018281535649
"060351210","BUENOS AIRES",397,395,1,0,0,1,0.994962216624685
"060351304","BUENOS AIRES",302,299,1,1,0,2,0.990066225165563
"060351305","BUENOS AIRES",245,219,14,10,0,24,0.893877551020408
"060351402","BUENOS AIRES",225,216,8,1,0,9,0.96
"060351703","BUENOS AIRES",299,138,60,100,0,160,0.461538461538462
"060351704","BUENOS AIRES",323,160,82,81,0,163,0.495356037151703
"060351711","BUENOS AIRES",232,58,84,90,0,174,0.25
"060351905","BUENOS AIRES",324,296,11,14,0,25,0.91358024691358
"060352411","BUENOS AIRES",363,76,94,185,2,281,0.209366391184573
"060352505","BUENOS AIRES",340,254,44,40,0,84,0.747058823529412
"060352507","BUENOS AIRES",301,159,65,74,0,139,0.528239202657807
"060352508","BUENOS AIRES",307,254,17,35,0,52,0.827361563517915
"060352607","BUENOS AIRES",277,269,6,2,0,8,0.971119133574007
"060352609","BUENOS AIRES",303,58,54,169,1,224,0.191419141914191
"060352713","BUENOS AIRES",230,18,71,139,0,210,0.0782608695652174
"060352903","BUENOS AIRES",345,60,201,82,0,283,0.173913043478261
"060353008","BUENOS AIRES",356,271,57,25,0,82,0.76123595505618
"060353202","BUENOS AIRES",258,208,25,23,0,48,0.806201550387597
"060353306","BUENOS AIRES",291,290,1,0,0,1,0.996563573883162
"060561415","BUENOS AIRES",191,190,1,0,0,1,0.994764397905759
"060353401","BUENOS AIRES",264,255,6,1,0,7,0.965909090909091
"060353402","BUENOS AIRES",240,226,9,2,0,11,0.941666666666667
"060353404","BUENOS AIRES",259,245,11,2,0,13,0.945945945945946
"060353504","BUENOS AIRES",246,239,4,3,0,7,0.971544715447154
"060353506","BUENOS AIRES",253,245,1,4,0,5,0.968379446640316
"060420101","BUENOS AIRES",381,350,7,20,0,27,0.918635170603675
"065151304","BUENOS AIRES",305,0,162,125,0,287,0
"060420104","BUENOS AIRES",247,240,4,2,1,7,0.97165991902834
"060420105","BUENOS AIRES",235,226,4,1,0,5,0.961702127659574
"060420109","BUENOS AIRES",424,350,28,45,1,74,0.825471698113208
"060421906","BUENOS AIRES",310,291,5,14,0,19,0.938709677419355
"060490104","BUENOS AIRES",291,286,5,0,0,5,0.982817869415808
"060490105","BUENOS AIRES",265,261,2,1,0,3,0.984905660377358
"060490108","BUENOS AIRES",299,292,3,3,0,6,0.976588628762542
"060490114","BUENOS AIRES",255,197,12,40,0,52,0.772549019607843
"060490202","BUENOS AIRES",283,277,2,4,0,6,0.978798586572438
"060490204","BUENOS AIRES",365,295,30,40,0,70,0.808219178082192
"060490602","BUENOS AIRES",212,122,29,57,0,86,0.575471698113208
"060491007","BUENOS AIRES",115,14,25,74,0,99,0.121739130434783
"062450414","BUENOS AIRES",100,4,78,18,0,96,0.04
"060560302","BUENOS AIRES",238,238,0,0,0,0,1
"060560112","BUENOS AIRES",277,277,0,0,0,0,1
"060560203","BUENOS AIRES",182,155,23,4,0,27,0.851648351648352
"060560506","BUENOS AIRES",327,317,6,4,0,10,0.969418960244648
"060560601","BUENOS AIRES",272,255,10,6,0,16,0.9375
"060560706","BUENOS AIRES",242,238,2,1,0,3,0.983471074380165
"060560707","BUENOS AIRES",347,331,4,10,0,14,0.953890489913545
"060560709","BUENOS AIRES",357,338,7,11,0,18,0.946778711484594
"060561007","BUENOS AIRES",245,244,0,0,0,0,0.995918367346939
"065151306","BUENOS AIRES",462,0,360,96,3,459,0
"060560904","BUENOS AIRES",255,254,1,0,0,1,0.996078431372549
"060560908","BUENOS AIRES",264,220,5,33,0,38,0.833333333333333
"060560909","BUENOS AIRES",153,150,0,1,0,1,0.980392156862745
"060561011","BUENOS AIRES",195,195,0,0,0,0,1
"060561504","BUENOS AIRES",246,225,5,13,0,18,0.914634146341463
"060561512","BUENOS AIRES",400,359,1,6,0,7,0.8975
"060561515","BUENOS AIRES",447,430,9,6,0,15,0.961968680089485
"060561601","BUENOS AIRES",214,211,2,1,0,3,0.985981308411215
"060561610","BUENOS AIRES",270,270,0,0,0,0,1
"060561611","BUENOS AIRES",335,334,1,0,0,1,0.997014925373134
"060561709","BUENOS AIRES",253,253,0,0,0,0,1
"060561801","BUENOS AIRES",384,376,2,5,0,7,0.979166666666667
"062600202","BUENOS AIRES",501,14,259,222,0,481,0.0279441117764471
"060561911","BUENOS AIRES",340,331,6,2,0,8,0.973529411764706
"060561913","BUENOS AIRES",413,396,2,5,0,7,0.958837772397094
"060561914","BUENOS AIRES",228,213,10,4,0,14,0.934210526315789
"060562210","BUENOS AIRES",283,283,0,0,0,0,1
"060562215","BUENOS AIRES",297,289,2,5,0,7,0.973063973063973
"060562216","BUENOS AIRES",343,322,5,1,0,6,0.938775510204082
"060562415","BUENOS AIRES",238,28,36,171,1,208,0.117647058823529
"060562508","BUENOS AIRES",395,363,18,10,0,28,0.918987341772152
"063573902","BUENOS AIRES",162,162,0,0,0,0,1
"065151309","BUENOS AIRES",444,0,353,84,1,438,0
"065151313","BUENOS AIRES",321,4,271,39,1,311,0.0124610591900312
"062601615","BUENOS AIRES",455,0,240,205,2,447,0
"060911502","BUENOS AIRES",249,223,11,13,0,24,0.895582329317269
"060562707","BUENOS AIRES",325,11,143,148,14,305,0.0338461538461538
"060563004","BUENOS AIRES",205,6,131,65,0,196,0.0292682926829268
"060630106","BUENOS AIRES",287,286,0,1,0,1,0.996515679442509
"060630108","BUENOS AIRES",382,361,3,18,0,21,0.945026178010471
"060630111","BUENOS AIRES",297,292,1,3,0,4,0.983164983164983
"060630206","BUENOS AIRES",159,55,27,61,3,91,0.345911949685535
"062700104","BUENOS AIRES",338,0,126,196,4,326,0
"060630806","BUENOS AIRES",66,0,23,36,5,64,0
"063573406","BUENOS AIRES",162,162,0,0,0,0,1
"060631101","BUENOS AIRES",23,0,19,4,0,23,0
"060700101","BUENOS AIRES",166,159,1,6,0,7,0.957831325301205
"060700211","BUENOS AIRES",246,25,62,150,0,212,0.101626016260163
"060700212","BUENOS AIRES",373,237,36,97,1,134,0.635388739946381
"062740302","BUENOS AIRES",291,11,142,134,0,276,0.0378006872852234
"063710508","BUENOS AIRES",194,190,1,3,0,4,0.979381443298969
"060840702","BUENOS AIRES",191,44,50,94,1,145,0.230366492146597
"060840707","BUENOS AIRES",273,241,19,11,2,32,0.882783882783883
"060911105","BUENOS AIRES",326,321,2,3,0,5,0.984662576687117
"060910103","BUENOS AIRES",226,221,2,2,0,4,0.97787610619469
"060910401","BUENOS AIRES",396,147,41,171,3,215,0.371212121212121
"060911505","BUENOS AIRES",299,287,7,4,0,11,0.959866220735786
"060911506","BUENOS AIRES",307,252,10,39,0,49,0.820846905537459
"060911508","BUENOS AIRES",297,249,6,30,0,36,0.838383838383838
"060911511","BUENOS AIRES",410,313,3,52,0,55,0.763414634146341
"060980507","BUENOS AIRES",240,184,19,29,1,49,0.766666666666667
"060910501","BUENOS AIRES",479,215,48,181,3,232,0.448851774530271
"060910503","BUENOS AIRES",449,275,53,108,1,162,0.612472160356347
"062741709","BUENOS AIRES",329,206,38,75,1,114,0.626139817629179
"060910601","BUENOS AIRES",343,214,21,100,0,121,0.623906705539359
"060910705","BUENOS AIRES",268,177,36,54,0,90,0.66044776119403
"064410411","BUENOS AIRES",353,353,0,0,0,0,1
"060910907","BUENOS AIRES",445,436,3,2,0,5,0.979775280898876
"060911010","BUENOS AIRES",555,498,12,23,0,35,0.897297297297297
"060911202","BUENOS AIRES",453,409,18,23,0,41,0.902869757174393
"060911203","BUENOS AIRES",358,266,37,15,0,52,0.743016759776536
"060911304","BUENOS AIRES",361,304,13,31,2,46,0.842105263157895
"061260903","BUENOS AIRES",278,9,44,219,2,265,0.0323741007194245
"060911512","BUENOS AIRES",286,265,3,12,0,15,0.926573426573427
"060911601","BUENOS AIRES",382,330,13,31,0,44,0.863874345549738
"060980110","BUENOS AIRES",312,91,167,54,0,221,0.291666666666667
"060911709","BUENOS AIRES",379,285,38,41,0,79,0.75197889182058
"060911710","BUENOS AIRES",369,268,26,65,0,91,0.726287262872629
"060911801","BUENOS AIRES",236,184,18,21,0,39,0.779661016949153
"060911805","BUENOS AIRES",385,232,46,98,2,146,0.602597402597403
"060911806","BUENOS AIRES",391,75,114,188,2,304,0.191815856777494
"060912101","BUENOS AIRES",266,12,74,170,3,247,0.0451127819548872
"060980210","BUENOS AIRES",310,11,212,85,0,297,0.0354838709677419
"060912102","BUENOS AIRES",312,309,3,0,0,3,0.990384615384615
"060980813","BUENOS AIRES",239,88,42,108,0,150,0.368200836820084
"060912213","BUENOS AIRES",254,241,11,2,0,13,0.948818897637795
"060912305","BUENOS AIRES",228,11,137,73,0,210,0.0482456140350877
"060912310","BUENOS AIRES",455,6,235,204,0,439,0.0131868131868132
"060912317","BUENOS AIRES",147,4,57,64,0,121,0.0272108843537415
"060912319","BUENOS AIRES",85,1,53,30,0,83,0.0117647058823529
"060912411","BUENOS AIRES",250,205,26,19,0,45,0.82
"060980103","BUENOS AIRES",316,129,150,30,2,182,0.408227848101266
"060980105","BUENOS AIRES",267,174,66,26,0,92,0.651685393258427
"063573908","BUENOS AIRES",173,173,0,0,0,0,1
"060980209","BUENOS AIRES",220,41,129,50,0,179,0.186363636363636
"060980301","BUENOS AIRES",137,134,1,2,0,3,0.978102189781022
"064273404","BUENOS AIRES",331,329,1,1,0,2,0.993957703927492
"060980606","BUENOS AIRES",298,60,186,52,0,238,0.201342281879195
"060980611","BUENOS AIRES",316,23,199,90,0,289,0.0727848101265823
"062940202","BUENOS AIRES",98,1,28,62,2,92,0.0102040816326531
"060980804","BUENOS AIRES",273,13,170,88,2,260,0.0476190476190476
"060980816","BUENOS AIRES",311,149,123,34,3,160,0.479099678456592
"061050211","BUENOS AIRES",346,332,6,5,1,12,0.959537572254335
"061051102","BUENOS AIRES",163,0,80,83,0,163,0
"061051104","BUENOS AIRES",178,2,88,87,1,176,0.0112359550561798
"061051303","BUENOS AIRES",233,57,99,77,0,176,0.244635193133047
"061120108","BUENOS AIRES",263,239,2,3,0,5,0.908745247148289
"061120201","BUENOS AIRES",318,91,86,117,0,203,0.286163522012579
"061120310","BUENOS AIRES",64,0,30,33,0,63,0
"061120601","BUENOS AIRES",15,0,7,6,1,14,0
"300280810","ENTRE RIOS",186,185,0,0,0,0,0.994623655913978
"061120702","BUENOS AIRES",350,1,159,186,3,348,0.00285714285714286
"061120901","BUENOS AIRES",40,0,6,30,1,37,0
"061190309","BUENOS AIRES",278,197,31,49,0,80,0.70863309352518
"061190701","BUENOS AIRES",201,80,95,26,0,121,0.398009950248756
"061190801","BUENOS AIRES",82,2,42,38,0,80,0.024390243902439
"061260303","BUENOS AIRES",357,352,5,0,0,5,0.985994397759104
"061260104","BUENOS AIRES",231,202,13,16,0,29,0.874458874458874
"061260202","BUENOS AIRES",442,10,116,309,1,426,0.0226244343891403
"061260203","BUENOS AIRES",347,221,93,33,0,126,0.636887608069164
"061260301","BUENOS AIRES",256,248,7,0,0,7,0.96875
"061260308","BUENOS AIRES",223,202,1,1,0,2,0.905829596412556
"061260501","BUENOS AIRES",321,2,172,139,0,311,0.00623052959501558
"061260502","BUENOS AIRES",375,190,77,104,2,183,0.506666666666667
"061260506","BUENOS AIRES",277,50,46,171,3,220,0.180505415162455
"061260710","BUENOS AIRES",295,289,0,0,0,0,0.979661016949153
"065151409","BUENOS AIRES",241,3,119,112,0,231,0.012448132780083
"061340203","BUENOS AIRES",301,2,93,188,8,289,0.00664451827242525
"061340909","BUENOS AIRES",409,0,272,124,3,399,0
"061340309","BUENOS AIRES",454,441,5,7,0,12,0.97136563876652
"061341002","BUENOS AIRES",381,272,63,41,2,106,0.713910761154856
"061341008","BUENOS AIRES",290,222,33,20,1,54,0.76551724137931
"061400401","BUENOS AIRES",82,0,33,46,0,79,0
"065151410","BUENOS AIRES",384,3,259,115,0,374,0.0078125
"061400306","BUENOS AIRES",236,199,7,27,0,34,0.843220338983051
"061400308","BUENOS AIRES",308,296,7,4,1,12,0.961038961038961
"061470103","BUENOS AIRES",240,238,1,1,0,2,0.991666666666667
"061470104","BUENOS AIRES",280,257,13,10,0,23,0.917857142857143
"061470201","BUENOS AIRES",167,0,126,40,1,167,0
"061470501","BUENOS AIRES",497,212,60,221,3,284,0.426559356136821
"063573510","BUENOS AIRES",132,132,0,0,0,0,1
"061470901","BUENOS AIRES",74,0,19,51,1,71,0
"061471204","BUENOS AIRES",245,212,9,24,0,33,0.86530612244898
"061540401","BUENOS AIRES",46,0,15,25,5,45,0
"061610105","BUENOS AIRES",174,11,55,107,0,162,0.0632183908045977
"061610113","BUENOS AIRES",299,209,27,62,1,90,0.698996655518395
"065391709","BUENOS AIRES",181,176,3,2,0,5,0.972375690607735
"061750403","BUENOS AIRES",273,2,54,209,3,266,0.00732600732600733
"061750409","BUENOS AIRES",327,187,31,105,0,136,0.571865443425077
"061750412","BUENOS AIRES",258,232,18,6,0,24,0.89922480620155
"061750601","BUENOS AIRES",283,160,53,69,1,123,0.565371024734982
"061750604","BUENOS AIRES",278,55,62,159,0,221,0.197841726618705
"061820111","BUENOS AIRES",324,316,6,2,0,8,0.975308641975309
"061820307","BUENOS AIRES",0,0,0,0,0,0,NA
"061891007","BUENOS AIRES",341,302,25,13,0,38,0.885630498533724
"062030104","BUENOS AIRES",279,266,6,7,0,13,0.953405017921147
"061820308","BUENOS AIRES",14,14,0,0,0,0,1
"061820312","BUENOS AIRES",24,23,1,0,0,1,0.958333333333333
"061820602","BUENOS AIRES",61,1,38,22,0,60,0.0163934426229508
"061820609","BUENOS AIRES",271,265,3,3,0,6,0.977859778597786
"061820705","BUENOS AIRES",292,267,5,17,0,22,0.914383561643836
"061820902","BUENOS AIRES",41,3,29,8,1,38,0.0731707317073171
"063577713","BUENOS AIRES",60,1,35,23,0,58,0.0166666666666667
"061960203","BUENOS AIRES",104,86,4,12,0,16,0.826923076923077
"061891002","BUENOS AIRES",240,229,7,4,0,11,0.954166666666667
"063573407","BUENOS AIRES",189,188,1,0,0,1,0.994708994708995
"061891008","BUENOS AIRES",216,208,7,1,0,8,0.962962962962963
"061891009","BUENOS AIRES",189,149,21,16,1,38,0.788359788359788
"061891211","BUENOS AIRES",136,2,90,42,0,132,0.0147058823529412
"063578017","BUENOS AIRES",140,0,97,42,1,140,0
"063578108","BUENOS AIRES",153,0,92,61,0,153,0
"063640101","BUENOS AIRES",330,96,101,130,0,231,0.290909090909091
"061960111","BUENOS AIRES",118,75,8,33,0,41,0.635593220338983
"061960118","BUENOS AIRES",157,97,17,42,1,60,0.617834394904459
"061960208","BUENOS AIRES",261,236,1,23,1,25,0.904214559386973
"061960213","BUENOS AIRES",202,184,7,10,0,17,0.910891089108911
"061960214","BUENOS AIRES",203,126,22,54,0,76,0.620689655172414
"061961507","BUENOS AIRES",150,3,130,17,0,147,0.02
"062030113","BUENOS AIRES",263,3,124,133,1,258,0.0114068441064639
"062030212","BUENOS AIRES",322,9,175,133,3,311,0.0279503105590062
"062030401","BUENOS AIRES",59,0,18,39,2,59,0
"062030803","BUENOS AIRES",234,97,76,61,0,137,0.414529914529915
"062030810","BUENOS AIRES",315,167,79,66,1,146,0.53015873015873
"062031605","BUENOS AIRES",274,28,118,126,1,245,0.102189781021898
"062031606","BUENOS AIRES",158,1,49,107,0,156,0.00632911392405063
"062031613","BUENOS AIRES",299,1,129,163,0,292,0.00334448160535117
"062100107","BUENOS AIRES",279,262,4,10,0,14,0.939068100358423
"062100110","BUENOS AIRES",168,166,1,1,0,2,0.988095238095238
"062100115","BUENOS AIRES",280,274,3,3,0,6,0.978571428571429
"062100201","BUENOS AIRES",279,136,64,76,0,140,0.487455197132616
"062100206","BUENOS AIRES",198,188,9,1,0,10,0.94949494949495
"062100606","BUENOS AIRES",197,4,122,69,1,192,0.0203045685279188
"063574004","BUENOS AIRES",207,207,0,0,0,0,1
"300280811","ENTRE RIOS",150,135,10,2,0,12,0.9
"062170102","BUENOS AIRES",302,297,3,2,0,5,0.983443708609272
"062101302","BUENOS AIRES",309,305,2,2,0,4,0.98705501618123
"062170101","BUENOS AIRES",285,273,4,8,0,12,0.957894736842105
"062170103","BUENOS AIRES",254,240,5,8,0,13,0.94488188976378
"062170303","BUENOS AIRES",79,0,32,44,0,76,0
"062170406","BUENOS AIRES",83,1,47,31,1,79,0.0120481927710843
"062240111","BUENOS AIRES",361,325,19,17,0,36,0.900277008310249
"062170501","BUENOS AIRES",11,1,7,1,2,10,0.0909090909090909
"062170503","BUENOS AIRES",6,0,4,1,1,6,0
"063572208","BUENOS AIRES",224,224,0,0,0,0,1
"062240409","BUENOS AIRES",369,188,86,94,0,180,0.509485094850949
"062240410","BUENOS AIRES",235,129,31,75,0,106,0.548936170212766
"063574201","BUENOS AIRES",163,163,0,0,0,0,1
"062170510","BUENOS AIRES",7,0,7,0,0,7,0
"062240101","BUENOS AIRES",166,2,47,115,1,163,0.0120481927710843
"062240102","BUENOS AIRES",311,256,25,28,0,53,0.823151125401929
"062240109","BUENOS AIRES",326,299,10,15,0,25,0.917177914110429
"062240208","BUENOS AIRES",366,336,7,20,0,27,0.918032786885246
"062240301","BUENOS AIRES",277,227,5,44,0,49,0.819494584837545
"062240303","BUENOS AIRES",310,228,49,32,1,82,0.735483870967742
"062240308","BUENOS AIRES",303,5,66,224,1,291,0.0165016501650165
"062240406","BUENOS AIRES",282,279,3,0,0,3,0.98936170212766
"064200904","BUENOS AIRES",101,60,24,17,0,41,0.594059405940594
"062240413","BUENOS AIRES",336,332,2,1,0,3,0.988095238095238
"062240415","BUENOS AIRES",134,34,47,52,1,100,0.253731343283582
"062240501","BUENOS AIRES",12,0,4,5,3,12,0
"062240901","BUENOS AIRES",140,0,77,62,1,140,0
"062240902","BUENOS AIRES",287,3,57,222,2,281,0.0104529616724739
"062240911","BUENOS AIRES",165,4,50,99,4,153,0.0242424242424242
"063572212","BUENOS AIRES",186,186,0,0,0,0,1
"062310101","BUENOS AIRES",227,1,195,31,0,226,0.00440528634361234
"062242202","BUENOS AIRES",261,258,0,2,0,2,0.988505747126437
"062310107","BUENOS AIRES",190,3,141,46,0,187,0.0157894736842105
"062311206","BUENOS AIRES",197,184,6,7,0,13,0.934010152284264
"062311208","BUENOS AIRES",398,286,64,46,2,112,0.718592964824121
"062311213","BUENOS AIRES",180,110,14,52,0,66,0.611111111111111
"020012306","CABA",214,214,0,0,0,0,1
"062380109","BUENOS AIRES",262,237,5,20,0,25,0.904580152671756
"065151506","BUENOS AIRES",350,1,193,134,3,330,0.00285714285714286
"062380602","BUENOS AIRES",88,5,44,39,0,83,0.0568181818181818
"062450110","BUENOS AIRES",311,285,19,7,0,26,0.916398713826367
"062450203","BUENOS AIRES",186,185,1,0,0,1,0.994623655913978
"062450207","BUENOS AIRES",397,305,57,35,0,92,0.768261964735516
"062450304","BUENOS AIRES",501,127,199,130,2,331,0.253493013972056
"062450404","BUENOS AIRES",235,5,153,69,0,222,0.0212765957446809
"065151503","BUENOS AIRES",362,1,167,172,1,340,0.00276243093922652
"062450405","BUENOS AIRES",232,4,145,81,0,226,0.0172413793103448
"062520804","BUENOS AIRES",416,0,232,164,3,399,0
"062520302","BUENOS AIRES",85,6,53,25,0,78,0.0705882352941176
"064273110","BUENOS AIRES",287,275,9,3,0,12,0.958188153310105
"062450411","BUENOS AIRES",41,0,34,6,0,40,0
"062450504","BUENOS AIRES",278,132,86,34,2,122,0.474820143884892
"062520203","BUENOS AIRES",198,0,126,65,0,191,0
"062520902","BUENOS AIRES",501,2,222,243,2,467,0.00399201596806387
"062520206","BUENOS AIRES",130,1,118,11,0,129,0.00769230769230769
"062520209","BUENOS AIRES",387,1,137,237,1,375,0.00258397932816537
"062520217","BUENOS AIRES",294,8,96,176,1,273,0.0272108843537415
"064278010","BUENOS AIRES",205,4,54,127,4,185,0.0195121951219512
"062520401","BUENOS AIRES",347,2,118,207,2,327,0.00576368876080692
"062520506","BUENOS AIRES",207,201,4,2,0,6,0.971014492753623
"063572803","BUENOS AIRES",159,159,0,0,0,0,1
"062520704","BUENOS AIRES",459,7,285,165,0,450,0.0152505446623094
"300280812","ENTRE RIOS",123,112,0,0,0,0,0.910569105691057
"062520905","BUENOS AIRES",412,1,181,211,2,394,0.00242718446601942
"065151510","BUENOS AIRES",380,4,239,125,2,366,0.0105263157894737
"063572804","BUENOS AIRES",133,133,0,0,0,0,1
"062601611","BUENOS AIRES",303,0,105,173,2,280,0
"062521013","BUENOS AIRES",425,152,111,142,12,265,0.357647058823529
"062521205","BUENOS AIRES",505,51,315,123,0,438,0.100990099009901
"065151512","BUENOS AIRES",328,0,224,103,0,327,0
"062521309","BUENOS AIRES",233,1,192,40,0,232,0.00429184549356223
"062521404","BUENOS AIRES",309,0,141,151,2,294,0
"062521416","BUENOS AIRES",294,2,170,115,0,285,0.00680272108843537
"062521503","BUENOS AIRES",351,0,86,263,0,349,0
"062521513","BUENOS AIRES",248,238,10,0,0,10,0.959677419354839
"062521514","BUENOS AIRES",421,420,1,0,0,1,0.997624703087886
"062600603","BUENOS AIRES",326,8,264,51,1,316,0.0245398773006135
"062600110","BUENOS AIRES",469,7,213,223,7,443,0.0149253731343284
"062600111","BUENOS AIRES",295,1,35,231,5,271,0.00338983050847458
"062600108","BUENOS AIRES",446,22,224,190,1,415,0.0493273542600897
"062600115","BUENOS AIRES",312,4,159,135,0,294,0.0128205128205128
"062601702","BUENOS AIRES",21,0,8,13,0,21,0
"062600201","BUENOS AIRES",587,4,213,335,15,563,0.00681431005110733
"062600212","BUENOS AIRES",348,5,156,177,2,335,0.014367816091954
"062600305","BUENOS AIRES",393,4,193,180,4,377,0.0101781170483461
"062600307","BUENOS AIRES",375,3,215,152,0,367,0.008
"062600312","BUENOS AIRES",519,518,1,0,0,1,0.998073217726397
"062600317","BUENOS AIRES",377,3,216,147,0,363,0.00795755968169761
"062600318","BUENOS AIRES",345,2,243,97,0,340,0.00579710144927536
"062600513","BUENOS AIRES",399,5,202,176,6,384,0.012531328320802
"062600515","BUENOS AIRES",357,1,234,118,0,352,0.00280112044817927
"062600605","BUENOS AIRES",400,8,283,107,1,391,0.02
"062600615","BUENOS AIRES",303,1,262,40,0,302,0.0033003300330033
"062600706","BUENOS AIRES",337,1,245,83,0,328,0.0029673590504451
"062600708","BUENOS AIRES",255,2,160,88,0,248,0.00784313725490196
"062600810","BUENOS AIRES",254,2,157,89,0,246,0.0078740157480315
"062600813","BUENOS AIRES",446,188,182,64,0,246,0.42152466367713
"062600903","BUENOS AIRES",502,393,49,50,1,100,0.782868525896414
"062600904","BUENOS AIRES",455,398,23,27,1,51,0.874725274725275
"062600906","BUENOS AIRES",100,0,78,21,0,99,0
"062600911","BUENOS AIRES",435,1,260,167,1,428,0.00229885057471264
"062601008","BUENOS AIRES",338,260,52,23,0,75,0.769230769230769
"062601202","BUENOS AIRES",187,187,0,0,0,0,1
"062601205","BUENOS AIRES",407,99,260,47,0,307,0.243243243243243
"062601208","BUENOS AIRES",314,178,125,11,0,136,0.56687898089172
"062660612","BUENOS AIRES",115,0,86,28,0,114,0
"062601302","BUENOS AIRES",477,425,34,17,0,51,0.890985324947589
"062601312","BUENOS AIRES",171,167,4,0,0,4,0.976608187134503
"065151602","BUENOS AIRES",294,0,181,110,2,293,0
"062601502","BUENOS AIRES",338,1,242,91,0,333,0.0029585798816568
"062601510","BUENOS AIRES",469,15,155,265,5,425,0.0319829424307036
"063572904","BUENOS AIRES",206,206,0,0,0,0,1
"063575705","BUENOS AIRES",217,184,2,1,0,3,0.847926267281106
"062601713","BUENOS AIRES",643,633,10,0,0,10,0.984447900466563
"062660304","BUENOS AIRES",202,200,1,1,0,2,0.99009900990099
"062660306","BUENOS AIRES",166,153,10,3,0,13,0.921686746987952
"062660308","BUENOS AIRES",159,152,1,5,0,6,0.955974842767296
"062660309","BUENOS AIRES",197,192,1,2,0,3,0.974619289340102
"062660505","BUENOS AIRES",54,1,41,9,0,50,0.0185185185185185
"062660603","BUENOS AIRES",113,0,84,26,1,111,0
"062660710","BUENOS AIRES",318,190,50,65,0,115,0.59748427672956
"062700216","BUENOS AIRES",338,1,185,134,2,321,0.0029585798816568
"062700203","BUENOS AIRES",281,11,179,88,1,268,0.0391459074733096
"062700205","BUENOS AIRES",309,266,28,14,0,42,0.86084142394822
"062700207","BUENOS AIRES",402,130,209,62,0,271,0.323383084577114
"062700308","BUENOS AIRES",396,227,113,52,0,165,0.573232323232323
"062700312","BUENOS AIRES",456,342,85,26,0,111,0.75
"062700315","BUENOS AIRES",256,214,33,4,0,37,0.8359375
"062700401","BUENOS AIRES",172,91,57,23,0,80,0.529069767441861
"062700405","BUENOS AIRES",403,3,204,181,2,387,0.00744416873449132
"062700413","BUENOS AIRES",366,89,189,82,0,271,0.243169398907104
"062700617","BUENOS AIRES",495,2,134,325,11,470,0.00404040404040404
"062700701","BUENOS AIRES",266,0,99,154,3,256,0
"062700703","BUENOS AIRES",320,3,166,146,3,315,0.009375
"062700707","BUENOS AIRES",431,2,360,65,0,425,0.00464037122969838
"062700709","BUENOS AIRES",220,1,145,74,0,219,0.00454545454545455
"062700714","BUENOS AIRES",331,5,180,138,2,320,0.0151057401812689
"062700717","BUENOS AIRES",389,1,156,206,6,368,0.0025706940874036
"062700910","BUENOS AIRES",367,7,206,139,0,345,0.0190735694822888
"063576905","BUENOS AIRES",248,240,3,4,0,7,0.967741935483871
"062700810","BUENOS AIRES",238,0,107,122,6,235,0
"062700813","BUENOS AIRES",63,13,14,36,0,50,0.206349206349206
"062700903","BUENOS AIRES",295,0,144,126,1,271,0
"062701001","BUENOS AIRES",370,13,313,42,1,356,0.0351351351351351
"062701003","BUENOS AIRES",644,3,305,316,0,621,0.0046583850931677
"062701004","BUENOS AIRES",470,10,330,124,2,456,0.0212765957446809
"062701008","BUENOS AIRES",345,2,162,130,3,295,0.00579710144927536
"062740114","BUENOS AIRES",243,155,25,61,0,86,0.637860082304527
"062740111","BUENOS AIRES",294,45,144,98,0,242,0.153061224489796
"062740202","BUENOS AIRES",376,305,20,45,1,66,0.811170212765957
"062740203","BUENOS AIRES",414,324,32,42,0,74,0.782608695652174
"062740413","BUENOS AIRES",318,11,94,197,3,294,0.0345911949685535
"062740311","BUENOS AIRES",350,5,128,210,0,338,0.0142857142857143
"062740410","BUENOS AIRES",342,184,49,95,0,144,0.538011695906433
"063570905","BUENOS AIRES",348,152,86,105,0,191,0.436781609195402
"062740411","BUENOS AIRES",283,37,136,100,0,236,0.130742049469965
"062740501","BUENOS AIRES",275,9,160,100,0,260,0.0327272727272727
"062740503","BUENOS AIRES",272,14,85,161,1,247,0.0514705882352941
"062740615","BUENOS AIRES",345,24,117,191,1,309,0.0695652173913043
"062740617","BUENOS AIRES",274,5,176,83,0,259,0.0182481751824818
"062740707","BUENOS AIRES",360,9,125,215,1,341,0.025
"062770114","BUENOS AIRES",229,164,32,28,0,60,0.716157205240175
"062740813","BUENOS AIRES",416,7,50,320,7,377,0.0168269230769231
"062740816","BUENOS AIRES",283,6,100,169,1,270,0.0212014134275618
"062740908","BUENOS AIRES",208,8,76,121,0,197,0.0384615384615385
"062740914","BUENOS AIRES",248,3,59,166,6,231,0.0120967741935484
"063570907","BUENOS AIRES",327,5,125,191,2,318,0.0152905198776758
"062740915","BUENOS AIRES",402,5,136,251,1,388,0.0124378109452736
"062741015","BUENOS AIRES",278,0,94,149,12,255,0
"062741115","BUENOS AIRES",308,1,160,140,0,300,0.00324675324675325
"062741116","BUENOS AIRES",278,2,74,194,1,269,0.00719424460431655
"062741117","BUENOS AIRES",401,2,141,241,0,382,0.00498753117206983
"062741215","BUENOS AIRES",349,14,62,265,2,329,0.0401146131805158
"062741302","BUENOS AIRES",199,192,3,2,0,5,0.964824120603015
"062741303","BUENOS AIRES",240,223,9,5,0,14,0.929166666666667
"062741306","BUENOS AIRES",311,262,5,31,0,36,0.842443729903537
"062741307","BUENOS AIRES",276,230,17,23,0,40,0.833333333333333
"062741314","BUENOS AIRES",191,187,3,0,0,3,0.979057591623037
"062741403","BUENOS AIRES",220,220,0,0,0,0,1
"062741411","BUENOS AIRES",363,361,2,0,0,2,0.994490358126722
"062741501","BUENOS AIRES",336,18,83,196,17,296,0.0535714285714286
"062741502","BUENOS AIRES",328,16,79,217,2,298,0.0487804878048781
"062741503","BUENOS AIRES",262,4,86,168,0,254,0.0152671755725191
"062741505","BUENOS AIRES",230,27,119,76,1,196,0.117391304347826
"062741507","BUENOS AIRES",304,11,134,148,0,282,0.0361842105263158
"064274902","BUENOS AIRES",314,280,7,23,0,30,0.89171974522293
"062741703","BUENOS AIRES",299,6,212,71,0,283,0.020066889632107
"062741802","BUENOS AIRES",288,0,117,145,2,264,0
"062741804","BUENOS AIRES",243,58,42,132,0,174,0.238683127572016
"062741806","BUENOS AIRES",408,236,74,78,0,152,0.57843137254902
"062741903","BUENOS AIRES",300,2,101,179,0,280,0.00666666666666667
"062741906","BUENOS AIRES",413,2,165,227,2,394,0.00484261501210654
"062741911","BUENOS AIRES",463,11,102,328,4,434,0.0237580993520518
"062742001","BUENOS AIRES",417,4,129,271,0,400,0.00959232613908873
"062742009","BUENOS AIRES",320,2,158,147,0,305,0.00625
"062742013","BUENOS AIRES",384,4,92,265,2,359,0.0104166666666667
"062742107","BUENOS AIRES",410,403,4,0,0,4,0.982926829268293
"064275609","BUENOS AIRES",347,271,19,49,0,68,0.780979827089337
"062742123","BUENOS AIRES",306,9,108,176,2,286,0.0294117647058824
"062742202","BUENOS AIRES",266,3,75,162,3,240,0.0112781954887218
"062742204","BUENOS AIRES",257,6,113,127,0,240,0.0233463035019455
"062800101","BUENOS AIRES",180,19,62,92,0,154,0.105555555555556
"062800304","BUENOS AIRES",56,56,0,0,0,0,1
"062800306","BUENOS AIRES",50,45,5,0,0,5,0.9
"062800307","BUENOS AIRES",90,90,0,0,0,0,1
"062800405","BUENOS AIRES",45,45,0,0,0,0,1
"062800409","BUENOS AIRES",127,52,23,47,0,70,0.409448818897638
"065151606","BUENOS AIRES",293,3,168,112,1,281,0.0102389078498294
"062800605","BUENOS AIRES",12,0,6,6,0,12,0
"062800616","BUENOS AIRES",34,3,26,5,0,31,0.0882352941176471
"062800610","BUENOS AIRES",128,2,29,96,0,125,0.015625
"062800612","BUENOS AIRES",39,0,20,19,0,39,0
"063571306","BUENOS AIRES",415,398,12,2,0,14,0.959036144578313
"062800613","BUENOS AIRES",26,0,10,16,0,26,0
"064277505","BUENOS AIRES",493,1,198,265,1,464,0.00202839756592292
"062940406","BUENOS AIRES",52,1,32,18,0,50,0.0192307692307692
"062940810","BUENOS AIRES",108,2,36,61,0,97,0.0185185185185185
"063010508","BUENOS AIRES",246,132,74,39,1,114,0.536585365853659
"063150106","BUENOS AIRES",311,275,21,14,0,35,0.884244372990354
"063150107","BUENOS AIRES",200,94,37,65,0,102,0.47
"063150110","BUENOS AIRES",376,330,23,21,0,44,0.877659574468085
"063570911","BUENOS AIRES",367,345,11,9,0,20,0.940054495912807
"063220702","BUENOS AIRES",16,0,2,14,0,16,0
"063290505","BUENOS AIRES",112,0,51,47,1,99,0
"063290506","BUENOS AIRES",156,2,81,70,1,152,0.0128205128205128
"063430703","BUENOS AIRES",277,187,48,40,1,89,0.675090252707581
"064342504","BUENOS AIRES",197,9,84,102,0,186,0.0456852791878173
"063510102","BUENOS AIRES",135,0,68,63,3,134,0
"063510301","BUENOS AIRES",18,0,1,16,0,17,0
"063510606","BUENOS AIRES",357,222,60,71,0,131,0.621848739495798
"063570507","BUENOS AIRES",183,182,0,0,0,0,0.994535519125683
"063570509","BUENOS AIRES",338,336,1,0,0,1,0.994082840236686
"063570513","BUENOS AIRES",147,147,0,0,0,0,1
"063570602","BUENOS AIRES",261,253,2,5,0,7,0.969348659003831
"063570704","BUENOS AIRES",307,304,2,1,0,3,0.990228013029316
"063570706","BUENOS AIRES",343,327,12,3,0,15,0.9533527696793
"063570708","BUENOS AIRES",268,249,9,9,0,18,0.92910447761194
"063570803","BUENOS AIRES",204,197,5,2,0,7,0.965686274509804
"063570912","BUENOS AIRES",422,387,18,15,0,33,0.917061611374408
"063571011","BUENOS AIRES",330,23,230,74,0,304,0.0696969696969697
"063571206","BUENOS AIRES",208,203,2,3,0,5,0.975961538461538
"063571209","BUENOS AIRES",338,126,76,130,0,206,0.372781065088757
"063571303","BUENOS AIRES",415,408,3,2,0,5,0.983132530120482
"063574602","BUENOS AIRES",197,194,1,0,0,1,0.984771573604061
"063571408","BUENOS AIRES",359,353,3,0,0,3,0.983286908077994
"063571607","BUENOS AIRES",188,188,0,0,0,0,1
"063571702","BUENOS AIRES",109,108,0,0,0,0,0.990825688073395
"063571710","BUENOS AIRES",185,184,0,0,0,0,0.994594594594595
"063571807","BUENOS AIRES",247,247,0,0,0,0,1
"063571809","BUENOS AIRES",234,234,0,0,0,0,1
"063571906","BUENOS AIRES",127,127,0,0,0,0,1
"063572301","BUENOS AIRES",165,165,0,0,0,0,1
"063572308","BUENOS AIRES",58,58,0,0,0,0,1
"063572701","BUENOS AIRES",178,178,0,0,0,0,1
"063572703","BUENOS AIRES",240,240,0,0,0,0,1
"063573305","BUENOS AIRES",271,271,0,0,0,0,1
"063574307","BUENOS AIRES",135,135,0,0,0,0,1
"063574401","BUENOS AIRES",27,27,0,0,0,0,1
"063574403","BUENOS AIRES",235,232,3,0,0,3,0.987234042553191
"063574406","BUENOS AIRES",112,111,1,0,0,1,0.991071428571429
"063574501","BUENOS AIRES",171,171,0,0,0,0,1
"063574504","BUENOS AIRES",227,227,0,0,0,0,1
"063574513","BUENOS AIRES",74,74,0,0,0,0,1
"063574611","BUENOS AIRES",244,243,1,0,0,1,0.995901639344262
"063574706","BUENOS AIRES",185,183,2,0,0,2,0.989189189189189
"063574812","BUENOS AIRES",188,187,1,0,0,1,0.99468085106383
"063574903","BUENOS AIRES",222,221,1,0,0,1,0.995495495495496
"063575010","BUENOS AIRES",208,207,0,1,0,1,0.995192307692308
"063575108","BUENOS AIRES",288,259,7,19,1,27,0.899305555555556
"063575204","BUENOS AIRES",383,345,15,17,0,32,0.900783289817232
"063575208","BUENOS AIRES",270,217,34,18,0,52,0.803703703703704
"063575302","BUENOS AIRES",343,331,7,4,0,11,0.965014577259475
"063575501","BUENOS AIRES",199,197,0,2,0,2,0.989949748743719
"063575603","BUENOS AIRES",312,311,1,0,0,1,0.996794871794872
"063575702","BUENOS AIRES",346,343,1,2,0,3,0.991329479768786
"063575706","BUENOS AIRES",343,340,1,2,0,3,0.991253644314869
"063575807","BUENOS AIRES",293,282,8,3,0,11,0.962457337883959
"063575902","BUENOS AIRES",301,300,0,1,0,1,0.996677740863787
"063575903","BUENOS AIRES",252,251,1,0,0,1,0.996031746031746
"063576101","BUENOS AIRES",310,308,2,0,0,2,0.993548387096774
"063576105","BUENOS AIRES",284,280,2,2,0,4,0.985915492957746
"063576110","BUENOS AIRES",322,319,2,1,0,3,0.990683229813665
"063576303","BUENOS AIRES",71,68,3,0,0,3,0.957746478873239
"063576305","BUENOS AIRES",133,112,15,6,0,21,0.842105263157895
"063576306","BUENOS AIRES",59,58,0,1,0,1,0.983050847457627
"063576307","BUENOS AIRES",57,57,0,0,0,0,1
"063576404","BUENOS AIRES",225,209,6,8,0,14,0.928888888888889
"063576506","BUENOS AIRES",193,190,3,0,0,3,0.984455958549223
"063576607","BUENOS AIRES",274,261,5,6,0,11,0.952554744525547
"063576710","BUENOS AIRES",326,299,5,15,0,20,0.917177914110429
"063576805","BUENOS AIRES",183,179,2,1,0,3,0.978142076502732
"063576806","BUENOS AIRES",253,248,2,1,0,3,0.980237154150198
"063576902","BUENOS AIRES",225,218,3,2,0,5,0.968888888888889
"063576904","BUENOS AIRES",250,238,5,4,1,10,0.952
"063577012","BUENOS AIRES",207,204,0,3,0,3,0.985507246376812
"063577210","BUENOS AIRES",426,382,20,22,0,42,0.896713615023474
"063577616","BUENOS AIRES",79,0,61,18,0,79,0
"063710712","BUENOS AIRES",317,307,2,8,0,10,0.968454258675079
"063577305","BUENOS AIRES",349,299,22,27,0,49,0.856733524355301
"064415408","BUENOS AIRES",168,166,1,1,0,2,0.988095238095238
"063577508","BUENOS AIRES",138,10,64,64,0,128,0.072463768115942
"063577601","BUENOS AIRES",98,0,37,59,1,97,0
"064415607","BUENOS AIRES",296,273,20,2,0,22,0.922297297297297
"063577611","BUENOS AIRES",110,0,71,37,0,108,0
"064415707","BUENOS AIRES",454,134,121,177,2,300,0.295154185022026
"063577613","BUENOS AIRES",80,2,40,38,0,78,0.025
"063577615","BUENOS AIRES",79,0,51,28,0,79,0
"063710704","BUENOS AIRES",360,301,32,14,0,46,0.836111111111111
"063577707","BUENOS AIRES",59,0,31,27,0,58,0
"063577718","BUENOS AIRES",40,0,14,25,1,40,0
"063577802","BUENOS AIRES",162,3,60,99,0,159,0.0185185185185185
"063577805","BUENOS AIRES",274,114,46,100,4,150,0.416058394160584
"063577813","BUENOS AIRES",261,26,75,153,0,228,0.0996168582375479
"063577912","BUENOS AIRES",223,133,46,36,0,82,0.596412556053812
"063640708","BUENOS AIRES",258,238,13,6,0,19,0.922480620155039
"020032104","CABA",347,328,2,0,0,2,0.945244956772334
"063578104","BUENOS AIRES",78,0,47,30,0,77,0
"063578211","BUENOS AIRES",151,1,132,18,0,150,0.00662251655629139
"063640102","BUENOS AIRES",227,192,25,10,0,35,0.845814977973568
"063640105","BUENOS AIRES",302,262,17,22,0,39,0.867549668874172
"063640113","BUENOS AIRES",205,0,128,72,2,202,0
"063640202","BUENOS AIRES",300,34,151,111,0,262,0.113333333333333
"063640711","BUENOS AIRES",210,196,10,4,0,14,0.933333333333333
"063640318","BUENOS AIRES",293,39,126,124,0,250,0.133105802047782
"063640403","BUENOS AIRES",350,0,157,182,3,342,0
"063640404","BUENOS AIRES",118,1,33,72,5,110,0.00847457627118644
"063640407","BUENOS AIRES",190,1,101,82,1,184,0.00526315789473684
"064550801","BUENOS AIRES",18,0,8,10,0,18,0
"064902409","BUENOS AIRES",161,160,1,0,0,1,0.993788819875776
"063640804","BUENOS AIRES",157,2,92,54,2,148,0.0127388535031847
"063640810","BUENOS AIRES",290,0,159,107,3,269,0
"063640814","BUENOS AIRES",196,0,121,64,3,188,0
"063710210","BUENOS AIRES",416,8,276,129,0,405,0.0192307692307692
"063640817","BUENOS AIRES",237,0,123,100,5,228,0
"063640821","BUENOS AIRES",157,0,68,80,2,150,0
"063710101","BUENOS AIRES",343,29,103,190,3,296,0.0845481049562682
"063710104","BUENOS AIRES",234,32,123,79,0,202,0.136752136752137
"063710201","BUENOS AIRES",403,15,194,186,3,383,0.0372208436724566
"063710207","BUENOS AIRES",256,5,176,75,0,251,0.01953125
"063710301","BUENOS AIRES",418,7,341,70,0,411,0.0167464114832536
"063710510","BUENOS AIRES",382,369,6,6,0,12,0.965968586387435
"063710606","BUENOS AIRES",301,283,13,5,0,18,0.940199335548173
"063710802","BUENOS AIRES",371,365,3,2,0,5,0.983827493261456
"063710905","BUENOS AIRES",317,304,9,4,0,13,0.958990536277603
"063710909","BUENOS AIRES",389,370,10,9,0,19,0.951156812339332
"063710911","BUENOS AIRES",190,182,7,1,0,8,0.957894736842105
"063711004","BUENOS AIRES",220,218,2,0,0,2,0.990909090909091
"063711008","BUENOS AIRES",301,298,3,0,0,3,0.990033222591362
"063711101","BUENOS AIRES",274,265,5,4,0,9,0.967153284671533
"063711106","BUENOS AIRES",231,228,2,1,0,3,0.987012987012987
"063711109","BUENOS AIRES",181,181,0,0,0,0,1
"063711202","BUENOS AIRES",296,292,3,0,0,3,0.986486486486487
"063711210","BUENOS AIRES",297,297,0,0,0,0,1
"063711312","BUENOS AIRES",373,362,10,1,0,11,0.970509383378016
"063711512","BUENOS AIRES",291,11,132,143,0,275,0.0378006872852234
"063711603","BUENOS AIRES",174,29,43,90,5,138,0.166666666666667
"063711711","BUENOS AIRES",346,154,121,71,0,192,0.445086705202312
"063711804","BUENOS AIRES",370,230,103,37,0,140,0.621621621621622
"063712005","BUENOS AIRES",286,6,205,75,0,280,0.020979020979021
"020070703","CABA",409,409,0,0,0,0,1
"063712006","BUENOS AIRES",375,370,4,0,0,4,0.986666666666667
"063712209","BUENOS AIRES",188,188,0,0,0,0,1
"063712301","BUENOS AIRES",297,288,9,0,0,9,0.96969696969697
"063712304","BUENOS AIRES",220,217,3,0,0,3,0.986363636363636
"063712306","BUENOS AIRES",260,252,8,0,0,8,0.969230769230769
"063712404","BUENOS AIRES",176,175,0,1,0,1,0.994318181818182
"063712406","BUENOS AIRES",222,211,6,5,0,11,0.95045045045045
"063712607","BUENOS AIRES",252,242,5,4,0,9,0.96031746031746
"063713001","BUENOS AIRES",292,24,169,99,0,268,0.0821917808219178
"063713106","BUENOS AIRES",453,68,99,285,0,384,0.150110375275938
"063713203","BUENOS AIRES",386,12,212,152,0,364,0.0310880829015544
"063713209","BUENOS AIRES",240,11,94,133,0,227,0.0458333333333333
"063713309","BUENOS AIRES",349,14,221,114,0,335,0.0401146131805158
"063713511","BUENOS AIRES",418,198,58,140,4,202,0.473684210526316
"063713513","BUENOS AIRES",328,12,211,105,0,316,0.0365853658536585
"063713604","BUENOS AIRES",558,6,296,228,5,529,0.010752688172043
"063713610","BUENOS AIRES",353,8,296,48,0,344,0.0226628895184136
"020061407","CABA",237,237,0,0,0,0,1
"063713716","BUENOS AIRES",480,11,322,143,0,465,0.0229166666666667
"063713703","BUENOS AIRES",198,3,35,152,2,189,0.0151515151515152
"063713704","BUENOS AIRES",143,2,27,111,0,138,0.013986013986014
"063713708","BUENOS AIRES",641,29,154,447,2,603,0.0452418096723869
"063850704","BUENOS AIRES",302,110,45,142,0,187,0.364238410596026
"063850714","BUENOS AIRES",284,109,64,106,3,173,0.383802816901408
"063850717","BUENOS AIRES",218,212,1,4,0,5,0.972477064220184
"063850718","BUENOS AIRES",53,2,23,26,2,51,0.0377358490566038
"063920101","BUENOS AIRES",241,117,43,68,2,113,0.485477178423237
"063920107","BUENOS AIRES",312,253,25,34,0,59,0.810897435897436
"063920109","BUENOS AIRES",367,315,36,15,0,51,0.858310626702997
"063920111","BUENOS AIRES",248,81,109,57,1,167,0.326612903225806
"063920112","BUENOS AIRES",303,291,4,6,0,10,0.96039603960396
"063920116","BUENOS AIRES",204,194,3,6,0,9,0.950980392156863
"064902403","BUENOS AIRES",199,197,2,0,0,2,0.989949748743719
"020012302","CABA",219,217,1,0,0,1,0.990867579908676
"063921206","BUENOS AIRES",247,4,142,99,0,241,0.0161943319838057
"063921502","BUENOS AIRES",218,1,167,46,1,214,0.00458715596330275
"063990101","BUENOS AIRES",281,200,45,36,0,81,0.711743772241993
"063990102","BUENOS AIRES",232,144,39,48,0,87,0.620689655172414
"063990103","BUENOS AIRES",140,110,18,12,0,30,0.785714285714286
"063990704","BUENOS AIRES",272,188,53,30,0,83,0.691176470588235
"063990705","BUENOS AIRES",217,137,44,34,2,80,0.631336405529954
"064060214","BUENOS AIRES",223,118,60,42,1,103,0.52914798206278
"064080101","BUENOS AIRES",373,10,291,70,0,361,0.0268096514745308
"064080109","BUENOS AIRES",442,14,357,70,0,427,0.0316742081447964
"064080111","BUENOS AIRES",584,12,448,115,1,564,0.0205479452054795
"064080112","BUENOS AIRES",416,2,341,70,0,411,0.00480769230769231
"064081203","BUENOS AIRES",326,15,212,80,1,293,0.0460122699386503
"064080206","BUENOS AIRES",331,18,282,31,0,313,0.054380664652568
"064272903","BUENOS AIRES",232,212,16,4,0,20,0.913793103448276
"064080207","BUENOS AIRES",437,31,270,124,1,395,0.0709382151029748
"064904013","BUENOS AIRES",449,305,13,124,1,138,0.679287305122494
"064080303","BUENOS AIRES",381,16,233,122,1,356,0.041994750656168
"064080309","BUENOS AIRES",327,0,229,96,0,325,0
"064080401","BUENOS AIRES",395,2,200,169,0,369,0.00506329113924051
"064080403","BUENOS AIRES",264,0,166,90,1,257,0
"064080410","BUENOS AIRES",582,22,469,86,0,555,0.0378006872852234
"064080507","BUENOS AIRES",270,0,202,66,0,268,0
"064080601","BUENOS AIRES",429,8,396,25,0,421,0.0186480186480186
"064080603","BUENOS AIRES",352,12,315,25,0,340,0.0340909090909091
"064080801","BUENOS AIRES",328,6,212,98,2,312,0.0182926829268293
"020031811","CABA",249,239,5,0,0,5,0.959839357429719
"064080811","BUENOS AIRES",354,9,255,86,1,342,0.0254237288135593
"064344204","BUENOS AIRES",284,23,121,139,0,260,0.0809859154929577
"064081002","BUENOS AIRES",303,1,250,46,0,296,0.0033003300330033
"064081105","BUENOS AIRES",482,8,350,118,1,469,0.016597510373444
"064081305","BUENOS AIRES",264,9,200,51,0,251,0.0340909090909091
"064081311","BUENOS AIRES",363,6,231,121,1,353,0.0165289256198347
"064081401","BUENOS AIRES",406,15,313,76,0,389,0.0369458128078818
"064081403","BUENOS AIRES",403,5,333,57,1,391,0.0124069478908189
"064081406","BUENOS AIRES",246,81,146,15,1,162,0.329268292682927
"064081411","BUENOS AIRES",300,28,248,23,0,271,0.0933333333333333
"064081412","BUENOS AIRES",312,50,221,40,1,262,0.16025641025641
"064081413","BUENOS AIRES",328,212,74,42,0,116,0.646341463414634
"064081505","BUENOS AIRES",492,460,23,9,0,32,0.934959349593496
"064200607","BUENOS AIRES",42,41,1,0,0,1,0.976190476190476
"064100305","BUENOS AIRES",365,3,255,102,1,358,0.00821917808219178
"064100306","BUENOS AIRES",297,0,175,111,4,290,0
"020061509","CABA",227,227,0,0,0,0,1
"064100307","BUENOS AIRES",276,0,207,68,0,275,0
"064100507","BUENOS AIRES",200,20,124,51,0,175,0.1
"064100508","BUENOS AIRES",358,2,265,87,2,354,0.00558659217877095
"064100705","BUENOS AIRES",379,0,333,45,0,378,0
"064100709","BUENOS AIRES",305,0,269,31,0,300,0
"064100902","BUENOS AIRES",271,221,35,15,0,50,0.81549815498155
"064121006","BUENOS AIRES",345,6,175,154,3,332,0.0173913043478261
"064100906","BUENOS AIRES",314,213,94,7,0,101,0.678343949044586
"064101003","BUENOS AIRES",357,1,332,24,0,356,0.00280112044817927
"064101005","BUENOS AIRES",317,1,278,38,0,316,0.00315457413249211
"064101006","BUENOS AIRES",310,3,265,42,0,307,0.00967741935483871
"064101007","BUENOS AIRES",466,4,405,51,0,456,0.00858369098712446
"064101010","BUENOS AIRES",356,2,310,43,0,353,0.00561797752808989
"064101107","BUENOS AIRES",297,139,150,8,0,158,0.468013468013468
"064101205","BUENOS AIRES",245,0,211,34,0,245,0
"064101208","BUENOS AIRES",178,2,160,16,0,176,0.0112359550561798
"064101210","BUENOS AIRES",226,5,167,51,0,218,0.0221238938053097
"064101301","BUENOS AIRES",404,1,370,31,0,401,0.00247524752475248
"064120103","BUENOS AIRES",63,2,55,6,0,61,0.0317460317460317
"064120201","BUENOS AIRES",136,1,61,73,0,134,0.00735294117647059
"064120210","BUENOS AIRES",334,10,292,32,0,324,0.029940119760479
"064120211","BUENOS AIRES",299,0,230,68,0,298,0
"065150302","BUENOS AIRES",368,1,211,142,4,357,0.00271739130434783
"064120305","BUENOS AIRES",426,5,344,56,0,400,0.0117370892018779
"064120403","BUENOS AIRES",409,6,233,163,1,397,0.0146699266503667
"064270106","BUENOS AIRES",453,449,2,1,0,3,0.991169977924945
"064120407","BUENOS AIRES",354,8,214,126,1,341,0.0225988700564972
"064120410","BUENOS AIRES",384,2,291,81,2,374,0.00520833333333333
"064120507","BUENOS AIRES",338,0,289,47,0,336,0
"064120508","BUENOS AIRES",371,3,268,96,0,364,0.00808625336927224
"065150506","BUENOS AIRES",357,1,310,45,0,355,0.00280112044817927
"065150706","BUENOS AIRES",340,1,240,84,1,325,0.00294117647058824
"064120714","BUENOS AIRES",305,2,202,99,0,301,0.00655737704918033
"064120716","BUENOS AIRES",285,0,196,76,2,274,0
"064120805","BUENOS AIRES",267,2,207,57,0,264,0.00749063670411985
"064200610","BUENOS AIRES",50,46,0,0,0,0,0.92
"064120902","BUENOS AIRES",269,0,106,147,4,257,0
"064120909","BUENOS AIRES",354,1,169,177,1,347,0.00282485875706215
"064121015","BUENOS AIRES",306,247,20,29,1,50,0.80718954248366
"064201002","BUENOS AIRES",52,31,18,3,0,21,0.596153846153846
"064121209","BUENOS AIRES",414,0,232,163,1,396,0
"064121412","BUENOS AIRES",377,0,216,146,2,364,0
"064130105","BUENOS AIRES",282,247,5,2,0,7,0.875886524822695
"064130209","BUENOS AIRES",311,309,2,0,0,2,0.993569131832797
"064130412","BUENOS AIRES",248,240,6,2,0,8,0.967741935483871
"064130601","BUENOS AIRES",197,156,2,3,0,5,0.791878172588833
"064130611","BUENOS AIRES",295,286,2,6,1,9,0.969491525423729
"065180211","BUENOS AIRES",214,121,34,59,0,93,0.565420560747664
"064131406","BUENOS AIRES",147,93,10,40,1,51,0.63265306122449
"020061006","CABA",455,455,0,0,0,0,1
"064131408","BUENOS AIRES",178,129,9,28,1,38,0.724719101123595
"064131505","BUENOS AIRES",40,0,24,16,0,40,0
"064131508","BUENOS AIRES",34,1,25,8,0,33,0.0294117647058824
"064131509","BUENOS AIRES",34,0,11,23,0,34,0
"064132101","BUENOS AIRES",436,418,4,11,1,16,0.958715596330275
"064132107","BUENOS AIRES",267,263,3,0,1,4,0.98501872659176
"064132210","BUENOS AIRES",157,151,1,5,0,6,0.961783439490446
"064200103","BUENOS AIRES",109,28,40,40,1,81,0.256880733944954
"064200106","BUENOS AIRES",83,53,26,4,0,30,0.63855421686747
"064200416","BUENOS AIRES",70,66,0,4,0,4,0.942857142857143
"064200503","BUENOS AIRES",167,100,61,6,0,67,0.598802395209581
"064200509","BUENOS AIRES",274,119,98,45,1,144,0.434306569343066
"064200603","BUENOS AIRES",69,69,0,0,0,0,1
"064200905","BUENOS AIRES",76,70,1,4,1,6,0.921052631578947
"064200909","BUENOS AIRES",50,47,2,1,0,3,0.94
"064201001","BUENOS AIRES",110,1,60,43,3,106,0.00909090909090909
"064271509","BUENOS AIRES",258,254,2,2,0,4,0.984496124031008
"064201006","BUENOS AIRES",111,44,38,23,0,61,0.396396396396396
"064201206","BUENOS AIRES",62,2,37,23,0,60,0.032258064516129
"064201305","BUENOS AIRES",31,29,1,1,0,2,0.935483870967742
"064201308","BUENOS AIRES",39,37,0,2,0,2,0.948717948717949
"064201408","BUENOS AIRES",31,30,1,0,0,1,0.967741935483871
"064201502","BUENOS AIRES",24,24,0,0,0,0,1
"064201503","BUENOS AIRES",30,24,3,0,0,3,0.8
"064201601","BUENOS AIRES",22,21,1,0,0,1,0.954545454545455
"064201609","BUENOS AIRES",36,36,0,0,0,0,1
"064201610","BUENOS AIRES",37,34,3,0,0,3,0.918918918918919
"064201612","BUENOS AIRES",210,151,21,37,1,59,0.719047619047619
"064201708","BUENOS AIRES",131,119,8,2,0,10,0.908396946564885
"064201804","BUENOS AIRES",23,22,0,1,0,1,0.956521739130435
"064201809","BUENOS AIRES",38,37,1,0,0,1,0.973684210526316
"064201810","BUENOS AIRES",23,23,0,0,0,0,1
"064201910","BUENOS AIRES",136,114,8,8,0,16,0.838235294117647
"064202111","BUENOS AIRES",197,153,29,13,1,43,0.776649746192893
"064344205","BUENOS AIRES",261,13,88,160,0,248,0.0498084291187739
"064202205","BUENOS AIRES",81,78,1,2,0,3,0.962962962962963
"064202209","BUENOS AIRES",129,18,51,57,2,110,0.13953488372093
"064270204","BUENOS AIRES",353,349,2,2,0,4,0.988668555240793
"064270211","BUENOS AIRES",86,80,2,2,2,6,0.930232558139535
"064270215","BUENOS AIRES",181,179,2,0,0,2,0.988950276243094
"064270216","BUENOS AIRES",177,167,3,5,2,10,0.943502824858757
"064270302","BUENOS AIRES",390,389,1,0,0,1,0.997435897435897
"064270303","BUENOS AIRES",218,216,1,1,0,2,0.990825688073395
"064270310","BUENOS AIRES",382,373,8,1,0,9,0.976439790575916
"064270409","BUENOS AIRES",427,401,24,1,0,25,0.939110070257611
"064270506","BUENOS AIRES",392,371,14,4,0,18,0.946428571428571
"064270808","BUENOS AIRES",209,205,3,1,0,4,0.980861244019139
"064271108","BUENOS AIRES",413,397,8,5,0,13,0.961259079903148
"064271302","BUENOS AIRES",451,420,19,10,1,30,0.931263858093126
"064271306","BUENOS AIRES",246,225,16,5,0,21,0.914634146341463
"064271307","BUENOS AIRES",282,265,8,5,4,17,0.939716312056738
"064271402","BUENOS AIRES",318,294,9,12,0,21,0.924528301886792
"064271411","BUENOS AIRES",858,789,26,27,0,53,0.91958041958042
"064271419","BUENOS AIRES",323,304,6,13,0,19,0.941176470588235
"064271507","BUENOS AIRES",257,253,4,0,0,4,0.98443579766537
"064271512","BUENOS AIRES",413,395,12,2,0,14,0.956416464891041
"064271513","BUENOS AIRES",242,228,13,1,0,14,0.942148760330578
"064271602","BUENOS AIRES",475,475,0,0,0,0,1
"064271607","BUENOS AIRES",388,384,1,1,0,2,0.989690721649485
"064271804","BUENOS AIRES",641,213,139,257,14,410,0.332293291731669
"064271805","BUENOS AIRES",1080,497,169,339,23,531,0.460185185185185
"064271905","BUENOS AIRES",238,233,3,0,0,3,0.978991596638655
"064272102","BUENOS AIRES",449,412,21,3,2,26,0.917594654788419
"064272108","BUENOS AIRES",399,384,10,4,1,15,0.962406015037594
"064272301","BUENOS AIRES",150,143,4,3,0,7,0.953333333333333
"064272408","BUENOS AIRES",397,355,18,14,0,32,0.894206549118388
"064272514","BUENOS AIRES",180,170,5,4,1,10,0.944444444444444
"064272804","BUENOS AIRES",280,263,5,11,0,16,0.939285714285714
"064272805","BUENOS AIRES",262,242,6,14,0,20,0.923664122137405
"064272811","BUENOS AIRES",348,337,9,0,0,9,0.968390804597701
"064272902","BUENOS AIRES",366,356,5,5,0,10,0.972677595628415
"064272909","BUENOS AIRES",195,192,2,1,0,3,0.984615384615385
"064272913","BUENOS AIRES",292,264,18,7,0,25,0.904109589041096
"064273011","BUENOS AIRES",170,168,0,0,0,0,0.988235294117647
"064273203","BUENOS AIRES",262,259,3,0,0,3,0.988549618320611
"064273205","BUENOS AIRES",389,366,14,7,0,21,0.940874035989717
"064273207","BUENOS AIRES",366,361,3,2,0,5,0.986338797814208
"064273303","BUENOS AIRES",215,201,6,8,0,14,0.934883720930233
"064273413","BUENOS AIRES",311,306,3,1,0,4,0.983922829581994
"064273504","BUENOS AIRES",245,243,2,0,0,2,0.991836734693878
"064273703","BUENOS AIRES",212,189,13,9,0,22,0.891509433962264
"064273710","BUENOS AIRES",579,527,21,29,1,51,0.910189982728843
"064273802","BUENOS AIRES",378,367,10,1,0,11,0.970899470899471
"064341404","BUENOS AIRES",294,9,109,173,2,284,0.0306122448979592
"064273901","BUENOS AIRES",485,458,15,6,1,22,0.944329896907216
"064274001","BUENOS AIRES",342,280,31,21,1,53,0.818713450292398
"064274002","BUENOS AIRES",458,411,15,29,0,44,0.897379912663755
"064274003","BUENOS AIRES",262,230,14,18,0,32,0.877862595419847
"064274010","BUENOS AIRES",552,388,89,66,2,157,0.702898550724638
"064274107","BUENOS AIRES",924,275,297,292,6,595,0.297619047619048
"064274201","BUENOS AIRES",426,397,2,1,0,3,0.931924882629108
"064274207","BUENOS AIRES",296,272,16,8,0,24,0.918918918918919
"064274302","BUENOS AIRES",440,429,9,1,0,10,0.975
"064274606","BUENOS AIRES",606,242,241,115,2,358,0.399339933993399
"064274612","BUENOS AIRES",406,21,255,128,0,383,0.0517241379310345
"064274710","BUENOS AIRES",318,303,3,2,0,5,0.952830188679245
"064274801","BUENOS AIRES",172,68,22,69,0,91,0.395348837209302
"064274811","BUENOS AIRES",517,275,122,96,2,220,0.531914893617021
"064274906","BUENOS AIRES",619,333,108,103,1,212,0.537964458804523
"064275012","BUENOS AIRES",487,475,5,6,0,11,0.975359342915811
"064275103","BUENOS AIRES",296,290,5,1,0,6,0.97972972972973
"064275108","BUENOS AIRES",541,397,46,86,0,132,0.733826247689464
"064275109","BUENOS AIRES",405,312,28,53,1,82,0.77037037037037
"065151708","BUENOS AIRES",139,0,88,51,0,139,0
"020041409","CABA",262,262,0,0,0,0,1
"064275110","BUENOS AIRES",371,356,9,4,0,13,0.959568733153639
"064275206","BUENOS AIRES",395,24,46,306,4,356,0.0607594936708861
"064275212","BUENOS AIRES",354,7,79,260,0,339,0.019774011299435
"064275301","BUENOS AIRES",522,447,11,56,0,67,0.85632183908046
"064275304","BUENOS AIRES",457,37,98,301,1,400,0.0809628008752735
"064275502","BUENOS AIRES",268,241,20,4,0,24,0.899253731343284
"064275508","BUENOS AIRES",345,252,61,31,0,92,0.730434782608696
"064275513","BUENOS AIRES",454,408,30,14,0,44,0.898678414096916
"064275704","BUENOS AIRES",315,18,176,116,0,292,0.0571428571428571
"064275705","BUENOS AIRES",327,33,248,43,0,291,0.100917431192661
"064275710","BUENOS AIRES",308,19,172,111,1,284,0.0616883116883117
"064275712","BUENOS AIRES",426,13,287,113,0,400,0.0305164319248826
"064275813","BUENOS AIRES",282,13,140,125,0,265,0.0460992907801418
"064276001","BUENOS AIRES",488,16,356,104,0,460,0.0327868852459016
"064276005","BUENOS AIRES",525,13,354,153,2,509,0.0247619047619048
"020101907","CABA",328,328,0,0,0,0,1
"064276108","BUENOS AIRES",470,135,171,140,3,314,0.287234042553192
"064276113","BUENOS AIRES",340,3,196,132,0,328,0.00882352941176471
"064276203","BUENOS AIRES",326,161,100,60,0,160,0.493865030674847
"064276215","BUENOS AIRES",315,8,235,70,0,305,0.0253968253968254
"064276216","BUENOS AIRES",418,12,285,115,0,400,0.0287081339712919
"064276413","BUENOS AIRES",232,4,140,44,2,186,0.0172413793103448
"064276414","BUENOS AIRES",301,15,170,110,0,280,0.0498338870431894
"064276916","BUENOS AIRES",307,2,212,85,0,297,0.00651465798045603
"064277516","BUENOS AIRES",392,7,192,172,1,365,0.0178571428571429
"065600803","BUENOS AIRES",305,4,203,93,1,297,0.0131147540983607
"064276509","BUENOS AIRES",234,6,147,78,0,225,0.0256410256410256
"064276511","BUENOS AIRES",556,13,307,213,1,521,0.0233812949640288
"064276604","BUENOS AIRES",420,5,320,84,0,404,0.0119047619047619
"064276609","BUENOS AIRES",302,9,222,65,0,287,0.0298013245033113
"064276718","BUENOS AIRES",425,11,269,131,1,401,0.0258823529411765
"064276802","BUENOS AIRES",360,7,223,128,0,351,0.0194444444444444
"064276803","BUENOS AIRES",208,3,153,49,0,202,0.0144230769230769
"064276806","BUENOS AIRES",385,12,293,72,0,365,0.0311688311688312
"064276907","BUENOS AIRES",392,6,276,100,1,377,0.0153061224489796
"064276911","BUENOS AIRES",262,4,227,30,0,257,0.0152671755725191
"064276914","BUENOS AIRES",380,5,213,148,0,361,0.0131578947368421
"064276915","BUENOS AIRES",409,7,253,126,5,384,0.0171149144254279
"064412706","BUENOS AIRES",214,214,0,0,0,0,1
"064277006","BUENOS AIRES",315,16,217,75,0,292,0.0507936507936508
"064277007","BUENOS AIRES",269,12,158,88,0,246,0.0446096654275093
"064277014","BUENOS AIRES",324,14,265,39,0,304,0.0432098765432099
"064277101","BUENOS AIRES",397,4,269,107,0,376,0.0100755667506297
"064277303","BUENOS AIRES",361,9,211,120,0,331,0.0249307479224377
"064277206","BUENOS AIRES",273,10,171,85,0,256,0.0366300366300366
"064277209","BUENOS AIRES",355,9,167,137,4,308,0.0253521126760563
"064277403","BUENOS AIRES",433,21,186,203,1,390,0.0484988452655889
"064277404","BUENOS AIRES",312,19,135,148,1,284,0.0608974358974359
"064277406","BUENOS AIRES",497,13,273,201,2,476,0.0261569416498994
"064277413","BUENOS AIRES",300,3,198,89,2,289,0.01
"065601913","BUENOS AIRES",195,0,131,58,0,189,0
"064277507","BUENOS AIRES",436,5,120,288,7,415,0.0114678899082569
"064277509","BUENOS AIRES",319,4,83,222,1,306,0.0125391849529781
"064277511","BUENOS AIRES",434,8,134,274,6,414,0.0184331797235023
"064277515","BUENOS AIRES",370,7,182,160,0,342,0.0189189189189189
"064277703","BUENOS AIRES",516,1,377,122,0,499,0.00193798449612403
"064277704","BUENOS AIRES",545,4,382,153,0,535,0.0073394495412844
"064277805","BUENOS AIRES",453,14,218,193,2,413,0.0309050772626932
"064277807","BUENOS AIRES",427,12,229,169,1,399,0.0281030444964871
"064277902","BUENOS AIRES",295,0,195,83,1,279,0
"064277905","BUENOS AIRES",490,3,312,156,4,472,0.00612244897959184
"064277906","BUENOS AIRES",331,2,255,63,0,318,0.00604229607250755
"064278004","BUENOS AIRES",290,6,194,81,2,277,0.0206896551724138
"064278009","BUENOS AIRES",313,1,125,172,2,299,0.00319488817891374
"064278011","BUENOS AIRES",247,39,64,134,3,201,0.157894736842105
"064278202","BUENOS AIRES",309,4,172,123,2,297,0.0129449838187702
"064278203","BUENOS AIRES",380,6,229,130,2,361,0.0157894736842105
"064278308","BUENOS AIRES",339,2,130,168,1,299,0.00589970501474926
"064278313","BUENOS AIRES",447,2,313,126,1,440,0.00447427293064877
"064278413","BUENOS AIRES",518,3,126,335,12,473,0.00579150579150579
"064278416","BUENOS AIRES",422,2,174,217,1,392,0.004739336492891
"064341505","BUENOS AIRES",235,222,4,9,0,13,0.94468085106383
"064278417","BUENOS AIRES",440,1,277,149,3,429,0.00227272727272727
"064278502","BUENOS AIRES",506,9,245,237,1,483,0.0177865612648221
"064278612","BUENOS AIRES",313,0,202,98,1,301,0
"064278707","BUENOS AIRES",338,4,203,130,0,333,0.0118343195266272
"064278709","BUENOS AIRES",293,25,149,112,0,261,0.0853242320819113
"064278712","BUENOS AIRES",297,0,218,69,1,288,0
"064278810","BUENOS AIRES",395,1,314,71,0,385,0.00253164556962025
"064279006","BUENOS AIRES",347,3,237,99,0,336,0.00864553314121038
"065151803","BUENOS AIRES",388,1,189,182,3,374,0.00257731958762887
"064279315","BUENOS AIRES",486,11,156,250,20,426,0.0226337448559671
"064279403","BUENOS AIRES",481,6,352,115,0,467,0.0124740124740125
"064279411","BUENOS AIRES",454,3,306,131,1,438,0.0066079295154185
"064279501","BUENOS AIRES",322,9,167,133,3,303,0.0279503105590062
"064279502","BUENOS AIRES",425,2,248,159,2,409,0.00470588235294118
"064342002","BUENOS AIRES",337,242,66,28,0,94,0.718100890207715
"064279510","BUENOS AIRES",453,5,312,118,0,430,0.011037527593819
"064279513","BUENOS AIRES",385,5,240,125,0,365,0.012987012987013
"064279613","BUENOS AIRES",40,2,13,18,0,31,0.05
"065151805","BUENOS AIRES",299,2,88,190,3,281,0.00668896321070234
"064279616","BUENOS AIRES",143,2,101,38,0,139,0.013986013986014
"064340803","BUENOS AIRES",216,14,82,118,1,201,0.0648148148148148
"064340806","BUENOS AIRES",486,22,81,375,3,459,0.0452674897119342
"064340911","BUENOS AIRES",228,15,69,139,0,208,0.0657894736842105
"064340916","BUENOS AIRES",306,24,142,133,1,276,0.0784313725490196
"064342608","BUENOS AIRES",277,8,133,122,4,259,0.0288808664259928
"064340918","BUENOS AIRES",274,30,72,168,0,240,0.109489051094891
"064341111","BUENOS AIRES",289,69,84,133,0,217,0.238754325259516
"064341207","BUENOS AIRES",413,113,146,150,0,296,0.273607748184019
"064341402","BUENOS AIRES",218,1,107,110,0,217,0.00458715596330275
"064279701","BUENOS AIRES",326,5,154,150,1,305,0.0153374233128834
"064279705","BUENOS AIRES",208,0,117,87,0,204,0
"064340105","BUENOS AIRES",362,310,22,28,0,50,0.856353591160221
"064340108","BUENOS AIRES",299,247,20,8,0,28,0.826086956521739
"064340110","BUENOS AIRES",313,303,8,2,0,10,0.968051118210863
"064340404","BUENOS AIRES",217,181,22,14,0,36,0.834101382488479
"064340504","BUENOS AIRES",327,249,45,20,1,66,0.761467889908257
"064340506","BUENOS AIRES",257,208,35,14,0,49,0.809338521400778
"064340608","BUENOS AIRES",353,258,35,58,0,93,0.730878186968839
"064340609","BUENOS AIRES",338,220,48,47,0,95,0.650887573964497
"064340707","BUENOS AIRES",1286,1043,88,140,6,234,0.81104199066874
"064342007","BUENOS AIRES",240,20,116,104,0,220,0.0833333333333333
"064342107","BUENOS AIRES",197,15,116,66,0,182,0.0761421319796954
"064342110","BUENOS AIRES",193,11,86,96,0,182,0.0569948186528497
"064342205","BUENOS AIRES",260,53,165,42,0,207,0.203846153846154
"064342207","BUENOS AIRES",232,10,153,69,0,222,0.0431034482758621
"064342409","BUENOS AIRES",280,8,164,108,0,272,0.0285714285714286
"064342308","BUENOS AIRES",358,30,100,210,1,311,0.0837988826815642
"064342501","BUENOS AIRES",394,50,158,185,0,343,0.126903553299492
"064342502","BUENOS AIRES",207,25,128,51,0,179,0.120772946859903
"064342601","BUENOS AIRES",353,34,50,239,11,300,0.0963172804532578
"064342704","BUENOS AIRES",275,13,142,108,0,250,0.0472727272727273
"064342603","BUENOS AIRES",438,5,33,248,27,308,0.0114155251141553
"064342616","BUENOS AIRES",262,26,85,145,0,230,0.099236641221374
"064342617","BUENOS AIRES",293,27,102,154,2,258,0.0921501706484642
"064342706","BUENOS AIRES",332,14,176,140,0,316,0.0421686746987952
"064342803","BUENOS AIRES",446,20,251,169,0,420,0.0448430493273543
"064342902","BUENOS AIRES",384,26,157,201,0,358,0.0677083333333333
"064343112","BUENOS AIRES",238,238,0,0,0,0,1
"064342905","BUENOS AIRES",288,5,121,162,0,283,0.0173611111111111
"064343006","BUENOS AIRES",329,74,141,114,0,255,0.224924012158055
"064343212","BUENOS AIRES",238,195,19,24,0,43,0.819327731092437
"064343302","BUENOS AIRES",368,13,203,152,0,355,0.0353260869565217
"064343305","BUENOS AIRES",324,24,153,147,0,300,0.0740740740740741
"064343408","BUENOS AIRES",228,12,118,94,0,212,0.0526315789473684
"064343409","BUENOS AIRES",208,4,133,69,1,203,0.0192307692307692
"064343502","BUENOS AIRES",201,8,113,79,0,192,0.0398009950248756
"064343508","BUENOS AIRES",420,158,67,180,2,249,0.376190476190476
"064343602","BUENOS AIRES",391,44,187,159,0,346,0.112531969309463
"064343703","BUENOS AIRES",233,77,69,87,0,156,0.330472103004292
"064343801","BUENOS AIRES",168,133,21,14,0,35,0.791666666666667
"064343902","BUENOS AIRES",223,14,118,91,0,209,0.062780269058296
"064343903","BUENOS AIRES",270,130,73,67,0,140,0.481481481481481
"064344002","BUENOS AIRES",364,65,152,146,0,298,0.178571428571429
"064344208","BUENOS AIRES",270,17,95,158,0,253,0.062962962962963
"064344411","BUENOS AIRES",257,32,127,97,0,224,0.124513618677043
"064410103","BUENOS AIRES",233,222,0,10,0,10,0.952789699570815
"064410709","BUENOS AIRES",246,244,0,1,0,1,0.991869918699187
"064410108","BUENOS AIRES",189,189,0,0,0,0,1
"064410109","BUENOS AIRES",305,301,2,2,0,4,0.986885245901639
"064410403","BUENOS AIRES",372,372,0,0,0,0,1
"064410407","BUENOS AIRES",313,312,1,0,0,1,0.996805111821086
"064410408","BUENOS AIRES",294,294,0,0,0,0,1
"064410702","BUENOS AIRES",191,189,2,0,0,2,0.989528795811518
"064410706","BUENOS AIRES",181,181,0,0,0,0,1
"064410903","BUENOS AIRES",201,201,0,0,0,0,1
"064410904","BUENOS AIRES",308,308,0,0,0,0,1
"064410912","BUENOS AIRES",284,278,0,6,0,6,0.97887323943662
"064411002","BUENOS AIRES",210,209,0,1,0,1,0.995238095238095
"064411008","BUENOS AIRES",234,233,1,0,0,1,0.995726495726496
"064411012","BUENOS AIRES",248,248,0,0,0,0,1
"064411101","BUENOS AIRES",195,194,1,0,0,1,0.994871794871795
"064411103","BUENOS AIRES",193,193,0,0,0,0,1
"064411104","BUENOS AIRES",173,172,1,0,0,1,0.994219653179191
"064411107","BUENOS AIRES",173,170,3,0,0,3,0.982658959537572
"064412811","BUENOS AIRES",313,313,0,0,0,0,1
"064411108","BUENOS AIRES",192,192,0,0,0,0,1
"064411809","BUENOS AIRES",204,204,0,0,0,0,1
"064411409","BUENOS AIRES",191,190,1,0,0,1,0.994764397905759
"064411501","BUENOS AIRES",290,290,0,0,0,0,1
"064411503","BUENOS AIRES",228,228,0,0,0,0,1
"064411601","BUENOS AIRES",329,323,2,0,0,2,0.981762917933131
"064411614","BUENOS AIRES",332,331,1,0,0,1,0.996987951807229
"064411703","BUENOS AIRES",264,263,0,1,0,1,0.996212121212121
"064411801","BUENOS AIRES",160,160,0,0,0,0,1
"064411806","BUENOS AIRES",168,168,0,0,0,0,1
"064411906","BUENOS AIRES",251,250,1,0,0,1,0.99601593625498
"064412003","BUENOS AIRES",268,268,0,0,0,0,1
"064412010","BUENOS AIRES",178,176,1,0,0,1,0.98876404494382
"064412011","BUENOS AIRES",140,140,0,0,0,0,1
"064412101","BUENOS AIRES",193,189,4,0,0,4,0.979274611398964
"064412112","BUENOS AIRES",204,203,0,0,0,0,0.995098039215686
"064412113","BUENOS AIRES",352,351,1,0,0,1,0.997159090909091
"064412209","BUENOS AIRES",254,252,1,0,0,1,0.992125984251969
"064412305","BUENOS AIRES",231,225,3,3,0,6,0.974025974025974
"064412407","BUENOS AIRES",190,190,0,0,0,0,1
"064412409","BUENOS AIRES",276,275,1,0,0,1,0.996376811594203
"064412510","BUENOS AIRES",274,274,0,0,0,0,1
"064412813","BUENOS AIRES",356,350,5,1,0,6,0.98314606741573
"064412905","BUENOS AIRES",234,234,0,0,0,0,1
"020062003","CABA",447,445,2,0,0,2,0.995525727069351
"064412911","BUENOS AIRES",189,188,1,0,0,1,0.994708994708995
"064412913","BUENOS AIRES",330,327,3,0,0,3,0.990909090909091
"064413005","BUENOS AIRES",239,228,6,5,0,11,0.95397489539749
"064413007","BUENOS AIRES",194,192,1,1,0,2,0.989690721649485
"065952404","BUENOS AIRES",283,276,2,5,0,7,0.975265017667845
"064413112","BUENOS AIRES",292,288,2,2,0,4,0.986301369863014
"064413116","BUENOS AIRES",229,228,1,0,0,1,0.995633187772926
"064413201","BUENOS AIRES",206,202,4,0,0,4,0.980582524271845
"064413210","BUENOS AIRES",292,158,59,70,0,129,0.541095890410959
"064413302","BUENOS AIRES",173,146,3,0,0,3,0.84393063583815
"064413405","BUENOS AIRES",317,310,3,4,0,7,0.977917981072555
"064413415","BUENOS AIRES",460,10,204,238,1,443,0.0217391304347826
"064413506","BUENOS AIRES",241,203,4,4,0,8,0.842323651452282
"064414402","BUENOS AIRES",251,17,136,94,0,230,0.0677290836653386
"064413508","BUENOS AIRES",366,217,119,28,0,147,0.592896174863388
"064413607","BUENOS AIRES",271,80,136,50,0,186,0.29520295202952
"064413610","BUENOS AIRES",372,342,21,6,0,27,0.919354838709677
"064413702","BUENOS AIRES",369,11,174,174,1,349,0.029810298102981
"064413710","BUENOS AIRES",420,261,58,91,0,149,0.621428571428571
"064413808","BUENOS AIRES",208,5,40,149,0,189,0.0240384615384615
"064413901","BUENOS AIRES",308,306,2,0,0,2,0.993506493506494
"064413909","BUENOS AIRES",271,266,4,1,0,5,0.981549815498155
"064414001","BUENOS AIRES",276,257,10,8,0,18,0.931159420289855
"064414103","BUENOS AIRES",357,6,53,286,2,341,0.0168067226890756
"064414104","BUENOS AIRES",418,34,211,169,0,380,0.0813397129186603
"064414210","BUENOS AIRES",469,42,134,254,4,392,0.0895522388059701
"064414216","BUENOS AIRES",364,199,63,96,0,159,0.546703296703297
"064414311","BUENOS AIRES",228,181,16,8,1,25,0.793859649122807
"064414501","BUENOS AIRES",230,8,180,37,1,218,0.0347826086956522
"067562402","BUENOS AIRES",195,182,11,2,0,13,0.933333333333333
"064414505","BUENOS AIRES",250,6,121,121,1,243,0.024
"064414506","BUENOS AIRES",313,8,146,143,5,294,0.0255591054313099
"064414508","BUENOS AIRES",305,6,167,126,0,293,0.019672131147541
"064414509","BUENOS AIRES",356,13,103,225,1,329,0.0365168539325843
"064414608","BUENOS AIRES",326,176,61,85,0,146,0.539877300613497
"064414802","BUENOS AIRES",174,145,19,9,0,28,0.833333333333333
"064414902","BUENOS AIRES",274,273,0,0,0,0,0.996350364963504
"064414904","BUENOS AIRES",216,216,0,0,0,0,1
"064415005","BUENOS AIRES",199,198,0,0,0,0,0.994974874371859
"064415109","BUENOS AIRES",215,215,0,0,0,0,1
"064415112","BUENOS AIRES",177,173,0,3,0,3,0.977401129943503
"064415205","BUENOS AIRES",274,244,3,1,19,23,0.89051094890511
"064415207","BUENOS AIRES",321,281,13,9,12,34,0.875389408099688
"064415303","BUENOS AIRES",191,181,6,4,0,10,0.947643979057592
"064416209","BUENOS AIRES",197,176,18,1,1,20,0.893401015228426
"020032304","CABA",191,188,0,0,0,0,0.984293193717278
"064415309","BUENOS AIRES",369,88,220,58,0,278,0.238482384823848
"064415310","BUENOS AIRES",391,19,110,242,6,358,0.0485933503836317
"064415402","BUENOS AIRES",264,153,56,51,2,109,0.579545454545455
"064415406","BUENOS AIRES",154,145,8,1,0,9,0.941558441558442
"064415413","BUENOS AIRES",126,41,59,25,1,85,0.325396825396825
"064415606","BUENOS AIRES",389,343,32,9,2,43,0.881748071979435
"064415701","BUENOS AIRES",41,5,32,4,0,36,0.121951219512195
"064415805","BUENOS AIRES",168,168,0,0,0,0,1
"064415901","BUENOS AIRES",228,224,2,2,0,4,0.982456140350877
"064415910","BUENOS AIRES",385,117,209,58,0,267,0.303896103896104
"064416101","BUENOS AIRES",252,249,2,0,0,2,0.988095238095238
"064416103","BUENOS AIRES",227,185,31,10,0,41,0.814977973568282
"066232002","BUENOS AIRES",400,146,65,164,4,233,0.365
"064416307","BUENOS AIRES",225,3,194,26,0,220,0.0133333333333333
"064416514","BUENOS AIRES",206,1,84,107,2,193,0.00485436893203883
"064416502","BUENOS AIRES",179,0,61,94,1,156,0
"064416506","BUENOS AIRES",98,0,20,54,3,77,0
"064416601","BUENOS AIRES",238,2,85,136,2,223,0.00840336134453781
"064416607","BUENOS AIRES",390,322,18,44,0,62,0.825641025641026
"064416901","BUENOS AIRES",344,20,145,162,2,309,0.0581395348837209
"064416907","BUENOS AIRES",227,5,118,94,0,212,0.0220264317180617
"064417004","BUENOS AIRES",457,12,223,186,1,410,0.0262582056892779
"064900807","BUENOS AIRES",193,193,0,0,0,0,1
"064901312","BUENOS AIRES",315,6,144,150,0,294,0.019047619047619
"064550106","BUENOS AIRES",288,258,11,6,0,17,0.895833333333333
"064550110","BUENOS AIRES",271,253,8,10,0,18,0.933579335793358
"064550114","BUENOS AIRES",257,143,32,80,1,113,0.556420233463035
"065151904","BUENOS AIRES",416,1,214,179,0,393,0.00240384615384615
"066380909","BUENOS AIRES",376,7,180,151,3,334,0.0186170212765957
"064551401","BUENOS AIRES",320,278,12,13,2,27,0.86875
"064551412","BUENOS AIRES",355,176,78,99,1,178,0.495774647887324
"064620703","BUENOS AIRES",398,278,34,74,1,109,0.698492462311558
"064620706","BUENOS AIRES",446,304,47,87,1,135,0.681614349775785
"064690106","BUENOS AIRES",367,357,1,8,0,9,0.97275204359673
"064690108","BUENOS AIRES",355,339,6,9,0,15,0.954929577464789
"064690114","BUENOS AIRES",262,121,33,102,1,136,0.461832061068702
"064690203","BUENOS AIRES",321,159,62,96,0,158,0.495327102803738
"064690207","BUENOS AIRES",319,313,5,1,0,6,0.981191222570533
"064904411","BUENOS AIRES",224,5,140,77,0,217,0.0223214285714286
"064690212","BUENOS AIRES",264,20,66,176,0,242,0.0757575757575758
"064690401","BUENOS AIRES",201,9,93,93,0,186,0.0447761194029851
"066381711","BUENOS AIRES",189,181,5,3,0,8,0.957671957671958
"064690601","BUENOS AIRES",255,67,77,106,1,184,0.262745098039216
"064690801","BUENOS AIRES",228,1,179,48,0,227,0.0043859649122807
"064691301","BUENOS AIRES",265,0,170,94,0,264,0
"064761407","BUENOS AIRES",148,145,1,1,0,2,0.97972972972973
"064830410","BUENOS AIRES",183,0,123,59,0,182,0
"064830412","BUENOS AIRES",271,19,131,119,0,250,0.0701107011070111
"064830414","BUENOS AIRES",269,7,175,84,1,260,0.0260223048327138
"066480502","BUENOS AIRES",400,5,167,206,5,378,0.0125
"064830702","BUENOS AIRES",50,0,26,21,2,49,0
"064830801","BUENOS AIRES",106,0,77,29,0,106,0
"060070603","BUENOS AIRES",10,0,5,5,0,10,0
"064900102","BUENOS AIRES",306,32,42,232,0,274,0.104575163398693
"064900104","BUENOS AIRES",231,22,51,158,0,209,0.0952380952380952
"064900502","BUENOS AIRES",379,36,101,238,2,341,0.0949868073878628
"064900507","BUENOS AIRES",285,8,178,96,0,274,0.0280701754385965
"064900513","BUENOS AIRES",209,45,34,127,0,161,0.215311004784689
"064900603","BUENOS AIRES",250,192,33,25,0,58,0.768
"064900607","BUENOS AIRES",332,33,135,162,0,297,0.0993975903614458
"064900702","BUENOS AIRES",274,8,121,141,1,263,0.0291970802919708
"064900707","BUENOS AIRES",293,27,92,170,1,263,0.0921501706484642
"064900709","BUENOS AIRES",218,4,69,144,1,214,0.018348623853211
"064900711","BUENOS AIRES",211,10,99,98,0,197,0.0473933649289099
"064900902","BUENOS AIRES",295,248,31,16,0,47,0.840677966101695
"064900904","BUENOS AIRES",182,121,43,18,0,61,0.664835164835165
"064900907","BUENOS AIRES",251,249,2,0,0,2,0.99203187250996
"064901002","BUENOS AIRES",388,341,29,18,0,47,0.878865979381443
"064901209","BUENOS AIRES",314,114,121,78,1,200,0.363057324840764
"064901307","BUENOS AIRES",243,241,2,0,0,2,0.991769547325103
"060070606","BUENOS AIRES",14,0,4,6,1,11,0
"064901315","BUENOS AIRES",456,19,279,155,0,434,0.0416666666666667
"064901503","BUENOS AIRES",245,10,83,145,0,228,0.0408163265306122
"064201807","BUENOS AIRES",23,21,2,0,0,2,0.91304347826087
"064901602","BUENOS AIRES",198,6,130,61,0,191,0.0303030303030303
"064901605","BUENOS AIRES",356,11,149,188,0,337,0.0308988764044944
"064901606","BUENOS AIRES",257,7,101,122,0,223,0.0272373540856031
"064901708","BUENOS AIRES",428,9,177,230,1,408,0.0210280373831776
"064901807","BUENOS AIRES",332,29,190,102,1,293,0.0873493975903614
"064901808","BUENOS AIRES",352,321,24,7,0,31,0.911931818181818
"064901813","BUENOS AIRES",442,15,252,175,0,427,0.0339366515837104
"064901816","BUENOS AIRES",299,1,131,161,1,293,0.00334448160535117
"064901903","BUENOS AIRES",245,236,4,5,0,9,0.963265306122449
"064902002","BUENOS AIRES",283,21,190,72,0,262,0.0742049469964664
"064902005","BUENOS AIRES",294,290,2,2,0,4,0.986394557823129
"064902104","BUENOS AIRES",247,245,2,0,0,2,0.991902834008097
"064902206","BUENOS AIRES",268,268,0,0,0,0,1
"065682710","BUENOS AIRES",278,0,199,76,1,276,0
"064902304","BUENOS AIRES",266,232,22,12,0,34,0.87218045112782
"064902305","BUENOS AIRES",265,254,5,6,0,11,0.958490566037736
"064902311","BUENOS AIRES",198,198,0,0,0,0,1
"064902313","BUENOS AIRES",175,171,1,3,0,4,0.977142857142857
"065952511","BUENOS AIRES",302,39,167,94,0,261,0.129139072847682
"064902613","BUENOS AIRES",309,260,36,11,0,47,0.841423948220065
"064902701","BUENOS AIRES",301,72,188,40,0,228,0.239202657807309
"064902705","BUENOS AIRES",422,8,287,122,2,411,0.018957345971564
"064902707","BUENOS AIRES",311,15,216,80,0,296,0.0482315112540193
"064902801","BUENOS AIRES",297,7,170,118,0,288,0.0235690235690236
"064902804","BUENOS AIRES",444,36,188,218,0,406,0.0810810810810811
"064902906","BUENOS AIRES",378,11,84,255,5,344,0.0291005291005291
"064903007","BUENOS AIRES",303,6,158,138,0,296,0.0198019801980198
"064903202","BUENOS AIRES",432,21,135,266,2,403,0.0486111111111111
"064903209","BUENOS AIRES",238,10,100,124,0,224,0.0420168067226891
"065810205","BUENOS AIRES",165,164,1,0,0,1,0.993939393939394
"064903210","BUENOS AIRES",338,11,127,182,4,313,0.0325443786982249
"064903410","BUENOS AIRES",353,8,120,200,0,320,0.0226628895184136
"064903509","BUENOS AIRES",265,10,100,129,3,232,0.0377358490566038
"064903510","BUENOS AIRES",288,7,86,167,0,253,0.0243055555555556
"064903609","BUENOS AIRES",300,23,120,142,0,262,0.0766666666666667
"064903612","BUENOS AIRES",317,3,75,212,0,287,0.00946372239747634
"064903701","BUENOS AIRES",367,16,197,139,1,337,0.0435967302452316
"064903702","BUENOS AIRES",294,15,88,168,0,256,0.0510204081632653
"064903802","BUENOS AIRES",363,56,180,127,0,307,0.154269972451791
"064903813","BUENOS AIRES",219,3,73,142,0,215,0.0136986301369863
"064903816","BUENOS AIRES",516,28,135,345,0,480,0.0542635658914729
"064904002","BUENOS AIRES",250,13,41,189,0,230,0.052
"064904101","BUENOS AIRES",27,14,5,8,0,13,0.518518518518518
"064904202","BUENOS AIRES",351,7,230,113,1,344,0.0199430199430199
"064904203","BUENOS AIRES",280,18,156,106,0,262,0.0642857142857143
"064904407","BUENOS AIRES",361,26,190,145,0,335,0.07202216066482
"064904304","BUENOS AIRES",342,13,161,167,0,328,0.0380116959064327
"064904502","BUENOS AIRES",373,7,225,138,0,363,0.0187667560321716
"064904601","BUENOS AIRES",297,287,9,1,0,10,0.966329966329966
"064904611","BUENOS AIRES",356,301,37,17,0,54,0.845505617977528
"064904701","BUENOS AIRES",71,0,54,17,0,71,0
"064904706","BUENOS AIRES",246,79,136,31,0,167,0.321138211382114
"065391205","BUENOS AIRES",314,7,161,134,1,296,0.0222929936305732
"065391207","BUENOS AIRES",318,0,216,97,0,313,0
"065391208","BUENOS AIRES",378,0,250,113,2,365,0
"065391407","BUENOS AIRES",499,4,382,103,0,485,0.00801603206412826
"060840303","BUENOS AIRES",13,0,7,6,0,13,0
"060840804","BUENOS AIRES",6,0,2,4,0,6,0
"060070104","BUENOS AIRES",1,0,0,1,0,1,0
"060070203","BUENOS AIRES",12,0,5,6,1,12,0
"060070204","BUENOS AIRES",4,0,2,2,0,4,0
"060070208","BUENOS AIRES",4,0,2,2,0,4,0
"060070302","BUENOS AIRES",7,0,6,1,0,7,0
"020032407","CABA",297,295,2,0,0,2,0.993265993265993
"067561305","BUENOS AIRES",348,311,22,14,1,37,0.89367816091954
"065391510","BUENOS AIRES",212,78,109,24,0,133,0.367924528301887
"060071009","BUENOS AIRES",6,0,6,0,0,6,0
"061820707","BUENOS AIRES",0,0,0,0,0,0,NA
"062310405","BUENOS AIRES",7,0,7,0,0,7,0
"060070306","BUENOS AIRES",19,0,12,6,1,19,0
"060070411","BUENOS AIRES",3,0,0,3,0,3,0
"060070504","BUENOS AIRES",10,0,4,5,0,9,0
"060070508","BUENOS AIRES",2,0,0,2,0,2,0
"060070613","BUENOS AIRES",8,0,3,5,0,8,0
"060070906","BUENOS AIRES",5,0,3,2,0,5,0
"065391607","BUENOS AIRES",409,408,0,1,0,1,0.997555012224939
"060071007","BUENOS AIRES",6,0,0,6,0,6,0
"062240905","BUENOS AIRES",10,0,2,7,1,10,0
"060210802","BUENOS AIRES",6,0,4,2,0,6,0
"060210803","BUENOS AIRES",16,0,10,6,0,16,0
"060210904","BUENOS AIRES",17,0,17,0,0,17,0
"060211003","BUENOS AIRES",8,0,3,5,0,8,0
"061961205","BUENOS AIRES",14,0,12,1,1,14,0
"060282012","BUENOS AIRES",195,0,62,113,5,180,0
"062030903","BUENOS AIRES",2,0,0,2,0,2,0
"060421401","BUENOS AIRES",69,1,17,45,2,64,0.0144927536231884
"060490901","BUENOS AIRES",31,0,11,20,0,31,0
"060562701","BUENOS AIRES",46,0,18,24,2,44,0
"060631202","BUENOS AIRES",17,0,4,13,0,17,0
"060491009","BUENOS AIRES",57,1,11,40,2,53,0.0175438596491228
"060491402","BUENOS AIRES",21,1,2,18,0,20,0.0476190476190476
"065391907","BUENOS AIRES",315,278,15,16,0,31,0.882539682539683
"060491601","BUENOS AIRES",32,0,6,25,1,32,0
"060630603","BUENOS AIRES",25,0,4,16,1,21,0
"060630904","BUENOS AIRES",7,0,2,5,0,7,0
"060840604","BUENOS AIRES",10,0,3,7,0,10,0
"060563001","BUENOS AIRES",43,1,24,18,0,42,0.0232558139534884
"065600718","BUENOS AIRES",326,0,161,157,1,319,0
"065391906","BUENOS AIRES",259,231,12,9,1,22,0.891891891891892
"060563212","BUENOS AIRES",22,9,2,8,0,10,0.409090909090909
"060630304","BUENOS AIRES",17,0,1,16,0,17,0
"060630404","BUENOS AIRES",40,0,20,17,1,38,0
"060630501","BUENOS AIRES",8,0,4,4,0,8,0
"062311004","BUENOS AIRES",1,0,0,1,0,1,0
"060700802","BUENOS AIRES",8,0,7,1,0,8,0
"060700902","BUENOS AIRES",5,0,0,4,0,4,0
"065391706","BUENOS AIRES",282,187,53,36,0,89,0.663120567375887
"061260405","BUENOS AIRES",28,0,13,15,0,28,0
"061260912","BUENOS AIRES",1,0,0,1,0,1,0
"060770405","BUENOS AIRES",17,0,1,15,0,16,0
"060770508","BUENOS AIRES",22,0,11,11,0,22,0
"060771301","BUENOS AIRES",0,0,0,0,0,0,NA
"060840103","BUENOS AIRES",32,0,11,20,0,31,0
"060840304","BUENOS AIRES",17,0,4,13,0,17,0
"060840402","BUENOS AIRES",30,0,0,30,0,30,0
"065682203","BUENOS AIRES",141,114,22,5,0,27,0.808510638297872
"060840802","BUENOS AIRES",12,0,4,8,0,12,0
"067561508","BUENOS AIRES",202,6,158,38,0,196,0.0297029702970297
"065391807","BUENOS AIRES",414,234,71,104,0,175,0.565217391304348
"061050301","BUENOS AIRES",101,0,41,58,2,101,0
"065391901","BUENOS AIRES",329,270,37,15,0,52,0.820668693009118
"061050602","BUENOS AIRES",37,0,18,18,0,36,0
"061050701","BUENOS AIRES",44,0,22,21,0,43,0
"061050804","BUENOS AIRES",4,0,0,4,0,4,0
"061120708","BUENOS AIRES",6,0,2,4,0,6,0
"061120902","BUENOS AIRES",2,0,0,2,0,2,0
"061120906","BUENOS AIRES",27,0,6,14,7,27,0
"061121105","BUENOS AIRES",0,0,0,0,0,0,NA
"061190205","BUENOS AIRES",38,0,23,14,1,38,0
"065391904","BUENOS AIRES",292,265,13,8,0,21,0.907534246575342
"061190705","BUENOS AIRES",17,0,11,6,0,17,0
"061190706","BUENOS AIRES",7,0,4,3,0,7,0
"064341007","BUENOS AIRES",332,18,99,214,0,313,0.0542168674698795
"061340702","BUENOS AIRES",18,0,9,9,0,18,0
"061340405","BUENOS AIRES",12,0,8,4,0,12,0
"061340804","BUENOS AIRES",13,0,8,4,1,13,0
"061400101","BUENOS AIRES",36,0,5,30,0,35,0
"063920203","BUENOS AIRES",14,0,1,12,0,13,0
"061400312","BUENOS AIRES",18,0,8,10,0,18,0
"061400403","BUENOS AIRES",30,21,7,1,0,8,0.7
"061470203","BUENOS AIRES",43,0,2,38,2,42,0
"061470304","BUENOS AIRES",16,0,8,8,0,16,0
"064410604","BUENOS AIRES",190,188,2,0,0,2,0.989473684210526
"061470604","BUENOS AIRES",4,0,4,0,0,4,0
"061470706","BUENOS AIRES",2,0,0,2,0,2,0
"061540104","BUENOS AIRES",13,0,6,7,0,13,0
"061471103","BUENOS AIRES",13,1,0,12,0,12,0.0769230769230769
"061540204","BUENOS AIRES",23,0,11,9,3,23,0
"061540804","BUENOS AIRES",16,0,4,11,0,15,0
"061610204","BUENOS AIRES",17,0,13,4,0,17,0
"061610401","BUENOS AIRES",26,2,16,8,0,24,0.0769230769230769
"061610502","BUENOS AIRES",7,0,1,4,2,7,0
"061610803","BUENOS AIRES",2,0,1,1,0,2,0
"061610804","BUENOS AIRES",14,0,5,8,0,13,0
"061680403","BUENOS AIRES",8,0,3,5,0,8,0
"064410605","BUENOS AIRES",271,271,0,0,0,0,1
"061681002","BUENOS AIRES",9,0,3,6,0,9,0
"061750302","BUENOS AIRES",5,0,0,5,0,5,0
"061750501","BUENOS AIRES",21,0,10,9,1,20,0
"061820701","BUENOS AIRES",14,0,12,2,0,14,0
"061820801","BUENOS AIRES",26,0,22,4,0,26,0
"061820903","BUENOS AIRES",15,0,4,11,0,15,0
"061890206","BUENOS AIRES",6,0,1,5,0,6,0
"061890303","BUENOS AIRES",7,0,0,7,0,7,0
"061890403","BUENOS AIRES",8,0,8,0,0,8,0
"062030708","BUENOS AIRES",2,0,0,2,0,2,0
"065392102","BUENOS AIRES",235,10,156,68,0,224,0.0425531914893617
"061890505","BUENOS AIRES",4,0,3,0,1,4,0
"061890606","BUENOS AIRES",1,0,1,0,0,1,0
"061890607","BUENOS AIRES",4,0,2,2,0,4,0
"061890706","BUENOS AIRES",2,0,2,0,0,2,0
"061891101","BUENOS AIRES",4,0,3,1,0,4,0
"061891206","BUENOS AIRES",7,0,4,3,0,7,0
"061891504","BUENOS AIRES",24,0,9,13,0,22,0
"062031004","BUENOS AIRES",6,0,3,3,0,6,0
"062100401","BUENOS AIRES",52,0,29,19,0,48,0
"061891507","BUENOS AIRES",5,0,3,2,0,5,0
"061960305","BUENOS AIRES",7,0,0,5,0,5,0
"061960504","BUENOS AIRES",4,0,0,4,0,4,0
"061960703","BUENOS AIRES",3,0,0,3,0,3,0
"061960706","BUENOS AIRES",3,0,0,2,0,2,0
"065951611","BUENOS AIRES",206,206,0,0,0,0,1
"061960802","BUENOS AIRES",13,0,2,10,1,13,0
"061960804","BUENOS AIRES",13,0,13,0,0,13,0
"061961108","BUENOS AIRES",7,0,0,7,0,7,0
"061961301","BUENOS AIRES",3,0,1,2,0,3,0
"062030207","BUENOS AIRES",36,0,14,21,0,35,0
"062030209","BUENOS AIRES",9,0,2,7,0,9,0
"062030506","BUENOS AIRES",7,0,1,5,0,6,0
"062030701","BUENOS AIRES",2,0,2,0,0,2,0
"062030704","BUENOS AIRES",5,0,2,3,0,5,0
"060561114","BUENOS AIRES",209,209,0,0,0,0,1
"062100811","BUENOS AIRES",87,1,29,43,3,75,0.0114942528735632
"062170201","BUENOS AIRES",30,0,16,14,0,30,0
"062170304","BUENOS AIRES",37,0,25,12,0,37,0
"065392314","BUENOS AIRES",332,7,199,113,2,314,0.0210843373493976
"020051802","CABA",375,365,3,0,1,4,0.973333333333333
"062170702","BUENOS AIRES",12,0,4,8,0,12,0
"065392402","BUENOS AIRES",283,0,216,62,0,278,0
"062171005","BUENOS AIRES",18,0,8,9,0,17,0
"064060103","BUENOS AIRES",16,0,6,10,0,16,0
"062240602","BUENOS AIRES",29,0,7,21,0,28,0
"062240801","BUENOS AIRES",10,0,0,10,0,10,0
"062241203","BUENOS AIRES",22,0,9,13,0,22,0
"062310105","BUENOS AIRES",22,0,14,5,2,21,0
"062310201","BUENOS AIRES",22,0,4,18,0,22,0
"062310403","BUENOS AIRES",9,0,6,3,0,9,0
"062310707","BUENOS AIRES",4,0,4,0,0,4,0
"062380607","BUENOS AIRES",43,0,22,20,1,43,0
"065392613","BUENOS AIRES",204,1,79,120,0,199,0.00490196078431373
"065600906","BUENOS AIRES",104,80,14,10,0,24,0.769230769230769
"064132001","BUENOS AIRES",0,0,0,0,0,0,NA
"062660102","BUENOS AIRES",70,0,55,14,0,69,0
"062660103","BUENOS AIRES",31,0,16,13,1,30,0
"062660402","BUENOS AIRES",5,0,5,0,0,5,0
"062940504","BUENOS AIRES",4,0,0,4,0,4,0
"062770104","BUENOS AIRES",22,0,12,9,1,22,0
"062800804","BUENOS AIRES",5,0,2,2,0,4,0
"062800810","BUENOS AIRES",9,0,3,6,0,9,0
"062800817","BUENOS AIRES",10,1,7,2,0,9,0.1
"063920204","BUENOS AIRES",6,0,2,4,0,6,0
"062870601","BUENOS AIRES",66,4,26,35,1,62,0.0606060606060606
"062940208","BUENOS AIRES",1,0,1,0,0,1,0
"065392703","BUENOS AIRES",396,27,155,205,1,361,0.0681818181818182
"062940814","BUENOS AIRES",7,0,1,5,0,6,0
"063150401","BUENOS AIRES",84,0,35,44,0,79,0
"063220305","BUENOS AIRES",13,0,8,3,0,11,0
"063220401","BUENOS AIRES",6,0,0,6,0,6,0
"063220403","BUENOS AIRES",10,0,0,10,0,10,0
"063920504","BUENOS AIRES",9,0,3,4,0,7,0
"063220902","BUENOS AIRES",10,0,6,4,0,10,0
"063220802","BUENOS AIRES",8,0,3,5,0,8,0
"063290104","BUENOS AIRES",23,0,8,15,0,23,0
"063430401","BUENOS AIRES",27,0,13,14,0,27,0
"065392805","BUENOS AIRES",362,4,197,152,0,349,0.0110497237569061
"063430303","BUENOS AIRES",19,0,13,6,0,19,0
"063430802","BUENOS AIRES",18,0,8,10,0,18,0
"063510402","BUENOS AIRES",13,0,1,12,0,13,0
"063510502","BUENOS AIRES",6,0,0,5,1,6,0
"064201603","BUENOS AIRES",30,30,0,0,0,0,1
"063510614","BUENOS AIRES",11,0,6,0,1,7,0
"065392812","BUENOS AIRES",294,7,167,89,1,257,0.0238095238095238
"063577801","BUENOS AIRES",12,0,9,3,0,12,0
"063578206","BUENOS AIRES",217,0,122,89,2,213,0
"063640502","BUENOS AIRES",24,1,21,1,0,22,0.0416666666666667
"064830805","BUENOS AIRES",16,0,4,12,0,16,0
"063850104","BUENOS AIRES",1,0,1,0,0,1,0
"063850501","BUENOS AIRES",7,0,4,3,0,7,0
"063850601","BUENOS AIRES",19,0,10,8,0,18,0
"063920505","BUENOS AIRES",1,0,1,0,0,1,0
"063920709","BUENOS AIRES",23,0,11,12,0,23,0
"063921302","BUENOS AIRES",26,0,15,11,0,26,0
"063921404","BUENOS AIRES",10,0,7,3,0,10,0
"063990701","BUENOS AIRES",11,0,4,4,0,8,0
"064060105","BUENOS AIRES",9,0,4,5,0,9,0
"064060307","BUENOS AIRES",5,0,3,2,0,5,0
"064060309","BUENOS AIRES",6,0,1,5,0,6,0
"064130701","BUENOS AIRES",0,0,0,0,0,0,NA
"064131805","BUENOS AIRES",4,0,1,3,0,4,0
"064131901","BUENOS AIRES",15,1,5,9,0,14,0.0666666666666667
"064275711","BUENOS AIRES",275,9,129,129,0,258,0.0327272727272727
"065050101","BUENOS AIRES",27,0,16,11,0,27,0
"064273405","BUENOS AIRES",343,339,4,0,0,4,0.988338192419825
"064132003","BUENOS AIRES",0,0,0,0,0,0,NA
"065881004","BUENOS AIRES",5,0,4,1,0,5,0
"066232702","BUENOS AIRES",4,0,1,3,0,4,0
"064620901","BUENOS AIRES",13,0,3,10,0,13,0
"064620405","BUENOS AIRES",36,4,12,19,1,32,0.111111111111111
"064620710","BUENOS AIRES",40,4,14,22,0,36,0.1
"064690404","BUENOS AIRES",14,0,8,6,0,14,0
"064690501","BUENOS AIRES",11,0,5,6,0,11,0
"064691107","BUENOS AIRES",29,0,15,13,0,28,0
"060561204","BUENOS AIRES",271,271,0,0,0,0,1
"064970207","BUENOS AIRES",47,0,31,16,0,47,0
"064971311","BUENOS AIRES",4,0,3,1,0,4,0
"065880106","BUENOS AIRES",305,302,1,2,0,3,0.99016393442623
"064417101","BUENOS AIRES",47,47,0,0,0,0,1
"064480802","BUENOS AIRES",8,0,6,2,0,8,0
"064620301","BUENOS AIRES",9,0,6,2,0,8,0
"020052011","CABA",302,300,1,0,0,1,0.993377483443709
"064760902","BUENOS AIRES",16,0,4,12,0,16,0
"064761002","BUENOS AIRES",10,0,2,8,0,10,0
"064761104","BUENOS AIRES",8,0,4,4,0,8,0
"064830907","BUENOS AIRES",27,0,15,12,0,27,0
"065050102","BUENOS AIRES",36,0,8,27,1,36,0
"065050209","BUENOS AIRES",34,5,19,10,0,29,0.147058823529412
"066720701","BUENOS AIRES",34,0,8,26,0,34,0
"065810212","BUENOS AIRES",242,193,14,30,2,46,0.797520661157025
"065050406","BUENOS AIRES",38,0,29,9,0,38,0
"067001201","BUENOS AIRES",8,0,2,6,0,8,0
"067701304","BUENOS AIRES",20,0,10,10,0,20,0
"861540204","SANTIAGO DEL ESTERO",10,0,1,4,4,9,0
"065180105","BUENOS AIRES",7,0,3,4,0,7,0
"065180106","BUENOS AIRES",3,0,1,2,0,3,0
"065180108","BUENOS AIRES",6,0,3,3,0,6,0
"065180109","BUENOS AIRES",9,0,8,1,0,9,0
"065180305","BUENOS AIRES",28,0,14,13,0,27,0
"065180805","BUENOS AIRES",4,0,2,0,1,3,0
"066510810","BUENOS AIRES",11,0,3,8,0,11,0
"066510709","BUENOS AIRES",3,0,2,1,0,3,0
"065180402","BUENOS AIRES",20,0,5,15,0,20,0
"067140302","BUENOS AIRES",8,0,2,6,0,8,0
"065180405","BUENOS AIRES",14,0,3,11,0,14,0
"065180410","BUENOS AIRES",6,0,4,1,0,5,0
"067701306","BUENOS AIRES",8,0,0,7,1,8,0
"067701701","BUENOS AIRES",6,0,0,6,0,6,0
"067910603","BUENOS AIRES",23,0,16,6,1,23,0
"067701102","BUENOS AIRES",14,1,3,10,0,13,0.0714285714285714
"065180811","BUENOS AIRES",15,0,7,8,0,15,0
"065250301","BUENOS AIRES",35,0,16,14,0,30,0
"065740503","BUENOS AIRES",41,0,9,32,0,41,0
"065810906","BUENOS AIRES",8,0,7,1,0,8,0
"065810703","BUENOS AIRES",25,0,3,22,0,25,0
"065881304","BUENOS AIRES",23,0,7,14,1,22,0
"064201702","BUENOS AIRES",5,4,0,0,0,0,0.8
"065250412","BUENOS AIRES",80,0,20,39,1,60,0
"065250503","BUENOS AIRES",19,0,16,3,0,19,0
"065320504","BUENOS AIRES",49,0,20,29,0,49,0
"065321002","BUENOS AIRES",21,0,10,8,3,21,0
"065392909","BUENOS AIRES",132,0,20,99,4,123,0
"065601005","BUENOS AIRES",395,165,95,128,0,223,0.417721518987342
"065601008","BUENOS AIRES",363,12,234,108,0,342,0.0330578512396694
"065601013","BUENOS AIRES",345,266,59,18,0,77,0.771014492753623
"065601103","BUENOS AIRES",238,2,181,46,0,227,0.00840336134453781
"065950501","BUENOS AIRES",60,0,19,37,1,57,0
"066020205","BUENOS AIRES",38,0,13,22,0,35,0
"067701206","BUENOS AIRES",6,0,3,2,1,6,0
"065392910","BUENOS AIRES",39,0,10,19,0,29,0
"065392911","BUENOS AIRES",191,0,88,96,0,184,0
"065392924","BUENOS AIRES",478,3,291,173,0,464,0.00627615062761506
"065810806","BUENOS AIRES",15,1,7,6,1,14,0.0666666666666667
"065810902","BUENOS AIRES",10,0,3,7,0,10,0
"065810805","BUENOS AIRES",17,0,7,10,0,17,0
"065810909","BUENOS AIRES",3,0,1,2,0,3,0
"065393004","BUENOS AIRES",404,7,230,164,0,394,0.0173267326732673
"066510809","BUENOS AIRES",8,0,6,2,0,8,0
"065811005","BUENOS AIRES",9,0,2,7,0,9,0
"065811103","BUENOS AIRES",16,0,6,9,1,16,0
"065811203","BUENOS AIRES",15,0,7,7,1,15,0
"065880308","BUENOS AIRES",17,0,7,10,0,17,0
"065880309","BUENOS AIRES",42,0,8,33,1,42,0
"065881006","BUENOS AIRES",19,0,9,10,0,19,0
"066091801","BUENOS AIRES",12,0,5,7,0,12,0
"065881008","BUENOS AIRES",20,0,4,15,0,19,0
"067600508","BUENOS AIRES",532,411,87,31,0,118,0.772556390977444
"066020903","BUENOS AIRES",11,0,3,8,0,11,0
"065393014","BUENOS AIRES",502,5,296,186,3,485,0.0099601593625498
"068331708","BUENOS AIRES",16,0,11,5,0,16,0
"066090302","BUENOS AIRES",4,0,2,2,0,4,0
"066090402","BUENOS AIRES",10,0,3,7,0,10,0
"066090611","BUENOS AIRES",15,0,1,10,1,12,0
"066090612","BUENOS AIRES",2,0,0,2,0,2,0
"066090702","BUENOS AIRES",4,0,1,3,0,4,0
"066090901","BUENOS AIRES",24,0,9,12,0,21,0
"066090906","BUENOS AIRES",17,0,3,10,2,15,0
"066091401","BUENOS AIRES",13,0,8,4,1,13,0
"066091704","BUENOS AIRES",13,0,11,2,0,13,0
"065391107","BUENOS AIRES",512,0,375,123,0,498,0
"066160107","BUENOS AIRES",40,0,11,29,0,40,0
"066160201","BUENOS AIRES",10,0,9,1,0,10,0
"066160202","BUENOS AIRES",8,0,3,5,0,8,0
"066230705","BUENOS AIRES",9,0,1,8,0,9,0
"066231604","BUENOS AIRES",22,4,9,7,0,16,0.181818181818182
"066232106","BUENOS AIRES",71,3,21,45,0,66,0.0422535211267606
"066232212","BUENOS AIRES",18,5,9,4,0,13,0.277777777777778
"066232704","BUENOS AIRES",9,0,5,4,0,9,0
"066232601","BUENOS AIRES",25,0,4,21,0,25,0
"066510103","BUENOS AIRES",27,0,7,19,1,27,0
"066510304","BUENOS AIRES",7,0,7,0,0,7,0
"066510405","BUENOS AIRES",6,0,2,4,0,6,0
"065391201","BUENOS AIRES",346,2,220,118,0,338,0.00578034682080925
"066510815","BUENOS AIRES",5,0,3,2,0,5,0
"066511102","BUENOS AIRES",7,0,1,5,0,6,0
"066511306","BUENOS AIRES",15,0,7,7,0,14,0
"065681813","BUENOS AIRES",255,2,229,24,0,253,0.00784313725490196
"066550208","BUENOS AIRES",25,0,6,19,0,25,0
"066650105","BUENOS AIRES",66,0,29,37,0,66,0
"066650301","BUENOS AIRES",18,2,9,5,0,14,0.111111111111111
"066651101","BUENOS AIRES",21,0,3,13,5,21,0
"066651301","BUENOS AIRES",9,0,5,2,2,9,0
"066721001","BUENOS AIRES",18,0,9,9,0,18,0
"066790503","BUENOS AIRES",10,0,4,6,0,10,0
"065393204","BUENOS AIRES",309,0,108,196,2,306,0
"066721403","BUENOS AIRES",62,3,24,31,4,59,0.0483870967741935
"066790103","BUENOS AIRES",17,0,5,12,0,17,0
"066860401","BUENOS AIRES",4,0,1,3,0,4,0
"066860704","BUENOS AIRES",1,0,1,0,0,1,0
"066861003","BUENOS AIRES",15,0,6,8,1,15,0
"066930502","BUENOS AIRES",20,0,8,12,0,20,0
"067140306","BUENOS AIRES",4,0,2,1,1,4,0
"067140906","BUENOS AIRES",11,0,6,5,0,11,0
"067210213","BUENOS AIRES",13,0,6,7,0,13,0
"067280303","BUENOS AIRES",27,0,18,9,0,27,0
"066930702","BUENOS AIRES",16,0,13,3,0,16,0
"067000105","BUENOS AIRES",6,0,1,5,0,6,0
"067000303","BUENOS AIRES",6,0,5,1,0,6,0
"067000804","BUENOS AIRES",7,0,5,1,0,6,0
"067000805","BUENOS AIRES",6,0,2,4,0,6,0
"067070504","BUENOS AIRES",44,0,16,28,0,44,0
"067140207","BUENOS AIRES",12,0,6,6,0,12,0
"067280402","BUENOS AIRES",5,0,1,1,0,2,0
"067280803","BUENOS AIRES",18,1,1,16,0,17,0.0555555555555556
"067281302","BUENOS AIRES",33,0,20,13,0,33,0
"067281501","BUENOS AIRES",50,1,12,33,3,48,0.02
"067350305","BUENOS AIRES",22,0,7,15,0,22,0
"067350306","BUENOS AIRES",39,0,21,18,0,39,0
"067350503","BUENOS AIRES",14,0,4,10,0,14,0
"065393403","BUENOS AIRES",334,3,109,210,4,323,0.00898203592814371
"064201706","BUENOS AIRES",27,26,1,0,0,1,0.962962962962963
"065393404","BUENOS AIRES",329,1,131,188,2,321,0.00303951367781155
"067491509","BUENOS AIRES",107,1,34,32,32,98,0.00934579439252336
"067491513","BUENOS AIRES",75,5,22,22,24,68,0.0666666666666667
"067700905","BUENOS AIRES",5,0,0,5,0,5,0
"067631901","BUENOS AIRES",12,0,7,5,0,12,0
"067700601","BUENOS AIRES",3,0,0,3,0,3,0
"067700704","BUENOS AIRES",5,0,2,3,0,5,0
"064343204","BUENOS AIRES",151,151,0,0,0,0,1
"067701607","BUENOS AIRES",9,0,8,1,0,9,0
"067701803","BUENOS AIRES",7,0,6,1,0,7,0
"067841202","BUENOS AIRES",10,0,8,2,0,10,0
"067780504","BUENOS AIRES",29,1,5,23,0,28,0.0344827586206897
"067780701","BUENOS AIRES",15,0,7,8,0,15,0
"067840303","BUENOS AIRES",4,0,0,4,0,4,0
"067840403","BUENOS AIRES",5,0,2,3,0,5,0
"067840703","BUENOS AIRES",8,0,8,0,0,8,0
"067840812","BUENOS AIRES",15,0,4,11,0,15,0
"067841001","BUENOS AIRES",9,0,4,5,0,9,0
"065600202","BUENOS AIRES",429,2,198,218,0,416,0.00466200466200466
"065682906","BUENOS AIRES",273,1,186,84,0,270,0.00366300366300366
"065682905","BUENOS AIRES",263,0,208,45,0,253,0
"067910901","BUENOS AIRES",35,0,7,27,0,34,0
"067911103","BUENOS AIRES",23,0,9,12,0,21,0
"067980103","BUENOS AIRES",19,0,4,14,1,19,0
"067980202","BUENOS AIRES",7,0,1,4,0,5,0
"067980401","BUENOS AIRES",8,0,3,5,0,8,0
"067980506","BUENOS AIRES",14,0,3,10,1,14,0
"065250609","BUENOS AIRES",271,1,68,194,0,262,0.003690036900369
"067980801","BUENOS AIRES",14,0,1,13,0,14,0
"065530313","BUENOS AIRES",40,27,8,5,0,13,0.675
"065810507","BUENOS AIRES",94,94,0,0,0,0,1
"065470905","BUENOS AIRES",428,319,48,55,2,105,0.745327102803738
"065470906","BUENOS AIRES",359,338,8,11,0,19,0.94150417827298
"065530202","BUENOS AIRES",34,0,31,2,0,33,0
"065600112","BUENOS AIRES",312,298,6,5,0,11,0.955128205128205
"065600211","BUENOS AIRES",929,2,225,604,28,857,0.00215285252960172
"065601206","BUENOS AIRES",286,7,125,150,0,275,0.0244755244755245
"065601208","BUENOS AIRES",267,1,169,96,0,265,0.00374531835205993
"065600301","BUENOS AIRES",1080,1,334,595,51,980,0.000925925925925926
"065601213","BUENOS AIRES",304,7,195,96,0,291,0.0230263157894737
"065600310","BUENOS AIRES",382,2,241,125,1,367,0.00523560209424084
"065600412","BUENOS AIRES",301,2,218,76,0,294,0.00664451827242525
"065600414","BUENOS AIRES",278,2,242,28,0,270,0.00719424460431655
"065600418","BUENOS AIRES",282,0,214,68,0,282,0
"065600515","BUENOS AIRES",282,5,179,81,2,262,0.0177304964539007
"065600605","BUENOS AIRES",694,1,483,194,0,677,0.00144092219020173
"065601305","BUENOS AIRES",375,17,178,174,1,353,0.0453333333333333
"065600705","BUENOS AIRES",368,360,3,2,0,5,0.978260869565217
"065600708","BUENOS AIRES",97,0,22,63,2,87,0
"067631703","BUENOS AIRES",278,263,13,2,0,15,0.946043165467626
"065601311","BUENOS AIRES",483,2,289,178,1,468,0.0041407867494824
"065250110","BUENOS AIRES",258,227,22,9,0,31,0.87984496124031
"065250103","BUENOS AIRES",130,16,78,35,1,114,0.123076923076923
"065250109","BUENOS AIRES",348,216,72,59,0,131,0.620689655172414
"065250114","BUENOS AIRES",256,4,104,125,2,231,0.015625
"065250304","BUENOS AIRES",254,0,133,114,0,247,0
"065250407","BUENOS AIRES",281,31,96,142,0,238,0.110320284697509
"065250607","BUENOS AIRES",549,287,106,144,5,255,0.522768670309654
"065250612","BUENOS AIRES",305,3,136,161,0,297,0.00983606557377049
"065320106","BUENOS AIRES",321,316,1,2,2,5,0.984423676012461
"065320108","BUENOS AIRES",270,269,0,0,0,0,0.996296296296296
"065320111","BUENOS AIRES",336,286,14,35,0,49,0.851190476190476
"065320112","BUENOS AIRES",312,302,7,1,0,8,0.967948717948718
"065320205","BUENOS AIRES",205,197,2,3,1,6,0.960975609756098
"067490512","BUENOS AIRES",200,200,0,0,0,0,1
"065320311","BUENOS AIRES",263,65,108,90,0,198,0.247148288973384
"065321408","BUENOS AIRES",278,277,1,0,0,1,0.996402877697842
"065321503","BUENOS AIRES",281,246,17,15,0,32,0.875444839857651
"065321505","BUENOS AIRES",311,142,44,118,2,164,0.456591639871383
"064412603","BUENOS AIRES",234,234,0,0,0,0,1
"062311005","BUENOS AIRES",56,0,18,37,1,56,0
"065390106","BUENOS AIRES",428,35,268,113,0,381,0.0817757009345794
"065390205","BUENOS AIRES",268,97,123,40,0,163,0.361940298507463
"065390209","BUENOS AIRES",211,200,6,5,0,11,0.947867298578199
"065390210","BUENOS AIRES",240,226,9,4,0,13,0.941666666666667
"065390213","BUENOS AIRES",264,224,5,3,0,8,0.848484848484849
"065390501","BUENOS AIRES",279,244,13,22,0,35,0.874551971326165
"065390408","BUENOS AIRES",385,383,1,1,0,2,0.994805194805195
"065390502","BUENOS AIRES",413,360,49,2,0,51,0.871670702179177
"065390803","BUENOS AIRES",377,0,295,78,1,374,0
"065390901","BUENOS AIRES",23,0,17,4,0,21,0
"065390907","BUENOS AIRES",571,2,396,154,2,552,0.00350262697022767
"065391009","BUENOS AIRES",439,0,217,206,0,423,0
"067560807","BUENOS AIRES",305,304,1,0,0,1,0.99672131147541
"065391106","BUENOS AIRES",242,0,143,87,0,230,0
"060070702","BUENOS AIRES",213,1,145,67,0,212,0.00469483568075117
"060210207","BUENOS AIRES",11,0,8,3,0,11,0
"060700305","BUENOS AIRES",456,241,55,149,3,207,0.528508771929825
"060421103","BUENOS AIRES",299,129,93,72,2,167,0.431438127090301
"060563202","BUENOS AIRES",226,28,121,74,0,195,0.123893805309735
"060630302","BUENOS AIRES",162,9,57,93,1,151,0.0555555555555556
"065682909","BUENOS AIRES",326,0,250,72,1,323,0
"060980402","BUENOS AIRES",144,2,49,68,3,120,0.0138888888888889
"061190103","BUENOS AIRES",12,0,2,10,0,12,0
"061260906","BUENOS AIRES",86,0,30,56,0,86,0
"061340206","BUENOS AIRES",198,5,93,96,0,189,0.0252525252525253
"061820706","BUENOS AIRES",119,20,62,34,1,97,0.168067226890756
"061891307","BUENOS AIRES",11,0,3,7,1,11,0
"062241403","BUENOS AIRES",51,0,36,15,0,51,0
"062601701","BUENOS AIRES",515,4,122,343,10,475,0.00776699029126214
"065683111","BUENOS AIRES",204,3,182,19,0,201,0.0147058823529412
"062770202","BUENOS AIRES",99,5,60,32,0,92,0.0505050505050505
"062700805","BUENOS AIRES",46,0,41,4,0,45,0
"062940209","BUENOS AIRES",11,0,8,2,0,10,0
"062800609","BUENOS AIRES",41,0,34,6,1,41,0
"064416814","BUENOS AIRES",186,0,99,68,0,167,0
"065740404","BUENOS AIRES",297,190,42,63,0,105,0.63973063973064
"063080502","BUENOS AIRES",85,0,49,36,0,85,0
"063578203","BUENOS AIRES",227,0,117,92,4,213,0
"063920902","BUENOS AIRES",77,0,48,26,1,75,0
"064480609","BUENOS AIRES",230,154,25,27,0,52,0.669565217391304
"064620201","BUENOS AIRES",33,0,9,23,1,33,0
"064970403","BUENOS AIRES",110,0,72,38,0,110,0
"064690903","BUENOS AIRES",114,0,72,41,1,114,0
"063640414","BUENOS AIRES",47,0,14,31,1,46,0
"067281402","BUENOS AIRES",158,0,55,102,0,157,0
"065320403","BUENOS AIRES",91,0,28,60,0,88,0
"063640801","BUENOS AIRES",141,4,116,21,0,137,0.0283687943262411
"064691106","BUENOS AIRES",186,1,135,47,1,183,0.00537634408602151
"065320903","BUENOS AIRES",122,0,64,56,0,120,0
"065392907","BUENOS AIRES",142,10,52,80,0,132,0.0704225352112676
"065392914","BUENOS AIRES",241,65,65,83,3,151,0.269709543568465
"065811105","BUENOS AIRES",27,0,7,20,0,27,0
"065682306","BUENOS AIRES",370,350,10,10,0,20,0.945945945945946
"063640603","BUENOS AIRES",24,0,17,7,0,24,0
"064131301","BUENOS AIRES",118,0,43,68,2,113,0
"064416703","BUENOS AIRES",87,0,59,28,0,87,0
"065880911","BUENOS AIRES",375,6,151,208,1,360,0.016
"068190101","BUENOS AIRES",71,0,54,17,0,71,0
"065952301","BUENOS AIRES",97,0,63,28,1,92,0
"066090404","BUENOS AIRES",44,0,26,16,1,43,0
"066381301","BUENOS AIRES",350,0,275,71,0,346,0
"066382307","BUENOS AIRES",59,27,18,14,0,32,0.457627118644068
"066480407","BUENOS AIRES",37,1,24,4,0,28,0.027027027027027
"066581210","BUENOS AIRES",281,281,0,0,0,0,1
"065682307","BUENOS AIRES",376,368,5,1,0,6,0.978723404255319
"066510104","BUENOS AIRES",204,3,173,27,0,200,0.0147058823529412
"066861002","BUENOS AIRES",36,6,19,10,0,29,0.166666666666667
"067000107","BUENOS AIRES",12,0,4,8,0,12,0
"067421001","BUENOS AIRES",16,0,10,5,0,15,0
"067630701","BUENOS AIRES",25,0,11,14,0,25,0
"068751604","BUENOS AIRES",272,3,154,91,14,259,0.0110294117647059
"068050203","BUENOS AIRES",368,6,140,195,8,343,0.016304347826087
"067631812","BUENOS AIRES",162,0,66,93,0,159,0
"065740411","BUENOS AIRES",256,169,52,34,0,86,0.66015625
"067701203","BUENOS AIRES",136,5,27,99,1,127,0.0367647058823529
"067780403","BUENOS AIRES",61,0,38,23,0,61,0
"068540201","BUENOS AIRES",390,5,77,301,2,380,0.0128205128205128
"065682409","BUENOS AIRES",236,232,1,3,0,4,0.983050847457627
"065682504","BUENOS AIRES",403,394,6,1,0,7,0.977667493796526
"068751605","BUENOS AIRES",387,84,189,97,6,292,0.217054263565891
"065681402","BUENOS AIRES",304,301,1,2,0,3,0.990131578947368
"065681507","BUENOS AIRES",353,335,7,8,0,15,0.949008498583569
"065681707","BUENOS AIRES",371,55,266,50,0,316,0.148247978436658
"065681710","BUENOS AIRES",292,291,1,0,0,1,0.996575342465753
"065681802","BUENOS AIRES",166,165,1,0,0,1,0.993975903614458
"065681907","BUENOS AIRES",347,4,250,93,0,343,0.0115273775216138
"065682003","BUENOS AIRES",314,311,1,0,0,1,0.990445859872611
"065682013","BUENOS AIRES",261,260,0,1,0,1,0.996168582375479
"065682201","BUENOS AIRES",184,159,22,3,0,25,0.864130434782609
"065810304","BUENOS AIRES",203,200,1,2,0,3,0.985221674876847
"065810306","BUENOS AIRES",210,208,0,2,0,2,0.990476190476191
"065810307","BUENOS AIRES",267,259,4,4,0,8,0.970037453183521
"065810405","BUENOS AIRES",371,276,25,68,2,95,0.743935309973046
"065810701","BUENOS AIRES",184,0,42,136,5,183,0
"065811706","BUENOS AIRES",234,207,7,20,0,27,0.884615384615385
"068052108","BUENOS AIRES",312,22,146,131,0,277,0.0705128205128205
"065811303","BUENOS AIRES",286,274,5,5,0,10,0.958041958041958
"065811310","BUENOS AIRES",205,133,45,27,0,72,0.648780487804878
"065811311","BUENOS AIRES",280,277,2,1,0,3,0.989285714285714
"065811402","BUENOS AIRES",275,121,49,102,0,151,0.44
"065811404","BUENOS AIRES",152,51,30,71,0,101,0.335526315789474
"065811408","BUENOS AIRES",271,167,51,52,0,103,0.616236162361624
"065811409","BUENOS AIRES",257,124,33,94,3,130,0.482490272373541
"065811411","BUENOS AIRES",222,40,29,149,0,178,0.18018018018018
"068052408","BUENOS AIRES",352,2,217,122,3,342,0.00568181818181818
"065811509","BUENOS AIRES",329,320,3,6,0,9,0.972644376899696
"065811603","BUENOS AIRES",311,300,6,5,0,11,0.964630225080386
"065811606","BUENOS AIRES",415,320,34,60,1,95,0.771084337349398
"065811701","BUENOS AIRES",203,200,2,1,0,3,0.985221674876847
"065811703","BUENOS AIRES",252,251,1,0,0,1,0.996031746031746
"065811802","BUENOS AIRES",104,104,0,0,0,0,1
"065811804","BUENOS AIRES",94,94,0,0,0,0,1
"065811906","BUENOS AIRES",129,2,17,108,1,126,0.0155038759689922
"065811909","BUENOS AIRES",207,114,13,78,0,91,0.550724637681159
"065810305","BUENOS AIRES",215,207,1,7,0,8,0.962790697674419
"065811911","BUENOS AIRES",199,173,16,10,0,26,0.869346733668342
"065880110","BUENOS AIRES",210,197,7,5,0,12,0.938095238095238
"065880205","BUENOS AIRES",103,82,13,6,0,19,0.796116504854369
"065880302","BUENOS AIRES",191,146,26,19,0,45,0.764397905759162
"065880303","BUENOS AIRES",231,167,32,32,0,64,0.722943722943723
"065881002","BUENOS AIRES",77,0,25,52,0,77,0
"065881301","BUENOS AIRES",181,5,88,87,0,175,0.0276243093922652
"065881402","BUENOS AIRES",132,0,44,85,3,132,0
"065950301","BUENOS AIRES",226,121,62,43,0,105,0.535398230088496
"065950312","BUENOS AIRES",256,249,7,0,0,7,0.97265625
"065950405","BUENOS AIRES",343,180,56,107,0,163,0.524781341107872
"065950406","BUENOS AIRES",221,16,130,74,0,204,0.0723981900452489
"065950410","BUENOS AIRES",276,6,135,135,0,270,0.0217391304347826
"065950412","BUENOS AIRES",368,62,126,179,0,305,0.168478260869565
"065952102","BUENOS AIRES",215,11,147,56,0,203,0.0511627906976744
"065952103","BUENOS AIRES",161,3,131,25,0,156,0.0186335403726708
"065952408","BUENOS AIRES",427,2,206,215,3,424,0.00468384074941452
"065952411","BUENOS AIRES",222,217,4,1,0,5,0.977477477477477
"065952507","BUENOS AIRES",252,2,159,91,0,250,0.00793650793650794
"065952611","BUENOS AIRES",371,6,204,158,1,363,0.0161725067385445
"065952613","BUENOS AIRES",234,0,128,102,1,231,0
"065952711","BUENOS AIRES",242,2,141,96,0,237,0.00826446280991736
"066021106","BUENOS AIRES",247,232,7,2,0,9,0.939271255060729
"066021113","BUENOS AIRES",289,263,18,6,0,24,0.910034602076125
"066021601","BUENOS AIRES",196,6,76,91,2,169,0.0306122448979592
"066021609","BUENOS AIRES",334,189,71,57,3,131,0.565868263473054
"066090601","BUENOS AIRES",28,0,7,16,2,25,0
"066380210","BUENOS AIRES",329,1,253,73,0,326,0.00303951367781155
"066090610","BUENOS AIRES",58,0,18,38,0,56,0
"066090904","BUENOS AIRES",178,0,113,63,0,176,0
"067491111","BUENOS AIRES",295,281,6,5,0,11,0.952542372881356
"066091007","BUENOS AIRES",140,0,51,80,5,136,0
"068400708","BUENOS AIRES",359,347,11,1,0,12,0.966573816155989
"067491112","BUENOS AIRES",229,219,7,2,0,9,0.956331877729258
"066091904","BUENOS AIRES",251,223,11,16,1,28,0.888446215139442
"066091908","BUENOS AIRES",391,241,75,72,1,148,0.616368286445013
"066230106","BUENOS AIRES",365,342,3,17,2,22,0.936986301369863
"066230404","BUENOS AIRES",259,255,2,2,0,4,0.984555984555985
"068401609","BUENOS AIRES",319,318,1,0,0,1,0.996865203761755
"068401610","BUENOS AIRES",221,214,5,2,0,7,0.968325791855204
"066231402","BUENOS AIRES",258,1,146,105,2,253,0.00387596899224806
"066232501","BUENOS AIRES",118,0,57,61,0,118,0
"066232901","BUENOS AIRES",378,158,26,185,0,211,0.417989417989418
"066232910","BUENOS AIRES",250,153,12,66,5,83,0.612
"066380108","BUENOS AIRES",489,0,163,304,3,470,0
"066380204","BUENOS AIRES",409,3,213,184,0,397,0.00733496332518337
"066380205","BUENOS AIRES",352,0,240,98,1,339,0
"066380902","BUENOS AIRES",170,1,140,26,0,166,0.00588235294117647
"066380904","BUENOS AIRES",184,0,106,74,0,180,0
"066380309","BUENOS AIRES",826,669,116,41,0,157,0.809927360774818
"066380310","BUENOS AIRES",240,139,73,25,1,99,0.579166666666667
"066380312","BUENOS AIRES",536,9,325,195,0,520,0.0167910447761194
"066380702","BUENOS AIRES",285,2,94,179,0,273,0.00701754385964912
"066380812","BUENOS AIRES",157,1,134,21,0,155,0.00636942675159236
"066381407","BUENOS AIRES",397,23,135,222,1,358,0.0579345088161209
"066381705","BUENOS AIRES",244,198,28,18,0,46,0.811475409836066
"066381707","BUENOS AIRES",266,164,58,43,0,101,0.616541353383459
"066380816","BUENOS AIRES",192,55,78,40,2,120,0.286458333333333
"066380908","BUENOS AIRES",373,2,176,166,3,345,0.00536193029490617
"066381004","BUENOS AIRES",289,2,125,159,0,284,0.0069204152249135
"066381104","BUENOS AIRES",452,0,251,181,3,435,0
"066381206","BUENOS AIRES",328,214,82,31,0,113,0.652439024390244
"066381305","BUENOS AIRES",391,1,222,157,4,383,0.00255754475703325
"066381315","BUENOS AIRES",115,1,55,56,0,111,0.00869565217391304
"066381808","BUENOS AIRES",368,9,141,202,6,349,0.0244565217391304
"066480105","BUENOS AIRES",389,7,216,163,0,379,0.0179948586118252
"066480501","BUENOS AIRES",228,0,104,112,4,220,0
"066381902","BUENOS AIRES",464,111,244,95,3,342,0.239224137931034
"066381906","BUENOS AIRES",143,0,119,22,0,141,0
"066382007","BUENOS AIRES",229,0,157,66,0,223,0
"066382208","BUENOS AIRES",305,29,94,174,0,268,0.0950819672131148
"066382302","BUENOS AIRES",289,1,66,187,4,257,0.00346020761245675
"066581009","BUENOS AIRES",261,259,2,0,0,2,0.992337164750958
"066440102","BUENOS AIRES",58,36,21,0,0,21,0.620689655172414
"066440108","BUENOS AIRES",20,20,0,0,0,0,1
"066480110","BUENOS AIRES",454,2,231,211,0,442,0.00440528634361234
"066480115","BUENOS AIRES",263,0,114,129,1,244,0
"068401006","BUENOS AIRES",328,327,1,0,0,1,0.996951219512195
"066440206","BUENOS AIRES",71,30,36,5,0,41,0.422535211267606
"066440302","BUENOS AIRES",161,7,125,29,0,154,0.0434782608695652
"066440316","BUENOS AIRES",10,2,7,1,0,8,0.2
"066440315","BUENOS AIRES",18,5,9,3,0,12,0.277777777777778
"066440403","BUENOS AIRES",56,7,38,11,0,49,0.125
"066581209","BUENOS AIRES",287,287,0,0,0,0,1
"066440405","BUENOS AIRES",61,6,44,11,0,55,0.0983606557377049
"066440504","BUENOS AIRES",144,114,20,9,0,29,0.791666666666667
"068820212","BUENOS AIRES",251,38,12,190,0,202,0.151394422310757
"066440507","BUENOS AIRES",218,215,2,1,0,3,0.986238532110092
"066440511","BUENOS AIRES",53,53,0,0,0,0,1
"066480302","BUENOS AIRES",363,3,229,113,1,343,0.00826446280991736
"066480504","BUENOS AIRES",312,3,156,135,4,295,0.00961538461538462
"068821606","BUENOS AIRES",254,198,13,36,0,49,0.779527559055118
"066480406","BUENOS AIRES",245,0,137,92,1,230,0
"066510505","BUENOS AIRES",189,2,109,77,0,186,0.0105820105820106
"066510506","BUENOS AIRES",326,132,131,60,0,191,0.404907975460123
"066510507","BUENOS AIRES",236,94,107,35,0,142,0.398305084745763
"066510509","BUENOS AIRES",314,162,107,44,1,152,0.515923566878981
"540281924","MISIONES",512,151,200,115,36,351,0.294921875
"066510510","BUENOS AIRES",271,132,71,66,1,138,0.487084870848708
"066550202","BUENOS AIRES",225,182,21,22,0,43,0.808888888888889
"066580202","BUENOS AIRES",255,16,80,151,0,231,0.0627450980392157
"068261703","BUENOS AIRES",15,0,2,12,1,15,0
"066580203","BUENOS AIRES",249,7,91,127,10,228,0.0281124497991968
"066580207","BUENOS AIRES",298,11,44,217,8,269,0.0369127516778524
"066580306","BUENOS AIRES",307,306,1,0,0,1,0.996742671009772
"066580501","BUENOS AIRES",224,224,0,0,0,0,1
"066580508","BUENOS AIRES",312,308,4,0,0,4,0.987179487179487
"066580805","BUENOS AIRES",322,321,1,0,0,1,0.996894409937888
"066580902","BUENOS AIRES",323,322,0,1,0,1,0.996904024767802
"066581405","BUENOS AIRES",131,0,14,115,0,129,0
"066581406","BUENOS AIRES",135,2,32,68,11,111,0.0148148148148148
"066582201","BUENOS AIRES",328,321,2,2,0,4,0.978658536585366
"066582203","BUENOS AIRES",314,311,1,2,0,3,0.990445859872611
"066581409","BUENOS AIRES",434,23,51,292,26,369,0.0529953917050691
"066581602","BUENOS AIRES",260,255,5,0,0,5,0.980769230769231
"066581605","BUENOS AIRES",209,209,0,0,0,0,1
"066581710","BUENOS AIRES",278,274,1,1,0,2,0.985611510791367
"066581712","BUENOS AIRES",317,312,2,1,0,3,0.984227129337539
"066581806","BUENOS AIRES",286,286,0,0,0,0,1
"066581812","BUENOS AIRES",148,148,0,0,0,0,1
"066581903","BUENOS AIRES",201,200,0,1,0,1,0.995024875621891
"066582006","BUENOS AIRES",254,228,18,5,1,24,0.897637795275591
"066582101","BUENOS AIRES",492,470,12,9,0,21,0.955284552845528
"066582103","BUENOS AIRES",495,468,6,15,0,21,0.945454545454545
"066582111","BUENOS AIRES",451,451,0,0,0,0,1
"066582115","BUENOS AIRES",296,7,54,212,1,267,0.0236486486486486
"064201707","BUENOS AIRES",44,43,1,0,0,1,0.977272727272727
"066582204","BUENOS AIRES",266,260,3,1,0,4,0.977443609022556
"066582209","BUENOS AIRES",456,434,14,3,0,17,0.951754385964912
"066582402","BUENOS AIRES",345,337,3,5,0,8,0.976811594202899
"066582404","BUENOS AIRES",284,281,2,1,0,3,0.98943661971831
"066582406","BUENOS AIRES",358,350,6,2,0,8,0.977653631284916
"066582412","BUENOS AIRES",237,237,0,0,0,0,1
"066582506","BUENOS AIRES",304,301,2,0,0,2,0.990131578947368
"066582603","BUENOS AIRES",341,305,10,25,0,35,0.894428152492669
"066582607","BUENOS AIRES",278,275,0,2,0,2,0.989208633093525
"066582705","BUENOS AIRES",120,14,39,66,1,106,0.116666666666667
"066582710","BUENOS AIRES",288,5,40,229,0,269,0.0173611111111111
"067911813","BUENOS AIRES",304,279,12,12,0,24,0.917763157894737
"066582808","BUENOS AIRES",431,113,139,156,13,308,0.262180974477958
"066582910","BUENOS AIRES",378,14,139,211,0,350,0.037037037037037
"066583008","BUENOS AIRES",389,30,84,260,4,348,0.077120822622108
"066583012","BUENOS AIRES",275,20,39,211,2,252,0.0727272727272727
"066583101","BUENOS AIRES",310,309,1,0,0,1,0.996774193548387
"066583201","BUENOS AIRES",241,226,7,6,0,13,0.937759336099585
"064275714","BUENOS AIRES",231,3,142,73,3,218,0.012987012987013
"066583205","BUENOS AIRES",274,263,11,0,0,11,0.95985401459854
"066583402","BUENOS AIRES",319,14,103,193,1,297,0.0438871473354232
"066583407","BUENOS AIRES",309,298,6,5,0,11,0.964401294498382
"066583602","BUENOS AIRES",535,40,106,343,8,457,0.0747663551401869
"066583604","BUENOS AIRES",249,6,136,102,1,239,0.0240963855421687
"066583705","BUENOS AIRES",206,4,19,159,3,181,0.0194174757281553
"066583708","BUENOS AIRES",398,9,150,193,11,354,0.0226130653266332
"066583709","BUENOS AIRES",310,2,122,181,0,303,0.00645161290322581
"066583803","BUENOS AIRES",251,4,39,190,2,231,0.0159362549800797
"066583812","BUENOS AIRES",355,270,52,28,1,81,0.76056338028169
"067491410","BUENOS AIRES",277,261,4,5,0,9,0.942238267148014
"066584006","BUENOS AIRES",143,9,36,88,2,126,0.0629370629370629
"066584015","BUENOS AIRES",551,2,245,255,3,503,0.00362976406533575
"066584101","BUENOS AIRES",330,11,54,217,0,271,0.0333333333333333
"066584109","BUENOS AIRES",468,81,154,214,5,373,0.173076923076923
"066584111","BUENOS AIRES",253,81,42,124,0,166,0.320158102766798
"066584112","BUENOS AIRES",313,162,63,70,4,137,0.517571884984026
"066584203","BUENOS AIRES",401,270,98,26,0,124,0.673316708229426
"066584212","BUENOS AIRES",404,284,74,40,0,114,0.702970297029703
"066584307","BUENOS AIRES",247,5,63,163,0,226,0.0202429149797571
"066584308","BUENOS AIRES",470,8,167,278,0,445,0.0170212765957447
"066650202","BUENOS AIRES",304,297,0,7,0,7,0.976973684210526
"066650305","BUENOS AIRES",153,144,2,4,0,6,0.941176470588235
"066651310","BUENOS AIRES",311,294,8,8,1,17,0.945337620578778
"066790610","BUENOS AIRES",291,250,32,8,0,40,0.859106529209622
"066790901","BUENOS AIRES",163,0,98,60,3,161,0
"066860609","BUENOS AIRES",189,101,35,51,2,88,0.534391534391534
"066861304","BUENOS AIRES",262,118,41,101,0,142,0.450381679389313
"066861305","BUENOS AIRES",274,28,41,198,2,241,0.102189781021898
"066861311","BUENOS AIRES",268,256,9,3,0,12,0.955223880597015
"067000102","BUENOS AIRES",174,1,137,34,2,173,0.00574712643678161
"067000208","BUENOS AIRES",191,190,0,0,0,0,0.994764397905759
"067000209","BUENOS AIRES",361,354,0,6,0,6,0.980609418282548
"067210216","BUENOS AIRES",220,116,61,42,0,103,0.527272727272727
"068400406","BUENOS AIRES",262,9,119,134,0,253,0.0343511450381679
"067000211","BUENOS AIRES",237,177,28,31,0,59,0.746835443037975
"067000215","BUENOS AIRES",315,292,7,15,0,22,0.926984126984127
"067000216","BUENOS AIRES",290,265,17,7,1,25,0.913793103448276
"067071108","BUENOS AIRES",302,293,5,4,0,9,0.970198675496689
"067071102","BUENOS AIRES",342,57,64,204,16,284,0.166666666666667
"067140102","BUENOS AIRES",359,188,70,97,1,168,0.523676880222841
"067140106","BUENOS AIRES",306,298,3,5,0,8,0.973856209150327
"061050204","BUENOS AIRES",165,162,2,1,0,3,0.981818181818182
"067140108","BUENOS AIRES",316,305,8,0,0,8,0.965189873417722
"067140111","BUENOS AIRES",228,182,27,19,0,46,0.798245614035088
"067140608","BUENOS AIRES",264,23,113,126,0,239,0.0871212121212121
"067140612","BUENOS AIRES",283,81,90,111,0,201,0.286219081272085
"067210215","BUENOS AIRES",236,20,144,71,0,215,0.0847457627118644
"067281004","BUENOS AIRES",170,102,23,43,0,66,0.6
"067281012","BUENOS AIRES",164,77,46,41,0,87,0.469512195121951
"067281024","BUENOS AIRES",263,2,81,178,0,259,0.00760456273764259
"067490302","BUENOS AIRES",143,142,1,0,0,1,0.993006993006993
"067350101","BUENOS AIRES",153,1,66,85,0,151,0.0065359477124183
"067350705","BUENOS AIRES",370,88,109,171,0,280,0.237837837837838
"068610302","BUENOS AIRES",233,233,0,0,0,0,1
"067420404","BUENOS AIRES",259,251,5,3,0,8,0.969111969111969
"067420406","BUENOS AIRES",185,159,5,20,0,25,0.859459459459459
"067490105","BUENOS AIRES",147,39,33,75,0,108,0.26530612244898
"067490201","BUENOS AIRES",198,194,3,1,0,4,0.97979797979798
"067490203","BUENOS AIRES",341,332,4,5,0,9,0.973607038123167
"067490503","BUENOS AIRES",291,291,0,0,0,0,1
"067490912","BUENOS AIRES",434,410,14,9,0,23,0.944700460829493
"067491003","BUENOS AIRES",411,387,15,8,0,23,0.941605839416058
"067491011","BUENOS AIRES",384,369,7,6,0,13,0.9609375
"067491103","BUENOS AIRES",276,20,128,124,0,252,0.072463768115942
"067491109","BUENOS AIRES",154,151,2,1,0,3,0.980519480519481
"067491211","BUENOS AIRES",394,16,107,238,22,367,0.0406091370558376
"067491306","BUENOS AIRES",442,298,80,52,0,132,0.67420814479638
"067491312","BUENOS AIRES",278,259,8,9,0,17,0.931654676258993
"067491314","BUENOS AIRES",295,284,6,3,0,9,0.96271186440678
"067491315","BUENOS AIRES",230,214,8,4,1,13,0.930434782608696
"067491320","BUENOS AIRES",255,72,43,123,9,175,0.282352941176471
"067491412","BUENOS AIRES",397,376,9,12,0,21,0.947103274559194
"067560404","BUENOS AIRES",288,287,0,1,0,1,0.996527777777778
"067491419","BUENOS AIRES",387,66,48,234,21,303,0.170542635658915
"067560506","BUENOS AIRES",238,238,0,0,0,0,1
"067560102","BUENOS AIRES",172,171,1,0,0,1,0.994186046511628
"067560115","BUENOS AIRES",214,213,1,0,0,1,0.995327102803738
"067560204","BUENOS AIRES",278,264,2,6,0,8,0.949640287769784
"067560308","BUENOS AIRES",268,267,0,0,0,0,0.996268656716418
"067560310","BUENOS AIRES",328,328,0,0,0,0,1
"068610309","BUENOS AIRES",179,179,0,0,0,0,1
"067560402","BUENOS AIRES",290,286,4,0,0,4,0.986206896551724
"067560501","BUENOS AIRES",263,253,9,1,0,10,0.961977186311787
"067560601","BUENOS AIRES",375,375,0,0,0,0,1
"067560602","BUENOS AIRES",257,257,0,0,0,0,1
"067560611","BUENOS AIRES",220,219,1,0,0,1,0.995454545454545
"067560704","BUENOS AIRES",313,313,0,0,0,0,1
"067560805","BUENOS AIRES",370,370,0,0,0,0,1
"067560901","BUENOS AIRES",204,200,2,2,0,4,0.980392156862745
"067560905","BUENOS AIRES",380,366,7,7,0,14,0.963157894736842
"067560906","BUENOS AIRES",405,396,5,3,0,8,0.977777777777778
"067560913","BUENOS AIRES",292,284,4,1,0,5,0.972602739726027
"064341807","BUENOS AIRES",184,181,0,3,0,3,0.983695652173913
"067561002","BUENOS AIRES",192,191,0,0,0,0,0.994791666666667
"067561104","BUENOS AIRES",276,273,3,0,0,3,0.989130434782609
"067561309","BUENOS AIRES",363,323,3,18,0,21,0.889807162534435
"067491313","BUENOS AIRES",280,271,2,7,0,9,0.967857142857143
"067561407","BUENOS AIRES",402,377,21,4,0,25,0.937810945273632
"067561410","BUENOS AIRES",556,197,40,277,16,333,0.35431654676259
"067561414","BUENOS AIRES",281,12,4,234,4,242,0.0427046263345196
"067561503","BUENOS AIRES",315,293,4,18,0,22,0.93015873015873
"067561504","BUENOS AIRES",449,127,214,108,0,322,0.282850779510022
"067561602","BUENOS AIRES",257,151,92,14,0,106,0.587548638132296
"067600114","BUENOS AIRES",453,392,41,15,0,56,0.865342163355408
"067561804","BUENOS AIRES",357,348,6,3,0,9,0.974789915966387
"067561806","BUENOS AIRES",244,238,4,1,0,5,0.975409836065574
"067561903","BUENOS AIRES",261,259,2,0,0,2,0.992337164750958
"067562002","BUENOS AIRES",322,5,207,110,0,317,0.015527950310559
"067562003","BUENOS AIRES",390,12,247,129,0,376,0.0307692307692308
"067562102","BUENOS AIRES",365,107,104,146,0,250,0.293150684931507
"067562103","BUENOS AIRES",245,131,65,6,0,71,0.53469387755102
"067562202","BUENOS AIRES",348,332,16,0,0,16,0.954022988505747
"067630107","BUENOS AIRES",210,210,0,0,0,0,1
"067562107","BUENOS AIRES",171,113,46,12,0,58,0.660818713450292
"067562209","BUENOS AIRES",279,6,194,77,1,272,0.021505376344086
"067562212","BUENOS AIRES",203,7,169,25,0,194,0.0344827586206897
"067631707","BUENOS AIRES",457,196,145,106,1,252,0.428884026258206
"067562213","BUENOS AIRES",190,8,131,51,0,182,0.0421052631578947
"067562303","BUENOS AIRES",250,243,7,0,0,7,0.972
"067562309","BUENOS AIRES",385,286,53,42,2,97,0.742857142857143
"067562506","BUENOS AIRES",221,4,171,46,0,217,0.0180995475113122
"067562511","BUENOS AIRES",280,114,67,93,1,161,0.407142857142857
"067562513","BUENOS AIRES",305,24,167,114,0,281,0.0786885245901639
"067562515","BUENOS AIRES",340,3,278,58,0,336,0.00882352941176471
"067562605","BUENOS AIRES",244,226,16,2,0,18,0.926229508196721
"067562608","BUENOS AIRES",382,352,20,5,0,25,0.921465968586387
"067562702","BUENOS AIRES",459,437,6,10,0,16,0.952069716775599
"067562712","BUENOS AIRES",406,15,274,117,0,391,0.0369458128078818
"067600102","BUENOS AIRES",324,2,244,76,0,320,0.00617283950617284
"067600107","BUENOS AIRES",472,412,44,8,1,53,0.872881355932203
"067600208","BUENOS AIRES",135,135,0,0,0,0,1
"067600303","BUENOS AIRES",318,309,6,2,0,8,0.971698113207547
"067600314","BUENOS AIRES",317,315,1,1,0,2,0.993690851735016
"067600504","BUENOS AIRES",242,222,8,11,0,19,0.917355371900826
"067600602","BUENOS AIRES",383,302,55,25,0,80,0.788511749347259
"067600603","BUENOS AIRES",285,223,56,6,0,62,0.782456140350877
"067600610","BUENOS AIRES",415,6,111,235,31,377,0.0144578313253012
"067600710","BUENOS AIRES",489,3,355,121,3,479,0.00613496932515337
"067600810","BUENOS AIRES",339,103,197,37,2,236,0.303834808259587
"067600909","BUENOS AIRES",229,221,6,2,0,8,0.965065502183406
"067600912","BUENOS AIRES",447,434,7,4,0,11,0.970917225950783
"067601002","BUENOS AIRES",262,2,206,48,0,254,0.00763358778625954
"067601007","BUENOS AIRES",96,3,80,12,1,93,0.03125
"067601102","BUENOS AIRES",298,2,199,88,0,287,0.00671140939597315
"067601113","BUENOS AIRES",238,1,172,65,0,237,0.00420168067226891
"067601115","BUENOS AIRES",180,0,134,44,0,178,0
"067601712","BUENOS AIRES",297,0,211,81,0,292,0
"067601203","BUENOS AIRES",102,1,89,12,0,101,0.00980392156862745
"067601209","BUENOS AIRES",216,1,145,60,3,208,0.00462962962962963
"067601306","BUENOS AIRES",429,3,190,221,1,412,0.00699300699300699
"067601310","BUENOS AIRES",443,5,150,262,1,413,0.0112866817155756
"067601311","BUENOS AIRES",378,1,172,200,1,373,0.00264550264550265
"067601401","BUENOS AIRES",234,2,158,64,0,222,0.00854700854700855
"067601407","BUENOS AIRES",572,3,232,314,2,548,0.00524475524475524
"067601502","BUENOS AIRES",237,1,180,55,0,235,0.00421940928270042
"067601512","BUENOS AIRES",358,2,210,142,1,353,0.00558659217877095
"067601514","BUENOS AIRES",250,1,138,101,0,239,0.004
"067601613","BUENOS AIRES",338,1,150,183,1,334,0.0029585798816568
"067601701","BUENOS AIRES",438,1,246,184,1,431,0.00228310502283105
"067601708","BUENOS AIRES",400,6,218,148,3,369,0.015
"067601807","BUENOS AIRES",304,1,104,191,0,295,0.00328947368421053
"067601808","BUENOS AIRES",398,1,157,201,7,365,0.00251256281407035
"067630103","BUENOS AIRES",384,335,35,14,0,49,0.872395833333333
"067630104","BUENOS AIRES",362,355,3,3,0,6,0.980662983425414
"067630110","BUENOS AIRES",307,306,1,0,0,1,0.996742671009772
"067630204","BUENOS AIRES",310,293,9,7,0,16,0.945161290322581
"067630302","BUENOS AIRES",355,353,2,0,0,2,0.994366197183099
"067630304","BUENOS AIRES",341,341,0,0,0,0,1
"067630308","BUENOS AIRES",366,364,2,0,0,2,0.994535519125683
"067630311","BUENOS AIRES",285,276,7,2,0,9,0.968421052631579
"067630610","BUENOS AIRES",298,124,81,86,2,169,0.416107382550336
"067630804","BUENOS AIRES",410,8,296,104,0,400,0.0195121951219512
"067631602","BUENOS AIRES",246,154,61,29,0,90,0.626016260162602
"067631708","BUENOS AIRES",241,104,99,38,0,137,0.431535269709544
"067631804","BUENOS AIRES",237,8,123,97,0,220,0.0337552742616034
"067631911","BUENOS AIRES",189,180,5,3,1,9,0.952380952380952
"067701003","BUENOS AIRES",273,256,6,7,1,14,0.937728937728938
"067701004","BUENOS AIRES",222,124,18,73,1,92,0.558558558558559
"067701010","BUENOS AIRES",298,290,2,3,0,5,0.973154362416107
"067701012","BUENOS AIRES",119,76,5,30,0,35,0.638655462184874
"067701014","BUENOS AIRES",31,2,3,21,0,24,0.0645161290322581
"067701603","BUENOS AIRES",244,4,79,153,6,238,0.0163934426229508
"067701801","BUENOS AIRES",170,1,107,57,0,164,0.00588235294117647
"067702103","BUENOS AIRES",254,252,2,0,0,2,0.992125984251969
"067911805","BUENOS AIRES",192,178,4,9,0,13,0.927083333333333
"067780202","BUENOS AIRES",150,4,67,74,0,141,0.0266666666666667
"067780204","BUENOS AIRES",267,9,119,122,2,243,0.0337078651685393
"067780904","BUENOS AIRES",133,2,74,52,1,127,0.0150375939849624
"067781008","BUENOS AIRES",387,162,52,149,7,208,0.418604651162791
"067910215","BUENOS AIRES",298,290,5,2,0,7,0.973154362416107
"067840803","BUENOS AIRES",278,90,81,103,0,184,0.323741007194245
"067840805","BUENOS AIRES",250,156,59,31,0,90,0.624
"067840808","BUENOS AIRES",388,242,74,66,2,142,0.623711340206186
"067840809","BUENOS AIRES",265,86,59,114,2,175,0.324528301886792
"067910110","BUENOS AIRES",344,339,2,3,0,5,0.98546511627907
"067910304","BUENOS AIRES",395,378,10,6,0,16,0.956962025316456
"067910402","BUENOS AIRES",254,250,2,2,0,4,0.984251968503937
"067911202","BUENOS AIRES",352,280,15,57,0,72,0.795454545454545
"067911204","BUENOS AIRES",291,186,32,68,2,102,0.639175257731959
"067911205","BUENOS AIRES",243,178,23,42,0,65,0.732510288065844
"067911209","BUENOS AIRES",376,336,18,21,0,39,0.893617021276596
"067911304","BUENOS AIRES",317,123,86,106,0,192,0.38801261829653
"067911306","BUENOS AIRES",531,414,25,89,0,114,0.779661016949153
"067911806","BUENOS AIRES",236,227,6,2,0,8,0.961864406779661
"067911312","BUENOS AIRES",259,130,35,91,0,126,0.501930501930502
"067911313","BUENOS AIRES",300,252,28,18,0,46,0.84
"067911803","BUENOS AIRES",188,185,2,1,0,3,0.984042553191489
"067911807","BUENOS AIRES",287,272,7,6,0,13,0.947735191637631
"067911811","BUENOS AIRES",211,154,20,36,0,56,0.729857819905213
"067911906","BUENOS AIRES",261,257,2,2,0,4,0.984674329501916
"067912101","BUENOS AIRES",203,0,70,128,2,200,0
"067912104","BUENOS AIRES",231,50,58,122,0,180,0.216450216450216
"067912107","BUENOS AIRES",271,256,12,3,0,15,0.944649446494465
"067912114","BUENOS AIRES",113,0,41,67,0,108,0
"067912116","BUENOS AIRES",221,82,69,63,2,134,0.3710407239819
"068050609","BUENOS AIRES",407,390,3,13,0,16,0.958230958230958
"067912205","BUENOS AIRES",286,181,41,61,0,102,0.632867132867133
"067912213","BUENOS AIRES",240,235,1,4,0,5,0.979166666666667
"067980705","BUENOS AIRES",174,130,14,30,0,44,0.747126436781609
"067980710","BUENOS AIRES",202,84,66,50,2,118,0.415841584158416
"068050302","BUENOS AIRES",149,8,79,49,1,129,0.0536912751677852
"068050303","BUENOS AIRES",329,5,74,233,4,311,0.0151975683890578
"068050409","BUENOS AIRES",490,21,199,263,1,463,0.0428571428571429
"068050601","BUENOS AIRES",672,299,121,148,8,277,0.444940476190476
"068050603","BUENOS AIRES",399,279,35,84,0,119,0.699248120300752
"068050605","BUENOS AIRES",208,141,34,33,0,67,0.677884615384615
"068050310","BUENOS AIRES",140,138,2,0,0,2,0.985714285714286
"068050404","BUENOS AIRES",464,7,98,327,6,431,0.0150862068965517
"068050405","BUENOS AIRES",501,13,140,319,4,463,0.0259481037924152
"068050708","BUENOS AIRES",26,24,0,2,0,2,0.923076923076923
"068050709","BUENOS AIRES",77,53,24,0,0,24,0.688311688311688
"068050810","BUENOS AIRES",214,7,93,101,1,195,0.0327102803738318
"068050814","BUENOS AIRES",467,33,157,261,0,418,0.0706638115631692
"068051002","BUENOS AIRES",293,5,124,161,0,285,0.0170648464163823
"068051103","BUENOS AIRES",512,369,113,29,0,142,0.720703125
"068051908","BUENOS AIRES",226,3,169,54,0,223,0.0132743362831858
"068051313","BUENOS AIRES",374,1,291,74,1,366,0.00267379679144385
"068051411","BUENOS AIRES",343,4,189,132,1,322,0.0116618075801749
"068051412","BUENOS AIRES",344,2,185,152,0,337,0.00581395348837209
"068051503","BUENOS AIRES",381,10,278,88,0,366,0.026246719160105
"068051510","BUENOS AIRES",364,6,233,122,1,356,0.0164835164835165
"068051603","BUENOS AIRES",347,1,120,219,1,340,0.00288184438040346
"068051705","BUENOS AIRES",417,0,340,64,1,405,0
"068051706","BUENOS AIRES",447,1,325,120,0,445,0.00223713646532438
"068051806","BUENOS AIRES",273,0,238,33,0,271,0
"068051811","BUENOS AIRES",468,7,387,72,1,460,0.014957264957265
"068052012","BUENOS AIRES",313,2,246,64,0,310,0.00638977635782748
"068052111","BUENOS AIRES",424,14,206,196,3,405,0.0330188679245283
"068052112","BUENOS AIRES",370,4,221,138,0,359,0.0108108108108108
"068052201","BUENOS AIRES",436,1,219,168,3,390,0.00229357798165138
"060210611","BUENOS AIRES",331,264,18,47,0,65,0.797583081570997
"068400208","BUENOS AIRES",241,139,57,45,0,102,0.576763485477178
"068052403","BUENOS AIRES",322,4,245,73,0,318,0.0124223602484472
"068052507","BUENOS AIRES",601,1,183,392,7,582,0.00166389351081531
"068052511","BUENOS AIRES",359,0,274,78,0,352,0
"068052512","BUENOS AIRES",473,2,268,186,0,454,0.00422832980972516
"060280502","BUENOS AIRES",25,0,17,8,0,25,0
"060281603","BUENOS AIRES",559,559,0,0,0,0,1
"068120501","BUENOS AIRES",10,0,0,9,1,10,0
"068120503","BUENOS AIRES",217,0,138,78,0,216,0
"068400209","BUENOS AIRES",350,134,182,31,0,213,0.382857142857143
"068610407","BUENOS AIRES",353,350,3,0,0,3,0.991501416430595
"064341814","BUENOS AIRES",113,111,2,0,0,2,0.982300884955752
"068331801","BUENOS AIRES",69,0,25,44,0,69,0
"068190505","BUENOS AIRES",140,1,112,6,21,139,0.00714285714285714
"068190903","BUENOS AIRES",172,0,144,28,0,172,0
"068260119","BUENOS AIRES",195,183,4,7,0,11,0.938461538461538
"068260214","BUENOS AIRES",109,107,2,0,0,2,0.981651376146789
"068260501","BUENOS AIRES",88,43,11,33,0,44,0.488636363636364
"068260701","BUENOS AIRES",395,371,13,9,0,22,0.939240506329114
"068261606","BUENOS AIRES",238,87,68,81,1,150,0.365546218487395
"068330104","BUENOS AIRES",354,322,11,21,0,32,0.909604519774011
"068330112","BUENOS AIRES",437,398,22,16,0,38,0.910755148741419
"068330204","BUENOS AIRES",305,305,0,0,0,0,1
"068330207","BUENOS AIRES",310,308,2,0,0,2,0.993548387096774
"068400205","BUENOS AIRES",320,76,142,101,0,243,0.2375
"068400102","BUENOS AIRES",338,3,226,98,5,329,0.00887573964497041
"068400107","BUENOS AIRES",422,10,158,230,7,395,0.023696682464455
"068400110","BUENOS AIRES",430,6,249,165,0,414,0.013953488372093
"068400504","BUENOS AIRES",300,4,196,100,0,296,0.0133333333333333
"068400505","BUENOS AIRES",300,23,207,67,0,274,0.0766666666666667
"068400510","BUENOS AIRES",302,302,0,0,0,0,1
"068400602","BUENOS AIRES",208,132,51,20,0,71,0.634615384615385
"068400607","BUENOS AIRES",297,289,6,0,0,6,0.973063973063973
"068400703","BUENOS AIRES",304,289,10,5,0,15,0.950657894736842
"068400804","BUENOS AIRES",291,285,4,1,0,5,0.979381443298969
"068400805","BUENOS AIRES",333,322,4,3,0,7,0.966966966966967
"068400809","BUENOS AIRES",388,385,1,2,0,3,0.992268041237113
"068400812","BUENOS AIRES",366,360,3,3,0,6,0.983606557377049
"068400910","BUENOS AIRES",320,315,2,0,0,2,0.984375
"068403101","BUENOS AIRES",122,83,14,24,0,38,0.680327868852459
"068401109","BUENOS AIRES",315,279,27,9,0,36,0.885714285714286
"068401112","BUENOS AIRES",336,324,4,7,0,11,0.964285714285714
"068401203","BUENOS AIRES",366,360,4,1,0,5,0.983606557377049
"068401606","BUENOS AIRES",317,314,2,0,0,2,0.990536277602524
"068401607","BUENOS AIRES",224,221,1,2,0,3,0.986607142857143
"068401701","BUENOS AIRES",273,269,2,1,0,3,0.985347985347985
"068401802","BUENOS AIRES",285,283,1,0,0,1,0.992982456140351
"068401805","BUENOS AIRES",177,163,0,0,0,0,0.92090395480226
"068401807","BUENOS AIRES",394,391,3,0,0,3,0.99238578680203
"068402001","BUENOS AIRES",293,286,6,0,0,6,0.976109215017065
"068402203","BUENOS AIRES",353,333,11,6,0,17,0.943342776203966
"068402204","BUENOS AIRES",322,312,6,4,0,10,0.968944099378882
"068402601","BUENOS AIRES",422,310,9,101,0,110,0.734597156398104
"068402803","BUENOS AIRES",204,77,8,114,1,123,0.377450980392157
"068402804","BUENOS AIRES",274,268,2,2,0,4,0.978102189781022
"068402903","BUENOS AIRES",452,428,2,17,0,19,0.946902654867257
"068402904","BUENOS AIRES",303,292,10,1,0,11,0.963696369636964
"068402906","BUENOS AIRES",266,251,2,0,0,2,0.943609022556391
"068403004","BUENOS AIRES",304,297,6,1,0,7,0.976973684210526
"068403105","BUENOS AIRES",335,334,0,0,0,0,0.997014925373134
"068403201","BUENOS AIRES",148,146,2,0,0,2,0.986486486486487
"068403207","BUENOS AIRES",308,304,2,1,1,4,0.987012987012987
"068403209","BUENOS AIRES",312,308,3,1,0,4,0.987179487179487
"068470104","BUENOS AIRES",381,0,233,148,0,381,0
"068120402","BUENOS AIRES",10,0,2,7,1,10,0
"068540109","BUENOS AIRES",371,103,97,169,1,267,0.277628032345013
"068190603","BUENOS AIRES",21,0,7,14,0,21,0
"068610504","BUENOS AIRES",264,264,0,0,0,0,1
"220211103","CHACO",40,0,4,19,6,29,0
"068610505","BUENOS AIRES",232,232,0,0,0,0,1
"068540115","BUENOS AIRES",165,5,37,108,1,146,0.0303030303030303
"068540205","BUENOS AIRES",242,238,2,2,0,4,0.983471074380165
"068190909","BUENOS AIRES",52,0,42,8,0,50,0
"068260303","BUENOS AIRES",14,0,7,7,0,14,0
"068260503","BUENOS AIRES",8,0,4,3,1,8,0
"068260703","BUENOS AIRES",50,0,15,33,0,48,0
"068261402","BUENOS AIRES",10,0,6,4,0,10,0
"068261701","BUENOS AIRES",17,0,2,15,0,17,0
"068330403","BUENOS AIRES",17,0,4,12,0,16,0
"068470205","BUENOS AIRES",9,0,5,3,1,9,0
"068540502","BUENOS AIRES",54,0,26,28,0,54,0
"068541102","BUENOS AIRES",26,0,9,17,0,26,0
"068541201","BUENOS AIRES",54,0,9,45,0,54,0
"068750401","BUENOS AIRES",53,0,38,14,0,52,0
"068610508","BUENOS AIRES",338,335,3,0,0,3,0.99112426035503
"060282710","BUENOS AIRES",158,69,60,28,0,88,0.436708860759494
"068610509","BUENOS AIRES",325,325,0,0,0,0,1
"064902410","BUENOS AIRES",244,244,0,0,0,0,1
"068540210","BUENOS AIRES",196,62,44,80,5,129,0.316326530612245
"068821201","BUENOS AIRES",134,2,49,79,0,128,0.0149253731343284
"068610701","BUENOS AIRES",259,259,0,0,0,0,1
"068610708","BUENOS AIRES",285,285,0,0,0,0,1
"068610807","BUENOS AIRES",213,213,0,0,0,0,1
"068610809","BUENOS AIRES",164,163,0,0,0,0,0.99390243902439
"068610904","BUENOS AIRES",239,237,2,0,0,2,0.99163179916318
"068611308","BUENOS AIRES",228,226,1,0,0,1,0.991228070175439
"068611309","BUENOS AIRES",309,303,5,1,0,6,0.980582524271845
"068611402","BUENOS AIRES",232,232,0,0,0,0,1
"068611408","BUENOS AIRES",261,257,1,1,0,2,0.984674329501916
"061120104","BUENOS AIRES",172,172,0,0,0,0,1
"068821803","BUENOS AIRES",27,0,0,11,12,23,0
"068541401","BUENOS AIRES",155,0,76,75,2,153,0
"068610202","BUENOS AIRES",211,209,2,0,0,2,0.990521327014218
"068610212","BUENOS AIRES",234,234,0,0,0,0,1
"068612602","BUENOS AIRES",292,289,2,1,0,3,0.98972602739726
"068611609","BUENOS AIRES",364,362,1,1,0,2,0.994505494505495
"068611703","BUENOS AIRES",259,257,1,0,0,1,0.992277992277992
"068611804","BUENOS AIRES",263,260,3,0,0,3,0.988593155893536
"068611904","BUENOS AIRES",314,311,3,0,0,3,0.990445859872611
"068611905","BUENOS AIRES",341,339,2,0,0,2,0.994134897360704
"068612003","BUENOS AIRES",359,337,17,0,0,17,0.938718662952646
"068612005","BUENOS AIRES",358,342,12,0,0,12,0.955307262569832
"068612008","BUENOS AIRES",246,236,8,0,0,8,0.959349593495935
"068612205","BUENOS AIRES",350,346,3,1,0,4,0.988571428571429
"068612212","BUENOS AIRES",187,185,2,0,0,2,0.989304812834225
"068612302","BUENOS AIRES",398,377,10,9,0,19,0.947236180904523
"068612304","BUENOS AIRES",310,264,9,27,0,36,0.851612903225806
"068612309","BUENOS AIRES",245,239,2,2,0,4,0.975510204081633
"068612507","BUENOS AIRES",316,316,0,0,0,0,1
"068612604","BUENOS AIRES",311,311,0,0,0,0,1
"068612609","BUENOS AIRES",328,328,0,0,0,0,1
"068612702","BUENOS AIRES",311,310,1,0,0,1,0.996784565916399
"068612801","BUENOS AIRES",191,188,2,1,0,3,0.984293193717278
"068612809","BUENOS AIRES",253,248,0,3,0,3,0.980237154150198
"068613002","BUENOS AIRES",291,273,4,14,0,18,0.938144329896907
"068613012","BUENOS AIRES",349,343,4,1,0,5,0.982808022922636
"068613203","BUENOS AIRES",79,71,0,3,0,3,0.89873417721519
"068613206","BUENOS AIRES",249,234,15,0,0,15,0.939759036144578
"068613306","BUENOS AIRES",273,269,3,0,0,3,0.985347985347985
"068680102","BUENOS AIRES",233,5,109,116,0,225,0.0214592274678112
"068680103","BUENOS AIRES",212,3,160,48,0,208,0.0141509433962264
"068680106","BUENOS AIRES",74,69,5,0,0,5,0.932432432432432
"068680108","BUENOS AIRES",205,193,6,6,0,12,0.941463414634146
"068680201","BUENOS AIRES",180,169,8,1,0,9,0.938888888888889
"068680209","BUENOS AIRES",26,26,0,0,0,0,1
"060070609","BUENOS AIRES",8,0,6,2,0,8,0
"068680310","BUENOS AIRES",44,37,3,4,0,7,0.840909090909091
"068680405","BUENOS AIRES",32,30,1,1,0,2,0.9375
"068680406","BUENOS AIRES",9,9,0,0,0,0,1
"068680505","BUENOS AIRES",68,6,50,10,1,61,0.0882352941176471
"068680508","BUENOS AIRES",149,0,124,22,1,147,0
"068680707","BUENOS AIRES",32,24,3,0,0,3,0.75
"068680708","BUENOS AIRES",47,42,4,1,0,5,0.893617021276596
"068680711","BUENOS AIRES",48,45,1,2,0,3,0.9375
"068750608","BUENOS AIRES",323,5,203,106,5,314,0.0154798761609907
"068750803","BUENOS AIRES",138,3,101,34,0,135,0.0217391304347826
"068820102","BUENOS AIRES",396,389,2,5,0,7,0.982323232323232
"900070306","TUCUMAN",120,0,21,80,1,102,0
"068820106","BUENOS AIRES",333,325,5,2,0,7,0.975975975975976
"068820110","BUENOS AIRES",339,327,1,10,0,11,0.964601769911504
"068820208","BUENOS AIRES",353,352,0,0,0,0,0.997167138810198
"068820302","BUENOS AIRES",322,299,1,18,0,19,0.928571428571429
"068820703","BUENOS AIRES",213,16,61,129,0,190,0.0751173708920188
"068820808","BUENOS AIRES",307,307,0,0,0,0,1
"068820810","BUENOS AIRES",279,276,2,0,0,2,0.989247311827957
"068820912","BUENOS AIRES",371,47,112,202,4,318,0.126684636118598
"068821004","BUENOS AIRES",250,250,0,0,0,0,1
"068821011","BUENOS AIRES",446,6,34,377,3,414,0.0134529147982063
"068821604","BUENOS AIRES",362,314,9,30,0,39,0.867403314917127
"068821705","BUENOS AIRES",518,13,29,440,5,474,0.0250965250965251
"065601603","BUENOS AIRES",340,6,172,159,0,331,0.0176470588235294
"065601612","BUENOS AIRES",463,7,207,241,0,448,0.0151187904967603
"900841216","TUCUMAN",397,377,0,0,0,0,0.949622166246851
"065601712","BUENOS AIRES",132,2,98,32,0,130,0.0151515151515152
"065601806","BUENOS AIRES",516,331,136,47,2,185,0.641472868217054
"065601812","BUENOS AIRES",270,1,230,38,1,269,0.0037037037037037
"065601903","BUENOS AIRES",376,4,146,180,7,333,0.0106382978723404
"065601909","BUENOS AIRES",289,1,206,75,0,281,0.00346020761245675
"065602317","BUENOS AIRES",386,380,6,0,0,6,0.984455958549223
"065601917","BUENOS AIRES",165,0,92,66,4,162,0
"065602105","BUENOS AIRES",257,0,134,114,1,249,0
"067910101","BUENOS AIRES",415,389,17,9,0,26,0.937349397590361
"065602313","BUENOS AIRES",329,317,7,5,0,12,0.963525835866261
"065602405","BUENOS AIRES",281,257,16,7,1,24,0.914590747330961
"065602415","BUENOS AIRES",198,192,4,2,0,6,0.96969696969697
"065602416","BUENOS AIRES",279,240,26,13,0,39,0.860215053763441
"064970109","BUENOS AIRES",196,77,69,50,0,119,0.392857142857143
"065602501","BUENOS AIRES",247,244,1,2,0,3,0.987854251012146
"065602509","BUENOS AIRES",469,381,65,21,0,86,0.812366737739872
"065602513","BUENOS AIRES",430,280,64,76,2,142,0.651162790697674
"065680102","BUENOS AIRES",268,258,10,0,0,10,0.962686567164179
"065680211","BUENOS AIRES",356,6,280,66,0,346,0.0168539325842697
"065680303","BUENOS AIRES",353,6,190,155,0,345,0.0169971671388102
"900841214","TUCUMAN",283,280,1,2,0,3,0.989399293286219
"065680313","BUENOS AIRES",423,331,36,32,0,68,0.782505910165485
"065680404","BUENOS AIRES",288,286,2,0,0,2,0.993055555555556
"065680407","BUENOS AIRES",285,282,3,0,0,3,0.989473684210526
"065680506","BUENOS AIRES",321,314,3,2,0,5,0.978193146417445
"065680509","BUENOS AIRES",222,217,0,4,0,4,0.977477477477477
"065680611","BUENOS AIRES",162,162,0,0,0,0,1
"020040504","CABA",279,269,2,0,0,2,0.96415770609319
"065680805","BUENOS AIRES",378,4,260,114,0,374,0.0105820105820106
"065680807","BUENOS AIRES",353,16,217,120,0,337,0.0453257790368272
"065680911","BUENOS AIRES",224,203,0,0,0,0,0.90625
"065681101","BUENOS AIRES",291,290,1,0,0,1,0.996563573883162
"065681103","BUENOS AIRES",241,241,0,0,0,0,1
"065681105","BUENOS AIRES",282,282,0,0,0,0,1
"065681106","BUENOS AIRES",276,271,4,1,0,5,0.981884057971015
"065681109","BUENOS AIRES",243,242,1,0,0,1,0.995884773662551
"065681306","BUENOS AIRES",380,361,12,6,0,18,0.95
"065681307","BUENOS AIRES",435,408,8,7,0,15,0.937931034482759
"065681308","BUENOS AIRES",368,346,12,8,0,20,0.940217391304348
"066300101","BUENOS AIRES",110,1,49,59,0,108,0.00909090909090909
"067491501","BUENOS AIRES",29,1,2,11,12,25,0.0344827586206897
"060070113","BUENOS AIRES",15,0,10,5,0,15,0
"064904808","BUENOS AIRES",315,283,1,2,0,3,0.898412698412698
"064904905","BUENOS AIRES",248,232,11,5,0,16,0.935483870967742
"064905002","BUENOS AIRES",408,395,8,4,0,12,0.968137254901961
"064905107","BUENOS AIRES",362,4,178,178,1,357,0.0110497237569061
"064970105","BUENOS AIRES",295,294,0,1,0,1,0.996610169491525
"064970302","BUENOS AIRES",369,3,203,162,0,365,0.00813008130081301
"064970310","BUENOS AIRES",118,4,31,81,0,112,0.0338983050847458
"064970407","BUENOS AIRES",195,8,132,55,0,187,0.041025641025641
"064970508","BUENOS AIRES",327,245,38,42,1,81,0.749235474006116
"064970513","BUENOS AIRES",352,274,34,43,0,77,0.778409090909091
"064970605","BUENOS AIRES",307,66,108,132,0,240,0.214983713355049
"064970706","BUENOS AIRES",291,289,1,1,0,2,0.993127147766323
"900841213","TUCUMAN",217,216,1,0,0,1,0.995391705069124
"064970710","BUENOS AIRES",238,215,23,0,0,23,0.903361344537815
"064970801","BUENOS AIRES",219,9,170,40,0,210,0.0410958904109589
"064970807","BUENOS AIRES",234,0,150,79,1,230,0
"064970811","BUENOS AIRES",406,1,324,75,0,399,0.00246305418719212
"064971207","BUENOS AIRES",321,73,117,130,0,247,0.227414330218069
"064971308","BUENOS AIRES",273,2,171,100,0,271,0.00732600732600733
"064971309","BUENOS AIRES",159,1,130,28,0,158,0.00628930817610063
"064971404","BUENOS AIRES",24,0,4,19,0,23,0
"065151914","BUENOS AIRES",260,1,190,62,2,254,0.00384615384615385
"065152009","BUENOS AIRES",330,1,222,101,0,323,0.00303030303030303
"065152013","BUENOS AIRES",419,6,283,117,2,402,0.0143198090692124
"065050301","BUENOS AIRES",48,1,23,23,0,46,0.0208333333333333
"065050304","BUENOS AIRES",66,1,37,26,0,63,0.0151515151515152
"065050320","BUENOS AIRES",179,107,48,22,0,70,0.597765363128492
"065110512","BUENOS AIRES",360,316,13,27,1,41,0.877777777777778
"065110513","BUENOS AIRES",197,31,52,111,1,164,0.157360406091371
"065152102","BUENOS AIRES",146,0,110,36,0,146,0
"065180102","BUENOS AIRES",123,77,31,15,0,46,0.626016260162602
"060070614","BUENOS AIRES",4,0,3,0,1,4,0
"065180103","BUENOS AIRES",186,146,12,26,0,38,0.78494623655914
"065180203","BUENOS AIRES",247,233,9,5,0,14,0.94331983805668
"065180301","BUENOS AIRES",75,1,29,44,0,73,0.0133333333333333
"065180607","BUENOS AIRES",66,0,53,12,0,65,0
"065151014","BUENOS AIRES",337,0,270,64,0,334,0
"065150203","BUENOS AIRES",176,0,86,85,0,171,0
"065150205","BUENOS AIRES",194,63,78,46,1,125,0.324742268041237
"065150206","BUENOS AIRES",200,77,108,14,0,122,0.385
"065150207","BUENOS AIRES",406,0,242,154,2,398,0
"061260310","BUENOS AIRES",368,362,1,4,0,5,0.983695652173913
"065150210","BUENOS AIRES",518,2,268,225,4,497,0.00386100386100386
"065150212","BUENOS AIRES",283,1,140,132,1,273,0.00353356890459364
"065150214","BUENOS AIRES",429,4,191,219,1,411,0.00932400932400932
"065150311","BUENOS AIRES",280,1,201,69,1,271,0.00357142857142857
"065150401","BUENOS AIRES",342,4,184,130,0,314,0.0116959064327485
"065151015","BUENOS AIRES",290,1,239,49,0,288,0.00344827586206897
"065150505","BUENOS AIRES",302,0,292,10,0,302,0
"065150606","BUENOS AIRES",395,3,341,48,0,389,0.00759493670886076
"065150608","BUENOS AIRES",275,0,173,98,0,271,0
"065150610","BUENOS AIRES",250,1,165,74,0,239,0.004
"065150705","BUENOS AIRES",287,4,197,76,0,273,0.0139372822299652
"060283103","BUENOS AIRES",288,5,223,60,0,283,0.0173611111111111
"060350105","BUENOS AIRES",149,146,1,1,0,2,0.979865771812081
"060350512","BUENOS AIRES",271,236,24,11,0,35,0.870848708487085
"065150910","BUENOS AIRES",451,0,331,111,0,442,0
"065151005","BUENOS AIRES",302,0,261,39,0,300,0
"060352606","BUENOS AIRES",223,222,1,0,0,1,0.995515695067265
"065151010","BUENOS AIRES",234,4,154,70,1,225,0.0170940170940171
"065151011","BUENOS AIRES",232,0,82,139,0,221,0
"060562003","BUENOS AIRES",311,310,0,1,0,1,0.996784565916399
"060562109","BUENOS AIRES",269,267,2,0,0,2,0.992565055762082
"060770101","BUENOS AIRES",324,87,51,169,2,222,0.268518518518519
"060910801","BUENOS AIRES",266,250,7,8,0,15,0.93984962406015
"060980610","BUENOS AIRES",226,13,157,48,1,206,0.0575221238938053
"061051103","BUENOS AIRES",156,3,84,65,0,149,0.0192307692307692
"065151204","BUENOS AIRES",233,2,149,75,0,224,0.00858369098712446
"065151210","BUENOS AIRES",291,0,168,101,0,269,0
"065151211","BUENOS AIRES",353,1,270,75,1,346,0.0028328611898017
"060281017","BUENOS AIRES",245,186,47,11,0,58,0.759183673469388
"061340901","BUENOS AIRES",38,0,9,26,2,37,0
"060070102","BUENOS AIRES",253,0,191,60,1,252,0
"060070405","BUENOS AIRES",332,1,177,148,2,327,0.00301204819277108
"060070612","BUENOS AIRES",50,0,28,21,0,49,0
"060070810","BUENOS AIRES",309,286,13,9,0,22,0.925566343042071
"060141001","BUENOS AIRES",127,1,45,76,3,124,0.0078740157480315
"060141008","BUENOS AIRES",213,164,28,21,0,49,0.769953051643192
"060141009","BUENOS AIRES",277,215,42,20,0,62,0.776173285198556
"060141012","BUENOS AIRES",193,26,86,80,1,167,0.134715025906736
"065151213","BUENOS AIRES",280,4,157,97,3,257,0.0142857142857143
"060281207","BUENOS AIRES",273,273,0,0,0,0,1
"060210612","BUENOS AIRES",227,164,17,46,0,63,0.722466960352423
"060280105","BUENOS AIRES",201,88,99,2,11,112,0.437810945273632
"060280109","BUENOS AIRES",485,12,248,204,1,453,0.0247422680412371
"060280208","BUENOS AIRES",324,3,127,174,0,301,0.00925925925925926
"060280305","BUENOS AIRES",406,4,50,301,12,363,0.00985221674876847
"060280309","BUENOS AIRES",277,4,137,131,0,268,0.0144404332129964
"060352304","BUENOS AIRES",131,129,0,2,0,2,0.984732824427481
"060280501","BUENOS AIRES",21,0,15,6,0,21,0
"060280504","BUENOS AIRES",306,1,177,116,0,293,0.00326797385620915
"060280702","BUENOS AIRES",546,7,235,284,4,523,0.0128205128205128
"060280703","BUENOS AIRES",573,2,275,271,2,548,0.00349040139616056
"060280706","BUENOS AIRES",449,3,309,129,1,439,0.0066815144766147
"060280801","BUENOS AIRES",82,1,33,41,0,74,0.0121951219512195
"060280806","BUENOS AIRES",267,3,212,52,0,264,0.0112359550561798
"060280807","BUENOS AIRES",260,2,127,127,0,254,0.00769230769230769
"060280901","BUENOS AIRES",463,20,228,195,2,425,0.0431965442764579
"063573707","BUENOS AIRES",159,159,0,0,0,0,1
"060281210","BUENOS AIRES",429,46,262,120,1,383,0.107226107226107
"060281211","BUENOS AIRES",372,27,282,63,0,345,0.0725806451612903
"060281302","BUENOS AIRES",235,1,183,50,0,233,0.00425531914893617
"060281303","BUENOS AIRES",236,8,142,80,0,222,0.0338983050847458
"060281308","BUENOS AIRES",332,5,81,236,0,317,0.0150602409638554
"060281410","BUENOS AIRES",304,1,196,99,0,295,0.00328947368421053
"060281512","BUENOS AIRES",292,5,184,91,1,276,0.0171232876712329
"060281608","BUENOS AIRES",277,277,0,0,0,0,1
"060281907","BUENOS AIRES",282,0,38,133,9,180,0
"060282004","BUENOS AIRES",490,0,211,243,4,458,0
"060282010","BUENOS AIRES",319,2,109,191,7,307,0.00626959247648903
"060282015","BUENOS AIRES",377,0,179,177,4,360,0
"060282108","BUENOS AIRES",306,0,221,78,1,300,0
"060282109","BUENOS AIRES",327,0,187,130,0,317,0
"060282113","BUENOS AIRES",254,0,207,46,0,253,0
"060282405","BUENOS AIRES",453,409,36,7,1,44,0.902869757174393
"060282602","BUENOS AIRES",126,125,0,1,0,1,0.992063492063492
"060282605","BUENOS AIRES",224,222,2,0,0,2,0.991071428571429
"060282609","BUENOS AIRES",280,280,0,0,0,0,1
"060282701","BUENOS AIRES",210,10,162,38,0,200,0.0476190476190476
"060282712","BUENOS AIRES",306,5,206,94,0,300,0.0163398692810458
"060282713","BUENOS AIRES",344,2,284,57,1,342,0.00581395348837209
"060282807","BUENOS AIRES",374,7,290,71,0,361,0.018716577540107
"060283006","BUENOS AIRES",288,4,188,83,2,273,0.0138888888888889
"060283007","BUENOS AIRES",360,1,179,163,1,343,0.00277777777777778
"060283010","BUENOS AIRES",385,1,202,154,10,366,0.0025974025974026
"060283112","BUENOS AIRES",300,2,245,51,1,297,0.00666666666666667
"060283301","BUENOS AIRES",627,62,177,293,33,503,0.0988835725677831
"060283314","BUENOS AIRES",482,0,179,270,5,454,0
"060283404","BUENOS AIRES",367,4,237,117,1,355,0.0108991825613079
"060283406","BUENOS AIRES",375,0,303,69,1,373,0
"060283509","BUENOS AIRES",415,0,216,189,0,405,0
"060283605","BUENOS AIRES",420,134,151,129,1,281,0.319047619047619
"060283607","BUENOS AIRES",438,1,367,66,1,434,0.00228310502283105
"060283613","BUENOS AIRES",364,0,20,126,54,200,0
"060283615","BUENOS AIRES",448,0,277,155,2,434,0
"060283711","BUENOS AIRES",380,3,269,94,1,364,0.00789473684210526
"060283713","BUENOS AIRES",275,0,144,118,1,263,0
"060283807","BUENOS AIRES",229,0,178,48,0,226,0
"060283905","BUENOS AIRES",317,0,164,112,1,277,0
"060283915","BUENOS AIRES",269,0,180,87,0,267,0
"060561009","BUENOS AIRES",230,230,0,0,0,0,1
"020071301","CABA",320,304,0,0,0,0,0.95
"060350106","BUENOS AIRES",225,206,3,12,1,16,0.915555555555556
"060350110","BUENOS AIRES",286,250,22,8,0,30,0.874125874125874
"060350111","BUENOS AIRES",256,207,8,19,1,28,0.80859375
"065151216","BUENOS AIRES",300,0,210,84,0,294,0
"060350301","BUENOS AIRES",308,18,125,158,1,284,0.0584415584415584
"060351801","BUENOS AIRES",286,222,43,20,1,64,0.776223776223776
"062170509","BUENOS AIRES",4,0,4,0,0,4,0
"060350405","BUENOS AIRES",356,106,134,116,0,250,0.297752808988764
"060350408","BUENOS AIRES",250,184,43,19,0,62,0.736
"060351302","BUENOS AIRES",338,333,4,1,0,5,0.985207100591716
"060350608","BUENOS AIRES",303,292,3,8,0,11,0.963696369636964
"060350802","BUENOS AIRES",174,174,0,0,0,0,1
"060350808","BUENOS AIRES",215,168,32,12,0,44,0.781395348837209
"060350814","BUENOS AIRES",222,158,27,35,0,62,0.711711711711712
"060350904","BUENOS AIRES",711,392,34,209,11,254,0.551336146272855
"060350912","BUENOS AIRES",191,168,13,3,0,16,0.879581151832461
"060351610","BUENOS AIRES",334,17,136,178,0,314,0.0508982035928144
"060351706","BUENOS AIRES",266,8,164,92,0,256,0.0300751879699248
"060351710","BUENOS AIRES",351,33,147,169,0,316,0.094017094017094
"060352006","BUENOS AIRES",287,238,29,18,0,47,0.829268292682927
"060352008","BUENOS AIRES",343,290,35,18,0,53,0.845481049562682
"060352305","BUENOS AIRES",381,343,21,16,0,37,0.900262467191601
"060352101","BUENOS AIRES",404,369,24,11,0,35,0.913366336633663
"060352110","BUENOS AIRES",299,297,2,0,0,2,0.993311036789298
"060352204","BUENOS AIRES",192,170,1,0,0,1,0.885416666666667
"060352207","BUENOS AIRES",274,272,2,0,0,2,0.992700729927007
"060352302","BUENOS AIRES",173,162,5,6,0,11,0.936416184971098
"060352312","BUENOS AIRES",363,202,23,119,0,142,0.556473829201102
"060352608","BUENOS AIRES",235,26,61,138,2,201,0.11063829787234
"060352610","BUENOS AIRES",484,31,124,303,0,427,0.0640495867768595
"063573802","BUENOS AIRES",179,179,0,0,0,0,1
"060352701","BUENOS AIRES",69,14,6,43,0,49,0.202898550724638
"020042007","CABA",290,279,10,1,0,11,0.962068965517241
"060352706","BUENOS AIRES",482,89,109,267,0,376,0.184647302904564
"060352804","BUENOS AIRES",272,36,127,109,0,236,0.132352941176471
"060352904","BUENOS AIRES",267,42,100,125,0,225,0.157303370786517
"060353109","BUENOS AIRES",219,27,151,40,0,191,0.123287671232877
"060353406","BUENOS AIRES",341,327,8,5,0,13,0.958944281524927
"060560902","BUENOS AIRES",270,270,0,0,0,0,1
"060353507","BUENOS AIRES",242,231,8,2,0,10,0.954545454545455
"060421905","BUENOS AIRES",309,293,7,8,0,15,0.948220064724919
"060490211","BUENOS AIRES",279,232,24,22,0,46,0.831541218637993
"060490506","BUENOS AIRES",282,258,11,13,0,24,0.914893617021277
"060490606","BUENOS AIRES",373,326,20,27,0,47,0.873994638069705
"060490615","BUENOS AIRES",142,42,26,70,0,96,0.295774647887324
"060492001","BUENOS AIRES",391,209,68,110,2,180,0.534526854219949
"062520304","BUENOS AIRES",232,0,170,58,0,228,0
"063572101","BUENOS AIRES",157,156,1,0,0,1,0.993630573248408
"060492507","BUENOS AIRES",437,316,63,58,0,121,0.723112128146453
"060560104","BUENOS AIRES",166,164,2,0,0,2,0.987951807228916
"060560105","BUENOS AIRES",194,194,0,0,0,0,1
"060560106","BUENOS AIRES",177,177,0,0,0,0,1
"060560303","BUENOS AIRES",285,284,1,0,0,1,0.996491228070175
"060560207","BUENOS AIRES",301,294,3,4,0,7,0.976744186046512
"060560905","BUENOS AIRES",224,223,1,0,0,1,0.995535714285714
"060561105","BUENOS AIRES",215,215,0,0,0,0,1
"060560213","BUENOS AIRES",177,171,3,3,0,6,0.966101694915254
"060560310","BUENOS AIRES",279,258,0,2,0,2,0.924731182795699
"060560312","BUENOS AIRES",233,217,0,10,0,10,0.931330472103004
"060560501","BUENOS AIRES",228,217,5,6,0,11,0.951754385964912
"060560502","BUENOS AIRES",301,275,13,11,0,24,0.913621262458472
"060560705","BUENOS AIRES",223,223,0,0,0,0,1
"060560708","BUENOS AIRES",277,277,0,0,0,0,1
"060560803","BUENOS AIRES",367,290,40,31,1,72,0.790190735694823
"060560812","BUENOS AIRES",275,38,29,191,4,224,0.138181818181818
"060561605","BUENOS AIRES",313,312,0,0,0,0,0.996805111821086
"060561612","BUENOS AIRES",258,257,1,0,0,1,0.996124031007752
"062600103","BUENOS AIRES",271,16,78,166,1,245,0.0590405904059041
"060561806","BUENOS AIRES",295,289,3,3,0,6,0.979661016949153
"060561810","BUENOS AIRES",252,246,5,1,0,6,0.976190476190476
"062600302","BUENOS AIRES",247,14,90,139,1,230,0.0566801619433198
"060562206","BUENOS AIRES",351,255,11,73,0,84,0.726495726495726
"060562212","BUENOS AIRES",101,93,6,0,0,6,0.920792079207921
"062601310","BUENOS AIRES",209,122,64,23,0,87,0.583732057416268
"060562316","BUENOS AIRES",296,150,26,100,4,130,0.506756756756757
"060562404","BUENOS AIRES",365,234,46,85,0,131,0.641095890410959
"900842007","TUCUMAN",333,333,0,0,0,0,1
"065151307","BUENOS AIRES",258,2,192,62,0,254,0.00775193798449612
"060562409","BUENOS AIRES",361,78,75,198,1,274,0.21606648199446
"060562413","BUENOS AIRES",405,258,49,95,0,144,0.637037037037037
"060562505","BUENOS AIRES",354,234,39,78,0,117,0.661016949152542
"060562514","BUENOS AIRES",314,312,1,1,0,2,0.993630573248408
"065151308","BUENOS AIRES",305,3,231,67,0,298,0.00983606557377049
"060562607","BUENOS AIRES",316,4,279,33,0,312,0.0126582278481013
"065151311","BUENOS AIRES",447,2,337,101,0,438,0.00447427293064877
"060562702","BUENOS AIRES",244,210,17,15,0,32,0.860655737704918
"060562706","BUENOS AIRES",100,0,36,63,0,99,0
"060911409","BUENOS AIRES",261,226,15,19,0,34,0.865900383141762
"067491318","BUENOS AIRES",311,286,10,7,0,17,0.919614147909968
"060563203","BUENOS AIRES",339,2,153,175,4,332,0.00589970501474926
"060563206","BUENOS AIRES",340,219,93,26,1,120,0.644117647058824
"060630112","BUENOS AIRES",217,213,1,1,2,4,0.981566820276498
"062660707","BUENOS AIRES",257,206,27,23,0,50,0.801556420233463
"060630207","BUENOS AIRES",325,218,27,78,0,105,0.670769230769231
"060630801","BUENOS AIRES",6,0,6,0,0,6,0
"062700706","BUENOS AIRES",237,2,106,93,1,200,0.00843881856540084
"060911003","BUENOS AIRES",448,418,19,8,0,27,0.933035714285714
"060631303","BUENOS AIRES",439,406,10,20,0,30,0.924829157175399
"060631308","BUENOS AIRES",372,214,41,113,1,155,0.575268817204301
"060700203","BUENOS AIRES",202,161,0,37,0,37,0.797029702970297
"060700306","BUENOS AIRES",454,285,16,130,4,150,0.627753303964758
"060770502","BUENOS AIRES",215,28,69,95,1,165,0.130232558139535
"060770505","BUENOS AIRES",257,31,78,134,2,214,0.120622568093385
"060840901","BUENOS AIRES",179,6,144,28,0,172,0.0335195530726257
"060910306","BUENOS AIRES",422,384,17,15,0,32,0.909952606635071
"060910106","BUENOS AIRES",224,218,3,1,0,4,0.973214285714286
"060910309","BUENOS AIRES",396,383,3,9,0,12,0.967171717171717
"060910312","BUENOS AIRES",156,156,0,0,0,0,1
"060910402","BUENOS AIRES",353,195,33,110,1,144,0.552407932011331
"060910403","BUENOS AIRES",447,338,22,69,0,91,0.756152125279642
"060910404","BUENOS AIRES",459,289,29,128,1,158,0.62962962962963
"060910408","BUENOS AIRES",223,199,3,19,0,22,0.89237668161435
"060910502","BUENOS AIRES",378,280,42,51,0,93,0.740740740740741
"060910504","BUENOS AIRES",245,231,6,8,0,14,0.942857142857143
"060911611","BUENOS AIRES",514,334,63,113,0,176,0.649805447470817
"060911701","BUENOS AIRES",282,234,16,24,0,40,0.829787234042553
"061120113","BUENOS AIRES",271,90,33,134,0,167,0.33210332103321
"900841205","TUCUMAN",189,189,0,0,0,0,1
"060910509","BUENOS AIRES",160,98,20,27,6,53,0.6125
"060910611","BUENOS AIRES",322,6,91,210,1,302,0.0186335403726708
"060910702","BUENOS AIRES",328,305,11,4,0,15,0.929878048780488
"060910605","BUENOS AIRES",232,190,24,18,0,42,0.818965517241379
"060910606","BUENOS AIRES",307,175,31,98,0,129,0.570032573289902
"060910906","BUENOS AIRES",360,348,2,7,0,9,0.966666666666667
"060911002","BUENOS AIRES",209,203,0,1,0,1,0.971291866028708
"060911107","BUENOS AIRES",406,395,5,3,0,8,0.972906403940887
"060911808","BUENOS AIRES",343,276,35,25,2,62,0.80466472303207
"060911904","BUENOS AIRES",382,348,6,16,0,22,0.910994764397906
"060912103","BUENOS AIRES",275,8,86,170,1,257,0.0290909090909091
"060912104","BUENOS AIRES",262,262,0,0,0,0,1
"060912112","BUENOS AIRES",424,18,184,206,4,394,0.0424528301886792
"060912117","BUENOS AIRES",446,16,163,252,0,415,0.0358744394618834
"060912208","BUENOS AIRES",265,4,109,148,1,258,0.0150943396226415
"060912214","BUENOS AIRES",175,107,41,27,0,68,0.611428571428571
"060912405","BUENOS AIRES",281,1,46,201,7,254,0.00355871886120996
"060980106","BUENOS AIRES",299,172,92,35,0,127,0.575250836120401
"060980204","BUENOS AIRES",406,332,47,24,0,71,0.817733990147783
"540282210","MISIONES",321,144,139,26,0,165,0.448598130841121
"060980208","BUENOS AIRES",360,27,251,76,1,328,0.075
"063573909","BUENOS AIRES",101,100,0,1,0,1,0.99009900990099
"060980604","BUENOS AIRES",231,23,156,48,0,204,0.0995670995670996
"060980608","BUENOS AIRES",345,61,178,105,0,283,0.176811594202899
"061050209","BUENOS AIRES",207,201,3,3,0,6,0.971014492753623
"060980613","BUENOS AIRES",240,3,124,93,7,224,0.0125
"060980617","BUENOS AIRES",232,31,173,28,0,201,0.133620689655172
"060980812","BUENOS AIRES",231,131,76,22,0,98,0.567099567099567
"061050210","BUENOS AIRES",287,282,3,2,0,5,0.982578397212544
"060980803","BUENOS AIRES",240,15,65,135,1,201,0.0625
"060980815","BUENOS AIRES",326,216,68,42,0,110,0.662576687116564
"061050105","BUENOS AIRES",241,236,2,3,0,5,0.979253112033195
"064272605","BUENOS AIRES",332,327,4,0,0,4,0.984939759036145
"061051407","BUENOS AIRES",283,282,1,0,0,1,0.996466431095406
"061120106","BUENOS AIRES",284,284,0,0,0,0,1
"061120701","BUENOS AIRES",157,1,76,78,2,156,0.00636942675159236
"061121305","BUENOS AIRES",86,26,24,35,0,59,0.302325581395349
"061121403","BUENOS AIRES",282,275,3,4,0,7,0.975177304964539
"061190306","BUENOS AIRES",181,121,30,28,0,58,0.668508287292818
"061191004","BUENOS AIRES",224,1,81,120,5,206,0.00446428571428571
"061191006","BUENOS AIRES",426,154,160,106,2,268,0.36150234741784
"061260105","BUENOS AIRES",255,248,2,5,0,7,0.972549019607843
"061260106","BUENOS AIRES",261,251,9,1,0,10,0.961685823754789
"061260109","BUENOS AIRES",328,253,39,36,0,75,0.771341463414634
"061260110","BUENOS AIRES",286,240,21,25,0,46,0.839160839160839
"061260114","BUENOS AIRES",227,223,1,1,0,2,0.982378854625551
"061260306","BUENOS AIRES",245,243,2,0,0,2,0.991836734693878
"061260401","BUENOS AIRES",249,249,0,0,0,0,1
"061260510","BUENOS AIRES",237,5,23,201,0,224,0.0210970464135021
"061540605","BUENOS AIRES",140,0,126,14,0,140,0
"064276513","BUENOS AIRES",272,3,172,82,0,254,0.0110294117647059
"061260607","BUENOS AIRES",108,99,9,0,0,9,0.916666666666667
"061260806","BUENOS AIRES",260,258,2,0,0,2,0.992307692307692
"061260905","BUENOS AIRES",89,0,63,26,0,89,0
"061340201","BUENOS AIRES",354,108,121,125,0,246,0.305084745762712
"061340307","BUENOS AIRES",474,403,33,35,0,68,0.850210970464135
"061340906","BUENOS AIRES",169,0,94,67,1,162,0
"061400302","BUENOS AIRES",401,353,14,29,0,43,0.880299251870324
"061400319","BUENOS AIRES",279,245,11,18,2,31,0.878136200716846
"061470301","BUENOS AIRES",145,0,76,64,2,142,0
"061471101","BUENOS AIRES",57,0,9,39,2,50,0
"061471210","BUENOS AIRES",231,159,30,41,0,71,0.688311688311688
"020120509","CABA",311,309,2,0,0,2,0.993569131832797
"061540611","BUENOS AIRES",195,0,139,56,0,195,0
"061540601","BUENOS AIRES",165,0,75,88,0,163,0
"061540802","BUENOS AIRES",46,0,34,12,0,46,0
"061610102","BUENOS AIRES",208,112,27,52,1,80,0.538461538461538
"061680904","BUENOS AIRES",348,323,15,10,0,25,0.92816091954023
"061750602","BUENOS AIRES",232,203,9,19,0,28,0.875
"061750603","BUENOS AIRES",246,41,27,169,0,196,0.166666666666667
"061820104","BUENOS AIRES",328,324,4,0,0,4,0.98780487804878
"061820502","BUENOS AIRES",127,2,97,28,0,125,0.015748031496063
"061821008","BUENOS AIRES",332,330,1,1,0,2,0.993975903614458
"061890601","BUENOS AIRES",17,0,12,4,1,17,0
"063572204","BUENOS AIRES",165,165,0,0,0,0,1
"061891003","BUENOS AIRES",252,239,10,3,0,13,0.948412698412698
"061891004","BUENOS AIRES",278,252,12,14,0,26,0.906474820143885
"061891502","BUENOS AIRES",363,3,260,94,3,357,0.00826446280991736
"062601403","BUENOS AIRES",287,34,212,41,0,253,0.118466898954704
"061960104","BUENOS AIRES",258,167,17,72,0,89,0.647286821705426
"062031604","BUENOS AIRES",425,328,43,54,0,97,0.771764705882353
"061960112","BUENOS AIRES",338,324,4,10,0,14,0.958579881656805
"061960206","BUENOS AIRES",318,312,6,0,0,6,0.981132075471698
"061960211","BUENOS AIRES",154,122,17,15,0,32,0.792207792207792
"061960701","BUENOS AIRES",136,49,33,50,1,84,0.360294117647059
"062030107","BUENOS AIRES",228,218,7,3,0,10,0.956140350877193
"062030108","BUENOS AIRES",294,53,134,104,0,238,0.180272108843537
"061961506","BUENOS AIRES",91,0,49,37,1,87,0
"062030103","BUENOS AIRES",293,292,0,0,0,0,0.996587030716723
"062030201","BUENOS AIRES",182,86,48,48,0,96,0.472527472527473
"062030210","BUENOS AIRES",248,66,76,102,2,180,0.266129032258065
"062030211","BUENOS AIRES",147,50,33,63,1,97,0.340136054421769
"062030805","BUENOS AIRES",424,316,76,30,0,106,0.745283018867924
"062030808","BUENOS AIRES",483,300,111,68,0,179,0.62111801242236
"063572206","BUENOS AIRES",242,242,0,0,0,0,1
"062740809","BUENOS AIRES",251,1,72,156,3,231,0.00398406374501992
"062031609","BUENOS AIRES",405,0,226,175,2,403,0
"063711108","BUENOS AIRES",245,244,0,1,0,1,0.995918367346939
"062100104","BUENOS AIRES",168,163,5,0,0,5,0.970238095238095
"062100113","BUENOS AIRES",203,188,6,9,0,15,0.926108374384236
"062100121","BUENOS AIRES",271,251,9,11,0,20,0.92619926199262
"062100207","BUENOS AIRES",440,424,6,7,0,13,0.963636363636364
"062100603","BUENOS AIRES",165,0,84,80,0,164,0
"062100608","BUENOS AIRES",94,0,36,56,2,94,0
"062100901","BUENOS AIRES",222,187,23,12,0,35,0.842342342342342
"062101303","BUENOS AIRES",187,178,4,4,0,8,0.951871657754011
"062101306","BUENOS AIRES",404,390,3,10,0,13,0.965346534653465
"062170108","BUENOS AIRES",218,212,4,2,0,6,0.972477064220184
"062170111","BUENOS AIRES",214,210,1,3,0,4,0.981308411214953
"062170403","BUENOS AIRES",125,2,43,79,0,122,0.016
"062240414","BUENOS AIRES",155,8,7,137,0,144,0.0516129032258065
"540282002","MISIONES",452,110,247,41,22,310,0.243362831858407
"062170407","BUENOS AIRES",90,1,49,39,0,88,0.0111111111111111
"062170410","BUENOS AIRES",223,43,104,72,0,176,0.192825112107623
"062240113","BUENOS AIRES",282,278,3,1,0,4,0.985815602836879
"062171003","BUENOS AIRES",377,353,13,11,0,24,0.936339522546419
"062171013","BUENOS AIRES",223,209,4,9,1,14,0.937219730941704
"062171202","BUENOS AIRES",592,588,3,0,0,3,0.993243243243243
"062171208","BUENOS AIRES",257,247,7,3,0,10,0.961089494163424
"062171209","BUENOS AIRES",226,218,3,3,0,6,0.964601769911504
"064080115","BUENOS AIRES",107,7,95,5,0,100,0.0654205607476635
"062240903","BUENOS AIRES",85,0,44,41,0,85,0
"062240912","BUENOS AIRES",144,2,85,57,0,142,0.0138888888888889
"062380101","BUENOS AIRES",193,1,85,107,0,192,0.00518134715025907
"062171215","BUENOS AIRES",216,163,29,21,1,51,0.75462962962963
"062240104","BUENOS AIRES",250,142,52,54,1,107,0.568
"063572210","BUENOS AIRES",173,173,0,0,0,0,1
"062240309","BUENOS AIRES",167,44,44,79,0,123,0.263473053892216
"062240404","BUENOS AIRES",286,280,2,4,0,6,0.979020979020979
"062240407","BUENOS AIRES",321,314,1,6,0,7,0.978193146417445
"062800403","BUENOS AIRES",35,35,0,0,0,0,1
"062380107","BUENOS AIRES",420,34,122,258,2,382,0.080952380952381
"062380112","BUENOS AIRES",252,238,9,4,0,13,0.944444444444444
"062600213","BUENOS AIRES",334,4,165,161,1,327,0.0119760479041916
"062380601","BUENOS AIRES",131,1,36,92,0,128,0.00763358778625954
"062380605","BUENOS AIRES",9,0,3,6,0,9,0
"062380610","BUENOS AIRES",16,0,4,11,0,15,0
"062380611","BUENOS AIRES",183,0,89,93,0,182,0
"062450211","BUENOS AIRES",488,231,165,75,6,246,0.473360655737705
"062450214","BUENOS AIRES",267,265,2,0,0,2,0.99250936329588
"062450301","BUENOS AIRES",312,302,6,1,0,7,0.967948717948718
"062450302","BUENOS AIRES",382,325,36,17,0,53,0.850785340314136
"065151502","BUENOS AIRES",293,1,234,52,1,287,0.00341296928327645
"062450410","BUENOS AIRES",233,13,137,66,9,212,0.055793991416309
"062450506","BUENOS AIRES",3,2,1,0,0,1,0.666666666666667
"062520107","BUENOS AIRES",543,186,232,118,0,350,0.342541436464088
"062520113","BUENOS AIRES",335,218,82,22,0,104,0.650746268656716
"062520404","BUENOS AIRES",265,179,48,37,0,85,0.675471698113208
"062601009","BUENOS AIRES",238,178,39,14,5,58,0.747899159663866
"062521304","BUENOS AIRES",319,1,217,100,0,317,0.00313479623824451
"062520207","BUENOS AIRES",173,1,129,42,1,172,0.00578034682080925
"062520213","BUENOS AIRES",253,135,72,45,0,117,0.533596837944664
"062520303","BUENOS AIRES",112,25,51,33,3,87,0.223214285714286
"062520305","BUENOS AIRES",445,5,112,294,5,411,0.0112359550561798
"062520309","BUENOS AIRES",204,1,158,45,0,203,0.00490196078431373
"062520405","BUENOS AIRES",319,162,44,60,0,104,0.507836990595611
"062520509","BUENOS AIRES",378,98,166,110,0,276,0.259259259259259
"062520703","BUENOS AIRES",420,34,167,215,1,383,0.080952380952381
"062521406","BUENOS AIRES",221,1,93,118,0,211,0.00452488687782805
"062520803","BUENOS AIRES",425,3,245,162,2,409,0.00705882352941176
"063573104","BUENOS AIRES",111,111,0,0,0,0,1
"062520910","BUENOS AIRES",399,1,290,103,0,393,0.0025062656641604
"062520912","BUENOS AIRES",414,0,197,208,1,406,0
"062521305","BUENOS AIRES",361,7,257,93,0,350,0.0193905817174515
"062521015","BUENOS AIRES",199,2,141,55,0,196,0.0100502512562814
"065151511","BUENOS AIRES",384,0,234,137,0,371,0
"062521104","BUENOS AIRES",366,2,305,58,0,363,0.00546448087431694
"062521108","BUENOS AIRES",97,1,79,17,0,96,0.0103092783505155
"062521203","BUENOS AIRES",428,1,251,171,0,422,0.00233644859813084
"062521301","BUENOS AIRES",223,3,157,57,1,215,0.0134529147982063
"062521302","BUENOS AIRES",370,2,173,189,2,364,0.00540540540540541
"062521303","BUENOS AIRES",387,1,208,167,0,375,0.00258397932816537
"062521405","BUENOS AIRES",214,1,151,59,1,211,0.00467289719626168
"062521408","BUENOS AIRES",492,3,278,202,0,480,0.00609756097560976
"062521410","BUENOS AIRES",300,2,200,97,0,297,0.00666666666666667
"062521412","BUENOS AIRES",395,0,143,228,10,381,0
"062521417","BUENOS AIRES",292,1,190,100,1,291,0.00342465753424658
"062521504","BUENOS AIRES",426,2,269,152,0,421,0.00469483568075117
"064130505","BUENOS AIRES",159,159,0,0,0,0,1
"062521510","BUENOS AIRES",194,187,3,4,0,7,0.963917525773196
"062521512","BUENOS AIRES",492,1,319,160,2,481,0.00203252032520325
"064130603","BUENOS AIRES",338,336,2,0,0,2,0.994082840236686
"062600112","BUENOS AIRES",418,13,122,262,7,391,0.0311004784688995
"062600206","BUENOS AIRES",328,1,118,201,0,319,0.00304878048780488
"065151513","BUENOS AIRES",395,0,259,131,1,391,0
"062600208","BUENOS AIRES",82,7,41,34,0,75,0.0853658536585366
"062600215","BUENOS AIRES",411,2,181,222,2,405,0.0048661800486618
"062601001","BUENOS AIRES",337,56,155,110,2,267,0.166172106824926
"062600501","BUENOS AIRES",351,7,118,186,4,308,0.0199430199430199
"062601301","BUENOS AIRES",253,38,160,55,0,215,0.150197628458498
"062600313","BUENOS AIRES",463,459,3,0,0,3,0.991360691144708
"062600404","BUENOS AIRES",336,126,114,85,0,199,0.375
"062600407","BUENOS AIRES",289,1,176,105,0,281,0.00346020761245675
"062600410","BUENOS AIRES",235,60,97,77,0,174,0.25531914893617
"062600502","BUENOS AIRES",325,1,176,141,1,318,0.00307692307692308
"062600506","BUENOS AIRES",424,9,110,286,6,402,0.0212264150943396
"062600512","BUENOS AIRES",313,2,135,167,1,303,0.00638977635782748
"062600604","BUENOS AIRES",432,9,302,120,0,422,0.0208333333333333
"062600606","BUENOS AIRES",221,9,162,47,1,210,0.0407239819004525
"062600614","BUENOS AIRES",353,9,265,79,0,344,0.0254957507082153
"062600711","BUENOS AIRES",323,2,251,69,0,320,0.00619195046439629
"062600910","BUENOS AIRES",372,0,223,141,0,364,0
"068402706","BUENOS AIRES",145,143,1,1,0,2,0.986206896551724
"062601207","BUENOS AIRES",213,1,167,45,0,212,0.00469483568075117
"062601311","BUENOS AIRES",269,268,1,0,0,1,0.996282527881041
"062601413","BUENOS AIRES",291,4,174,105,0,279,0.013745704467354
"062601513","BUENOS AIRES",342,11,241,84,0,325,0.0321637426900585
"062601514","BUENOS AIRES",244,2,118,112,0,230,0.00819672131147541
"062601515","BUENOS AIRES",285,8,109,161,1,271,0.0280701754385965
"062601516","BUENOS AIRES",307,177,64,59,2,125,0.576547231270358
"062601519","BUENOS AIRES",329,3,208,112,1,321,0.00911854103343465
"063572905","BUENOS AIRES",51,51,0,0,0,0,1
"062601608","BUENOS AIRES",125,0,41,81,1,123,0
"062601610","BUENOS AIRES",286,1,148,130,0,278,0.0034965034965035
"062601616","BUENOS AIRES",361,21,193,142,1,336,0.0581717451523546
"062660302","BUENOS AIRES",285,252,10,21,0,31,0.884210526315789
"062660307","BUENOS AIRES",186,180,2,4,0,6,0.967741935483871
"062740705","BUENOS AIRES",324,10,88,211,2,301,0.0308641975308642
"062660310","BUENOS AIRES",279,249,11,17,1,29,0.89247311827957
"063573106","BUENOS AIRES",189,189,0,0,0,0,1
"062660604","BUENOS AIRES",77,2,60,15,0,75,0.025974025974026
"062740807","BUENOS AIRES",376,365,11,0,0,11,0.970744680851064
"062700311","BUENOS AIRES",356,24,278,49,0,327,0.0674157303370786
"062700407","BUENOS AIRES",339,298,32,9,0,41,0.87905604719764
"062700409","BUENOS AIRES",433,390,32,10,0,42,0.900692840646651
"062700504","BUENOS AIRES",465,1,258,189,3,450,0.0021505376344086
"062700505","BUENOS AIRES",380,0,226,146,0,372,0
"062700508","BUENOS AIRES",434,7,247,137,2,386,0.0161290322580645
"064271420","BUENOS AIRES",239,232,2,4,0,6,0.97071129707113
"062700909","BUENOS AIRES",392,3,227,139,7,373,0.0076530612244898
"062701005","BUENOS AIRES",368,3,275,87,0,362,0.00815217391304348
"062740103","BUENOS AIRES",227,224,1,2,0,3,0.986784140969163
"064275005","BUENOS AIRES",367,353,7,7,0,14,0.961852861035422
"062740105","BUENOS AIRES",493,420,41,24,0,65,0.851926977687627
"062740108","BUENOS AIRES",177,167,3,3,0,6,0.943502824858757
"062740205","BUENOS AIRES",331,304,16,10,0,26,0.918429003021148
"064276206","BUENOS AIRES",339,117,157,61,0,218,0.345132743362832
"062740206","BUENOS AIRES",496,462,11,15,0,26,0.931451612903226
"062740209","BUENOS AIRES",273,235,13,16,0,29,0.860805860805861
"062740211","BUENOS AIRES",442,406,12,14,0,26,0.918552036199095
"062740212","BUENOS AIRES",328,302,15,8,0,23,0.920731707317073
"062740214","BUENOS AIRES",405,385,11,7,0,18,0.950617283950617
"062740306","BUENOS AIRES",211,3,125,80,0,205,0.014218009478673
"062740307","BUENOS AIRES",458,5,268,173,2,443,0.0109170305676856
"062740512","BUENOS AIRES",359,14,186,154,0,340,0.0389972144846797
"062740606","BUENOS AIRES",396,15,172,199,1,372,0.0378787878787879
"062740710","BUENOS AIRES",303,7,66,217,2,285,0.0231023102310231
"062740804","BUENOS AIRES",257,254,3,0,0,3,0.988326848249027
"020080204","CABA",249,244,5,0,0,5,0.979919678714859
"062740903","BUENOS AIRES",327,0,102,188,5,295,0
"062740917","BUENOS AIRES",297,8,145,135,1,281,0.0269360269360269
"062740921","BUENOS AIRES",344,2,179,151,1,331,0.00581395348837209
"064274006","BUENOS AIRES",378,322,28,24,0,52,0.851851851851852
"062741105","BUENOS AIRES",437,313,54,62,0,116,0.716247139588101
"062741213","BUENOS AIRES",232,5,91,124,2,217,0.021551724137931
"062741309","BUENOS AIRES",287,9,109,154,5,268,0.0313588850174216
"062741401","BUENOS AIRES",416,390,13,13,0,26,0.9375
"062741405","BUENOS AIRES",376,374,1,1,0,2,0.99468085106383
"062741406","BUENOS AIRES",205,203,2,0,0,2,0.990243902439024
"062741408","BUENOS AIRES",313,312,1,0,0,1,0.996805111821086
"062741705","BUENOS AIRES",294,7,141,141,0,282,0.0238095238095238
"063573010","BUENOS AIRES",160,160,0,0,0,0,1
"063573011","BUENOS AIRES",205,205,0,0,0,0,1
"062742006","BUENOS AIRES",411,92,75,235,0,310,0.223844282238443
"062742016","BUENOS AIRES",280,5,41,215,4,260,0.0178571428571429
"062742101","BUENOS AIRES",213,149,37,24,0,61,0.699530516431925
"063571203","BUENOS AIRES",298,280,4,11,0,15,0.939597315436242
"062742121","BUENOS AIRES",225,5,108,109,0,217,0.0222222222222222
"062742207","BUENOS AIRES",47,0,19,27,1,47,0
"062742208","BUENOS AIRES",93,1,55,33,3,91,0.010752688172043
"062742212","BUENOS AIRES",244,1,80,140,7,227,0.00409836065573771
"062770103","BUENOS AIRES",113,0,75,37,0,112,0
"062800103","BUENOS AIRES",184,62,57,62,2,121,0.33695652173913
"540281214","MISIONES",467,440,26,0,0,26,0.942184154175589
"062800203","BUENOS AIRES",177,176,1,0,0,1,0.994350282485876
"062800205","BUENOS AIRES",342,291,24,25,0,49,0.850877192982456
"062800207","BUENOS AIRES",290,288,1,1,0,2,0.993103448275862
"062800303","BUENOS AIRES",62,62,0,0,0,0,1
"062800305","BUENOS AIRES",83,80,2,1,0,3,0.963855421686747
"062800309","BUENOS AIRES",46,46,0,0,0,0,1
"062800311","BUENOS AIRES",37,37,0,0,0,0,1
"062801002","BUENOS AIRES",197,145,28,22,0,50,0.736040609137056
"062801112","BUENOS AIRES",137,15,43,79,0,122,0.109489051094891
"062801206","BUENOS AIRES",336,185,65,81,0,146,0.550595238095238
"062870415","BUENOS AIRES",279,227,26,25,0,51,0.813620071684588
"062940402","BUENOS AIRES",331,103,156,71,1,228,0.311178247734139
"062940602","BUENOS AIRES",146,0,53,92,0,145,0
"062940805","BUENOS AIRES",143,120,16,6,0,22,0.839160839160839
"062940809","BUENOS AIRES",56,13,14,29,0,43,0.232142857142857
"064279012","BUENOS AIRES",262,21,181,56,1,238,0.0801526717557252
"064279110","BUENOS AIRES",188,6,107,73,0,180,0.0319148936170213
"063010511","BUENOS AIRES",287,268,3,16,0,19,0.933797909407665
"063010811","BUENOS AIRES",280,225,35,19,0,54,0.803571428571429
"063010812","BUENOS AIRES",358,4,206,147,0,353,0.0111731843575419
"063010814","BUENOS AIRES",222,9,88,122,1,211,0.0405405405405405
"063150108","BUENOS AIRES",227,93,55,70,2,127,0.409691629955947
"063150109","BUENOS AIRES",368,332,12,11,1,24,0.902173913043478
"063220607","BUENOS AIRES",194,0,100,91,1,192,0
"063220616","BUENOS AIRES",188,2,68,112,2,182,0.0106382978723404
"063290101","BUENOS AIRES",15,0,5,10,0,15,0
"064340708","BUENOS AIRES",178,132,24,22,0,46,0.741573033707865
"063570401","BUENOS AIRES",231,226,4,1,0,5,0.978354978354978
"063290305","BUENOS AIRES",304,55,116,128,1,245,0.180921052631579
"063290312","BUENOS AIRES",332,206,83,43,0,126,0.620481927710843
"065390212","BUENOS AIRES",256,248,3,1,0,4,0.96875
"063290313","BUENOS AIRES",190,116,62,12,0,74,0.610526315789474
"063290316","BUENOS AIRES",264,2,141,119,1,261,0.00757575757575758
"063290401","BUENOS AIRES",32,1,17,14,0,31,0.03125
"064341812","BUENOS AIRES",199,197,2,0,0,2,0.989949748743719
"063430706","BUENOS AIRES",263,92,104,65,0,169,0.349809885931559
"063570810","BUENOS AIRES",370,359,8,2,0,10,0.97027027027027
"063430712","BUENOS AIRES",182,10,58,109,3,170,0.0549450549450549
"063510103","BUENOS AIRES",140,0,81,51,5,137,0
"063510401","BUENOS AIRES",205,0,58,145,2,205,0
"063510406","BUENOS AIRES",290,2,137,148,1,286,0.00689655172413793
"063570103","BUENOS AIRES",359,317,21,17,0,38,0.883008356545961
"063570106","BUENOS AIRES",247,240,6,1,0,7,0.97165991902834
"063570306","BUENOS AIRES",327,304,17,6,0,23,0.929663608562691
"064270205","BUENOS AIRES",226,224,0,2,0,2,0.991150442477876
"063570307","BUENOS AIRES",282,281,1,0,0,1,0.99645390070922
"063570403","BUENOS AIRES",161,159,1,0,0,1,0.987577639751553
"063570606","BUENOS AIRES",236,222,9,4,0,13,0.940677966101695
"063570607","BUENOS AIRES",333,332,1,0,0,1,0.996996996996997
"063570608","BUENOS AIRES",340,337,2,0,0,2,0.991176470588235
"063570805","BUENOS AIRES",320,310,1,9,0,10,0.96875
"063575206","BUENOS AIRES",243,222,7,12,0,19,0.91358024691358
"063570903","BUENOS AIRES",284,153,59,71,0,130,0.538732394366197
"063570904","BUENOS AIRES",349,316,17,11,0,28,0.905444126074499
"063570906","BUENOS AIRES",376,49,119,203,0,322,0.13031914893617
"063570908","BUENOS AIRES",319,6,158,150,0,308,0.0188087774294671
"063571013","BUENOS AIRES",217,179,31,4,0,35,0.824884792626728
"063571214","BUENOS AIRES",295,287,8,0,0,8,0.972881355932203
"063571309","BUENOS AIRES",185,185,0,0,0,0,1
"063571407","BUENOS AIRES",383,377,0,2,0,2,0.984334203655353
"063571705","BUENOS AIRES",379,300,30,44,0,74,0.79155672823219
"063571709","BUENOS AIRES",226,226,0,0,0,0,1
"063571905","BUENOS AIRES",162,162,0,0,0,0,1
"063571910","BUENOS AIRES",110,110,0,0,0,0,1
"063572303","BUENOS AIRES",110,110,0,0,0,0,1
"063572307","BUENOS AIRES",110,110,0,0,0,0,1
"063572501","BUENOS AIRES",249,249,0,0,0,0,1
"063572502","BUENOS AIRES",241,241,0,0,0,0,1
"063572503","BUENOS AIRES",138,138,0,0,0,0,1
"063573301","BUENOS AIRES",270,270,0,0,0,0,1
"063573306","BUENOS AIRES",226,226,0,0,0,0,1
"063574003","BUENOS AIRES",160,160,0,0,0,0,1
"063574106","BUENOS AIRES",62,62,0,0,0,0,1
"063574205","BUENOS AIRES",137,137,0,0,0,0,1
"063574301","BUENOS AIRES",80,80,0,0,0,0,1
"063574303","BUENOS AIRES",107,107,0,0,0,0,1
"063574304","BUENOS AIRES",166,166,0,0,0,0,1
"063574305","BUENOS AIRES",55,55,0,0,0,0,1
"063574310","BUENOS AIRES",96,96,0,0,0,0,1
"063574312","BUENOS AIRES",92,92,0,0,0,0,1
"063574508","BUENOS AIRES",269,268,1,0,0,1,0.996282527881041
"063574512","BUENOS AIRES",134,134,0,0,0,0,1
"063575315","BUENOS AIRES",298,255,14,20,1,35,0.855704697986577
"063575610","BUENOS AIRES",160,160,0,0,0,0,1
"063574516","BUENOS AIRES",268,267,1,0,0,1,0.996268656716418
"063574612","BUENOS AIRES",249,247,2,0,0,2,0.991967871485944
"063574701","BUENOS AIRES",317,317,0,0,0,0,1
"063574710","BUENOS AIRES",327,326,1,0,0,1,0.996941896024465
"063574802","BUENOS AIRES",325,323,2,0,0,2,0.993846153846154
"063574803","BUENOS AIRES",297,295,2,0,0,2,0.993265993265993
"063574806","BUENOS AIRES",166,160,3,3,0,6,0.963855421686747
"063574809","BUENOS AIRES",172,172,0,0,0,0,1
"063575007","BUENOS AIRES",367,315,17,32,1,50,0.858310626702997
"063575105","BUENOS AIRES",335,318,5,9,0,14,0.949253731343284
"063575203","BUENOS AIRES",379,349,6,23,0,29,0.920844327176781
"063575214","BUENOS AIRES",381,128,47,201,0,248,0.335958005249344
"063575215","BUENOS AIRES",443,17,223,185,1,409,0.0383747178329571
"063575216","BUENOS AIRES",447,10,217,206,1,424,0.0223713646532438
"063575304","BUENOS AIRES",298,287,5,1,0,6,0.963087248322148
"063575306","BUENOS AIRES",259,211,17,28,0,45,0.814671814671815
"063575808","BUENOS AIRES",437,426,5,2,0,7,0.974828375286041
"063575907","BUENOS AIRES",311,186,24,69,7,100,0.598070739549839
"063576005","BUENOS AIRES",280,274,3,3,0,6,0.978571428571429
"063576104","BUENOS AIRES",223,221,0,2,0,2,0.991031390134529
"063576406","BUENOS AIRES",143,132,10,1,0,11,0.923076923076923
"063576508","BUENOS AIRES",323,317,3,3,0,6,0.981424148606811
"063576606","BUENOS AIRES",253,252,0,1,0,1,0.99604743083004
"063576608","BUENOS AIRES",213,206,4,2,0,6,0.967136150234742
"063576706","BUENOS AIRES",241,232,7,1,0,8,0.962655601659751
"063576715","BUENOS AIRES",365,334,5,17,0,22,0.915068493150685
"063576801","BUENOS AIRES",437,424,3,3,2,8,0.97025171624714
"063576907","BUENOS AIRES",372,337,19,14,1,34,0.905913978494624
"063577001","BUENOS AIRES",261,166,16,72,2,90,0.636015325670498
"063577005","BUENOS AIRES",204,200,4,0,0,4,0.980392156862745
"063577111","BUENOS AIRES",391,261,38,86,0,124,0.667519181585678
"063577206","BUENOS AIRES",293,264,8,17,0,25,0.901023890784983
"063577702","BUENOS AIRES",187,4,114,64,2,180,0.0213903743315508
"063577308","BUENOS AIRES",145,0,43,93,3,139,0
"063577310","BUENOS AIRES",3,0,2,1,0,3,0
"063577312","BUENOS AIRES",74,0,46,28,0,74,0
"063577415","BUENOS AIRES",175,1,117,57,0,174,0.00571428571428571
"063577501","BUENOS AIRES",149,65,62,22,0,84,0.436241610738255
"063577603","BUENOS AIRES",56,0,47,9,0,56,0
"063577606","BUENOS AIRES",45,0,40,5,0,45,0
"063710105","BUENOS AIRES",189,4,38,122,22,182,0.0211640211640212
"063577607","BUENOS AIRES",94,1,72,21,0,93,0.0106382978723404
"063577608","BUENOS AIRES",131,3,113,14,1,128,0.0229007633587786
"063577614","BUENOS AIRES",49,0,41,8,0,49,0
"063710710","BUENOS AIRES",222,206,15,1,0,16,0.927927927927928
"063577703","BUENOS AIRES",62,1,47,11,0,58,0.0161290322580645
"063577710","BUENOS AIRES",76,0,48,21,0,69,0
"063577908","BUENOS AIRES",311,11,96,196,1,293,0.0353697749196141
"063577913","BUENOS AIRES",369,254,54,54,1,109,0.688346883468835
"063710504","BUENOS AIRES",245,234,5,6,0,11,0.955102040816327
"063578111","BUENOS AIRES",171,0,145,26,0,171,0
"063640109","BUENOS AIRES",245,0,104,131,3,238,0
"063710108","BUENOS AIRES",111,14,19,36,33,88,0.126126126126126
"063640110","BUENOS AIRES",252,0,122,127,1,250,0
"063640112","BUENOS AIRES",187,1,138,45,1,184,0.0053475935828877
"063710806","BUENOS AIRES",406,368,14,20,0,34,0.9064039408867
"063710906","BUENOS AIRES",504,495,3,4,0,7,0.982142857142857
"063710908","BUENOS AIRES",371,367,3,0,0,3,0.98921832884097
"063640210","BUENOS AIRES",283,112,123,43,3,169,0.395759717314488
"063640313","BUENOS AIRES",106,106,0,0,0,0,1
"063640314","BUENOS AIRES",0,0,0,0,0,0,NA
"064551413","BUENOS AIRES",321,293,12,16,0,28,0.912772585669782
"064620402","BUENOS AIRES",276,163,53,58,0,111,0.590579710144927
"064620601","BUENOS AIRES",104,1,42,56,0,98,0.00961538461538462
"064621201","BUENOS AIRES",112,23,36,52,1,89,0.205357142857143
"063640704","BUENOS AIRES",332,150,70,109,1,180,0.451807228915663
"063640705","BUENOS AIRES",270,265,4,1,0,5,0.981481481481482
"063640809","BUENOS AIRES",263,0,163,82,4,249,0
"063640818","BUENOS AIRES",262,0,149,106,0,255,0
"063710211","BUENOS AIRES",261,1,139,119,0,258,0.00383141762452107
"063710305","BUENOS AIRES",361,189,60,112,0,172,0.523545706371191
"063710312","BUENOS AIRES",115,28,58,29,0,87,0.243478260869565
"063710607","BUENOS AIRES",303,293,2,5,1,8,0.966996699669967
"063711002","BUENOS AIRES",382,367,2,3,0,5,0.960732984293194
"063711005","BUENOS AIRES",228,220,5,3,0,8,0.964912280701754
"063711011","BUENOS AIRES",293,293,0,0,0,0,1
"063711012","BUENOS AIRES",108,47,21,38,1,60,0.435185185185185
"063711016","BUENOS AIRES",193,191,1,0,0,1,0.989637305699482
"063711204","BUENOS AIRES",378,370,3,5,0,8,0.978835978835979
"063711302","BUENOS AIRES",319,296,17,5,0,22,0.927899686520376
"063711411","BUENOS AIRES",278,12,185,79,0,264,0.0431654676258993
"063711502","BUENOS AIRES",236,17,62,131,1,194,0.0720338983050847
"063711606","BUENOS AIRES",190,4,113,57,5,175,0.0210526315789474
"063711607","BUENOS AIRES",250,6,179,65,0,244,0.024
"063711610","BUENOS AIRES",261,9,198,48,2,248,0.0344827586206897
"063711611","BUENOS AIRES",285,6,109,169,0,278,0.0210526315789474
"063711712","BUENOS AIRES",258,21,114,122,0,236,0.0813953488372093
"063711714","BUENOS AIRES",343,24,233,82,1,316,0.0699708454810496
"063711808","BUENOS AIRES",275,6,175,94,0,269,0.0218181818181818
"063711814","BUENOS AIRES",460,4,325,129,0,454,0.00869565217391304
"063712003","BUENOS AIRES",302,6,129,156,1,286,0.0198675496688742
"063712107","BUENOS AIRES",274,269,0,5,0,5,0.981751824817518
"063712108","BUENOS AIRES",375,367,2,6,0,8,0.978666666666667
"063712109","BUENOS AIRES",336,332,3,1,0,4,0.988095238095238
"063712205","BUENOS AIRES",211,211,0,0,0,0,1
"063712208","BUENOS AIRES",230,227,1,2,0,3,0.98695652173913
"063712211","BUENOS AIRES",134,134,0,0,0,0,1
"063712212","BUENOS AIRES",208,206,2,0,0,2,0.990384615384615
"063712405","BUENOS AIRES",205,162,12,19,0,31,0.790243902439024
"063712507","BUENOS AIRES",327,321,5,1,0,6,0.981651376146789
"063712606","BUENOS AIRES",321,314,4,2,0,6,0.978193146417445
"063712608","BUENOS AIRES",248,242,2,1,0,3,0.975806451612903
"063712902","BUENOS AIRES",205,199,0,0,0,0,0.970731707317073
"063713005","BUENOS AIRES",297,5,175,117,0,292,0.0168350168350168
"063713006","BUENOS AIRES",297,8,171,115,0,286,0.0269360269360269
"063713101","BUENOS AIRES",331,20,193,113,2,308,0.0604229607250755
"063713105","BUENOS AIRES",301,30,142,127,1,270,0.0996677740863787
"063713206","BUENOS AIRES",403,5,146,249,0,395,0.0124069478908189
"063713306","BUENOS AIRES",415,12,291,112,0,403,0.0289156626506024
"063713505","BUENOS AIRES",244,3,177,63,0,240,0.0122950819672131
"064343605","BUENOS AIRES",288,254,21,13,0,34,0.881944444444444
"063850708","BUENOS AIRES",309,299,6,4,0,10,0.967637540453074
"063850709","BUENOS AIRES",270,35,111,116,2,229,0.12962962962963
"063850712","BUENOS AIRES",47,0,13,33,0,46,0
"063851001","BUENOS AIRES",316,313,0,0,0,0,0.990506329113924
"063920103","BUENOS AIRES",220,212,4,4,0,8,0.963636363636364
"063920301","BUENOS AIRES",256,1,109,143,2,254,0.00390625
"064902106","BUENOS AIRES",310,310,0,0,0,0,1
"063920702","BUENOS AIRES",204,0,114,86,1,201,0
"064902203","BUENOS AIRES",256,251,1,0,0,1,0.98046875
"064271503","BUENOS AIRES",269,265,2,2,0,4,0.985130111524164
"063921401","BUENOS AIRES",18,0,3,13,0,16,0
"063921501","BUENOS AIRES",223,2,136,80,1,217,0.00896860986547085
"063990502","BUENOS AIRES",156,0,52,98,3,153,0
"064903406","BUENOS AIRES",297,26,90,168,0,258,0.0875420875420875
"064903608","BUENOS AIRES",305,37,99,125,10,234,0.121311475409836
"064060206","BUENOS AIRES",329,228,67,33,0,100,0.693009118541033
"064080103","BUENOS AIRES",351,60,250,41,0,291,0.170940170940171
"064411810","BUENOS AIRES",256,253,3,0,0,3,0.98828125
"064080201","BUENOS AIRES",318,3,225,82,0,307,0.00943396226415094
"064903914","BUENOS AIRES",397,8,78,299,1,378,0.0201511335012594
"064080202","BUENOS AIRES",373,53,227,83,0,310,0.142091152815013
"064080203","BUENOS AIRES",389,35,295,55,1,351,0.089974293059126
"064080409","BUENOS AIRES",417,0,296,109,3,408,0
"064273101","BUENOS AIRES",295,293,2,0,0,2,0.993220338983051
"064080501","BUENOS AIRES",262,1,137,115,0,252,0.00381679389312977
"064080510","BUENOS AIRES",253,5,184,41,0,225,0.0197628458498024
"064080512","BUENOS AIRES",241,0,164,75,0,239,0
"064080802","BUENOS AIRES",324,6,188,119,3,310,0.0185185185185185
"064080803","BUENOS AIRES",206,4,149,52,0,201,0.0194174757281553
"064080813","BUENOS AIRES",255,6,137,96,9,242,0.0235294117647059
"064081004","BUENOS AIRES",368,0,324,42,0,366,0
"064081006","BUENOS AIRES",309,0,231,76,0,307,0
"064081110","BUENOS AIRES",184,2,126,51,0,177,0.0108695652173913
"064081304","BUENOS AIRES",289,10,188,89,0,277,0.0346020761245675
"064081308","BUENOS AIRES",314,2,226,69,0,295,0.00636942675159236
"064081309","BUENOS AIRES",279,3,149,114,0,263,0.010752688172043
"064100309","BUENOS AIRES",465,0,330,91,0,421,0
"064081501","BUENOS AIRES",405,71,281,52,0,333,0.175308641975309
"064081506","BUENOS AIRES",106,102,3,1,0,4,0.962264150943396
"064411811","BUENOS AIRES",392,381,5,5,0,10,0.971938775510204
"064100202","BUENOS AIRES",297,4,261,31,0,292,0.0134680134680135
"064100204","BUENOS AIRES",61,0,52,9,0,61,0
"064100206","BUENOS AIRES",88,1,74,10,0,84,0.0113636363636364
"064100308","BUENOS AIRES",287,0,228,52,0,280,0
"064100411","BUENOS AIRES",233,0,200,28,1,229,0
"064100412","BUENOS AIRES",369,2,291,72,0,363,0.00542005420054201
"064100503","BUENOS AIRES",412,0,308,102,1,411,0
"064100511","BUENOS AIRES",282,1,180,93,0,273,0.00354609929078014
"064100515","BUENOS AIRES",487,9,195,256,3,454,0.0184804928131417
"064100607","BUENOS AIRES",327,0,153,174,0,327,0
"064100801","BUENOS AIRES",227,0,205,22,0,227,0
"064271416","BUENOS AIRES",401,365,24,11,0,35,0.910224438902743
"064100803","BUENOS AIRES",402,2,334,63,1,398,0.00497512437810945
"064120404","BUENOS AIRES",478,0,368,104,0,472,0
"064273209","BUENOS AIRES",216,212,4,0,0,4,0.981481481481482
"064100903","BUENOS AIRES",440,337,85,18,0,103,0.765909090909091
"065050310","BUENOS AIRES",163,84,31,45,1,77,0.515337423312883
"064100909","BUENOS AIRES",284,5,207,72,0,279,0.0176056338028169
"064101104","BUENOS AIRES",291,102,184,5,0,189,0.350515463917526
"064101106","BUENOS AIRES",209,151,39,19,0,58,0.722488038277512
"064101202","BUENOS AIRES",360,230,116,13,0,129,0.638888888888889
"064101209","BUENOS AIRES",224,0,204,20,0,224,0
"064101303","BUENOS AIRES",232,0,213,19,0,232,0
"064101306","BUENOS AIRES",456,2,402,48,0,450,0.0043859649122807
"064120203","BUENOS AIRES",344,1,208,134,0,342,0.00290697674418605
"064120310","BUENOS AIRES",334,235,83,16,0,99,0.703592814371258
"065152005","BUENOS AIRES",304,0,191,68,2,261,0
"064120505","BUENOS AIRES",215,1,186,26,1,213,0.00465116279069767
"064120101","BUENOS AIRES",212,3,173,34,0,207,0.0141509433962264
"064120108","BUENOS AIRES",134,0,76,54,0,130,0
"065150105","BUENOS AIRES",477,3,258,199,2,459,0.00628930817610063
"064120112","BUENOS AIRES",317,204,46,65,0,111,0.643533123028391
"064120113","BUENOS AIRES",300,19,129,138,4,271,0.0633333333333333
"064120202","BUENOS AIRES",335,0,207,123,0,330,0
"064120609","BUENOS AIRES",273,2,207,58,0,265,0.00732600732600733
"064120610","BUENOS AIRES",269,0,218,49,0,267,0
"064120703","BUENOS AIRES",412,1,229,168,1,398,0.00242718446601942
"064120704","BUENOS AIRES",294,5,222,60,1,283,0.0170068027210884
"064120706","BUENOS AIRES",243,0,137,99,0,236,0
"064120814","BUENOS AIRES",311,1,145,152,0,297,0.00321543408360129
"064120916","BUENOS AIRES",203,0,76,122,2,200,0
"064121001","BUENOS AIRES",401,1,163,218,0,381,0.00249376558603491
"064121019","BUENOS AIRES",412,396,13,0,0,13,0.961165048543689
"064121111","BUENOS AIRES",279,1,176,91,0,267,0.003584229390681
"064121204","BUENOS AIRES",458,5,284,152,1,437,0.0109170305676856
"064121206","BUENOS AIRES",341,2,173,158,1,332,0.00586510263929619
"065180601","BUENOS AIRES",53,3,29,21,0,50,0.0566037735849057
"064121208","BUENOS AIRES",391,18,189,169,1,359,0.0460358056265985
"064121309","BUENOS AIRES",295,1,204,87,0,291,0.00338983050847458
"064121310","BUENOS AIRES",237,0,161,64,1,226,0
"064121312","BUENOS AIRES",424,6,159,235,2,396,0.0141509433962264
"064121405","BUENOS AIRES",331,1,243,83,0,326,0.00302114803625378
"064121413","BUENOS AIRES",299,4,194,93,0,287,0.0133779264214047
"064121502","BUENOS AIRES",466,0,421,45,0,466,0
"064130204","BUENOS AIRES",273,182,24,59,1,84,0.666666666666667
"064130208","BUENOS AIRES",316,310,2,2,0,4,0.981012658227848
"064130210","BUENOS AIRES",322,322,0,0,0,0,1
"064130407","BUENOS AIRES",256,253,0,3,0,3,0.98828125
"064202009","BUENOS AIRES",53,51,0,0,0,0,0.962264150943396
"064130609","BUENOS AIRES",332,293,17,18,0,35,0.882530120481928
"064132209","BUENOS AIRES",128,97,20,11,0,31,0.7578125
"064200203","BUENOS AIRES",36,36,0,0,0,0,1
"064200207","BUENOS AIRES",55,55,0,0,0,0,1
"064200215","BUENOS AIRES",132,130,2,0,0,2,0.984848484848485
"064200305","BUENOS AIRES",103,70,24,9,0,33,0.679611650485437
"065250108","BUENOS AIRES",332,289,23,19,0,42,0.870481927710843
"064200418","BUENOS AIRES",42,37,3,2,0,5,0.880952380952381
"064200419","BUENOS AIRES",78,8,60,10,0,70,0.102564102564103
"064200508","BUENOS AIRES",212,90,86,36,0,122,0.424528301886792
"064200602","BUENOS AIRES",19,18,0,1,0,1,0.947368421052632
"064200704","BUENOS AIRES",40,35,5,0,0,5,0.875
"064200706","BUENOS AIRES",88,84,3,1,0,4,0.954545454545455
"064200803","BUENOS AIRES",125,56,49,18,0,67,0.448
"064200805","BUENOS AIRES",150,86,38,25,1,64,0.573333333333333
"064271502","BUENOS AIRES",253,242,7,0,0,7,0.956521739130435
"064200903","BUENOS AIRES",200,19,116,61,3,180,0.095
"064200912","BUENOS AIRES",23,21,2,0,0,2,0.91304347826087
"064201007","BUENOS AIRES",130,19,70,37,3,110,0.146153846153846
"064201008","BUENOS AIRES",51,37,9,4,0,13,0.725490196078431
"064201115","BUENOS AIRES",71,60,9,2,0,11,0.845070422535211
"064201013","BUENOS AIRES",110,53,32,12,0,44,0.481818181818182
"065321401","BUENOS AIRES",277,276,0,1,0,1,0.996389891696751
"064201207","BUENOS AIRES",45,2,36,7,0,43,0.0444444444444444
"064201403","BUENOS AIRES",108,57,33,16,1,50,0.527777777777778
"064201303","BUENOS AIRES",44,35,5,4,0,9,0.795454545454545
"064201306","BUENOS AIRES",59,51,4,4,0,8,0.864406779661017
"064201402","BUENOS AIRES",36,35,1,0,0,1,0.972222222222222
"064201406","BUENOS AIRES",25,25,0,0,0,0,1
"064201504","BUENOS AIRES",17,16,1,0,0,1,0.941176470588235
"064201701","BUENOS AIRES",76,56,13,6,0,19,0.736842105263158
"064202002","BUENOS AIRES",130,125,5,0,0,5,0.961538461538462
"064202003","BUENOS AIRES",93,88,4,0,0,4,0.946236559139785
"064202109","BUENOS AIRES",383,238,80,62,1,143,0.621409921671018
"064202208","BUENOS AIRES",69,7,48,14,0,62,0.101449275362319
"064270202","BUENOS AIRES",194,194,0,0,0,0,1
"064270210","BUENOS AIRES",282,266,3,10,0,13,0.943262411347518
"064270212","BUENOS AIRES",195,195,0,0,0,0,1
"064270214","BUENOS AIRES",184,177,1,1,0,2,0.96195652173913
"064270306","BUENOS AIRES",344,340,2,1,0,3,0.988372093023256
"064270402","BUENOS AIRES",388,386,0,2,0,2,0.994845360824742
"064270510","BUENOS AIRES",310,298,7,2,0,9,0.961290322580645
"064270608","BUENOS AIRES",208,202,6,0,0,6,0.971153846153846
"064270803","BUENOS AIRES",364,363,0,1,0,1,0.997252747252747
"064270804","BUENOS AIRES",442,432,6,3,0,9,0.97737556561086
"064270903","BUENOS AIRES",550,404,19,124,1,144,0.734545454545455
"064271006","BUENOS AIRES",354,344,0,10,0,10,0.971751412429379
"064271011","BUENOS AIRES",199,193,1,4,0,5,0.969849246231156
"064271101","BUENOS AIRES",439,421,12,5,0,17,0.958997722095672
"064271105","BUENOS AIRES",346,334,9,3,0,12,0.965317919075145
"064271210","BUENOS AIRES",235,230,3,2,0,5,0.978723404255319
"064271410","BUENOS AIRES",818,443,71,225,48,344,0.541564792176039
"064271506","BUENOS AIRES",298,291,4,0,0,4,0.976510067114094
"064271604","BUENOS AIRES",336,309,8,10,1,19,0.919642857142857
"064271705","BUENOS AIRES",259,228,10,15,0,25,0.88030888030888
"064271612","BUENOS AIRES",388,374,10,4,0,14,0.963917525773196
"064271701","BUENOS AIRES",382,363,3,15,0,18,0.950261780104712
"064271703","BUENOS AIRES",423,353,37,33,0,70,0.83451536643026
"064271706","BUENOS AIRES",214,122,22,68,1,91,0.570093457943925
"064271711","BUENOS AIRES",1016,308,197,486,5,688,0.303149606299213
"064271803","BUENOS AIRES",272,32,65,164,5,234,0.117647058823529
"064271806","BUENOS AIRES",43,7,15,17,2,34,0.162790697674419
"064271807","BUENOS AIRES",562,45,165,323,4,492,0.0800711743772242
"020130506","CABA",437,436,1,0,0,1,0.997711670480549
"064270218","BUENOS AIRES",310,309,1,0,0,1,0.996774193548387
"064271809","BUENOS AIRES",692,79,314,259,11,584,0.114161849710983
"064271902","BUENOS AIRES",212,209,3,0,0,3,0.985849056603774
"064271907","BUENOS AIRES",378,370,3,4,0,7,0.978835978835979
"064271910","BUENOS AIRES",335,320,6,6,0,12,0.955223880597015
"064272002","BUENOS AIRES",251,178,34,37,0,71,0.709163346613546
"064276304","BUENOS AIRES",291,28,127,130,2,259,0.0962199312714777
"064272012","BUENOS AIRES",114,111,3,0,0,3,0.973684210526316
"064272304","BUENOS AIRES",558,525,8,21,0,29,0.940860215053763
"064272305","BUENOS AIRES",416,389,21,5,0,26,0.935096153846154
"064272401","BUENOS AIRES",408,391,11,5,0,16,0.958333333333333
"064272402","BUENOS AIRES",188,126,30,32,0,62,0.670212765957447
"064272406","BUENOS AIRES",362,354,6,2,0,8,0.977900552486188
"064272511","BUENOS AIRES",773,356,276,118,3,397,0.460543337645537
"064272515","BUENOS AIRES",313,211,23,66,0,89,0.674121405750799
"064272705","BUENOS AIRES",274,260,6,8,0,14,0.948905109489051
"064272904","BUENOS AIRES",244,235,2,6,0,8,0.963114754098361
"064273008","BUENOS AIRES",189,179,7,3,0,10,0.947089947089947
"064273403","BUENOS AIRES",505,505,0,0,0,0,1
"064273412","BUENOS AIRES",481,468,10,3,0,13,0.972972972972973
"065392923","BUENOS AIRES",315,0,250,50,0,300,0
"064273503","BUENOS AIRES",214,211,1,0,0,1,0.985981308411215
"064273509","BUENOS AIRES",477,469,5,2,0,7,0.983228511530398
"064273907","BUENOS AIRES",300,275,9,14,0,23,0.916666666666667
"064274011","BUENOS AIRES",461,320,53,68,1,122,0.6941431670282
"064274103","BUENOS AIRES",604,519,35,45,0,80,0.859271523178808
"064274109","BUENOS AIRES",604,163,144,272,7,423,0.269867549668874
"064274206","BUENOS AIRES",320,298,12,9,0,21,0.93125
"064274209","BUENOS AIRES",518,459,10,1,0,11,0.886100386100386
"064274403","BUENOS AIRES",464,403,25,31,0,56,0.868534482758621
"064274407","BUENOS AIRES",200,175,2,10,0,12,0.875
"064274411","BUENOS AIRES",212,199,5,7,0,12,0.938679245283019
"064275505","BUENOS AIRES",451,382,24,25,1,50,0.847006651884701
"064274510","BUENOS AIRES",330,234,47,43,3,93,0.709090909090909
"064274605","BUENOS AIRES",559,202,191,154,0,345,0.361359570661896
"064274706","BUENOS AIRES",167,87,53,20,0,73,0.520958083832335
"064275605","BUENOS AIRES",268,256,5,4,0,9,0.955223880597015
"064274901","BUENOS AIRES",548,507,6,31,0,37,0.925182481751825
"064274910","BUENOS AIRES",379,230,61,74,0,135,0.606860158311346
"064274911","BUENOS AIRES",223,205,2,1,0,3,0.919282511210762
"064275003","BUENOS AIRES",385,372,10,3,0,13,0.966233766233766
"064275010","BUENOS AIRES",345,303,31,10,1,42,0.878260869565217
"065600102","BUENOS AIRES",381,2,198,167,1,366,0.005249343832021
"064275303","BUENOS AIRES",228,196,3,20,6,29,0.859649122807018
"064275307","BUENOS AIRES",434,380,27,24,1,52,0.875576036866359
"065600302","BUENOS AIRES",501,2,265,218,0,483,0.00399201596806387
"064275410","BUENOS AIRES",945,411,290,205,5,500,0.434920634920635
"064275512","BUENOS AIRES",501,445,33,16,0,49,0.888223552894212
"064270301","BUENOS AIRES",253,253,0,0,0,0,1
"064275610","BUENOS AIRES",427,409,11,4,0,15,0.957845433255269
"064275613","BUENOS AIRES",292,10,190,91,0,281,0.0342465753424658
"064275708","BUENOS AIRES",276,24,154,84,0,238,0.0869565217391304
"064275715","BUENOS AIRES",207,3,134,61,0,195,0.0144927536231884
"064275804","BUENOS AIRES",382,16,169,189,1,359,0.0418848167539267
"064275809","BUENOS AIRES",151,0,126,0,0,126,0
"064275812","BUENOS AIRES",281,2,162,109,0,271,0.00711743772241993
"064275814","BUENOS AIRES",259,4,179,74,0,253,0.0154440154440154
"064275906","BUENOS AIRES",236,3,177,50,0,227,0.0127118644067797
"064275909","BUENOS AIRES",274,0,203,65,0,268,0
"064276112","BUENOS AIRES",305,7,171,124,0,295,0.0229508196721311
"064276103","BUENOS AIRES",470,346,73,20,0,93,0.736170212765957
"064276104","BUENOS AIRES",549,464,57,18,0,75,0.845173041894353
"064276201","BUENOS AIRES",311,201,78,29,0,107,0.646302250803859
"064276205","BUENOS AIRES",650,439,143,43,0,186,0.675384615384615
"064276208","BUENOS AIRES",258,139,98,18,0,116,0.538759689922481
"064276212","BUENOS AIRES",340,21,227,86,1,314,0.0617647058823529
"064276311","BUENOS AIRES",511,60,215,206,9,430,0.117416829745597
"064276404","BUENOS AIRES",285,6,136,131,1,268,0.0210526315789474
"064276405","BUENOS AIRES",329,26,155,140,0,295,0.0790273556231003
"064276408","BUENOS AIRES",298,12,165,115,0,280,0.0402684563758389
"064276502","BUENOS AIRES",493,35,217,223,0,440,0.0709939148073022
"064276505","BUENOS AIRES",234,15,91,122,1,214,0.0641025641025641
"064276507","BUENOS AIRES",478,25,229,206,0,435,0.0523012552301255
"064276607","BUENOS AIRES",305,19,217,59,1,277,0.0622950819672131
"064276804","BUENOS AIRES",267,4,203,50,0,253,0.0149812734082397
"064276809","BUENOS AIRES",321,10,239,67,0,306,0.0311526479750779
"064277002","BUENOS AIRES",341,16,275,43,0,318,0.0469208211143695
"064277003","BUENOS AIRES",325,41,192,86,0,278,0.126153846153846
"064277009","BUENOS AIRES",298,4,154,120,2,276,0.0134228187919463
"064277105","BUENOS AIRES",236,5,160,67,0,227,0.0211864406779661
"064277109","BUENOS AIRES",260,12,169,75,0,244,0.0461538461538462
"064277201","BUENOS AIRES",572,119,261,187,1,449,0.208041958041958
"064277207","BUENOS AIRES",298,5,208,77,0,285,0.0167785234899329
"064277304","BUENOS AIRES",297,10,165,111,1,277,0.0336700336700337
"064277307","BUENOS AIRES",579,72,286,193,6,485,0.124352331606218
"064277310","BUENOS AIRES",476,24,207,235,0,442,0.0504201680672269
"064277314","BUENOS AIRES",287,1,165,100,3,268,0.00348432055749129
"064277402","BUENOS AIRES",539,9,330,182,1,513,0.0166975881261596
"064277411","BUENOS AIRES",631,53,300,243,2,545,0.0839936608557845
"064277416","BUENOS AIRES",280,3,131,129,0,260,0.0107142857142857
"064277606","BUENOS AIRES",466,22,303,137,0,440,0.0472103004291846
"064277607","BUENOS AIRES",573,29,343,191,2,536,0.0506108202443281
"064277608","BUENOS AIRES",511,131,277,91,0,368,0.256360078277886
"064277702","BUENOS AIRES",440,36,325,74,0,399,0.0818181818181818
"065601714","BUENOS AIRES",194,2,72,101,5,178,0.0103092783505155
"064277713","BUENOS AIRES",339,3,241,83,0,324,0.00884955752212389
"064277716","BUENOS AIRES",293,0,221,69,0,290,0
"064278007","BUENOS AIRES",350,11,203,119,0,322,0.0314285714285714
"064278012","BUENOS AIRES",251,18,27,193,6,226,0.0717131474103586
"064278015","BUENOS AIRES",230,0,99,120,1,220,0
"064278102","BUENOS AIRES",347,2,252,79,5,336,0.00576368876080692
"064278201","BUENOS AIRES",461,5,269,178,0,447,0.0108459869848156
"064278208","BUENOS AIRES",420,3,210,166,0,376,0.00714285714285714
"064278211","BUENOS AIRES",318,20,203,85,0,288,0.0628930817610063
"064278303","BUENOS AIRES",413,6,210,172,4,386,0.0145278450363196
"064278402","BUENOS AIRES",260,130,21,84,5,110,0.5
"064278403","BUENOS AIRES",342,6,174,150,2,326,0.0175438596491228
"064278410","BUENOS AIRES",337,7,115,183,6,304,0.0207715133531157
"064278504","BUENOS AIRES",300,6,211,61,0,272,0.02
"064278508","BUENOS AIRES",247,1,213,32,0,245,0.00404858299595142
"064278509","BUENOS AIRES",512,3,398,92,3,493,0.005859375
"065602206","BUENOS AIRES",257,223,19,10,0,29,0.867704280155642
"065950402","BUENOS AIRES",400,397,3,0,0,3,0.9925
"064278602","BUENOS AIRES",318,1,264,36,3,303,0.00314465408805031
"064278608","BUENOS AIRES",275,2,224,43,0,267,0.00727272727272727
"064278609","BUENOS AIRES",317,4,212,93,0,305,0.0126182965299685
"064278702","BUENOS AIRES",325,18,252,43,0,295,0.0553846153846154
"064278710","BUENOS AIRES",353,0,273,75,0,348,0
"064278807","BUENOS AIRES",340,3,249,62,1,312,0.00882352941176471
"064279008","BUENOS AIRES",373,12,213,130,2,345,0.032171581769437
"064278908","BUENOS AIRES",535,14,255,245,6,506,0.0261682242990654
"064279107","BUENOS AIRES",342,2,255,73,0,328,0.00584795321637427
"064279111","BUENOS AIRES",261,9,136,114,0,250,0.0344827586206897
"064340303","BUENOS AIRES",522,450,35,37,0,72,0.862068965517241
"064340307","BUENOS AIRES",341,237,57,45,0,102,0.695014662756598
"064411701","BUENOS AIRES",192,190,2,0,0,2,0.989583333333333
"064279602","BUENOS AIRES",389,3,116,248,4,368,0.0077120822622108
"064340811","BUENOS AIRES",309,19,66,212,0,278,0.0614886731391586
"064340910","BUENOS AIRES",294,15,109,164,0,273,0.0510204081632653
"064279113","BUENOS AIRES",164,6,83,59,0,142,0.0365853658536585
"064279204","BUENOS AIRES",447,4,207,219,3,429,0.00894854586129754
"064279303","BUENOS AIRES",334,1,126,176,11,313,0.0029940119760479
"065151804","BUENOS AIRES",378,0,124,194,3,321,0
"064341906","BUENOS AIRES",325,158,101,64,0,165,0.486153846153846
"064279401","BUENOS AIRES",477,12,264,178,3,445,0.0251572327044025
"064279402","BUENOS AIRES",444,5,295,130,2,427,0.0112612612612613
"064279405","BUENOS AIRES",515,4,294,197,3,494,0.00776699029126214
"064340710","BUENOS AIRES",216,166,28,21,0,49,0.768518518518518
"064279605","BUENOS AIRES",462,3,264,174,1,439,0.00649350649350649
"065681704","BUENOS AIRES",234,2,193,39,0,232,0.00854700854700855
"064340301","BUENOS AIRES",340,267,50,22,0,72,0.785294117647059
"064279702","BUENOS AIRES",934,162,465,256,4,725,0.173447537473233
"064279707","BUENOS AIRES",412,19,240,134,0,374,0.0461165048543689
"065151809","BUENOS AIRES",235,8,164,55,1,220,0.0340425531914894
"064340205","BUENOS AIRES",293,274,11,8,0,19,0.935153583617747
"064340207","BUENOS AIRES",60,59,1,0,0,1,0.983333333333333
"064344503","BUENOS AIRES",295,28,86,171,2,259,0.0949152542372881
"064340402","BUENOS AIRES",286,223,41,20,0,61,0.77972027972028
"064340508","BUENOS AIRES",310,244,21,20,0,41,0.787096774193548
"064340604","BUENOS AIRES",341,264,44,33,0,77,0.774193548387097
"064340701","BUENOS AIRES",236,193,8,17,3,28,0.817796610169492
"064340705","BUENOS AIRES",284,223,13,40,1,54,0.785211267605634
"064341005","BUENOS AIRES",239,14,105,118,0,223,0.0585774058577406
"064341107","BUENOS AIRES",198,21,76,95,0,171,0.106060606060606
"065740407","BUENOS AIRES",291,258,17,14,0,31,0.88659793814433
"064341201","BUENOS AIRES",345,17,73,253,1,327,0.0492753623188406
"064341204","BUENOS AIRES",355,14,126,215,0,341,0.0394366197183099
"064341310","BUENOS AIRES",334,26,123,182,0,305,0.0778443113772455
"064341312","BUENOS AIRES",319,10,119,187,0,306,0.0313479623824451
"065740701","BUENOS AIRES",169,0,26,142,1,169,0
"064341406","BUENOS AIRES",322,18,115,189,0,304,0.0559006211180124
"064341502","BUENOS AIRES",298,293,2,2,0,4,0.983221476510067
"064341508","BUENOS AIRES",249,249,0,0,0,0,1
"064341513","BUENOS AIRES",338,269,50,19,0,69,0.79585798816568
"064341605","BUENOS AIRES",196,195,1,0,0,1,0.994897959183674
"064341701","BUENOS AIRES",268,235,19,14,0,33,0.876865671641791
"064341706","BUENOS AIRES",198,166,20,12,0,32,0.838383838383838
"064341904","BUENOS AIRES",313,100,95,118,0,213,0.319488817891374
"064342101","BUENOS AIRES",344,36,174,133,0,307,0.104651162790698
"064342103","BUENOS AIRES",269,30,120,119,0,239,0.111524163568773
"064342109","BUENOS AIRES",213,12,95,102,0,197,0.0563380281690141
"064342307","BUENOS AIRES",191,28,62,89,8,159,0.146596858638743
"064342404","BUENOS AIRES",231,24,92,114,0,206,0.103896103896104
"064342506","BUENOS AIRES",247,24,110,78,0,188,0.097165991902834
"064342508","BUENOS AIRES",329,17,165,141,1,307,0.0516717325227964
"064342514","BUENOS AIRES",249,168,66,15,0,81,0.674698795180723
"064342515","BUENOS AIRES",214,167,12,34,0,46,0.780373831775701
"064342605","BUENOS AIRES",119,5,31,73,0,104,0.0420168067226891
"064342609","BUENOS AIRES",220,4,58,147,2,207,0.0181818181818182
"064342613","BUENOS AIRES",361,59,108,156,0,264,0.163434903047091
"064342807","BUENOS AIRES",260,8,126,125,0,251,0.0307692307692308
"064342809","BUENOS AIRES",430,25,229,174,0,403,0.0581395348837209
"064342810","BUENOS AIRES",385,9,210,166,0,376,0.0233766233766234
"064342909","BUENOS AIRES",350,8,142,191,1,334,0.0228571428571429
"064342910","BUENOS AIRES",186,34,79,72,0,151,0.182795698924731
"064342911","BUENOS AIRES",197,2,113,82,0,195,0.0101522842639594
"064343002","BUENOS AIRES",222,9,139,74,0,213,0.0405405405405405
"064343003","BUENOS AIRES",289,98,100,90,0,190,0.339100346020761
"064343005","BUENOS AIRES",316,87,98,130,0,228,0.275316455696203
"064343008","BUENOS AIRES",240,143,32,65,0,97,0.595833333333333
"064343102","BUENOS AIRES",211,92,69,50,0,119,0.436018957345972
"064343107","BUENOS AIRES",185,182,2,1,0,3,0.983783783783784
"064343301","BUENOS AIRES",285,10,113,162,0,275,0.0350877192982456
"064343306","BUENOS AIRES",325,6,117,201,0,318,0.0184615384615385
"064343413","BUENOS AIRES",347,6,174,162,2,338,0.0172910662824208
"064343509","BUENOS AIRES",285,19,128,135,1,264,0.0666666666666667
"064343607","BUENOS AIRES",251,29,140,80,0,220,0.115537848605578
"064343702","BUENOS AIRES",295,220,51,24,0,75,0.745762711864407
"064343706","BUENOS AIRES",336,325,8,2,0,10,0.967261904761905
"064343904","BUENOS AIRES",228,192,16,20,0,36,0.842105263157895
"064344001","BUENOS AIRES",348,51,109,188,0,297,0.146551724137931
"064344005","BUENOS AIRES",195,157,5,33,0,38,0.805128205128205
"064344103","BUENOS AIRES",392,20,215,157,0,372,0.0510204081632653
"064344104","BUENOS AIRES",321,7,114,197,0,311,0.0218068535825545
"064344402","BUENOS AIRES",276,16,62,192,3,257,0.0579710144927536
"064344404","BUENOS AIRES",182,6,91,84,0,175,0.032967032967033
"064344407","BUENOS AIRES",456,28,213,212,0,425,0.0614035087719298
"064344502","BUENOS AIRES",485,38,107,331,0,438,0.0783505154639175
"064410105","BUENOS AIRES",228,228,0,0,0,0,1
"064410303","BUENOS AIRES",189,189,0,0,0,0,1
"064410409","BUENOS AIRES",290,290,0,0,0,0,1
"064410502","BUENOS AIRES",276,276,0,0,0,0,1
"064410503","BUENOS AIRES",224,220,3,0,0,3,0.982142857142857
"064410506","BUENOS AIRES",219,219,0,0,0,0,1
"064410609","BUENOS AIRES",298,298,0,0,0,0,1
"064411009","BUENOS AIRES",371,369,1,0,1,2,0.994609164420485
"064411105","BUENOS AIRES",228,227,1,0,0,1,0.995614035087719
"064411114","BUENOS AIRES",293,293,0,0,0,0,1
"064411203","BUENOS AIRES",149,149,0,0,0,0,1
"064411206","BUENOS AIRES",189,189,0,0,0,0,1
"064411210","BUENOS AIRES",106,106,0,0,0,0,1
"064411301","BUENOS AIRES",192,192,0,0,0,0,1
"064411306","BUENOS AIRES",149,149,0,0,0,0,1
"064411607","BUENOS AIRES",356,353,3,0,0,3,0.991573033707865
"064411405","BUENOS AIRES",301,301,0,0,0,0,1
"064411407","BUENOS AIRES",215,215,0,0,0,0,1
"064411505","BUENOS AIRES",276,275,1,0,0,1,0.996376811594203
"064411608","BUENOS AIRES",200,200,0,0,0,0,1
"064411610","BUENOS AIRES",398,395,3,0,0,3,0.992462311557789
"065950101","BUENOS AIRES",291,9,105,177,0,282,0.0309278350515464
"064411911","BUENOS AIRES",241,241,0,0,0,0,1
"065950602","BUENOS AIRES",22,0,1,15,6,22,0
"064412503","BUENOS AIRES",198,197,1,0,0,1,0.994949494949495
"064412403","BUENOS AIRES",186,185,1,0,0,1,0.994623655913978
"064412502","BUENOS AIRES",265,264,1,0,0,1,0.99622641509434
"065951911","BUENOS AIRES",313,0,193,119,1,313,0
"064412708","BUENOS AIRES",384,382,0,1,0,1,0.994791666666667
"064412709","BUENOS AIRES",347,347,0,0,0,0,1
"064412806","BUENOS AIRES",197,197,0,0,0,0,1
"064413003","BUENOS AIRES",285,269,13,3,0,16,0.943859649122807
"065952405","BUENOS AIRES",277,264,3,10,0,13,0.953068592057762
"064413108","BUENOS AIRES",211,208,3,0,0,3,0.985781990521327
"064413111","BUENOS AIRES",400,397,3,0,0,3,0.9925
"064413207","BUENOS AIRES",334,330,4,0,0,4,0.988023952095808
"064413309","BUENOS AIRES",402,394,3,4,0,7,0.980099502487562
"064413503","BUENOS AIRES",207,207,0,0,0,0,1
"064413604","BUENOS AIRES",220,211,7,2,0,9,0.959090909090909
"064413609","BUENOS AIRES",309,239,37,25,0,62,0.773462783171521
"064413611","BUENOS AIRES",314,275,15,21,0,36,0.875796178343949
"064903408","BUENOS AIRES",252,4,78,165,0,243,0.0158730158730159
"064413703","BUENOS AIRES",197,3,51,137,0,188,0.0152284263959391
"064413806","BUENOS AIRES",307,290,9,5,0,14,0.944625407166124
"064413810","BUENOS AIRES",305,275,0,30,0,30,0.901639344262295
"064413906","BUENOS AIRES",303,263,5,1,1,7,0.867986798679868
"064414105","BUENOS AIRES",403,248,78,76,0,154,0.615384615384615
"064415104","BUENOS AIRES",292,270,13,8,0,21,0.924657534246575
"064414111","BUENOS AIRES",123,2,47,60,3,110,0.016260162601626
"064414201","BUENOS AIRES",508,5,133,344,7,484,0.00984251968503937
"064414302","BUENOS AIRES",297,184,63,50,0,113,0.619528619528619
"064414309","BUENOS AIRES",367,107,185,74,0,259,0.291553133514986
"064414410","BUENOS AIRES",602,11,160,392,9,561,0.0182724252491694
"064414601","BUENOS AIRES",295,9,177,101,0,278,0.0305084745762712
"064414603","BUENOS AIRES",283,46,137,97,0,234,0.162544169611307
"064414702","BUENOS AIRES",368,25,226,112,0,338,0.0679347826086956
"064414705","BUENOS AIRES",360,219,69,65,1,135,0.608333333333333
"064414803","BUENOS AIRES",244,197,26,21,0,47,0.807377049180328
"064414807","BUENOS AIRES",332,331,1,0,0,1,0.996987951807229
"064414808","BUENOS AIRES",197,196,1,0,0,1,0.99492385786802
"064415001","BUENOS AIRES",198,187,11,0,0,11,0.944444444444444
"064415010","BUENOS AIRES",263,260,2,0,0,2,0.988593155893536
"064415108","BUENOS AIRES",282,257,15,9,0,24,0.911347517730496
"064415209","BUENOS AIRES",186,181,4,1,0,5,0.973118279569892
"064415302","BUENOS AIRES",377,363,11,3,0,14,0.962864721485411
"064415304","BUENOS AIRES",297,287,9,0,0,9,0.966329966329966
"064415306","BUENOS AIRES",234,212,13,5,1,19,0.905982905982906
"064415401","BUENOS AIRES",299,244,24,29,0,53,0.816053511705686
"064415409","BUENOS AIRES",214,207,4,2,0,6,0.967289719626168
"064415417","BUENOS AIRES",354,9,258,84,1,343,0.0254237288135593
"064415504","BUENOS AIRES",230,3,167,56,0,223,0.0130434782608696
"064415510","BUENOS AIRES",130,1,62,54,11,127,0.00769230769230769
"064415605","BUENOS AIRES",403,377,14,12,0,26,0.935483870967742
"064415704","BUENOS AIRES",241,149,82,10,0,92,0.618257261410788
"064415705","BUENOS AIRES",364,73,205,76,2,283,0.200549450549451
"066230504","BUENOS AIRES",322,248,9,65,0,74,0.770186335403727
"064415906","BUENOS AIRES",224,64,108,50,0,158,0.285714285714286
"064415909","BUENOS AIRES",267,150,102,14,0,116,0.561797752808989
"064416008","BUENOS AIRES",223,2,190,30,0,220,0.00896860986547085
"064416210","BUENOS AIRES",183,57,64,58,0,122,0.311475409836066
"064416516","BUENOS AIRES",263,218,23,21,1,45,0.828897338403042
"065151901","BUENOS AIRES",451,152,173,121,1,295,0.337028824833703
"064903412","BUENOS AIRES",333,8,64,252,0,316,0.024024024024024
"064416213","BUENOS AIRES",351,13,129,194,2,325,0.037037037037037
"064416301","BUENOS AIRES",216,15,160,41,0,201,0.0694444444444444
"064416308","BUENOS AIRES",184,2,97,83,0,180,0.0108695652173913
"064760101","BUENOS AIRES",233,208,11,13,0,24,0.892703862660944
"064416311","BUENOS AIRES",140,3,77,56,0,133,0.0214285714285714
"064416406","BUENOS AIRES",155,0,66,88,0,154,0
"064416407","BUENOS AIRES",157,4,80,69,0,149,0.0254777070063694
"064416413","BUENOS AIRES",91,41,42,6,1,49,0.450549450549451
"064416515","BUENOS AIRES",312,193,36,70,2,108,0.618589743589744
"064416505","BUENOS AIRES",72,0,9,55,0,64,0
"066232905","BUENOS AIRES",247,201,33,12,0,45,0.813765182186235
"064760105","BUENOS AIRES",209,204,3,2,0,5,0.976076555023923
"064416518","BUENOS AIRES",186,74,47,53,1,101,0.397849462365591
"064416608","BUENOS AIRES",295,223,28,40,1,69,0.75593220338983
"066380201","BUENOS AIRES",341,340,1,0,0,1,0.997067448680352
"064416902","BUENOS AIRES",339,165,68,95,2,165,0.486725663716814
"064416908","BUENOS AIRES",349,6,167,163,1,331,0.0171919770773639
"064480607","BUENOS AIRES",285,162,50,72,0,122,0.568421052631579
"064551406","BUENOS AIRES",321,263,15,32,0,47,0.819314641744548
"064551410","BUENOS AIRES",284,11,133,133,1,267,0.0387323943661972
"064620406","BUENOS AIRES",110,55,34,21,0,55,0.5
"064690111","BUENOS AIRES",297,253,23,21,0,44,0.851851851851852
"064690602","BUENOS AIRES",413,405,5,0,0,5,0.980629539951574
"064690603","BUENOS AIRES",243,91,44,104,1,149,0.374485596707819
"064691007","BUENOS AIRES",171,0,130,39,0,169,0
"064691101","BUENOS AIRES",94,0,23,69,0,92,0
"066440404","BUENOS AIRES",47,4,40,3,0,43,0.0851063829787234
"064761402","BUENOS AIRES",283,237,14,29,0,43,0.837455830388693
"064761404","BUENOS AIRES",257,209,25,15,8,48,0.813229571984436
"064830112","BUENOS AIRES",205,34,96,75,0,171,0.165853658536585
"064830406","BUENOS AIRES",109,0,56,45,8,109,0
"064900202","BUENOS AIRES",534,16,166,337,2,505,0.0299625468164794
"064900110","BUENOS AIRES",166,14,35,117,0,152,0.0843373493975904
"064900208","BUENOS AIRES",549,15,217,275,0,492,0.0273224043715847
"064900301","BUENOS AIRES",342,27,149,153,0,302,0.0789473684210526
"064900303","BUENOS AIRES",277,15,153,101,0,254,0.0541516245487365
"064900306","BUENOS AIRES",406,36,124,237,0,361,0.0886699507389163
"064900307","BUENOS AIRES",274,9,143,103,1,247,0.0328467153284672
"064900310","BUENOS AIRES",503,52,99,328,3,430,0.10337972166998
"064900311","BUENOS AIRES",159,12,46,98,0,144,0.0754716981132075
"064900401","BUENOS AIRES",411,12,210,177,0,387,0.0291970802919708
"064900404","BUENOS AIRES",246,18,53,149,13,215,0.0731707317073171
"064900514","BUENOS AIRES",320,34,151,129,0,280,0.10625
"064900605","BUENOS AIRES",222,5,152,65,0,217,0.0225225225225225
"064900608","BUENOS AIRES",366,22,185,150,0,335,0.0601092896174863
"064900705","BUENOS AIRES",361,17,208,135,0,343,0.0470914127423823
"064900712","BUENOS AIRES",351,6,207,129,0,336,0.0170940170940171
"064900905","BUENOS AIRES",392,343,20,28,0,48,0.875
"064901111","BUENOS AIRES",184,184,0,0,0,0,1
"064901116","BUENOS AIRES",357,348,3,6,0,9,0.974789915966387
"064901301","BUENOS AIRES",381,327,29,23,0,52,0.858267716535433
"064901304","BUENOS AIRES",219,31,106,82,0,188,0.141552511415525
"064901313","BUENOS AIRES",316,17,161,134,1,296,0.0537974683544304
"064901403","BUENOS AIRES",212,5,100,105,0,205,0.0235849056603774
"064901407","BUENOS AIRES",283,20,105,112,0,217,0.0706713780918728
"064901412","BUENOS AIRES",418,19,159,213,2,374,0.0454545454545455
"064901505","BUENOS AIRES",312,13,88,206,0,294,0.0416666666666667
"064901509","BUENOS AIRES",178,7,31,138,0,169,0.0393258426966292
"064901706","BUENOS AIRES",398,34,184,172,1,357,0.085427135678392
"064901707","BUENOS AIRES",395,5,197,191,0,388,0.0126582278481013
"064901804","BUENOS AIRES",404,362,28,12,1,41,0.896039603960396
"064901811","BUENOS AIRES",349,6,205,132,1,338,0.0171919770773639
"064901815","BUENOS AIRES",479,59,166,249,0,415,0.123173277661795
"064901905","BUENOS AIRES",278,256,21,1,0,22,0.920863309352518
"064901907","BUENOS AIRES",381,333,31,15,1,47,0.874015748031496
"064901908","BUENOS AIRES",253,230,17,4,0,21,0.909090909090909
"064902007","BUENOS AIRES",376,255,75,46,0,121,0.678191489361702
"064902110","BUENOS AIRES",337,335,1,1,0,2,0.99406528189911
"064902204","BUENOS AIRES",204,204,0,0,0,0,1
"064902209","BUENOS AIRES",197,197,0,0,0,0,1
"064902307","BUENOS AIRES",234,232,0,2,0,2,0.991452991452991
"064902507","BUENOS AIRES",283,253,23,7,0,30,0.893992932862191
"064902601","BUENOS AIRES",316,193,72,50,0,122,0.610759493670886
"064902609","BUENOS AIRES",157,142,10,5,0,15,0.904458598726115
"064902802","BUENOS AIRES",227,8,148,70,0,218,0.0352422907488987
"064902905","BUENOS AIRES",335,10,178,142,0,320,0.0298507462686567
"064902909","BUENOS AIRES",430,13,259,153,1,413,0.0302325581395349
"064903010","BUENOS AIRES",358,9,250,94,3,347,0.0251396648044693
"064903106","BUENOS AIRES",407,12,104,270,0,374,0.0294840294840295
"064903107","BUENOS AIRES",377,9,158,192,0,350,0.0238726790450928
"064903203","BUENOS AIRES",358,17,93,212,0,305,0.0474860335195531
"064903305","BUENOS AIRES",474,1,219,228,4,451,0.00210970464135021
"064903307","BUENOS AIRES",224,32,63,113,7,183,0.142857142857143
"064903403","BUENOS AIRES",320,24,92,184,7,283,0.075
"064903407","BUENOS AIRES",287,20,143,115,2,260,0.0696864111498258
"064903507","BUENOS AIRES",403,2,47,202,20,269,0.00496277915632754
"064903513","BUENOS AIRES",461,11,117,318,0,435,0.0238611713665944
"064903602","BUENOS AIRES",427,10,170,222,1,393,0.0234192037470726
"064903606","BUENOS AIRES",361,26,116,160,0,276,0.07202216066482
"064903611","BUENOS AIRES",282,10,101,151,1,253,0.0354609929078014
"064903803","BUENOS AIRES",179,15,76,71,4,151,0.0837988826815642
"064903906","BUENOS AIRES",472,14,94,351,10,455,0.0296610169491525
"064903908","BUENOS AIRES",287,30,27,157,1,185,0.104529616724739
"064903915","BUENOS AIRES",640,9,94,481,14,589,0.0140625
"065391712","BUENOS AIRES",255,236,2,14,0,16,0.925490196078431
"064904006","BUENOS AIRES",618,13,89,496,2,587,0.0210355987055016
"064904008","BUENOS AIRES",423,13,52,328,6,386,0.0307328605200946
"064904201","BUENOS AIRES",282,3,228,50,0,278,0.0106382978723404
"064904408","BUENOS AIRES",354,10,266,77,0,343,0.0282485875706215
"064904303","BUENOS AIRES",280,9,168,101,0,269,0.0321428571428571
"064904311","BUENOS AIRES",214,1,178,35,0,213,0.00467289719626168
"064904312","BUENOS AIRES",294,65,204,24,0,228,0.22108843537415
"064904413","BUENOS AIRES",286,9,201,74,0,275,0.0314685314685315
"064904703","BUENOS AIRES",209,11,143,54,0,197,0.0526315789473684
"064904705","BUENOS AIRES",289,20,232,37,0,269,0.069204152249135
"064904713","BUENOS AIRES",259,77,110,72,0,182,0.297297297297297
"065391308","BUENOS AIRES",360,2,307,47,0,354,0.00555555555555556
"065391408","BUENOS AIRES",347,0,246,90,0,336,0
"065391415","BUENOS AIRES",271,0,167,95,2,264,0
"060630502","BUENOS AIRES",16,0,5,10,0,15,0
"061470306","BUENOS AIRES",7,0,0,7,0,7,0
"065681606","BUENOS AIRES",350,344,4,2,0,6,0.982857142857143
"065391509","BUENOS AIRES",257,232,14,10,0,24,0.90272373540856
"061680104","BUENOS AIRES",10,0,1,8,1,10,0
"060070305","BUENOS AIRES",4,0,1,2,0,3,0
"060070510","BUENOS AIRES",3,0,1,1,0,2,0
"065391601","BUENOS AIRES",237,51,150,36,0,186,0.215189873417722
"061120706","BUENOS AIRES",7,0,7,0,0,7,0
"060070903","BUENOS AIRES",7,0,1,6,0,7,0
"060070904","BUENOS AIRES",6,0,0,6,0,6,0
"060070905","BUENOS AIRES",3,0,0,3,0,3,0
"060071010","BUENOS AIRES",10,0,3,7,0,10,0
"060071102","BUENOS AIRES",0,0,0,0,0,0,NA
"060071105","BUENOS AIRES",4,0,1,3,0,4,0
"061820401","BUENOS AIRES",22,0,13,8,1,22,0
"061120903","BUENOS AIRES",11,0,5,6,0,11,0
"061121203","BUENOS AIRES",6,0,4,2,0,6,0
"060141501","BUENOS AIRES",3,0,0,3,0,3,0
"060210203","BUENOS AIRES",14,0,6,8,0,14,0
"061890304","BUENOS AIRES",2,0,1,1,0,2,0
"060210301","BUENOS AIRES",7,0,4,3,0,7,0
"060210502","BUENOS AIRES",11,0,5,6,0,11,0
"061891406","BUENOS AIRES",6,0,6,0,0,6,0
"062170603","BUENOS AIRES",9,0,9,0,0,9,0
"060490401","BUENOS AIRES",128,3,52,69,4,125,0.0234375
"063220103","BUENOS AIRES",11,0,0,11,0,11,0
"063220304","BUENOS AIRES",18,0,10,8,0,18,0
"066381709","BUENOS AIRES",165,161,3,1,0,4,0.975757575757576
"065600715","BUENOS AIRES",406,1,221,162,4,387,0.00246305418719212
"064270304","BUENOS AIRES",233,232,1,0,0,1,0.995708154506438
"060491501","BUENOS AIRES",35,2,3,29,0,32,0.0571428571428571
"060492102","BUENOS AIRES",48,1,25,21,1,47,0.0208333333333333
"065391806","BUENOS AIRES",402,235,69,88,1,158,0.584577114427861
"062940102","BUENOS AIRES",2,0,1,1,0,2,0
"061050901","BUENOS AIRES",42,0,17,24,1,42,0
"061190204","BUENOS AIRES",28,0,0,28,0,28,0
"061190405","BUENOS AIRES",26,0,6,20,0,26,0
"061610405","BUENOS AIRES",47,3,22,22,0,44,0.0638297872340425
"060492401","BUENOS AIRES",19,0,5,12,2,19,0
"060562901","BUENOS AIRES",17,0,10,6,0,16,0
"061051304","BUENOS AIRES",79,6,23,48,0,71,0.0759493670886076
"061120307","BUENOS AIRES",10,0,9,0,1,10,0
"061120504","BUENOS AIRES",4,0,0,3,1,4,0
"060563204","BUENOS AIRES",113,2,27,65,5,97,0.0176991150442478
"060630403","BUENOS AIRES",23,0,2,19,0,21,0
"060770403","BUENOS AIRES",16,0,3,13,0,16,0
"060700501","BUENOS AIRES",42,2,28,11,1,40,0.0476190476190476
"060770301","BUENOS AIRES",13,0,8,5,0,13,0
"060700702","BUENOS AIRES",19,1,6,12,0,18,0.0526315789473684
"060700901","BUENOS AIRES",7,0,0,6,0,6,0
"060701003","BUENOS AIRES",19,0,6,12,1,19,0
"540282005","MISIONES",358,13,231,106,4,341,0.0363128491620112
"060770601","BUENOS AIRES",21,0,19,2,0,21,0
"060770602","BUENOS AIRES",31,0,23,8,0,31,0
"060770603","BUENOS AIRES",18,0,2,13,1,16,0
"060771003","BUENOS AIRES",8,0,5,3,0,8,0
"060771201","BUENOS AIRES",21,0,18,1,0,19,0
"060840101","BUENOS AIRES",19,1,12,5,1,18,0.0526315789473684
"060840603","BUENOS AIRES",6,0,4,2,0,6,0
"065391804","BUENOS AIRES",308,256,35,16,0,51,0.831168831168831
"068052610","BUENOS AIRES",222,4,125,69,18,212,0.018018018018018
"061340802","BUENOS AIRES",14,0,6,8,0,14,0
"061340803","BUENOS AIRES",31,0,17,14,0,31,0
"061540404","BUENOS AIRES",12,0,3,8,1,12,0
"061540703","BUENOS AIRES",15,0,0,15,0,15,0
"020130308","CABA",278,278,0,0,0,0,1
"061610301","BUENOS AIRES",30,0,17,13,0,30,0
"061340902","BUENOS AIRES",162,7,83,61,0,144,0.0432098765432099
"065392006","BUENOS AIRES",366,4,250,99,0,349,0.0109289617486339
"061400313","BUENOS AIRES",13,0,10,3,0,13,0
"061470403","BUENOS AIRES",15,0,2,13,0,15,0
"061400501","BUENOS AIRES",19,3,5,11,0,16,0.157894736842105
"061470502","BUENOS AIRES",14,1,12,1,0,13,0.0714285714285714
"061470903","BUENOS AIRES",9,0,3,5,0,8,0
"061540208","BUENOS AIRES",30,0,13,16,0,29,0
"061960402","BUENOS AIRES",10,0,6,4,0,10,0
"061610504","BUENOS AIRES",33,0,11,22,0,33,0
"061610802","BUENOS AIRES",16,0,3,13,0,16,0
"065392008","BUENOS AIRES",464,12,259,185,2,446,0.0258620689655172
"061680702","BUENOS AIRES",7,0,3,3,0,6,0
"061680801","BUENOS AIRES",17,0,9,8,0,17,0
"061681102","BUENOS AIRES",14,0,3,11,0,14,0
"061750504","BUENOS AIRES",5,0,2,3,0,5,0
"061820603","BUENOS AIRES",18,1,4,12,0,16,0.0555555555555556
"065392101","BUENOS AIRES",277,14,235,28,0,263,0.0505415162454874
"061890703","BUENOS AIRES",11,0,10,1,0,11,0
"061890704","BUENOS AIRES",2,0,1,1,0,2,0
"061890707","BUENOS AIRES",10,0,6,4,0,10,0
"061960801","BUENOS AIRES",9,0,2,7,0,9,0
"061890803","BUENOS AIRES",4,0,2,2,0,4,0
"061890902","BUENOS AIRES",16,1,8,7,0,15,0.0625
"061891204","BUENOS AIRES",3,1,0,1,1,2,0.333333333333333
"061891305","BUENOS AIRES",2,0,0,1,0,1,0
"061891404","BUENOS AIRES",2,0,0,2,0,2,0
"061891603","BUENOS AIRES",11,0,8,3,0,11,0
"061891605","BUENOS AIRES",4,0,0,4,0,4,0
"061891701","BUENOS AIRES",23,0,18,4,1,23,0
"020120710","CABA",476,474,1,0,0,1,0.995798319327731
"061960601","BUENOS AIRES",7,0,0,7,0,7,0
"064273305","BUENOS AIRES",211,198,5,8,0,13,0.938388625592417
"061960902","BUENOS AIRES",5,0,0,5,0,5,0
"061961005","BUENOS AIRES",13,0,8,5,0,13,0
"061961203","BUENOS AIRES",6,0,3,3,0,6,0
"062030601","BUENOS AIRES",9,0,3,6,0,9,0
"061961206","BUENOS AIRES",9,0,0,9,0,9,0
"061961305","BUENOS AIRES",11,0,8,3,0,11,0
"061961403","BUENOS AIRES",10,1,0,8,0,8,0.1
"020131612","CABA",347,345,2,0,0,2,0.994236311239193
"062030208","BUENOS AIRES",10,0,3,7,0,10,0
"067562401","BUENOS AIRES",340,308,12,11,0,23,0.905882352941176
"062030306","BUENOS AIRES",9,0,5,4,0,9,0
"062030405","BUENOS AIRES",6,0,0,6,0,6,0
"062030407","BUENOS AIRES",5,0,2,3,0,5,0
"065392207","BUENOS AIRES",477,9,317,139,1,457,0.0188679245283019
"062030505","BUENOS AIRES",7,0,0,7,0,7,0
"062030507","BUENOS AIRES",3,0,0,3,0,3,0
"065392303","BUENOS AIRES",310,1,252,55,1,308,0.0032258064516129
"062030907","BUENOS AIRES",5,0,0,5,0,5,0
"062031202","BUENOS AIRES",6,0,1,5,0,6,0
"062100610","BUENOS AIRES",21,0,11,9,0,20,0
"065392313","BUENOS AIRES",357,2,134,186,2,322,0.00560224089635854
"063221102","BUENOS AIRES",12,0,4,7,0,11,0
"062170207","BUENOS AIRES",15,0,4,11,0,15,0
"062170507","BUENOS AIRES",20,0,6,13,1,20,0
"065392404","BUENOS AIRES",424,2,250,164,0,414,0.00471698113207547
"065392405","BUENOS AIRES",300,1,182,109,1,292,0.00333333333333333
"063920603","BUENOS AIRES",7,0,6,1,0,7,0
"065392507","BUENOS AIRES",329,5,191,130,0,321,0.0151975683890578
"065392512","BUENOS AIRES",220,5,98,109,0,207,0.0227272727272727
"062240703","BUENOS AIRES",15,0,4,10,1,15,0
"068120401","BUENOS AIRES",30,0,7,23,0,30,0
"062241001","BUENOS AIRES",9,1,2,6,0,8,0.111111111111111
"065392606","BUENOS AIRES",344,6,216,116,1,333,0.0174418604651163
"062242005","BUENOS AIRES",18,0,2,16,0,18,0
"063574609","BUENOS AIRES",274,273,0,0,0,0,0.996350364963504
"063850403","BUENOS AIRES",13,0,2,11,0,13,0
"062242103","BUENOS AIRES",7,0,1,6,0,7,0
"062310602","BUENOS AIRES",8,0,2,6,0,8,0
"062310902","BUENOS AIRES",37,0,19,18,0,37,0
"062311214","BUENOS AIRES",39,0,17,22,0,39,0
"062381001","BUENOS AIRES",8,0,0,7,1,8,0
"062520301","BUENOS AIRES",52,0,7,40,0,47,0
"062520602","BUENOS AIRES",3,0,0,3,0,3,0
"062770201","BUENOS AIRES",31,0,15,16,0,31,0
"062800502","BUENOS AIRES",13,0,7,6,0,13,0
"062800505","BUENOS AIRES",9,0,8,1,0,9,0
"062800809","BUENOS AIRES",17,0,9,5,1,15,0
"063430301","BUENOS AIRES",30,0,9,21,0,30,0
"063510201","BUENOS AIRES",50,2,24,22,0,46,0.04
"063510302","BUENOS AIRES",7,0,0,7,0,7,0
"062870101","BUENOS AIRES",91,0,25,59,3,87,0
"062870417","BUENOS AIRES",7,0,4,1,0,5,0
"062940301","BUENOS AIRES",10,0,9,1,0,10,0
"063081001","BUENOS AIRES",39,0,16,23,0,39,0
"063220803","BUENOS AIRES",16,0,6,10,0,16,0
"063220801","BUENOS AIRES",8,0,1,7,0,8,0
"063221101","BUENOS AIRES",11,0,10,0,0,10,0
"063510405","BUENOS AIRES",15,0,1,12,0,13,0
"063510612","BUENOS AIRES",4,0,3,1,0,4,0
"067562407","BUENOS AIRES",194,188,4,2,0,6,0.969072164948454
"063577917","BUENOS AIRES",43,1,0,41,0,41,0.0232558139534884
"067631815","BUENOS AIRES",177,1,72,104,0,176,0.00564971751412429
"063578201","BUENOS AIRES",35,0,9,22,4,35,0
"064480102","BUENOS AIRES",8,0,2,5,0,7,0
"064131104","BUENOS AIRES",0,0,0,0,0,0,NA
"063850303","BUENOS AIRES",13,0,5,8,0,13,0
"065881604","BUENOS AIRES",11,0,0,11,0,11,0
"063851102","BUENOS AIRES",19,0,5,14,0,19,0
"063920201","BUENOS AIRES",19,0,14,4,0,18,0
"063920804","BUENOS AIRES",17,0,8,9,0,17,0
"063920905","BUENOS AIRES",20,0,1,19,0,20,0
"063921001","BUENOS AIRES",19,0,16,3,0,19,0
"063921505","BUENOS AIRES",13,0,4,6,0,10,0
"063990202","BUENOS AIRES",38,1,15,22,0,37,0.0263157894736842
"065600807","BUENOS AIRES",378,11,199,152,4,355,0.0291005291005291
"065180502","BUENOS AIRES",11,0,5,6,0,11,0
"065392905","BUENOS AIRES",92,0,32,58,1,91,0
"064200501","BUENOS AIRES",4,1,2,0,1,3,0.25
"065390310","BUENOS AIRES",439,429,8,1,0,9,0.977220956719818
"064416816","BUENOS AIRES",167,8,44,78,0,122,0.0479041916167665
"064480201","BUENOS AIRES",10,0,6,4,0,10,0
"064480501","BUENOS AIRES",11,0,3,8,0,11,0
"064480503","BUENOS AIRES",4,0,3,0,1,4,0
"064480702","BUENOS AIRES",1,0,0,1,0,1,0
"064480703","BUENOS AIRES",5,0,0,5,0,5,0
"064480904","BUENOS AIRES",6,0,5,1,0,6,0
"064481201","BUENOS AIRES",7,0,3,3,0,6,0
"064550602","BUENOS AIRES",18,0,3,12,0,15,0
"065392908","BUENOS AIRES",111,0,69,40,0,109,0
"064551101","BUENOS AIRES",59,0,15,43,1,59,0
"063574613","BUENOS AIRES",195,195,0,0,0,0,1
"064620501","BUENOS AIRES",6,0,1,5,0,6,0
"064620709","BUENOS AIRES",9,0,3,6,0,9,0
"064690504","BUENOS AIRES",6,0,2,4,0,6,0
"064690804","BUENOS AIRES",38,0,19,19,0,38,0
"064691103","BUENOS AIRES",5,0,4,0,0,4,0
"064691201","BUENOS AIRES",8,0,3,5,0,8,0
"064691403","BUENOS AIRES",24,7,0,17,0,17,0.291666666666667
"064691506","BUENOS AIRES",16,0,4,9,3,16,0
"064760504","BUENOS AIRES",15,0,9,5,1,15,0
"065600811","BUENOS AIRES",274,247,15,10,0,25,0.901459854014598
"064760702","BUENOS AIRES",48,1,15,30,0,45,0.0208333333333333
"064760901","BUENOS AIRES",19,0,9,9,0,18,0
"064971007","BUENOS AIRES",11,0,7,3,1,11,0
"064761001","BUENOS AIRES",30,0,13,17,0,30,0
"064830601","BUENOS AIRES",32,0,22,8,0,30,0
"064830703","BUENOS AIRES",30,0,12,18,0,30,0
"064830902","BUENOS AIRES",41,0,19,22,0,41,0
"064831001","BUENOS AIRES",29,0,19,10,0,29,0
"066511002","BUENOS AIRES",4,0,0,4,0,4,0
"064970204","BUENOS AIRES",20,0,8,12,0,20,0
"064970805","BUENOS AIRES",48,0,14,30,3,47,0
"064970901","BUENOS AIRES",29,0,18,7,0,25,0
"065390407","BUENOS AIRES",185,182,0,2,0,2,0.983783783783784
"064971310","BUENOS AIRES",29,0,27,2,0,29,0
"065050103","BUENOS AIRES",72,0,31,23,0,54,0
"065050208","BUENOS AIRES",24,0,14,10,0,24,0
"065050106","BUENOS AIRES",15,0,5,10,0,15,0
"065050204","BUENOS AIRES",108,0,75,32,0,107,0
"066720404","BUENOS AIRES",15,0,6,9,0,15,0
"066721212","BUENOS AIRES",43,0,14,26,2,42,0
"065110304","BUENOS AIRES",42,0,23,17,0,40,0
"065881609","BUENOS AIRES",3,0,1,2,0,3,0
"065110401","BUENOS AIRES",31,0,14,13,0,27,0
"066861103","BUENOS AIRES",13,0,8,5,0,13,0
"067000502","BUENOS AIRES",6,0,6,0,0,6,0
"067000808","BUENOS AIRES",0,0,0,0,0,0,NA
"065180403","BUENOS AIRES",6,0,0,6,0,6,0
"065180509","BUENOS AIRES",3,0,3,0,0,3,0
"020132207","CABA",455,455,0,0,0,0,1
"065180615","BUENOS AIRES",9,0,8,1,0,9,0
"065180813","BUENOS AIRES",7,0,5,2,0,7,0
"065180814","BUENOS AIRES",3,0,3,0,0,3,0
"065250201","BUENOS AIRES",32,0,13,19,0,32,0
"065320803","BUENOS AIRES",14,0,3,11,0,14,0
"065321005","BUENOS AIRES",23,0,9,14,0,23,0
"065321103","BUENOS AIRES",25,0,13,11,1,25,0
"065321104","BUENOS AIRES",11,0,6,4,0,10,0
"065600812","BUENOS AIRES",232,125,36,65,1,102,0.538793103448276
"065393316","BUENOS AIRES",14,0,5,8,0,13,0
"065600908","BUENOS AIRES",78,44,11,22,1,34,0.564102564102564
"065740302","BUENOS AIRES",32,0,26,6,0,32,0
"065740401","BUENOS AIRES",71,0,20,51,0,71,0
"540281210","MISIONES",444,429,9,6,0,15,0.966216216216216
"067630310","BUENOS AIRES",261,258,3,0,0,3,0.988505747126437
"065740703","BUENOS AIRES",27,0,5,22,0,27,0
"065810704","BUENOS AIRES",19,0,13,6,0,19,0
"065601003","BUENOS AIRES",314,79,164,67,0,231,0.251592356687898
"065601102","BUENOS AIRES",384,4,201,178,1,380,0.0104166666666667
"065392925","BUENOS AIRES",309,5,192,109,0,301,0.0161812297734628
"065810808","BUENOS AIRES",18,0,4,14,0,18,0
"065810903","BUENOS AIRES",8,0,0,6,0,6,0
"065950802","BUENOS AIRES",58,0,11,46,1,58,0
"066510604","BUENOS AIRES",10,0,1,8,1,10,0
"020131704","CABA",247,247,0,0,0,0,1
"065810907","BUENOS AIRES",4,0,0,4,0,4,0
"065811002","BUENOS AIRES",22,0,5,17,0,22,0
"065811004","BUENOS AIRES",7,0,7,0,0,7,0
"065811107","BUENOS AIRES",23,0,14,4,0,18,0
"065811109","BUENOS AIRES",5,0,3,2,0,5,0
"065601111","BUENOS AIRES",427,3,239,165,2,406,0.00702576112412178
"066091302","BUENOS AIRES",11,0,8,3,0,11,0
"066091402","BUENOS AIRES",20,0,10,10,0,20,0
"066160104","BUENOS AIRES",64,0,39,19,4,62,0
"066510606","BUENOS AIRES",9,0,7,2,0,9,0
"065811207","BUENOS AIRES",17,0,9,6,1,16,0
"065880502","BUENOS AIRES",17,0,5,12,0,17,0
"065881202","BUENOS AIRES",9,0,1,8,0,9,0
"065881305","BUENOS AIRES",26,0,7,18,1,26,0
"065881605","BUENOS AIRES",5,0,3,1,0,4,0
"065881606","BUENOS AIRES",12,0,3,7,2,12,0
"065881608","BUENOS AIRES",10,0,2,8,0,10,0
"066510607","BUENOS AIRES",13,0,9,4,0,13,0
"066510808","BUENOS AIRES",11,0,8,3,0,11,0
"065951701","BUENOS AIRES",46,0,0,46,0,46,0
"066021001","BUENOS AIRES",13,0,6,7,0,13,0
"065393105","BUENOS AIRES",321,3,200,108,0,308,0.00934579439252336
"066230601","BUENOS AIRES",4,0,1,3,0,4,0
"066230802","BUENOS AIRES",9,0,3,4,2,9,0
"065393108","BUENOS AIRES",282,0,145,121,0,266,0
"065530105","BUENOS AIRES",78,67,9,0,0,9,0.858974358974359
"066231403","BUENOS AIRES",25,0,17,8,0,25,0
"066021401","BUENOS AIRES",38,0,19,17,1,37,0
"066021501","BUENOS AIRES",1,0,0,1,0,1,0
"066090604","BUENOS AIRES",6,0,1,5,0,6,0
"066090701","BUENOS AIRES",4,0,2,2,0,4,0
"066090804","BUENOS AIRES",5,0,0,5,0,5,0
"066091102","BUENOS AIRES",18,0,9,8,0,17,0
"066231503","BUENOS AIRES",13,0,5,8,0,13,0
"066232105","BUENOS AIRES",22,1,19,2,0,21,0.0454545454545455
"066300401","BUENOS AIRES",48,0,11,36,1,48,0
"066510706","BUENOS AIRES",8,0,5,3,0,8,0
"068750101","BUENOS AIRES",11,0,8,3,0,11,0
"068751101","BUENOS AIRES",12,0,4,7,0,11,0
"068821708","BUENOS AIRES",193,19,93,75,0,168,0.0984455958549223
"066510112","BUENOS AIRES",6,0,1,5,0,6,0
"066510301","BUENOS AIRES",11,0,10,1,0,11,0
"066510501","BUENOS AIRES",3,0,0,3,0,3,0
"066510502","BUENOS AIRES",3,0,2,1,0,3,0
"066510702","BUENOS AIRES",12,0,8,4,0,12,0
"066510602","BUENOS AIRES",7,0,2,5,0,7,0
"065880202","BUENOS AIRES",336,291,26,17,0,43,0.866071428571429
"066510816","BUENOS AIRES",3,0,2,1,0,3,0
"066511104","BUENOS AIRES",10,0,2,7,1,10,0
"066511202","BUENOS AIRES",9,0,8,1,0,9,0
"066550104","BUENOS AIRES",29,0,7,20,1,28,0
"066550106","BUENOS AIRES",19,0,9,10,0,19,0
"066651004","BUENOS AIRES",23,0,8,14,0,22,0
"066720604","BUENOS AIRES",6,0,1,5,0,6,0
"066720801","BUENOS AIRES",13,0,0,13,0,13,0
"066720503","BUENOS AIRES",8,0,6,2,0,8,0
"066720603","BUENOS AIRES",4,0,2,2,0,4,0
"066583505","BUENOS AIRES",271,14,74,179,0,253,0.0516605166051661
"066720902","BUENOS AIRES",13,0,1,12,0,13,0
"066721102","BUENOS AIRES",16,0,3,13,0,16,0
"066721104","BUENOS AIRES",15,0,4,11,0,15,0
"066721301","BUENOS AIRES",13,0,8,5,0,13,0
"066790403","BUENOS AIRES",11,0,10,1,0,11,0
"066790801","BUENOS AIRES",21,0,2,19,0,21,0
"066790903","BUENOS AIRES",13,0,13,0,0,13,0
"066791002","BUENOS AIRES",10,0,7,3,0,10,0
"066860205","BUENOS AIRES",3,0,2,1,0,3,0
"065393209","BUENOS AIRES",235,1,157,72,2,231,0.00425531914893617
"066860705","BUENOS AIRES",7,0,0,7,0,7,0
"066860707","BUENOS AIRES",16,0,6,8,2,16,0
"066861204","BUENOS AIRES",7,0,0,6,0,6,0
"067000201","BUENOS AIRES",14,0,0,12,2,14,0
"067000806","BUENOS AIRES",3,0,1,2,0,3,0
"067000809","BUENOS AIRES",5,0,2,3,0,5,0
"067000902","BUENOS AIRES",5,0,4,1,0,5,0
"067071001","BUENOS AIRES",23,0,13,10,0,23,0
"066583507","BUENOS AIRES",335,280,29,24,0,53,0.835820895522388
"067001002","BUENOS AIRES",8,0,8,0,0,8,0
"067001101","BUENOS AIRES",14,0,8,6,0,14,0
"067001202","BUENOS AIRES",16,0,11,5,0,16,0
"067070201","BUENOS AIRES",26,0,4,22,0,26,0
"067280401","BUENOS AIRES",16,0,6,8,2,16,0
"067280502","BUENOS AIRES",9,0,0,9,0,9,0
"067280702","BUENOS AIRES",8,0,7,1,0,8,0
"067070601","BUENOS AIRES",9,1,6,2,0,8,0.111111111111111
"067070608","BUENOS AIRES",31,0,15,15,0,30,0
"067840301","BUENOS AIRES",7,0,0,7,0,7,0
"067840501","BUENOS AIRES",7,0,0,7,0,7,0
"067140201","BUENOS AIRES",6,0,1,5,0,6,0
"067140205","BUENOS AIRES",7,0,3,4,0,7,0
"067140206","BUENOS AIRES",10,0,1,9,0,10,0
"067280902","BUENOS AIRES",90,1,30,56,1,87,0.0111111111111111
"067281101","BUENOS AIRES",6,0,0,6,0,6,0
"067140806","BUENOS AIRES",64,0,26,34,4,64,0
"067140903","BUENOS AIRES",12,0,7,5,0,12,0
"065600702","BUENOS AIRES",337,284,34,19,0,53,0.84272997032641
"067140904","BUENOS AIRES",18,0,8,10,0,18,0
"067210209","BUENOS AIRES",23,0,11,12,0,23,0
"067280204","BUENOS AIRES",15,0,5,10,0,15,0
"300150911","ENTRE RIOS",14,1,13,0,0,13,0.0714285714285714
"067281503","BUENOS AIRES",22,0,4,17,1,22,0
"067350203","BUENOS AIRES",4,0,0,4,0,4,0
"067840502","BUENOS AIRES",6,0,0,6,0,6,0
"067350302","BUENOS AIRES",26,0,19,7,0,26,0
"067350303","BUENOS AIRES",15,0,0,15,0,15,0
"067701402","BUENOS AIRES",15,0,5,10,0,15,0
"067701703","BUENOS AIRES",4,0,2,2,0,4,0
"067350501","BUENOS AIRES",8,0,1,7,0,8,0
"065601114","BUENOS AIRES",342,0,253,86,1,340,0
"065600314","BUENOS AIRES",235,0,154,76,0,230,0
"065180716","BUENOS AIRES",101,3,90,8,0,98,0.0297029702970297
"065393416","BUENOS AIRES",45,0,19,25,0,44,0
"065470305","BUENOS AIRES",241,21,89,129,0,218,0.0871369294605809
"067631103","BUENOS AIRES",17,2,8,7,0,15,0.117647058823529
"067700701","BUENOS AIRES",9,0,3,4,2,9,0
"067700906","BUENOS AIRES",44,0,19,24,1,44,0
"067701204","BUENOS AIRES",8,0,1,7,0,8,0
"060350711","BUENOS AIRES",191,134,27,20,0,47,0.701570680628272
"067701805","BUENOS AIRES",16,0,4,12,0,16,0
"067780801","BUENOS AIRES",16,0,6,10,0,16,0
"067840601","BUENOS AIRES",10,0,1,9,0,10,0
"068613309","BUENOS AIRES",364,332,24,0,0,24,0.912087912087912
"067910701","BUENOS AIRES",55,0,35,16,1,52,0
"065470902","BUENOS AIRES",318,10,141,158,1,300,0.0314465408805031
"067910906","BUENOS AIRES",51,0,15,34,0,49,0
"067911504","BUENOS AIRES",46,0,22,21,3,46,0
"067980301","BUENOS AIRES",14,0,1,13,0,14,0
"067980302","BUENOS AIRES",21,0,10,9,1,20,0
"067980507","BUENOS AIRES",13,0,0,13,0,13,0
"067980901","BUENOS AIRES",19,0,9,10,0,19,0
"067981006","BUENOS AIRES",6,0,0,6,0,6,0
"065470311","BUENOS AIRES",118,28,48,41,0,89,0.23728813559322
"065530101","BUENOS AIRES",253,234,7,12,0,19,0.924901185770751
"065600502","BUENOS AIRES",386,0,232,144,1,377,0
"065600506","BUENOS AIRES",59,0,34,20,0,54,0
"065600609","BUENOS AIRES",445,1,285,149,1,435,0.00224719101123596
"065600614","BUENOS AIRES",214,1,111,99,1,211,0.00467289719626168
"068052614","BUENOS AIRES",37,0,28,7,1,36,0
"065530205","BUENOS AIRES",52,1,28,21,0,49,0.0192307692307692
"065320202","BUENOS AIRES",295,292,1,2,0,3,0.989830508474576
"065600115","BUENOS AIRES",275,0,121,129,1,251,0
"065601207","BUENOS AIRES",287,2,162,118,0,280,0.00696864111498258
"065601212","BUENOS AIRES",262,2,131,125,1,257,0.00763358778625954
"065600311","BUENOS AIRES",383,2,214,150,1,365,0.00522193211488251
"065390207","BUENOS AIRES",391,180,167,42,0,209,0.460358056265985
"065250106","BUENOS AIRES",317,91,113,110,0,223,0.287066246056782
"065250608","BUENOS AIRES",236,34,80,115,0,195,0.144067796610169
"065250403","BUENOS AIRES",228,0,38,158,2,198,0
"065250404","BUENOS AIRES",352,10,159,163,3,325,0.0284090909090909
"065250605","BUENOS AIRES",196,36,61,99,0,160,0.183673469387755
"065250606","BUENOS AIRES",497,400,38,36,0,74,0.804828973843058
"065250611","BUENOS AIRES",483,413,34,35,0,69,0.855072463768116
"065320102","BUENOS AIRES",377,368,3,6,0,9,0.976127320954907
"065320307","BUENOS AIRES",309,121,57,121,0,178,0.391585760517799
"065320310","BUENOS AIRES",277,35,60,177,2,239,0.126353790613718
"065321403","BUENOS AIRES",352,341,7,2,1,10,0.96875
"065321502","BUENOS AIRES",315,226,48,40,0,88,0.717460317460317
"065390201","BUENOS AIRES",238,6,138,91,0,229,0.0252100840336134
"065390504","BUENOS AIRES",343,322,18,2,0,20,0.938775510204082
"065390507","BUENOS AIRES",404,329,52,22,0,74,0.814356435643564
"065390509","BUENOS AIRES",418,386,27,4,0,31,0.923444976076555
"065390601","BUENOS AIRES",442,32,350,58,0,408,0.0723981900452489
"065390607","BUENOS AIRES",484,4,332,138,1,471,0.00826446280991736
"065390704","BUENOS AIRES",543,2,404,123,0,527,0.00368324125230203
"065390804","BUENOS AIRES",262,1,217,38,0,255,0.00381679389312977
"065390815","BUENOS AIRES",310,0,235,68,0,303,0
"065391003","BUENOS AIRES",354,0,202,141,1,344,0
"067560605","BUENOS AIRES",240,240,0,0,0,0,1
"065391116","BUENOS AIRES",409,0,309,94,1,404,0
"065391204","BUENOS AIRES",497,15,294,166,1,461,0.0301810865191147
"062311210","BUENOS AIRES",289,242,23,23,1,47,0.837370242214533
"067560604","BUENOS AIRES",134,134,0,0,0,0,1
"061050208","BUENOS AIRES",151,147,2,2,0,4,0.973509933774834
"061540205","BUENOS AIRES",133,0,96,35,0,131,0
"062450409","BUENOS AIRES",231,4,119,74,2,195,0.0173160173160173
"061051408","BUENOS AIRES",79,5,28,42,0,70,0.0632911392405063
"061120801","BUENOS AIRES",7,0,1,4,1,6,0
"061190203","BUENOS AIRES",112,0,59,49,2,110,0
"061190502","BUENOS AIRES",30,0,16,13,0,29,0
"061260516","BUENOS AIRES",349,1,62,266,7,335,0.00286532951289398
"061400310","BUENOS AIRES",192,129,15,23,2,40,0.671875
"066583603","BUENOS AIRES",367,16,154,169,0,323,0.0435967302452316
"061820702","BUENOS AIRES",199,6,69,118,1,188,0.0301507537688442
"062450309","BUENOS AIRES",392,230,33,73,14,120,0.586734693877551
"064060302","BUENOS AIRES",47,0,33,14,0,47,0
"064970402","BUENOS AIRES",60,0,47,13,0,60,0
"062520101","BUENOS AIRES",147,0,58,76,6,140,0
"062601712","BUENOS AIRES",108,103,4,1,0,5,0.953703703703704
"062660204","BUENOS AIRES",309,253,32,17,0,49,0.818770226537217
"062660602","BUENOS AIRES",223,4,167,51,0,218,0.0179372197309417
"064131902","BUENOS AIRES",165,2,74,84,2,160,0.0121212121212121
"062700106","BUENOS AIRES",169,6,142,17,2,161,0.0355029585798817
"062770106","BUENOS AIRES",45,2,28,14,0,42,0.0444444444444444
"063150302","BUENOS AIRES",105,3,48,51,3,102,0.0285714285714286
"067600803","BUENOS AIRES",386,373,4,4,0,8,0.966321243523316
"063850401","BUENOS AIRES",63,0,30,30,0,60,0
"064416521","BUENOS AIRES",113,2,79,32,0,111,0.0176991150442478
"064278412","BUENOS AIRES",401,2,91,278,2,371,0.00498753117206983
"064416811","BUENOS AIRES",111,0,52,53,3,108,0
"065391016","BUENOS AIRES",458,2,307,137,2,446,0.00436681222707424
"065681711","BUENOS AIRES",311,310,1,0,0,1,0.996784565916399
"065681803","BUENOS AIRES",178,175,3,0,0,3,0.98314606741573
"064416813","BUENOS AIRES",36,0,24,12,0,36,0
"065682607","BUENOS AIRES",412,18,258,131,0,389,0.0436893203883495
"064970815","BUENOS AIRES",318,0,185,131,0,316,0
"064971211","BUENOS AIRES",130,1,76,53,0,129,0.00769230769230769
"066160102","BUENOS AIRES",24,0,12,11,0,23,0
"066160105","BUENOS AIRES",26,0,7,18,0,25,0
"065391011","BUENOS AIRES",445,1,271,168,1,440,0.00224719101123596
"065470901","BUENOS AIRES",218,67,75,70,2,147,0.307339449541284
"067280904","BUENOS AIRES",224,2,107,113,0,220,0.00892857142857143
"066091101","BUENOS AIRES",13,0,6,7,0,13,0
"065530204","BUENOS AIRES",387,270,50,58,2,110,0.697674418604651
"065740707","BUENOS AIRES",22,0,6,16,0,22,0
"066650303","BUENOS AIRES",237,32,57,137,3,197,0.135021097046413
"066382305","BUENOS AIRES",6,0,0,6,0,6,0
"067140901","BUENOS AIRES",51,0,7,42,0,49,0
"067980708","BUENOS AIRES",413,354,12,44,0,56,0.857142857142857
"065951901","BUENOS AIRES",157,6,95,53,0,148,0.0382165605095541
"066232001","BUENOS AIRES",227,8,78,134,3,215,0.0352422907488987
"066232209","BUENOS AIRES",83,74,5,4,0,9,0.891566265060241
"066860805","BUENOS AIRES",33,0,12,18,2,32,0
"066232504","BUENOS AIRES",76,0,16,58,2,76,0
"065682009","BUENOS AIRES",409,408,1,0,0,1,0.997555012224939
"066380105","BUENOS AIRES",190,0,126,63,1,190,0
"066381102","BUENOS AIRES",147,1,24,117,2,143,0.00680272108843537
"066382004","BUENOS AIRES",25,5,20,0,0,20,0.2
"065682001","BUENOS AIRES",344,340,4,0,0,4,0.988372093023256
"067631903","BUENOS AIRES",65,30,16,19,0,35,0.461538461538462
"068540403","BUENOS AIRES",81,2,35,41,2,78,0.0246913580246914
"068821101","BUENOS AIRES",232,0,109,115,4,228,0
"060980401","BUENOS AIRES",55,3,33,12,4,49,0.0545454545454545
"065681403","BUENOS AIRES",447,253,150,42,0,192,0.565995525727069
"065681406","BUENOS AIRES",207,203,4,0,0,4,0.980676328502415
"065681510","BUENOS AIRES",305,299,4,2,0,6,0.980327868852459
"065682110","BUENOS AIRES",174,171,1,0,0,1,0.982758620689655
"065682112","BUENOS AIRES",246,245,1,0,0,1,0.995934959349594
"065682402","BUENOS AIRES",310,296,8,6,0,14,0.954838709677419
"065682509","BUENOS AIRES",316,15,91,202,0,293,0.0474683544303797
"065682512","BUENOS AIRES",403,9,298,95,0,393,0.0223325062034739
"065682606","BUENOS AIRES",218,54,135,26,0,161,0.247706422018349
"067632001","BUENOS AIRES",105,37,52,14,0,66,0.352380952380952
"067780109","BUENOS AIRES",241,1,96,132,1,229,0.004149377593361
"068260402","BUENOS AIRES",42,10,5,24,1,30,0.238095238095238
"068331901","BUENOS AIRES",272,4,43,210,4,257,0.0147058823529412
"065682806","BUENOS AIRES",353,0,255,95,1,351,0
"065682808","BUENOS AIRES",289,1,169,68,0,237,0.00346020761245675
"065682903","BUENOS AIRES",259,4,152,93,0,245,0.0154440154440154
"065682914","BUENOS AIRES",262,1,138,111,0,249,0.00381679389312977
"065683003","BUENOS AIRES",441,6,331,97,0,428,0.0136054421768707
"065683004","BUENOS AIRES",457,5,337,114,0,451,0.0109409190371991
"065740405","BUENOS AIRES",254,30,80,140,0,220,0.118110236220472
"065810104","BUENOS AIRES",381,367,5,8,0,13,0.963254593175853
"065810203","BUENOS AIRES",144,144,0,0,0,0,1
"065810401","BUENOS AIRES",360,340,9,11,0,20,0.944444444444444
"065810404","BUENOS AIRES",232,227,4,1,0,5,0.978448275862069
"065810801","BUENOS AIRES",188,4,93,88,3,184,0.0212765957446809
"068052311","BUENOS AIRES",212,0,129,75,0,204,0
"065811410","BUENOS AIRES",268,148,31,87,0,118,0.552238805970149
"065811412","BUENOS AIRES",395,294,23,76,0,99,0.744303797468354
"065811506","BUENOS AIRES",279,209,22,44,0,66,0.74910394265233
"065811510","BUENOS AIRES",307,286,4,17,0,21,0.931596091205212
"065811702","BUENOS AIRES",238,233,5,0,0,5,0.978991596638655
"065811905","BUENOS AIRES",269,181,31,55,0,86,0.672862453531598
"065880111","BUENOS AIRES",416,372,24,20,0,44,0.894230769230769
"065811908","BUENOS AIRES",351,283,20,47,1,68,0.806267806267806
"065880103","BUENOS AIRES",381,339,17,24,0,41,0.889763779527559
"065880109","BUENOS AIRES",233,138,50,38,6,94,0.592274678111588
"063574705","BUENOS AIRES",348,346,2,0,0,2,0.994252873563218
"065881012","BUENOS AIRES",137,5,65,65,0,130,0.0364963503649635
"065881401","BUENOS AIRES",101,2,39,60,0,99,0.0198019801980198
"065881602","BUENOS AIRES",336,227,68,40,1,109,0.675595238095238
"065881704","BUENOS AIRES",318,242,21,52,2,75,0.761006289308176
"065881706","BUENOS AIRES",326,321,2,3,0,5,0.984662576687117
"065881707","BUENOS AIRES",237,234,1,0,0,1,0.987341772151899
"065881708","BUENOS AIRES",211,204,2,5,0,7,0.966824644549763
"065950109","BUENOS AIRES",260,2,124,132,2,258,0.00769230769230769
"065950205","BUENOS AIRES",224,223,0,1,0,1,0.995535714285714
"065950207","BUENOS AIRES",305,302,3,0,0,3,0.99016393442623
"065950411","BUENOS AIRES",243,7,116,117,0,233,0.0288065843621399
"068260403","BUENOS AIRES",281,221,23,37,0,60,0.786476868327402
"065951907","BUENOS AIRES",105,1,60,43,0,103,0.00952380952380952
"065952001","BUENOS AIRES",256,15,141,100,0,241,0.05859375
"065952502","BUENOS AIRES",262,237,16,9,0,25,0.904580152671756
"065952602","BUENOS AIRES",421,11,248,156,1,405,0.0261282660332542
"065952609","BUENOS AIRES",247,5,70,168,1,239,0.0202429149797571
"066440306","BUENOS AIRES",49,2,20,27,0,47,0.0408163265306122
"065952702","BUENOS AIRES",444,217,190,35,0,225,0.488738738738739
"065952710","BUENOS AIRES",193,3,101,89,0,190,0.0155440414507772
"068330801","BUENOS AIRES",23,0,3,20,0,23,0
"066020308","BUENOS AIRES",437,153,155,116,0,271,0.350114416475973
"066020806","BUENOS AIRES",15,0,1,12,1,14,0
"066021108","BUENOS AIRES",429,410,13,5,0,18,0.955710955710956
"066021110","BUENOS AIRES",10,1,0,9,0,9,0.1
"066021604","BUENOS AIRES",229,141,47,34,0,81,0.615720524017467
"066021606","BUENOS AIRES",300,224,51,18,1,70,0.746666666666667
"066021607","BUENOS AIRES",279,220,44,15,0,59,0.788530465949821
"066090101","BUENOS AIRES",408,208,107,89,0,196,0.509803921568627
"066090203","BUENOS AIRES",204,198,2,4,0,6,0.970588235294118
"066090205","BUENOS AIRES",329,48,217,64,0,281,0.145896656534954
"066580502","BUENOS AIRES",171,170,1,0,0,1,0.994152046783626
"066090213","BUENOS AIRES",433,12,197,219,0,416,0.0277136258660508
"066090401","BUENOS AIRES",90,0,8,81,0,89,0
"066090613","BUENOS AIRES",71,1,51,17,1,69,0.0140845070422535
"066160301","BUENOS AIRES",230,194,13,23,0,36,0.843478260869565
"066230103","BUENOS AIRES",400,359,13,23,0,36,0.8975
"066230104","BUENOS AIRES",364,308,16,22,0,38,0.846153846153846
"066230202","BUENOS AIRES",247,239,6,0,2,8,0.967611336032389
"066230307","BUENOS AIRES",257,257,0,0,0,0,1
"066230405","BUENOS AIRES",332,311,10,9,0,19,0.936746987951807
"066230406","BUENOS AIRES",404,367,29,8,0,37,0.908415841584158
"066230409","BUENOS AIRES",302,220,28,50,0,78,0.728476821192053
"066380504","BUENOS AIRES",57,57,0,0,0,0,1
"066230506","BUENOS AIRES",405,318,16,66,1,83,0.785185185185185
"067491406","BUENOS AIRES",327,302,4,13,0,17,0.923547400611621
"020132205","CABA",394,394,0,0,0,0,1
"066230903","BUENOS AIRES",95,0,52,43,0,95,0
"066232005","BUENOS AIRES",294,116,16,151,7,174,0.394557823129252
"066232010","BUENOS AIRES",258,148,43,58,1,102,0.573643410852713
"066232207","BUENOS AIRES",328,245,49,33,1,83,0.746951219512195
"068540211","BUENOS AIRES",261,86,37,137,0,174,0.329501915708812
"066232807","BUENOS AIRES",345,261,28,50,3,81,0.756521739130435
"066232808","BUENOS AIRES",363,183,97,80,1,178,0.504132231404959
"066232909","BUENOS AIRES",274,112,48,106,1,155,0.408759124087591
"066380503","BUENOS AIRES",84,42,41,1,0,42,0.5
"066580503","BUENOS AIRES",299,297,0,0,0,0,0.993311036789298
"066232911","BUENOS AIRES",230,82,73,65,3,141,0.356521739130435
"066380104","BUENOS AIRES",107,0,57,44,0,101,0
"068610305","BUENOS AIRES",280,279,1,0,0,1,0.996428571428571
"066380203","BUENOS AIRES",252,2,157,82,1,240,0.00793650793650794
"066380301","BUENOS AIRES",380,1,153,160,4,317,0.00263157894736842
"066380304","BUENOS AIRES",533,6,207,286,4,497,0.0112570356472795
"066380308","BUENOS AIRES",142,141,1,0,0,1,0.992957746478873
"066380409","BUENOS AIRES",248,4,182,62,0,244,0.0161290322580645
"066380410","BUENOS AIRES",291,0,230,59,2,291,0
"066380601","BUENOS AIRES",387,2,258,123,2,383,0.00516795865633075
"066380609","BUENOS AIRES",154,0,132,22,0,154,0
"066380701","BUENOS AIRES",528,2,129,373,4,506,0.00378787878787879
"066380708","BUENOS AIRES",215,0,151,64,0,215,0
"066380810","BUENOS AIRES",199,0,128,68,0,196,0
"066380906","BUENOS AIRES",403,2,243,150,3,396,0.00496277915632754
"066380910","BUENOS AIRES",362,1,204,139,0,343,0.00276243093922652
"066381107","BUENOS AIRES",372,5,271,92,2,365,0.0134408602150538
"066381708","BUENOS AIRES",352,350,1,1,0,2,0.994318181818182
"066381204","BUENOS AIRES",94,0,74,20,0,94,0
"066381208","BUENOS AIRES",15,14,1,0,0,1,0.933333333333333
"066381307","BUENOS AIRES",484,1,315,153,5,473,0.00206611570247934
"066381313","BUENOS AIRES",387,319,46,13,0,59,0.824289405684755
"066381317","BUENOS AIRES",112,1,86,24,0,110,0.00892857142857143
"066381404","BUENOS AIRES",280,0,114,130,1,245,0
"066381408","BUENOS AIRES",355,28,141,174,1,316,0.0788732394366197
"066381507","BUENOS AIRES",474,140,139,153,1,293,0.29535864978903
"066381606","BUENOS AIRES",319,234,39,44,0,83,0.733542319749216
"066381703","BUENOS AIRES",327,190,74,61,0,135,0.581039755351682
"066381706","BUENOS AIRES",193,186,3,4,0,7,0.963730569948187
"066381714","BUENOS AIRES",340,330,8,1,0,9,0.970588235294118
"066510107","BUENOS AIRES",183,7,141,35,0,176,0.0382513661202186
"066381805","BUENOS AIRES",149,1,85,62,0,147,0.00671140939597315
"066382005","BUENOS AIRES",221,3,80,129,2,211,0.0135746606334842
"066382204","BUENOS AIRES",393,1,131,248,1,380,0.00254452926208651
"066382101","BUENOS AIRES",114,2,42,66,0,108,0.0175438596491228
"066382211","BUENOS AIRES",170,0,66,94,3,163,0
"066440109","BUENOS AIRES",12,8,0,4,0,4,0.666666666666667
"066440207","BUENOS AIRES",99,37,53,9,0,62,0.373737373737374
"066440615","BUENOS AIRES",243,9,122,109,0,231,0.037037037037037
"067000214","BUENOS AIRES",305,285,13,7,0,20,0.934426229508197
"066440307","BUENOS AIRES",92,1,79,10,0,89,0.0108695652173913
"066440311","BUENOS AIRES",58,0,52,6,0,58,0
"066440406","BUENOS AIRES",26,3,16,6,0,22,0.115384615384615
"066440501","BUENOS AIRES",42,6,31,4,0,35,0.142857142857143
"066440512","BUENOS AIRES",79,72,3,0,0,3,0.911392405063291
"066440513","BUENOS AIRES",35,35,0,0,0,0,1
"066440604","BUENOS AIRES",121,78,24,14,0,38,0.644628099173554
"066440605","BUENOS AIRES",91,68,17,6,0,23,0.747252747252747
"066440609","BUENOS AIRES",235,16,126,90,0,216,0.0680851063829787
"066440616","BUENOS AIRES",120,6,86,27,1,114,0.05
"066440617","BUENOS AIRES",57,5,49,3,0,52,0.087719298245614
"066480101","BUENOS AIRES",360,2,220,131,1,352,0.00555555555555556
"066480111","BUENOS AIRES",348,4,211,124,2,337,0.0114942528735632
"066480117","BUENOS AIRES",274,0,130,129,2,261,0
"066480213","BUENOS AIRES",404,9,309,80,1,390,0.0222772277227723
"066480307","BUENOS AIRES",233,1,89,121,6,216,0.00429184549356223
"066480308","BUENOS AIRES",449,6,172,240,6,418,0.0133630289532294
"066480404","BUENOS AIRES",318,0,123,176,0,299,0
"066480510","BUENOS AIRES",255,7,161,81,2,244,0.0274509803921569
"020131508","CABA",372,372,0,0,0,0,1
"066510109","BUENOS AIRES",227,15,145,67,0,212,0.066079295154185
"066510504","BUENOS AIRES",211,12,102,96,1,199,0.0568720379146919
"066510701","BUENOS AIRES",141,6,113,21,0,134,0.0425531914893617
"066511308","BUENOS AIRES",122,3,97,20,2,119,0.0245901639344262
"066550203","BUENOS AIRES",220,204,6,6,0,12,0.927272727272727
"066550205","BUENOS AIRES",233,176,26,28,2,56,0.755364806866953
"066550305","BUENOS AIRES",65,0,32,33,0,65,0
"066580102","BUENOS AIRES",378,362,8,8,0,16,0.957671957671958
"066580112","BUENOS AIRES",50,0,1,44,0,45,0
"066580404","BUENOS AIRES",271,67,69,132,1,202,0.247232472324723
"066581402","BUENOS AIRES",65,2,13,44,1,58,0.0307692307692308
"066580405","BUENOS AIRES",284,282,0,2,0,2,0.992957746478873
"066580707","BUENOS AIRES",272,247,2,1,0,3,0.908088235294118
"066580907","BUENOS AIRES",195,194,1,0,0,1,0.994871794871795
"066581012","BUENOS AIRES",427,28,71,247,35,353,0.0655737704918033
"066581110","BUENOS AIRES",306,305,0,1,0,1,0.996732026143791
"066581213","BUENOS AIRES",264,263,0,1,0,1,0.996212121212121
"066581303","BUENOS AIRES",109,6,7,96,0,103,0.055045871559633
"066581309","BUENOS AIRES",268,17,37,207,1,245,0.0634328358208955
"066581401","BUENOS AIRES",152,3,6,114,13,133,0.0197368421052632
"066582009","BUENOS AIRES",566,492,20,47,0,67,0.869257950530035
"066581403","BUENOS AIRES",81,3,7,54,3,64,0.037037037037037
"066581404","BUENOS AIRES",188,0,39,140,3,182,0
"066581408","BUENOS AIRES",217,5,29,158,6,193,0.0230414746543779
"066581505","BUENOS AIRES",371,263,11,87,0,98,0.708894878706199
"066581510","BUENOS AIRES",233,231,2,0,0,2,0.991416309012876
"066581612","BUENOS AIRES",253,245,1,5,0,6,0.968379446640316
"066581709","BUENOS AIRES",364,362,2,0,0,2,0.994505494505495
"066581811","BUENOS AIRES",247,245,1,0,0,1,0.991902834008097
"066581904","BUENOS AIRES",193,178,0,0,0,0,0.922279792746114
"066581908","BUENOS AIRES",276,275,1,0,0,1,0.996376811594203
"066581910","BUENOS AIRES",277,269,6,1,0,7,0.971119133574007
"066581911","BUENOS AIRES",305,257,7,10,0,17,0.842622950819672
"066582001","BUENOS AIRES",301,265,1,1,0,2,0.880398671096346
"066582105","BUENOS AIRES",392,281,25,45,0,70,0.716836734693878
"066582106","BUENOS AIRES",469,426,17,17,0,34,0.908315565031983
"066582114","BUENOS AIRES",366,216,56,91,0,147,0.590163934426229
"066582207","BUENOS AIRES",298,280,0,0,0,0,0.939597315436242
"066582309","BUENOS AIRES",371,113,52,195,2,249,0.304582210242588
"066582407","BUENOS AIRES",323,319,2,0,0,2,0.987616099071207
"066582704","BUENOS AIRES",125,15,20,88,0,108,0.12
"066582901","BUENOS AIRES",432,396,10,22,0,32,0.916666666666667
"066582905","BUENOS AIRES",345,314,13,14,0,27,0.910144927536232
"066583004","BUENOS AIRES",262,256,5,1,0,6,0.977099236641221
"066583009","BUENOS AIRES",457,41,127,271,2,400,0.0897155361050328
"066583204","BUENOS AIRES",193,191,1,1,0,2,0.989637305699482
"066583207","BUENOS AIRES",523,482,27,10,1,38,0.921606118546845
"066583304","BUENOS AIRES",352,13,33,273,4,310,0.0369318181818182
"066583403","BUENOS AIRES",326,16,120,185,0,305,0.049079754601227
"066583404","BUENOS AIRES",333,12,93,223,1,317,0.036036036036036
"066583608","BUENOS AIRES",293,15,99,171,0,270,0.0511945392491468
"066583614","BUENOS AIRES",310,49,84,144,1,229,0.158064516129032
"066583704","BUENOS AIRES",233,7,29,179,1,209,0.0300429184549356
"066583710","BUENOS AIRES",272,10,141,120,0,261,0.0367647058823529
"066583811","BUENOS AIRES",522,241,51,192,14,257,0.461685823754789
"066584009","BUENOS AIRES",195,4,93,80,0,173,0.0205128205128205
"066584016","BUENOS AIRES",339,3,172,148,0,320,0.00884955752212389
"066584303","BUENOS AIRES",498,25,212,241,1,454,0.0502008032128514
"066584304","BUENOS AIRES",480,9,52,349,31,432,0.01875
"066584310","BUENOS AIRES",232,2,112,107,5,224,0.00862068965517241
"066584311","BUENOS AIRES",363,10,133,211,0,344,0.0275482093663912
"067490802","BUENOS AIRES",178,111,53,12,0,65,0.623595505617977
"066584406","BUENOS AIRES",349,40,206,99,1,306,0.114613180515759
"066584411","BUENOS AIRES",503,8,203,272,3,478,0.0159045725646123
"066584413","BUENOS AIRES",145,3,36,78,12,126,0.0206896551724138
"066584414","BUENOS AIRES",187,0,41,133,3,177,0
"066650101","BUENOS AIRES",239,2,144,89,0,233,0.00836820083682008
"066650203","BUENOS AIRES",401,392,3,6,0,9,0.977556109725686
"066650205","BUENOS AIRES",451,391,10,36,3,49,0.866962305986696
"066650401","BUENOS AIRES",123,2,50,68,3,121,0.016260162601626
"067491411","BUENOS AIRES",97,88,4,0,0,4,0.907216494845361
"066860202","BUENOS AIRES",142,2,78,61,1,140,0.0140845070422535
"066721203","BUENOS AIRES",333,314,5,12,0,17,0.942942942942943
"066930307","BUENOS AIRES",434,42,286,105,1,392,0.0967741935483871
"064273311","BUENOS AIRES",327,324,3,0,0,3,0.990825688073395
"066721206","BUENOS AIRES",346,332,10,4,0,14,0.959537572254335
"066790603","BUENOS AIRES",238,139,42,56,0,98,0.584033613445378
"063574709","BUENOS AIRES",300,300,0,0,0,0,1
"066790605","BUENOS AIRES",389,318,46,23,0,69,0.817480719794344
"066790607","BUENOS AIRES",264,184,25,51,2,78,0.696969696969697
"066790609","BUENOS AIRES",244,128,85,31,0,116,0.524590163934426
"066860105","BUENOS AIRES",281,269,6,6,0,12,0.95729537366548
"066861302","BUENOS AIRES",198,41,22,128,0,150,0.207070707070707
"066861307","BUENOS AIRES",234,187,14,33,0,47,0.799145299145299
"066930309","BUENOS AIRES",180,121,52,7,0,59,0.672222222222222
"067000213","BUENOS AIRES",296,283,6,6,1,13,0.956081081081081
"067000206","BUENOS AIRES",227,207,20,0,0,20,0.911894273127753
"063574804","BUENOS AIRES",147,144,1,1,1,3,0.979591836734694
"067000606","BUENOS AIRES",183,3,133,46,1,180,0.0163934426229508
"067000701","BUENOS AIRES",199,0,120,77,2,199,0
"067001205","BUENOS AIRES",182,169,4,8,0,12,0.928571428571429
"067070102","BUENOS AIRES",458,360,43,47,0,90,0.786026200873362
"067070108","BUENOS AIRES",227,217,3,2,0,5,0.955947136563877
"067071109","BUENOS AIRES",218,207,7,4,0,11,0.94954128440367
"067140101","BUENOS AIRES",408,295,48,64,0,112,0.723039215686274
"067140109","BUENOS AIRES",298,297,0,1,0,1,0.996644295302013
"067140112","BUENOS AIRES",298,285,4,9,0,13,0.956375838926175
"067140601","BUENOS AIRES",330,225,57,41,0,98,0.681818181818182
"067490801","BUENOS AIRES",272,232,15,23,2,40,0.852941176470588
"067140602","BUENOS AIRES",339,305,14,15,1,30,0.899705014749263
"067140604","BUENOS AIRES",256,2,112,127,3,242,0.0078125
"067140613","BUENOS AIRES",471,109,153,196,7,356,0.231422505307856
"067140809","BUENOS AIRES",195,0,84,107,1,192,0
"067281008","BUENOS AIRES",186,48,71,64,0,135,0.258064516129032
"067281015","BUENOS AIRES",194,110,58,26,0,84,0.56701030927835
"067281018","BUENOS AIRES",248,100,68,78,1,147,0.403225806451613
"067350110","BUENOS AIRES",403,105,125,173,0,298,0.260545905707196
"067350708","BUENOS AIRES",344,51,138,155,0,293,0.148255813953488
"067490401","BUENOS AIRES",91,72,2,17,0,19,0.791208791208791
"067490406","BUENOS AIRES",265,264,0,1,0,1,0.99622641509434
"067490507","BUENOS AIRES",195,195,0,0,0,0,1
"067490511","BUENOS AIRES",145,136,5,3,0,8,0.937931034482759
"067490603","BUENOS AIRES",348,345,2,0,0,2,0.991379310344828
"067490605","BUENOS AIRES",306,306,0,0,0,0,1
"067490709","BUENOS AIRES",238,125,28,77,1,106,0.525210084033613
"067490911","BUENOS AIRES",409,286,49,56,0,105,0.699266503667482
"067490913","BUENOS AIRES",128,83,10,21,2,33,0.6484375
"067491004","BUENOS AIRES",380,341,27,8,0,35,0.897368421052632
"067491009","BUENOS AIRES",289,107,92,86,0,178,0.370242214532872
"067491106","BUENOS AIRES",216,202,11,2,0,13,0.935185185185185
"067491107","BUENOS AIRES",330,319,2,4,0,6,0.966666666666667
"067491206","BUENOS AIRES",273,235,21,9,1,31,0.860805860805861
"067491207","BUENOS AIRES",286,28,77,172,5,254,0.0979020979020979
"067491303","BUENOS AIRES",265,259,2,1,0,3,0.977358490566038
"067491309","BUENOS AIRES",266,244,8,8,1,17,0.917293233082707
"067491414","BUENOS AIRES",414,345,20,10,0,30,0.833333333333333
"067491415","BUENOS AIRES",355,310,25,17,0,42,0.873239436619718
"067491416","BUENOS AIRES",320,238,19,31,0,50,0.74375
"067560106","BUENOS AIRES",257,251,5,1,0,6,0.976653696498054
"067630615","BUENOS AIRES",426,7,240,162,2,404,0.0164319248826291
"067560107","BUENOS AIRES",443,443,0,0,0,0,1
"067560112","BUENOS AIRES",330,327,2,1,0,3,0.990909090909091
"067562307","BUENOS AIRES",385,350,27,8,0,35,0.909090909090909
"020131506","CABA",281,281,0,0,0,0,1
"067560304","BUENOS AIRES",250,248,2,0,0,2,0.992
"067560305","BUENOS AIRES",140,139,1,0,0,1,0.992857142857143
"067560505","BUENOS AIRES",232,232,0,0,0,0,1
"067560406","BUENOS AIRES",223,223,0,0,0,0,1
"067560804","BUENOS AIRES",367,361,0,4,0,4,0.983651226158038
"067561008","BUENOS AIRES",245,245,0,0,0,0,1
"067561103","BUENOS AIRES",294,294,0,0,0,0,1
"067561402","BUENOS AIRES",704,439,26,209,9,244,0.623579545454545
"067600316","BUENOS AIRES",132,106,17,9,0,26,0.803030303030303
"067561415","BUENOS AIRES",278,247,21,10,0,31,0.888489208633094
"067561501","BUENOS AIRES",401,373,20,8,0,28,0.930174563591022
"064412614","BUENOS AIRES",273,271,2,0,0,2,0.992673992673993
"067561505","BUENOS AIRES",399,359,25,13,0,38,0.899749373433584
"067561611","BUENOS AIRES",334,312,12,9,0,21,0.934131736526946
"067561612","BUENOS AIRES",262,245,11,6,0,17,0.935114503816794
"067561613","BUENOS AIRES",290,210,66,14,0,80,0.724137931034483
"067561805","BUENOS AIRES",224,187,1,1,0,2,0.834821428571429
"067561807","BUENOS AIRES",206,205,1,0,0,1,0.995145631067961
"067561901","BUENOS AIRES",385,370,12,2,0,14,0.961038961038961
"067562009","BUENOS AIRES",306,296,6,4,0,10,0.967320261437909
"067562104","BUENOS AIRES",436,406,26,4,0,30,0.931192660550459
"067562210","BUENOS AIRES",293,14,118,157,0,275,0.0477815699658703
"067562411","BUENOS AIRES",392,388,1,1,0,2,0.989795918367347
"067562413","BUENOS AIRES",352,345,5,1,0,6,0.980113636363636
"067562512","BUENOS AIRES",387,49,232,102,0,334,0.126614987080103
"067562606","BUENOS AIRES",363,332,24,6,0,30,0.914600550964187
"067562705","BUENOS AIRES",420,376,12,11,2,25,0.895238095238095
"067562707","BUENOS AIRES",224,6,137,81,0,218,0.0267857142857143
"067562710","BUENOS AIRES",255,8,137,108,0,245,0.0313725490196078
"067600103","BUENOS AIRES",385,283,74,28,0,102,0.735064935064935
"060352003","BUENOS AIRES",438,433,3,2,0,5,0.988584474885845
"067600302","BUENOS AIRES",501,472,21,8,0,29,0.942115768463074
"067600317","BUENOS AIRES",328,278,35,11,0,46,0.847560975609756
"067600505","BUENOS AIRES",397,342,35,14,0,49,0.861460957178841
"067600605","BUENOS AIRES",300,248,44,7,0,51,0.826666666666667
"067600701","BUENOS AIRES",571,292,105,166,2,273,0.51138353765324
"067600804","BUENOS AIRES",367,358,5,3,0,8,0.975476839237057
"067601010","BUENOS AIRES",82,4,45,30,0,75,0.0487804878048781
"067601013","BUENOS AIRES",378,3,191,171,0,362,0.00793650793650794
"067601014","BUENOS AIRES",389,6,251,114,0,365,0.0154241645244216
"067601107","BUENOS AIRES",396,8,208,172,0,380,0.0202020202020202
"067601116","BUENOS AIRES",150,1,119,26,0,145,0.00666666666666667
"067630705","BUENOS AIRES",308,29,189,90,0,279,0.0941558441558442
"067601204","BUENOS AIRES",229,117,93,18,0,111,0.510917030567686
"067601206","BUENOS AIRES",207,66,113,28,0,141,0.318840579710145
"067601214","BUENOS AIRES",338,0,193,132,1,326,0
"067601305","BUENOS AIRES",306,5,183,114,1,298,0.0163398692810458
"067601308","BUENOS AIRES",272,3,154,105,2,261,0.0110294117647059
"067601313","BUENOS AIRES",259,3,171,85,0,256,0.0115830115830116
"067601315","BUENOS AIRES",411,3,237,160,1,398,0.0072992700729927
"067601501","BUENOS AIRES",325,6,200,118,0,318,0.0184615384615385
"067601509","BUENOS AIRES",427,1,128,277,6,411,0.00234192037470726
"067700107","BUENOS AIRES",379,362,6,11,0,17,0.955145118733509
"067601513","BUENOS AIRES",303,8,234,61,0,295,0.0264026402640264
"067601516","BUENOS AIRES",205,0,142,58,0,200,0
"067601611","BUENOS AIRES",234,0,161,68,0,229,0
"067601711","BUENOS AIRES",274,3,193,69,0,262,0.0109489051094891
"067601714","BUENOS AIRES",278,12,177,83,0,260,0.0431654676258993
"067601716","BUENOS AIRES",240,6,115,116,2,233,0.025
"067630111","BUENOS AIRES",354,351,2,1,0,3,0.991525423728814
"067630205","BUENOS AIRES",427,416,6,2,1,9,0.97423887587822
"067630208","BUENOS AIRES",162,162,0,0,0,0,1
"067630211","BUENOS AIRES",351,344,5,0,1,6,0.98005698005698
"067630212","BUENOS AIRES",169,169,0,0,0,0,1
"067630503","BUENOS AIRES",252,244,0,8,0,8,0.968253968253968
"067630505","BUENOS AIRES",249,82,94,67,2,163,0.329317269076305
"067630506","BUENOS AIRES",362,130,134,92,0,226,0.359116022099448
"067630515","BUENOS AIRES",273,264,7,2,0,9,0.967032967032967
"067630517","BUENOS AIRES",271,101,115,48,0,163,0.372693726937269
"067630711","BUENOS AIRES",519,11,205,278,2,485,0.0211946050096339
"067630802","BUENOS AIRES",320,5,158,149,1,308,0.015625
"067630805","BUENOS AIRES",307,3,153,149,0,302,0.00977198697068404
"067630811","BUENOS AIRES",302,6,169,116,1,286,0.0198675496688742
"067631102","BUENOS AIRES",399,260,67,64,3,134,0.651629072681704
"067631705","BUENOS AIRES",275,166,84,25,0,109,0.603636363636364
"067631706","BUENOS AIRES",317,153,87,73,2,162,0.482649842271293
"068400801","BUENOS AIRES",301,288,6,7,0,13,0.956810631229236
"067631803","BUENOS AIRES",352,8,172,171,0,343,0.0227272727272727
"067700110","BUENOS AIRES",259,215,18,26,0,44,0.83011583011583
"067632006","BUENOS AIRES",368,353,7,8,0,15,0.959239130434783
"067632007","BUENOS AIRES",155,143,8,3,0,11,0.92258064516129
"067632008","BUENOS AIRES",393,379,2,9,0,11,0.964376590330789
"067912005","BUENOS AIRES",306,276,18,11,0,29,0.901960784313726
"067700206","BUENOS AIRES",198,90,44,60,0,104,0.454545454545455
"067702107","BUENOS AIRES",415,404,4,3,0,7,0.973493975903614
"067702110","BUENOS AIRES",266,262,2,1,0,3,0.984962406015038
"067780205","BUENOS AIRES",392,48,200,137,2,339,0.122448979591837
"067780206","BUENOS AIRES",256,169,43,43,0,86,0.66015625
"067780209","BUENOS AIRES",360,305,18,33,0,51,0.847222222222222
"067780211","BUENOS AIRES",184,111,38,29,1,68,0.603260869565217
"067780213","BUENOS AIRES",175,19,46,94,1,141,0.108571428571429
"067780401","BUENOS AIRES",19,2,9,8,0,17,0.105263157894737
"067781004","BUENOS AIRES",308,274,19,14,0,33,0.88961038961039
"067780906","BUENOS AIRES",357,31,234,87,1,322,0.0868347338935574
"067910213","BUENOS AIRES",345,334,8,3,0,11,0.968115942028986
"068470109","BUENOS AIRES",10,0,4,5,0,9,0
"067780909","BUENOS AIRES",248,171,45,25,0,70,0.689516129032258
"067780913","BUENOS AIRES",307,275,17,14,0,31,0.895765472312704
"067781003","BUENOS AIRES",258,73,45,117,6,168,0.282945736434109
"067910106","BUENOS AIRES",302,291,4,7,0,11,0.963576158940397
"067910206","BUENOS AIRES",370,361,4,5,0,9,0.975675675675676
"067910207","BUENOS AIRES",291,269,5,6,0,11,0.924398625429553
"067910212","BUENOS AIRES",299,297,1,1,0,2,0.993311036789298
"067910307","BUENOS AIRES",387,380,2,5,0,7,0.981912144702842
"067910308","BUENOS AIRES",244,244,0,0,0,0,1
"067910310","BUENOS AIRES",404,392,8,3,0,11,0.97029702970297
"067910408","BUENOS AIRES",274,274,0,0,0,0,1
"067910409","BUENOS AIRES",191,187,3,1,0,4,0.979057591623037
"067910410","BUENOS AIRES",200,198,1,1,0,2,0.99
"067910412","BUENOS AIRES",193,192,1,0,0,1,0.994818652849741
"067911208","BUENOS AIRES",422,375,19,27,0,46,0.888625592417062
"067911211","BUENOS AIRES",225,194,18,11,0,29,0.862222222222222
"067911804","BUENOS AIRES",253,248,2,3,0,5,0.980237154150198
"067912009","BUENOS AIRES",333,315,12,6,0,18,0.945945945945946
"067912102","BUENOS AIRES",361,5,112,240,0,352,0.0138504155124654
"067912201","BUENOS AIRES",131,17,37,77,0,114,0.129770992366412
"068050101","BUENOS AIRES",214,4,104,94,2,200,0.0186915887850467
"067980501","BUENOS AIRES",49,0,16,27,6,49,0
"067981001","BUENOS AIRES",20,0,9,11,0,20,0
"068402003","BUENOS AIRES",378,365,7,1,0,8,0.965608465608466
"068050107","BUENOS AIRES",247,218,26,2,1,29,0.882591093117409
"068050305","BUENOS AIRES",453,198,66,154,2,222,0.437086092715232
"068050308","BUENOS AIRES",220,219,1,0,0,1,0.995454545454545
"068261704","BUENOS AIRES",6,0,4,2,0,6,0
"068050502","BUENOS AIRES",346,338,3,5,0,8,0.976878612716763
"068050513","BUENOS AIRES",387,97,145,137,0,282,0.250645994832041
"068050702","BUENOS AIRES",285,260,13,10,0,23,0.912280701754386
"068051507","BUENOS AIRES",404,2,307,93,0,400,0.00495049504950495
"068050703","BUENOS AIRES",349,244,45,60,0,105,0.699140401146132
"068050804","BUENOS AIRES",249,230,17,2,0,19,0.923694779116466
"068050806","BUENOS AIRES",291,226,34,29,0,63,0.776632302405498
"068050809","BUENOS AIRES",474,21,161,248,7,416,0.0443037974683544
"061610115","BUENOS AIRES",148,148,0,0,0,0,1
"068050904","BUENOS AIRES",611,18,315,263,1,579,0.0294599018003273
"068052202","BUENOS AIRES",499,5,202,258,2,462,0.0100200400801603
"068820206","BUENOS AIRES",258,258,0,0,0,0,1
"068050906","BUENOS AIRES",585,568,13,2,2,17,0.970940170940171
"068051108","BUENOS AIRES",565,44,161,310,6,477,0.0778761061946903
"068051202","BUENOS AIRES",321,10,146,159,4,309,0.0311526479750779
"068051206","BUENOS AIRES",232,8,175,49,0,224,0.0344827586206897
"068051211","BUENOS AIRES",349,1,277,70,0,347,0.00286532951289398
"068051213","BUENOS AIRES",281,3,229,49,0,278,0.0106761565836299
"068051306","BUENOS AIRES",277,10,164,95,1,260,0.036101083032491
"068051310","BUENOS AIRES",242,5,120,110,0,230,0.0206611570247934
"068051316","BUENOS AIRES",380,6,293,79,0,372,0.0157894736842105
"068051401","BUENOS AIRES",403,5,166,211,1,378,0.0124069478908189
"068051405","BUENOS AIRES",484,8,306,165,0,471,0.0165289256198347
"068051601","BUENOS AIRES",448,10,151,254,0,405,0.0223214285714286
"068051910","BUENOS AIRES",227,10,172,44,0,216,0.0440528634361234
"068051901","BUENOS AIRES",259,5,156,95,0,251,0.0193050193050193
"068051902","BUENOS AIRES",274,4,251,18,0,269,0.0145985401459854
"068052008","BUENOS AIRES",285,105,75,99,1,175,0.368421052631579
"068052013","BUENOS AIRES",318,19,140,152,0,292,0.059748427672956
"068052106","BUENOS AIRES",345,11,169,153,0,322,0.0318840579710145
"068400811","BUENOS AIRES",315,314,1,0,0,1,0.996825396825397
"068052114","BUENOS AIRES",307,1,160,141,1,302,0.00325732899022801
"068052406","BUENOS AIRES",226,0,121,101,0,222,0
"068052203","BUENOS AIRES",482,7,207,228,21,456,0.0145228215767635
"068052207","BUENOS AIRES",381,10,185,166,4,355,0.026246719160105
"068052208","BUENOS AIRES",340,7,272,58,0,330,0.0205882352941176
"068052306","BUENOS AIRES",333,1,249,83,0,332,0.003003003003003
"068052312","BUENOS AIRES",1326,48,650,555,5,1210,0.0361990950226244
"068260101","BUENOS AIRES",627,497,29,92,2,123,0.792663476874003
"068052315","BUENOS AIRES",362,0,114,217,6,337,0
"068260208","BUENOS AIRES",152,150,1,1,0,2,0.986842105263158
"068052506","BUENOS AIRES",460,1,270,179,3,452,0.00217391304347826
"060280206","BUENOS AIRES",337,0,68,255,3,326,0
"068190403","BUENOS AIRES",283,251,10,20,1,31,0.886925795053004
"068190911","BUENOS AIRES",147,1,85,59,1,145,0.00680272108843537
"068190901","BUENOS AIRES",60,0,52,8,0,60,0
"068190905","BUENOS AIRES",170,4,131,26,0,157,0.0235294117647059
"068190912","BUENOS AIRES",166,1,129,35,0,164,0.00602409638554217
"068401907","BUENOS AIRES",282,273,5,4,0,9,0.968085106382979
"068260109","BUENOS AIRES",189,171,10,8,0,18,0.904761904761905
"068260113","BUENOS AIRES",228,208,10,7,1,18,0.912280701754386
"068260206","BUENOS AIRES",150,137,5,8,0,13,0.913333333333333
"068260209","BUENOS AIRES",270,256,11,2,0,13,0.948148148148148
"068260210","BUENOS AIRES",158,151,2,5,0,7,0.955696202531646
"068330109","BUENOS AIRES",323,291,7,25,0,32,0.900928792569659
"068261907","BUENOS AIRES",179,165,5,9,0,14,0.921787709497207
"068330101","BUENOS AIRES",215,199,8,8,0,16,0.925581395348837
"068330110","BUENOS AIRES",373,350,11,12,0,23,0.938337801608579
"068330209","BUENOS AIRES",266,266,0,0,0,0,1
"068330211","BUENOS AIRES",343,337,4,1,0,5,0.982507288629738
"068331011","BUENOS AIRES",314,173,36,101,1,138,0.550955414012739
"068331006","BUENOS AIRES",358,140,103,108,1,212,0.391061452513966
"068331010","BUENOS AIRES",224,201,10,12,1,23,0.897321428571429
"068331401","BUENOS AIRES",204,6,132,64,1,197,0.0294117647058824
"068331709","BUENOS AIRES",188,1,144,41,0,185,0.00531914893617021
"068331807","BUENOS AIRES",77,0,49,28,0,77,0
"068402402","BUENOS AIRES",288,266,10,12,0,22,0.923611111111111
"068331906","BUENOS AIRES",309,5,97,197,1,295,0.0161812297734628
"068331911","BUENOS AIRES",268,0,107,156,2,265,0
"068400204","BUENOS AIRES",294,11,200,81,0,281,0.0374149659863946
"068400104","BUENOS AIRES",292,2,165,112,1,278,0.00684931506849315
"068400305","BUENOS AIRES",391,12,209,160,0,369,0.030690537084399
"068400312","BUENOS AIRES",426,8,252,152,0,404,0.0187793427230047
"068400413","BUENOS AIRES",381,102,114,164,0,278,0.267716535433071
"068400415","BUENOS AIRES",383,380,1,2,0,3,0.992167101827676
"068400509","BUENOS AIRES",235,234,1,0,0,1,0.995744680851064
"068400605","BUENOS AIRES",382,352,21,9,0,30,0.921465968586387
"068400612","BUENOS AIRES",197,186,3,8,0,11,0.944162436548223
"068400705","BUENOS AIRES",252,243,8,1,0,9,0.964285714285714
"068400711","BUENOS AIRES",341,334,5,2,0,7,0.979472140762463
"068400904","BUENOS AIRES",210,210,0,0,0,0,1
"068400906","BUENOS AIRES",306,306,0,0,0,0,1
"068400908","BUENOS AIRES",235,232,3,0,0,3,0.987234042553191
"068401005","BUENOS AIRES",207,207,0,0,0,0,1
"068401007","BUENOS AIRES",305,305,0,0,0,0,1
"068401011","BUENOS AIRES",259,258,1,0,0,1,0.996138996138996
"068401104","BUENOS AIRES",105,93,10,1,0,11,0.885714285714286
"068401311","BUENOS AIRES",249,248,0,0,0,0,0.995983935742972
"068401312","BUENOS AIRES",357,350,6,1,0,7,0.980392156862745
"068401401","BUENOS AIRES",337,320,12,4,1,17,0.949554896142433
"068401407","BUENOS AIRES",294,293,0,0,0,0,0.996598639455782
"068401513","BUENOS AIRES",324,318,6,0,0,6,0.981481481481482
"068401611","BUENOS AIRES",195,194,1,0,0,1,0.994871794871795
"068401801","BUENOS AIRES",117,101,0,12,2,14,0.863247863247863
"068401812","BUENOS AIRES",218,211,4,3,0,7,0.967889908256881
"068402004","BUENOS AIRES",358,356,0,1,0,1,0.994413407821229
"068402107","BUENOS AIRES",381,373,4,2,0,6,0.979002624671916
"068402207","BUENOS AIRES",380,379,1,0,0,1,0.997368421052632
"068402302","BUENOS AIRES",293,281,6,6,0,12,0.959044368600683
"068402501","BUENOS AIRES",125,9,11,98,0,109,0.072
"068402510","BUENOS AIRES",257,234,1,17,0,18,0.910505836575875
"068402511","BUENOS AIRES",211,117,14,76,0,90,0.554502369668246
"068402607","BUENOS AIRES",199,153,10,34,0,44,0.768844221105528
"068402608","BUENOS AIRES",6,6,0,0,0,0,1
"068402702","BUENOS AIRES",373,350,3,1,2,6,0.938337801608579
"068402703","BUENOS AIRES",303,287,9,1,3,13,0.947194719471947
"068402705","BUENOS AIRES",103,103,0,0,0,0,1
"068402902","BUENOS AIRES",263,260,3,0,0,3,0.988593155893536
"068402909","BUENOS AIRES",351,335,9,5,0,14,0.954415954415954
"068402910","BUENOS AIRES",371,361,5,4,0,9,0.973045822102426
"068402911","BUENOS AIRES",179,171,6,2,0,8,0.955307262569832
"068403103","BUENOS AIRES",363,362,0,1,0,1,0.997245179063361
"060352103","BUENOS AIRES",205,197,5,3,0,8,0.960975609756098
"068403205","BUENOS AIRES",260,256,1,0,0,1,0.984615384615385
"068470114","BUENOS AIRES",286,0,222,63,0,285,0
"068330601","BUENOS AIRES",5,1,0,3,0,3,0.2
"068120602","BUENOS AIRES",6,0,3,3,0,6,0
"068190301","BUENOS AIRES",18,0,8,10,0,18,0
"068540401","BUENOS AIRES",188,2,120,64,1,185,0.0106382978723404
"068261802","BUENOS AIRES",24,0,11,11,1,23,0
"068540207","BUENOS AIRES",348,131,52,158,0,210,0.376436781609195
"068261702","BUENOS AIRES",21,0,21,0,0,21,0
"068330303","BUENOS AIRES",4,0,0,4,0,4,0
"068330603","BUENOS AIRES",11,0,0,10,0,10,0
"068330703","BUENOS AIRES",18,0,9,8,0,17,0
"068331102","BUENOS AIRES",3,0,1,2,0,3,0
"068331104","BUENOS AIRES",8,0,4,4,0,8,0
"068610806","BUENOS AIRES",234,234,0,0,0,0,1
"068610810","BUENOS AIRES",277,275,2,0,0,2,0.992779783393502
"068331301","BUENOS AIRES",7,0,7,0,0,7,0
"068540402","BUENOS AIRES",91,0,60,27,3,90,0
"068540602","BUENOS AIRES",152,2,37,109,1,147,0.0131578947368421
"068610902","BUENOS AIRES",227,225,2,0,0,2,0.991189427312775
"068610905","BUENOS AIRES",397,393,2,2,0,4,0.98992443324937
"068610907","BUENOS AIRES",322,322,0,0,0,0,1
"068541301","BUENOS AIRES",51,0,15,32,0,47,0
"068820207","BUENOS AIRES",312,310,2,0,0,2,0.993589743589744
"068750402","BUENOS AIRES",38,1,14,23,0,37,0.0263157894736842
"068751601","BUENOS AIRES",138,0,81,51,4,136,0
"068541006","BUENOS AIRES",321,55,77,166,9,252,0.171339563862928
"068610105","BUENOS AIRES",314,312,2,0,0,2,0.993630573248408
"068610208","BUENOS AIRES",139,139,0,0,0,0,1
"068610303","BUENOS AIRES",323,322,1,0,0,1,0.996904024767802
"068610603","BUENOS AIRES",257,257,0,0,0,0,1
"068610607","BUENOS AIRES",296,296,0,0,0,0,1
"068610707","BUENOS AIRES",275,275,0,0,0,0,1
"068612810","BUENOS AIRES",298,294,2,0,0,2,0.986577181208054
"068610908","BUENOS AIRES",274,273,1,0,0,1,0.996350364963504
"068611002","BUENOS AIRES",409,407,2,0,0,2,0.995110024449878
"068611206","BUENOS AIRES",252,251,0,1,0,1,0.996031746031746
"068611405","BUENOS AIRES",206,206,0,0,0,0,1
"068611409","BUENOS AIRES",355,355,0,0,0,0,1
"068611505","BUENOS AIRES",185,185,0,0,0,0,1
"068611801","BUENOS AIRES",388,384,3,0,0,3,0.989690721649485
"068611803","BUENOS AIRES",302,300,2,0,0,2,0.993377483443709
"068612407","BUENOS AIRES",433,427,3,3,0,6,0.986143187066975
"068611909","BUENOS AIRES",280,280,0,0,0,0,1
"068612101","BUENOS AIRES",331,325,2,3,0,5,0.981873111782477
"068612103","BUENOS AIRES",318,317,0,1,0,1,0.99685534591195
"068612104","BUENOS AIRES",313,304,6,3,0,9,0.971246006389776
"068612106","BUENOS AIRES",360,355,4,1,0,5,0.986111111111111
"068612607","BUENOS AIRES",346,344,1,1,0,2,0.994219653179191
"068612108","BUENOS AIRES",403,399,4,0,0,4,0.990074441687345
"068612203","BUENOS AIRES",334,332,2,0,0,2,0.994011976047904
"060911406","BUENOS AIRES",338,218,24,86,1,111,0.644970414201183
"068612307","BUENOS AIRES",401,392,6,3,0,9,0.977556109725686
"068612405","BUENOS AIRES",380,357,1,1,0,2,0.939473684210526
"068612505","BUENOS AIRES",290,278,6,5,0,11,0.958620689655172
"068612603","BUENOS AIRES",270,270,0,0,0,0,1
"068612704","BUENOS AIRES",243,243,0,0,0,0,1
"068612708","BUENOS AIRES",333,327,5,1,0,6,0.981981981981982
"068612803","BUENOS AIRES",238,233,3,2,0,5,0.978991596638655
"068613001","BUENOS AIRES",277,262,6,7,1,14,0.945848375451264
"068613005","BUENOS AIRES",250,58,15,171,3,189,0.232
"068613007","BUENOS AIRES",255,255,0,0,0,0,1
"068613010","BUENOS AIRES",217,216,1,0,0,1,0.995391705069124
"068613103","BUENOS AIRES",362,354,6,1,0,7,0.977900552486188
"068613104","BUENOS AIRES",661,640,21,0,0,21,0.968229954614221
"068613304","BUENOS AIRES",252,244,6,0,0,6,0.968253968253968
"068680205","BUENOS AIRES",367,346,14,6,0,20,0.942779291553134
"068680208","BUENOS AIRES",9,8,1,0,0,1,0.888888888888889
"068680301","BUENOS AIRES",411,31,137,229,2,368,0.0754257907542579
"068680312","BUENOS AIRES",38,34,3,1,0,4,0.894736842105263
"068680407","BUENOS AIRES",56,51,4,1,0,5,0.910714285714286
"068680603","BUENOS AIRES",75,72,3,0,0,3,0.96
"068680701","BUENOS AIRES",284,15,155,112,2,269,0.0528169014084507
"068750901","BUENOS AIRES",78,2,46,30,0,76,0.0256410256410256
"068751501","BUENOS AIRES",243,3,196,42,2,240,0.0123456790123457
"068751502","BUENOS AIRES",125,48,59,17,1,77,0.384
"068751508","BUENOS AIRES",291,10,190,76,4,270,0.0343642611683849
"068751509","BUENOS AIRES",187,31,127,27,0,154,0.165775401069519
"068751607","BUENOS AIRES",233,187,36,9,0,45,0.802575107296137
"068751609","BUENOS AIRES",197,180,9,6,0,15,0.913705583756345
"065680305","BUENOS AIRES",244,21,176,44,0,220,0.0860655737704918
"068751615","BUENOS AIRES",391,0,107,196,34,337,0
"068820210","BUENOS AIRES",279,273,1,5,0,6,0.978494623655914
"068820304","BUENOS AIRES",385,355,7,14,0,21,0.922077922077922
"068820305","BUENOS AIRES",294,284,2,7,0,9,0.965986394557823
"068820401","BUENOS AIRES",368,283,20,61,0,81,0.769021739130435
"068820911","BUENOS AIRES",251,137,46,65,1,112,0.545816733067729
"068820506","BUENOS AIRES",46,17,2,25,0,27,0.369565217391304
"068820802","BUENOS AIRES",397,265,47,74,1,122,0.667506297229219
"068820902","BUENOS AIRES",332,12,152,158,0,310,0.036144578313253
"068820905","BUENOS AIRES",246,17,80,141,2,223,0.0691056910569106
"068820910","BUENOS AIRES",395,378,3,13,0,16,0.956962025316456
"068821006","BUENOS AIRES",432,381,2,43,1,46,0.881944444444444
"065601502","BUENOS AIRES",205,10,90,100,0,190,0.0487804878048781
"065601407","BUENOS AIRES",269,2,62,193,2,257,0.00743494423791822
"065601408","BUENOS AIRES",557,0,247,267,10,524,0
"065601411","BUENOS AIRES",279,5,94,169,5,268,0.017921146953405
"065601412","BUENOS AIRES",363,11,187,154,1,342,0.0303030303030303
"065601413","BUENOS AIRES",318,2,280,32,0,312,0.00628930817610063
"065601512","BUENOS AIRES",402,6,136,209,0,345,0.0149253731343284
"065601513","BUENOS AIRES",383,3,167,206,1,374,0.00783289817232376
"065601602","BUENOS AIRES",266,2,173,91,0,264,0.0075187969924812
"065601606","BUENOS AIRES",434,2,200,223,0,423,0.00460829493087558
"065601611","BUENOS AIRES",409,6,279,118,0,397,0.0146699266503667
"065601615","BUENOS AIRES",258,1,162,90,0,252,0.00387596899224806
"065602007","BUENOS AIRES",339,98,150,86,0,236,0.289085545722714
"060980304","BUENOS AIRES",285,22,153,108,0,261,0.0771929824561404
"065601706","BUENOS AIRES",222,79,86,54,0,140,0.355855855855856
"067702206","BUENOS AIRES",411,379,8,13,0,21,0.922141119221411
"065601718","BUENOS AIRES",184,0,141,39,0,180,0
"065601802","BUENOS AIRES",358,1,269,81,2,352,0.00279329608938547
"067780207","BUENOS AIRES",394,127,90,161,0,251,0.322335025380711
"065601810","BUENOS AIRES",474,1,288,174,1,463,0.00210970464135021
"065601811","BUENOS AIRES",411,2,275,126,0,401,0.0048661800486618
"065601901","BUENOS AIRES",256,8,118,118,3,239,0.03125
"067780910","BUENOS AIRES",243,168,43,30,0,73,0.691358024691358
"065150213","BUENOS AIRES",209,0,91,97,1,189,0
"065602008","BUENOS AIRES",293,90,95,99,1,195,0.307167235494881
"065602009","BUENOS AIRES",335,0,139,175,6,320,0
"065602010","BUENOS AIRES",325,50,49,211,4,264,0.153846153846154
"065602013","BUENOS AIRES",423,61,187,156,1,344,0.144208037825059
"065602103","BUENOS AIRES",245,0,105,127,4,236,0
"065602108","BUENOS AIRES",404,0,152,249,0,401,0
"065602111","BUENOS AIRES",441,338,77,21,0,98,0.766439909297052
"065602201","BUENOS AIRES",291,1,139,134,2,275,0.00343642611683849
"065602301","BUENOS AIRES",326,11,229,81,0,310,0.0337423312883436
"065602309","BUENOS AIRES",189,187,0,2,0,2,0.989417989417989
"065602408","BUENOS AIRES",297,243,37,17,0,54,0.818181818181818
"065602411","BUENOS AIRES",293,290,3,0,0,3,0.989761092150171
"065602508","BUENOS AIRES",363,199,100,58,0,158,0.548209366391185
"065150805","BUENOS AIRES",251,0,178,70,0,248,0
"061260907","BUENOS AIRES",492,490,0,0,0,0,0.995934959349594
"065680310","BUENOS AIRES",227,221,3,0,0,3,0.973568281938326
"065680311","BUENOS AIRES",395,268,76,47,0,123,0.678481012658228
"065680406","BUENOS AIRES",186,184,2,0,0,2,0.989247311827957
"065680408","BUENOS AIRES",340,331,8,1,0,9,0.973529411764706
"065680410","BUENOS AIRES",295,295,0,0,0,0,1
"065680706","BUENOS AIRES",367,353,14,0,0,14,0.961852861035422
"065680901","BUENOS AIRES",194,3,134,57,0,191,0.0154639175257732
"065681001","BUENOS AIRES",335,8,253,73,0,326,0.0238805970149254
"065681007","BUENOS AIRES",204,1,141,58,0,199,0.00490196078431373
"065681012","BUENOS AIRES",339,265,54,19,0,73,0.781710914454277
"065681017","BUENOS AIRES",266,204,23,28,1,52,0.766917293233083
"061340305","BUENOS AIRES",296,285,9,2,0,11,0.962837837837838
"064971001","BUENOS AIRES",214,1,120,91,0,211,0.00467289719626168
"065681104","BUENOS AIRES",192,190,0,1,1,2,0.989583333333333
"065681203","BUENOS AIRES",327,324,3,0,0,3,0.990825688073395
"065681303","BUENOS AIRES",272,268,3,1,0,4,0.985294117647059
"065681309","BUENOS AIRES",372,359,9,3,0,12,0.96505376344086
"066510708","BUENOS AIRES",4,0,4,0,0,4,0
"068751402","BUENOS AIRES",46,0,35,11,0,46,0
"060070114","BUENOS AIRES",21,0,3,17,1,21,0
"064905010","BUENOS AIRES",408,224,96,86,0,182,0.549019607843137
"064905111","BUENOS AIRES",181,44,105,32,0,137,0.243093922651934
"064970102","BUENOS AIRES",202,199,3,0,0,3,0.985148514851485
"064970502","BUENOS AIRES",218,197,10,9,0,19,0.903669724770642
"065390113","BUENOS AIRES",267,8,181,77,0,258,0.0299625468164794
"064970602","BUENOS AIRES",332,287,18,25,1,44,0.864457831325301
"064970614","BUENOS AIRES",133,0,40,86,1,127,0
"064970707","BUENOS AIRES",155,154,0,1,0,1,0.993548387096774
"064970814","BUENOS AIRES",218,0,177,39,1,217,0
"066584312","BUENOS AIRES",386,20,232,130,0,362,0.0518134715025907
"066650201","BUENOS AIRES",22,19,3,0,0,3,0.863636363636364
"064971008","BUENOS AIRES",336,2,160,162,1,323,0.00595238095238095
"064971408","BUENOS AIRES",243,182,36,6,0,42,0.748971193415638
"065152001","BUENOS AIRES",506,5,367,120,0,487,0.00988142292490119
"065152015","BUENOS AIRES",427,2,252,159,2,413,0.00468384074941452
"065050307","BUENOS AIRES",173,101,42,25,1,68,0.583815028901734
"065050316","BUENOS AIRES",88,3,56,27,1,84,0.0340909090909091
"065110301","BUENOS AIRES",33,0,3,28,2,33,0
"065110501","BUENOS AIRES",100,14,26,59,0,85,0.14
"065110503","BUENOS AIRES",379,135,91,149,3,243,0.356200527704486
"065150607","BUENOS AIRES",386,0,297,83,0,380,0
"065110509","BUENOS AIRES",201,4,47,142,5,194,0.0199004975124378
"065152107","BUENOS AIRES",216,4,128,80,0,208,0.0185185185185185
"065152109","BUENOS AIRES",363,1,242,114,0,356,0.00275482093663912
"065152111","BUENOS AIRES",299,2,200,93,0,293,0.00668896321070234
"065180101","BUENOS AIRES",186,173,3,9,0,12,0.93010752688172
"065180112","BUENOS AIRES",26,2,5,19,0,24,0.0769230769230769
"065180206","BUENOS AIRES",190,7,67,113,2,182,0.0368421052631579
"065180302","BUENOS AIRES",111,1,31,77,0,108,0.00900900900900901
"065150106","BUENOS AIRES",349,1,234,104,0,338,0.00286532951289398
"065150110","BUENOS AIRES",423,1,180,224,6,410,0.00236406619385343
"065150112","BUENOS AIRES",530,8,181,327,1,509,0.0150943396226415
"060563210","BUENOS AIRES",315,8,228,77,0,305,0.0253968253968254
"065180604","BUENOS AIRES",190,2,169,19,0,188,0.0105263157894737
"066860109","BUENOS AIRES",255,244,3,8,0,11,0.956862745098039
"061610108","BUENOS AIRES",173,168,2,3,0,5,0.971098265895954
"065150216","BUENOS AIRES",281,3,124,144,2,270,0.0106761565836299
"065150310","BUENOS AIRES",294,2,179,99,1,279,0.00680272108843537
"065150403","BUENOS AIRES",329,6,191,123,1,315,0.0182370820668693
"065150404","BUENOS AIRES",196,1,160,33,0,193,0.00510204081632653
"065150409","BUENOS AIRES",318,0,208,103,0,311,0
"065391202","BUENOS AIRES",300,1,209,86,1,296,0.00333333333333333
"065150511","BUENOS AIRES",411,270,121,20,0,141,0.656934306569343
"065150601","BUENOS AIRES",251,0,143,102,1,246,0
"065150712","BUENOS AIRES",466,4,269,136,3,408,0.00858369098712446
"065150714","BUENOS AIRES",245,0,185,55,1,241,0
"065150801","BUENOS AIRES",343,1,290,48,0,338,0.00291545189504373
"065150809","BUENOS AIRES",393,2,214,169,1,384,0.00508905852417303
"065150904","BUENOS AIRES",242,0,125,112,0,237,0
"065150906","BUENOS AIRES",332,4,266,62,0,328,0.0120481927710843
"065150911","BUENOS AIRES",293,1,170,120,0,290,0.00341296928327645
"065150914","BUENOS AIRES",356,0,162,173,0,335,0
"065151002","BUENOS AIRES",481,1,334,131,0,465,0.00207900207900208
"060351403","BUENOS AIRES",335,300,12,23,0,35,0.895522388059702
"060352902","BUENOS AIRES",304,34,186,82,0,268,0.111842105263158
"060353010","BUENOS AIRES",300,241,39,19,0,58,0.803333333333333
"060562507","BUENOS AIRES",401,244,128,25,0,153,0.608478802992519
"061340914","BUENOS AIRES",159,0,114,37,0,151,0
"060070101","BUENOS AIRES",178,0,133,45,0,178,0
"061680802","BUENOS AIRES",12,0,3,9,0,12,0
"060070403","BUENOS AIRES",234,11,123,100,0,223,0.047008547008547
"060070404","BUENOS AIRES",253,8,173,70,1,244,0.0316205533596838
"060140505","BUENOS AIRES",154,3,125,25,0,150,0.0194805194805195
"060141003","BUENOS AIRES",150,19,28,100,2,130,0.126666666666667
"060141006","BUENOS AIRES",204,66,81,55,0,136,0.323529411764706
"060210201","BUENOS AIRES",154,81,18,52,0,70,0.525974025974026
"060210608","BUENOS AIRES",143,136,5,2,0,7,0.951048951048951
"060210801","BUENOS AIRES",70,1,17,49,3,69,0.0142857142857143
"060280113","BUENOS AIRES",277,3,132,138,0,270,0.0108303249097473
"060280310","BUENOS AIRES",318,5,162,141,0,303,0.0157232704402516
"060281805","BUENOS AIRES",240,12,159,64,1,224,0.05
"060280404","BUENOS AIRES",331,3,72,230,1,303,0.00906344410876133
"060280508","BUENOS AIRES",75,0,11,63,0,74,0
"060280601","BUENOS AIRES",389,0,273,109,0,382,0
"060280611","BUENOS AIRES",254,0,86,156,1,243,0
"060280614","BUENOS AIRES",762,5,390,328,3,721,0.00656167979002625
"060280707","BUENOS AIRES",666,3,368,275,1,644,0.0045045045045045
"060280711","BUENOS AIRES",433,9,257,151,3,411,0.0207852193995381
"060280905","BUENOS AIRES",300,119,145,35,0,180,0.396666666666667
"060281006","BUENOS AIRES",281,17,160,101,1,262,0.0604982206405694
"060281015","BUENOS AIRES",286,248,16,15,0,31,0.867132867132867
"060281103","BUENOS AIRES",276,253,6,16,0,22,0.916666666666667
"060281104","BUENOS AIRES",225,210,12,3,0,15,0.933333333333333
"060281311","BUENOS AIRES",367,16,194,152,0,346,0.0435967302452316
"060281407","BUENOS AIRES",454,3,285,144,0,429,0.0066079295154185
"060281703","BUENOS AIRES",186,186,0,0,0,0,1
"060281705","BUENOS AIRES",257,249,5,1,0,6,0.968871595330739
"060281901","BUENOS AIRES",364,364,0,0,0,0,1
"060281913","BUENOS AIRES",192,0,39,135,2,176,0
"060282011","BUENOS AIRES",262,0,114,134,3,251,0
"060282013","BUENOS AIRES",406,1,147,233,5,385,0.00246305418719212
"060282107","BUENOS AIRES",307,1,235,68,1,304,0.00325732899022801
"060282306","BUENOS AIRES",318,9,249,60,0,309,0.0283018867924528
"060282308","BUENOS AIRES",213,8,130,75,0,205,0.0375586854460094
"060282309","BUENOS AIRES",284,3,197,84,0,281,0.0105633802816901
"060282403","BUENOS AIRES",291,5,223,63,0,286,0.0171821305841924
"060282409","BUENOS AIRES",341,15,249,77,0,326,0.0439882697947214
"060282501","BUENOS AIRES",262,232,26,3,0,29,0.885496183206107
"060282507","BUENOS AIRES",218,217,1,0,0,1,0.995412844036697
"060283312","BUENOS AIRES",361,3,248,98,2,348,0.00831024930747922
"060282508","BUENOS AIRES",199,199,0,0,0,0,1
"060282513","BUENOS AIRES",307,304,3,0,0,3,0.990228013029316
"060282603","BUENOS AIRES",284,131,101,51,0,152,0.461267605633803
"060282612","BUENOS AIRES",123,42,48,33,0,81,0.341463414634146
"060282703","BUENOS AIRES",373,15,139,209,0,348,0.0402144772117962
"060282805","BUENOS AIRES",441,3,236,180,2,418,0.00680272108843537
"060282903","BUENOS AIRES",302,0,226,66,0,292,0
"060282908","BUENOS AIRES",283,0,155,117,2,274,0
"060282909","BUENOS AIRES",301,0,207,88,2,297,0
"060283107","BUENOS AIRES",387,0,203,157,5,365,0
"060283109","BUENOS AIRES",279,3,153,113,0,266,0.010752688172043
"060283206","BUENOS AIRES",238,0,172,66,0,238,0
"060283502","BUENOS AIRES",351,2,154,190,0,344,0.0056980056980057
"060283611","BUENOS AIRES",304,0,192,95,1,288,0
"060283702","BUENOS AIRES",276,2,188,80,0,268,0.0072463768115942
"060283703","BUENOS AIRES",286,1,158,117,0,275,0.0034965034965035
"060283714","BUENOS AIRES",289,3,111,174,0,285,0.0103806228373702
"060283803","BUENOS AIRES",347,0,211,127,1,339,0
"060283804","BUENOS AIRES",436,0,313,120,0,433,0
"060283904","BUENOS AIRES",360,0,157,181,0,338,0
"062170404","BUENOS AIRES",169,1,78,86,1,165,0.00591715976331361
"060350103","BUENOS AIRES",239,184,27,27,0,54,0.769874476987448
"060350308","BUENOS AIRES",291,291,0,0,0,0,1
"060350311","BUENOS AIRES",334,332,0,1,0,1,0.994011976047904
"060350407","BUENOS AIRES",348,279,21,46,1,68,0.801724137931034
"060350413","BUENOS AIRES",327,308,11,8,0,19,0.941896024464832
"060350504","BUENOS AIRES",375,44,146,181,1,328,0.117333333333333
"060350801","BUENOS AIRES",274,259,5,6,2,13,0.945255474452555
"060352205","BUENOS AIRES",201,201,0,0,0,0,1
"020121608","CABA",528,522,5,0,1,6,0.988636363636364
"060350908","BUENOS AIRES",342,182,27,55,29,111,0.532163742690059
"060351003","BUENOS AIRES",297,275,6,9,0,15,0.925925925925926
"060351107","BUENOS AIRES",107,98,2,0,0,2,0.91588785046729
"060351201","BUENOS AIRES",250,248,1,1,0,2,0.992
"060351408","BUENOS AIRES",294,269,0,21,0,21,0.914965986394558
"060351412","BUENOS AIRES",216,210,6,0,0,6,0.972222222222222
"063573801","BUENOS AIRES",238,238,0,0,0,0,1
"060351509","BUENOS AIRES",261,15,145,100,1,246,0.0574712643678161
"060351511","BUENOS AIRES",264,225,26,12,0,38,0.852272727272727
"060351606","BUENOS AIRES",267,41,104,122,0,226,0.153558052434457
"060351701","BUENOS AIRES",296,195,41,58,0,99,0.658783783783784
"060351702","BUENOS AIRES",262,228,24,10,0,34,0.870229007633588
"060351807","BUENOS AIRES",248,213,19,16,0,35,0.858870967741935
"060351809","BUENOS AIRES",306,15,115,176,0,291,0.0490196078431373
"060351907","BUENOS AIRES",289,26,86,176,1,263,0.0899653979238754
"060352005","BUENOS AIRES",304,253,22,27,1,50,0.832236842105263
"060352102","BUENOS AIRES",391,359,7,25,0,32,0.918158567774936
"060352311","BUENOS AIRES",323,266,32,22,0,54,0.823529411764706
"060352402","BUENOS AIRES",315,207,49,57,0,106,0.657142857142857
"060352403","BUENOS AIRES",406,282,21,100,0,121,0.694581280788177
"060352406","BUENOS AIRES",307,272,14,20,1,35,0.885993485342019
"060352407","BUENOS AIRES",317,255,35,24,0,59,0.804416403785489
"060352504","BUENOS AIRES",277,232,18,24,0,42,0.837545126353791
"060352603","BUENOS AIRES",208,207,1,0,0,1,0.995192307692308
"060352605","BUENOS AIRES",593,570,22,0,0,22,0.961214165261383
"060352614","BUENOS AIRES",267,23,42,186,1,229,0.0861423220973783
"060352702","BUENOS AIRES",261,13,155,89,0,244,0.0498084291187739
"060352708","BUENOS AIRES",128,16,23,88,0,111,0.125
"060352712","BUENOS AIRES",412,42,120,243,3,366,0.101941747572816
"060352714","BUENOS AIRES",297,233,1,63,0,64,0.784511784511784
"060353006","BUENOS AIRES",333,260,25,47,0,72,0.780780780780781
"060353201","BUENOS AIRES",353,348,3,1,0,4,0.985835694050991
"060353403","BUENOS AIRES",223,219,0,0,0,0,0.982062780269058
"060353409","BUENOS AIRES",252,237,8,6,0,14,0.94047619047619
"060353508","BUENOS AIRES",247,241,3,2,0,5,0.975708502024291
"060420107","BUENOS AIRES",232,219,3,9,1,13,0.943965517241379
"062380215","BUENOS AIRES",20,0,3,17,0,20,0
"060490210","BUENOS AIRES",217,7,51,152,4,207,0.032258064516129
"060490608","BUENOS AIRES",420,316,55,46,0,101,0.752380952380952
"060491001","BUENOS AIRES",116,44,28,38,4,70,0.379310344827586
"060492003","BUENOS AIRES",35,1,19,14,1,34,0.0285714285714286
"060492503","BUENOS AIRES",225,157,13,51,0,64,0.697777777777778
"062520211","BUENOS AIRES",272,0,203,68,0,271,0
"060492502","BUENOS AIRES",431,389,18,22,1,41,0.902552204176334
"060492509","BUENOS AIRES",415,245,30,135,0,165,0.590361445783133
"060561004","BUENOS AIRES",308,308,0,0,0,0,1
"060560110","BUENOS AIRES",240,239,1,0,0,1,0.995833333333333
"060560114","BUENOS AIRES",223,222,0,1,0,1,0.995515695067265
"060561708","BUENOS AIRES",259,203,0,0,0,0,0.783783783783784
"060560202","BUENOS AIRES",377,171,85,111,1,197,0.453580901856764
"060560211","BUENOS AIRES",318,292,14,12,0,26,0.918238993710692
"020132603","CABA",288,287,1,0,0,1,0.996527777777778
"060560604","BUENOS AIRES",213,207,3,2,0,5,0.971830985915493
"060560606","BUENOS AIRES",201,193,0,7,0,7,0.960199004975124
"060560702","BUENOS AIRES",309,306,2,1,0,3,0.990291262135922
"060560710","BUENOS AIRES",330,320,6,4,0,10,0.96969696969697
"060561005","BUENOS AIRES",197,196,1,0,0,1,0.99492385786802
"060560805","BUENOS AIRES",472,409,13,44,0,57,0.866525423728814
"060560808","BUENOS AIRES",73,37,9,26,0,35,0.506849315068493
"060561710","BUENOS AIRES",261,260,1,0,0,1,0.996168582375479
"060561803","BUENOS AIRES",222,217,2,3,0,5,0.977477477477477
"060561904","BUENOS AIRES",341,257,34,44,1,79,0.75366568914956
"060560811","BUENOS AIRES",23,0,0,10,9,19,0
"060560813","BUENOS AIRES",325,149,73,96,2,171,0.458461538461538
"062521206","BUENOS AIRES",360,0,192,153,2,347,0
"060560814","BUENOS AIRES",400,267,38,90,0,128,0.6675
"060561101","BUENOS AIRES",210,209,1,0,0,1,0.995238095238095
"060561107","BUENOS AIRES",258,257,1,0,0,1,0.996124031007752
"060561301","BUENOS AIRES",496,492,2,2,0,4,0.991935483870968
"060561404","BUENOS AIRES",227,226,0,0,0,0,0.995594713656388
"060561407","BUENOS AIRES",240,236,3,1,0,4,0.983333333333333
"060561421","BUENOS AIRES",188,188,0,0,0,0,1
"060561505","BUENOS AIRES",282,250,5,24,0,29,0.886524822695035
"060561507","BUENOS AIRES",307,294,9,4,0,13,0.957654723127036
"060561508","BUENOS AIRES",381,375,2,0,0,2,0.984251968503937
"060561509","BUENOS AIRES",177,149,23,5,0,28,0.84180790960452
"060561604","BUENOS AIRES",182,180,2,0,0,2,0.989010989010989
"060561906","BUENOS AIRES",451,442,4,1,0,5,0.980044345898004
"060562004","BUENOS AIRES",320,315,5,0,0,5,0.984375
"060562007","BUENOS AIRES",240,240,0,0,0,0,1
"060562104","BUENOS AIRES",225,221,4,0,0,4,0.982222222222222
"060562110","BUENOS AIRES",252,240,7,4,0,11,0.952380952380952
"060562201","BUENOS AIRES",343,336,3,4,0,7,0.979591836734694
"060562205","BUENOS AIRES",253,203,17,31,0,48,0.802371541501976
"060562217","BUENOS AIRES",355,332,11,1,0,12,0.935211267605634
"060562312","BUENOS AIRES",207,188,3,15,1,19,0.908212560386473
"060562401","BUENOS AIRES",392,11,285,96,0,381,0.0280612244897959
"061821006","BUENOS AIRES",256,255,1,0,0,1,0.99609375
"060562411","BUENOS AIRES",194,115,29,42,0,71,0.592783505154639
"065151310","BUENOS AIRES",398,2,305,80,0,385,0.0050251256281407
"062660610","BUENOS AIRES",151,3,92,54,0,146,0.0198675496688742
"066582605","BUENOS AIRES",273,254,8,11,0,19,0.93040293040293
"060630105","BUENOS AIRES",417,371,15,30,0,45,0.88968824940048
"060630109","BUENOS AIRES",381,305,14,53,0,67,0.800524934383202
"060630114","BUENOS AIRES",269,237,9,18,1,28,0.881040892193309
"060630202","BUENOS AIRES",299,293,2,4,0,6,0.979933110367893
"060630402","BUENOS AIRES",28,0,5,20,0,25,0
"062700503","BUENOS AIRES",280,12,118,139,1,258,0.0428571428571429
"060700102","BUENOS AIRES",168,166,1,1,0,2,0.988095238095238
"060630103","BUENOS AIRES",334,291,4,34,2,40,0.87125748502994
"060700106","BUENOS AIRES",291,286,3,2,0,5,0.982817869415808
"060700110","BUENOS AIRES",284,277,2,5,0,7,0.975352112676056
"060700210","BUENOS AIRES",467,20,93,326,11,430,0.0428265524625268
"060700213","BUENOS AIRES",286,177,44,62,1,107,0.618881118881119
"060700214","BUENOS AIRES",354,297,26,30,0,56,0.838983050847458
"060700401","BUENOS AIRES",385,15,176,188,1,365,0.038961038961039
"063572102","BUENOS AIRES",272,264,3,0,0,3,0.970588235294118
"060910610","BUENOS AIRES",370,3,107,246,1,354,0.00810810810810811
"060910706","BUENOS AIRES",294,160,44,81,0,125,0.54421768707483
"060562610","BUENOS AIRES",572,14,425,116,2,543,0.0244755244755245
"061821007","BUENOS AIRES",247,239,3,4,0,7,0.967611336032389
"060563002","BUENOS AIRES",140,1,86,52,0,138,0.00714285714285714
"060630102","BUENOS AIRES",324,300,7,14,1,22,0.925925925925926
"065151402","BUENOS AIRES",315,2,185,104,1,290,0.00634920634920635
"060770107","BUENOS AIRES",107,66,13,23,0,36,0.616822429906542
"060771406","BUENOS AIRES",335,312,8,15,0,23,0.93134328358209
"060771407","BUENOS AIRES",285,257,16,12,0,28,0.901754385964912
"060840703","BUENOS AIRES",207,33,72,97,1,170,0.159420289855072
"060840708","BUENOS AIRES",292,277,10,5,0,15,0.948630136986301
"062741003","BUENOS AIRES",400,7,221,154,4,379,0.0175
"060840903","BUENOS AIRES",129,1,116,12,0,128,0.00775193798449612
"060840906","BUENOS AIRES",225,3,168,53,1,222,0.0133333333333333
"060910108","BUENOS AIRES",330,327,2,1,0,3,0.990909090909091
"060910208","BUENOS AIRES",372,366,4,1,0,5,0.983870967741935
"060910311","BUENOS AIRES",307,301,0,0,0,0,0.980456026058632
"060910411","BUENOS AIRES",431,189,55,170,2,227,0.438515081206497
"064278811","BUENOS AIRES",203,1,165,34,0,199,0.00492610837438424
"060910809","BUENOS AIRES",405,378,8,12,0,20,0.933333333333333
"060910901","BUENOS AIRES",227,224,1,2,0,3,0.986784140969163
"060910904","BUENOS AIRES",422,410,3,5,0,8,0.971563981042654
"060910908","BUENOS AIRES",224,218,2,0,0,2,0.973214285714286
"060911009","BUENOS AIRES",290,289,1,0,0,1,0.996551724137931
"060911302","BUENOS AIRES",327,309,6,9,0,15,0.944954128440367
"060911305","BUENOS AIRES",418,353,14,40,1,55,0.844497607655502
"060911311","BUENOS AIRES",270,200,13,44,0,57,0.740740740740741
"060911408","BUENOS AIRES",385,349,8,23,0,31,0.906493506493506
"060911610","BUENOS AIRES",285,254,15,7,1,23,0.891228070175439
"060911704","BUENOS AIRES",260,218,7,30,0,37,0.838461538461538
"060911708","BUENOS AIRES",250,141,15,79,0,94,0.564
"060911905","BUENOS AIRES",208,205,1,2,0,3,0.985576923076923
"060911912","BUENOS AIRES",418,356,31,15,0,46,0.851674641148325
"060912003","BUENOS AIRES",153,95,29,29,0,58,0.620915032679739
"060912318","BUENOS AIRES",58,0,22,35,0,57,0
"060912013","BUENOS AIRES",229,7,63,149,2,214,0.0305676855895196
"060912105","BUENOS AIRES",248,247,1,0,0,1,0.995967741935484
"060912203","BUENOS AIRES",370,309,39,20,0,59,0.835135135135135
"060912205","BUENOS AIRES",265,260,4,0,0,4,0.981132075471698
"060980108","BUENOS AIRES",258,219,26,13,0,39,0.848837209302326
"061820204","BUENOS AIRES",265,264,1,0,0,1,0.99622641509434
"060912312","BUENOS AIRES",193,4,57,127,0,184,0.0207253886010363
"060912313","BUENOS AIRES",171,1,63,98,1,162,0.00584795321637427
"060912314","BUENOS AIRES",72,0,60,12,0,72,0
"063573602","BUENOS AIRES",261,260,0,0,0,0,0.996168582375479
"060912407","BUENOS AIRES",153,1,92,59,1,152,0.0065359477124183
"060912413","BUENOS AIRES",190,1,50,123,7,180,0.00526315789473684
"060980112","BUENOS AIRES",254,159,70,25,0,95,0.625984251968504
"060980202","BUENOS AIRES",347,167,146,34,0,180,0.481268011527378
"060980207","BUENOS AIRES",377,80,249,42,5,296,0.212201591511936
"060980309","BUENOS AIRES",477,337,42,70,8,120,0.706498951781971
"060980602","BUENOS AIRES",387,41,298,46,1,345,0.10594315245478
"060980605","BUENOS AIRES",387,37,266,79,0,345,0.0956072351421189
"060980802","BUENOS AIRES",367,2,146,162,21,329,0.00544959128065395
"060980805","BUENOS AIRES",164,156,6,1,0,7,0.951219512195122
"060980807","BUENOS AIRES",187,179,7,1,0,8,0.957219251336898
"060980817","BUENOS AIRES",378,107,130,128,2,260,0.283068783068783
"061050103","BUENOS AIRES",289,276,3,10,0,13,0.955017301038062
"061051301","BUENOS AIRES",176,43,81,50,0,131,0.244318181818182
"061051402","BUENOS AIRES",262,215,12,29,0,41,0.820610687022901
"061051412","BUENOS AIRES",198,187,5,6,0,11,0.944444444444444
"061120103","BUENOS AIRES",408,344,9,49,0,58,0.843137254901961
"061120301","BUENOS AIRES",72,0,35,36,0,71,0
"061121401","BUENOS AIRES",291,161,30,94,1,125,0.553264604810997
"061121402","BUENOS AIRES",334,263,38,31,0,69,0.787425149700599
"061190305","BUENOS AIRES",384,217,85,80,1,166,0.565104166666667
"020132810","CABA",273,273,0,0,0,0,1
"061190403","BUENOS AIRES",123,1,73,49,0,122,0.00813008130081301
"061191001","BUENOS AIRES",80,0,19,58,1,78,0
"061191008","BUENOS AIRES",352,280,39,32,0,71,0.795454545454545
"061260107","BUENOS AIRES",250,248,1,1,0,2,0.992
"063573603","BUENOS AIRES",173,172,1,0,0,1,0.994219653179191
"061260112","BUENOS AIRES",362,359,0,3,0,3,0.99171270718232
"061260113","BUENOS AIRES",242,90,63,87,0,150,0.371900826446281
"061260305","BUENOS AIRES",191,188,3,0,0,3,0.984293193717278
"061260402","BUENOS AIRES",248,245,1,0,0,1,0.987903225806452
"061260407","BUENOS AIRES",492,26,32,343,62,437,0.0528455284552846
"061260604","BUENOS AIRES",108,1,95,11,0,106,0.00925925925925926
"061260707","BUENOS AIRES",331,9,98,219,0,317,0.027190332326284
"061260709","BUENOS AIRES",468,389,29,47,0,76,0.831196581196581
"061340801","BUENOS AIRES",105,0,68,36,0,104,0
"020140911","CABA",395,395,0,0,0,0,1
"061340207","BUENOS AIRES",386,84,100,187,3,290,0.217616580310881
"061340209","BUENOS AIRES",306,1,150,147,2,299,0.00326797385620915
"061340302","BUENOS AIRES",292,262,19,8,0,27,0.897260273972603
"061340903","BUENOS AIRES",133,1,51,77,2,130,0.0075187969924812
"061471205","BUENOS AIRES",233,206,7,20,0,27,0.88412017167382
"061540202","BUENOS AIRES",141,0,89,46,1,136,0
"061540602","BUENOS AIRES",146,0,114,32,0,146,0
"063572106","BUENOS AIRES",196,196,0,0,0,0,1
"061610117","BUENOS AIRES",349,213,37,96,0,133,0.610315186246418
"063576111","BUENOS AIRES",202,202,0,0,0,0,1
"061680803","BUENOS AIRES",21,0,2,19,0,21,0
"061680901","BUENOS AIRES",252,210,13,26,0,39,0.833333333333333
"061820205","BUENOS AIRES",245,241,4,0,0,4,0.983673469387755
"061680902","BUENOS AIRES",284,244,23,15,0,38,0.859154929577465
"061680908","BUENOS AIRES",178,113,19,43,3,65,0.634831460674157
"061960110","BUENOS AIRES",122,77,10,32,2,44,0.631147540983607
"061750201","BUENOS AIRES",69,1,22,44,1,67,0.0144927536231884
"061750405","BUENOS AIRES",275,271,1,2,1,4,0.985454545454545
"061750407","BUENOS AIRES",260,258,2,0,0,2,0.992307692307692
"061750413","BUENOS AIRES",197,194,2,1,0,3,0.984771573604061
"061750608","BUENOS AIRES",295,45,50,198,0,248,0.152542372881356
"061750609","BUENOS AIRES",275,10,71,181,0,252,0.0363636363636364
"063577303","BUENOS AIRES",19,0,0,9,1,10,0
"061820103","BUENOS AIRES",376,373,1,2,0,3,0.992021276595745
"061820106","BUENOS AIRES",271,262,7,2,0,9,0.966789667896679
"063577311","BUENOS AIRES",114,0,63,47,3,113,0
"061820301","BUENOS AIRES",32,28,3,1,0,4,0.875
"062380701","BUENOS AIRES",51,1,30,20,0,50,0.0196078431372549
"061820303","BUENOS AIRES",46,46,0,0,0,0,1
"061820311","BUENOS AIRES",152,147,4,1,0,5,0.967105263157895
"061821004","BUENOS AIRES",329,314,9,6,0,15,0.954407294832827
"061820703","BUENOS AIRES",359,324,16,19,0,35,0.902506963788301
"061821103","BUENOS AIRES",336,325,5,5,0,10,0.967261904761905
"061891201","BUENOS AIRES",151,0,106,43,0,149,0
"063578010","BUENOS AIRES",111,0,49,60,1,110,0
"061891301","BUENOS AIRES",34,2,24,6,0,30,0.0588235294117647
"061891704","BUENOS AIRES",218,163,33,20,0,53,0.747706422018349
"061960101","BUENOS AIRES",284,162,35,85,0,120,0.570422535211268
"061960202","BUENOS AIRES",99,16,16,63,1,80,0.161616161616162
"061960106","BUENOS AIRES",106,1,20,65,8,93,0.00943396226415094
"061960115","BUENOS AIRES",197,193,1,3,0,4,0.979695431472081
"061960117","BUENOS AIRES",181,165,4,12,0,16,0.911602209944751
"061960210","BUENOS AIRES",315,273,8,34,0,42,0.866666666666667
"063640208","BUENOS AIRES",230,133,36,59,1,96,0.578260869565217
"062030110","BUENOS AIRES",317,175,64,77,0,141,0.55205047318612
"062030112","BUENOS AIRES",308,13,190,105,0,295,0.0422077922077922
"062030807","BUENOS AIRES",353,314,18,21,0,39,0.889518413597734
"063710502","BUENOS AIRES",360,348,5,7,0,12,0.966666666666667
"062031301","BUENOS AIRES",7,0,2,5,0,7,0
"062031603","BUENOS AIRES",255,68,67,113,1,181,0.266666666666667
"020132804","CABA",201,187,3,0,0,3,0.930348258706468
"062031610","BUENOS AIRES",320,4,126,181,3,310,0.0125
"062100102","BUENOS AIRES",187,177,7,2,0,9,0.946524064171123
"062100106","BUENOS AIRES",271,266,3,2,0,5,0.981549815498155
"062100111","BUENOS AIRES",272,268,3,1,0,4,0.985294117647059
"062100117","BUENOS AIRES",315,306,5,1,0,6,0.971428571428571
"062100120","BUENOS AIRES",306,282,11,9,0,20,0.92156862745098
"062100612","BUENOS AIRES",134,0,33,100,0,133,0
"062101307","BUENOS AIRES",282,268,5,8,0,13,0.950354609929078
"062170109","BUENOS AIRES",256,251,4,1,0,5,0.98046875
"062170114","BUENOS AIRES",147,144,1,2,0,3,0.979591836734694
"063713010","BUENOS AIRES",132,8,20,94,1,115,0.0606060606060606
"062170412","BUENOS AIRES",194,4,41,143,1,185,0.0206185567010309
"062171001","BUENOS AIRES",263,187,38,35,0,73,0.711026615969582
"062171203","BUENOS AIRES",300,280,7,13,0,20,0.933333333333333
"062240207","BUENOS AIRES",300,268,13,17,1,31,0.893333333333333
"062520601","BUENOS AIRES",239,4,73,160,1,234,0.0167364016736402
"062240411","BUENOS AIRES",317,8,149,159,0,308,0.0252365930599369
"062240913","BUENOS AIRES",69,0,36,32,0,68,0
"062240914","BUENOS AIRES",68,0,49,17,0,66,0
"063572211","BUENOS AIRES",168,167,1,0,0,1,0.994047619047619
"062242003","BUENOS AIRES",294,0,145,143,5,293,0
"064080907","BUENOS AIRES",434,3,315,113,0,428,0.00691244239631336
"063572705","BUENOS AIRES",239,239,0,0,0,0,1
"062311207","BUENOS AIRES",332,249,19,59,1,79,0.75
"062380102","BUENOS AIRES",194,44,43,105,1,149,0.22680412371134
"062380202","BUENOS AIRES",398,112,141,141,0,282,0.281407035175879
"062380203","BUENOS AIRES",328,256,25,47,0,72,0.780487804878049
"062380204","BUENOS AIRES",196,195,1,0,0,1,0.994897959183674
"062380207","BUENOS AIRES",403,95,152,156,0,308,0.235732009925558
"062520413","BUENOS AIRES",357,331,25,0,1,26,0.927170868347339
"062380603","BUENOS AIRES",207,104,35,67,1,103,0.502415458937198
"062450201","BUENOS AIRES",395,39,260,86,0,346,0.0987341772151899
"062450308","BUENOS AIRES",259,239,13,5,0,18,0.922779922779923
"064100610","BUENOS AIRES",277,0,235,42,0,277,0
"062450413","BUENOS AIRES",236,4,126,99,1,226,0.0169491525423729
"062520115","BUENOS AIRES",310,7,200,102,0,302,0.0225806451612903
"062520502","BUENOS AIRES",263,259,3,0,0,3,0.984790874524715
"062520406","BUENOS AIRES",244,218,15,10,0,25,0.89344262295082
"062520410","BUENOS AIRES",248,166,67,13,0,80,0.669354838709677
"062520411","BUENOS AIRES",31,0,21,10,0,31,0
"062601201","BUENOS AIRES",308,306,2,0,0,2,0.993506493506494
"062521105","BUENOS AIRES",434,5,328,98,0,426,0.0115207373271889
"062601211","BUENOS AIRES",283,1,222,58,0,280,0.00353356890459364
"062520606","BUENOS AIRES",291,186,58,44,0,102,0.639175257731959
"062520708","BUENOS AIRES",433,2,222,196,1,419,0.0046189376443418
"062520710","BUENOS AIRES",262,0,182,80,0,262,0
"062520802","BUENOS AIRES",465,1,263,191,4,458,0.0021505376344086
"062520904","BUENOS AIRES",427,1,142,221,3,366,0.00234192037470726
"062520908","BUENOS AIRES",245,0,184,57,1,242,0
"062521012","BUENOS AIRES",388,0,155,206,6,367,0
"062521107","BUENOS AIRES",307,2,264,40,0,304,0.00651465798045603
"062521014","BUENOS AIRES",225,1,188,35,0,223,0.00444444444444444
"062521101","BUENOS AIRES",264,1,216,43,0,259,0.00378787878787879
"063572902","BUENOS AIRES",110,110,0,0,0,0,1
"062521110","BUENOS AIRES",328,4,270,53,0,323,0.0121951219512195
"062521310","BUENOS AIRES",219,1,161,54,0,215,0.0045662100456621
"062521311","BUENOS AIRES",293,7,219,64,0,283,0.0238907849829352
"062521402","BUENOS AIRES",431,0,269,154,0,423,0
"062521505","BUENOS AIRES",362,0,265,96,0,361,0
"064130901","BUENOS AIRES",42,6,11,25,0,36,0.142857142857143
"062600104","BUENOS AIRES",235,16,43,166,3,212,0.0680851063829787
"062600105","BUENOS AIRES",306,0,6,222,13,241,0
"062600117","BUENOS AIRES",464,8,236,208,0,444,0.0172413793103448
"062600311","BUENOS AIRES",432,429,3,0,0,3,0.993055555555556
"062600319","BUENOS AIRES",325,4,187,126,2,315,0.0123076923076923
"062600403","BUENOS AIRES",339,7,208,109,2,319,0.0206489675516224
"062600405","BUENOS AIRES",313,43,183,83,0,266,0.137380191693291
"062601204","BUENOS AIRES",303,298,4,1,0,5,0.983498349834984
"062601210","BUENOS AIRES",204,1,154,47,0,201,0.00490196078431373
"064131507","BUENOS AIRES",68,2,39,27,0,66,0.0294117647058824
"062600412","BUENOS AIRES",331,2,251,51,4,306,0.00604229607250755
"062600503","BUENOS AIRES",240,0,152,78,1,231,0
"064131801","BUENOS AIRES",106,0,46,53,1,100,0
"062600508","BUENOS AIRES",187,2,139,43,1,183,0.0106951871657754
"062601314","BUENOS AIRES",218,218,0,0,0,0,1
"062600608","BUENOS AIRES",246,3,186,57,0,243,0.0121951219512195
"062600616","BUENOS AIRES",390,4,340,46,0,386,0.0102564102564103
"062600801","BUENOS AIRES",332,0,209,108,1,318,0
"062600805","BUENOS AIRES",290,0,95,158,21,274,0
"063572806","BUENOS AIRES",177,177,0,0,0,0,1
"062600901","BUENOS AIRES",344,291,23,23,0,46,0.845930232558139
"062600902","BUENOS AIRES",325,275,37,13,0,50,0.846153846153846
"062601004","BUENOS AIRES",303,9,223,70,0,293,0.0297029702970297
"062601305","BUENOS AIRES",429,77,241,111,0,352,0.179487179487179
"062601307","BUENOS AIRES",371,331,27,12,0,39,0.892183288409704
"062601308","BUENOS AIRES",356,278,25,53,0,78,0.780898876404494
"062601605","BUENOS AIRES",370,3,206,155,0,361,0.00810810810810811
"062601614","BUENOS AIRES",472,4,257,191,3,451,0.00847457627118644
"062601707","BUENOS AIRES",58,52,4,1,0,5,0.896551724137931
"062601709","BUENOS AIRES",77,71,6,0,0,6,0.922077922077922
"062741701","BUENOS AIRES",228,218,5,4,0,9,0.956140350877193
"062660312","BUENOS AIRES",26,0,1,24,0,25,0
"062700208","BUENOS AIRES",478,1,287,182,1,470,0.00209205020920502
"062700214","BUENOS AIRES",263,0,174,82,0,256,0
"062700301","BUENOS AIRES",232,22,143,65,0,208,0.0948275862068965
"062700302","BUENOS AIRES",266,103,78,83,0,161,0.387218045112782
"020132905","CABA",280,276,0,0,0,0,0.985714285714286
"062700305","BUENOS AIRES",455,307,89,46,2,137,0.674725274725275
"062700502","BUENOS AIRES",248,130,70,48,0,118,0.524193548387097
"062700402","BUENOS AIRES",274,154,72,43,0,115,0.562043795620438
"062700607","BUENOS AIRES",420,1,232,176,5,413,0.00238095238095238
"062700613","BUENOS AIRES",108,0,100,7,0,107,0
"063573002","BUENOS AIRES",161,160,0,1,0,1,0.993788819875776
"062700704","BUENOS AIRES",191,2,136,52,1,189,0.0104712041884817
"062700711","BUENOS AIRES",367,0,228,132,0,360,0
"062700716","BUENOS AIRES",367,0,140,210,3,353,0
"062700816","BUENOS AIRES",188,0,94,89,0,183,0
"062700901","BUENOS AIRES",674,10,324,303,6,633,0.0148367952522255
"062701002","BUENOS AIRES",609,2,314,252,6,572,0.00328407224958949
"062740112","BUENOS AIRES",253,16,72,155,2,229,0.0632411067193676
"062740113","BUENOS AIRES",463,26,209,214,2,425,0.0561555075593952
"062740208","BUENOS AIRES",301,80,109,99,0,208,0.26578073089701
"062740303","BUENOS AIRES",228,8,122,95,0,217,0.0350877192982456
"062740403","BUENOS AIRES",371,15,129,210,1,340,0.0404312668463612
"062740406","BUENOS AIRES",303,7,117,134,0,251,0.0231023102310231
"062740409","BUENOS AIRES",401,184,94,105,1,200,0.458852867830424
"062740412","BUENOS AIRES",490,33,73,338,10,421,0.0673469387755102
"062740505","BUENOS AIRES",241,11,36,182,1,219,0.045643153526971
"062740510","BUENOS AIRES",318,8,150,155,0,305,0.0251572327044025
"062740515","BUENOS AIRES",355,15,116,213,2,331,0.0422535211267606
"062740603","BUENOS AIRES",304,8,77,194,0,271,0.0263157894736842
"062740616","BUENOS AIRES",220,1,74,125,5,204,0.00454545454545455
"062740619","BUENOS AIRES",198,2,78,112,3,193,0.0101010101010101
"062740811","BUENOS AIRES",242,2,92,133,6,231,0.00826446280991736
"062740912","BUENOS AIRES",247,0,43,192,4,239,0
"062740913","BUENOS AIRES",257,1,79,144,0,223,0.00389105058365759
"064900313","BUENOS AIRES",342,14,172,146,0,318,0.0409356725146199
"062741009","BUENOS AIRES",235,18,110,91,1,202,0.0765957446808511
"062741014","BUENOS AIRES",249,0,53,152,12,217,0
"062741106","BUENOS AIRES",602,114,179,294,1,474,0.18936877076412
"062741108","BUENOS AIRES",314,3,119,180,1,300,0.00955414012738853
"062741118","BUENOS AIRES",295,6,131,151,1,283,0.0203389830508475
"062741209","BUENOS AIRES",403,365,16,11,0,27,0.905707196029777
"062741210","BUENOS AIRES",331,308,9,5,0,14,0.930513595166163
"062741211","BUENOS AIRES",365,205,77,80,0,157,0.561643835616438
"062741305","BUENOS AIRES",246,143,44,47,0,91,0.58130081300813
"062741308","BUENOS AIRES",242,207,3,20,0,23,0.855371900826446
"062741313","BUENOS AIRES",177,176,1,0,0,1,0.994350282485876
"062741504","BUENOS AIRES",440,19,195,216,1,412,0.0431818181818182
"062741506","BUENOS AIRES",236,12,171,52,0,223,0.0508474576271186
"062940404","BUENOS AIRES",162,60,57,44,0,101,0.37037037037037
"064279218","BUENOS AIRES",228,0,180,42,0,222,0
"062741516","BUENOS AIRES",343,82,157,101,0,258,0.239067055393586
"062741606","BUENOS AIRES",335,175,78,73,0,151,0.522388059701492
"062741704","BUENOS AIRES",320,4,170,141,0,311,0.0125
"064275102","BUENOS AIRES",328,281,29,15,0,44,0.856707317073171
"062741712","BUENOS AIRES",258,26,109,116,2,227,0.10077519379845
"062741713","BUENOS AIRES",353,271,53,24,0,77,0.767705382436261
"062741812","BUENOS AIRES",202,0,45,135,4,184,0
"062741814","BUENOS AIRES",243,3,84,145,1,230,0.0123456790123457
"062741818","BUENOS AIRES",447,14,142,279,0,421,0.0313199105145414
"062741909","BUENOS AIRES",223,1,51,158,8,217,0.00448430493273543
"062742015","BUENOS AIRES",10,0,4,6,0,10,0
"062742007","BUENOS AIRES",486,5,130,330,1,461,0.0102880658436214
"062742011","BUENOS AIRES",332,3,103,198,0,301,0.00903614457831325
"062742014","BUENOS AIRES",63,0,6,55,0,61,0
"063571613","BUENOS AIRES",205,205,0,0,0,0,1
"062742105","BUENOS AIRES",375,207,40,120,0,160,0.552
"065151605","BUENOS AIRES",239,1,184,48,3,235,0.00418410041841004
"062742110","BUENOS AIRES",265,3,113,139,2,254,0.0113207547169811
"062742113","BUENOS AIRES",380,1,155,205,1,361,0.00263157894736842
"062742114","BUENOS AIRES",314,1,174,138,1,313,0.00318471337579618
"062800204","BUENOS AIRES",241,217,18,5,0,23,0.900414937759336
"062800104","BUENOS AIRES",230,94,74,58,0,132,0.408695652173913
"062800106","BUENOS AIRES",137,27,32,72,2,106,0.197080291970803
"062800407","BUENOS AIRES",69,42,13,12,2,27,0.608695652173913
"062800408","BUENOS AIRES",96,44,13,39,0,52,0.458333333333333
"062940601","BUENOS AIRES",263,0,106,157,0,263,0
"064342512","BUENOS AIRES",225,5,148,71,0,219,0.0222222222222222
"062800611","BUENOS AIRES",73,2,32,37,0,69,0.0273972602739726
"062800819","BUENOS AIRES",216,171,30,15,0,45,0.791666666666667
"062800820","BUENOS AIRES",99,61,22,12,1,35,0.616161616161616
"063290314","BUENOS AIRES",192,85,63,36,0,99,0.442708333333333
"062800909","BUENOS AIRES",41,0,28,13,0,41,0
"062801008","BUENOS AIRES",125,125,0,0,0,0,1
"062801107","BUENOS AIRES",153,150,1,2,0,3,0.980392156862745
"062801109","BUENOS AIRES",214,118,49,45,0,94,0.551401869158878
"062801111","BUENOS AIRES",153,7,61,83,0,144,0.0457516339869281
"063570205","BUENOS AIRES",270,267,1,2,0,3,0.988888888888889
"062940204","BUENOS AIRES",336,216,65,53,0,118,0.642857142857143
"063574815","BUENOS AIRES",214,212,0,1,0,1,0.990654205607477
"062940803","BUENOS AIRES",199,127,22,49,0,71,0.638190954773869
"063010510","BUENOS AIRES",242,29,140,73,0,213,0.119834710743802
"064279109","BUENOS AIRES",297,3,113,140,4,257,0.0101010101010101
"064279214","BUENOS AIRES",412,2,254,147,0,401,0.00485436893203883
"063010804","BUENOS AIRES",55,0,36,19,0,55,0
"063010807","BUENOS AIRES",117,1,81,35,0,116,0.00854700854700855
"063080602","BUENOS AIRES",143,0,92,49,1,142,0
"063220307","BUENOS AIRES",125,0,39,82,1,122,0
"063220602","BUENOS AIRES",272,34,125,113,0,238,0.125
"063220612","BUENOS AIRES",244,4,143,96,0,239,0.0163934426229508
"064340306","BUENOS AIRES",260,192,43,23,0,66,0.738461538461539
"063220701","BUENOS AIRES",68,0,29,38,0,67,0
"063290307","BUENOS AIRES",153,2,83,68,0,151,0.0130718954248366
"063290309","BUENOS AIRES",251,59,127,63,0,190,0.235059760956175
"063290310","BUENOS AIRES",307,42,157,100,5,262,0.136807817589577
"063290315","BUENOS AIRES",294,79,150,63,0,213,0.268707482993197
"063570701","BUENOS AIRES",287,283,2,2,0,4,0.986062717770035
"063360201","BUENOS AIRES",175,109,41,22,1,64,0.622857142857143
"063430711","BUENOS AIRES",215,63,97,52,0,149,0.293023255813953
"063510603","BUENOS AIRES",312,251,33,20,4,57,0.80448717948718
"063510607","BUENOS AIRES",340,299,32,9,0,41,0.879411764705882
"063570102","BUENOS AIRES",326,311,8,7,0,15,0.95398773006135
"063570203","BUENOS AIRES",267,262,2,3,0,5,0.9812734082397
"063570209","BUENOS AIRES",281,281,0,0,0,0,1
"063570301","BUENOS AIRES",147,132,8,7,0,15,0.897959183673469
"063570409","BUENOS AIRES",228,228,0,0,0,0,1
"063571611","BUENOS AIRES",170,169,1,0,0,1,0.994117647058824
"063571002","BUENOS AIRES",214,194,14,5,0,19,0.906542056074766
"063571005","BUENOS AIRES",337,144,35,146,0,181,0.427299703264095
"063571104","BUENOS AIRES",404,7,151,237,0,388,0.0173267326732673
"063571110","BUENOS AIRES",269,229,26,10,0,36,0.851301115241636
"063571205","BUENOS AIRES",381,375,3,3,0,6,0.984251968503937
"063571213","BUENOS AIRES",279,254,10,14,0,24,0.910394265232975
"063571307","BUENOS AIRES",364,354,5,3,0,8,0.972527472527473
"063571502","BUENOS AIRES",208,208,0,0,0,0,1
"063571505","BUENOS AIRES",356,356,0,0,0,0,1
"063571506","BUENOS AIRES",245,241,3,0,0,3,0.983673469387755
"063571507","BUENOS AIRES",701,700,1,0,0,1,0.998573466476462
"063571601","BUENOS AIRES",269,266,1,0,0,1,0.988847583643123
"063571605","BUENOS AIRES",201,195,2,4,0,6,0.970149253731343
"063571609","BUENOS AIRES",155,155,0,0,0,0,1
"063571708","BUENOS AIRES",249,244,3,0,0,3,0.979919678714859
"063571903","BUENOS AIRES",155,154,1,0,0,1,0.993548387096774
"063572214","BUENOS AIRES",204,204,0,0,0,0,1
"063573209","BUENOS AIRES",252,252,0,0,0,0,1
"063573401","BUENOS AIRES",176,176,0,0,0,0,1
"063573501","BUENOS AIRES",256,256,0,0,0,0,1
"063574006","BUENOS AIRES",161,161,0,0,0,0,1
"063574302","BUENOS AIRES",89,89,0,0,0,0,1
"063574408","BUENOS AIRES",126,126,0,0,0,0,1
"063574502","BUENOS AIRES",184,184,0,0,0,0,1
"063574509","BUENOS AIRES",336,330,5,0,1,6,0.982142857142857
"063574603","BUENOS AIRES",238,238,0,0,0,0,1
"063574704","BUENOS AIRES",261,261,0,0,0,0,1
"063574801","BUENOS AIRES",363,363,0,0,0,0,1
"063574805","BUENOS AIRES",204,203,1,0,0,1,0.995098039215686
"063574808","BUENOS AIRES",197,197,0,0,0,0,1
"063575001","BUENOS AIRES",257,251,4,1,0,5,0.976653696498054
"063575013","BUENOS AIRES",192,190,2,0,0,2,0.989583333333333
"063575101","BUENOS AIRES",237,231,3,3,0,6,0.974683544303797
"063575212","BUENOS AIRES",324,226,49,48,0,97,0.697530864197531
"020010907","CABA",288,283,5,0,0,5,0.982638888888889
"063575305","BUENOS AIRES",264,243,9,11,1,21,0.920454545454545
"063575311","BUENOS AIRES",329,289,10,21,0,31,0.878419452887538
"063575314","BUENOS AIRES",234,198,12,21,0,33,0.846153846153846
"063575401","BUENOS AIRES",301,286,8,4,0,12,0.950166112956811
"063575506","BUENOS AIRES",257,257,0,0,0,0,1
"063575606","BUENOS AIRES",284,280,4,0,0,4,0.985915492957746
"064413603","BUENOS AIRES",235,208,18,8,0,26,0.885106382978723
"063575708","BUENOS AIRES",208,205,2,1,0,3,0.985576923076923
"063575805","BUENOS AIRES",350,348,2,0,0,2,0.994285714285714
"063575904","BUENOS AIRES",291,291,0,0,0,0,1
"063576009","BUENOS AIRES",212,208,4,0,0,4,0.981132075471698
"063576106","BUENOS AIRES",373,371,2,0,0,2,0.994638069705094
"063576204","BUENOS AIRES",292,288,4,0,0,4,0.986301369863014
"063576208","BUENOS AIRES",183,181,2,0,0,2,0.989071038251366
"064414011","BUENOS AIRES",386,322,30,22,1,53,0.83419689119171
"063577105","BUENOS AIRES",269,267,0,0,0,0,0.992565055762082
"063577107","BUENOS AIRES",321,319,1,1,0,2,0.993769470404984
"063577108","BUENOS AIRES",424,421,3,0,0,3,0.992924528301887
"063576301","BUENOS AIRES",4,2,2,0,0,2,0.5
"063576504","BUENOS AIRES",334,315,16,3,0,19,0.94311377245509
"063576704","BUENOS AIRES",302,280,10,3,0,13,0.927152317880795
"063576707","BUENOS AIRES",402,384,6,6,0,12,0.955223880597015
"063576708","BUENOS AIRES",252,246,1,1,0,2,0.976190476190476
"063576711","BUENOS AIRES",379,354,7,10,0,17,0.934036939313984
"063576901","BUENOS AIRES",240,231,6,3,0,9,0.9625
"063576911","BUENOS AIRES",194,181,5,3,0,8,0.93298969072165
"063577004","BUENOS AIRES",419,414,4,1,0,5,0.988066825775656
"063577006","BUENOS AIRES",253,223,3,1,0,4,0.881422924901186
"063577007","BUENOS AIRES",380,377,2,1,0,3,0.992105263157895
"063577103","BUENOS AIRES",397,394,0,1,0,1,0.992443324937028
"063577201","BUENOS AIRES",289,208,18,52,1,71,0.719723183391003
"063577306","BUENOS AIRES",347,345,2,0,0,2,0.994236311239193
"063577307","BUENOS AIRES",71,0,17,51,0,68,0
"063577401","BUENOS AIRES",336,273,63,0,0,63,0.8125
"063577403","BUENOS AIRES",228,12,162,54,0,216,0.0526315789473684
"064415202","BUENOS AIRES",254,240,12,2,0,14,0.94488188976378
"063577416","BUENOS AIRES",158,2,136,20,0,156,0.0126582278481013
"063577505","BUENOS AIRES",64,17,35,12,0,47,0.265625
"063577507","BUENOS AIRES",196,4,87,105,0,192,0.0204081632653061
"063577509","BUENOS AIRES",82,7,40,35,0,75,0.0853658536585366
"063577516","BUENOS AIRES",58,1,36,21,0,57,0.0172413793103448
"020151808","CABA",218,217,1,0,0,1,0.995412844036697
"063577610","BUENOS AIRES",242,0,165,74,0,239,0
"063577708","BUENOS AIRES",42,0,35,7,0,42,0
"063577716","BUENOS AIRES",66,1,55,9,0,64,0.0151515151515152
"063577803","BUENOS AIRES",111,5,44,58,1,103,0.045045045045045
"063710706","BUENOS AIRES",426,410,10,2,2,14,0.962441314553991
"063710808","BUENOS AIRES",359,355,1,3,0,4,0.988857938718663
"063577810","BUENOS AIRES",296,6,96,188,2,286,0.0202702702702703
"063577816","BUENOS AIRES",207,2,91,108,0,199,0.00966183574879227
"063578014","BUENOS AIRES",137,0,84,50,0,134,0
"063578012","BUENOS AIRES",100,0,26,72,0,98,0
"063711713","BUENOS AIRES",368,14,173,181,0,354,0.0380434782608696
"063578208","BUENOS AIRES",90,1,78,11,0,89,0.0111111111111111
"063578209","BUENOS AIRES",67,1,59,6,0,65,0.0149253731343284
"063640103","BUENOS AIRES",368,289,49,24,3,76,0.785326086956522
"063710810","BUENOS AIRES",340,330,7,3,0,10,0.970588235294118
"063711003","BUENOS AIRES",352,350,2,0,0,2,0.994318181818182
"063640206","BUENOS AIRES",234,46,97,84,0,181,0.196581196581197
"063640213","BUENOS AIRES",143,0,56,83,1,140,0
"063640303","BUENOS AIRES",230,4,95,123,2,220,0.0173913043478261
"063640406","BUENOS AIRES",213,0,121,82,4,207,0
"063640408","BUENOS AIRES",237,0,80,133,4,217,0
"063711903","BUENOS AIRES",309,308,1,0,0,1,0.996763754045307
"020111202","CABA",236,230,6,0,0,6,0.974576271186441
"063640701","BUENOS AIRES",263,0,201,60,0,261,0
"063710106","BUENOS AIRES",162,4,46,82,17,145,0.0246913580246914
"063710107","BUENOS AIRES",102,5,16,45,30,91,0.0490196078431373
"063710203","BUENOS AIRES",426,14,207,204,1,412,0.0328638497652582
"063710401","BUENOS AIRES",478,452,14,8,0,22,0.945606694560669
"063710701","BUENOS AIRES",283,268,12,3,0,15,0.946996466431095
"063711102","BUENOS AIRES",237,233,2,1,0,3,0.983122362869198
"063711208","BUENOS AIRES",432,406,23,3,0,26,0.939814814814815
"063711404","BUENOS AIRES",248,4,28,203,2,233,0.0161290322580645
"063711412","BUENOS AIRES",281,4,201,76,0,277,0.0142348754448399
"063711505","BUENOS AIRES",654,104,136,376,0,512,0.159021406727829
"063711702","BUENOS AIRES",331,81,195,53,0,248,0.244712990936556
"063711704","BUENOS AIRES",321,37,135,148,0,283,0.115264797507788
"063711707","BUENOS AIRES",305,33,238,34,0,272,0.108196721311475
"064341902","BUENOS AIRES",367,7,197,163,0,360,0.0190735694822888
"063711907","BUENOS AIRES",370,286,67,17,0,84,0.772972972972973
"063712203","BUENOS AIRES",276,269,5,2,0,7,0.97463768115942
"063712101","BUENOS AIRES",312,305,5,2,0,7,0.977564102564103
"063712113","BUENOS AIRES",292,282,5,5,0,10,0.965753424657534
"063712302","BUENOS AIRES",414,385,11,18,0,29,0.929951690821256
"063712303","BUENOS AIRES",150,149,1,0,0,1,0.993333333333333
"063712316","BUENOS AIRES",426,405,12,9,0,21,0.950704225352113
"063712317","BUENOS AIRES",278,275,2,1,0,3,0.989208633093525
"063712504","BUENOS AIRES",297,278,14,4,0,18,0.936026936026936
"063712601","BUENOS AIRES",371,358,11,2,0,13,0.964959568733154
"063712604","BUENOS AIRES",334,325,4,5,0,9,0.973053892215569
"063712703","BUENOS AIRES",524,431,8,73,2,83,0.822519083969466
"063712905","BUENOS AIRES",404,293,75,36,0,111,0.725247524752475
"063712908","BUENOS AIRES",654,615,20,17,1,38,0.940366972477064
"063713210","BUENOS AIRES",440,17,162,258,1,421,0.0386363636363636
"063713301","BUENOS AIRES",267,142,33,86,0,119,0.531835205992509
"063713405","BUENOS AIRES",460,185,118,145,4,267,0.402173913043478
"063713406","BUENOS AIRES",284,7,136,141,0,277,0.0246478873239437
"063713408","BUENOS AIRES",349,9,234,105,0,339,0.0257879656160458
"063713508","BUENOS AIRES",54,31,10,12,1,23,0.574074074074074
"064902508","BUENOS AIRES",346,216,76,54,0,130,0.624277456647399
"063850715","BUENOS AIRES",272,213,17,38,1,56,0.783088235294118
"063920106","BUENOS AIRES",385,375,4,6,0,10,0.974025974025974
"063920113","BUENOS AIRES",318,297,10,5,0,15,0.933962264150943
"063920801","BUENOS AIRES",258,4,193,55,1,249,0.0155038759689922
"063990801","BUENOS AIRES",20,0,18,2,0,20,0
"064270805","BUENOS AIRES",349,341,5,2,0,7,0.977077363896848
"064060207","BUENOS AIRES",235,107,53,63,0,116,0.45531914893617
"064060216","BUENOS AIRES",214,82,62,63,6,131,0.383177570093458
"064080107","BUENOS AIRES",399,183,201,14,0,215,0.458646616541353
"064080114","BUENOS AIRES",34,11,13,10,0,23,0.323529411764706
"064080404","BUENOS AIRES",508,2,329,160,0,489,0.00393700787401575
"064080405","BUENOS AIRES",360,1,272,72,0,344,0.00277777777777778
"064080406","BUENOS AIRES",284,19,195,60,1,256,0.0669014084507042
"064130211","BUENOS AIRES",298,295,1,1,0,2,0.98993288590604
"064080503","BUENOS AIRES",356,1,231,90,1,322,0.00280898876404494
"064080505","BUENOS AIRES",135,10,79,40,5,124,0.0740740740740741
"064080607","BUENOS AIRES",344,2,312,29,0,341,0.00581395348837209
"064080609","BUENOS AIRES",351,2,316,23,0,339,0.0056980056980057
"064080704","BUENOS AIRES",424,194,146,80,0,226,0.457547169811321
"064080708","BUENOS AIRES",337,24,267,46,0,313,0.0712166172106825
"064080709","BUENOS AIRES",218,46,117,55,0,172,0.211009174311927
"064080805","BUENOS AIRES",241,1,195,42,0,237,0.004149377593361
"064080809","BUENOS AIRES",253,7,182,64,0,246,0.0276679841897233
"064080810","BUENOS AIRES",335,6,202,123,0,325,0.017910447761194
"064080904","BUENOS AIRES",261,9,200,52,0,252,0.0344827586206897
"064081003","BUENOS AIRES",436,1,351,82,1,434,0.00229357798165138
"064081109","BUENOS AIRES",73,0,54,14,0,68,0
"064081312","BUENOS AIRES",344,4,227,108,0,335,0.0116279069767442
"064081410","BUENOS AIRES",273,5,208,56,0,264,0.0183150183150183
"064970606","BUENOS AIRES",100,3,57,39,0,96,0.03
"064100107","BUENOS AIRES",227,18,189,20,0,209,0.079295154185022
"020120311","CABA",290,287,2,0,0,2,0.989655172413793
"064100210","BUENOS AIRES",287,2,242,42,0,284,0.00696864111498258
"065151703","BUENOS AIRES",194,2,146,45,0,191,0.0103092783505155
"064100402","BUENOS AIRES",336,1,272,60,0,332,0.00297619047619048
"064100406","BUENOS AIRES",364,1,323,37,1,361,0.00274725274725275
"064100416","BUENOS AIRES",181,3,113,65,0,178,0.0165745856353591
"064100502","BUENOS AIRES",297,0,235,58,0,293,0
"064100506","BUENOS AIRES",219,33,131,51,0,182,0.150684931506849
"064100513","BUENOS AIRES",394,1,279,108,0,387,0.00253807106598985
"064100601","BUENOS AIRES",356,0,206,138,3,347,0
"064100603","BUENOS AIRES",380,2,335,41,0,376,0.00526315789473684
"020130605","CABA",454,451,0,0,0,0,0.993392070484581
"064100701","BUENOS AIRES",222,2,208,11,0,219,0.00900900900900901
"064100704","BUENOS AIRES",440,0,397,39,0,436,0
"064100712","BUENOS AIRES",282,0,239,43,0,282,0
"064100807","BUENOS AIRES",387,90,217,77,0,294,0.232558139534884
"064101001","BUENOS AIRES",420,4,386,28,0,414,0.00952380952380952
"064101002","BUENOS AIRES",430,1,379,48,0,427,0.00232558139534884
"064121115","BUENOS AIRES",362,6,221,127,1,349,0.0165745856353591
"064101102","BUENOS AIRES",352,258,87,7,0,94,0.732954545454545
"064101105","BUENOS AIRES",200,147,49,4,0,53,0.735
"064101110","BUENOS AIRES",348,0,301,47,0,348,0
"064101201","BUENOS AIRES",331,258,59,14,0,73,0.779456193353474
"064101203","BUENOS AIRES",212,2,191,19,0,210,0.00943396226415094
"064101213","BUENOS AIRES",472,2,347,120,1,468,0.00423728813559322
"064270810","BUENOS AIRES",456,446,7,3,0,10,0.978070175438597
"064101310","BUENOS AIRES",250,0,198,51,0,249,0
"064120105","BUENOS AIRES",99,4,74,21,0,95,0.0404040404040404
"064120110","BUENOS AIRES",406,1,276,122,1,399,0.00246305418719212
"064120114","BUENOS AIRES",332,101,86,136,3,225,0.30421686746988
"064120302","BUENOS AIRES",448,21,285,129,1,415,0.046875
"064120303","BUENOS AIRES",441,1,355,81,0,436,0.00226757369614512
"064120304","BUENOS AIRES",405,5,285,109,1,395,0.0123456790123457
"064120409","BUENOS AIRES",230,3,165,58,0,223,0.0130434782608696
"064120608","BUENOS AIRES",461,1,333,109,2,444,0.00216919739696312
"064120514","BUENOS AIRES",297,1,254,40,0,294,0.00336700336700337
"064120601","BUENOS AIRES",171,0,134,36,1,171,0
"064120603","BUENOS AIRES",292,1,255,36,0,291,0.00342465753424658
"064120605","BUENOS AIRES",282,0,238,44,0,282,0
"020120607","CABA",332,331,1,0,0,1,0.996987951807229
"064120611","BUENOS AIRES",475,1,367,99,3,469,0.00210526315789474
"064120613","BUENOS AIRES",342,1,266,75,0,341,0.00292397660818713
"064120701","BUENOS AIRES",370,0,210,147,0,357,0
"064120705","BUENOS AIRES",274,1,172,93,0,265,0.00364963503649635
"064120713","BUENOS AIRES",374,2,275,93,0,368,0.0053475935828877
"064120918","BUENOS AIRES",407,0,132,262,5,399,0
"064121013","BUENOS AIRES",259,1,72,179,1,252,0.00386100386100386
"064121020","BUENOS AIRES",399,386,8,1,0,9,0.967418546365915
"064121021","BUENOS AIRES",330,318,10,0,0,10,0.963636363636364
"064121110","BUENOS AIRES",242,3,117,117,0,234,0.012396694214876
"064270109","BUENOS AIRES",262,262,0,0,0,0,1
"020050601","CABA",304,304,0,0,0,0,1
"064121116","BUENOS AIRES",289,3,100,167,2,269,0.0103806228373702
"064121203","BUENOS AIRES",386,3,250,130,0,380,0.0077720207253886
"064121207","BUENOS AIRES",448,0,182,250,2,434,0
"064121302","BUENOS AIRES",381,1,265,107,0,372,0.0026246719160105
"064121307","BUENOS AIRES",299,0,158,121,3,282,0
"064121401","BUENOS AIRES",250,1,214,32,0,246,0.004
"064121402","BUENOS AIRES",326,0,222,98,0,320,0
"064130108","BUENOS AIRES",299,290,5,4,0,9,0.969899665551839
"064121508","BUENOS AIRES",270,1,203,62,0,265,0.0037037037037037
"064121509","BUENOS AIRES",291,0,213,77,0,290,0
"064130102","BUENOS AIRES",293,259,9,23,0,32,0.883959044368601
"064130104","BUENOS AIRES",372,370,1,1,0,2,0.994623655913978
"064130203","BUENOS AIRES",322,294,10,17,0,27,0.91304347826087
"064130212","BUENOS AIRES",301,298,2,1,0,3,0.990033222591362
"064130213","BUENOS AIRES",258,210,13,35,0,48,0.813953488372093
"064130305","BUENOS AIRES",240,239,1,0,0,1,0.995833333333333
"065151906","BUENOS AIRES",240,1,110,122,1,233,0.00416666666666667
"064130311","BUENOS AIRES",267,261,2,3,0,5,0.97752808988764
"064130409","BUENOS AIRES",386,381,1,4,0,5,0.987046632124352
"064130502","BUENOS AIRES",298,295,2,1,0,3,0.98993288590604
"064130513","BUENOS AIRES",148,148,0,0,0,0,1
"064900805","BUENOS AIRES",157,154,3,0,0,3,0.980891719745223
"064130606","BUENOS AIRES",307,301,4,2,0,6,0.980456026058632
"064131303","BUENOS AIRES",172,9,32,123,1,156,0.0523255813953488
"064131903","BUENOS AIRES",40,0,37,1,0,38,0
"064132203","BUENOS AIRES",42,0,29,13,0,42,0
"064132207","BUENOS AIRES",68,3,10,48,1,59,0.0441176470588235
"064200108","BUENOS AIRES",81,67,11,3,0,14,0.827160493827161
"065151807","BUENOS AIRES",349,0,169,163,3,335,0
"064271001","BUENOS AIRES",473,425,14,24,0,38,0.898520084566596
"065180808","BUENOS AIRES",83,1,65,16,0,81,0.0120481927710843
"064200206","BUENOS AIRES",26,26,0,0,0,0,1
"064200303","BUENOS AIRES",63,32,11,20,0,31,0.507936507936508
"064200317","BUENOS AIRES",58,51,6,0,1,7,0.879310344827586
"064200318","BUENOS AIRES",39,11,22,5,1,28,0.282051282051282
"064200320","BUENOS AIRES",132,1,91,36,1,128,0.00757575757575758
"065151705","BUENOS AIRES",204,0,179,24,0,203,0
"064201203","BUENOS AIRES",101,3,78,16,1,95,0.0297029702970297
"064201205","BUENOS AIRES",69,1,49,15,0,64,0.0144927536231884
"061400314","BUENOS AIRES",11,0,4,7,0,11,0
"065151706","BUENOS AIRES",388,1,217,156,8,381,0.00257731958762887
"064411813","BUENOS AIRES",203,202,1,0,0,1,0.995073891625616
"064200407","BUENOS AIRES",114,98,11,5,0,16,0.859649122807018
"064200411","BUENOS AIRES",101,0,81,19,0,100,0
"064200415","BUENOS AIRES",72,67,4,1,0,5,0.930555555555556
"065250414","BUENOS AIRES",373,5,197,160,0,357,0.0134048257372654
"064200611","BUENOS AIRES",8,8,0,0,0,0,1
"064200708","BUENOS AIRES",53,53,0,0,0,0,1
"064200709","BUENOS AIRES",24,24,0,0,0,0,1
"064200807","BUENOS AIRES",111,104,4,2,0,6,0.936936936936937
"064201003","BUENOS AIRES",29,22,4,3,0,7,0.758620689655172
"065320308","BUENOS AIRES",355,212,32,92,0,124,0.597183098591549
"064201106","BUENOS AIRES",89,19,34,36,0,70,0.213483146067416
"064201114","BUENOS AIRES",74,67,2,5,0,7,0.905405405405405
"064271005","BUENOS AIRES",400,383,10,5,0,15,0.9575
"063711103","BUENOS AIRES",315,313,0,2,0,2,0.993650793650794
"064201116","BUENOS AIRES",115,68,28,19,0,47,0.591304347826087
"064201709","BUENOS AIRES",196,186,2,7,0,9,0.948979591836735
"064201801","BUENOS AIRES",16,16,0,0,0,0,1
"064201903","BUENOS AIRES",100,92,4,3,0,7,0.92
"064202102","BUENOS AIRES",68,63,2,2,0,4,0.926470588235294
"064202110","BUENOS AIRES",200,183,4,12,0,16,0.915
"064270113","BUENOS AIRES",307,300,3,3,0,6,0.977198697068404
"064270207","BUENOS AIRES",259,258,1,0,0,1,0.996138996138996
"064270208","BUENOS AIRES",251,245,2,4,0,6,0.97609561752988
"064270404","BUENOS AIRES",312,306,4,2,0,6,0.980769230769231
"064270406","BUENOS AIRES",322,303,8,10,0,18,0.940993788819876
"064270603","BUENOS AIRES",319,309,2,5,0,7,0.968652037617555
"064270604","BUENOS AIRES",574,554,15,3,0,18,0.965156794425087
"064270605","BUENOS AIRES",212,205,4,2,0,6,0.966981132075472
"064270701","BUENOS AIRES",408,381,18,3,0,21,0.933823529411765
"064270801","BUENOS AIRES",393,386,6,1,0,7,0.982188295165394
"064270802","BUENOS AIRES",421,411,0,0,0,0,0.97624703087886
"064275405","BUENOS AIRES",298,290,5,2,0,7,0.973154362416107
"064271008","BUENOS AIRES",390,375,4,11,0,15,0.961538461538462
"064271012","BUENOS AIRES",410,388,15,6,0,21,0.946341463414634
"064271202","BUENOS AIRES",438,418,3,7,0,10,0.954337899543379
"064271204","BUENOS AIRES",216,213,1,2,0,3,0.986111111111111
"064271417","BUENOS AIRES",258,235,13,8,0,21,0.910852713178295
"064271504","BUENOS AIRES",419,419,0,0,0,0,1
"064271508","BUENOS AIRES",269,257,4,5,0,9,0.955390334572491
"064271510","BUENOS AIRES",271,265,0,1,0,1,0.977859778597786
"064902604","BUENOS AIRES",160,133,24,3,0,27,0.83125
"064271707","BUENOS AIRES",1370,878,167,282,4,453,0.640875912408759
"064271709","BUENOS AIRES",275,238,18,18,0,36,0.865454545454545
"065391609","BUENOS AIRES",215,171,25,14,0,39,0.795348837209302
"064271811","BUENOS AIRES",447,40,195,189,13,397,0.0894854586129754
"064272303","BUENOS AIRES",609,600,5,3,0,8,0.985221674876847
"064272306","BUENOS AIRES",418,373,21,20,0,41,0.892344497607656
"064275806","BUENOS AIRES",248,8,143,92,0,235,0.032258064516129
"064271812","BUENOS AIRES",67,14,18,34,1,53,0.208955223880597
"064272001","BUENOS AIRES",242,179,20,35,1,56,0.739669421487603
"064272004","BUENOS AIRES",229,210,5,8,0,13,0.91703056768559
"064272016","BUENOS AIRES",653,292,210,130,2,342,0.447166921898928
"064272101","BUENOS AIRES",437,414,17,2,0,19,0.947368421052632
"064272103","BUENOS AIRES",498,477,11,2,1,14,0.957831325301205
"064272107","BUENOS AIRES",320,314,1,1,0,2,0.98125
"064272201","BUENOS AIRES",279,271,5,1,0,6,0.971326164874552
"064272209","BUENOS AIRES",392,379,9,3,0,12,0.966836734693878
"064272512","BUENOS AIRES",849,346,301,163,1,465,0.4075382803298
"064272611","BUENOS AIRES",426,378,31,15,0,46,0.887323943661972
"064272801","BUENOS AIRES",385,380,4,0,0,4,0.987012987012987
"064272809","BUENOS AIRES",246,236,7,3,0,10,0.959349593495935
"064272812","BUENOS AIRES",396,393,3,0,0,3,0.992424242424242
"066580815","BUENOS AIRES",157,157,0,0,0,0,1
"065392712","BUENOS AIRES",430,8,187,223,2,412,0.0186046511627907
"064272914","BUENOS AIRES",382,349,15,17,1,33,0.913612565445026
"064273202","BUENOS AIRES",271,265,6,0,0,6,0.977859778597786
"064273312","BUENOS AIRES",508,504,2,2,0,4,0.992125984251969
"064273313","BUENOS AIRES",300,298,1,1,0,2,0.993333333333333
"064273411","BUENOS AIRES",255,253,1,0,0,1,0.992156862745098
"065392922","BUENOS AIRES",362,0,233,124,0,357,0
"064273506","BUENOS AIRES",408,400,4,4,0,8,0.980392156862745
"064273508","BUENOS AIRES",343,315,11,16,0,27,0.918367346938776
"064273602","BUENOS AIRES",334,311,19,1,0,20,0.931137724550898
"064273702","BUENOS AIRES",211,173,18,17,0,35,0.819905213270142
"064273902","BUENOS AIRES",327,268,24,27,1,52,0.819571865443425
"020131201","CABA",277,277,0,0,0,0,1
"064273904","BUENOS AIRES",404,375,15,9,0,24,0.928217821782178
"064273908","BUENOS AIRES",22,3,3,16,0,19,0.136363636363636
"064274106","BUENOS AIRES",374,347,13,12,0,25,0.927807486631016
"064274205","BUENOS AIRES",394,371,17,3,1,21,0.941624365482233
"064274210","BUENOS AIRES",253,241,8,4,0,12,0.952569169960474
"064274303","BUENOS AIRES",444,430,6,5,0,11,0.968468468468468
"064274304","BUENOS AIRES",381,377,1,0,0,1,0.989501312335958
"064274308","BUENOS AIRES",366,364,0,0,0,0,0.994535519125683
"064274311","BUENOS AIRES",295,292,3,0,0,3,0.989830508474576
"064274404","BUENOS AIRES",432,388,14,28,0,42,0.898148148148148
"064274503","BUENOS AIRES",308,290,11,7,0,18,0.941558441558442
"064274602","BUENOS AIRES",227,0,85,128,0,213,0
"064274613","BUENOS AIRES",451,167,184,96,0,280,0.370288248337029
"064274704","BUENOS AIRES",225,217,3,4,0,7,0.964444444444444
"064274805","BUENOS AIRES",304,279,6,19,0,25,0.917763157894737
"064276602","BUENOS AIRES",323,4,214,96,0,310,0.0123839009287926
"064274813","BUENOS AIRES",415,336,53,10,0,63,0.809638554216867
"064274903","BUENOS AIRES",351,329,6,10,0,16,0.937321937321937
"064275006","BUENOS AIRES",475,456,9,7,0,16,0.96
"065530303","BUENOS AIRES",64,46,8,9,0,17,0.71875
"064275105","BUENOS AIRES",317,299,9,7,1,17,0.943217665615142
"064275205","BUENOS AIRES",448,66,136,202,5,343,0.147321428571429
"064275207","BUENOS AIRES",376,15,97,254,3,354,0.0398936170212766
"064275601","BUENOS AIRES",293,14,184,94,0,278,0.0477815699658703
"064275807","BUENOS AIRES",347,5,184,149,0,333,0.0144092219020173
"064275815","BUENOS AIRES",543,47,240,200,9,449,0.0865561694290976
"064275903","BUENOS AIRES",561,17,317,219,0,536,0.0303030303030303
"064276004","BUENOS AIRES",319,15,207,97,0,304,0.0470219435736677
"064276017","BUENOS AIRES",312,12,177,118,2,297,0.0384615384615385
"064276101","BUENOS AIRES",532,448,40,29,0,69,0.842105263157895
"064276105","BUENOS AIRES",582,399,90,73,5,168,0.685567010309278
"064276106","BUENOS AIRES",375,108,96,157,3,256,0.288
"064276209","BUENOS AIRES",340,36,181,110,0,291,0.105882352941176
"064276210","BUENOS AIRES",554,16,424,103,0,527,0.0288808664259928
"065600717","BUENOS AIRES",416,0,283,117,5,405,0
"064276403","BUENOS AIRES",438,16,201,206,1,408,0.0365296803652968
"064276409","BUENOS AIRES",495,25,304,153,3,460,0.0505050505050505
"064276501","BUENOS AIRES",492,32,195,236,7,438,0.0650406504065041
"064276506","BUENOS AIRES",335,22,143,164,0,307,0.0656716417910448
"020130414","CABA",327,326,1,0,0,1,0.996941896024465
"064276702","BUENOS AIRES",470,14,175,247,11,433,0.0297872340425532
"064276703","BUENOS AIRES",288,1,103,124,14,241,0.00347222222222222
"064276715","BUENOS AIRES",299,10,116,150,3,269,0.0334448160535117
"064276810","BUENOS AIRES",261,0,204,52,0,256,0
"064276901","BUENOS AIRES",289,9,227,44,0,271,0.0311418685121107
"065601107","BUENOS AIRES",393,11,210,164,2,376,0.0279898218829517
"064276910","BUENOS AIRES",221,8,157,55,0,212,0.0361990950226244
"064276912","BUENOS AIRES",268,5,204,58,0,262,0.0186567164179104
"065601204","BUENOS AIRES",232,3,149,74,1,224,0.0129310344827586
"064277008","BUENOS AIRES",389,9,248,128,1,377,0.0231362467866324
"064277015","BUENOS AIRES",244,10,184,32,0,216,0.040983606557377
"064277107","BUENOS AIRES",469,17,319,121,0,440,0.0362473347547974
"064277116","BUENOS AIRES",420,10,240,161,1,402,0.0238095238095238
"064277315","BUENOS AIRES",300,0,184,106,2,292,0
"064277408","BUENOS AIRES",391,10,247,122,0,369,0.0255754475703325
"064277414","BUENOS AIRES",413,6,233,152,0,385,0.0145278450363196
"064277503","BUENOS AIRES",410,30,110,260,4,374,0.0731707317073171
"064277504","BUENOS AIRES",520,8,198,286,2,486,0.0153846153846154
"064277513","BUENOS AIRES",357,17,136,178,4,318,0.0476190476190476
"064277514","BUENOS AIRES",321,5,160,150,0,310,0.0155763239875389
"064277601","BUENOS AIRES",464,5,160,265,8,433,0.0107758620689655
"064277810","BUENOS AIRES",357,0,145,188,1,334,0
"065601703","BUENOS AIRES",334,1,120,180,12,312,0.0029940119760479
"064277611","BUENOS AIRES",597,31,304,222,1,527,0.0519262981574539
"064277612","BUENOS AIRES",578,22,315,212,2,529,0.0380622837370242
"064277614","BUENOS AIRES",284,11,145,123,4,272,0.0387323943661972
"064277615","BUENOS AIRES",491,34,237,203,2,442,0.0692464358452139
"064277616","BUENOS AIRES",493,45,270,172,1,443,0.0912778904665314
"064277707","BUENOS AIRES",360,6,207,126,0,333,0.0166666666666667
"064277909","BUENOS AIRES",297,3,194,57,0,251,0.0101010101010101
"020130604","CABA",419,419,0,0,0,0,1
"064277910","BUENOS AIRES",462,4,343,107,1,451,0.00865800865800866
"064279003","BUENOS AIRES",236,9,138,84,1,223,0.038135593220339
"064278002","BUENOS AIRES",475,10,193,244,3,440,0.0210526315789474
"064278014","BUENOS AIRES",272,0,91,159,3,253,0
"064278104","BUENOS AIRES",318,2,167,127,0,294,0.00628930817610063
"064278112","BUENOS AIRES",65,2,30,33,0,63,0.0307692307692308
"064278205","BUENOS AIRES",415,17,212,171,3,386,0.0409638554216867
"064278207","BUENOS AIRES",482,6,266,190,4,460,0.012448132780083
"064278213","BUENOS AIRES",349,10,223,102,2,327,0.0286532951289398
"065602011","BUENOS AIRES",276,232,19,21,0,40,0.840579710144927
"064278406","BUENOS AIRES",334,10,195,110,0,305,0.029940119760479
"064278603","BUENOS AIRES",361,1,287,70,0,357,0.00277008310249307
"064278610","BUENOS AIRES",303,1,211,88,1,300,0.0033003300330033
"064278701","BUENOS AIRES",342,3,213,115,0,328,0.0087719298245614
"064278711","BUENOS AIRES",45,0,31,13,0,44,0
"064278802","BUENOS AIRES",546,10,373,139,0,512,0.0183150183150183
"064278904","BUENOS AIRES",588,2,353,210,0,563,0.00340136054421769
"064278912","BUENOS AIRES",538,4,246,262,10,518,0.00743494423791822
"064279103","BUENOS AIRES",434,10,114,291,5,410,0.0230414746543779
"064279216","BUENOS AIRES",367,4,209,138,1,348,0.0108991825613079
"064279201","BUENOS AIRES",389,0,192,136,8,336,0
"064279203","BUENOS AIRES",235,0,145,66,6,217,0
"064279205","BUENOS AIRES",432,8,235,179,1,415,0.0185185185185185
"064279212","BUENOS AIRES",371,3,215,141,0,356,0.00808625336927224
"064279219","BUENOS AIRES",413,0,194,190,2,386,0
"064279301","BUENOS AIRES",363,6,145,191,5,341,0.0165289256198347
"065681301","BUENOS AIRES",221,217,2,1,0,3,0.981900452488688
"064279407","BUENOS AIRES",309,0,141,155,5,301,0
"064340709","BUENOS AIRES",177,151,18,8,0,26,0.853107344632768
"064342004","BUENOS AIRES",206,166,34,5,0,39,0.805825242718447
"064279508","BUENOS AIRES",470,8,243,177,1,421,0.0170212765957447
"064279514","BUENOS AIRES",389,13,207,148,0,355,0.0334190231362468
"065681508","BUENOS AIRES",416,396,8,10,0,18,0.951923076923077
"064279715","BUENOS AIRES",216,3,148,58,1,207,0.0138888888888889
"065151811","BUENOS AIRES",308,0,129,169,0,298,0
"064279717","BUENOS AIRES",277,2,132,131,2,265,0.0072202166064982
"064279719","BUENOS AIRES",216,9,108,97,0,205,0.0416666666666667
"064340208","BUENOS AIRES",197,188,6,1,0,7,0.954314720812183
"064340304","BUENOS AIRES",307,212,38,57,0,95,0.690553745928339
"064340408","BUENOS AIRES",144,131,9,4,0,13,0.909722222222222
"064341602","BUENOS AIRES",284,252,20,12,0,32,0.887323943661972
"064340410","BUENOS AIRES",368,324,32,11,0,43,0.880434782608696
"064340502","BUENOS AIRES",383,304,45,33,0,78,0.793733681462141
"064340601","BUENOS AIRES",334,251,44,37,0,81,0.751497005988024
"064340704","BUENOS AIRES",230,205,14,8,3,25,0.891304347826087
"064340815","BUENOS AIRES",421,34,88,288,1,377,0.0807600950118765
"064340905","BUENOS AIRES",222,47,31,140,1,172,0.211711711711712
"064340909","BUENOS AIRES",315,23,105,186,0,291,0.073015873015873
"064340914","BUENOS AIRES",381,37,82,249,0,331,0.0971128608923885
"064341001","BUENOS AIRES",290,9,93,187,0,280,0.0310344827586207
"064341006","BUENOS AIRES",315,19,150,141,0,291,0.0603174603174603
"064341010","BUENOS AIRES",342,17,151,152,0,303,0.0497076023391813
"064341011","BUENOS AIRES",379,89,190,97,1,288,0.234828496042216
"064341109","BUENOS AIRES",268,18,48,201,0,249,0.0671641791044776
"064341112","BUENOS AIRES",394,48,137,205,1,343,0.121827411167513
"064343115","BUENOS AIRES",140,137,1,1,0,2,0.978571428571429
"064341205","BUENOS AIRES",313,17,115,180,0,295,0.0543130990415335
"064341208","BUENOS AIRES",324,13,178,132,0,310,0.0401234567901235
"064341308","BUENOS AIRES",347,236,58,53,0,111,0.680115273775216
"064341613","BUENOS AIRES",380,352,15,13,0,28,0.926315789473684
"064341703","BUENOS AIRES",352,273,40,37,1,78,0.775568181818182
"064341803","BUENOS AIRES",396,321,31,43,0,74,0.810606060606061
"064342005","BUENOS AIRES",318,248,51,19,0,70,0.779874213836478
"064342105","BUENOS AIRES",249,13,164,71,0,235,0.0522088353413655
"064342106","BUENOS AIRES",208,9,91,105,0,196,0.0432692307692308
"064342108","BUENOS AIRES",252,13,137,101,0,238,0.0515873015873016
"064342201","BUENOS AIRES",301,181,37,53,3,93,0.601328903654485
"065810504","BUENOS AIRES",83,82,1,0,0,1,0.987951807228916
"064342204","BUENOS AIRES",311,28,152,123,7,282,0.090032154340836
"064342206","BUENOS AIRES",314,22,191,95,6,292,0.0700636942675159
"064342309","BUENOS AIRES",267,34,48,161,0,209,0.127340823970037
"064342311","BUENOS AIRES",393,81,84,189,7,280,0.206106870229008
"064342312","BUENOS AIRES",290,98,41,145,2,188,0.337931034482759
"064342401","BUENOS AIRES",239,2,105,126,5,236,0.00836820083682008
"064342402","BUENOS AIRES",201,11,119,69,0,188,0.054726368159204
"064342405","BUENOS AIRES",261,14,113,134,0,247,0.053639846743295
"064342510","BUENOS AIRES",257,24,147,77,0,224,0.0933852140077821
"064342511","BUENOS AIRES",294,21,124,148,0,272,0.0714285714285714
"064342513","BUENOS AIRES",265,23,139,101,0,240,0.0867924528301887
"064342604","BUENOS AIRES",361,12,138,183,2,323,0.0332409972299169
"064342611","BUENOS AIRES",214,9,88,106,1,195,0.0420560747663551
"064342702","BUENOS AIRES",316,7,190,115,1,306,0.0221518987341772
"064342705","BUENOS AIRES",190,9,88,93,0,181,0.0473684210526316
"064342806","BUENOS AIRES",358,7,205,142,1,348,0.0195530726256983
"064342814","BUENOS AIRES",283,6,115,149,0,264,0.0212014134275618
"064343104","BUENOS AIRES",216,180,17,19,0,36,0.833333333333333
"064343213","BUENOS AIRES",294,247,31,15,0,46,0.840136054421769
"064343308","BUENOS AIRES",248,6,110,131,0,241,0.0241935483870968
"064343410","BUENOS AIRES",346,18,189,133,0,322,0.0520231213872832
"064343411","BUENOS AIRES",347,16,149,176,0,325,0.0461095100864553
"064343503","BUENOS AIRES",177,5,103,69,0,172,0.0282485875706215
"064343510","BUENOS AIRES",294,119,35,134,2,171,0.404761904761905
"064343513","BUENOS AIRES",302,7,133,155,0,288,0.0231788079470199
"064343601","BUENOS AIRES",366,11,223,131,0,354,0.0300546448087432
"064343701","BUENOS AIRES",219,109,79,31,0,110,0.497716894977169
"064343704","BUENOS AIRES",303,279,12,11,0,23,0.920792079207921
"064343804","BUENOS AIRES",339,329,7,3,0,10,0.970501474926254
"064343908","BUENOS AIRES",175,8,69,98,0,167,0.0457142857142857
"020120601","CABA",320,320,0,0,0,0,1
"064344106","BUENOS AIRES",316,75,84,155,0,239,0.237341772151899
"064344303","BUENOS AIRES",382,21,169,192,0,361,0.0549738219895288
"064344307","BUENOS AIRES",261,82,94,85,0,179,0.314176245210728
"064344308","BUENOS AIRES",231,74,62,95,0,157,0.32034632034632
"064411307","BUENOS AIRES",215,215,0,0,0,0,1
"064344406","BUENOS AIRES",463,429,16,4,0,20,0.926565874730022
"064410112","BUENOS AIRES",309,305,0,0,0,0,0.98705501618123
"064410204","BUENOS AIRES",208,208,0,0,0,0,1
"064410211","BUENOS AIRES",223,219,1,2,0,3,0.982062780269058
"064410302","BUENOS AIRES",415,415,0,0,0,0,1
"064410504","BUENOS AIRES",251,251,0,0,0,0,1
"064410507","BUENOS AIRES",145,144,0,1,0,1,0.993103448275862
"064410607","BUENOS AIRES",219,219,0,0,0,0,1
"064410704","BUENOS AIRES",225,225,0,0,0,0,1
"064410809","BUENOS AIRES",245,245,0,0,0,0,1
"064410905","BUENOS AIRES",231,231,0,0,0,0,1
"064410910","BUENOS AIRES",71,71,0,0,0,0,1
"064411001","BUENOS AIRES",400,391,5,0,1,6,0.9775
"020130803","CABA",411,411,0,0,0,0,1
"064411015","BUENOS AIRES",177,177,0,0,0,0,1
"064411115","BUENOS AIRES",202,201,1,0,0,1,0.995049504950495
"064411213","BUENOS AIRES",200,200,0,0,0,0,1
"064411214","BUENOS AIRES",169,169,0,0,0,0,1
"064411302","BUENOS AIRES",268,268,0,0,0,0,1
"064411304","BUENOS AIRES",281,281,0,0,0,0,1
"064411305","BUENOS AIRES",142,142,0,0,0,0,1
"064411606","BUENOS AIRES",351,350,0,1,0,1,0.997150997150997
"064411406","BUENOS AIRES",159,159,0,0,0,0,1
"064411504","BUENOS AIRES",241,239,2,0,0,2,0.991701244813278
"064411508","BUENOS AIRES",202,202,0,0,0,0,1
"064411712","BUENOS AIRES",298,297,1,0,0,1,0.996644295302013
"064411909","BUENOS AIRES",204,204,0,0,0,0,1
"064412014","BUENOS AIRES",57,57,0,0,0,0,1
"064412108","BUENOS AIRES",196,196,0,0,0,0,1
"064412202","BUENOS AIRES",288,285,2,1,0,3,0.989583333333333
"064412205","BUENOS AIRES",300,295,4,1,0,5,0.983333333333333
"064412207","BUENOS AIRES",216,215,1,0,0,1,0.99537037037037
"064412208","BUENOS AIRES",253,251,2,0,0,2,0.992094861660079
"064412405","BUENOS AIRES",411,408,1,1,0,2,0.992700729927007
"064412411","BUENOS AIRES",377,376,1,0,0,1,0.997347480106101
"064412506","BUENOS AIRES",231,231,0,0,0,0,1
"064412508","BUENOS AIRES",224,223,1,0,0,1,0.995535714285714
"064412602","BUENOS AIRES",214,213,0,1,0,1,0.995327102803738
"064412607","BUENOS AIRES",266,262,3,0,0,3,0.984962406015038
"064412703","BUENOS AIRES",313,313,0,0,0,0,1
"064412704","BUENOS AIRES",331,330,1,0,0,1,0.996978851963746
"064412907","BUENOS AIRES",242,241,1,0,0,1,0.995867768595041
"064412914","BUENOS AIRES",337,335,2,0,0,2,0.99406528189911
"064413006","BUENOS AIRES",362,353,9,0,0,9,0.975138121546961
"064413107","BUENOS AIRES",233,231,0,1,0,1,0.991416309012876
"064413308","BUENOS AIRES",230,222,8,0,0,8,0.965217391304348
"064413311","BUENOS AIRES",423,416,5,2,0,7,0.983451536643026
"064413409","BUENOS AIRES",223,221,2,0,0,2,0.991031390134529
"064413411","BUENOS AIRES",231,121,72,28,2,102,0.523809523809524
"064413509","BUENOS AIRES",361,334,9,18,0,27,0.925207756232687
"064413512","BUENOS AIRES",349,326,13,10,0,23,0.934097421203438
"064413516","BUENOS AIRES",752,198,95,378,13,486,0.263297872340426
"064413801","BUENOS AIRES",501,472,12,16,0,28,0.942115768463074
"064413809","BUENOS AIRES",311,187,49,65,0,114,0.601286173633441
"064413908","BUENOS AIRES",295,284,3,8,0,11,0.96271186440678
"064414002","BUENOS AIRES",272,217,22,23,2,47,0.797794117647059
"064414005","BUENOS AIRES",182,177,5,0,0,5,0.972527472527473
"064414010","BUENOS AIRES",371,300,15,45,0,60,0.808625336927224
"064760104","BUENOS AIRES",190,181,7,2,0,9,0.952631578947368
"064414101","BUENOS AIRES",588,16,178,369,3,550,0.0272108843537415
"064414106","BUENOS AIRES",272,250,16,5,0,21,0.919117647058823
"064414217","BUENOS AIRES",408,316,52,31,0,83,0.774509803921569
"064414219","BUENOS AIRES",370,222,61,77,2,140,0.6
"064414305","BUENOS AIRES",238,228,4,2,0,6,0.957983193277311
"064414707","BUENOS AIRES",496,322,56,115,0,171,0.649193548387097
"064414809","BUENOS AIRES",236,229,4,2,1,7,0.970338983050847
"064414908","BUENOS AIRES",193,189,2,2,0,4,0.979274611398964
"064414909","BUENOS AIRES",250,244,6,0,0,6,0.976
"064415003","BUENOS AIRES",405,400,4,1,0,5,0.987654320987654
"064415107","BUENOS AIRES",246,159,39,44,0,83,0.646341463414634
"064415116","BUENOS AIRES",160,133,5,20,0,25,0.83125
"064415118","BUENOS AIRES",333,328,3,2,0,5,0.984984984984985
"064415204","BUENOS AIRES",352,295,17,6,27,50,0.838068181818182
"064415307","BUENOS AIRES",214,209,5,0,0,5,0.976635514018692
"064415407","BUENOS AIRES",252,247,5,0,0,5,0.98015873015873
"064415702","BUENOS AIRES",255,218,27,7,0,34,0.854901960784314
"064415711","BUENOS AIRES",340,223,79,33,2,114,0.655882352941176
"064415803","BUENOS AIRES",276,274,1,0,1,2,0.992753623188406
"064415804","BUENOS AIRES",180,180,0,0,0,0,1
"066232203","BUENOS AIRES",261,215,35,11,0,46,0.823754789272031
"064416405","BUENOS AIRES",136,0,32,89,2,123,0
"064416609","BUENOS AIRES",311,269,13,28,0,41,0.864951768488746
"063711805","BUENOS AIRES",340,26,219,95,0,314,0.0764705882352941
"064415807","BUENOS AIRES",228,134,85,8,0,93,0.587719298245614
"064415903","BUENOS AIRES",204,198,6,0,0,6,0.970588235294118
"064415905","BUENOS AIRES",246,238,5,3,0,8,0.967479674796748
"064415907","BUENOS AIRES",302,9,230,59,2,291,0.0298013245033113
"064416201","BUENOS AIRES",111,8,79,21,3,103,0.0720720720720721
"064416206","BUENOS AIRES",286,282,2,2,0,4,0.986013986013986
"066232103","BUENOS AIRES",5,0,4,1,0,5,0
"064416305","BUENOS AIRES",180,0,154,24,0,178,0
"064416517","BUENOS AIRES",324,222,37,56,0,93,0.685185185185185
"064416409","BUENOS AIRES",395,2,169,192,11,372,0.00506329113924051
"064416415","BUENOS AIRES",329,4,223,94,3,320,0.0121580547112462
"064416416","BUENOS AIRES",150,0,101,45,0,146,0
"064416513","BUENOS AIRES",150,2,73,73,0,146,0.0133333333333333
"065391710","BUENOS AIRES",290,233,29,27,0,56,0.803448275862069
"064416602","BUENOS AIRES",241,145,56,32,0,88,0.601659751037344
"064416603","BUENOS AIRES",472,155,105,191,2,298,0.328389830508475
"064416605","BUENOS AIRES",19,2,1,14,1,16,0.105263157894737
"064900505","BUENOS AIRES",245,12,124,105,1,230,0.0489795918367347
"064416417","BUENOS AIRES",218,1,90,121,1,212,0.00458715596330275
"064416418","BUENOS AIRES",177,145,28,4,0,32,0.819209039548023
"066232806","BUENOS AIRES",424,413,8,2,0,10,0.974056603773585
"066380107","BUENOS AIRES",353,2,137,183,6,326,0.0056657223796034
"064416906","BUENOS AIRES",458,36,236,170,3,409,0.0786026200873362
"065151903","BUENOS AIRES",413,6,195,200,0,395,0.0145278450363196
"064416911","BUENOS AIRES",319,7,174,128,3,305,0.0219435736677116
"064900806","BUENOS AIRES",222,219,3,0,0,3,0.986486486486487
"064417001","BUENOS AIRES",424,5,282,130,0,412,0.0117924528301887
"064480601","BUENOS AIRES",464,297,50,115,0,165,0.640086206896552
"064480602","BUENOS AIRES",357,223,88,45,0,133,0.624649859943978
"064550107","BUENOS AIRES",183,40,18,118,0,136,0.218579234972678
"064550108","BUENOS AIRES",264,183,26,53,0,79,0.693181818181818
"064551403","BUENOS AIRES",144,10,47,86,0,133,0.0694444444444444
"066381405","BUENOS AIRES",323,0,98,186,0,284,0
"064690107","BUENOS AIRES",262,258,3,1,0,4,0.984732824427481
"064690113","BUENOS AIRES",261,236,8,17,0,25,0.904214559386973
"064690209","BUENOS AIRES",206,153,25,28,0,53,0.742718446601942
"064690901","BUENOS AIRES",242,2,145,93,0,238,0.00826446280991736
"064691302","BUENOS AIRES",435,8,232,195,0,427,0.0183908045977011
"064760708","BUENOS AIRES",182,119,10,47,6,63,0.653846153846154
"065151907","BUENOS AIRES",511,4,296,148,2,446,0.00782778864970646
"064761405","BUENOS AIRES",220,200,11,9,0,20,0.909090909090909
"064830117","BUENOS AIRES",278,7,176,92,1,269,0.0251798561151079
"064902102","BUENOS AIRES",346,327,17,2,0,19,0.945086705202312
"064830415","BUENOS AIRES",326,3,185,133,1,319,0.00920245398773006
"064900103","BUENOS AIRES",202,13,63,126,0,189,0.0643564356435644
"064900106","BUENOS AIRES",222,18,45,159,0,204,0.0810810810810811
"064900302","BUENOS AIRES",390,22,204,150,3,357,0.0564102564102564
"064900403","BUENOS AIRES",281,13,70,177,6,253,0.0462633451957295
"064900409","BUENOS AIRES",208,17,36,134,9,179,0.0817307692307692
"064900412","BUENOS AIRES",222,34,79,102,0,181,0.153153153153153
"064900512","BUENOS AIRES",454,56,174,211,0,385,0.123348017621145
"064900515","BUENOS AIRES",463,29,245,172,2,419,0.0626349892008639
"064900612","BUENOS AIRES",337,337,0,0,0,0,1
"064900801","BUENOS AIRES",243,51,117,75,0,192,0.209876543209877
"064900901","BUENOS AIRES",369,122,160,86,1,247,0.330623306233062
"064901003","BUENOS AIRES",300,292,5,2,0,7,0.973333333333333
"064901406","BUENOS AIRES",226,9,113,103,1,217,0.0398230088495575
"064901501","BUENOS AIRES",290,2,98,183,0,281,0.00689655172413793
"064901508","BUENOS AIRES",229,7,44,174,1,219,0.0305676855895196
"064901806","BUENOS AIRES",211,3,101,107,0,208,0.014218009478673
"064901912","BUENOS AIRES",200,176,14,7,0,21,0.88
"064902006","BUENOS AIRES",293,280,10,3,0,13,0.955631399317406
"064902607","BUENOS AIRES",361,324,23,13,0,36,0.897506925207756
"064902611","BUENOS AIRES",278,237,19,22,0,41,0.852517985611511
"064902805","BUENOS AIRES",314,18,197,98,0,295,0.0573248407643312
"064902908","BUENOS AIRES",484,3,173,304,1,478,0.00619834710743802
"064903003","BUENOS AIRES",287,6,119,150,4,273,0.0209059233449477
"064903006","BUENOS AIRES",325,8,181,133,0,314,0.0246153846153846
"064903206","BUENOS AIRES",505,9,178,295,0,473,0.0178217821782178
"064903304","BUENOS AIRES",300,8,97,183,1,281,0.0266666666666667
"064903508","BUENOS AIRES",456,15,159,220,0,379,0.0328947368421053
"064903512","BUENOS AIRES",258,8,97,139,0,236,0.0310077519379845
"064903703","BUENOS AIRES",245,7,152,80,0,232,0.0285714285714286
"064903706","BUENOS AIRES",361,9,99,233,2,334,0.0249307479224377
"064903714","BUENOS AIRES",458,23,148,270,5,423,0.0502183406113537
"064904009","BUENOS AIRES",583,251,49,196,8,253,0.430531732418525
"064904406","BUENOS AIRES",408,12,145,248,0,393,0.0294117647058824
"064904308","BUENOS AIRES",193,168,16,8,0,24,0.870466321243523
"064904313","BUENOS AIRES",275,6,178,90,1,269,0.0218181818181818
"064904401","BUENOS AIRES",300,6,185,109,0,294,0.02
"064904505","BUENOS AIRES",382,9,179,191,2,372,0.0235602094240838
"064904801","BUENOS AIRES",287,281,3,3,0,6,0.979094076655052
"064904807","BUENOS AIRES",286,284,0,1,1,2,0.993006993006993
"020050305","CABA",336,336,0,0,0,0,1
"065391406","BUENOS AIRES",431,169,174,83,0,257,0.392111368909513
"065391504","BUENOS AIRES",385,109,160,103,2,265,0.283116883116883
"065391507","BUENOS AIRES",314,313,1,0,0,1,0.996815286624204
"061190201","BUENOS AIRES",10,0,5,5,0,10,0
"061540206","BUENOS AIRES",9,0,9,0,0,9,0
"060070108","BUENOS AIRES",11,0,10,1,0,11,0
"060070207","BUENOS AIRES",3,0,0,3,0,3,0
"060070303","BUENOS AIRES",15,0,12,3,0,15,0
"060070401","BUENOS AIRES",13,0,4,9,0,13,0
"060070412","BUENOS AIRES",2,0,0,1,0,1,0
"065391606","BUENOS AIRES",297,293,3,1,0,4,0.986531986531986
"060071109","BUENOS AIRES",0,0,0,0,0,0,NA
"060140701","BUENOS AIRES",12,2,5,3,2,10,0.166666666666667
"060141202","BUENOS AIRES",18,0,7,10,1,18,0
"060141301","BUENOS AIRES",21,0,15,6,0,21,0
"060210101","BUENOS AIRES",9,0,8,1,0,9,0
"060210204","BUENOS AIRES",6,0,3,3,0,6,0
"065950407","BUENOS AIRES",261,90,89,81,1,171,0.344827586206897
"060210804","BUENOS AIRES",16,0,9,7,0,16,0
"060210901","BUENOS AIRES",12,0,0,12,0,12,0
"062031404","BUENOS AIRES",5,1,2,2,0,4,0.2
"062660201","BUENOS AIRES",15,0,6,8,0,14,0
"060283017","BUENOS AIRES",11,0,5,4,2,11,0
"062171011","BUENOS AIRES",77,49,12,16,0,28,0.636363636363636
"060420601","BUENOS AIRES",58,0,20,37,1,58,0
"060421601","BUENOS AIRES",34,0,15,17,2,34,0
"060490801","BUENOS AIRES",20,0,7,11,2,20,0
"060492004","BUENOS AIRES",34,0,22,12,0,34,0
"065391701","BUENOS AIRES",314,1,181,121,2,304,0.00318471337579618
"060630803","BUENOS AIRES",8,1,1,6,0,7,0.125
"060630902","BUENOS AIRES",17,0,2,12,1,15,0
"060631203","BUENOS AIRES",8,0,1,6,0,7,0
"060841002","BUENOS AIRES",7,0,3,4,0,7,0
"060841003","BUENOS AIRES",10,0,1,9,0,10,0
"068401509","BUENOS AIRES",343,342,1,0,0,1,0.997084548104956
"061120502","BUENOS AIRES",10,0,0,10,0,10,0
"061120803","BUENOS AIRES",13,0,2,11,0,13,0
"060700805","BUENOS AIRES",13,0,10,3,0,13,0
"060701002","BUENOS AIRES",19,0,1,18,0,19,0
"065391713","BUENOS AIRES",268,253,9,5,0,14,0.944029850746269
"060770701","BUENOS AIRES",14,0,5,9,0,14,0
"060770904","BUENOS AIRES",24,0,14,10,0,24,0
"065391801","BUENOS AIRES",360,202,84,64,0,148,0.561111111111111
"060840502","BUENOS AIRES",17,0,4,11,0,15,0
"065391802","BUENOS AIRES",347,271,63,13,0,76,0.780979827089337
"060910510","BUENOS AIRES",27,0,8,15,1,24,0
"062800704","BUENOS AIRES",54,2,29,23,0,52,0.037037037037037
"062800812","BUENOS AIRES",15,0,2,12,0,14,0
"062940502","BUENOS AIRES",5,0,1,4,0,5,0
"061120304","BUENOS AIRES",8,0,1,7,0,8,0
"061120306","BUENOS AIRES",8,0,4,4,0,8,0
"061121302","BUENOS AIRES",11,0,3,5,1,9,0
"065391903","BUENOS AIRES",308,269,16,14,0,30,0.873376623376623
"061190104","BUENOS AIRES",15,1,2,12,0,14,0.0666666666666667
"063220903","BUENOS AIRES",5,0,0,5,0,5,0
"061191010","BUENOS AIRES",34,0,10,24,0,34,0
"065392001","BUENOS AIRES",244,1,214,24,0,238,0.00409836065573771
"061341001","BUENOS AIRES",38,0,15,23,0,38,0
"061400102","BUENOS AIRES",17,0,15,2,0,17,0
"068401512","BUENOS AIRES",224,195,1,0,0,1,0.870535714285714
"061470202","BUENOS AIRES",13,0,9,4,0,13,0
"061470601","BUENOS AIRES",4,0,0,1,3,4,0
"061470707","BUENOS AIRES",1,0,1,0,0,1,0
"061261004","BUENOS AIRES",37,1,11,13,11,35,0.027027027027027
"061340404","BUENOS AIRES",67,0,39,27,0,66,0
"061340501","BUENOS AIRES",141,3,76,61,0,137,0.0212765957446809
"062310401","BUENOS AIRES",2,0,0,2,0,2,0
"061470902","BUENOS AIRES",48,0,12,34,1,47,0
"061471102","BUENOS AIRES",9,0,7,1,1,9,0
"061540302","BUENOS AIRES",32,0,26,6,0,32,0
"061540803","BUENOS AIRES",19,0,8,11,0,19,0
"061610503","BUENOS AIRES",7,0,3,4,0,7,0
"061610703","BUENOS AIRES",11,0,9,2,0,11,0
"061680201","BUENOS AIRES",11,0,5,5,1,11,0
"061680202","BUENOS AIRES",8,0,2,6,0,8,0
"061680502","BUENOS AIRES",7,0,0,7,0,7,0
"060350305","BUENOS AIRES",252,252,0,0,0,0,1
"065392203","BUENOS AIRES",448,4,309,134,0,443,0.00892857142857143
"065392206","BUENOS AIRES",436,6,234,145,1,380,0.0137614678899083
"068052611","BUENOS AIRES",112,0,73,32,6,111,0
"065392011","BUENOS AIRES",379,3,220,149,0,369,0.0079155672823219
"061680603","BUENOS AIRES",13,0,8,5,0,13,0
"061750301","BUENOS AIRES",6,0,1,5,0,6,0
"061750304","BUENOS AIRES",1,0,1,0,0,1,0
"061750615","BUENOS AIRES",16,0,1,14,0,15,0
"061820302","BUENOS AIRES",6,6,0,0,0,0,1
"061960604","BUENOS AIRES",4,0,1,3,0,4,0
"061820601","BUENOS AIRES",20,1,13,6,0,19,0.05
"061890501","BUENOS AIRES",2,0,2,0,0,2,0
"061890207","BUENOS AIRES",9,0,7,2,0,9,0
"061890302","BUENOS AIRES",5,0,5,0,0,5,0
"061890503","BUENOS AIRES",6,0,6,0,0,6,0
"061890804","BUENOS AIRES",3,0,1,2,0,3,0
"061891208","BUENOS AIRES",5,0,3,2,0,5,0
"061891306","BUENOS AIRES",4,0,4,0,0,4,0
"061891309","BUENOS AIRES",1,0,0,1,0,1,0
"061891601","BUENOS AIRES",11,0,5,4,0,9,0
"061891604","BUENOS AIRES",3,0,1,2,0,3,0
"061960404","BUENOS AIRES",7,0,0,7,0,7,0
"061961302","BUENOS AIRES",5,0,3,2,0,5,0
"061961505","BUENOS AIRES",2,0,0,1,1,2,0
"062030305","BUENOS AIRES",9,0,6,3,0,9,0
"062030404","BUENOS AIRES",5,0,1,4,0,5,0
"062030605","BUENOS AIRES",5,0,2,2,1,5,0
"065392308","BUENOS AIRES",335,15,195,118,2,315,0.0447761194029851
"065392309","BUENOS AIRES",359,3,188,160,0,348,0.00835654596100279
"062031005","BUENOS AIRES",6,0,0,4,0,4,0
"062031102","BUENOS AIRES",12,0,12,0,0,12,0
"062031105","BUENOS AIRES",3,0,1,2,0,3,0
"062031402","BUENOS AIRES",11,0,3,8,0,11,0
"062031303","BUENOS AIRES",7,0,2,4,1,7,0
"062100609","BUENOS AIRES",14,0,4,9,1,14,0
"068403110","BUENOS AIRES",268,267,1,0,0,1,0.996268656716418
"062170511","BUENOS AIRES",12,0,0,12,0,12,0
"062170604","BUENOS AIRES",22,1,6,15,0,21,0.0454545454545455
"062170801","BUENOS AIRES",27,0,10,17,0,27,0
"068401905","BUENOS AIRES",335,320,11,3,0,14,0.955223880597015
"062170902","BUENOS AIRES",31,0,10,21,0,31,0
"062170906","BUENOS AIRES",20,0,7,13,0,20,0
"065392502","BUENOS AIRES",331,1,273,51,0,324,0.00302114803625378
"063920306","BUENOS AIRES",29,0,14,15,0,29,0
"062171006","BUENOS AIRES",22,0,13,9,0,22,0
"062171009","BUENOS AIRES",22,0,12,10,0,22,0
"064060104","BUENOS AIRES",7,0,0,7,0,7,0
"062240604","BUENOS AIRES",35,0,9,24,2,35,0
"062240802","BUENOS AIRES",12,0,5,7,0,12,0
"062240910","BUENOS AIRES",55,0,11,35,0,46,0
"062241703","BUENOS AIRES",24,0,5,18,0,23,0
"062241802","BUENOS AIRES",18,0,12,6,0,18,0
"062242101","BUENOS AIRES",9,0,3,6,0,9,0
"062310303","BUENOS AIRES",22,0,10,12,0,22,0
"062310704","BUENOS AIRES",16,1,3,12,0,15,0.0625
"062310705","BUENOS AIRES",1,0,1,0,0,1,0
"062380302","BUENOS AIRES",25,0,11,14,0,25,0
"065392612","BUENOS AIRES",394,5,276,99,0,375,0.0126903553299492
"062660104","BUENOS AIRES",62,0,33,21,0,54,0
"064620604","BUENOS AIRES",13,1,0,10,2,12,0.0769230769230769
"062800705","BUENOS AIRES",18,0,8,9,0,17,0
"062800706","BUENOS AIRES",15,0,3,12,0,15,0
"062800707","BUENOS AIRES",10,0,4,6,0,10,0
"062801204","BUENOS AIRES",29,1,8,20,0,28,0.0344827586206897
"067631816","BUENOS AIRES",218,2,113,102,0,215,0.00917431192660551
"062870702","BUENOS AIRES",48,0,29,19,0,48,0
"062940702","BUENOS AIRES",12,0,1,11,0,12,0
"062940703","BUENOS AIRES",7,0,2,4,0,6,0
"063010201","BUENOS AIRES",48,0,28,19,1,48,0
"065392706","BUENOS AIRES",407,264,59,70,1,130,0.648648648648649
"063080901","BUENOS AIRES",35,0,4,29,2,35,0
"063080401","BUENOS AIRES",24,0,14,9,0,23,0
"063150601","BUENOS AIRES",122,0,51,66,3,120,0
"063510404","BUENOS AIRES",17,0,11,3,3,17,0
"063220102","BUENOS AIRES",3,0,0,3,0,3,0
"063220203","BUENOS AIRES",4,0,0,4,0,4,0
"063220405","BUENOS AIRES",5,0,1,4,0,5,0
"063220502","BUENOS AIRES",10,0,0,8,1,9,0
"063220609","BUENOS AIRES",5,0,4,1,0,5,0
"063221004","BUENOS AIRES",24,0,8,14,1,23,0
"063221005","BUENOS AIRES",22,0,12,9,1,22,0
"063221301","BUENOS AIRES",6,0,1,5,0,6,0
"063221302","BUENOS AIRES",9,0,3,5,0,8,0
"063290202","BUENOS AIRES",18,2,3,13,0,16,0.111111111111111
"063290303","BUENOS AIRES",64,1,14,48,1,63,0.015625
"063510609","BUENOS AIRES",2,0,0,2,0,2,0
"063510703","BUENOS AIRES",9,0,3,6,0,9,0
"063920202","BUENOS AIRES",20,0,10,9,0,19,0
"063360101","BUENOS AIRES",35,0,12,17,6,35,0
"063360501","BUENOS AIRES",116,2,73,36,1,110,0.0172413793103448
"063360901","BUENOS AIRES",33,1,9,22,1,32,0.0303030303030303
"063430103","BUENOS AIRES",66,1,33,30,0,63,0.0151515151515152
"063430605","BUENOS AIRES",17,0,11,6,0,17,0
"063430801","BUENOS AIRES",16,0,6,10,0,16,0
"063510303","BUENOS AIRES",4,0,0,4,0,4,0
"063577705","BUENOS AIRES",52,0,34,18,0,52,0
"063578105","BUENOS AIRES",70,1,42,26,0,68,0.0142857142857143
"064480611","BUENOS AIRES",6,0,2,3,0,5,0
"064830503","BUENOS AIRES",57,0,8,49,0,57,0
"063990104","BUENOS AIRES",23,0,11,12,0,23,0
"063990803","BUENOS AIRES",20,0,12,8,0,20,0
"065050104","BUENOS AIRES",8,0,4,4,0,8,0
"064130801","BUENOS AIRES",0,0,0,0,0,0,NA
"065392901","BUENOS AIRES",37,0,10,25,0,35,0
"064621001","BUENOS AIRES",20,0,18,2,0,20,0
"064621102","BUENOS AIRES",8,0,0,8,0,8,0
"066550207","BUENOS AIRES",29,0,18,10,1,29,0
"064130802","BUENOS AIRES",0,0,0,0,0,0,NA
"064131001","BUENOS AIRES",0,0,0,0,0,0,NA
"064131105","BUENOS AIRES",0,0,0,0,0,0,NA
"065180210","BUENOS AIRES",0,0,0,0,0,0,NA
"064690303","BUENOS AIRES",10,0,2,6,2,10,0
"064131701","BUENOS AIRES",0,0,0,0,0,0,NA
"064200101","BUENOS AIRES",7,0,7,0,0,7,0
"064201209","BUENOS AIRES",0,0,0,0,0,0,NA
"066230602","BUENOS AIRES",10,0,6,4,0,10,0
"064480203","BUENOS AIRES",16,0,1,14,0,15,0
"064480302","BUENOS AIRES",5,0,3,2,0,5,0
"064480701","BUENOS AIRES",10,0,2,7,1,10,0
"064480902","BUENOS AIRES",8,0,1,6,0,7,0
"064480903","BUENOS AIRES",3,0,0,3,0,3,0
"064481002","BUENOS AIRES",7,0,0,7,0,7,0
"064481004","BUENOS AIRES",3,0,1,2,0,3,0
"064620602","BUENOS AIRES",8,0,3,5,0,8,0
"064690406","BUENOS AIRES",15,0,4,11,0,15,0
"064690803","BUENOS AIRES",23,0,4,19,0,23,0
"064690904","BUENOS AIRES",11,0,4,6,1,11,0
"064691004","BUENOS AIRES",21,0,5,15,1,21,0
"064691104","BUENOS AIRES",13,0,1,12,0,13,0
"064691203","BUENOS AIRES",12,0,7,5,0,12,0
"064691204","BUENOS AIRES",10,0,8,2,0,10,0
"066382108","BUENOS AIRES",3,0,3,0,0,3,0
"064760204","BUENOS AIRES",25,0,15,8,1,24,0
"064760208","BUENOS AIRES",20,0,5,15,0,20,0
"064760302","BUENOS AIRES",18,0,4,13,0,17,0
"064760303","BUENOS AIRES",10,1,6,2,0,8,0.1
"064760404","BUENOS AIRES",15,0,3,12,0,15,0
"066511312","BUENOS AIRES",9,0,6,3,0,9,0
"064760505","BUENOS AIRES",11,0,6,4,1,11,0
"064760601","BUENOS AIRES",9,1,3,5,0,8,0.111111111111111
"064760801","BUENOS AIRES",19,0,13,6,0,19,0
"064761203","BUENOS AIRES",26,0,15,10,0,25,0
"064761102","BUENOS AIRES",24,1,11,3,0,14,0.0416666666666667
"064830201","BUENOS AIRES",13,0,9,4,0,13,0
"064971002","BUENOS AIRES",49,0,36,10,2,48,0
"064971004","BUENOS AIRES",30,0,13,17,0,30,0
"064971006","BUENOS AIRES",22,0,13,9,0,22,0
"065050402","BUENOS AIRES",97,1,60,35,1,96,0.0103092783505155
"065050404","BUENOS AIRES",36,0,13,23,0,36,0
"065110511","BUENOS AIRES",16,0,0,14,2,16,0
"065180409","BUENOS AIRES",5,0,3,2,0,5,0
"065180412","BUENOS AIRES",12,0,9,2,0,11,0
"067350403","BUENOS AIRES",22,0,18,4,0,22,0
"065810911","BUENOS AIRES",2,0,1,1,0,2,0
"062241302","BUENOS AIRES",14,0,2,11,1,14,0
"065391004","BUENOS AIRES",314,3,206,91,2,299,0.00955414012738853
"065320402","BUENOS AIRES",24,0,7,16,0,23,0
"065320602","BUENOS AIRES",8,0,4,4,0,8,0
"065320906","BUENOS AIRES",93,0,42,51,0,93,0
"065321003","BUENOS AIRES",32,0,27,5,0,32,0
"065321004","BUENOS AIRES",18,0,15,3,0,18,0
"065321102","BUENOS AIRES",64,0,26,36,0,62,0
"065321201","BUENOS AIRES",16,0,4,12,0,16,0
"065321202","BUENOS AIRES",9,0,2,7,0,9,0
"065470503","BUENOS AIRES",22,1,15,6,0,21,0.0454545454545455
"068400111","BUENOS AIRES",335,3,231,95,1,327,0.00895522388059702
"066091703","BUENOS AIRES",26,0,18,7,0,25,0
"067780802","BUENOS AIRES",2,0,0,2,0,2,0
"067980201","BUENOS AIRES",22,1,7,13,1,21,0.0454545454545455
"065740301","BUENOS AIRES",10,0,3,7,0,10,0
"065600909","BUENOS AIRES",106,80,14,12,0,26,0.754716981132076
"065740303","BUENOS AIRES",56,0,20,35,1,56,0
"065740413","BUENOS AIRES",8,0,4,4,0,8,0
"065740601","BUENOS AIRES",43,0,8,35,0,43,0
"065740704","BUENOS AIRES",15,0,4,11,0,15,0
"065740705","BUENOS AIRES",32,0,9,22,0,31,0
"065740708","BUENOS AIRES",24,0,11,13,0,24,0
"065600910","BUENOS AIRES",55,30,6,15,1,22,0.545454545454545
"065951301","BUENOS AIRES",53,0,30,21,0,51,0
"064760703","BUENOS AIRES",82,0,22,59,0,81,0
"065810913","BUENOS AIRES",11,0,0,11,0,11,0
"065810706","BUENOS AIRES",22,0,10,12,0,22,0
"065601004","BUENOS AIRES",378,58,141,172,1,314,0.153439153439153
"065601009","BUENOS AIRES",347,3,203,138,2,343,0.00864553314121038
"065601012","BUENOS AIRES",336,219,23,84,2,109,0.651785714285714
"065530111","BUENOS AIRES",17,16,0,1,0,1,0.941176470588235
"065392920","BUENOS AIRES",444,4,184,223,3,410,0.00900900900900901
"068400210","BUENOS AIRES",279,24,134,118,0,252,0.0860215053763441
"065810901","BUENOS AIRES",7,0,4,3,0,7,0
"065810904","BUENOS AIRES",7,0,0,6,1,7,0
"065811006","BUENOS AIRES",13,0,6,7,0,13,0
"065811104","BUENOS AIRES",8,0,3,5,0,8,0
"067000503","BUENOS AIRES",8,0,5,2,0,7,0
"065880306","BUENOS AIRES",17,0,2,15,0,17,0
"065881005","BUENOS AIRES",39,0,31,8,0,39,0
"065881010","BUENOS AIRES",8,0,2,6,0,8,0
"065881101","BUENOS AIRES",10,1,5,3,1,9,0.1
"067000504","BUENOS AIRES",6,0,3,3,0,6,0
"065951802","BUENOS AIRES",9,0,8,1,0,9,0
"066091602","BUENOS AIRES",10,0,4,6,0,10,0
"065951803","BUENOS AIRES",21,0,9,11,0,20,0
"065952705","BUENOS AIRES",19,0,2,17,0,19,0
"066020206","BUENOS AIRES",19,0,2,13,1,16,0
"066020207","BUENOS AIRES",34,0,12,18,2,32,0
"065393013","BUENOS AIRES",364,0,192,162,3,357,0
"065393015","BUENOS AIRES",323,1,265,57,0,322,0.00309597523219814
"065393016","BUENOS AIRES",342,0,249,90,0,339,0
"065393103","BUENOS AIRES",365,0,121,214,1,336,0
"066091304","BUENOS AIRES",25,0,17,7,0,24,0
"066090304","BUENOS AIRES",15,0,6,8,0,14,0
"066090603","BUENOS AIRES",14,1,8,4,0,12,0.0714285714285714
"066090801","BUENOS AIRES",2,0,0,2,0,2,0
"066091503","BUENOS AIRES",3,0,1,2,0,3,0
"066160103","BUENOS AIRES",33,0,15,18,0,33,0
"066160108","BUENOS AIRES",19,0,3,14,0,17,0
"066230603","BUENOS AIRES",0,0,0,0,0,0,NA
"066231201","BUENOS AIRES",12,0,4,8,0,12,0
"066231502","BUENOS AIRES",16,0,3,13,0,16,0
"066231801","BUENOS AIRES",18,0,4,14,0,18,0
"066232211","BUENOS AIRES",10,5,2,3,0,5,0.5
"066232505","BUENOS AIRES",13,0,5,8,0,13,0
"068540503","BUENOS AIRES",18,0,6,12,0,18,0
"065393110","BUENOS AIRES",380,7,233,132,0,365,0.0184210526315789
"066300501","BUENOS AIRES",69,0,13,54,2,69,0
"068750501","BUENOS AIRES",11,0,4,7,0,11,0
"063574814","BUENOS AIRES",237,237,0,0,0,0,1
"066382306","BUENOS AIRES",32,0,26,6,0,32,0
"066510101","BUENOS AIRES",7,0,4,3,0,7,0
"066510102","BUENOS AIRES",8,1,2,5,0,7,0.125
"066510406","BUENOS AIRES",3,0,2,1,0,3,0
"066510601","BUENOS AIRES",8,0,2,6,0,8,0
"066510608","BUENOS AIRES",4,0,1,3,0,4,0
"066510610","BUENOS AIRES",6,0,4,2,0,6,0
"066510712","BUENOS AIRES",6,0,4,2,0,6,0
"066510807","BUENOS AIRES",2,0,1,1,0,2,0
"066511005","BUENOS AIRES",3,0,3,0,0,3,0
"066720302","BUENOS AIRES",15,0,3,12,0,15,0
"066721101","BUENOS AIRES",7,0,3,4,0,7,0
"065393207","BUENOS AIRES",385,6,131,228,3,362,0.0155844155844156
"067140203","BUENOS AIRES",11,0,7,3,0,10,0
"066550105","BUENOS AIRES",50,0,32,17,1,50,0
"066550308","BUENOS AIRES",122,3,75,39,2,116,0.0245901639344262
"066650209","BUENOS AIRES",27,1,4,21,1,26,0.037037037037037
"066651003","BUENOS AIRES",14,0,0,14,0,14,0
"066720802","BUENOS AIRES",14,0,4,10,0,14,0
"066720901","BUENOS AIRES",18,0,3,15,0,18,0
"065393202","BUENOS AIRES",394,2,178,197,6,381,0.0050761421319797
"065393417","BUENOS AIRES",299,1,196,97,2,295,0.00334448160535117
"066790104","BUENOS AIRES",11,0,7,2,1,10,0
"066790202","BUENOS AIRES",12,1,11,0,0,11,0.0833333333333333
"066790306","BUENOS AIRES",14,0,12,2,0,14,0
"066790501","BUENOS AIRES",4,0,1,3,0,4,0
"066790701","BUENOS AIRES",12,0,1,11,0,12,0
"066860403","BUENOS AIRES",4,0,0,4,0,4,0
"066861203","BUENOS AIRES",15,0,8,7,0,15,0
"067280901","BUENOS AIRES",112,2,33,74,2,109,0.0178571428571429
"067000204","BUENOS AIRES",78,60,14,4,0,18,0.769230769230769
"067000707","BUENOS AIRES",11,0,5,6,0,11,0
"067000807","BUENOS AIRES",7,0,7,0,0,7,0
"067001001","BUENOS AIRES",5,0,4,0,0,4,0
"066930603","BUENOS AIRES",11,0,2,9,0,11,0
"067281303","BUENOS AIRES",21,0,11,10,0,21,0
"066930701","BUENOS AIRES",18,0,13,4,0,17,0
"067000108","BUENOS AIRES",4,0,3,1,0,4,0
"067000106","BUENOS AIRES",6,0,0,6,0,6,0
"067140305","BUENOS AIRES",9,0,0,8,1,9,0
"067140403","BUENOS AIRES",20,0,6,14,0,20,0
"067350204","BUENOS AIRES",47,3,15,29,0,44,0.0638297872340425
"065950801","BUENOS AIRES",173,1,49,118,4,171,0.00578034682080925
"067140702","BUENOS AIRES",58,0,34,22,1,57,0
"067140802","BUENOS AIRES",5,0,1,4,0,5,0
"067210210","BUENOS AIRES",4,0,3,0,0,3,0
"065393418","BUENOS AIRES",214,1,134,71,7,212,0.00467289719626168
"063711410","BUENOS AIRES",252,6,66,173,1,240,0.0238095238095238
"067280102","BUENOS AIRES",60,1,27,31,1,59,0.0166666666666667
"067280302","BUENOS AIRES",15,0,5,10,0,15,0
"067280304","BUENOS AIRES",10,0,0,10,0,10,0
"065951601","BUENOS AIRES",262,24,93,140,2,235,0.0916030534351145
"067350207","BUENOS AIRES",21,0,13,8,0,21,0
"067350601","BUENOS AIRES",14,0,0,13,1,14,0
"067350502","BUENOS AIRES",4,0,1,3,0,4,0
"067350504","BUENOS AIRES",2,0,0,2,0,2,0
"065393315","BUENOS AIRES",160,0,64,95,0,159,0
"067700801","BUENOS AIRES",26,0,5,18,0,23,0
"067700803","BUENOS AIRES",10,0,5,5,0,10,0
"067420901","BUENOS AIRES",38,0,7,31,0,38,0
"067701101","BUENOS AIRES",35,1,9,25,0,34,0.0285714285714286
"067701605","BUENOS AIRES",36,0,29,6,0,35,0
"067701702","BUENOS AIRES",7,0,0,7,0,7,0
"067701904","BUENOS AIRES",5,0,1,4,0,5,0
"065600107","BUENOS AIRES",259,3,128,119,1,248,0.0115830115830116
"067491512","BUENOS AIRES",102,1,36,46,13,95,0.00980392156862745
"065682305","BUENOS AIRES",224,222,2,0,0,2,0.991071428571429
"065393411","BUENOS AIRES",302,3,136,156,0,292,0.00993377483443709
"067631302","BUENOS AIRES",17,0,0,17,0,17,0
"067700204","BUENOS AIRES",18,0,10,7,1,18,0
"067700602","BUENOS AIRES",9,0,2,6,0,8,0
"065600508","BUENOS AIRES",89,0,55,31,1,87,0
"067491504","BUENOS AIRES",86,0,38,34,11,83,0
"065393415","BUENOS AIRES",265,1,139,106,2,247,0.00377358490566038
"067702002","BUENOS AIRES",2,0,0,2,0,2,0
"067780601","BUENOS AIRES",4,0,2,2,0,4,0
"067840201","BUENOS AIRES",5,0,5,0,0,5,0
"067840302","BUENOS AIRES",12,0,0,12,0,12,0
"067840702","BUENOS AIRES",9,0,1,8,0,9,0
"067910602","BUENOS AIRES",38,0,12,22,4,38,0
"065600510","BUENOS AIRES",381,0,286,91,0,377,0
"067910904","BUENOS AIRES",31,0,12,15,2,29,0
"067911102","BUENOS AIRES",29,0,19,10,0,29,0
"067911104","BUENOS AIRES",60,0,9,48,2,59,0
"064412604","BUENOS AIRES",165,164,1,0,0,1,0.993939393939394
"067911503","BUENOS AIRES",32,0,14,15,1,30,0
"067980101","BUENOS AIRES",20,4,9,7,0,16,0.2
"067980102","BUENOS AIRES",21,0,5,16,0,21,0
"067980402","BUENOS AIRES",16,0,7,9,0,16,0
"067980902","BUENOS AIRES",12,0,1,11,0,12,0
"065810508","BUENOS AIRES",102,102,0,0,0,0,1
"065601115","BUENOS AIRES",319,4,213,97,1,311,0.0125391849529781
"065470908","BUENOS AIRES",376,321,20,19,1,40,0.853723404255319
"065530102","BUENOS AIRES",143,116,17,9,0,26,0.811188811188811
"065530106","BUENOS AIRES",88,57,23,8,0,31,0.647727272727273
"065530307","BUENOS AIRES",73,64,9,0,0,9,0.876712328767123
"020121605","CABA",618,596,1,0,0,1,0.964401294498382
"065600111","BUENOS AIRES",316,1,182,120,0,302,0.00316455696202532
"065600409","BUENOS AIRES",328,5,253,64,0,317,0.0152439024390244
"065600209","BUENOS AIRES",465,0,232,209,4,445,0
"065600305","BUENOS AIRES",269,9,161,96,0,257,0.033457249070632
"065600312","BUENOS AIRES",345,0,223,113,1,337,0
"065600316","BUENOS AIRES",81,0,32,40,4,76,0
"065600402","BUENOS AIRES",284,8,221,41,0,262,0.028169014084507
"065180613","BUENOS AIRES",61,0,44,16,0,60,0
"065180708","BUENOS AIRES",128,0,101,26,0,127,0
"065180715","BUENOS AIRES",123,2,98,23,0,121,0.016260162601626
"065180717","BUENOS AIRES",104,1,76,19,0,95,0.00961538461538462
"067631704","BUENOS AIRES",379,287,63,29,0,92,0.757255936675462
"068052603","BUENOS AIRES",157,2,74,64,14,152,0.0127388535031847
"065600608","BUENOS AIRES",387,0,240,142,1,383,0
"065600615","BUENOS AIRES",266,0,196,61,0,257,0
"067701005","BUENOS AIRES",354,325,14,11,1,26,0.918079096045198
"065601306","BUENOS AIRES",291,1,181,97,0,278,0.00343642611683849
"020132309","CABA",429,426,2,0,0,2,0.993006993006993
"065600709","BUENOS AIRES",246,148,19,68,7,94,0.601626016260163
"065601307","BUENOS AIRES",456,6,317,129,1,447,0.0131578947368421
"065320302","BUENOS AIRES",504,393,25,83,1,109,0.779761904761905
"065320911","BUENOS AIRES",239,5,131,101,0,232,0.0209205020920502
"067491321","BUENOS AIRES",204,193,3,7,0,10,0.946078431372549
"065682213","BUENOS AIRES",280,222,49,9,0,58,0.792857142857143
"065180804","BUENOS AIRES",49,3,31,15,0,46,0.0612244897959184
"065601308","BUENOS AIRES",339,3,208,121,0,329,0.00884955752212389
"065250104","BUENOS AIRES",189,6,75,105,0,180,0.0317460317460317
"065250402","BUENOS AIRES",433,1,188,228,0,416,0.0023094688221709
"067350703","BUENOS AIRES",381,97,159,117,0,276,0.254593175853018
"065250408","BUENOS AIRES",414,400,9,2,0,11,0.966183574879227
"067420402","BUENOS AIRES",311,236,27,45,1,73,0.758842443729904
"065320109","BUENOS AIRES",233,229,2,0,0,2,0.982832618025751
"065320203","BUENOS AIRES",305,301,0,3,0,3,0.986885245901639
"065320207","BUENOS AIRES",349,336,1,11,0,12,0.962750716332378
"067491420","BUENOS AIRES",210,2,30,106,60,196,0.00952380952380952
"065321407","BUENOS AIRES",195,195,0,0,0,0,1
"065390114","BUENOS AIRES",381,25,326,29,0,355,0.0656167979002625
"065390202","BUENOS AIRES",233,2,193,36,0,229,0.00858369098712446
"065390303","BUENOS AIRES",283,246,6,0,0,6,0.869257950530035
"068821608","BUENOS AIRES",391,11,59,302,1,362,0.0281329923273657
"065390306","BUENOS AIRES",280,274,6,0,0,6,0.978571428571429
"065390401","BUENOS AIRES",452,403,40,8,0,48,0.891592920353982
"065390403","BUENOS AIRES",404,376,20,8,0,28,0.930693069306931
"065390404","BUENOS AIRES",449,427,18,4,0,22,0.951002227171492
"065390411","BUENOS AIRES",348,347,1,0,0,1,0.997126436781609
"065390604","BUENOS AIRES",281,39,138,99,0,237,0.138790035587189
"065390608","BUENOS AIRES",352,2,280,67,0,347,0.00568181818181818
"065390708","BUENOS AIRES",323,4,254,60,1,315,0.0123839009287926
"065390709","BUENOS AIRES",451,426,14,9,0,23,0.944567627494457
"065390801","BUENOS AIRES",224,3,187,33,0,220,0.0133928571428571
"065390806","BUENOS AIRES",274,3,165,98,1,264,0.0109489051094891
"064412605","BUENOS AIRES",196,191,2,1,0,3,0.974489795918367
"065391104","BUENOS AIRES",331,1,224,100,2,326,0.00302114803625378
"063574002","BUENOS AIRES",246,194,20,25,4,49,0.788617886178862
"064340405","BUENOS AIRES",243,199,32,10,0,42,0.818930041152263
"068610306","BUENOS AIRES",258,258,0,0,0,0,1
"068821702","BUENOS AIRES",302,4,64,224,0,288,0.0132450331125828
"060210610","BUENOS AIRES",93,59,21,12,1,34,0.634408602150538
"060283011","BUENOS AIRES",290,1,108,169,3,280,0.00344827586206897
"060492006","BUENOS AIRES",189,38,59,87,0,146,0.201058201058201
"061190404","BUENOS AIRES",55,0,39,16,0,55,0
"061750203","BUENOS AIRES",5,0,1,4,0,5,0
"062030406","BUENOS AIRES",6,0,2,4,0,6,0
"060770509","BUENOS AIRES",467,408,33,23,0,56,0.873661670235546
"064416704","BUENOS AIRES",108,1,32,70,3,105,0.00925925925925926
"061190904","BUENOS AIRES",98,0,48,49,0,97,0
"061260403","BUENOS AIRES",17,0,4,11,2,17,0
"061260508","BUENOS AIRES",359,336,16,5,0,21,0.935933147632312
"061260904","BUENOS AIRES",0,0,0,0,0,0,NA
"065682216","BUENOS AIRES",211,170,40,1,0,41,0.805687203791469
"061750505","BUENOS AIRES",35,0,18,14,3,35,0
"061750614","BUENOS AIRES",85,0,17,63,1,81,0
"062031611","BUENOS AIRES",105,1,76,28,0,104,0.00952380952380952
"062520801","BUENOS AIRES",60,0,22,29,0,51,0
"064760704","BUENOS AIRES",46,1,14,31,0,45,0.0217391304347826
"065682304","BUENOS AIRES",236,207,3,3,0,6,0.877118644067797
"063920803","BUENOS AIRES",42,0,24,18,0,42,0
"065951612","BUENOS AIRES",224,221,3,0,0,3,0.986607142857143
"062660205","BUENOS AIRES",125,0,92,33,0,125,0
"063010101","BUENOS AIRES",195,1,92,99,2,193,0.00512820512820513
"066650503","BUENOS AIRES",33,0,14,17,1,32,0
"064131906","BUENOS AIRES",35,0,19,15,0,34,0
"064416519","BUENOS AIRES",352,13,72,236,4,312,0.0369318181818182
"064416509","BUENOS AIRES",278,4,45,155,0,200,0.0143884892086331
"064830303","BUENOS AIRES",73,1,37,35,0,72,0.0136986301369863
"064412609","BUENOS AIRES",203,199,4,0,0,4,0.980295566502463
"065951912","BUENOS AIRES",175,1,135,39,0,174,0.00571428571428571
"065681503","BUENOS AIRES",334,17,259,56,0,315,0.0508982035928144
"065951905","BUENOS AIRES",95,0,54,39,1,94,0
"064279112","BUENOS AIRES",561,36,160,230,19,409,0.0641711229946524
"064279711","BUENOS AIRES",108,33,41,32,1,74,0.305555555555556
"064416501","BUENOS AIRES",169,0,61,104,1,166,0
"065682211","BUENOS AIRES",144,96,42,6,0,48,0.666666666666667
"064830904","BUENOS AIRES",34,0,27,6,1,34,0
"064970305","BUENOS AIRES",213,2,177,33,0,210,0.00938967136150235
"066480203","BUENOS AIRES",161,96,39,25,0,64,0.596273291925466
"065682403","BUENOS AIRES",202,187,11,4,0,15,0.925742574257426
"065681404","BUENOS AIRES",262,240,18,4,0,22,0.916030534351145
"065681407","BUENOS AIRES",328,320,8,0,0,8,0.975609756097561
"064970410","BUENOS AIRES",234,4,100,126,3,229,0.0170940170940171
"067780602","BUENOS AIRES",176,110,56,10,0,66,0.625
"066790608","BUENOS AIRES",185,44,85,55,0,140,0.237837837837838
"068541202","BUENOS AIRES",20,0,3,16,0,19,0
"066381401","BUENOS AIRES",171,59,88,22,0,110,0.345029239766082
"066550101","BUENOS AIRES",24,0,7,12,1,20,0
"066510902","BUENOS AIRES",16,0,11,5,0,16,0
"066721214","BUENOS AIRES",170,92,17,58,3,78,0.541176470588235
"066791001","BUENOS AIRES",266,182,64,16,0,80,0.684210526315789
"066860602","BUENOS AIRES",57,2,32,22,0,54,0.0350877192982456
"067280703","BUENOS AIRES",29,0,7,21,0,28,0
"067700202","BUENOS AIRES",55,0,23,28,1,52,0
"067701002","BUENOS AIRES",275,166,29,76,1,106,0.603636363636364
"068540303","BUENOS AIRES",30,0,17,13,0,30,0
"060980408","BUENOS AIRES",45,0,23,20,2,45,0
"065681609","BUENOS AIRES",423,12,354,56,0,410,0.0283687943262411
"065681612","BUENOS AIRES",388,382,3,2,0,5,0.984536082474227
"065681804","BUENOS AIRES",238,236,2,0,0,2,0.991596638655462
"065681805","BUENOS AIRES",258,254,3,1,0,4,0.984496124031008
"065681807","BUENOS AIRES",333,145,173,15,0,188,0.435435435435435
"065681808","BUENOS AIRES",256,252,4,0,0,4,0.984375
"065681905","BUENOS AIRES",267,244,3,1,0,4,0.913857677902622
"065681906","BUENOS AIRES",419,332,74,13,0,87,0.79236276849642
"065681908","BUENOS AIRES",373,12,343,18,0,361,0.032171581769437
"065681909","BUENOS AIRES",392,99,241,52,0,293,0.252551020408163
"065682004","BUENOS AIRES",298,293,2,3,0,5,0.983221476510067
"065682008","BUENOS AIRES",361,356,4,1,0,5,0.986149584487535
"065682202","BUENOS AIRES",138,98,35,5,0,40,0.710144927536232
"065682204","BUENOS AIRES",184,159,15,10,0,25,0.864130434782609
"065682407","BUENOS AIRES",269,261,8,0,0,8,0.970260223048327
"065682410","BUENOS AIRES",228,209,15,4,0,19,0.916666666666667
"065950408","BUENOS AIRES",253,65,121,65,0,186,0.256916996047431
"065682602","BUENOS AIRES",359,352,4,3,0,7,0.98050139275766
"065682705","BUENOS AIRES",247,1,218,25,0,243,0.00404858299595142
"065682707","BUENOS AIRES",359,0,287,68,0,355,0
"065682709","BUENOS AIRES",327,6,258,62,0,320,0.018348623853211
"065682902","BUENOS AIRES",328,2,198,121,2,321,0.00609756097560976
"065682908","BUENOS AIRES",280,0,162,111,0,273,0
"065682911","BUENOS AIRES",536,0,364,151,0,515,0
"065683005","BUENOS AIRES",265,1,189,70,0,259,0.00377358490566038
"065683103","BUENOS AIRES",334,15,269,48,1,318,0.0449101796407186
"065683104","BUENOS AIRES",472,15,306,147,1,454,0.0317796610169492
"065740702","BUENOS AIRES",66,1,7,57,0,64,0.0151515151515152
"065740801","BUENOS AIRES",104,0,48,56,0,104,0
"065810209","BUENOS AIRES",268,266,0,1,0,1,0.992537313432836
"065810802","BUENOS AIRES",192,0,76,115,0,191,0
"060561302","BUENOS AIRES",311,311,0,0,0,0,1
"068051903","BUENOS AIRES",295,0,235,58,0,293,0
"065811504","BUENOS AIRES",359,335,12,11,1,24,0.933147632311978
"068052509","BUENOS AIRES",283,1,193,88,0,281,0.00353356890459364
"065811604","BUENOS AIRES",319,245,66,8,0,74,0.768025078369906
"065811608","BUENOS AIRES",271,180,12,77,0,89,0.664206642066421
"065811803","BUENOS AIRES",107,107,0,0,0,0,1
"065811806","BUENOS AIRES",94,94,0,0,0,0,1
"065880113","BUENOS AIRES",249,198,19,31,0,50,0.795180722891566
"065880208","BUENOS AIRES",256,240,2,1,0,3,0.9375
"065880304","BUENOS AIRES",87,65,8,14,0,22,0.747126436781609
"065880501","BUENOS AIRES",175,0,100,69,2,171,0
"065880702","BUENOS AIRES",89,0,33,52,4,89,0
"065880915","BUENOS AIRES",234,2,82,143,2,227,0.00854700854700855
"065881702","BUENOS AIRES",296,284,6,4,0,10,0.959459459459459
"065950203","BUENOS AIRES",289,285,4,0,0,4,0.986159169550173
"065950206","BUENOS AIRES",291,289,2,0,0,2,0.993127147766323
"065950208","BUENOS AIRES",362,357,1,4,0,5,0.986187845303867
"065950209","BUENOS AIRES",216,211,2,3,0,5,0.976851851851852
"065950307","BUENOS AIRES",258,258,0,0,0,0,1
"065951910","BUENOS AIRES",189,4,153,15,2,170,0.0211640211640212
"065952104","BUENOS AIRES",224,2,195,27,0,222,0.00892857142857143
"065952407","BUENOS AIRES",352,321,14,15,0,29,0.911931818181818
"065952409","BUENOS AIRES",301,50,118,128,1,247,0.166112956810631
"065952410","BUENOS AIRES",256,2,86,165,0,251,0.0078125
"065952504","BUENOS AIRES",379,135,171,73,0,244,0.356200527704486
"065952505","BUENOS AIRES",294,48,200,45,0,245,0.163265306122449
"065952513","BUENOS AIRES",215,5,109,98,1,208,0.0232558139534884
"065952704","BUENOS AIRES",232,0,142,88,1,231,0
"065952709","BUENOS AIRES",242,14,178,50,0,228,0.0578512396694215
"066020301","BUENOS AIRES",420,84,234,84,0,318,0.2
"066021101","BUENOS AIRES",298,6,200,82,0,282,0.0201342281879195
"066020802","BUENOS AIRES",265,7,215,33,2,250,0.0264150943396226
"068401608","BUENOS AIRES",336,332,4,0,0,4,0.988095238095238
"066020804","BUENOS AIRES",125,1,96,26,0,122,0.008
"066090209","BUENOS AIRES",405,43,264,97,0,361,0.106172839506173
"068331903","BUENOS AIRES",376,313,23,37,1,61,0.832446808510638
"066021611","BUENOS AIRES",234,19,74,121,7,202,0.0811965811965812
"066090110","BUENOS AIRES",322,116,106,96,0,202,0.360248447204969
"066090202","BUENOS AIRES",274,260,11,3,0,14,0.948905109489051
"066090212","BUENOS AIRES",318,0,180,131,2,313,0
"068400303","BUENOS AIRES",316,9,228,75,2,305,0.0284810126582278
"066090215","BUENOS AIRES",218,2,176,40,0,216,0.00917431192660551
"066090905","BUENOS AIRES",152,0,85,63,1,149,0
"066091301","BUENOS AIRES",74,0,50,24,0,74,0
"066091905","BUENOS AIRES",203,187,8,8,0,16,0.921182266009852
"066160306","BUENOS AIRES",175,133,23,15,3,41,0.76
"066160309","BUENOS AIRES",150,122,14,14,0,28,0.813333333333333
"066380109","BUENOS AIRES",433,1,250,168,3,421,0.0023094688221709
"064415110","BUENOS AIRES",171,166,5,0,0,5,0.970760233918129
"066230110","BUENOS AIRES",169,76,34,56,0,90,0.449704142011834
"068610203","BUENOS AIRES",143,143,0,0,0,0,1
"066230111","BUENOS AIRES",250,241,3,5,0,8,0.964
"066230206","BUENOS AIRES",295,281,6,5,0,11,0.952542372881356
"066230207","BUENOS AIRES",269,252,10,7,0,17,0.936802973977695
"066230303","BUENOS AIRES",240,239,1,0,0,1,0.995833333333333
"066230310","BUENOS AIRES",291,267,0,0,0,0,0.917525773195876
"066230401","BUENOS AIRES",345,338,2,5,0,7,0.979710144927536
"066230408","BUENOS AIRES",392,312,55,24,1,80,0.795918367346939
"068401804","BUENOS AIRES",220,220,0,0,0,0,1
"066231601","BUENOS AIRES",129,0,44,79,3,126,0
"067491409","BUENOS AIRES",338,301,12,19,0,31,0.890532544378698
"066232810","BUENOS AIRES",268,209,31,27,0,58,0.779850746268657
"066232902","BUENOS AIRES",402,225,50,118,2,170,0.559701492537313
"066300204","BUENOS AIRES",162,111,28,22,0,50,0.685185185185185
"066380709","BUENOS AIRES",226,1,164,55,0,219,0.00442477876106195
"066380114","BUENOS AIRES",309,270,19,16,3,38,0.87378640776699
"066380302","BUENOS AIRES",422,1,202,192,3,397,0.0023696682464455
"066380306","BUENOS AIRES",228,1,156,71,0,227,0.0043859649122807
"066380307","BUENOS AIRES",163,161,2,0,0,2,0.987730061349693
"066380311","BUENOS AIRES",490,6,260,212,1,473,0.0122448979591837
"066380411","BUENOS AIRES",244,25,136,80,1,217,0.102459016393443
"066380602","BUENOS AIRES",301,4,228,67,0,295,0.0132890365448505
"066380606","BUENOS AIRES",390,1,150,219,2,371,0.00256410256410256
"066380705","BUENOS AIRES",252,1,182,67,0,249,0.00396825396825397
"066580909","BUENOS AIRES",183,182,0,1,0,1,0.994535519125683
"066381008","BUENOS AIRES",524,0,266,232,6,504,0
"066380809","BUENOS AIRES",143,1,101,36,0,137,0.00699300699300699
"066380901","BUENOS AIRES",181,37,108,33,0,141,0.204419889502762
"066380911","BUENOS AIRES",374,0,238,126,0,364,0
"066381011","BUENOS AIRES",313,3,221,86,0,307,0.00958466453674121
"066381103","BUENOS AIRES",573,12,207,341,2,550,0.0209424083769634
"066381106","BUENOS AIRES",307,2,191,82,3,276,0.00651465798045603
"066381108","BUENOS AIRES",406,1,211,184,3,398,0.00246305418719212
"066381201","BUENOS AIRES",113,5,73,34,1,108,0.0442477876106195
"068612308","BUENOS AIRES",234,229,3,2,0,5,0.978632478632479
"068680403","BUENOS AIRES",19,19,0,0,0,0,1
"020151707","CABA",333,333,0,0,0,0,1
"020050602","CABA",437,437,0,0,0,0,1
"060492508","BUENOS AIRES",387,342,26,19,0,45,0.883720930232558
"066381209","BUENOS AIRES",150,133,10,7,0,17,0.886666666666667
"066381211","BUENOS AIRES",167,1,55,100,0,155,0.00598802395209581
"066381310","BUENOS AIRES",327,0,110,198,5,313,0
"066381503","BUENOS AIRES",341,100,163,76,0,239,0.293255131964809
"066381504","BUENOS AIRES",356,49,133,163,0,296,0.137640449438202
"066381506","BUENOS AIRES",337,236,47,54,0,101,0.700296735905044
"066381603","BUENOS AIRES",377,350,4,10,0,14,0.928381962864722
"066381609","BUENOS AIRES",285,116,79,89,1,169,0.407017543859649
"066381610","BUENOS AIRES",330,7,133,187,2,322,0.0212121212121212
"066381702","BUENOS AIRES",215,165,34,15,0,49,0.767441860465116
"066381810","BUENOS AIRES",198,0,59,122,6,187,0
"066381905","BUENOS AIRES",384,151,109,94,24,227,0.393229166666667
"066382209","BUENOS AIRES",263,5,128,129,1,258,0.0190114068441065
"066440104","BUENOS AIRES",43,40,3,0,0,3,0.930232558139535
"066440505","BUENOS AIRES",446,403,24,17,0,41,0.903587443946188
"066440620","BUENOS AIRES",106,5,87,14,0,101,0.0471698113207547
"066480102","BUENOS AIRES",326,8,227,84,1,312,0.0245398773006135
"066480108","BUENOS AIRES",275,5,211,52,0,263,0.0181818181818182
"066480113","BUENOS AIRES",330,3,201,120,0,321,0.00909090909090909
"066480202","BUENOS AIRES",252,1,76,158,4,238,0.00396825396825397
"066480301","BUENOS AIRES",314,11,248,52,0,300,0.035031847133758
"066580910","BUENOS AIRES",302,302,0,0,0,0,1
"066480310","BUENOS AIRES",413,2,212,183,1,396,0.00484261501210654
"066480411","BUENOS AIRES",47,26,20,1,0,21,0.553191489361702
"066480511","BUENOS AIRES",366,2,201,154,2,357,0.00546448087431694
"066480512","BUENOS AIRES",270,9,119,109,2,230,0.0333333333333333
"066510803","BUENOS AIRES",1,0,1,0,0,1,0
"066510901","BUENOS AIRES",7,0,1,6,0,7,0
"066580104","BUENOS AIRES",249,248,1,0,0,1,0.995983935742972
"066580206","BUENOS AIRES",428,29,96,269,9,374,0.0677570093457944
"066580307","BUENOS AIRES",378,367,10,0,0,10,0.970899470899471
"066580412","BUENOS AIRES",398,394,1,2,0,3,0.989949748743719
"066580511","BUENOS AIRES",356,332,7,1,0,8,0.932584269662921
"066580601","BUENOS AIRES",237,237,0,0,0,0,1
"066580702","BUENOS AIRES",259,256,3,0,0,3,0.988416988416988
"066580709","BUENOS AIRES",305,155,21,113,1,135,0.508196721311475
"066580711","BUENOS AIRES",260,237,6,14,0,20,0.911538461538462
"066580813","BUENOS AIRES",138,138,0,0,0,0,1
"066580913","BUENOS AIRES",239,237,2,0,0,2,0.99163179916318
"066581001","BUENOS AIRES",307,33,35,185,14,234,0.107491856677524
"066581102","BUENOS AIRES",260,260,0,0,0,0,1
"066581107","BUENOS AIRES",289,282,2,4,0,6,0.975778546712803
"066581302","BUENOS AIRES",137,7,8,120,1,129,0.0510948905109489
"066581504","BUENOS AIRES",171,24,26,120,0,146,0.140350877192982
"066581604","BUENOS AIRES",186,186,0,0,0,0,1
"066581711","BUENOS AIRES",361,348,6,7,0,13,0.96398891966759
"066581901","BUENOS AIRES",228,227,1,0,0,1,0.995614035087719
"066582110","BUENOS AIRES",307,283,11,9,0,20,0.921824104234528
"066582112","BUENOS AIRES",553,506,15,25,0,40,0.91500904159132
"066582206","BUENOS AIRES",242,241,1,0,0,1,0.995867768595041
"066582310","BUENOS AIRES",378,63,70,233,0,303,0.166666666666667
"066582401","BUENOS AIRES",316,311,4,0,0,4,0.984177215189873
"066582513","BUENOS AIRES",375,371,1,0,0,1,0.989333333333333
"066650306","BUENOS AIRES",169,162,5,2,0,7,0.958579881656805
"066582601","BUENOS AIRES",517,445,29,30,4,63,0.86073500967118
"066582604","BUENOS AIRES",349,313,3,31,1,35,0.896848137535817
"066582702","BUENOS AIRES",327,12,33,267,0,300,0.036697247706422
"066582706","BUENOS AIRES",402,22,66,292,1,359,0.054726368159204
"066582708","BUENOS AIRES",214,8,49,142,0,191,0.0373831775700935
"066582709","BUENOS AIRES",457,14,164,264,2,430,0.0306345733041575
"066582712","BUENOS AIRES",370,21,95,244,0,339,0.0567567567567568
"066582908","BUENOS AIRES",391,6,149,215,2,366,0.0153452685421995
"066582911","BUENOS AIRES",360,26,127,203,1,331,0.0722222222222222
"066583102","BUENOS AIRES",387,378,5,1,0,6,0.976744186046512
"066583104","BUENOS AIRES",456,416,22,16,0,38,0.912280701754386
"066583109","BUENOS AIRES",270,266,4,0,0,4,0.985185185185185
"066583112","BUENOS AIRES",235,7,111,114,0,225,0.0297872340425532
"066583203","BUENOS AIRES",365,357,3,3,0,6,0.978082191780822
"066583311","BUENOS AIRES",374,352,14,8,0,22,0.941176470588235
"060561307","BUENOS AIRES",321,316,2,3,0,5,0.984423676012461
"066583413","BUENOS AIRES",409,362,14,22,0,36,0.885085574572127
"066583501","BUENOS AIRES",324,281,21,21,0,42,0.867283950617284
"066583502","BUENOS AIRES",394,256,39,98,0,137,0.649746192893401
"066583601","BUENOS AIRES",524,381,15,111,3,129,0.727099236641221
"066583703","BUENOS AIRES",275,5,110,124,28,262,0.0181818181818182
"066583706","BUENOS AIRES",307,4,29,237,9,275,0.0130293159609121
"066583802","BUENOS AIRES",490,18,97,334,0,431,0.036734693877551
"066583807","BUENOS AIRES",108,2,20,77,0,97,0.0185185185185185
"066583810","BUENOS AIRES",222,8,24,164,3,191,0.036036036036036
"067491307","BUENOS AIRES",9,2,1,6,0,7,0.222222222222222
"066583814","BUENOS AIRES",421,352,24,32,6,62,0.836104513064133
"066583907","BUENOS AIRES",370,14,152,195,1,348,0.0378378378378378
"066930704","BUENOS AIRES",51,0,22,28,0,50,0
"066584003","BUENOS AIRES",301,3,21,242,24,287,0.00996677740863787
"066584008","BUENOS AIRES",284,8,108,153,0,261,0.028169014084507
"066584013","BUENOS AIRES",333,12,169,124,2,295,0.036036036036036
"066584107","BUENOS AIRES",497,123,172,190,1,363,0.24748490945674
"066584113","BUENOS AIRES",495,256,106,123,1,230,0.517171717171717
"066584209","BUENOS AIRES",467,383,47,31,0,78,0.820128479657388
"066584309","BUENOS AIRES",237,4,111,121,0,232,0.0168776371308017
"066584403","BUENOS AIRES",404,10,113,258,2,373,0.0247524752475248
"066584409","BUENOS AIRES",530,6,234,268,0,502,0.0113207547169811
"066584410","BUENOS AIRES",402,16,117,239,3,359,0.0398009950248756
"066650102","BUENOS AIRES",195,3,92,95,0,187,0.0153846153846154
"066650207","BUENOS AIRES",351,339,6,5,0,11,0.965811965811966
"066651001","BUENOS AIRES",311,170,66,69,1,136,0.546623794212219
"067490804","BUENOS AIRES",346,15,151,172,2,325,0.0433526011560694
"066651304","BUENOS AIRES",318,308,5,2,0,7,0.968553459119497
"066651307","BUENOS AIRES",268,262,2,3,1,6,0.977611940298508
"066721201","BUENOS AIRES",483,411,19,43,0,62,0.850931677018634
"066721208","BUENOS AIRES",384,336,17,31,0,48,0.875
"066790305","BUENOS AIRES",107,3,71,31,0,102,0.0280373831775701
"066790401","BUENOS AIRES",6,0,0,6,0,6,0
"066860201","BUENOS AIRES",244,3,151,87,0,238,0.0122950819672131
"066860608","BUENOS AIRES",178,101,25,52,0,77,0.567415730337079
"068400610","BUENOS AIRES",249,239,5,4,0,9,0.959839357429719
"066861312","BUENOS AIRES",266,260,4,2,0,6,0.977443609022556
"066930313","BUENOS AIRES",269,20,201,47,1,249,0.0743494423791822
"066930317","BUENOS AIRES",254,175,64,14,0,78,0.688976377952756
"067490805","BUENOS AIRES",404,202,101,93,0,194,0.5
"067000207","BUENOS AIRES",150,145,4,1,0,5,0.966666666666667
"067001206","BUENOS AIRES",148,144,4,0,0,4,0.972972972972973
"067001211","BUENOS AIRES",328,312,6,1,0,7,0.951219512195122
"067070101","BUENOS AIRES",334,259,27,48,0,75,0.775449101796407
"067070603","BUENOS AIRES",130,3,67,60,0,127,0.0230769230769231
"067071105","BUENOS AIRES",276,142,51,78,1,130,0.514492753623188
"067140107","BUENOS AIRES",337,291,18,27,0,45,0.863501483679525
"067140110","BUENOS AIRES",375,331,16,27,0,43,0.882666666666667
"067140113","BUENOS AIRES",199,75,50,68,2,120,0.376884422110553
"067560912","BUENOS AIRES",322,322,0,0,0,0,1
"067140606","BUENOS AIRES",240,65,78,94,0,172,0.270833333333333
"067140607","BUENOS AIRES",254,68,46,140,0,186,0.267716535433071
"067140610","BUENOS AIRES",164,84,45,32,0,77,0.51219512195122
"067210206","BUENOS AIRES",236,123,66,47,0,113,0.521186440677966
"060561414","BUENOS AIRES",340,339,0,1,0,1,0.997058823529412
"067210214","BUENOS AIRES",240,100,72,66,0,138,0.416666666666667
"067281005","BUENOS AIRES",158,71,54,26,0,80,0.449367088607595
"067281007","BUENOS AIRES",162,93,52,17,0,69,0.574074074074074
"067281010","BUENOS AIRES",269,100,80,84,1,165,0.371747211895911
"067350104","BUENOS AIRES",239,204,18,17,0,35,0.853556485355649
"067350107","BUENOS AIRES",329,239,47,42,1,90,0.726443768996961
"067350301","BUENOS AIRES",151,2,47,98,2,147,0.0132450331125828
"067490303","BUENOS AIRES",228,228,0,0,0,0,1
"067561004","BUENOS AIRES",331,331,0,0,0,0,1
"067350707","BUENOS AIRES",346,12,132,200,0,332,0.0346820809248555
"067490309","BUENOS AIRES",239,237,2,0,0,2,0.99163179916318
"067490311","BUENOS AIRES",316,316,0,0,0,0,1
"067490502","BUENOS AIRES",249,243,5,0,0,5,0.975903614457831
"067490505","BUENOS AIRES",253,250,3,0,0,3,0.988142292490119
"067490708","BUENOS AIRES",438,293,69,70,0,139,0.668949771689498
"067630108","BUENOS AIRES",345,345,0,0,0,0,1
"067490905","BUENOS AIRES",416,350,56,3,7,66,0.841346153846154
"067490906","BUENOS AIRES",324,247,28,44,0,72,0.762345679012346
"067490907","BUENOS AIRES",248,108,104,36,0,140,0.435483870967742
"067491002","BUENOS AIRES",366,333,20,5,0,25,0.909836065573771
"067491007","BUENOS AIRES",291,278,12,1,0,13,0.9553264604811
"067491013","BUENOS AIRES",191,163,7,20,0,27,0.853403141361257
"067491102","BUENOS AIRES",375,124,82,142,1,225,0.330666666666667
"067491203","BUENOS AIRES",446,318,56,51,2,109,0.713004484304933
"067491308","BUENOS AIRES",242,177,23,34,0,57,0.731404958677686
"067491311","BUENOS AIRES",246,230,3,9,0,12,0.934959349593496
"067491316","BUENOS AIRES",504,478,10,4,0,14,0.948412698412698
"067491317","BUENOS AIRES",264,255,6,3,0,9,0.965909090909091
"067600913","BUENOS AIRES",390,373,11,6,0,17,0.956410256410256
"067560202","BUENOS AIRES",237,229,5,3,0,8,0.966244725738397
"020151810","CABA",240,240,0,0,0,0,1
"067560206","BUENOS AIRES",278,269,8,1,0,9,0.967625899280576
"067560408","BUENOS AIRES",195,195,0,0,0,0,1
"067560502","BUENOS AIRES",281,277,3,1,0,4,0.98576512455516
"067560608","BUENOS AIRES",235,235,0,0,0,0,1
"067560709","BUENOS AIRES",285,284,1,0,0,1,0.996491228070175
"067560710","BUENOS AIRES",326,324,2,0,0,2,0.993865030674847
"067561012","BUENOS AIRES",337,336,1,0,0,1,0.997032640949555
"067561106","BUENOS AIRES",341,341,0,0,0,0,1
"067561107","BUENOS AIRES",373,372,0,1,0,1,0.997319034852547
"067561109","BUENOS AIRES",175,175,0,0,0,0,1
"067561211","BUENOS AIRES",332,316,9,3,0,12,0.951807228915663
"067561306","BUENOS AIRES",298,279,12,6,0,18,0.936241610738255
"067561308","BUENOS AIRES",377,366,2,9,0,11,0.970822281167109
"067561312","BUENOS AIRES",373,326,24,12,0,36,0.873994638069705
"067561313","BUENOS AIRES",400,366,32,2,0,34,0.915
"067561412","BUENOS AIRES",270,28,31,170,19,220,0.103703703703704
"067561502","BUENOS AIRES",365,239,54,67,0,121,0.654794520547945
"067601614","BUENOS AIRES",305,8,179,113,0,292,0.0262295081967213
"068402201","BUENOS AIRES",399,361,11,24,1,36,0.904761904761905
"067561701","BUENOS AIRES",309,243,53,4,0,57,0.786407766990291
"067561803","BUENOS AIRES",295,284,8,3,0,11,0.96271186440678
"067561811","BUENOS AIRES",425,420,5,0,0,5,0.988235294117647
"067561902","BUENOS AIRES",421,380,0,4,0,4,0.902612826603325
"063576113","BUENOS AIRES",238,237,1,0,0,1,0.995798319327731
"067562001","BUENOS AIRES",285,116,101,68,0,169,0.407017543859649
"067562007","BUENOS AIRES",468,381,41,14,0,55,0.814102564102564
"067562008","BUENOS AIRES",362,342,11,8,0,19,0.94475138121547
"067562101","BUENOS AIRES",415,320,37,58,0,95,0.771084337349398
"067562204","BUENOS AIRES",465,442,4,3,0,7,0.950537634408602
"067562306","BUENOS AIRES",279,270,6,3,0,9,0.967741935483871
"067562405","BUENOS AIRES",240,233,4,3,0,7,0.970833333333333
"067562502","BUENOS AIRES",317,14,233,66,0,299,0.0441640378548896
"067562505","BUENOS AIRES",238,5,161,71,0,232,0.0210084033613445
"067562507","BUENOS AIRES",203,2,135,63,2,200,0.00985221674876847
"067562509","BUENOS AIRES",350,4,285,61,0,346,0.0114285714285714
"067600111","BUENOS AIRES",222,18,141,62,0,203,0.0810810810810811
"068051102","BUENOS AIRES",253,3,144,103,2,249,0.0118577075098814
"067600203","BUENOS AIRES",227,209,6,8,0,14,0.920704845814978
"067600215","BUENOS AIRES",208,201,7,0,0,7,0.966346153846154
"067600216","BUENOS AIRES",185,185,0,0,0,0,1
"067600501","BUENOS AIRES",542,485,34,18,0,52,0.894833948339483
"067600503","BUENOS AIRES",480,453,13,12,0,25,0.94375
"067600707","BUENOS AIRES",242,1,190,51,0,241,0.00413223140495868
"067600902","BUENOS AIRES",212,83,92,37,0,129,0.391509433962264
"067600911","BUENOS AIRES",459,257,174,28,0,202,0.559912854030501
"067600914","BUENOS AIRES",350,13,213,121,0,334,0.0371428571428571
"067601001","BUENOS AIRES",228,7,131,87,0,218,0.0307017543859649
"067601008","BUENOS AIRES",103,0,63,33,0,96,0
"067601012","BUENOS AIRES",415,29,175,195,1,371,0.0698795180722892
"067601015","BUENOS AIRES",386,7,267,103,1,371,0.0181347150259067
"067601106","BUENOS AIRES",681,9,510,148,6,664,0.013215859030837
"067601210","BUENOS AIRES",234,1,160,70,0,230,0.00427350427350427
"064131102","BUENOS AIRES",0,0,0,0,0,0,NA
"067601302","BUENOS AIRES",330,2,265,63,0,328,0.00606060606060606
"067601404","BUENOS AIRES",444,4,241,189,0,430,0.00900900900900901
"067601406","BUENOS AIRES",572,2,145,384,13,542,0.0034965034965035
"067601415","BUENOS AIRES",118,0,61,56,1,118,0
"067601505","BUENOS AIRES",447,4,141,265,7,413,0.00894854586129754
"067601607","BUENOS AIRES",310,0,125,157,5,287,0
"067601609","BUENOS AIRES",262,2,157,95,2,254,0.00763358778625954
"067601705","BUENOS AIRES",345,3,190,134,0,324,0.00869565217391304
"067601706","BUENOS AIRES",391,0,225,152,0,377,0
"067601707","BUENOS AIRES",295,2,189,95,0,284,0.00677966101694915
"067601713","BUENOS AIRES",316,2,270,40,0,310,0.00632911392405063
"067601806","BUENOS AIRES",253,0,179,73,0,252,0
"067601813","BUENOS AIRES",274,1,146,119,0,265,0.00364963503649635
"067601815","BUENOS AIRES",284,4,155,110,1,266,0.0140845070422535
"063575403","BUENOS AIRES",369,369,0,0,0,0,1
"067630109","BUENOS AIRES",389,386,0,3,0,3,0.992287917737789
"067630401","BUENOS AIRES",325,162,17,136,5,158,0.498461538461538
"067630409","BUENOS AIRES",271,270,0,1,0,1,0.996309963099631
"067630508","BUENOS AIRES",217,70,83,61,0,144,0.32258064516129
"067630509","BUENOS AIRES",257,72,67,111,1,179,0.280155642023346
"067630511","BUENOS AIRES",432,409,12,9,0,21,0.946759259259259
"020132707","CABA",497,495,0,1,0,1,0.995975855130785
"067630512","BUENOS AIRES",140,118,7,15,0,22,0.842857142857143
"067630513","BUENOS AIRES",320,231,73,16,0,89,0.721875
"067630604","BUENOS AIRES",376,6,173,192,1,366,0.0159574468085106
"067630608","BUENOS AIRES",408,2,139,248,0,387,0.00490196078431373
"067630609","BUENOS AIRES",298,5,131,147,1,279,0.0167785234899329
"067630806","BUENOS AIRES",326,8,132,181,1,314,0.0245398773006135
"067630808","BUENOS AIRES",374,6,250,115,1,366,0.0160427807486631
"067630813","BUENOS AIRES",284,3,162,110,1,273,0.0105633802816901
"067632013","BUENOS AIRES",262,8,147,103,0,250,0.0305343511450382
"067631802","BUENOS AIRES",274,270,1,3,0,4,0.985401459854015
"067631805","BUENOS AIRES",215,3,135,75,0,210,0.013953488372093
"067700111","BUENOS AIRES",340,155,52,125,0,177,0.455882352941176
"067631814","BUENOS AIRES",301,7,193,93,1,287,0.0232558139534884
"067631910","BUENOS AIRES",295,281,11,3,0,14,0.952542372881356
"067632004","BUENOS AIRES",41,1,36,3,0,39,0.024390243902439
"067632009","BUENOS AIRES",310,302,4,2,0,6,0.974193548387097
"067700103","BUENOS AIRES",510,424,13,52,3,68,0.831372549019608
"067700104","BUENOS AIRES",359,303,14,35,0,49,0.844011142061281
"067700108","BUENOS AIRES",301,301,0,0,0,0,1
"063711705","BUENOS AIRES",288,22,228,35,0,263,0.0763888888888889
"067702105","BUENOS AIRES",313,309,2,1,0,3,0.987220447284345
"067702214","BUENOS AIRES",391,369,4,17,0,21,0.943734015345269
"067780210","BUENOS AIRES",309,286,12,7,0,19,0.925566343042071
"067780215","BUENOS AIRES",317,115,58,125,1,184,0.362776025236593
"067912003","BUENOS AIRES",450,253,47,134,0,181,0.562222222222222
"067780907","BUENOS AIRES",152,3,86,63,0,149,0.0197368421052632
"067781001","BUENOS AIRES",415,332,36,31,1,68,0.8
"067910105","BUENOS AIRES",206,202,3,1,0,4,0.980582524271845
"067910107","BUENOS AIRES",371,367,3,1,0,4,0.98921832884097
"067910201","BUENOS AIRES",184,178,4,2,0,6,0.967391304347826
"067910203","BUENOS AIRES",268,238,11,17,0,28,0.888059701492537
"067910210","BUENOS AIRES",355,351,3,1,0,4,0.988732394366197
"067910406","BUENOS AIRES",224,220,2,2,0,4,0.982142857142857
"067911003","BUENOS AIRES",87,0,38,47,1,86,0
"067911303","BUENOS AIRES",267,134,43,78,5,126,0.50187265917603
"068401703","BUENOS AIRES",332,329,3,0,0,3,0.990963855421687
"067911305","BUENOS AIRES",498,172,89,219,0,308,0.345381526104418
"067911907","BUENOS AIRES",180,179,0,1,0,1,0.994444444444444
"067912002","BUENOS AIRES",313,214,48,48,1,97,0.68370607028754
"068402304","BUENOS AIRES",225,221,2,2,0,4,0.982222222222222
"067912004","BUENOS AIRES",353,165,62,117,0,179,0.46742209631728
"067912007","BUENOS AIRES",326,319,2,5,0,7,0.978527607361963
"067912111","BUENOS AIRES",288,8,49,217,0,266,0.0277777777777778
"067912212","BUENOS AIRES",254,247,5,2,0,7,0.97244094488189
"067980703","BUENOS AIRES",318,289,13,16,0,29,0.908805031446541
"067980709","BUENOS AIRES",180,56,34,83,2,119,0.311111111111111
"068050104","BUENOS AIRES",318,1,145,166,1,312,0.00314465408805031
"068051210","BUENOS AIRES",595,39,452,102,1,555,0.065546218487395
"068051307","BUENOS AIRES",311,7,188,111,0,299,0.022508038585209
"020112103","CABA",423,422,1,0,0,1,0.997635933806147
"068050507","BUENOS AIRES",521,61,179,272,3,454,0.117082533589251
"068050106","BUENOS AIRES",158,153,4,1,0,5,0.968354430379747
"068050304","BUENOS AIRES",607,591,7,0,0,7,0.973640856672158
"068050407","BUENOS AIRES",719,13,97,567,10,674,0.0180806675938804
"068050504","BUENOS AIRES",251,244,5,2,0,7,0.972111553784861
"068051501","BUENOS AIRES",275,3,167,104,0,271,0.0109090909090909
"068050510","BUENOS AIRES",269,9,187,73,0,260,0.033457249070632
"068050606","BUENOS AIRES",227,217,5,5,0,10,0.955947136563877
"068050711","BUENOS AIRES",35,27,0,6,0,6,0.771428571428571
"068050901","BUENOS AIRES",1,0,0,1,0,1,0
"068051007","BUENOS AIRES",418,6,153,227,1,381,0.0143540669856459
"068051010","BUENOS AIRES",379,2,72,285,5,362,0.00527704485488127
"068051508","BUENOS AIRES",433,3,276,146,3,425,0.0069284064665127
"068051602","BUENOS AIRES",550,4,303,217,5,525,0.00727272727272727
"068052107","BUENOS AIRES",271,3,88,164,1,253,0.011070110701107
"068052503","BUENOS AIRES",156,1,120,35,0,155,0.00641025641025641
"068051609","BUENOS AIRES",316,153,100,56,0,156,0.484177215189873
"068051610","BUENOS AIRES",594,33,201,328,0,529,0.0555555555555556
"068051710","BUENOS AIRES",431,1,321,104,0,425,0.00232018561484919
"068051711","BUENOS AIRES",443,1,287,147,0,434,0.00225733634311512
"068051913","BUENOS AIRES",82,24,40,18,0,58,0.292682926829268
"068052007","BUENOS AIRES",533,481,39,3,2,44,0.902439024390244
"068052404","BUENOS AIRES",374,0,275,97,0,372,0
"068052104","BUENOS AIRES",577,7,310,240,2,552,0.0121317157712305
"068052113","BUENOS AIRES",374,7,161,198,0,359,0.018716577540107
"068190407","BUENOS AIRES",262,188,36,35,0,71,0.717557251908397
"068052301","BUENOS AIRES",344,4,163,155,1,319,0.0116279069767442
"068052305","BUENOS AIRES",365,1,196,148,3,347,0.00273972602739726
"068052308","BUENOS AIRES",250,16,125,105,2,232,0.064
"068052310","BUENOS AIRES",392,3,237,144,0,381,0.0076530612244898
"068052402","BUENOS AIRES",447,27,258,147,1,406,0.0604026845637584
"068052410","BUENOS AIRES",431,3,158,255,2,415,0.00696055684454756
"068190904","BUENOS AIRES",167,3,127,27,9,163,0.0179640718562874
"068260110","BUENOS AIRES",131,127,1,3,0,4,0.969465648854962
"060281911","BUENOS AIRES",362,3,203,139,2,344,0.00828729281767956
"068260211","BUENOS AIRES",145,139,4,2,0,6,0.958620689655172
"060282401","BUENOS AIRES",390,120,141,128,0,269,0.307692307692308
"068260704","BUENOS AIRES",179,16,107,53,2,162,0.0893854748603352
"068261904","BUENOS AIRES",190,183,2,3,1,6,0.963157894736842
"068401502","BUENOS AIRES",407,394,3,0,0,3,0.968058968058968
"068261905","BUENOS AIRES",165,153,5,7,0,12,0.927272727272727
"068261909","BUENOS AIRES",339,320,9,4,0,13,0.943952802359882
"068330106","BUENOS AIRES",337,301,12,23,0,35,0.893175074183976
"068330205","BUENOS AIRES",271,271,0,0,0,0,1
"068330210","BUENOS AIRES",320,317,3,0,0,3,0.990625
"068330213","BUENOS AIRES",349,324,6,16,0,22,0.92836676217765
"068400207","BUENOS AIRES",213,43,115,55,0,170,0.2018779342723
"068331007","BUENOS AIRES",418,245,108,63,0,171,0.586124401913876
"068331009","BUENOS AIRES",374,121,49,201,2,252,0.323529411764706
"068331501","BUENOS AIRES",76,0,33,42,0,75,0
"068331506","BUENOS AIRES",119,0,48,70,0,118,0
"068331909","BUENOS AIRES",300,115,40,141,1,182,0.383333333333333
"068400103","BUENOS AIRES",537,9,276,217,25,518,0.0167597765363128
"068400109","BUENOS AIRES",313,11,165,128,3,296,0.0351437699680511
"068400301","BUENOS AIRES",368,34,188,144,0,332,0.0923913043478261
"068400304","BUENOS AIRES",403,9,261,124,0,385,0.0223325062034739
"068400310","BUENOS AIRES",270,151,92,27,0,119,0.559259259259259
"068400601","BUENOS AIRES",407,17,200,187,0,387,0.0417690417690418
"068402307","BUENOS AIRES",189,179,2,5,1,8,0.947089947089947
"068400616","BUENOS AIRES",328,323,2,3,0,5,0.984756097560976
"068401402","BUENOS AIRES",231,227,2,2,0,4,0.982683982683983
"068401001","BUENOS AIRES",411,406,2,2,0,4,0.987834549878346
"068401002","BUENOS AIRES",441,440,0,0,0,0,0.997732426303855
"068401106","BUENOS AIRES",378,373,2,1,0,3,0.986772486772487
"068401107","BUENOS AIRES",279,274,1,3,0,4,0.982078853046595
"068401110","BUENOS AIRES",410,403,6,1,0,7,0.982926829268293
"068401201","BUENOS AIRES",365,359,2,1,0,3,0.983561643835616
"068401202","BUENOS AIRES",376,371,3,2,0,5,0.986702127659574
"068401314","BUENOS AIRES",180,179,0,1,0,1,0.994444444444444
"068401406","BUENOS AIRES",262,259,2,1,0,3,0.988549618320611
"068402006","BUENOS AIRES",322,300,13,7,0,20,0.93167701863354
"068402009","BUENOS AIRES",311,289,16,5,0,21,0.929260450160772
"068402106","BUENOS AIRES",391,385,5,0,0,5,0.9846547314578
"068402110","BUENOS AIRES",393,384,1,5,0,6,0.977099236641221
"020132803","CABA",318,317,1,0,0,1,0.99685534591195
"068402310","BUENOS AIRES",305,301,2,0,0,2,0.986885245901639
"068402603","BUENOS AIRES",359,346,8,1,0,9,0.963788300835655
"068402701","BUENOS AIRES",250,247,1,1,0,2,0.988
"068403109","BUENOS AIRES",380,375,3,2,0,5,0.986842105263158
"068402805","BUENOS AIRES",380,377,2,0,0,2,0.992105263157895
"068402901","BUENOS AIRES",333,325,5,3,0,8,0.975975975975976
"068403007","BUENOS AIRES",231,228,2,0,0,2,0.987012987012987
"068403108","BUENOS AIRES",333,329,2,1,0,3,0.987987987987988
"068403206","BUENOS AIRES",267,265,2,0,0,2,0.99250936329588
"068470111","BUENOS AIRES",351,0,254,83,6,343,0
"068470112","BUENOS AIRES",178,0,106,69,2,177,0
"068120102","BUENOS AIRES",28,0,11,17,0,28,0
"068190302","BUENOS AIRES",29,0,10,18,1,29,0
"068190103","BUENOS AIRES",30,0,23,7,0,30,0
"068190104","BUENOS AIRES",60,1,31,27,0,58,0.0166666666666667
"068540209","BUENOS AIRES",422,162,55,196,1,252,0.383886255924171
"064905011","BUENOS AIRES",238,54,154,30,0,184,0.226890756302521
"068540103","BUENOS AIRES",300,250,8,38,3,49,0.833333333333333
"068540104","BUENOS AIRES",267,152,49,66,0,115,0.569288389513109
"068540204","BUENOS AIRES",286,265,10,11,0,21,0.926573426573427
"068260707","BUENOS AIRES",20,0,2,18,0,20,0
"068260709","BUENOS AIRES",55,5,24,26,0,50,0.0909090909090909
"068540206","BUENOS AIRES",309,265,11,33,0,44,0.857605177993528
"068260802","BUENOS AIRES",14,14,0,0,0,0,1
"068261603","BUENOS AIRES",37,0,27,9,0,36,0
"068330304","BUENOS AIRES",4,0,0,4,0,4,0
"068331404","BUENOS AIRES",5,0,1,4,0,5,0
"068331105","BUENOS AIRES",4,0,3,1,0,4,0
"068331502","BUENOS AIRES",15,0,8,7,0,15,0
"068610209","BUENOS AIRES",266,245,0,4,0,4,0.921052631578947
"068610310","BUENOS AIRES",233,233,0,0,0,0,1
"068331504","BUENOS AIRES",12,0,10,2,0,12,0
"068470106","BUENOS AIRES",14,0,11,3,0,14,0
"068470110","BUENOS AIRES",23,0,1,22,0,23,0
"068470203","BUENOS AIRES",25,0,13,11,0,24,0
"068540501","BUENOS AIRES",43,0,19,23,0,42,0
"068541004","BUENOS AIRES",315,135,96,84,0,180,0.428571428571429
"068611109","BUENOS AIRES",308,302,2,4,0,6,0.980519480519481
"068611201","BUENOS AIRES",265,265,0,0,0,0,1
"065180201","BUENOS AIRES",96,69,15,12,0,27,0.71875
"068610201","BUENOS AIRES",273,155,15,97,2,114,0.567765567765568
"068540901","BUENOS AIRES",47,0,15,31,0,46,0
"068541405","BUENOS AIRES",29,0,21,5,1,27,0
"068680511","BUENOS AIRES",2,0,0,0,0,0,0
"068540801","BUENOS AIRES",102,1,34,66,0,100,0.00980392156862745
"068821301","BUENOS AIRES",178,29,59,73,2,134,0.162921348314607
"068610411","BUENOS AIRES",199,199,0,0,0,0,1
"068610703","BUENOS AIRES",286,286,0,0,0,0,1
"068610704","BUENOS AIRES",248,248,0,0,0,0,1
"068610801","BUENOS AIRES",341,340,0,1,0,1,0.997067448680352
"068610808","BUENOS AIRES",257,257,0,0,0,0,1
"068611103","BUENOS AIRES",300,296,2,1,0,3,0.986666666666667
"068611107","BUENOS AIRES",375,357,14,4,0,18,0.952
"068611205","BUENOS AIRES",339,336,1,0,0,1,0.991150442477876
"068611207","BUENOS AIRES",309,305,1,2,0,3,0.98705501618123
"068611305","BUENOS AIRES",296,293,3,0,0,3,0.989864864864865
"068611406","BUENOS AIRES",189,189,0,0,0,0,1
"068611410","BUENOS AIRES",248,248,0,0,0,0,1
"068611503","BUENOS AIRES",392,391,0,0,0,0,0.997448979591837
"068611507","BUENOS AIRES",289,287,2,0,0,2,0.993079584775087
"068611607","BUENOS AIRES",318,317,0,1,0,1,0.99685534591195
"068611608","BUENOS AIRES",266,262,4,0,0,4,0.984962406015038
"068611914","BUENOS AIRES",239,232,5,2,0,7,0.97071129707113
"068612107","BUENOS AIRES",338,326,3,9,0,12,0.964497041420118
"068612207","BUENOS AIRES",332,331,1,0,0,1,0.996987951807229
"068612306","BUENOS AIRES",162,138,17,5,0,22,0.851851851851852
"068612409","BUENOS AIRES",333,333,0,0,0,0,1
"068612701","BUENOS AIRES",367,364,3,0,0,3,0.991825613079019
"068612705","BUENOS AIRES",242,242,0,0,0,0,1
"068612707","BUENOS AIRES",346,333,10,1,0,11,0.96242774566474
"068612710","BUENOS AIRES",287,285,2,0,0,2,0.993031358885017
"068612907","BUENOS AIRES",262,252,4,0,0,4,0.961832061068702
"068613105","BUENOS AIRES",237,227,5,3,0,8,0.957805907172996
"068613202","BUENOS AIRES",404,389,12,0,0,12,0.962871287128713
"068613303","BUENOS AIRES",371,355,12,0,0,12,0.956873315363881
"068680105","BUENOS AIRES",102,92,6,4,0,10,0.901960784313726
"068680306","BUENOS AIRES",204,181,18,5,0,23,0.887254901960784
"068680313","BUENOS AIRES",37,37,0,0,0,0,1
"068680402","BUENOS AIRES",24,23,1,0,0,1,0.958333333333333
"068680409","BUENOS AIRES",29,28,1,0,0,1,0.96551724137931
"068680602","BUENOS AIRES",37,34,2,1,0,3,0.918918918918919
"068680605","BUENOS AIRES",34,34,0,0,0,0,1
"068680703","BUENOS AIRES",121,40,48,31,0,79,0.330578512396694
"068680705","BUENOS AIRES",70,64,6,0,0,6,0.914285714285714
"068680709","BUENOS AIRES",26,25,1,0,0,1,0.961538461538462
"068821605","BUENOS AIRES",465,398,12,48,0,60,0.855913978494624
"068680801","BUENOS AIRES",305,47,173,82,1,256,0.154098360655738
"068751504","BUENOS AIRES",163,0,86,56,9,151,0
"068751602","BUENOS AIRES",437,315,62,45,4,111,0.720823798627002
"068751606","BUENOS AIRES",297,8,140,138,2,280,0.0269360269360269
"068820104","BUENOS AIRES",423,407,7,5,0,12,0.962174940898345
"068820203","BUENOS AIRES",226,226,0,0,0,0,1
"068820205","BUENOS AIRES",314,313,1,0,0,1,0.996815286624204
"068820501","BUENOS AIRES",117,79,10,26,0,36,0.675213675213675
"068820505","BUENOS AIRES",48,41,0,7,0,7,0.854166666666667
"068820801","BUENOS AIRES",440,84,109,181,41,331,0.190909090909091
"063573705","BUENOS AIRES",213,211,2,0,0,2,0.990610328638498
"068821002","BUENOS AIRES",230,228,0,0,0,0,0.991304347826087
"068821007","BUENOS AIRES",241,227,9,5,0,14,0.941908713692946
"065601506","BUENOS AIRES",287,0,135,148,0,283,0
"065601508","BUENOS AIRES",729,391,172,144,2,318,0.536351165980796
"065601510","BUENOS AIRES",328,9,166,142,2,310,0.0274390243902439
"065601609","BUENOS AIRES",387,2,210,163,2,375,0.00516795865633075
"065601616","BUENOS AIRES",240,0,173,46,0,219,0
"065601701","BUENOS AIRES",377,1,144,213,4,361,0.0026525198938992
"065601716","BUENOS AIRES",248,0,155,77,4,236,0
"065601723","BUENOS AIRES",224,120,85,19,0,104,0.535714285714286
"064905009","BUENOS AIRES",215,167,28,19,0,47,0.776744186046512
"065601724","BUENOS AIRES",245,134,73,33,0,106,0.546938775510204
"065601906","BUENOS AIRES",203,1,84,108,1,193,0.00492610837438424
"065601907","BUENOS AIRES",302,0,206,95,0,301,0
"065601908","BUENOS AIRES",286,0,255,30,0,285,0
"065602006","BUENOS AIRES",303,137,74,84,5,163,0.452145214521452
"065602101","BUENOS AIRES",377,5,248,116,5,369,0.013262599469496
"066583711","BUENOS AIRES",539,6,154,364,0,518,0.0111317254174397
"065602310","BUENOS AIRES",233,232,0,1,0,1,0.995708154506438
"065602406","BUENOS AIRES",282,243,21,12,0,33,0.861702127659574
"065602507","BUENOS AIRES",280,210,69,1,0,70,0.75
"065680103","BUENOS AIRES",349,222,104,23,0,127,0.636103151862464
"065680203","BUENOS AIRES",324,279,40,5,0,45,0.861111111111111
"020111304","CABA",345,341,1,0,0,1,0.988405797101449
"065680402","BUENOS AIRES",233,228,4,1,0,5,0.978540772532189
"065680411","BUENOS AIRES",371,367,3,1,0,4,0.98921832884097
"065680603","BUENOS AIRES",294,293,1,0,0,1,0.996598639455782
"065680708","BUENOS AIRES",281,8,213,60,0,273,0.0284697508896797
"065680801","BUENOS AIRES",337,5,290,41,0,331,0.0148367952522255
"065680907","BUENOS AIRES",393,4,283,105,0,388,0.0101781170483461
"065680908","BUENOS AIRES",180,3,160,16,0,176,0.0166666666666667
"065680912","BUENOS AIRES",204,204,0,0,0,0,1
"065681013","BUENOS AIRES",363,347,8,7,0,15,0.955922865013774
"065681201","BUENOS AIRES",265,262,2,1,0,3,0.988679245283019
"065681205","BUENOS AIRES",387,384,2,1,0,3,0.992248062015504
"065681207","BUENOS AIRES",401,398,1,0,0,1,0.992518703241895
"068751505","BUENOS AIRES",41,1,20,16,2,38,0.024390243902439
"064904903","BUENOS AIRES",264,262,2,0,0,2,0.992424242424242
"064904904","BUENOS AIRES",481,478,3,0,0,3,0.993762993762994
"064904909","BUENOS AIRES",207,152,40,15,0,55,0.734299516908213
"064905001","BUENOS AIRES",359,335,15,9,0,24,0.933147632311978
"064905008","BUENOS AIRES",325,323,2,0,0,2,0.993846153846154
"064970104","BUENOS AIRES",313,310,1,1,0,2,0.990415335463259
"066583410","BUENOS AIRES",245,168,43,34,0,77,0.685714285714286
"064970306","BUENOS AIRES",205,2,94,102,1,197,0.00975609756097561
"064970307","BUENOS AIRES",432,5,115,285,9,409,0.0115740740740741
"066583612","BUENOS AIRES",398,140,88,149,0,237,0.351758793969849
"065151909","BUENOS AIRES",340,4,214,109,1,324,0.0117647058823529
"064970405","BUENOS AIRES",181,0,94,87,0,181,0
"065321511","BUENOS AIRES",409,407,0,2,0,2,0.995110024449878
"064970505","BUENOS AIRES",413,5,78,316,1,395,0.0121065375302663
"064970507","BUENOS AIRES",345,126,88,124,0,212,0.365217391304348
"064970512","BUENOS AIRES",322,124,103,85,3,191,0.385093167701863
"064970708","BUENOS AIRES",295,294,1,0,0,1,0.996610169491525
"064970806","BUENOS AIRES",213,1,96,116,0,212,0.00469483568075117
"066584207","BUENOS AIRES",226,64,68,89,0,157,0.283185840707965
"064971106","BUENOS AIRES",382,375,5,2,0,7,0.981675392670157
"060351413","BUENOS AIRES",210,205,3,2,0,5,0.976190476190476
"064971203","BUENOS AIRES",293,232,26,34,0,60,0.791808873720137
"065150107","BUENOS AIRES",258,0,167,87,0,254,0
"064971303","BUENOS AIRES",165,1,119,45,0,164,0.00606060606060606
"064971304","BUENOS AIRES",137,0,95,42,0,137,0
"064971403","BUENOS AIRES",502,184,178,134,1,313,0.366533864541833
"064971410","BUENOS AIRES",292,145,81,65,0,146,0.496575342465753
"065050313","BUENOS AIRES",161,129,14,17,0,31,0.801242236024845
"065050317","BUENOS AIRES",91,5,51,35,0,86,0.0549450549450549
"066790101","BUENOS AIRES",78,0,65,13,0,78,0
"065152101","BUENOS AIRES",101,0,94,7,0,101,0
"065152110","BUENOS AIRES",328,4,249,72,0,321,0.0121951219512195
"065152115","BUENOS AIRES",203,1,152,49,0,201,0.00492610837438424
"065180111","BUENOS AIRES",52,12,18,18,4,40,0.230769230769231
"067140115","BUENOS AIRES",211,173,11,26,0,37,0.819905213270142
"065250113","BUENOS AIRES",160,50,62,48,0,110,0.3125
"065150215","BUENOS AIRES",363,3,180,168,1,349,0.00826446280991736
"065150304","BUENOS AIRES",369,1,212,145,1,358,0.002710027100271
"065150307","BUENOS AIRES",297,1,155,130,3,288,0.00336700336700337
"065150503","BUENOS AIRES",471,6,319,133,3,455,0.0127388535031847
"065150507","BUENOS AIRES",337,15,284,37,0,321,0.0445103857566766
"065150510","BUENOS AIRES",96,1,59,34,0,93,0.0104166666666667
"065150615","BUENOS AIRES",233,2,172,58,0,230,0.00858369098712446
"065150701","BUENOS AIRES",525,11,228,257,2,487,0.020952380952381
"065390413","BUENOS AIRES",249,249,0,0,0,0,1
"065150803","BUENOS AIRES",304,4,183,99,0,282,0.0131578947368421
"065150808","BUENOS AIRES",379,2,291,81,0,372,0.00527704485488127
"060282610","BUENOS AIRES",171,45,39,75,2,116,0.263157894736842
"060283009","BUENOS AIRES",325,3,150,161,1,312,0.00923076923076923
"060283305","BUENOS AIRES",288,158,94,26,10,130,0.548611111111111
"060283910","BUENOS AIRES",452,4,306,132,3,441,0.00884955752212389
"060283911","BUENOS AIRES",408,0,131,259,4,394,0
"065150912","BUENOS AIRES",345,1,238,100,1,339,0.00289855072463768
"060351204","BUENOS AIRES",146,146,0,0,0,0,1
"060490201","BUENOS AIRES",258,239,7,12,0,19,0.926356589147287
"060490501","BUENOS AIRES",261,239,12,9,0,21,0.915708812260536
"060491002","BUENOS AIRES",124,49,44,29,2,75,0.395161290322581
"060560209","BUENOS AIRES",252,249,3,0,0,3,0.988095238095238
"065151012","BUENOS AIRES",162,1,147,12,1,160,0.00617283950617284
"060561202","BUENOS AIRES",294,293,0,0,0,0,0.996598639455782
"060770512","BUENOS AIRES",191,42,93,43,1,137,0.219895287958115
"065151104","BUENOS AIRES",230,0,173,52,1,226,0
"060911706","BUENOS AIRES",363,240,48,64,0,112,0.661157024793388
"060912409","BUENOS AIRES",104,0,77,27,0,104,0
"020151812","CABA",244,243,1,0,0,1,0.995901639344262
"062242004","BUENOS AIRES",5,0,1,4,0,5,0
"061120111","BUENOS AIRES",330,258,32,36,0,68,0.781818181818182
"061470102","BUENOS AIRES",321,308,5,6,0,11,0.959501557632399
"060070103","BUENOS AIRES",13,0,10,3,0,13,0
"060070209","BUENOS AIRES",6,0,1,4,1,6,0
"060070803","BUENOS AIRES",257,146,65,46,0,111,0.568093385214008
"060070807","BUENOS AIRES",313,284,11,18,0,29,0.907348242811502
"060070813","BUENOS AIRES",205,102,42,54,0,96,0.497560975609756
"061820209","BUENOS AIRES",252,245,3,1,0,4,0.972222222222222
"060140504","BUENOS AIRES",301,2,218,78,2,298,0.00664451827242525
"060141013","BUENOS AIRES",306,200,57,49,0,106,0.65359477124183
"063573703","BUENOS AIRES",206,206,0,0,0,0,1
"060280303","BUENOS AIRES",496,18,142,291,4,437,0.0362903225806452
"060280306","BUENOS AIRES",194,1,23,161,1,185,0.00515463917525773
"060560507","BUENOS AIRES",329,320,3,5,0,8,0.972644376899696
"060280403","BUENOS AIRES",390,28,79,246,1,326,0.0717948717948718
"060280405","BUENOS AIRES",339,7,80,216,9,305,0.0206489675516224
"060280409","BUENOS AIRES",445,8,80,322,3,405,0.0179775280898876
"060280509","BUENOS AIRES",62,0,20,37,0,57,0
"060280510","BUENOS AIRES",66,5,25,29,0,54,0.0757575757575758
"060280511","BUENOS AIRES",324,2,122,191,0,313,0.00617283950617284
"060280513","BUENOS AIRES",359,0,145,203,0,348,0
"060280603","BUENOS AIRES",443,3,261,146,1,408,0.00677200902934537
"060280607","BUENOS AIRES",400,5,187,178,0,365,0.0125
"060280609","BUENOS AIRES",334,282,51,1,0,52,0.844311377245509
"060280610","BUENOS AIRES",1001,7,567,399,2,968,0.00699300699300699
"060280810","BUENOS AIRES",490,25,310,147,2,459,0.0510204081632653
"060280811","BUENOS AIRES",464,5,366,89,0,455,0.0107758620689655
"060280909","BUENOS AIRES",490,118,209,155,0,364,0.240816326530612
"060281012","BUENOS AIRES",320,8,159,141,0,300,0.025
"060281101","BUENOS AIRES",298,262,14,17,0,31,0.879194630872483
"060281202","BUENOS AIRES",335,329,6,0,0,6,0.982089552238806
"060281203","BUENOS AIRES",408,391,12,5,0,17,0.958333333333333
"060281209","BUENOS AIRES",334,275,40,19,0,59,0.823353293413174
"060281404","BUENOS AIRES",434,0,266,152,1,419,0
"060281605","BUENOS AIRES",323,322,1,0,0,1,0.996904024767802
"060281701","BUENOS AIRES",247,243,0,3,0,3,0.983805668016194
"060281707","BUENOS AIRES",332,300,0,0,0,0,0.903614457831325
"060281708","BUENOS AIRES",397,387,1,1,0,2,0.974811083123426
"060281806","BUENOS AIRES",466,1,310,135,2,447,0.00214592274678112
"060281912","BUENOS AIRES",298,2,189,95,0,284,0.00671140939597315
"060282001","BUENOS AIRES",397,2,286,107,0,393,0.00503778337531486
"060282102","BUENOS AIRES",249,2,163,81,0,244,0.00803212851405622
"060282203","BUENOS AIRES",345,7,210,119,0,329,0.0202898550724638
"063573903","BUENOS AIRES",168,168,0,0,0,0,1
"060282205","BUENOS AIRES",438,4,258,162,0,420,0.0091324200913242
"060282212","BUENOS AIRES",246,1,165,75,1,241,0.0040650406504065
"060351904","BUENOS AIRES",272,118,125,29,0,154,0.433823529411765
"060282216","BUENOS AIRES",544,7,310,221,1,532,0.0128676470588235
"060282218","BUENOS AIRES",237,0,186,46,1,233,0
"060282311","BUENOS AIRES",262,5,197,59,0,256,0.0190839694656489
"060282408","BUENOS AIRES",324,7,246,71,0,317,0.0216049382716049
"060282502","BUENOS AIRES",329,326,2,1,0,3,0.990881458966565
"060282511","BUENOS AIRES",399,382,12,4,1,17,0.957393483709273
"060282606","BUENOS AIRES",227,90,75,55,0,130,0.39647577092511
"060282707","BUENOS AIRES",152,3,76,61,1,138,0.0197368421052632
"060282808","BUENOS AIRES",253,3,182,64,0,246,0.0118577075098814
"060283012","BUENOS AIRES",244,1,142,97,1,240,0.00409836065573771
"060700207","BUENOS AIRES",185,182,0,2,0,2,0.983783783783784
"060283106","BUENOS AIRES",407,2,353,52,0,405,0.00491400491400491
"062100208","BUENOS AIRES",289,286,2,1,0,3,0.98961937716263
"060283204","BUENOS AIRES",296,3,222,71,0,293,0.0101351351351351
"060283309","BUENOS AIRES",373,2,300,71,0,371,0.00536193029490617
"060283401","BUENOS AIRES",275,0,181,92,1,274,0
"060283501","BUENOS AIRES",386,12,205,155,5,365,0.0310880829015544
"060283504","BUENOS AIRES",315,0,221,87,0,308,0
"060283606","BUENOS AIRES",404,0,180,214,2,396,0
"060283701","BUENOS AIRES",352,2,298,52,0,350,0.00568181818181818
"060283708","BUENOS AIRES",259,0,171,77,3,251,0
"060283806","BUENOS AIRES",272,0,235,33,0,268,0
"060352803","BUENOS AIRES",298,30,131,134,2,267,0.100671140939597
"060283902","BUENOS AIRES",380,0,201,160,2,363,0
"060353203","BUENOS AIRES",325,288,21,15,0,36,0.886153846153846
"060283906","BUENOS AIRES",251,75,44,122,1,167,0.298804780876494
"060350108","BUENOS AIRES",175,145,12,7,0,19,0.828571428571429
"060350104","BUENOS AIRES",217,187,7,5,1,13,0.861751152073733
"060350302","BUENOS AIRES",341,47,108,181,0,289,0.13782991202346
"060561108","BUENOS AIRES",234,234,0,0,0,0,1
"060350312","BUENOS AIRES",248,235,0,0,0,0,0.94758064516129
"060350503","BUENOS AIRES",291,288,3,0,0,3,0.989690721649485
"060350505","BUENOS AIRES",830,68,287,423,7,717,0.0819277108433735
"060350603","BUENOS AIRES",337,296,16,25,0,41,0.878338278931751
"060350610","BUENOS AIRES",266,258,2,3,0,5,0.969924812030075
"060350708","BUENOS AIRES",117,89,18,9,0,27,0.760683760683761
"060350805","BUENOS AIRES",112,106,3,1,0,4,0.946428571428571
"060350806","BUENOS AIRES",233,214,10,4,0,14,0.918454935622318
"060350810","BUENOS AIRES",180,107,26,46,0,72,0.594444444444444
"060350901","BUENOS AIRES",229,164,29,10,0,39,0.716157205240175
"060350913","BUENOS AIRES",294,251,28,11,2,41,0.853741496598639
"060353205","BUENOS AIRES",244,241,1,2,0,3,0.987704918032787
"060351001","BUENOS AIRES",256,180,10,44,1,55,0.703125
"060351002","BUENOS AIRES",905,905,0,0,0,0,1
"060351010","BUENOS AIRES",299,299,0,0,0,0,1
"060351012","BUENOS AIRES",283,278,4,0,0,4,0.982332155477032
"060351407","BUENOS AIRES",174,172,1,1,0,2,0.988505747126437
"060351409","BUENOS AIRES",285,285,0,0,0,0,1
"060351608","BUENOS AIRES",357,54,124,174,2,300,0.151260504201681
"060351808","BUENOS AIRES",229,115,67,47,0,114,0.502183406113537
"060561211","BUENOS AIRES",169,169,0,0,0,0,1
"060351906","BUENOS AIRES",319,254,41,24,0,65,0.796238244514107
"060352107","BUENOS AIRES",212,207,5,0,0,5,0.976415094339623
"060352201","BUENOS AIRES",421,125,27,249,0,276,0.296912114014252
"060352210","BUENOS AIRES",260,248,5,7,0,12,0.953846153846154
"060352511","BUENOS AIRES",385,382,2,0,0,2,0.992207792207792
"060352709","BUENOS AIRES",303,32,115,152,0,267,0.105610561056106
"060352802","BUENOS AIRES",340,52,191,91,0,282,0.152941176470588
"060352806","BUENOS AIRES",321,34,140,146,0,286,0.105919003115265
"060352808","BUENOS AIRES",340,34,163,141,0,304,0.1
"060352909","BUENOS AIRES",219,28,130,61,0,191,0.127853881278539
"060353208","BUENOS AIRES",286,239,38,8,0,46,0.835664335664336
"060353302","BUENOS AIRES",311,303,8,0,0,8,0.97427652733119
"060353408","BUENOS AIRES",251,233,14,4,0,18,0.928286852589641
"065151217","BUENOS AIRES",231,0,172,49,0,221,0
"020050603","CABA",438,438,0,0,0,0,1
"065151301","BUENOS AIRES",317,0,182,92,2,276,0
"060421907","BUENOS AIRES",231,226,3,2,0,5,0.978354978354978
"060490102","BUENOS AIRES",210,205,1,2,0,3,0.976190476190476
"060490103","BUENOS AIRES",259,241,14,4,0,18,0.930501930501931
"060490106","BUENOS AIRES",246,246,0,0,0,0,1
"060560405","BUENOS AIRES",440,434,5,1,0,6,0.986363636363636
"060490113","BUENOS AIRES",241,236,4,1,0,5,0.979253112033195
"060490116","BUENOS AIRES",189,110,13,64,1,78,0.582010582010582
"060490404","BUENOS AIRES",103,14,72,17,0,89,0.135922330097087
"060490609","BUENOS AIRES",318,205,48,64,0,112,0.644654088050314
"062520105","BUENOS AIRES",394,8,190,183,6,379,0.0203045685279188
"060492510","BUENOS AIRES",292,171,28,93,0,121,0.585616438356164
"060560101","BUENOS AIRES",326,325,1,0,0,1,0.996932515337423
"060560118","BUENOS AIRES",176,176,0,0,0,0,1
"060560119","BUENOS AIRES",295,295,0,0,0,0,1
"065151303","BUENOS AIRES",255,1,139,84,0,223,0.00392156862745098
"060560204","BUENOS AIRES",193,170,11,12,0,23,0.880829015544041
"060560205","BUENOS AIRES",189,177,10,2,0,12,0.936507936507937
"060560212","BUENOS AIRES",329,315,13,1,0,14,0.957446808510638
"062520614","BUENOS AIRES",199,2,115,76,1,192,0.0100502512562814
"060560214","BUENOS AIRES",247,243,2,2,0,4,0.983805668016194
"060560401","BUENOS AIRES",387,370,7,8,1,16,0.956072351421189
"060560704","BUENOS AIRES",390,389,1,0,0,1,0.997435897435897
"060560802","BUENOS AIRES",475,365,56,47,0,103,0.768421052631579
"060560903","BUENOS AIRES",263,263,0,0,0,0,1
"060561001","BUENOS AIRES",129,129,0,0,0,0,1
"060561002","BUENOS AIRES",183,183,0,0,0,0,1
"060561502","BUENOS AIRES",383,372,7,2,0,9,0.971279373368146
"060561503","BUENOS AIRES",336,323,7,6,0,13,0.961309523809524
"060561513","BUENOS AIRES",234,186,35,13,0,48,0.794871794871795
"060561516","BUENOS AIRES",175,154,5,14,0,19,0.88
"060561808","BUENOS AIRES",327,317,8,2,0,10,0.969418960244648
"060561910","BUENOS AIRES",479,252,25,181,0,206,0.526096033402923
"060562005","BUENOS AIRES",357,356,0,0,0,0,0.997198879551821
"060562106","BUENOS AIRES",158,157,1,0,0,1,0.993670886075949
"062600314","BUENOS AIRES",259,3,150,98,1,249,0.0115830115830116
"060562208","BUENOS AIRES",391,369,11,9,0,20,0.943734015345269
"060562211","BUENOS AIRES",264,263,0,1,0,1,0.996212121212121
"060562408","BUENOS AIRES",732,108,129,435,4,568,0.147540983606557
"060562417","BUENOS AIRES",186,88,20,71,0,91,0.473118279569892
"060562510","BUENOS AIRES",328,327,1,0,0,1,0.996951219512195
"060562516","BUENOS AIRES",343,337,3,2,0,5,0.982507288629738
"060562602","BUENOS AIRES",289,0,218,64,1,283,0
"060562605","BUENOS AIRES",301,5,238,57,1,296,0.0166112956810631
"060562606","BUENOS AIRES",189,2,93,93,0,186,0.0105820105820106
"060562613","BUENOS AIRES",438,32,192,205,0,397,0.0730593607305936
"060562618","BUENOS AIRES",201,2,59,130,1,190,0.00995024875621891
"062601617","BUENOS AIRES",416,27,283,97,1,381,0.0649038461538462
"060630104","BUENOS AIRES",344,143,25,165,2,192,0.415697674418605
"060630107","BUENOS AIRES",307,296,8,2,0,10,0.964169381107492
"060910308","BUENOS AIRES",241,218,15,8,0,23,0.904564315352697
"060630201","BUENOS AIRES",446,277,33,86,3,122,0.621076233183857
"060630203","BUENOS AIRES",303,295,3,3,0,6,0.973597359735974
"060630708","BUENOS AIRES",406,336,48,19,0,67,0.827586206896552
"060630906","BUENOS AIRES",100,0,38,60,1,99,0
"060631302","BUENOS AIRES",336,335,1,0,0,1,0.99702380952381
"060700103","BUENOS AIRES",229,226,1,1,0,2,0.986899563318777
"060700107","BUENOS AIRES",292,289,1,2,0,3,0.98972602739726
"060700201","BUENOS AIRES",459,316,55,81,1,137,0.688453159041394
"060700206","BUENOS AIRES",387,227,42,110,2,154,0.58656330749354
"060700209","BUENOS AIRES",296,6,103,185,0,288,0.0202702702702703
"062701010","BUENOS AIRES",338,13,138,168,7,313,0.0384615384615385
"060770401","BUENOS AIRES",255,2,153,97,2,252,0.00784313725490196
"060911308","BUENOS AIRES",308,254,26,23,0,49,0.824675324675325
"060770102","BUENOS AIRES",272,89,70,90,9,169,0.327205882352941
"060770106","BUENOS AIRES",400,349,16,34,0,50,0.8725
"060770504","BUENOS AIRES",176,4,48,123,1,172,0.0227272727272727
"060770511","BUENOS AIRES",329,84,183,55,1,239,0.25531914893617
"060770514","BUENOS AIRES",97,96,0,0,0,0,0.989690721649485
"062740614","BUENOS AIRES",264,11,62,173,2,237,0.0416666666666667
"062740806","BUENOS AIRES",189,188,1,0,0,1,0.994708994708995
"060911006","BUENOS AIRES",462,399,7,22,1,30,0.863636363636364
"060840711","BUENOS AIRES",342,190,51,100,1,152,0.555555555555556
"060910209","BUENOS AIRES",424,374,21,20,1,42,0.882075471698113
"060840905","BUENOS AIRES",205,9,134,59,1,194,0.0439024390243902
"060910303","BUENOS AIRES",221,219,2,0,0,2,0.990950226244344
"060841202","BUENOS AIRES",140,37,36,63,3,102,0.264285714285714
"061050803","BUENOS AIRES",273,216,12,35,2,49,0.791208791208791
"060910101","BUENOS AIRES",420,11,49,343,2,394,0.0261904761904762
"060910507","BUENOS AIRES",299,200,33,54,0,87,0.668896321070234
"060910603","BUENOS AIRES",258,190,38,24,0,62,0.736434108527132
"060910609","BUENOS AIRES",405,4,84,295,1,380,0.00987654320987654
"060910709","BUENOS AIRES",317,181,36,86,0,122,0.570977917981073
"060910807","BUENOS AIRES",439,389,10,31,0,41,0.886104783599089
"060910810","BUENOS AIRES",376,337,18,16,0,34,0.896276595744681
"060911007","BUENOS AIRES",315,294,11,5,0,16,0.933333333333333
"060911008","BUENOS AIRES",278,261,2,13,0,15,0.938848920863309
"060911106","BUENOS AIRES",339,333,2,4,0,6,0.982300884955752
"060911201","BUENOS AIRES",370,342,9,9,0,18,0.924324324324324
"060911206","BUENOS AIRES",443,365,9,54,0,63,0.82392776523702
"060911207","BUENOS AIRES",278,207,16,50,0,66,0.744604316546763
"060911208","BUENOS AIRES",475,432,10,24,0,34,0.909473684210526
"020050406","CABA",504,478,0,0,0,0,0.948412698412698
"060911501","BUENOS AIRES",247,234,10,2,0,12,0.947368421052632
"060911707","BUENOS AIRES",379,206,42,112,0,154,0.54353562005277
"060911713","BUENOS AIRES",256,169,22,54,0,76,0.66015625
"060911714","BUENOS AIRES",452,215,40,172,1,213,0.475663716814159
"062800202","BUENOS AIRES",231,154,43,34,0,77,0.666666666666667
"060911812","BUENOS AIRES",415,9,150,245,1,396,0.0216867469879518
"060911909","BUENOS AIRES",226,214,8,4,0,12,0.946902654867257
"063572104","BUENOS AIRES",131,131,0,0,0,0,1
"060912005","BUENOS AIRES",418,4,80,301,18,399,0.00956937799043062
"060912006","BUENOS AIRES",226,225,1,0,0,1,0.995575221238938
"060912107","BUENOS AIRES",360,11,90,232,3,325,0.0305555555555556
"060912110","BUENOS AIRES",316,314,1,1,0,2,0.993670886075949
"060912113","BUENOS AIRES",303,6,104,180,0,284,0.0198019801980198
"061050801","BUENOS AIRES",138,87,13,37,0,50,0.630434782608696
"060912114","BUENOS AIRES",350,17,127,202,1,330,0.0485714285714286
"060912204","BUENOS AIRES",340,292,32,14,0,46,0.858823529411765
"060912306","BUENOS AIRES",388,13,188,182,0,370,0.0335051546391753
"060912307","BUENOS AIRES",223,3,159,57,0,216,0.0134529147982063
"061820202","BUENOS AIRES",326,312,8,5,0,13,0.957055214723926
"060912308","BUENOS AIRES",231,5,137,87,0,224,0.0216450216450216
"060912316","BUENOS AIRES",115,0,52,59,1,112,0
"060912412","BUENOS AIRES",179,8,38,125,0,163,0.0446927374301676
"060980107","BUENOS AIRES",235,187,29,19,0,48,0.795744680851064
"060980111","BUENOS AIRES",367,49,277,41,0,318,0.133514986376022
"060980206","BUENOS AIRES",304,231,60,13,0,73,0.759868421052632
"065151405","BUENOS AIRES",164,6,90,60,2,152,0.0365853658536585
"060980211","BUENOS AIRES",226,11,173,40,0,213,0.0486725663716814
"060980305","BUENOS AIRES",260,37,145,74,0,219,0.142307692307692
"065151406","BUENOS AIRES",304,0,179,117,0,296,0
"060980504","BUENOS AIRES",290,248,21,19,0,40,0.855172413793103
"060980505","BUENOS AIRES",328,209,14,95,2,111,0.63719512195122
"060980510","BUENOS AIRES",319,198,51,64,0,115,0.620689655172414
"060980702","BUENOS AIRES",596,410,129,41,1,171,0.687919463087248
"060980810","BUENOS AIRES",458,52,216,177,1,394,0.11353711790393
"061050101","BUENOS AIRES",390,370,0,3,0,3,0.948717948717949
"061050102","BUENOS AIRES",332,318,7,4,0,11,0.957831325301205
"061050109","BUENOS AIRES",250,245,4,1,0,5,0.98
"061050201","BUENOS AIRES",348,326,6,11,1,18,0.936781609195402
"061050203","BUENOS AIRES",325,316,2,6,0,8,0.972307692307692
"020050701","CABA",529,529,0,0,0,0,1
"061051401","BUENOS AIRES",424,142,74,199,2,275,0.334905660377358
"061051413","BUENOS AIRES",339,267,13,51,2,66,0.787610619469027
"061120101","BUENOS AIRES",231,99,51,80,0,131,0.428571428571429
"063010506","BUENOS AIRES",222,1,91,127,0,218,0.0045045045045045
"061120208","BUENOS AIRES",113,14,16,82,0,98,0.123893805309735
"061120709","BUENOS AIRES",164,1,51,111,1,163,0.00609756097560976
"061121410","BUENOS AIRES",279,276,2,1,0,3,0.989247311827957
"061190302","BUENOS AIRES",308,270,24,14,0,38,0.876623376623377
"061190901","BUENOS AIRES",67,0,41,25,0,66,0
"061260102","BUENOS AIRES",465,412,30,23,0,53,0.886021505376344
"061260205","BUENOS AIRES",374,361,9,4,0,13,0.96524064171123
"061260206","BUENOS AIRES",238,221,15,0,0,15,0.928571428571429
"061260210","BUENOS AIRES",335,138,56,135,0,191,0.411940298507463
"061260302","BUENOS AIRES",273,272,1,0,0,1,0.996336996336996
"061260304","BUENOS AIRES",167,166,1,0,0,1,0.994011976047904
"063360202","BUENOS AIRES",149,91,37,20,1,58,0.610738255033557
"061260404","BUENOS AIRES",432,13,56,326,14,396,0.0300925925925926
"061260504","BUENOS AIRES",320,222,23,67,1,91,0.69375
"061340913","BUENOS AIRES",270,1,168,101,0,269,0.0037037037037037
"061260608","BUENOS AIRES",99,6,74,16,0,90,0.0606060606060606
"061260701","BUENOS AIRES",357,14,39,301,0,340,0.0392156862745098
"061260703","BUENOS AIRES",454,4,151,283,11,445,0.00881057268722467
"061260805","BUENOS AIRES",319,276,22,20,0,42,0.865203761755486
"061260808","BUENOS AIRES",301,291,7,3,0,10,0.966777408637874
"061260809","BUENOS AIRES",246,245,0,0,0,0,0.995934959349594
"061260901","BUENOS AIRES",495,5,155,325,2,482,0.0101010101010101
"061260902","BUENOS AIRES",277,1,92,180,0,272,0.0036101083032491
"061260908","BUENOS AIRES",308,306,1,1,0,2,0.993506493506494
"061260909","BUENOS AIRES",420,51,43,315,1,359,0.121428571428571
"061340105","BUENOS AIRES",427,12,248,163,2,413,0.0281030444964871
"064270713","BUENOS AIRES",296,296,0,0,0,0,1
"061340303","BUENOS AIRES",257,232,10,15,0,25,0.90272373540856
"061340905","BUENOS AIRES",130,0,25,97,3,125,0
"061341005","BUENOS AIRES",299,31,127,125,3,255,0.103678929765886
"061470101","BUENOS AIRES",338,269,22,46,1,69,0.79585798816568
"061470303","BUENOS AIRES",3,0,0,3,0,3,0
"063573509","BUENOS AIRES",239,239,0,0,0,0,1
"061470702","BUENOS AIRES",4,0,0,4,0,4,0
"061540603","BUENOS AIRES",177,0,131,46,0,177,0
"061540606","BUENOS AIRES",60,0,35,25,0,60,0
"061540608","BUENOS AIRES",200,0,145,54,0,199,0
"061610104","BUENOS AIRES",129,69,17,43,0,60,0.534883720930233
"061610112","BUENOS AIRES",164,17,25,113,3,141,0.103658536585366
"061610116","BUENOS AIRES",200,76,37,86,0,123,0.38
"061680807","BUENOS AIRES",196,165,15,16,0,31,0.841836734693878
"061680907","BUENOS AIRES",183,172,4,7,0,11,0.939890710382514
"061750406","BUENOS AIRES",254,251,1,2,0,3,0.988188976377953
"061750611","BUENOS AIRES",275,252,4,18,0,22,0.916363636363636
"061750612","BUENOS AIRES",284,268,2,14,0,16,0.943661971830986
"061820305","BUENOS AIRES",68,59,9,0,0,9,0.867647058823529
"061820504","BUENOS AIRES",263,4,192,66,0,258,0.0152091254752852
"061820505","BUENOS AIRES",104,10,35,59,0,94,0.0961538461538462
"061821003","BUENOS AIRES",338,332,4,2,0,6,0.982248520710059
"061821104","BUENOS AIRES",238,237,0,1,0,1,0.995798319327731
"061821108","BUENOS AIRES",271,76,104,90,0,194,0.280442804428044
"063577910","BUENOS AIRES",228,3,85,131,1,217,0.0131578947368421
"061891005","BUENOS AIRES",258,229,21,6,0,27,0.887596899224806
"061960108","BUENOS AIRES",307,283,5,18,0,23,0.921824104234528
"061960109","BUENOS AIRES",121,61,20,35,0,55,0.504132231404959
"061960119","BUENOS AIRES",164,130,7,25,0,32,0.792682926829268
"061960209","BUENOS AIRES",321,292,13,15,0,28,0.909657320872274
"062940806","BUENOS AIRES",162,117,15,20,0,35,0.722222222222222
"061960212","BUENOS AIRES",137,99,10,27,0,37,0.722627737226277
"062030101","BUENOS AIRES",339,327,6,5,0,11,0.964601769911504
"062030106","BUENOS AIRES",280,253,16,11,0,27,0.903571428571429
"063640811","BUENOS AIRES",161,0,92,59,0,151,0
"062031602","BUENOS AIRES",292,4,104,179,3,286,0.0136986301369863
"062100101","BUENOS AIRES",197,174,7,13,1,21,0.883248730964467
"062100103","BUENOS AIRES",164,151,5,7,0,12,0.920731707317073
"062100119","BUENOS AIRES",298,276,5,15,0,20,0.926174496644295
"062100203","BUENOS AIRES",417,301,47,56,5,108,0.721822541966427
"062100804","BUENOS AIRES",389,345,12,27,1,40,0.886889460154242
"064411609","BUENOS AIRES",220,219,1,0,0,1,0.995454545454545
"062100902","BUENOS AIRES",241,202,23,16,0,39,0.838174273858921
"062101305","BUENOS AIRES",239,231,3,3,0,6,0.96652719665272
"062170104","BUENOS AIRES",331,247,40,42,1,83,0.746223564954683
"062380103","BUENOS AIRES",356,195,55,106,0,161,0.547752808988764
"062170302","BUENOS AIRES",49,0,23,25,0,48,0
"062170402","BUENOS AIRES",199,1,92,101,0,193,0.0050251256281407
"062170408","BUENOS AIRES",94,2,54,36,0,90,0.0212765957446809
"062170411","BUENOS AIRES",220,3,86,124,1,211,0.0136363636363636
"062240114","BUENOS AIRES",321,158,48,110,1,159,0.492211838006231
"062240211","BUENOS AIRES",261,259,2,0,0,2,0.992337164750958
"062171213","BUENOS AIRES",271,241,16,12,0,28,0.88929889298893
"062171204","BUENOS AIRES",215,204,5,6,0,11,0.948837209302326
"062240108","BUENOS AIRES",216,214,1,1,0,2,0.990740740740741
"062240203","BUENOS AIRES",152,28,10,113,0,123,0.184210526315789
"063570814","BUENOS AIRES",150,149,0,1,0,1,0.993333333333333
"062240205","BUENOS AIRES",267,180,30,56,0,86,0.674157303370786
"062240210","BUENOS AIRES",316,315,1,0,0,1,0.996835443037975
"062240213","BUENOS AIRES",105,0,9,85,8,102,0
"062240304","BUENOS AIRES",288,266,22,0,0,22,0.923611111111111
"062240310","BUENOS AIRES",266,176,35,52,0,87,0.661654135338346
"062240417","BUENOS AIRES",248,4,76,162,1,239,0.0161290322580645
"062241102","BUENOS AIRES",46,0,16,29,1,46,0
"062242201","BUENOS AIRES",233,231,0,2,0,2,0.991416309012876
"062242203","BUENOS AIRES",331,327,1,3,0,4,0.987915407854985
"062450306","BUENOS AIRES",405,276,79,39,1,119,0.681481481481481
"062520110","BUENOS AIRES",165,162,0,0,0,0,0.981818181818182
"062311202","BUENOS AIRES",297,243,11,41,0,52,0.818181818181818
"062311209","BUENOS AIRES",241,219,17,5,0,22,0.908713692946058
"062380113","BUENOS AIRES",163,6,56,100,1,157,0.0368098159509202
"062380201","BUENOS AIRES",245,121,42,78,0,120,0.493877551020408
"062380213","BUENOS AIRES",153,13,53,87,0,140,0.0849673202614379
"062450104","BUENOS AIRES",270,201,59,9,1,69,0.744444444444444
"062450105","BUENOS AIRES",351,272,47,29,1,77,0.774928774928775
"062450205","BUENOS AIRES",372,196,142,31,1,174,0.526881720430108
"062450213","BUENOS AIRES",270,25,154,82,2,238,0.0925925925925926
"062450305","BUENOS AIRES",423,159,87,143,17,247,0.375886524822695
"063572802","BUENOS AIRES",133,132,0,0,0,0,0.992481203007519
"062450501","BUENOS AIRES",302,21,185,90,6,281,0.0695364238410596
"062450416","BUENOS AIRES",121,3,97,21,0,118,0.0247933884297521
"062520212","BUENOS AIRES",188,4,119,64,1,184,0.0212765957446809
"065151505","BUENOS AIRES",390,0,192,168,3,363,0
"062520409","BUENOS AIRES",509,38,210,242,0,452,0.0746561886051081
"062520507","BUENOS AIRES",455,105,201,147,0,348,0.230769230769231
"062520607","BUENOS AIRES",37,0,23,13,0,36,0
"062520609","BUENOS AIRES",40,0,9,27,3,39,0
"062520810","BUENOS AIRES",157,155,0,0,0,0,0.987261146496815
"062520903","BUENOS AIRES",455,0,206,207,6,419,0
"062521002","BUENOS AIRES",42,0,38,4,0,42,0
"062521005","BUENOS AIRES",218,27,93,69,0,162,0.123853211009174
"062521010","BUENOS AIRES",311,76,201,31,0,232,0.244372990353698
"062521011","BUENOS AIRES",339,1,151,174,1,326,0.00294985250737463
"020151604","CABA",293,293,0,0,0,0,1
"062740918","BUENOS AIRES",287,8,88,174,4,266,0.0278745644599303
"063710910","BUENOS AIRES",378,374,4,0,0,4,0.989417989417989
"062521106","BUENOS AIRES",281,2,208,69,0,277,0.00711743772241993
"062521204","BUENOS AIRES",473,0,237,223,0,460,0
"062521401","BUENOS AIRES",340,124,70,141,3,214,0.364705882352941
"062521414","BUENOS AIRES",327,0,125,155,0,280,0
"062521415","BUENOS AIRES",266,1,100,155,0,255,0.0037593984962406
"062600113","BUENOS AIRES",278,1,83,170,10,263,0.00359712230215827
"062600107","BUENOS AIRES",368,8,176,156,1,333,0.0217391304347826
"063572805","BUENOS AIRES",201,201,0,0,0,0,1
"062600116","BUENOS AIRES",324,3,104,208,2,314,0.00925925925925926
"062600207","BUENOS AIRES",424,12,131,263,1,395,0.0283018867924528
"062600303","BUENOS AIRES",338,21,65,239,0,304,0.0621301775147929
"062600411","BUENOS AIRES",247,10,150,85,0,235,0.0404858299595142
"064271109","BUENOS AIRES",393,375,14,3,0,17,0.954198473282443
"062600514","BUENOS AIRES",386,2,192,148,1,341,0.00518134715025907
"062600611","BUENOS AIRES",239,102,126,10,0,136,0.426778242677824
"062600803","BUENOS AIRES",317,0,102,206,2,310,0
"062600812","BUENOS AIRES",402,347,33,20,0,53,0.86318407960199
"062600814","BUENOS AIRES",295,2,160,125,1,286,0.00677966101694915
"062600907","BUENOS AIRES",420,0,263,151,0,414,0
"062601007","BUENOS AIRES",376,245,45,77,2,124,0.651595744680851
"062601013","BUENOS AIRES",412,1,184,210,1,395,0.00242718446601942
"062601102","BUENOS AIRES",195,195,0,0,0,0,1
"062601107","BUENOS AIRES",419,1,358,58,0,416,0.00238663484486874
"062601109","BUENOS AIRES",353,3,322,28,0,350,0.0084985835694051
"062601209","BUENOS AIRES",274,20,198,54,2,254,0.072992700729927
"062601409","BUENOS AIRES",380,6,269,102,0,371,0.0157894736842105
"064200408","BUENOS AIRES",57,55,2,0,0,2,0.964912280701754
"062601410","BUENOS AIRES",401,6,231,160,0,391,0.0149625935162095
"063712807","BUENOS AIRES",83,82,1,0,0,1,0.987951807228916
"062700608","BUENOS AIRES",424,6,231,168,3,402,0.0141509433962264
"062601511","BUENOS AIRES",448,2,215,222,1,438,0.00446428571428571
"064200510","BUENOS AIRES",98,82,12,3,0,15,0.836734693877551
"062601606","BUENOS AIRES",386,6,194,175,1,370,0.0155440414507772
"062601609","BUENOS AIRES",336,0,131,187,8,326,0
"062601613","BUENOS AIRES",318,3,162,139,2,303,0.00943396226415094
"065681110","BUENOS AIRES",226,226,0,0,0,0,1
"062601706","BUENOS AIRES",457,280,87,80,2,169,0.612691466083151
"062601711","BUENOS AIRES",85,83,1,1,0,2,0.976470588235294
"062660101","BUENOS AIRES",8,0,4,4,0,8,0
"062660303","BUENOS AIRES",274,243,6,13,1,20,0.886861313868613
"062660503","BUENOS AIRES",139,0,101,36,0,137,0
"062700217","BUENOS AIRES",388,1,280,90,1,371,0.00257731958762887
"062740919","BUENOS AIRES",355,1,89,242,4,335,0.0028169014084507
"062660605","BUENOS AIRES",105,0,84,20,0,104,0
"062660608","BUENOS AIRES",102,2,84,16,0,100,0.0196078431372549
"062660702","BUENOS AIRES",283,157,78,45,1,124,0.554770318021201
"062700210","BUENOS AIRES",405,3,280,114,1,395,0.00740740740740741
"062700211","BUENOS AIRES",439,2,273,145,6,424,0.00455580865603645
"062700306","BUENOS AIRES",375,277,50,44,0,94,0.738666666666667
"062700307","BUENOS AIRES",287,203,38,17,0,55,0.707317073170732
"062700313","BUENOS AIRES",258,222,33,2,0,35,0.86046511627907
"062740910","BUENOS AIRES",341,257,50,30,0,80,0.75366568914956
"062700403","BUENOS AIRES",372,340,23,7,0,30,0.913978494623656
"062700404","BUENOS AIRES",401,202,119,76,1,196,0.503740648379052
"062700410","BUENOS AIRES",364,172,131,52,1,184,0.472527472527473
"062700511","BUENOS AIRES",222,1,159,55,0,214,0.0045045045045045
"062700610","BUENOS AIRES",559,4,175,335,13,523,0.00715563506261181
"062700702","BUENOS AIRES",218,0,125,84,2,211,0
"062700803","BUENOS AIRES",75,6,57,12,0,69,0.08
"062700808","BUENOS AIRES",380,2,240,131,5,376,0.00526315789473684
"062700809","BUENOS AIRES",263,0,98,148,6,252,0
"062700911","BUENOS AIRES",251,9,185,52,0,237,0.0358565737051793
"062700907","BUENOS AIRES",246,6,176,63,0,239,0.024390243902439
"062740106","BUENOS AIRES",282,271,3,4,0,7,0.960992907801418
"062740201","BUENOS AIRES",413,405,5,2,0,7,0.980629539951574
"062740204","BUENOS AIRES",288,273,8,4,0,12,0.947916666666667
"062741602","BUENOS AIRES",396,5,47,326,0,373,0.0126262626262626
"062740308","BUENOS AIRES",301,7,138,150,0,288,0.0232558139534884
"062740316","BUENOS AIRES",307,5,123,170,1,294,0.0162866449511401
"062740404","BUENOS AIRES",368,9,154,183,2,339,0.0244565217391304
"062740416","BUENOS AIRES",298,12,73,195,3,271,0.0402684563758389
"062740417","BUENOS AIRES",303,11,56,216,6,278,0.0363036303630363
"062740504","BUENOS AIRES",347,10,114,212,0,326,0.0288184438040346
"063573004","BUENOS AIRES",182,181,0,0,0,0,0.994505494505495
"062740514","BUENOS AIRES",374,19,172,169,1,342,0.0508021390374332
"063573005","BUENOS AIRES",159,159,0,0,0,0,1
"062740611","BUENOS AIRES",262,0,94,162,2,258,0
"062740701","BUENOS AIRES",189,2,102,82,1,185,0.0105820105820106
"062740704","BUENOS AIRES",287,4,40,232,3,275,0.0139372822299652
"062740803","BUENOS AIRES",262,222,30,10,0,40,0.847328244274809
"065151604","BUENOS AIRES",210,1,125,80,0,205,0.00476190476190476
"062740819","BUENOS AIRES",325,3,129,173,5,307,0.00923076923076923
"062740902","BUENOS AIRES",312,0,79,209,4,292,0
"062740916","BUENOS AIRES",245,0,106,126,4,236,0
"063574902","BUENOS AIRES",311,305,4,1,0,5,0.980707395498392
"062741007","BUENOS AIRES",366,4,86,231,1,318,0.0109289617486339
"063573007","BUENOS AIRES",130,130,0,0,0,0,1
"062741202","BUENOS AIRES",245,214,9,2,0,11,0.873469387755102
"062741217","BUENOS AIRES",342,307,8,11,0,19,0.89766081871345
"062741315","BUENOS AIRES",239,231,1,0,0,1,0.96652719665272
"062741316","BUENOS AIRES",271,269,1,1,0,2,0.992619926199262
"063573009","BUENOS AIRES",213,213,0,0,0,0,1
"062741409","BUENOS AIRES",370,367,2,1,0,3,0.991891891891892
"062741410","BUENOS AIRES",293,291,0,2,0,2,0.993174061433447
"062741509","BUENOS AIRES",266,10,127,123,0,250,0.037593984962406
"062741510","BUENOS AIRES",428,25,140,240,0,380,0.058411214953271
"062741511","BUENOS AIRES",245,7,70,161,0,231,0.0285714285714286
"062741512","BUENOS AIRES",248,41,65,134,0,199,0.165322580645161
"062741604","BUENOS AIRES",469,120,110,195,2,307,0.255863539445629
"062741607","BUENOS AIRES",274,3,105,134,0,239,0.0109489051094891
"062741611","BUENOS AIRES",233,3,110,110,0,220,0.0128755364806867
"062741801","BUENOS AIRES",470,6,238,196,0,434,0.0127659574468085
"062741913","BUENOS AIRES",282,1,40,222,6,268,0.00354609929078014
"062742004","BUENOS AIRES",618,14,213,355,3,571,0.0226537216828479
"062742010","BUENOS AIRES",297,4,115,168,4,287,0.0134680134680135
"062742102","BUENOS AIRES",232,189,16,22,0,38,0.814655172413793
"062742104","BUENOS AIRES",363,7,117,230,1,348,0.0192837465564738
"062742106","BUENOS AIRES",412,388,11,3,0,14,0.941747572815534
"062742108","BUENOS AIRES",401,368,16,8,0,24,0.917705735660848
"062742115","BUENOS AIRES",432,12,159,248,3,410,0.0277777777777778
"062870412","BUENOS AIRES",190,149,20,20,0,40,0.784210526315789
"062770102","BUENOS AIRES",120,0,79,37,0,116,0
"062770108","BUENOS AIRES",228,135,52,39,2,93,0.592105263157895
"062770113","BUENOS AIRES",259,202,42,15,0,57,0.77992277992278
"064411711","BUENOS AIRES",205,203,2,0,0,2,0.990243902439024
"062770115","BUENOS AIRES",303,190,47,57,8,112,0.627062706270627
"062800107","BUENOS AIRES",254,34,119,100,0,219,0.133858267716535
"062800108","BUENOS AIRES",162,44,40,75,0,115,0.271604938271605
"062800201","BUENOS AIRES",302,203,35,63,0,98,0.672185430463576
"064276305","BUENOS AIRES",283,11,192,67,1,260,0.03886925795053
"062800614","BUENOS AIRES",33,0,23,10,0,33,0
"062800406","BUENOS AIRES",103,101,2,0,0,2,0.980582524271845
"062870414","BUENOS AIRES",223,167,22,31,1,54,0.748878923766816
"062940211","BUENOS AIRES",96,2,39,50,4,93,0.0208333333333333
"062940403","BUENOS AIRES",389,125,138,121,2,261,0.32133676092545
"062800606","BUENOS AIRES",195,10,150,35,0,185,0.0512820512820513
"063571103","BUENOS AIRES",252,3,161,87,0,248,0.0119047619047619
"062800607","BUENOS AIRES",68,2,53,13,0,66,0.0294117647058824
"064277005","BUENOS AIRES",397,11,239,130,0,369,0.0277078085642317
"062801102","BUENOS AIRES",299,253,24,18,0,42,0.846153846153846
"062801104","BUENOS AIRES",142,138,1,2,0,3,0.971830985915493
"062801108","BUENOS AIRES",170,150,7,13,0,20,0.882352941176471
"062801207","BUENOS AIRES",392,245,79,53,1,133,0.625
"062870406","BUENOS AIRES",199,149,36,14,0,50,0.748743718592965
"062870409","BUENOS AIRES",124,10,35,79,0,114,0.0806451612903226
"063010504","BUENOS AIRES",219,1,123,92,3,218,0.0045662100456621
"063573105","BUENOS AIRES",208,208,0,0,0,0,1
"063571108","BUENOS AIRES",210,94,43,71,0,114,0.447619047619048
"063575011","BUENOS AIRES",155,150,2,3,0,5,0.967741935483871
"063010813","BUENOS AIRES",234,4,130,100,0,230,0.0170940170940171
"065151607","BUENOS AIRES",393,1,309,76,1,386,0.00254452926208651
"063150104","BUENOS AIRES",315,272,29,14,0,43,0.863492063492064
"063150115","BUENOS AIRES",261,96,83,80,0,163,0.367816091954023
"063220615","BUENOS AIRES",146,2,89,55,0,144,0.0136986301369863
"063573109","BUENOS AIRES",258,256,0,0,0,0,0.992248062015504
"063221001","BUENOS AIRES",112,1,63,46,2,111,0.00892857142857143
"063360205","BUENOS AIRES",126,80,20,25,0,45,0.634920634920635
"063576001","BUENOS AIRES",321,317,3,1,0,4,0.987538940809969
"063570108","BUENOS AIRES",341,338,3,0,0,3,0.991202346041056
"063570109","BUENOS AIRES",255,228,17,9,0,26,0.894117647058824
"063570305","BUENOS AIRES",227,183,15,11,0,26,0.806167400881057
"063570310","BUENOS AIRES",290,286,2,2,0,4,0.986206896551724
"063570402","BUENOS AIRES",171,169,1,0,0,1,0.988304093567251
"063570405","BUENOS AIRES",154,153,1,0,0,1,0.993506493506494
"063570505","BUENOS AIRES",191,191,0,0,0,0,1
"063570506","BUENOS AIRES",237,234,3,0,0,3,0.987341772151899
"063570508","BUENOS AIRES",196,196,0,0,0,0,1
"063570801","BUENOS AIRES",370,286,26,51,0,77,0.772972972972973
"063570807","BUENOS AIRES",320,309,5,2,0,7,0.965625
"063570813","BUENOS AIRES",213,210,2,1,0,3,0.985915492957746
"063570901","BUENOS AIRES",426,160,172,90,2,264,0.375586854460094
"063571006","BUENOS AIRES",394,207,126,61,0,187,0.525380710659898
"063574608","BUENOS AIRES",202,200,2,0,0,2,0.99009900990099
"063571215","BUENOS AIRES",380,359,16,3,0,19,0.944736842105263
"063571302","BUENOS AIRES",309,292,11,6,0,17,0.944983818770227
"063571401","BUENOS AIRES",375,371,2,2,0,4,0.989333333333333
"063571405","BUENOS AIRES",219,215,3,0,1,4,0.981735159817352
"063571501","BUENOS AIRES",351,350,0,1,0,1,0.997150997150997
"063571504","BUENOS AIRES",352,349,2,0,0,2,0.991477272727273
"063572002","BUENOS AIRES",329,329,0,0,0,0,1
"063572003","BUENOS AIRES",174,173,1,0,0,1,0.994252873563218
"063573205","BUENOS AIRES",139,139,0,0,0,0,1
"063573302","BUENOS AIRES",338,337,1,0,0,1,0.997041420118343
"063573303","BUENOS AIRES",305,304,1,0,0,1,0.99672131147541
"063573309","BUENOS AIRES",180,180,0,0,0,0,1
"063573403","BUENOS AIRES",151,151,0,0,0,0,1
"063576107","BUENOS AIRES",160,150,0,5,0,5,0.9375
"063574101","BUENOS AIRES",299,297,2,0,0,2,0.993311036789298
"063574107","BUENOS AIRES",115,115,0,0,0,0,1
"063574204","BUENOS AIRES",68,68,0,0,0,0,1
"063574308","BUENOS AIRES",47,46,1,0,0,1,0.978723404255319
"064412504","BUENOS AIRES",187,187,0,0,0,0,1
"063574601","BUENOS AIRES",178,178,0,0,0,0,1
"063575102","BUENOS AIRES",284,283,0,0,0,0,0.996478873239437
"064413105","BUENOS AIRES",205,203,0,0,0,0,0.990243902439024
"063575312","BUENOS AIRES",366,315,15,30,0,45,0.860655737704918
"063575402","BUENOS AIRES",325,318,4,2,0,6,0.978461538461538
"063575508","BUENOS AIRES",438,438,0,0,0,0,1
"063575602","BUENOS AIRES",352,350,2,0,0,2,0.994318181818182
"063575609","BUENOS AIRES",286,281,1,2,0,3,0.982517482517482
"063575709","BUENOS AIRES",376,366,2,8,0,10,0.973404255319149
"063575710","BUENOS AIRES",237,233,4,0,0,4,0.983122362869198
"063575804","BUENOS AIRES",298,296,1,1,0,2,0.993288590604027
"063575806","BUENOS AIRES",355,351,2,2,0,4,0.988732394366197
"063576207","BUENOS AIRES",229,202,7,17,2,26,0.882096069868996
"063576209","BUENOS AIRES",261,257,4,0,0,4,0.984674329501916
"063576309","BUENOS AIRES",55,54,1,0,0,1,0.981818181818182
"064276906","BUENOS AIRES",312,6,206,94,1,301,0.0192307692307692
"063576407","BUENOS AIRES",170,164,5,1,0,6,0.964705882352941
"063576410","BUENOS AIRES",66,63,2,1,0,3,0.954545454545455
"063576509","BUENOS AIRES",262,259,3,0,0,3,0.988549618320611
"063576604","BUENOS AIRES",352,336,4,10,0,14,0.954545454545455
"063576709","BUENOS AIRES",291,266,11,12,0,23,0.914089347079038
"063576714","BUENOS AIRES",206,188,6,8,0,14,0.912621359223301
"063576803","BUENOS AIRES",251,234,1,7,1,9,0.932270916334661
"063576804","BUENOS AIRES",200,195,4,1,0,5,0.975
"063576807","BUENOS AIRES",275,262,3,7,1,11,0.952727272727273
"063576903","BUENOS AIRES",194,182,5,2,0,7,0.938144329896907
"064414604","BUENOS AIRES",293,272,16,5,0,21,0.928327645051195
"063576908","BUENOS AIRES",289,251,23,10,0,33,0.868512110726644
"063576910","BUENOS AIRES",326,291,9,21,0,30,0.892638036809816
"063577010","BUENOS AIRES",241,217,13,4,0,17,0.900414937759336
"063577104","BUENOS AIRES",408,404,2,1,0,3,0.990196078431373
"063577106","BUENOS AIRES",394,372,5,13,0,18,0.944162436548223
"063577302","BUENOS AIRES",369,0,155,188,4,347,0
"063577506","BUENOS AIRES",128,18,93,17,0,110,0.140625
"064411502","BUENOS AIRES",283,282,1,0,0,1,0.996466431095406
"063577512","BUENOS AIRES",162,5,117,40,0,157,0.0308641975308642
"063577515","BUENOS AIRES",74,0,51,23,0,74,0
"063577602","BUENOS AIRES",153,1,96,50,0,146,0.0065359477124183
"063577609","BUENOS AIRES",138,0,96,40,1,137,0
"063577709","BUENOS AIRES",130,2,98,29,1,128,0.0153846153846154
"063577711","BUENOS AIRES",61,0,39,22,0,61,0
"063640106","BUENOS AIRES",275,104,103,64,0,167,0.378181818181818
"064416110","BUENOS AIRES",220,1,178,36,0,214,0.00454545454545455
"063710912","BUENOS AIRES",233,225,5,3,0,8,0.965665236051502
"063577901","BUENOS AIRES",2,0,1,1,0,2,0
"063577902","BUENOS AIRES",284,274,7,3,0,10,0.964788732394366
"064416412","BUENOS AIRES",122,2,90,28,0,118,0.0163934426229508
"063578008","BUENOS AIRES",180,0,108,72,0,180,0
"063578018","BUENOS AIRES",102,1,70,30,0,100,0.00980392156862745
"063578107","BUENOS AIRES",124,0,74,46,1,121,0
"063710915","BUENOS AIRES",201,190,4,4,0,8,0.945273631840796
"063578109","BUENOS AIRES",162,7,103,51,0,154,0.0432098765432099
"063578114","BUENOS AIRES",340,0,185,148,1,334,0
"063578207","BUENOS AIRES",78,8,55,15,0,70,0.102564102564103
"063710505","BUENOS AIRES",263,260,1,2,0,3,0.988593155893536
"063640104","BUENOS AIRES",262,91,86,74,1,161,0.347328244274809
"063640117","BUENOS AIRES",191,189,2,0,0,2,0.989528795811518
"063640119","BUENOS AIRES",379,342,21,16,0,37,0.902374670184697
"063640203","BUENOS AIRES",362,108,115,134,1,250,0.298342541436464
"063640207","BUENOS AIRES",335,4,71,253,4,328,0.0119402985074627
"063710507","BUENOS AIRES",265,258,4,3,0,7,0.973584905660377
"063640310","BUENOS AIRES",161,1,71,81,1,153,0.0062111801242236
"063711001","BUENOS AIRES",302,300,0,1,0,1,0.993377483443709
"063640315","BUENOS AIRES",167,167,0,0,0,0,1
"063640410","BUENOS AIRES",256,2,118,121,2,241,0.0078125
"063640710","BUENOS AIRES",186,156,3,1,0,4,0.838709677419355
"063640703","BUENOS AIRES",234,8,124,86,0,210,0.0341880341880342
"063640807","BUENOS AIRES",259,0,133,113,1,247,0
"063711509","BUENOS AIRES",198,4,93,93,2,188,0.0202020202020202
"063640820","BUENOS AIRES",195,0,67,128,0,195,0
"063710212","BUENOS AIRES",268,8,166,89,1,256,0.0298507462686567
"063710102","BUENOS AIRES",288,9,147,129,0,276,0.03125
"063710313","BUENOS AIRES",204,66,110,27,0,137,0.323529411764706
"063710405","BUENOS AIRES",356,326,25,5,0,30,0.915730337078652
"063710605","BUENOS AIRES",250,246,4,0,0,4,0.984
"063710610","BUENOS AIRES",434,181,39,204,0,243,0.41705069124424
"063710708","BUENOS AIRES",226,72,62,90,0,152,0.31858407079646
"063710809","BUENOS AIRES",365,359,5,1,0,6,0.983561643835616
"063711406","BUENOS AIRES",385,4,31,317,3,351,0.0103896103896104
"063711414","BUENOS AIRES",300,19,48,140,62,250,0.0633333333333333
"063711701","BUENOS AIRES",362,209,119,32,0,151,0.577348066298343
"063711706","BUENOS AIRES",333,14,168,151,0,319,0.042042042042042
"063711709","BUENOS AIRES",309,120,125,33,0,158,0.388349514563107
"063711810","BUENOS AIRES",236,7,119,110,0,229,0.0296610169491525
"063711901","BUENOS AIRES",210,208,1,1,0,2,0.990476190476191
"063712001","BUENOS AIRES",372,159,139,74,0,213,0.42741935483871
"063712002","BUENOS AIRES",373,35,154,181,1,336,0.0938337801608579
"063712111","BUENOS AIRES",404,389,10,3,0,13,0.962871287128713
"063712214","BUENOS AIRES",241,238,3,0,0,3,0.987551867219917
"063712311","BUENOS AIRES",253,247,0,6,0,6,0.976284584980237
"063712312","BUENOS AIRES",233,227,1,5,0,6,0.974248927038627
"063712313","BUENOS AIRES",249,240,6,3,0,9,0.963855421686747
"063712506","BUENOS AIRES",299,295,3,1,0,4,0.986622073578595
"063712508","BUENOS AIRES",292,291,0,0,0,0,0.996575342465753
"063712605","BUENOS AIRES",223,205,18,0,0,18,0.919282511210762
"063712805","BUENOS AIRES",67,66,0,1,0,1,0.985074626865672
"063713004","BUENOS AIRES",251,4,234,12,0,246,0.0159362549800797
"063713205","BUENOS AIRES",321,13,166,138,1,305,0.0404984423676012
"063713207","BUENOS AIRES",291,3,151,135,0,286,0.0103092783505155
"063713208","BUENOS AIRES",456,19,116,260,0,376,0.0416666666666667
"063713211","BUENOS AIRES",412,15,223,164,0,387,0.0364077669902913
"063713303","BUENOS AIRES",415,105,174,112,23,309,0.253012048192771
"063713304","BUENOS AIRES",307,8,137,161,0,298,0.0260586319218241
"063713404","BUENOS AIRES",242,10,154,77,0,231,0.0413223140495868
"063713510","BUENOS AIRES",290,82,64,142,1,207,0.282758620689655
"063713601","BUENOS AIRES",603,9,142,441,1,584,0.0149253731343284
"063713607","BUENOS AIRES",401,10,209,142,1,352,0.0249376558603491
"063713611","BUENOS AIRES",415,15,303,93,0,396,0.036144578313253
"063713702","BUENOS AIRES",363,8,59,273,7,339,0.0220385674931129
"063850107","BUENOS AIRES",225,0,93,130,1,224,0
"063850701","BUENOS AIRES",319,181,73,62,0,135,0.567398119122257
"063850706","BUENOS AIRES",207,159,27,20,0,47,0.768115942028985
"063850710","BUENOS AIRES",265,60,92,106,3,201,0.226415094339623
"063920105","BUENOS AIRES",358,353,4,1,0,5,0.986033519553073
"063920108","BUENOS AIRES",320,278,17,22,0,39,0.86875
"063920601","BUENOS AIRES",96,0,25,69,0,94,0
"063920806","BUENOS AIRES",375,0,289,84,0,373,0
"063920901","BUENOS AIRES",310,1,176,132,0,308,0.0032258064516129
"063990106","BUENOS AIRES",291,229,20,39,3,62,0.786941580756014
"063921506","BUENOS AIRES",147,0,79,61,2,142,0
"064080310","BUENOS AIRES",221,3,188,30,0,218,0.0135746606334842
"064060215","BUENOS AIRES",298,195,72,31,0,103,0.654362416107383
"064080204","BUENOS AIRES",388,17,288,79,1,368,0.0438144329896907
"064080208","BUENOS AIRES",488,3,302,167,5,474,0.00614754098360656
"064080302","BUENOS AIRES",100,1,56,40,1,97,0.01
"064080305","BUENOS AIRES",294,42,183,67,0,250,0.142857142857143
"064904305","BUENOS AIRES",2,1,1,0,0,1,0.5
"064080504","BUENOS AIRES",313,0,231,69,0,300,0
"064080508","BUENOS AIRES",281,0,209,69,1,279,0
"064080606","BUENOS AIRES",103,2,84,17,0,101,0.0194174757281553
"064080705","BUENOS AIRES",351,261,72,18,0,90,0.743589743589744
"064080807","BUENOS AIRES",267,2,194,44,0,238,0.00749063670411985
"064081001","BUENOS AIRES",325,0,302,22,0,324,0
"064081005","BUENOS AIRES",442,0,336,104,0,440,0
"064081108","BUENOS AIRES",334,1,260,67,1,328,0.0029940119760479
"064100209","BUENOS AIRES",344,1,309,34,0,343,0.00290697674418605
"064100302","BUENOS AIRES",347,0,276,65,4,345,0
"068400407","BUENOS AIRES",327,12,87,224,0,311,0.036697247706422
"064081201","BUENOS AIRES",675,148,346,155,4,505,0.219259259259259
"064081207","BUENOS AIRES",370,2,286,75,0,361,0.00540540540540541
"064081310","BUENOS AIRES",375,45,231,88,1,320,0.12
"064081502","BUENOS AIRES",442,68,238,133,0,371,0.153846153846154
"064081511","BUENOS AIRES",270,258,11,0,0,11,0.955555555555556
"064100109","BUENOS AIRES",265,3,200,57,0,257,0.0113207547169811
"064100112","BUENOS AIRES",349,2,248,93,0,341,0.00573065902578797
"064100509","BUENOS AIRES",385,4,280,93,2,375,0.0103896103896104
"064100606","BUENOS AIRES",306,0,270,36,0,306,0
"064100611","BUENOS AIRES",223,2,140,78,0,218,0.00896860986547085
"064100612","BUENOS AIRES",438,0,353,82,0,435,0
"064100615","BUENOS AIRES",334,1,308,13,0,321,0.0029940119760479
"064100703","BUENOS AIRES",313,1,283,29,0,312,0.00319488817891374
"064100706","BUENOS AIRES",295,0,286,8,0,294,0
"064100711","BUENOS AIRES",301,0,265,34,0,299,0
"064100715","BUENOS AIRES",252,6,166,76,0,242,0.0238095238095238
"064100805","BUENOS AIRES",289,0,194,92,0,286,0
"064100808","BUENOS AIRES",316,152,123,40,0,163,0.481012658227848
"064101004","BUENOS AIRES",412,2,377,31,0,408,0.00485436893203883
"064101108","BUENOS AIRES",299,134,159,6,0,165,0.448160535117057
"064120803","BUENOS AIRES",220,1,170,49,0,219,0.00454545454545455
"064101111","BUENOS AIRES",328,8,299,21,0,320,0.024390243902439
"064101304","BUENOS AIRES",223,0,179,44,0,223,0
"064120312","BUENOS AIRES",159,1,137,21,0,158,0.00628930817610063
"064120401","BUENOS AIRES",407,10,274,120,0,394,0.0245700245700246
"064120402","BUENOS AIRES",377,4,278,92,0,370,0.0106100795755968
"064120406","BUENOS AIRES",286,5,174,98,0,272,0.0174825174825175
"064120408","BUENOS AIRES",205,0,166,35,0,201,0
"064120412","BUENOS AIRES",506,2,369,131,1,501,0.00395256916996047
"064120503","BUENOS AIRES",375,9,257,84,0,341,0.024
"064120513","BUENOS AIRES",403,1,342,52,3,397,0.00248138957816377
"064120708","BUENOS AIRES",294,0,243,49,0,292,0
"064120709","BUENOS AIRES",215,2,179,33,0,212,0.00930232558139535
"064120717","BUENOS AIRES",290,3,200,74,0,274,0.0103448275862069
"064120804","BUENOS AIRES",232,3,172,54,0,226,0.0129310344827586
"064120906","BUENOS AIRES",86,1,61,23,0,84,0.0116279069767442
"064121003","BUENOS AIRES",418,1,193,210,3,406,0.00239234449760766
"064121004","BUENOS AIRES",448,1,194,228,7,429,0.00223214285714286
"064121005","BUENOS AIRES",371,0,151,196,2,349,0
"064900804","BUENOS AIRES",175,174,0,1,0,1,0.994285714285714
"064121008","BUENOS AIRES",376,2,198,165,1,364,0.00531914893617021
"064121009","BUENOS AIRES",280,145,39,85,0,124,0.517857142857143
"064121012","BUENOS AIRES",236,0,107,111,1,219,0
"064121014","BUENOS AIRES",397,0,179,195,3,377,0
"064121106","BUENOS AIRES",337,4,195,124,2,321,0.0118694362017804
"064121107","BUENOS AIRES",269,1,134,120,1,255,0.00371747211895911
"064121109","BUENOS AIRES",255,3,146,93,1,240,0.0117647058823529
"064201301","BUENOS AIRES",24,21,3,0,0,3,0.875
"064121118","BUENOS AIRES",332,1,165,154,0,319,0.00301204819277108
"064121202","BUENOS AIRES",343,3,164,160,0,324,0.0087463556851312
"064121301","BUENOS AIRES",348,0,242,100,0,342,0
"064121303","BUENOS AIRES",206,0,139,63,1,203,0
"064121406","BUENOS AIRES",411,255,106,45,0,151,0.62043795620438
"064201103","BUENOS AIRES",43,36,6,1,0,7,0.837209302325581
"064121503","BUENOS AIRES",505,2,364,134,1,499,0.00396039603960396
"064121504","BUENOS AIRES",371,0,265,101,2,368,0
"064121510","BUENOS AIRES",298,0,213,75,2,290,0
"064130106","BUENOS AIRES",380,348,3,1,0,4,0.91578947368421
"064130206","BUENOS AIRES",294,218,25,45,0,70,0.741496598639456
"064130301","BUENOS AIRES",139,127,1,3,0,4,0.913669064748201
"064130304","BUENOS AIRES",215,215,0,0,0,0,1
"064130401","BUENOS AIRES",265,261,3,1,0,4,0.984905660377358
"064130402","BUENOS AIRES",225,225,0,0,0,0,1
"064130413","BUENOS AIRES",380,368,2,5,1,8,0.968421052631579
"064130501","BUENOS AIRES",400,396,0,3,0,3,0.99
"064130506","BUENOS AIRES",266,266,0,0,0,0,1
"064130703","BUENOS AIRES",37,37,0,0,0,0,1
"064131106","BUENOS AIRES",40,13,25,2,0,27,0.325
"065390909","BUENOS AIRES",92,1,53,32,1,86,0.0108695652173913
"064131302","BUENOS AIRES",332,254,22,50,0,72,0.765060240963855
"064131601","BUENOS AIRES",8,0,6,1,0,7,0
"064132102","BUENOS AIRES",305,289,4,10,0,14,0.947540983606557
"064132104","BUENOS AIRES",452,443,5,4,0,9,0.980088495575221
"064132204","BUENOS AIRES",50,7,19,23,0,42,0.14
"064132212","BUENOS AIRES",97,94,1,2,0,3,0.969072164948454
"064550105","BUENOS AIRES",258,230,18,9,0,27,0.891472868217054
"064200105","BUENOS AIRES",93,81,11,0,0,11,0.870967741935484
"064200114","BUENOS AIRES",68,68,0,0,0,0,1
"064200208","BUENOS AIRES",88,87,1,0,0,1,0.988636363636364
"064200209","BUENOS AIRES",67,66,1,0,0,1,0.985074626865672
"064200210","BUENOS AIRES",59,58,1,0,0,1,0.983050847457627
"065180812","BUENOS AIRES",66,0,63,2,0,65,0
"064200306","BUENOS AIRES",86,84,1,0,0,1,0.976744186046512
"064270907","BUENOS AIRES",379,326,9,19,0,28,0.860158311345646
"064200308","BUENOS AIRES",141,26,77,38,0,115,0.184397163120567
"064200312","BUENOS AIRES",92,3,67,22,0,89,0.0326086956521739
"064200404","BUENOS AIRES",100,9,46,42,0,88,0.09
"065250405","BUENOS AIRES",422,16,173,225,2,400,0.037914691943128
"065250406","BUENOS AIRES",488,12,167,301,0,468,0.0245901639344262
"064200414","BUENOS AIRES",77,67,5,5,0,10,0.87012987012987
"020050803","CABA",504,504,0,0,0,0,1
"064200417","BUENOS AIRES",38,35,3,0,0,3,0.921052631578947
"064200504","BUENOS AIRES",161,151,4,0,3,7,0.937888198757764
"065250601","BUENOS AIRES",129,1,50,74,2,126,0.00775193798449612
"064200604","BUENOS AIRES",57,56,0,1,0,1,0.982456140350877
"064200606","BUENOS AIRES",15,15,0,0,0,0,1
"064200612","BUENOS AIRES",29,28,0,0,0,0,0.96551724137931
"064200809","BUENOS AIRES",54,52,1,0,0,1,0.962962962962963
"064200901","BUENOS AIRES",332,85,107,129,2,238,0.256024096385542
"064201011","BUENOS AIRES",120,78,26,16,0,42,0.65
"064201102","BUENOS AIRES",47,40,6,0,0,6,0.851063829787234
"064201110","BUENOS AIRES",121,65,34,20,0,54,0.537190082644628
"064201201","BUENOS AIRES",117,1,75,39,0,114,0.00854700854700855
"064201208","BUENOS AIRES",90,2,64,24,0,88,0.0222222222222222
"064201211","BUENOS AIRES",61,0,50,9,0,59,0
"064201311","BUENOS AIRES",74,42,20,12,0,32,0.567567567567568
"064201401","BUENOS AIRES",57,44,8,4,0,12,0.771929824561403
"064201404","BUENOS AIRES",168,128,18,18,1,37,0.761904761904762
"064201605","BUENOS AIRES",14,13,0,0,0,0,0.928571428571429
"064201606","BUENOS AIRES",18,17,0,0,0,0,0.944444444444444
"064202011","BUENOS AIRES",46,46,0,0,0,0,1
"064201803","BUENOS AIRES",33,32,0,1,0,1,0.96969696969697
"064202013","BUENOS AIRES",86,80,5,1,0,6,0.930232558139535
"064202101","BUENOS AIRES",80,79,0,1,0,1,0.9875
"064202105","BUENOS AIRES",140,122,9,8,1,18,0.871428571428571
"064202106","BUENOS AIRES",241,232,5,3,0,8,0.962655601659751
"064272404","BUENOS AIRES",242,96,75,52,6,133,0.396694214876033
"064202201","BUENOS AIRES",168,10,55,96,4,155,0.0595238095238095
"064202203","BUENOS AIRES",146,94,32,19,0,51,0.643835616438356
"064202206","BUENOS AIRES",121,49,43,23,1,67,0.40495867768595
"064202207","BUENOS AIRES",65,27,18,16,3,37,0.415384615384615
"064270305","BUENOS AIRES",262,258,4,0,0,4,0.984732824427481
"064270307","BUENOS AIRES",268,267,1,0,0,1,0.996268656716418
"064270309","BUENOS AIRES",204,200,2,2,0,4,0.980392156862745
"064270403","BUENOS AIRES",475,458,10,4,0,14,0.96421052631579
"064270507","BUENOS AIRES",447,434,6,3,1,10,0.970917225950783
"064270511","BUENOS AIRES",320,297,8,6,1,15,0.928125
"064270612","BUENOS AIRES",265,259,3,1,0,4,0.977358490566038
"064270614","BUENOS AIRES",276,267,1,5,0,6,0.967391304347826
"064270707","BUENOS AIRES",229,217,5,5,0,10,0.947598253275109
"064270712","BUENOS AIRES",409,401,1,6,1,8,0.980440097799511
"064270806","BUENOS AIRES",487,478,5,2,0,7,0.981519507186858
"064270807","BUENOS AIRES",392,366,5,0,0,5,0.933673469387755
"064270812","BUENOS AIRES",464,455,1,5,0,6,0.980603448275862
"064270902","BUENOS AIRES",390,303,3,83,0,86,0.776923076923077
"064270912","BUENOS AIRES",282,271,6,2,0,8,0.960992907801418
"064271107","BUENOS AIRES",359,350,5,3,0,8,0.974930362116992
"064271110","BUENOS AIRES",275,266,4,3,0,7,0.967272727272727
"064271309","BUENOS AIRES",286,279,5,2,0,7,0.975524475524476
"064271311","BUENOS AIRES",437,433,3,0,1,4,0.990846681922197
"064271407","BUENOS AIRES",530,346,113,63,1,177,0.652830188679245
"064271501","BUENOS AIRES",284,272,3,0,2,5,0.957746478873239
"064271511","BUENOS AIRES",246,239,1,2,0,3,0.971544715447154
"064271605","BUENOS AIRES",640,575,8,11,3,22,0.8984375
"064271608","BUENOS AIRES",254,250,2,2,0,4,0.984251968503937
"064271710","BUENOS AIRES",549,458,50,31,3,84,0.834244080145719
"064271810","BUENOS AIRES",442,82,97,226,14,337,0.18552036199095
"064271903","BUENOS AIRES",476,464,7,2,0,9,0.974789915966387
"064272007","BUENOS AIRES",280,254,26,0,0,26,0.907142857142857
"064272202","BUENOS AIRES",241,218,3,0,0,3,0.904564315352697
"064272205","BUENOS AIRES",362,338,16,5,0,21,0.933701657458563
"064272308","BUENOS AIRES",467,439,16,11,0,27,0.940042826552463
"064272405","BUENOS AIRES",473,312,63,81,2,146,0.659619450317125
"064272504","BUENOS AIRES",316,312,2,2,0,4,0.987341772151899
"064272601","BUENOS AIRES",242,229,7,6,0,13,0.946280991735537
"064272810","BUENOS AIRES",432,429,0,2,0,2,0.993055555555556
"064272907","BUENOS AIRES",434,410,19,5,0,24,0.944700460829493
"064273104","BUENOS AIRES",316,313,3,0,0,3,0.990506329113924
"064900305","BUENOS AIRES",179,19,47,103,1,151,0.106145251396648
"064273106","BUENOS AIRES",393,385,5,3,0,8,0.979643765903308
"064273109","BUENOS AIRES",266,251,12,3,0,15,0.943609022556391
"064273208","BUENOS AIRES",430,371,19,39,0,58,0.862790697674419
"064273302","BUENOS AIRES",411,374,1,14,0,15,0.909975669099757
"064273315","BUENOS AIRES",296,290,5,1,0,6,0.97972972972973
"064273401","BUENOS AIRES",351,348,1,1,0,2,0.991452991452991
"064273513","BUENOS AIRES",279,277,0,2,0,2,0.992831541218638
"064273604","BUENOS AIRES",212,188,18,4,0,22,0.886792452830189
"064273609","BUENOS AIRES",380,378,1,0,0,1,0.994736842105263
"064273704","BUENOS AIRES",461,412,22,23,2,47,0.893709327548807
"064273705","BUENOS AIRES",289,213,34,29,0,63,0.737024221453287
"064273808","BUENOS AIRES",439,418,2,5,0,7,0.952164009111617
"064273909","BUENOS AIRES",422,411,3,4,0,7,0.9739336492891
"064274104","BUENOS AIRES",424,395,21,8,0,29,0.931603773584906
"064274208","BUENOS AIRES",261,235,16,7,0,23,0.900383141762452
"064274401","BUENOS AIRES",528,420,49,57,0,106,0.795454545454545
"064274501","BUENOS AIRES",551,526,19,5,0,24,0.954627949183303
"064274504","BUENOS AIRES",476,468,5,1,0,6,0.983193277310924
"064274505","BUENOS AIRES",320,316,2,2,0,4,0.9875
"064274507","BUENOS AIRES",520,509,4,4,0,8,0.978846153846154
"064274509","BUENOS AIRES",311,289,15,6,0,21,0.929260450160772
"064274604","BUENOS AIRES",583,257,255,56,0,311,0.44082332761578
"064274907","BUENOS AIRES",463,48,87,308,10,405,0.103671706263499
"064274610","BUENOS AIRES",329,7,193,89,0,282,0.0212765957446809
"064274611","BUENOS AIRES",377,5,178,172,2,352,0.013262599469496
"064274705","BUENOS AIRES",262,245,5,1,1,7,0.935114503816794
"064274708","BUENOS AIRES",156,21,76,55,0,131,0.134615384615385
"064274709","BUENOS AIRES",245,237,6,2,0,8,0.96734693877551
"064274806","BUENOS AIRES",615,324,136,135,0,271,0.526829268292683
"064274809","BUENOS AIRES",472,437,7,18,0,25,0.925847457627119
"064277903","BUENOS AIRES",339,21,182,129,0,311,0.0619469026548673
"064275001","BUENOS AIRES",420,398,10,11,0,21,0.947619047619048
"064275002","BUENOS AIRES",329,314,7,8,0,15,0.954407294832827
"064275013","BUENOS AIRES",251,243,4,4,0,8,0.968127490039841
"065530302","BUENOS AIRES",87,37,32,11,2,45,0.425287356321839
"065151707","BUENOS AIRES",320,1,198,117,1,316,0.003125
"064275808","BUENOS AIRES",475,11,331,120,0,451,0.0231578947368421
"064275810","BUENOS AIRES",313,9,225,70,0,295,0.0287539936102236
"064275811","BUENOS AIRES",234,1,162,64,0,226,0.00427350427350427
"064276008","BUENOS AIRES",582,21,338,208,0,546,0.0360824742268041
"064276010","BUENOS AIRES",384,38,208,127,0,335,0.0989583333333333
"064276012","BUENOS AIRES",309,6,211,87,1,299,0.0194174757281553
"064276018","BUENOS AIRES",295,9,201,80,1,282,0.0305084745762712
"064276110","BUENOS AIRES",553,216,202,121,1,324,0.390596745027125
"064275106","BUENOS AIRES",259,123,57,72,1,130,0.474903474903475
"064275111","BUENOS AIRES",384,356,14,13,0,27,0.927083333333333
"064275306","BUENOS AIRES",535,487,2,24,0,26,0.910280373831776
"064275401","BUENOS AIRES",434,403,14,12,0,26,0.928571428571429
"064275501","BUENOS AIRES",269,242,13,14,0,27,0.899628252788104
"064275503","BUENOS AIRES",255,249,6,0,0,6,0.976470588235294
"064275702","BUENOS AIRES",332,14,182,126,0,308,0.0421686746987952
"064275713","BUENOS AIRES",448,8,313,117,0,430,0.0178571428571429
"064275801","BUENOS AIRES",501,9,310,181,0,491,0.0179640718562874
"064275803","BUENOS AIRES",370,11,221,129,0,350,0.0297297297297297
"064276306","BUENOS AIRES",411,17,268,114,4,386,0.0413625304136253
"064276308","BUENOS AIRES",491,15,343,103,1,447,0.0305498981670061
"064276310","BUENOS AIRES",644,54,382,193,1,576,0.0838509316770186
"064276401","BUENOS AIRES",252,12,188,48,0,236,0.0476190476190476
"064276410","BUENOS AIRES",484,25,286,158,0,444,0.0516528925619835
"064276508","BUENOS AIRES",271,29,149,88,0,237,0.107011070110701
"064276512","BUENOS AIRES",301,9,173,105,0,278,0.0299003322259136
"064276514","BUENOS AIRES",309,5,182,113,5,300,0.0161812297734628
"064276515","BUENOS AIRES",406,13,198,154,1,353,0.0320197044334975
"064276603","BUENOS AIRES",554,6,399,134,0,533,0.0108303249097473
"064276606","BUENOS AIRES",304,4,196,102,0,298,0.0131578947368421
"064276611","BUENOS AIRES",324,11,232,75,0,307,0.0339506172839506
"065601106","BUENOS AIRES",257,0,130,115,1,246,0
"064276917","BUENOS AIRES",385,2,299,67,1,367,0.00519480519480519
"064277004","BUENOS AIRES",479,21,278,177,0,455,0.0438413361169102
"064277018","BUENOS AIRES",249,2,148,96,0,244,0.00803212851405622
"064277110","BUENOS AIRES",226,9,134,74,0,208,0.0398230088495575
"064277113","BUENOS AIRES",364,0,228,107,0,335,0
"064277211","BUENOS AIRES",477,5,335,121,0,456,0.010482180293501
"064277311","BUENOS AIRES",286,9,138,128,0,266,0.0314685314685315
"064277405","BUENOS AIRES",427,6,317,89,2,408,0.0140515222482436
"064277412","BUENOS AIRES",440,4,205,218,2,425,0.00909090909090909
"064277506","BUENOS AIRES",418,0,124,275,1,400,0
"064277809","BUENOS AIRES",319,20,156,132,1,289,0.0626959247648903
"064277508","BUENOS AIRES",396,12,150,217,2,369,0.0303030303030303
"064277602","BUENOS AIRES",535,32,274,198,5,477,0.0598130841121495
"064277604","BUENOS AIRES",503,5,192,279,1,472,0.0099403578528827
"064277610","BUENOS AIRES",502,8,297,193,0,490,0.0159362549800797
"064278415","BUENOS AIRES",549,3,148,374,3,525,0.00546448087431694
"064277706","BUENOS AIRES",486,9,266,186,0,452,0.0185185185185185
"064277802","BUENOS AIRES",616,27,432,140,2,574,0.0438311688311688
"064278001","BUENOS AIRES",809,100,289,401,12,702,0.123609394313968
"064278101","BUENOS AIRES",462,6,271,160,2,433,0.012987012987013
"064278103","BUENOS AIRES",373,1,246,105,5,356,0.00268096514745308
"064278105","BUENOS AIRES",236,11,42,165,1,208,0.0466101694915254
"064278106","BUENOS AIRES",202,2,87,89,7,183,0.0099009900990099
"064278107","BUENOS AIRES",205,0,60,115,9,184,0
"064278109","BUENOS AIRES",106,0,54,42,5,101,0
"065601915","BUENOS AIRES",312,0,152,152,0,304,0
"064278301","BUENOS AIRES",375,1,235,132,1,368,0.00266666666666667
"064278314","BUENOS AIRES",368,7,232,124,2,358,0.0190217391304348
"064278401","BUENOS AIRES",243,188,29,21,0,50,0.773662551440329
"064278601","BUENOS AIRES",409,6,351,48,0,399,0.0146699266503667
"064278505","BUENOS AIRES",315,2,247,61,1,309,0.00634920634920635
"064278512","BUENOS AIRES",407,7,227,155,1,383,0.0171990171990172
"064344207","BUENOS AIRES",261,25,146,89,0,235,0.0957854406130268
"064278513","BUENOS AIRES",466,3,275,170,9,454,0.00643776824034335
"064278605","BUENOS AIRES",308,3,226,72,0,298,0.00974025974025974
"064278706","BUENOS AIRES",295,2,231,57,0,288,0.00677966101694915
"064278812","BUENOS AIRES",339,3,299,34,0,333,0.00884955752212389
"064278905","BUENOS AIRES",522,5,316,191,0,507,0.00957854406130268
"064278906","BUENOS AIRES",479,2,236,220,2,458,0.00417536534446764
"064278910","BUENOS AIRES",345,6,226,103,0,329,0.0173913043478261
"064279010","BUENOS AIRES",607,16,340,233,1,574,0.0263591433278418
"064279102","BUENOS AIRES",318,11,145,120,14,279,0.0345911949685535
"064279104","BUENOS AIRES",374,12,205,146,0,351,0.0320855614973262
"064279114","BUENOS AIRES",132,1,53,62,0,115,0.00757575757575758
"064279209","BUENOS AIRES",441,101,107,198,4,309,0.229024943310658
"064279406","BUENOS AIRES",572,1,284,266,1,551,0.00174825174825175
"064279505","BUENOS AIRES",477,7,131,307,3,441,0.0146750524109015
"064279506","BUENOS AIRES",424,24,134,238,12,384,0.0566037735849057
"064279604","BUENOS AIRES",614,3,258,296,5,559,0.00488599348534202
"064279606","BUENOS AIRES",506,1,352,139,0,491,0.00197628458498024
"064340807","BUENOS AIRES",224,22,33,160,2,195,0.0982142857142857
"064340706","BUENOS AIRES",156,144,6,5,0,11,0.923076923076923
"064279615","BUENOS AIRES",248,1,151,79,4,234,0.00403225806451613
"064279716","BUENOS AIRES",133,6,63,58,1,122,0.0451127819548872
"064279724","BUENOS AIRES",255,4,126,118,0,244,0.0156862745098039
"064340103","BUENOS AIRES",267,217,17,33,0,50,0.812734082397004
"064340202","BUENOS AIRES",55,38,7,10,0,17,0.690909090909091
"064342407","BUENOS AIRES",228,14,62,151,0,213,0.0614035087719298
"064340406","BUENOS AIRES",360,298,20,38,0,58,0.827777777777778
"064340407","BUENOS AIRES",218,183,22,13,0,35,0.839449541284404
"064340602","BUENOS AIRES",307,225,53,26,1,80,0.732899022801303
"064340605","BUENOS AIRES",288,232,31,23,0,54,0.805555555555556
"064340813","BUENOS AIRES",321,12,67,233,0,300,0.0373831775700935
"064340915","BUENOS AIRES",359,26,113,205,1,319,0.0724233983286908
"064341012","BUENOS AIRES",297,8,189,98,1,288,0.0269360269360269
"064341101","BUENOS AIRES",333,74,108,149,0,257,0.222222222222222
"064341102","BUENOS AIRES",393,259,55,76,0,131,0.659033078880407
"064341114","BUENOS AIRES",242,3,83,154,0,237,0.012396694214876
"064341506","BUENOS AIRES",200,197,3,0,0,3,0.985
"064341512","BUENOS AIRES",150,147,2,1,0,3,0.98
"064341606","BUENOS AIRES",179,176,1,2,0,3,0.983240223463687
"064341608","BUENOS AIRES",193,86,68,39,0,107,0.44559585492228
"064341612","BUENOS AIRES",430,381,41,8,0,49,0.886046511627907
"064341702","BUENOS AIRES",328,276,25,23,0,48,0.841463414634146
"064341802","BUENOS AIRES",252,198,24,30,0,54,0.785714285714286
"064341811","BUENOS AIRES",195,193,1,0,1,2,0.98974358974359
"064341907","BUENOS AIRES",315,243,43,28,0,71,0.771428571428571
"064342001","BUENOS AIRES",256,162,43,51,0,94,0.6328125
"064342003","BUENOS AIRES",381,307,54,16,0,70,0.805774278215223
"064342104","BUENOS AIRES",187,22,107,58,0,165,0.117647058823529
"064342113","BUENOS AIRES",332,36,187,108,0,295,0.108433734939759
"064342211","BUENOS AIRES",305,54,166,82,0,248,0.177049180327869
"064412606","BUENOS AIRES",314,311,1,1,0,2,0.990445859872611
"064342214","BUENOS AIRES",313,61,133,119,0,252,0.194888178913738
"064342306","BUENOS AIRES",415,101,105,185,6,296,0.243373493975904
"064342315","BUENOS AIRES",317,40,77,179,0,256,0.126182965299685
"064342406","BUENOS AIRES",244,3,127,114,0,241,0.0122950819672131
"064342516","BUENOS AIRES",323,28,166,129,0,295,0.086687306501548
"064342612","BUENOS AIRES",220,16,62,138,1,201,0.0727272727272727
"064342614","BUENOS AIRES",322,18,157,134,0,291,0.0559006211180124
"064342703","BUENOS AIRES",433,15,307,108,0,415,0.0346420323325635
"064342707","BUENOS AIRES",283,11,173,96,0,269,0.03886925795053
"064342813","BUENOS AIRES",234,7,116,110,1,227,0.0299145299145299
"064342906","BUENOS AIRES",293,15,138,134,0,272,0.0511945392491468
"064342907","BUENOS AIRES",340,11,183,144,0,327,0.0323529411764706
"064342908","BUENOS AIRES",285,22,150,112,0,262,0.0771929824561404
"064343103","BUENOS AIRES",268,205,42,19,0,61,0.764925373134328
"064343110","BUENOS AIRES",173,171,1,0,0,1,0.988439306358382
"064343405","BUENOS AIRES",225,3,118,100,0,218,0.0133333333333333
"064343505","BUENOS AIRES",145,7,81,57,0,138,0.0482758620689655
"064343604","BUENOS AIRES",325,244,22,58,0,80,0.750769230769231
"064343803","BUENOS AIRES",335,313,13,9,0,22,0.934328358208955
"064343809","BUENOS AIRES",252,245,1,6,0,7,0.972222222222222
"064344101","BUENOS AIRES",263,51,108,104,0,212,0.193916349809886
"064344301","BUENOS AIRES",372,11,117,244,0,361,0.0295698924731183
"064344501","BUENOS AIRES",335,19,196,118,1,315,0.0567164179104478
"064344505","BUENOS AIRES",372,8,141,219,0,360,0.021505376344086
"064344508","BUENOS AIRES",365,25,94,236,2,332,0.0684931506849315
"064410101","BUENOS AIRES",299,299,0,0,0,0,1
"064410402","BUENOS AIRES",354,354,0,0,0,0,1
"064410412","BUENOS AIRES",286,286,0,0,0,0,1
"064410601","BUENOS AIRES",248,247,1,0,0,1,0.995967741935484
"064410701","BUENOS AIRES",147,147,0,0,0,0,1
"064410703","BUENOS AIRES",287,285,1,1,0,2,0.993031358885017
"064410705","BUENOS AIRES",321,321,0,0,0,0,1
"064410708","BUENOS AIRES",172,172,0,0,0,0,1
"064410806","BUENOS AIRES",42,42,0,0,0,0,1
"064410807","BUENOS AIRES",180,180,0,0,0,0,1
"068400408","BUENOS AIRES",150,6,129,15,0,144,0.04
"064411007","BUENOS AIRES",207,207,0,0,0,0,1
"064411109","BUENOS AIRES",200,184,1,0,0,1,0.92
"064411202","BUENOS AIRES",248,248,0,0,0,0,1
"064411207","BUENOS AIRES",234,234,0,0,0,0,1
"064411216","BUENOS AIRES",177,175,2,0,0,2,0.988700564971751
"064411507","BUENOS AIRES",234,234,0,0,0,0,1
"064411702","BUENOS AIRES",213,213,0,0,0,0,1
"064411802","BUENOS AIRES",223,223,0,0,0,0,1
"064411805","BUENOS AIRES",244,241,2,1,0,3,0.987704918032787
"064411905","BUENOS AIRES",157,157,0,0,0,0,1
"064411907","BUENOS AIRES",222,221,1,0,0,1,0.995495495495496
"064411908","BUENOS AIRES",170,170,0,0,0,0,1
"064412001","BUENOS AIRES",322,319,3,0,0,3,0.990683229813665
"064412006","BUENOS AIRES",209,208,1,0,0,1,0.995215311004785
"064412007","BUENOS AIRES",185,185,0,0,0,0,1
"064412009","BUENOS AIRES",262,260,2,0,0,2,0.99236641221374
"064412013","BUENOS AIRES",148,147,0,1,0,1,0.993243243243243
"064412102","BUENOS AIRES",218,214,1,3,0,4,0.981651376146789
"064412103","BUENOS AIRES",383,382,0,1,0,1,0.997389033942559
"064412105","BUENOS AIRES",318,318,0,0,0,0,1
"064412109","BUENOS AIRES",204,202,2,0,0,2,0.990196078431373
"064412304","BUENOS AIRES",191,190,1,0,0,1,0.994764397905759
"064412308","BUENOS AIRES",238,236,1,0,1,2,0.991596638655462
"064412406","BUENOS AIRES",325,321,2,2,0,4,0.987692307692308
"064412501","BUENOS AIRES",232,230,2,0,0,2,0.991379310344828
"064412509","BUENOS AIRES",198,198,0,0,0,0,1
"064412601","BUENOS AIRES",220,218,2,0,0,2,0.990909090909091
"064412702","BUENOS AIRES",358,357,1,0,0,1,0.997206703910615
"064412803","BUENOS AIRES",240,238,2,0,0,2,0.991666666666667
"064413106","BUENOS AIRES",272,265,3,0,0,3,0.974264705882353
"064413113","BUENOS AIRES",216,205,8,3,0,11,0.949074074074074
"064413114","BUENOS AIRES",261,249,5,6,0,11,0.954022988505747
"064413204","BUENOS AIRES",410,402,5,2,1,8,0.980487804878049
"064413401","BUENOS AIRES",215,187,24,3,1,28,0.869767441860465
"064413414","BUENOS AIRES",291,1,122,156,0,278,0.00343642611683849
"064413501","BUENOS AIRES",381,361,8,9,0,17,0.94750656167979
"064413510","BUENOS AIRES",334,229,73,28,0,101,0.68562874251497
"064413707","BUENOS AIRES",251,238,8,5,0,13,0.948207171314741
"064414004","BUENOS AIRES",228,225,1,0,0,1,0.986842105263158
"064414009","BUENOS AIRES",280,181,35,51,3,89,0.646428571428571
"066021111","BUENOS AIRES",355,329,12,13,0,25,0.926760563380282
"064415009","BUENOS AIRES",252,250,2,0,0,2,0.992063492063492
"064415114","BUENOS AIRES",227,225,1,1,0,2,0.991189427312775
"066021112","BUENOS AIRES",279,259,11,7,0,18,0.92831541218638
"064550109","BUENOS AIRES",263,238,6,19,0,25,0.904942965779468
"064414109","BUENOS AIRES",340,137,58,135,1,194,0.402941176470588
"064414208","BUENOS AIRES",231,119,71,40,0,111,0.515151515151515
"064414212","BUENOS AIRES",283,19,171,93,0,264,0.0671378091872792
"064414304","BUENOS AIRES",344,338,4,1,0,5,0.982558139534884
"064414306","BUENOS AIRES",322,301,5,8,0,13,0.934782608695652
"064414308","BUENOS AIRES",245,6,146,90,0,236,0.0244897959183673
"064414404","BUENOS AIRES",258,7,148,99,0,247,0.0271317829457364
"064414409","BUENOS AIRES",252,1,49,181,2,232,0.00396825396825397
"064414510","BUENOS AIRES",339,19,137,165,1,303,0.056047197640118
"064414607","BUENOS AIRES",302,289,7,6,0,13,0.956953642384106
"064414805","BUENOS AIRES",202,178,0,0,0,0,0.881188118811881
"064414903","BUENOS AIRES",300,295,3,2,0,5,0.983333333333333
"064415004","BUENOS AIRES",204,202,1,1,0,2,0.990196078431373
"064415305","BUENOS AIRES",388,167,22,32,152,206,0.430412371134021
"064415308","BUENOS AIRES",275,256,15,4,0,19,0.930909090909091
"064415411","BUENOS AIRES",194,186,7,1,0,8,0.958762886597938
"064415415","BUENOS AIRES",204,6,60,126,2,188,0.0294117647058824
"064415503","BUENOS AIRES",212,8,150,48,0,198,0.0377358490566038
"064415508","BUENOS AIRES",334,324,8,1,0,9,0.970059880239521
"064415608","BUENOS AIRES",426,404,12,10,0,22,0.948356807511737
"064415712","BUENOS AIRES",344,303,30,10,0,40,0.880813953488372
"064415801","BUENOS AIRES",247,247,0,0,0,0,1
"064415902","BUENOS AIRES",238,230,3,5,0,8,0.966386554621849
"064416001","BUENOS AIRES",364,196,108,53,0,161,0.538461538461538
"064416003","BUENOS AIRES",257,194,37,22,0,59,0.754863813229572
"064416009","BUENOS AIRES",345,8,228,99,1,328,0.0231884057971014
"064416102","BUENOS AIRES",213,187,11,14,0,25,0.877934272300469
"064416104","BUENOS AIRES",227,177,33,17,0,50,0.779735682819383
"064416109","BUENOS AIRES",228,1,162,57,2,221,0.0043859649122807
"064416112","BUENOS AIRES",245,9,136,95,0,231,0.036734693877551
"064416205","BUENOS AIRES",65,65,0,0,0,0,1
"064416207","BUENOS AIRES",202,193,3,5,0,8,0.955445544554455
"064416208","BUENOS AIRES",331,308,20,3,0,23,0.930513595166163
"064900808","BUENOS AIRES",357,349,6,2,0,8,0.977591036414566
"064416211","BUENOS AIRES",437,5,243,181,0,424,0.011441647597254
"066232004","BUENOS AIRES",106,45,13,46,0,59,0.424528301886792
"064416302","BUENOS AIRES",219,6,191,21,0,212,0.0273972602739726
"064416306","BUENOS AIRES",252,4,191,57,0,248,0.0158730158730159
"065151813","BUENOS AIRES",350,176,69,104,0,173,0.502857142857143
"067001210","BUENOS AIRES",267,265,1,1,0,2,0.99250936329588
"064416604","BUENOS AIRES",306,246,13,47,0,60,0.803921568627451
"064416614","BUENOS AIRES",235,5,112,107,5,224,0.0212765957446809
"066380106","BUENOS AIRES",331,4,120,192,5,317,0.0120845921450151
"064480605","BUENOS AIRES",201,74,51,75,0,126,0.368159203980099
"064550102","BUENOS AIRES",270,234,14,20,0,34,0.866666666666667
"064550104","BUENOS AIRES",226,222,3,1,0,4,0.982300884955752
"064551404","BUENOS AIRES",160,109,22,28,0,50,0.68125
"064551405","BUENOS AIRES",280,206,38,36,0,74,0.735714285714286
"064551407","BUENOS AIRES",306,274,17,13,1,31,0.895424836601307
"064551408","BUENOS AIRES",329,252,17,39,2,58,0.765957446808511
"064620401","BUENOS AIRES",111,52,10,49,0,59,0.468468468468468
"064620707","BUENOS AIRES",401,220,43,127,1,171,0.548628428927681
"064621203","BUENOS AIRES",303,175,51,72,0,123,0.577557755775578
"064690101","BUENOS AIRES",270,163,33,71,0,104,0.603703703703704
"064690102","BUENOS AIRES",346,344,1,1,0,2,0.994219653179191
"064690104","BUENOS AIRES",461,427,13,20,0,33,0.926247288503254
"064690110","BUENOS AIRES",238,168,17,49,1,67,0.705882352941177
"064690205","BUENOS AIRES",296,291,4,1,0,5,0.983108108108108
"064690206","BUENOS AIRES",216,203,5,3,1,9,0.939814814814815
"064690214","BUENOS AIRES",277,143,53,77,0,130,0.516245487364621
"066381710","BUENOS AIRES",203,198,5,0,0,5,0.975369458128079
"066382202","BUENOS AIRES",266,0,116,144,1,261,0
"064760108","BUENOS AIRES",296,242,17,34,1,52,0.817567567567568
"064760701","BUENOS AIRES",96,1,6,89,0,95,0.0104166666666667
"066440510","BUENOS AIRES",47,47,0,0,0,0,1
"064830106","BUENOS AIRES",307,252,34,21,0,55,0.820846905537459
"064830115","BUENOS AIRES",214,8,123,80,1,204,0.0373831775700935
"064830301","BUENOS AIRES",94,1,38,48,0,86,0.0106382978723404
"064830403","BUENOS AIRES",154,4,99,51,0,150,0.025974025974026
"064830404","BUENOS AIRES",363,11,202,145,1,348,0.0303030303030303
"066480315","BUENOS AIRES",326,0,155,159,0,314,0
"064830701","BUENOS AIRES",112,0,62,46,2,110,0
"064900105","BUENOS AIRES",258,24,58,176,0,234,0.0930232558139535
"064900111","BUENOS AIRES",236,22,77,132,0,209,0.0932203389830508
"064900112","BUENOS AIRES",286,16,87,169,0,256,0.0559440559440559
"064900516","BUENOS AIRES",539,23,230,273,1,504,0.0426716141001855
"064900610","BUENOS AIRES",228,22,107,66,0,173,0.0964912280701754
"064900613","BUENOS AIRES",381,373,7,1,0,8,0.979002624671916
"064900706","BUENOS AIRES",348,20,161,162,1,324,0.0574712643678161
"064900802","BUENOS AIRES",238,184,24,30,0,54,0.773109243697479
"064900809","BUENOS AIRES",385,325,50,10,0,60,0.844155844155844
"064900906","BUENOS AIRES",347,316,17,12,1,30,0.910662824207493
"064901004","BUENOS AIRES",351,342,3,6,0,9,0.974358974358974
"064901012","BUENOS AIRES",310,297,7,6,0,13,0.958064516129032
"064901101","BUENOS AIRES",173,171,1,1,0,2,0.988439306358382
"064901105","BUENOS AIRES",352,349,2,1,0,3,0.991477272727273
"064901115","BUENOS AIRES",229,223,5,0,0,5,0.973799126637555
"064901117","BUENOS AIRES",330,329,1,0,0,1,0.996969696969697
"064901202","BUENOS AIRES",389,343,39,7,0,46,0.881748071979435
"064901208","BUENOS AIRES",293,225,43,25,0,68,0.767918088737201
"064901303","BUENOS AIRES",320,168,93,56,0,149,0.525
"064901306","BUENOS AIRES",358,15,171,147,0,318,0.0418994413407821
"064901308","BUENOS AIRES",276,272,4,0,0,4,0.985507246376812
"064901314","BUENOS AIRES",369,33,127,197,5,329,0.0894308943089431
"020050608","CABA",385,384,0,0,0,0,0.997402597402597
"064901405","BUENOS AIRES",286,5,185,94,1,280,0.0174825174825175
"064901410","BUENOS AIRES",358,49,142,163,0,305,0.136871508379888
"064901504","BUENOS AIRES",268,13,92,157,0,249,0.0485074626865672
"064901510","BUENOS AIRES",289,8,107,168,1,276,0.027681660899654
"064901511","BUENOS AIRES",335,11,87,230,2,319,0.0328358208955224
"064901603","BUENOS AIRES",327,0,175,151,0,326,0
"064901604","BUENOS AIRES",174,3,117,51,0,168,0.0172413793103448
"064901705","BUENOS AIRES",399,15,248,129,0,377,0.037593984962406
"064901805","BUENOS AIRES",222,82,72,68,0,140,0.369369369369369
"064901810","BUENOS AIRES",300,15,116,162,0,278,0.05
"064901909","BUENOS AIRES",168,151,10,7,0,17,0.898809523809524
"064901910","BUENOS AIRES",337,304,19,11,0,30,0.902077151335312
"064902009","BUENOS AIRES",210,21,132,57,0,189,0.1
"064902103","BUENOS AIRES",353,349,4,0,0,4,0.988668555240793
"064902108","BUENOS AIRES",155,154,0,1,0,1,0.993548387096774
"064902202","BUENOS AIRES",225,217,5,3,0,8,0.964444444444444
"064903605","BUENOS AIRES",304,24,130,146,0,276,0.0789473684210526
"064902411","BUENOS AIRES",199,194,3,2,0,5,0.974874371859296
"064902502","BUENOS AIRES",290,278,8,4,0,12,0.958620689655172
"064902505","BUENOS AIRES",250,242,4,4,0,8,0.968
"064902708","BUENOS AIRES",311,3,153,151,3,307,0.00964630225080386
"064902711","BUENOS AIRES",478,7,290,180,0,470,0.0146443514644351
"064902808","BUENOS AIRES",209,7,141,59,0,200,0.0334928229665072
"064902810","BUENOS AIRES",407,13,195,189,1,385,0.0319410319410319
"064903002","BUENOS AIRES",523,32,221,230,9,460,0.0611854684512428
"064903005","BUENOS AIRES",478,13,255,180,0,435,0.0271966527196653
"064903008","BUENOS AIRES",316,6,167,140,0,307,0.0189873417721519
"064903009","BUENOS AIRES",338,18,176,143,1,320,0.0532544378698225
"064903101","BUENOS AIRES",246,10,67,161,1,229,0.040650406504065
"064903105","BUENOS AIRES",336,9,123,169,0,292,0.0267857142857143
"064903205","BUENOS AIRES",253,6,116,120,2,238,0.0237154150197628
"064903401","BUENOS AIRES",665,19,169,328,17,514,0.0285714285714286
"064903405","BUENOS AIRES",442,17,144,264,0,408,0.0384615384615385
"064903414","BUENOS AIRES",361,2,107,229,5,341,0.00554016620498615
"064903415","BUENOS AIRES",252,4,112,112,0,224,0.0158730158730159
"064903517","BUENOS AIRES",321,4,105,188,2,295,0.0124610591900312
"064903603","BUENOS AIRES",275,9,76,174,0,250,0.0327272727272727
"064904804","BUENOS AIRES",345,339,3,3,0,6,0.982608695652174
"064903805","BUENOS AIRES",405,6,59,300,12,371,0.0148148148148148
"064903808","BUENOS AIRES",482,30,172,251,1,424,0.0622406639004149
"064903810","BUENOS AIRES",274,4,89,175,3,267,0.0145985401459854
"064903811","BUENOS AIRES",354,11,126,192,3,321,0.0310734463276836
"064903812","BUENOS AIRES",263,14,92,141,4,237,0.0532319391634981
"064903909","BUENOS AIRES",328,6,41,244,5,290,0.0182926829268293
"064904003","BUENOS AIRES",308,11,22,261,6,289,0.0357142857142857
"064904309","BUENOS AIRES",445,4,285,155,1,441,0.00898876404494382
"064904402","BUENOS AIRES",386,64,172,149,1,322,0.16580310880829
"064904403","BUENOS AIRES",281,7,129,144,0,273,0.0249110320284698
"064904412","BUENOS AIRES",260,7,179,72,0,251,0.0269230769230769
"064904507","BUENOS AIRES",196,7,111,77,0,188,0.0357142857142857
"064904603","BUENOS AIRES",273,245,9,18,0,27,0.897435897435897
"064904604","BUENOS AIRES",281,252,19,8,1,28,0.896797153024911
"064904605","BUENOS AIRES",126,116,5,5,0,10,0.920634920634921
"064904612","BUENOS AIRES",265,236,14,14,0,28,0.890566037735849
"065391212","BUENOS AIRES",402,4,280,112,0,392,0.00995024875621891
"065391213","BUENOS AIRES",320,0,235,82,0,317,0
"065391404","BUENOS AIRES",227,158,48,20,0,68,0.696035242290749
"065391410","BUENOS AIRES",266,136,105,18,0,123,0.511278195488722
"065391411","BUENOS AIRES",269,4,186,77,0,263,0.0148698884758364
"065391505","BUENOS AIRES",152,152,0,0,0,0,1
"060631103","BUENOS AIRES",44,0,17,26,1,44,0
"060700502","BUENOS AIRES",26,0,7,19,0,26,0
"061121107","BUENOS AIRES",7,0,6,1,0,7,0
"061400204","BUENOS AIRES",19,0,8,10,0,18,0
"060070105","BUENOS AIRES",12,1,8,2,1,11,0.0833333333333333
"060070110","BUENOS AIRES",11,0,7,3,0,10,0
"060070111","BUENOS AIRES",8,0,1,7,0,8,0
"060070307","BUENOS AIRES",5,0,3,2,0,5,0
"060070408","BUENOS AIRES",6,0,3,3,0,6,0
"061470205","BUENOS AIRES",9,0,2,6,1,9,0
"060070410","BUENOS AIRES",2,0,1,1,0,2,0
"060070505","BUENOS AIRES",3,0,1,2,0,3,0
"060070602","BUENOS AIRES",7,0,5,1,0,6,0
"060070610","BUENOS AIRES",9,0,6,3,0,9,0
"060070901","BUENOS AIRES",5,0,0,5,0,5,0
"060140101","BUENOS AIRES",27,0,8,18,1,27,0
"065391608","BUENOS AIRES",220,150,29,40,0,69,0.681818181818182
"060140401","BUENOS AIRES",35,0,6,29,0,35,0
"060140503","BUENOS AIRES",36,0,26,8,0,34,0
"060141101","BUENOS AIRES",18,0,6,11,1,18,0
"060210302","BUENOS AIRES",7,0,3,4,0,7,0
"065391610","BUENOS AIRES",319,315,4,0,0,4,0.987460815047022
"062170206","BUENOS AIRES",15,0,6,9,0,15,0
"060421101","BUENOS AIRES",24,1,2,20,1,23,0.0416666666666667
"060492101","BUENOS AIRES",46,0,7,33,5,45,0
"060840602","BUENOS AIRES",5,0,5,0,0,5,0
"060563101","BUENOS AIRES",59,1,31,27,0,58,0.0169491525423729
"060630406","BUENOS AIRES",29,1,16,12,0,28,0.0344827586206897
"065391702","BUENOS AIRES",332,2,194,132,1,327,0.00602409638554217
"060630607","BUENOS AIRES",18,0,5,12,0,17,0
"060630805","BUENOS AIRES",56,0,18,35,2,55,0
"068401208","BUENOS AIRES",237,233,3,1,0,4,0.983122362869198
"068051109","BUENOS AIRES",430,18,150,232,1,383,0.0418604651162791
"060631104","BUENOS AIRES",45,0,11,33,1,45,0
"060631106","BUENOS AIRES",42,3,18,18,0,36,0.0714285714285714
"060700403","BUENOS AIRES",19,0,18,1,0,19,0
"060700701","BUENOS AIRES",22,0,1,21,0,22,0
"060770302","BUENOS AIRES",8,0,4,4,0,8,0
"065392007","BUENOS AIRES",216,4,137,72,0,209,0.0185185185185185
"060701201","BUENOS AIRES",21,0,2,6,13,21,0
"060770902","BUENOS AIRES",8,0,0,8,0,8,0
"060840201","BUENOS AIRES",18,0,10,6,1,17,0
"060840401","BUENOS AIRES",4,0,1,3,0,4,0
"060840601","BUENOS AIRES",0,0,0,0,0,0,NA
"060840803","BUENOS AIRES",30,2,6,22,0,28,0.0666666666666667
"061960303","BUENOS AIRES",8,0,3,4,1,8,0
"060840909","BUENOS AIRES",13,0,13,0,0,13,0
"062801201","BUENOS AIRES",39,2,26,10,0,36,0.0512820512820513
"065391809","BUENOS AIRES",395,352,24,15,0,39,0.891139240506329
"061120309","BUENOS AIRES",10,0,4,6,0,10,0
"061120604","BUENOS AIRES",15,0,3,12,0,15,0
"061120403","BUENOS AIRES",5,0,4,1,0,5,0
"061121004","BUENOS AIRES",55,0,20,34,1,55,0
"061190102","BUENOS AIRES",13,0,8,5,0,13,0
"063220504","BUENOS AIRES",4,0,0,4,0,4,0
"061190602","BUENOS AIRES",19,0,12,6,1,19,0
"061190803","BUENOS AIRES",0,0,0,0,0,0,NA
"061190902","BUENOS AIRES",21,0,17,2,1,20,0
"068612904","BUENOS AIRES",265,260,5,0,0,5,0.981132075471698
"063360401","BUENOS AIRES",16,0,9,7,0,16,0
"061340502","BUENOS AIRES",32,0,17,14,0,31,0
"061470305","BUENOS AIRES",15,0,9,5,1,15,0
"061470503","BUENOS AIRES",14,0,0,14,0,14,0
"061470711","BUENOS AIRES",8,0,2,6,0,8,0
"061470712","BUENOS AIRES",2,0,0,2,0,2,0
"061470803","BUENOS AIRES",7,0,1,6,0,7,0
"061470904","BUENOS AIRES",10,0,3,6,1,10,0
"061470905","BUENOS AIRES",9,0,0,9,0,9,0
"061540301","BUENOS AIRES",24,0,7,16,0,23,0
"061540609","BUENOS AIRES",20,0,11,8,1,20,0
"061610501","BUENOS AIRES",14,0,1,13,0,14,0
"061610201","BUENOS AIRES",11,0,1,10,0,11,0
"061680303","BUENOS AIRES",16,0,4,12,0,16,0
"061890103","BUENOS AIRES",3,0,1,2,0,3,0
"061890104","BUENOS AIRES",7,0,6,0,1,7,0
"061890305","BUENOS AIRES",5,0,3,2,0,5,0
"061680402","BUENOS AIRES",10,0,3,6,0,9,0
"061680405","BUENOS AIRES",1,0,0,1,0,1,0
"061680503","BUENOS AIRES",8,0,0,8,0,8,0
"061681003","BUENOS AIRES",22,0,3,18,0,21,0
"061750202","BUENOS AIRES",5,0,3,2,0,5,0
"061750401","BUENOS AIRES",30,0,12,18,0,30,0
"067561702","BUENOS AIRES",406,389,13,4,0,17,0.958128078817734
"061890101","BUENOS AIRES",9,0,9,0,0,9,0
"020112107","CABA",270,269,1,0,0,1,0.996296296296296
"061890604","BUENOS AIRES",7,0,2,4,1,7,0
"061890701","BUENOS AIRES",6,0,3,3,0,6,0
"061890702","BUENOS AIRES",3,0,3,0,0,3,0
"061891207","BUENOS AIRES",2,0,2,0,0,2,0
"061891106","BUENOS AIRES",5,0,3,1,1,5,0
"061891308","BUENOS AIRES",5,0,4,1,0,5,0
"061891602","BUENOS AIRES",1,0,1,0,0,1,0
"061960502","BUENOS AIRES",2,0,0,2,0,2,0
"061960503","BUENOS AIRES",12,0,0,11,0,11,0
"061960702","BUENOS AIRES",5,0,1,4,0,5,0
"061960806","BUENOS AIRES",10,0,3,7,0,10,0
"020151605","CABA",276,275,1,0,0,1,0.996376811594203
"061960903","BUENOS AIRES",12,0,5,7,0,12,0
"065392108","BUENOS AIRES",241,1,223,17,0,240,0.004149377593361
"061961304","BUENOS AIRES",12,0,5,6,1,12,0
"062030206","BUENOS AIRES",11,0,9,2,0,11,0
"062030403","BUENOS AIRES",10,0,8,2,0,10,0
"062030408","BUENOS AIRES",12,0,4,8,0,12,0
"062030502","BUENOS AIRES",3,0,2,1,0,3,0
"062030703","BUENOS AIRES",5,0,0,5,0,5,0
"062030705","BUENOS AIRES",4,0,2,2,0,4,0
"065392304","BUENOS AIRES",282,1,182,96,0,278,0.00354609929078014
"062030802","BUENOS AIRES",28,0,23,5,0,28,0
"062030905","BUENOS AIRES",3,0,0,3,0,3,0
"062031002","BUENOS AIRES",11,0,3,8,0,11,0
"062031203","BUENOS AIRES",12,0,1,10,0,11,0
"062031305","BUENOS AIRES",13,0,7,6,0,13,0
"062031307","BUENOS AIRES",11,0,1,10,0,11,0
"062031308","BUENOS AIRES",10,0,8,2,0,10,0
"062031503","BUENOS AIRES",11,0,7,4,0,11,0
"062100301","BUENOS AIRES",70,0,40,30,0,70,0
"062101101","BUENOS AIRES",17,0,8,9,0,17,0
"062170203","BUENOS AIRES",9,0,3,6,0,9,0
"065392601","BUENOS AIRES",452,10,262,172,0,434,0.0221238938053097
"062310703","BUENOS AIRES",10,0,7,3,0,10,0
"062170605","BUENOS AIRES",17,0,7,9,0,16,0
"065392409","BUENOS AIRES",234,3,128,98,0,226,0.0128205128205128
"064411804","BUENOS AIRES",179,178,1,0,0,1,0.994413407821229
"062170205","BUENOS AIRES",21,0,9,12,0,21,0
"062170512","BUENOS AIRES",6,0,0,6,0,6,0
"020132405","CABA",286,285,1,0,0,1,0.996503496503496
"062170601","BUENOS AIRES",9,0,8,1,0,9,0
"062170602","BUENOS AIRES",6,1,4,1,0,5,0.166666666666667
"065810502","BUENOS AIRES",52,52,0,0,0,0,1
"065392410","BUENOS AIRES",251,1,156,88,1,245,0.00398406374501992
"065392411","BUENOS AIRES",295,6,178,105,1,284,0.0203389830508475
"063510902","BUENOS AIRES",8,0,3,5,0,8,0
"062171007","BUENOS AIRES",18,0,9,7,0,16,0
"065392415","BUENOS AIRES",466,2,272,184,0,456,0.00429184549356223
"062171012","BUENOS AIRES",11,0,1,10,0,11,0
"063920502","BUENOS AIRES",28,0,14,14,0,28,0
"065392508","BUENOS AIRES",382,3,240,131,0,371,0.00785340314136126
"065392511","BUENOS AIRES",263,2,111,140,0,251,0.00760456273764259
"062241502","BUENOS AIRES",18,0,4,13,0,17,0
"062310706","BUENOS AIRES",5,0,1,1,3,5,0
"062311003","BUENOS AIRES",11,0,3,8,0,11,0
"062380401","BUENOS AIRES",29,1,7,21,0,28,0.0344827586206897
"062800504","BUENOS AIRES",3,0,0,2,0,2,0
"063850901","BUENOS AIRES",30,0,19,11,0,30,0
"020050606","CABA",407,404,3,0,0,3,0.992628992628993
"062171103","BUENOS AIRES",20,0,11,9,0,20,0
"065392604","BUENOS AIRES",268,19,117,118,1,236,0.0708955223880597
"062240907","BUENOS AIRES",29,2,7,17,1,25,0.0689655172413793
"062242102","BUENOS AIRES",4,0,1,3,0,4,0
"062310301","BUENOS AIRES",11,0,4,6,1,11,0
"062310404","BUENOS AIRES",13,0,6,7,0,13,0
"062310501","BUENOS AIRES",12,0,8,3,0,11,0
"062310604","BUENOS AIRES",5,0,5,0,0,5,0
"020111205","CABA",245,245,0,0,0,0,1
"062800506","BUENOS AIRES",12,0,11,1,0,12,0
"062800710","BUENOS AIRES",10,0,0,9,1,10,0
"062870701","BUENOS AIRES",45,0,23,19,3,45,0
"063360801","BUENOS AIRES",45,0,29,14,2,45,0
"062800711","BUENOS AIRES",11,0,6,5,0,11,0
"062800803","BUENOS AIRES",5,0,1,4,0,5,0
"062800806","BUENOS AIRES",7,0,4,2,1,7,0
"062800807","BUENOS AIRES",13,0,7,4,1,12,0
"062800813","BUENOS AIRES",11,0,7,4,0,11,0
"063851101","BUENOS AIRES",16,0,14,2,0,16,0
"062800907","BUENOS AIRES",6,0,5,1,0,6,0
"062800903","BUENOS AIRES",5,0,2,1,1,4,0
"062801202","BUENOS AIRES",30,0,6,24,0,30,0
"063220202","BUENOS AIRES",6,0,1,5,0,6,0
"062940205","BUENOS AIRES",20,10,3,7,0,10,0.5
"062940607","BUENOS AIRES",15,0,7,8,0,15,0
"063220608","BUENOS AIRES",28,0,10,17,1,28,0
"062940701","BUENOS AIRES",7,0,0,7,0,7,0
"062940812","BUENOS AIRES",3,0,2,1,0,3,0
"063080301","BUENOS AIRES",27,0,8,19,0,27,0
"063150701","BUENOS AIRES",38,0,14,24,0,38,0
"063220303","BUENOS AIRES",4,0,1,3,0,4,0
"063220402","BUENOS AIRES",6,0,0,6,0,6,0
"063220901","BUENOS AIRES",17,0,10,7,0,17,0
"063220610","BUENOS AIRES",1,0,0,1,0,1,0
"066580606","BUENOS AIRES",196,193,3,0,0,3,0.98469387755102
"063220703","BUENOS AIRES",17,0,6,11,0,17,0
"063220704","BUENOS AIRES",6,0,1,4,0,5,0
"065392711","BUENOS AIRES",392,33,113,236,0,349,0.0841836734693878
"063221304","BUENOS AIRES",8,0,2,6,0,8,0
"063290502","BUENOS AIRES",101,0,33,63,1,97,0
"065392802","BUENOS AIRES",328,5,206,109,1,316,0.0152439024390244
"063360601","BUENOS AIRES",19,0,16,1,2,19,0
"060770104","BUENOS AIRES",257,256,1,0,0,1,0.996108949416342
"065392803","BUENOS AIRES",303,1,191,108,0,299,0.0033003300330033
"063430713","BUENOS AIRES",148,3,56,85,1,142,0.0202702702702703
"063510702","BUENOS AIRES",13,0,9,4,0,13,0
"063577903","BUENOS AIRES",84,1,29,46,2,77,0.0119047619047619
"068051703","BUENOS AIRES",236,2,183,50,0,233,0.00847457627118644
"063920305","BUENOS AIRES",21,1,11,8,1,20,0.0476190476190476
"063920403","BUENOS AIRES",22,0,8,13,1,22,0
"063920602","BUENOS AIRES",23,0,14,9,0,23,0
"063920802","BUENOS AIRES",31,0,13,18,0,31,0
"063920904","BUENOS AIRES",35,0,17,18,0,35,0
"063921004","BUENOS AIRES",19,0,12,7,0,19,0
"063921006","BUENOS AIRES",8,0,8,0,0,8,0
"063921101","BUENOS AIRES",9,1,3,4,0,7,0.111111111111111
"063921208","BUENOS AIRES",19,0,5,10,0,15,0
"063921301","BUENOS AIRES",24,1,14,9,0,23,0.0416666666666667
"063921402","BUENOS AIRES",10,0,6,3,1,10,0
"063921504","BUENOS AIRES",23,0,2,21,0,23,0
"063921507","BUENOS AIRES",11,0,9,2,0,11,0
"063990402","BUENOS AIRES",18,0,9,7,1,17,0
"063990805","BUENOS AIRES",20,0,15,5,0,20,0
"064060102","BUENOS AIRES",2,0,1,0,0,1,0
"064060303","BUENOS AIRES",12,0,2,7,1,10,0
"063640602","BUENOS AIRES",14,0,9,5,0,14,0
"063850105","BUENOS AIRES",9,0,6,3,0,9,0
"063850202","BUENOS AIRES",12,0,8,3,0,11,0
"063850302","BUENOS AIRES",8,0,2,6,0,8,0
"063850402","BUENOS AIRES",19,0,7,11,0,18,0
"063920404","BUENOS AIRES",6,0,1,5,0,6,0
"063850802","BUENOS AIRES",18,0,8,10,0,18,0
"065392902","BUENOS AIRES",55,0,14,38,0,52,0
"064480803","BUENOS AIRES",8,0,3,4,0,7,0
"064481003","BUENOS AIRES",3,0,3,0,0,3,0
"064550301","BUENOS AIRES",47,0,21,24,2,47,0
"064550604","BUENOS AIRES",56,0,21,32,3,56,0
"064620605","BUENOS AIRES",15,0,6,8,0,14,0
"064620801","BUENOS AIRES",29,0,9,18,2,29,0
"064621204","BUENOS AIRES",8,0,0,8,0,8,0
"064690702","BUENOS AIRES",7,0,3,3,1,7,0
"064690905","BUENOS AIRES",6,0,6,0,0,6,0
"064690906","BUENOS AIRES",15,0,10,3,1,14,0
"064691202","BUENOS AIRES",9,0,3,6,0,9,0
"064691402","BUENOS AIRES",10,0,5,5,0,10,0
"064760207","BUENOS AIRES",25,0,3,22,0,25,0
"020130508","CABA",417,416,1,0,0,1,0.997601918465228
"064131604","BUENOS AIRES",0,0,0,0,0,0,NA
"065320701","BUENOS AIRES",42,0,24,18,0,42,0
"066232404","BUENOS AIRES",8,0,3,4,0,7,0
"064481001","BUENOS AIRES",6,0,0,6,0,6,0
"064480301","BUENOS AIRES",7,0,2,5,0,7,0
"064480303","BUENOS AIRES",5,0,2,3,0,5,0
"064480402","BUENOS AIRES",4,0,1,2,0,3,0
"064620711","BUENOS AIRES",8,1,4,2,0,6,0.125
"064760401","BUENOS AIRES",7,0,0,7,0,7,0
"064830502","BUENOS AIRES",42,0,10,30,1,41,0
"064830504","BUENOS AIRES",71,1,38,29,1,68,0.0140845070422535
"064830704","BUENOS AIRES",8,0,4,4,0,8,0
"064830802","BUENOS AIRES",43,0,22,20,1,43,0
"020111207","CABA",259,258,1,0,0,1,0.996138996138996
"064830905","BUENOS AIRES",39,0,34,5,0,39,0
"064970205","BUENOS AIRES",8,0,4,4,0,8,0
"064971005","BUENOS AIRES",11,0,7,4,0,11,0
"067911401","BUENOS AIRES",27,0,10,17,0,27,0
"064760604","BUENOS AIRES",7,0,1,6,0,7,0
"064761103","BUENOS AIRES",20,0,9,11,0,20,0
"064761205","BUENOS AIRES",26,2,20,3,0,23,0.0769230769230769
"064830302","BUENOS AIRES",87,1,31,51,0,82,0.0114942528735632
"065050405","BUENOS AIRES",19,0,15,4,0,19,0
"065110602","BUENOS AIRES",27,0,9,18,0,27,0
"065110603","BUENOS AIRES",24,0,6,18,0,24,0
"065110702","BUENOS AIRES",17,0,7,10,0,17,0
"066860304","BUENOS AIRES",21,0,10,11,0,21,0
"067070401","BUENOS AIRES",138,1,53,84,0,137,0.0072463768115942
"067070404","BUENOS AIRES",54,0,26,28,0,54,0
"068401602","BUENOS AIRES",284,281,0,0,0,0,0.98943661971831
"067070602","BUENOS AIRES",43,0,11,31,0,42,0
"068401603","BUENOS AIRES",303,303,0,0,0,0,1
"065180501","BUENOS AIRES",11,0,9,2,0,11,0
"065180505","BUENOS AIRES",7,0,4,3,0,7,0
"065180508","BUENOS AIRES",6,0,0,6,0,6,0
"065180701","BUENOS AIRES",27,1,5,20,0,25,0.037037037037037
"065810403","BUENOS AIRES",197,192,4,1,0,5,0.974619289340102
"065180806","BUENOS AIRES",8,0,5,3,0,8,0
"065320503","BUENOS AIRES",49,1,20,25,2,47,0.0204081632653061
"065320604","BUENOS AIRES",10,0,2,7,0,9,0
"065321302","BUENOS AIRES",11,0,2,9,0,11,0
"065470302","BUENOS AIRES",44,0,25,18,0,43,0
"065470304","BUENOS AIRES",33,0,16,16,0,32,0
"065470602","BUENOS AIRES",31,0,22,9,0,31,0
"065392913","BUENOS AIRES",56,0,22,31,1,54,0
"066091706","BUENOS AIRES",5,0,4,1,0,5,0
"065951401","BUENOS AIRES",100,0,47,47,1,95,0
"065393010","BUENOS AIRES",324,0,227,92,0,319,0
"065470801","BUENOS AIRES",71,0,46,24,1,71,0
"067910902","BUENOS AIRES",66,30,14,20,1,35,0.454545454545455
"067910903","BUENOS AIRES",35,0,12,22,1,35,0
"065740501","BUENOS AIRES",26,0,3,23,0,26,0
"065740803","BUENOS AIRES",27,0,22,5,0,27,0
"065810602","BUENOS AIRES",36,0,13,20,0,33,0
"065392919","BUENOS AIRES",213,1,59,138,1,198,0.00469483568075117
"065392921","BUENOS AIRES",344,2,160,175,1,336,0.00581395348837209
"065810905","BUENOS AIRES",3,0,1,2,0,3,0
"065811003","BUENOS AIRES",14,0,2,10,1,13,0
"065811205","BUENOS AIRES",35,0,6,28,0,34,0
"065880307","BUENOS AIRES",12,0,8,4,0,12,0
"065881404","BUENOS AIRES",19,0,1,18,0,19,0
"065881503","BUENOS AIRES",7,0,5,1,1,7,0
"065951001","BUENOS AIRES",54,0,29,25,0,54,0
"068052612","BUENOS AIRES",82,0,50,29,0,79,0
"065601002","BUENOS AIRES",273,127,104,39,0,143,0.465201465201465
"065601101","BUENOS AIRES",293,3,225,61,0,286,0.0102389078498294
"065682007","BUENOS AIRES",219,219,0,0,0,0,1
"066020101","BUENOS AIRES",99,0,30,34,0,64,0
"066020204","BUENOS AIRES",23,0,6,14,0,20,0
"065810505","BUENOS AIRES",73,73,0,0,0,0,1
"066090605","BUENOS AIRES",24,0,13,10,0,23,0
"066091305","BUENOS AIRES",9,0,4,4,0,8,0
"066090703","BUENOS AIRES",6,0,1,2,3,6,0
"066091705","BUENOS AIRES",2,0,0,1,0,1,0
"066091802","BUENOS AIRES",3,0,3,0,0,3,0
"067350206","BUENOS AIRES",32,2,4,26,0,30,0.0625
"067701501","BUENOS AIRES",3,0,1,2,0,3,0
"066230703","BUENOS AIRES",22,0,11,9,2,22,0
"066230803","BUENOS AIRES",10,1,4,5,0,9,0.1
"066230904","BUENOS AIRES",28,0,12,16,0,28,0
"066231101","BUENOS AIRES",21,0,7,13,0,20,0
"066231301","BUENOS AIRES",3,0,3,0,0,3,0
"066231302","BUENOS AIRES",8,1,3,4,0,7,0.125
"066231602","BUENOS AIRES",15,0,10,4,1,15,0
"067700503","BUENOS AIRES",2,0,0,1,0,1,0
"066231804","BUENOS AIRES",15,1,11,3,0,14,0.0666666666666667
"066231902","BUENOS AIRES",20,0,8,12,0,20,0
"065393111","BUENOS AIRES",385,3,203,170,0,373,0.00779220779220779
"065393112","BUENOS AIRES",366,2,307,54,0,361,0.00546448087431694
"068821801","BUENOS AIRES",56,0,12,27,14,53,0
"066510503","BUENOS AIRES",10,0,9,1,0,10,0
"066510603","BUENOS AIRES",8,1,4,3,0,7,0.125
"066510813","BUENOS AIRES",8,0,1,7,0,8,0
"066511203","BUENOS AIRES",15,0,10,4,0,14,0
"065393115","BUENOS AIRES",296,0,130,156,0,286,0
"065393116","BUENOS AIRES",387,0,230,145,2,377,0
"066860502","BUENOS AIRES",14,0,4,10,0,14,0
"066861202","BUENOS AIRES",4,0,3,1,0,4,0
"066650103","BUENOS AIRES",7,0,2,0,3,5,0
"066650104","BUENOS AIRES",13,0,4,9,0,13,0
"066650801","BUENOS AIRES",13,0,6,7,0,13,0
"066651006","BUENOS AIRES",8,0,6,2,0,8,0
"066860801","BUENOS AIRES",7,0,4,3,0,7,0
"065530312","BUENOS AIRES",32,24,6,1,0,7,0.75
"067281403","BUENOS AIRES",40,0,5,24,3,32,0
"067281405","BUENOS AIRES",35,1,9,21,1,31,0.0285714285714286
"067701505","BUENOS AIRES",11,1,7,2,1,10,0.0909090909090909
"067631202","BUENOS AIRES",18,0,10,8,0,18,0
"066651202","BUENOS AIRES",2,0,0,1,1,2,0
"066720104","BUENOS AIRES",14,0,9,5,0,14,0
"066720502","BUENOS AIRES",6,0,3,2,1,6,0
"066720903","BUENOS AIRES",15,0,8,7,0,15,0
"065393203","BUENOS AIRES",415,2,143,256,3,402,0.00481927710843374
"066721302","BUENOS AIRES",10,0,0,10,0,10,0
"066860204","BUENOS AIRES",2,0,1,1,0,2,0
"066860206","BUENOS AIRES",3,0,3,0,0,3,0
"066860210","BUENOS AIRES",1,0,1,0,0,1,0
"067281407","BUENOS AIRES",18,0,7,11,0,18,0
"067281502","BUENOS AIRES",20,0,10,9,0,19,0
"066860901","BUENOS AIRES",7,0,3,4,0,7,0
"066861001","BUENOS AIRES",4,0,1,3,0,4,0
"066861102","BUENOS AIRES",10,0,2,8,0,10,0
"066930101","BUENOS AIRES",48,0,10,32,3,45,0
"067600601","BUENOS AIRES",346,266,55,23,0,78,0.76878612716763
"065810506","BUENOS AIRES",149,149,0,0,0,0,1
"065393214","BUENOS AIRES",275,1,95,155,1,251,0.00363636363636364
"065393302","BUENOS AIRES",278,0,159,111,0,270,0
"067000104","BUENOS AIRES",5,0,4,1,0,5,0
"065393305","BUENOS AIRES",203,1,78,113,5,196,0.00492610837438424
"067000801","BUENOS AIRES",8,0,1,6,0,7,0
"067000903","BUENOS AIRES",5,0,4,1,0,5,0
"067280601","BUENOS AIRES",9,1,3,5,0,8,0.111111111111111
"067070606","BUENOS AIRES",56,0,26,29,0,55,0
"067350202","BUENOS AIRES",22,0,14,8,0,22,0
"067070702","BUENOS AIRES",48,0,16,30,1,47,0
"067140503","BUENOS AIRES",21,0,7,14,0,21,0
"065393308","BUENOS AIRES",407,2,222,176,3,401,0.00491400491400491
"065393309","BUENOS AIRES",438,2,193,223,3,419,0.0045662100456621
"067140905","BUENOS AIRES",6,0,5,1,0,6,0
"067210102","BUENOS AIRES",23,0,5,17,0,22,0
"067280403","BUENOS AIRES",4,0,1,3,0,4,0
"067281201","BUENOS AIRES",21,0,9,12,0,21,0
"065530310","BUENOS AIRES",22,21,1,0,0,1,0.954545454545455
"067350307","BUENOS AIRES",31,0,6,25,0,31,0
"067350603","BUENOS AIRES",2,0,1,1,0,2,0
"065393401","BUENOS AIRES",322,3,178,116,2,296,0.0093167701863354
"065393409","BUENOS AIRES",383,0,230,117,2,349,0
"067491508","BUENOS AIRES",58,1,24,25,4,53,0.0172413793103448
"065740416","BUENOS AIRES",237,10,91,136,0,227,0.0421940928270042
"067701604","BUENOS AIRES",9,0,5,4,0,9,0
"020120203","CABA",394,393,0,0,0,0,0.99746192893401
"065470201","BUENOS AIRES",198,3,130,65,0,195,0.0151515151515152
"067631603","BUENOS AIRES",19,0,3,16,0,19,0
"067631813","BUENOS AIRES",11,0,3,8,0,11,0
"067601110","BUENOS AIRES",422,0,282,127,0,409,0
"067700305","BUENOS AIRES",3,0,0,3,0,3,0
"067700705","BUENOS AIRES",7,0,1,6,0,7,0
"067700802","BUENOS AIRES",4,0,1,3,0,4,0
"067700805","BUENOS AIRES",3,0,1,2,0,3,0
"067700908","BUENOS AIRES",43,0,22,20,0,42,0
"067701802","BUENOS AIRES",8,0,4,4,0,8,0
"067701806","BUENOS AIRES",8,0,8,0,0,8,0
"067840101","BUENOS AIRES",5,0,1,3,0,4,0
"067840901","BUENOS AIRES",9,0,8,1,0,9,0
"067840902","BUENOS AIRES",5,0,2,3,0,5,0
"067910502","BUENOS AIRES",28,0,5,16,4,25,0
"065470307","BUENOS AIRES",402,363,5,32,0,37,0.902985074626866
"067911004","BUENOS AIRES",35,0,17,17,1,35,0
"065390508","BUENOS AIRES",350,346,4,0,0,4,0.988571428571429
"067911502","BUENOS AIRES",125,1,48,40,14,102,0.008
"067911701","BUENOS AIRES",42,0,24,14,1,39,0
"067980504","BUENOS AIRES",9,0,2,7,0,9,0
"067980706","BUENOS AIRES",37,0,7,30,0,37,0
"067980905","BUENOS AIRES",10,0,4,6,0,10,0
"067981004","BUENOS AIRES",20,0,13,6,0,19,0
"065470310","BUENOS AIRES",124,9,52,60,0,112,0.0725806451612903
"068052607","BUENOS AIRES",27,0,16,6,3,25,0
"065470909","BUENOS AIRES",303,298,2,1,0,3,0.983498349834984
"065530104","BUENOS AIRES",48,46,2,0,0,2,0.958333333333333
"065530109","BUENOS AIRES",51,50,0,0,0,0,0.980392156862745
"065530203","BUENOS AIRES",60,1,49,10,0,59,0.0166666666666667
"065530301","BUENOS AIRES",68,0,45,23,0,68,0
"065390807","BUENOS AIRES",273,2,220,45,0,265,0.00732600732600733
"065530314","BUENOS AIRES",45,15,21,6,0,27,0.333333333333333
"065600106","BUENOS AIRES",260,1,179,78,0,257,0.00384615384615385
"065600108","BUENOS AIRES",380,2,261,106,2,369,0.00526315789473684
"065601301","BUENOS AIRES",346,4,134,203,0,337,0.0115606936416185
"065600114","BUENOS AIRES",427,7,251,153,4,408,0.0163934426229508
"065600208","BUENOS AIRES",420,0,247,155,2,404,0
"065600513","BUENOS AIRES",397,2,214,168,0,382,0.00503778337531486
"065250416","BUENOS AIRES",135,2,53,76,0,129,0.0148148148148148
"065601117","BUENOS AIRES",257,5,196,52,1,249,0.0194552529182879
"065601201","BUENOS AIRES",360,10,195,151,0,346,0.0277777777777778
"065601203","BUENOS AIRES",435,8,219,184,2,405,0.0183908045977011
"065601210","BUENOS AIRES",265,5,190,69,0,259,0.0188679245283019
"065600303","BUENOS AIRES",314,1,168,139,0,307,0.00318471337579618
"065600406","BUENOS AIRES",213,3,100,100,0,200,0.0140845070422535
"065600401","BUENOS AIRES",302,6,220,65,0,285,0.0198675496688742
"065600411","BUENOS AIRES",305,0,181,118,1,300,0
"065600413","BUENOS AIRES",292,2,269,15,0,284,0.00684931506849315
"065600415","BUENOS AIRES",253,2,222,23,0,245,0.00790513833992095
"065600417","BUENOS AIRES",395,4,229,157,0,386,0.010126582278481
"065600512","BUENOS AIRES",285,3,181,87,0,268,0.0105263157894737
"065600610","BUENOS AIRES",382,1,198,167,10,375,0.00261780104712042
"065180702","BUENOS AIRES",42,0,35,6,0,41,0
"065180803","BUENOS AIRES",78,0,62,16,0,78,0
"065810410","BUENOS AIRES",185,185,0,0,0,0,1
"065600712","BUENOS AIRES",212,91,55,63,2,120,0.429245283018868
"065600805","BUENOS AIRES",282,20,153,105,0,258,0.0709219858156028
"065601310","BUENOS AIRES",458,8,313,131,0,444,0.0174672489082969
"065250204","BUENOS AIRES",146,2,134,10,0,144,0.0136986301369863
"060980501","BUENOS AIRES",290,74,114,95,1,210,0.255172413793103
"065250418","BUENOS AIRES",400,193,95,90,1,186,0.4825
"065250614","BUENOS AIRES",171,115,48,7,0,55,0.672514619883041
"065320104","BUENOS AIRES",334,326,3,2,0,5,0.976047904191617
"065320208","BUENOS AIRES",258,258,0,0,0,0,1
"065320301","BUENOS AIRES",320,240,16,59,0,75,0.75
"065320303","BUENOS AIRES",281,270,4,6,0,10,0.96085409252669
"065321404","BUENOS AIRES",316,312,1,3,0,4,0.987341772151899
"065321405","BUENOS AIRES",293,289,3,0,0,3,0.986348122866894
"065321508","BUENOS AIRES",293,83,111,98,0,209,0.283276450511945
"065390104","BUENOS AIRES",287,19,163,104,0,267,0.0662020905923345
"065390110","BUENOS AIRES",248,24,111,94,0,205,0.0967741935483871
"065390206","BUENOS AIRES",434,29,288,108,2,398,0.0668202764976959
"065390301","BUENOS AIRES",313,272,25,15,0,40,0.869009584664537
"065390414","BUENOS AIRES",176,174,2,0,0,2,0.988636363636364
"065390405","BUENOS AIRES",308,282,13,10,0,23,0.915584415584416
"020151710","CABA",342,342,0,0,0,0,1
"068052604","BUENOS AIRES",71,1,41,24,5,70,0.0140845070422535
"065390805","BUENOS AIRES",417,1,270,136,1,407,0.00239808153477218
"065390810","BUENOS AIRES",310,1,237,59,0,296,0.0032258064516129
"065390814","BUENOS AIRES",311,1,210,92,1,303,0.00321543408360129
"065391008","BUENOS AIRES",539,1,237,284,1,522,0.00185528756957328
"065810411","BUENOS AIRES",212,211,1,0,0,1,0.995283018867924
"065391101","BUENOS AIRES",315,0,230,81,0,311,0
"065391109","BUENOS AIRES",359,0,228,126,1,355,0
"065391112","BUENOS AIRES",250,1,196,49,0,245,0.004
"065391114","BUENOS AIRES",440,1,252,171,0,423,0.00227272727272727
"064410106","BUENOS AIRES",208,208,0,0,0,0,1
"064620708","BUENOS AIRES",282,180,48,53,0,101,0.638297872340426
"065811602","BUENOS AIRES",342,330,6,5,0,11,0.964912280701754
"068821703","BUENOS AIRES",421,52,150,217,2,369,0.123515439429929
"060980404","BUENOS AIRES",101,2,57,31,5,93,0.0198019801980198
"061051001","BUENOS AIRES",54,0,27,24,1,52,0
"061121003","BUENOS AIRES",376,78,182,116,0,298,0.207446808510638
"065682011","BUENOS AIRES",422,369,40,10,0,50,0.874407582938389
"060141007","BUENOS AIRES",137,5,62,67,1,130,0.0364963503649635
"060490407","BUENOS AIRES",176,2,47,123,0,170,0.0113636363636364
"060562301","BUENOS AIRES",195,14,49,114,7,170,0.0717948717948718
"061121109","BUENOS AIRES",435,17,169,242,2,413,0.0390804597701149
"061190401","BUENOS AIRES",153,0,92,53,1,146,0
"061610403","BUENOS AIRES",176,3,73,99,0,172,0.0170454545454545
"061260913","BUENOS AIRES",114,45,48,21,0,69,0.394736842105263
"061610406","BUENOS AIRES",131,2,48,80,0,128,0.0152671755725191
"061681001","BUENOS AIRES",95,48,31,14,0,45,0.505263157894737
"061820501","BUENOS AIRES",142,5,111,25,1,137,0.0352112676056338
"065682205","BUENOS AIRES",117,109,4,4,0,8,0.931623931623932
"062100803","BUENOS AIRES",314,126,65,115,0,180,0.401273885350318
"062240603","BUENOS AIRES",36,0,16,16,0,32,0
"062240904","BUENOS AIRES",59,0,12,46,0,58,0
"062520102","BUENOS AIRES",274,24,130,109,2,241,0.0875912408759124
"063510903","BUENOS AIRES",45,0,21,23,0,44,0
"066381319","BUENOS AIRES",196,1,146,47,0,193,0.00510204081632653
"062700804","BUENOS AIRES",19,0,12,7,0,19,0
"062700817","BUENOS AIRES",37,0,37,0,0,37,0
"062800908","BUENOS AIRES",11,0,7,3,1,11,0
"062940801","BUENOS AIRES",64,47,11,5,0,16,0.734375
"064970301","BUENOS AIRES",9,3,4,2,0,6,0.333333333333333
"064970804","BUENOS AIRES",71,0,32,38,0,70,0
"066382303","BUENOS AIRES",70,1,41,26,2,69,0.0142857142857143
"063010801","BUENOS AIRES",91,0,40,51,0,91,0
"065392509","BUENOS AIRES",407,6,212,171,2,385,0.0147420147420147
"063361002","BUENOS AIRES",147,0,75,68,1,144,0
"065682209","BUENOS AIRES",169,120,45,4,0,49,0.710059171597633
"020030701","CABA",136,135,0,1,0,1,0.992647058823529
"063640301","BUENOS AIRES",209,0,48,149,2,199,0
"066550309","BUENOS AIRES",275,206,28,39,0,67,0.749090909090909
"063990105","BUENOS AIRES",238,156,36,45,0,81,0.65546218487395
"064131410","BUENOS AIRES",0,0,0,0,0,0,NA
"064970808","BUENOS AIRES",79,0,39,40,0,79,0
"065682217","BUENOS AIRES",199,180,17,2,0,19,0.904522613065327
"063990504","BUENOS AIRES",68,0,40,28,0,68,0
"063990702","BUENOS AIRES",93,57,26,9,0,35,0.612903225806452
"064971208","BUENOS AIRES",118,102,14,2,0,16,0.864406779661017
"065050205","BUENOS AIRES",93,0,52,40,1,93,0
"064275115","BUENOS AIRES",85,5,36,40,0,76,0.0588235294117647
"064621002","BUENOS AIRES",346,186,42,91,2,135,0.53757225433526
"064691002","BUENOS AIRES",81,0,50,31,0,81,0
"064691305","BUENOS AIRES",120,2,56,58,1,115,0.0166666666666667
"064830803","BUENOS AIRES",30,1,17,12,0,29,0.0333333333333333
"066550311","BUENOS AIRES",407,317,34,52,0,86,0.778869778869779
"065050305","BUENOS AIRES",52,0,35,17,0,52,0
"065050322","BUENOS AIRES",193,31,54,94,1,149,0.160621761658031
"065320905","BUENOS AIRES",178,36,76,63,1,140,0.202247191011236
"066160308","BUENOS AIRES",42,10,22,10,0,32,0.238095238095238
"067910802","BUENOS AIRES",39,0,8,29,2,39,0
"065952107","BUENOS AIRES",60,10,25,24,0,49,0.166666666666667
"065952708","BUENOS AIRES",98,5,73,20,0,93,0.0510204081632653
"066020805","BUENOS AIRES",97,0,38,49,6,93,0
"066160101","BUENOS AIRES",25,14,6,5,0,11,0.56
"066300601","BUENOS AIRES",134,0,64,64,4,132,0
"066382210","BUENOS AIRES",166,2,124,39,0,163,0.0120481927710843
"066380814","BUENOS AIRES",164,1,64,78,2,144,0.00609756097560976
"066381111","BUENOS AIRES",275,0,90,160,9,259,0
"066382103","BUENOS AIRES",71,11,55,4,0,59,0.154929577464789
"020131004","CABA",417,416,1,0,0,1,0.997601918465228
"066440502","BUENOS AIRES",141,6,105,27,0,132,0.0425531914893617
"068821709","BUENOS AIRES",92,27,13,44,1,58,0.293478260869565
"067780402","BUENOS AIRES",32,0,5,26,1,32,0
"065682303","BUENOS AIRES",286,282,3,1,0,4,0.986013986013986
"066721210","BUENOS AIRES",651,548,35,62,2,99,0.841781874039939
"067280903","BUENOS AIRES",130,5,77,47,1,125,0.0384615384615385
"067701804","BUENOS AIRES",10,0,8,1,0,9,0
"067702202","BUENOS AIRES",318,225,17,60,0,77,0.707547169811321
"068821003","BUENOS AIRES",303,299,4,0,0,4,0.986798679867987
"067780404","BUENOS AIRES",126,0,54,67,4,125,0
"068261303","BUENOS AIRES",46,0,26,16,3,45,0
"068540111","BUENOS AIRES",596,177,154,258,1,413,0.296979865771812
"068751506","BUENOS AIRES",366,3,86,193,38,317,0.00819672131147541
"068821707","BUENOS AIRES",173,13,111,48,0,159,0.0751445086705202
"062450412","BUENOS AIRES",82,3,35,43,0,78,0.0365853658536585
"066550209","BUENOS AIRES",60,0,41,18,0,59,0
"065681706","BUENOS AIRES",399,7,318,73,0,391,0.0175438596491228
"065681712","BUENOS AIRES",284,283,0,1,0,1,0.996478873239437
"065681806","BUENOS AIRES",179,178,1,0,0,1,0.994413407821229
"065681809","BUENOS AIRES",361,355,5,1,0,6,0.983379501385042
"065681911","BUENOS AIRES",381,5,245,127,0,372,0.0131233595800525
"065682006","BUENOS AIRES",223,222,1,0,0,1,0.995515695067265
"068821710","BUENOS AIRES",359,10,114,218,3,335,0.0278551532033426
"065681405","BUENOS AIRES",184,180,4,0,0,4,0.978260869565217
"065681502","BUENOS AIRES",356,19,230,104,2,336,0.0533707865168539
"065681505","BUENOS AIRES",312,302,6,4,0,10,0.967948717948718
"065681602","BUENOS AIRES",337,44,225,63,0,288,0.130563798219585
"065681604","BUENOS AIRES",438,379,43,15,0,58,0.865296803652968
"065681811","BUENOS AIRES",304,50,218,35,1,254,0.164473684210526
"065682406","BUENOS AIRES",249,248,1,0,0,1,0.995983935742972
"065682502","BUENOS AIRES",314,310,3,0,0,3,0.987261146496815
"065682508","BUENOS AIRES",378,210,106,58,0,164,0.555555555555556
"065682511","BUENOS AIRES",420,14,310,96,0,406,0.0333333333333333
"065682609","BUENOS AIRES",229,84,87,58,0,145,0.366812227074236
"065682612","BUENOS AIRES",367,9,278,77,1,356,0.0245231607629428
"065682704","BUENOS AIRES",307,0,212,90,0,302,0
"068050403","BUENOS AIRES",535,9,172,308,17,497,0.0168224299065421
"065683007","BUENOS AIRES",435,2,278,135,0,413,0.00459770114942529
"065683011","BUENOS AIRES",427,16,315,89,0,404,0.0374707259953162
"065683102","BUENOS AIRES",398,11,293,93,0,386,0.0276381909547739
"065683107","BUENOS AIRES",402,6,337,52,1,390,0.0149253731343284
"065740805","BUENOS AIRES",94,1,52,41,0,93,0.0106382978723404
"065810111","BUENOS AIRES",239,216,13,8,0,21,0.903765690376569
"065810201","BUENOS AIRES",291,269,2,18,0,20,0.924398625429553
"065810207","BUENOS AIRES",291,279,2,10,0,12,0.958762886597938
"065810809","BUENOS AIRES",180,1,18,157,3,178,0.00555555555555556
"065810810","BUENOS AIRES",173,1,58,114,0,172,0.00578034682080925
"065811001","BUENOS AIRES",141,6,34,97,1,132,0.0425531914893617
"068052109","BUENOS AIRES",325,5,192,118,1,311,0.0153846153846154
"066583208","BUENOS AIRES",548,528,7,10,0,17,0.963503649635037
"065811301","BUENOS AIRES",248,159,11,78,0,89,0.641129032258065
"065811308","BUENOS AIRES",191,4,83,97,2,182,0.0209424083769634
"065811405","BUENOS AIRES",163,4,32,123,0,155,0.0245398773006135
"065811407","BUENOS AIRES",236,64,48,115,2,165,0.271186440677966
"065811507","BUENOS AIRES",403,302,12,85,1,98,0.749379652605459
"068052510","BUENOS AIRES",282,0,205,70,0,275,0
"065811901","BUENOS AIRES",84,1,31,50,0,81,0.0119047619047619
"065811903","BUENOS AIRES",124,77,11,36,0,47,0.620967741935484
"065811907","BUENOS AIRES",137,30,48,58,0,106,0.218978102189781
"065880104","BUENOS AIRES",334,321,3,10,0,13,0.961077844311377
"065880115","BUENOS AIRES",213,201,4,7,0,11,0.943661971830986
"065880207","BUENOS AIRES",226,225,0,1,0,1,0.995575221238938
"065880703","BUENOS AIRES",95,0,21,72,0,93,0
"065880914","BUENOS AIRES",184,113,41,29,0,70,0.614130434782609
"068120504","BUENOS AIRES",3,0,2,1,0,3,0
"065881601","BUENOS AIRES",279,177,48,54,0,102,0.634408602150538
"065881703","BUENOS AIRES",240,215,12,13,0,25,0.895833333333333
"065950108","BUENOS AIRES",373,337,10,25,0,35,0.903485254691689
"065950110","BUENOS AIRES",371,334,9,28,0,37,0.900269541778976
"065950210","BUENOS AIRES",424,410,7,6,0,13,0.966981132075472
"065950306","BUENOS AIRES",295,293,1,1,0,2,0.993220338983051
"065950409","BUENOS AIRES",333,22,186,122,0,308,0.0660660660660661
"068611915","BUENOS AIRES",199,191,7,1,0,8,0.959798994974874
"065951606","BUENOS AIRES",241,3,175,61,0,236,0.012448132780083
"068260205","BUENOS AIRES",151,138,9,4,0,13,0.913907284768212
"065952605","BUENOS AIRES",361,29,137,184,2,323,0.0803324099722992
"065952101","BUENOS AIRES",175,0,120,54,0,174,0
"065952402","BUENOS AIRES",307,295,7,5,0,12,0.960912052117264
"065952506","BUENOS AIRES",274,4,229,38,0,267,0.0145985401459854
"065952604","BUENOS AIRES",239,26,106,102,2,210,0.108786610878661
"065952701","BUENOS AIRES",333,60,231,40,2,273,0.18018018018018
"066020309","BUENOS AIRES",248,35,122,88,3,213,0.141129032258065
"066020901","BUENOS AIRES",34,0,19,15,0,34,0
"066021103","BUENOS AIRES",378,201,72,91,2,165,0.531746031746032
"067600116","BUENOS AIRES",224,217,4,1,0,5,0.96875
"066021105","BUENOS AIRES",224,210,12,2,0,14,0.9375
"066021602","BUENOS AIRES",175,80,31,54,0,85,0.457142857142857
"066021405","BUENOS AIRES",43,0,35,7,0,42,0
"066021605","BUENOS AIRES",281,237,37,7,0,44,0.843416370106762
"066021612","BUENOS AIRES",16,0,9,5,1,15,0
"066090206","BUENOS AIRES",418,34,182,192,2,376,0.0813397129186603
"066090903","BUENOS AIRES",219,1,127,87,4,218,0.0045662100456621
"066160304","BUENOS AIRES",254,221,19,13,1,33,0.87007874015748
"066230105","BUENOS AIRES",331,307,10,13,0,23,0.927492447129909
"066230209","BUENOS AIRES",326,299,12,14,1,27,0.917177914110429
"066230308","BUENOS AIRES",236,236,0,0,0,0,1
"066230309","BUENOS AIRES",223,223,0,0,0,0,1
"066230501","BUENOS AIRES",337,293,20,24,0,44,0.869436201780415
"066230502","BUENOS AIRES",254,208,19,27,0,46,0.818897637795276
"066230505","BUENOS AIRES",423,353,16,53,1,70,0.83451536643026
"066230509","BUENOS AIRES",270,204,20,46,0,66,0.755555555555556
"066230510","BUENOS AIRES",370,312,26,32,0,58,0.843243243243243
"066230902","BUENOS AIRES",170,1,132,34,0,166,0.00588235294117647
"066231401","BUENOS AIRES",277,3,187,86,0,273,0.0108303249097473
"066231605","BUENOS AIRES",230,5,145,78,1,224,0.0217391304347826
"066232202","BUENOS AIRES",245,181,35,29,0,64,0.738775510204082
"066232214","BUENOS AIRES",56,20,22,14,0,36,0.357142857142857
"066232301","BUENOS AIRES",181,0,134,47,0,181,0
"066232304","BUENOS AIRES",119,0,66,49,1,116,0
"020121303","CABA",721,720,1,0,0,1,0.998613037447989
"066232801","BUENOS AIRES",432,168,65,185,1,251,0.388888888888889
"020132906","CABA",330,329,1,0,0,1,0.996969696969697
"066300205","BUENOS AIRES",185,163,14,6,2,22,0.881081081081081
"066380113","BUENOS AIRES",792,362,143,254,3,400,0.457070707070707
"066380206","BUENOS AIRES",246,0,149,85,11,245,0
"066381308","BUENOS AIRES",275,0,124,137,4,265,0
"066381309","BUENOS AIRES",281,2,151,116,0,267,0.00711743772241993
"020132808","CABA",451,451,0,0,0,0,1
"066380406","BUENOS AIRES",299,194,37,63,0,100,0.648829431438127
"066380408","BUENOS AIRES",347,2,235,108,1,344,0.00576368876080692
"066380509","BUENOS AIRES",262,0,118,134,4,256,0
"066380514","BUENOS AIRES",369,5,227,123,1,351,0.013550135501355
"066380615","BUENOS AIRES",383,0,231,137,1,369,0
"066380808","BUENOS AIRES",509,13,258,223,0,481,0.0255402750491159
"066380811","BUENOS AIRES",191,1,173,17,0,190,0.00523560209424084
"068611509","BUENOS AIRES",255,254,0,1,0,1,0.996078431372549
"066380905","BUENOS AIRES",310,2,230,73,0,303,0.00645161290322581
"066381001","BUENOS AIRES",362,1,197,149,0,346,0.00276243093922652
"066381009","BUENOS AIRES",379,2,198,168,1,367,0.00527704485488127
"068401306","BUENOS AIRES",233,231,1,0,0,1,0.991416309012876
"066381314","BUENOS AIRES",101,1,61,39,0,100,0.0099009900990099
"067630305","BUENOS AIRES",236,235,0,0,0,0,0.995762711864407
"066381318","BUENOS AIRES",412,5,292,111,0,403,0.0121359223300971
"066381406","BUENOS AIRES",343,0,170,167,2,339,0
"066381502","BUENOS AIRES",145,1,96,47,0,143,0.00689655172413793
"066381505","BUENOS AIRES",180,2,109,68,1,178,0.0111111111111111
"066381509","BUENOS AIRES",361,3,173,174,0,347,0.00831024930747922
"066381512","BUENOS AIRES",431,1,310,118,0,428,0.00232018561484919
"066381601","BUENOS AIRES",363,353,7,3,0,10,0.972451790633609
"068613307","BUENOS AIRES",322,298,18,0,0,18,0.925465838509317
"066381712","BUENOS AIRES",376,217,95,60,0,155,0.577127659574468
"066381903","BUENOS AIRES",328,16,187,117,2,306,0.0487804878048781
"068680607","BUENOS AIRES",39,35,4,0,0,4,0.897435897435897
"066382203","BUENOS AIRES",252,3,126,113,0,239,0.0119047619047619
"066382104","BUENOS AIRES",291,172,80,38,0,118,0.59106529209622
"066382205","BUENOS AIRES",312,17,125,155,3,283,0.0544871794871795
"066382206","BUENOS AIRES",641,13,306,305,1,612,0.0202808112324493
"066382213","BUENOS AIRES",233,0,95,132,5,232,0
"066440103","BUENOS AIRES",114,106,8,0,0,8,0.929824561403509
"068820107","BUENOS AIRES",350,349,1,0,0,1,0.997142857142857
"066440601","BUENOS AIRES",259,150,48,55,2,105,0.579150579150579
"066440603","BUENOS AIRES",135,5,97,30,0,127,0.037037037037037
"066440611","BUENOS AIRES",82,0,46,33,0,79,0
"066480103","BUENOS AIRES",455,11,311,122,0,433,0.0241758241758242
"066480409","BUENOS AIRES",37,0,15,21,0,36,0
"066480106","BUENOS AIRES",376,1,297,77,0,374,0.00265957446808511
"066480112","BUENOS AIRES",376,13,194,155,1,350,0.0345744680851064
"066480116","BUENOS AIRES",280,3,174,95,0,269,0.0107142857142857
"066480119","BUENOS AIRES",313,2,128,170,0,298,0.00638977635782748
"066480503","BUENOS AIRES",263,2,123,123,0,246,0.00760456273764259
"020132904","CABA",382,381,1,0,0,1,0.99738219895288
"066480204","BUENOS AIRES",310,0,133,155,2,290,0
"066480303","BUENOS AIRES",60,0,31,26,0,57,0
"066480309","BUENOS AIRES",417,19,213,162,4,379,0.0455635491606715
"066480311","BUENOS AIRES",258,2,39,179,6,224,0.00775193798449612
"066480312","BUENOS AIRES",325,0,198,116,0,314,0
"066480402","BUENOS AIRES",238,0,117,106,3,226,0
"020140407","CABA",432,432,0,0,0,0,1
"066510105","BUENOS AIRES",274,10,191,73,0,264,0.0364963503649635
"066510108","BUENOS AIRES",339,52,215,72,0,287,0.153392330383481
"066510401","BUENOS AIRES",11,0,4,7,0,11,0
"066510511","BUENOS AIRES",323,194,107,22,0,129,0.60061919504644
"066580514","BUENOS AIRES",286,281,1,2,0,3,0.982517482517482
"066510716","BUENOS AIRES",119,0,86,32,1,119,0
"066511302","BUENOS AIRES",36,0,17,18,1,36,0
"066550210","BUENOS AIRES",158,33,96,29,0,125,0.208860759493671
"066550301","BUENOS AIRES",38,1,23,12,1,36,0.0263157894736842
"066580107","BUENOS AIRES",243,243,0,0,0,0,1
"066580308","BUENOS AIRES",470,458,7,2,0,9,0.974468085106383
"066580309","BUENOS AIRES",452,452,0,0,0,0,1
"066581205","BUENOS AIRES",325,323,1,1,0,2,0.993846153846154
"066580403","BUENOS AIRES",338,199,19,117,0,136,0.588757396449704
"066580406","BUENOS AIRES",283,266,0,13,0,13,0.939929328621908
"066580415","BUENOS AIRES",288,281,2,3,0,5,0.975694444444444
"066580509","BUENOS AIRES",363,357,4,1,0,5,0.983471074380165
"066580512","BUENOS AIRES",266,263,3,0,0,3,0.988721804511278
"066580607","BUENOS AIRES",269,268,1,0,0,1,0.996282527881041
"066580609","BUENOS AIRES",403,399,2,1,0,3,0.990074441687345
"066580706","BUENOS AIRES",270,261,4,3,0,7,0.966666666666667
"066580803","BUENOS AIRES",169,168,1,0,0,1,0.994082840236686
"066580808","BUENOS AIRES",216,216,0,0,0,0,1
"066580901","BUENOS AIRES",334,332,1,1,0,2,0.994011976047904
"066581008","BUENOS AIRES",304,302,0,1,0,1,0.993421052631579
"066581013","BUENOS AIRES",233,66,13,136,0,149,0.283261802575107
"066581202","BUENOS AIRES",353,346,4,3,0,7,0.980169971671388
"066581211","BUENOS AIRES",344,344,0,0,0,0,1
"066581306","BUENOS AIRES",214,4,22,176,7,205,0.0186915887850467
"066581502","BUENOS AIRES",302,269,11,20,0,31,0.890728476821192
"066581503","BUENOS AIRES",325,194,19,106,0,125,0.596923076923077
"066581506","BUENOS AIRES",183,177,1,5,0,6,0.967213114754098
"066581507","BUENOS AIRES",262,255,6,1,0,7,0.973282442748092
"066581513","BUENOS AIRES",241,238,2,0,0,2,0.987551867219917
"066581601","BUENOS AIRES",261,258,1,0,0,1,0.988505747126437
"066581606","BUENOS AIRES",265,263,2,0,0,2,0.992452830188679
"066581701","BUENOS AIRES",300,289,2,0,0,2,0.963333333333333
"066581703","BUENOS AIRES",254,254,0,0,0,0,1
"066581707","BUENOS AIRES",298,294,2,1,0,3,0.986577181208054
"066581902","BUENOS AIRES",265,265,0,0,0,0,1
"066581906","BUENOS AIRES",190,188,1,1,0,2,0.989473684210526
"066582007","BUENOS AIRES",259,246,1,8,0,9,0.94980694980695
"066582102","BUENOS AIRES",478,454,8,14,0,22,0.949790794979079
"066861314","BUENOS AIRES",190,178,11,1,0,12,0.936842105263158
"066582108","BUENOS AIRES",582,199,46,317,2,365,0.34192439862543
"066582109","BUENOS AIRES",367,349,4,11,1,16,0.950953678474114
"066582113","BUENOS AIRES",505,402,28,64,2,94,0.796039603960396
"066582210","BUENOS AIRES",379,362,9,5,0,14,0.955145118733509
"066582302","BUENOS AIRES",379,360,5,6,0,11,0.949868073878628
"066582303","BUENOS AIRES",450,430,12,7,0,19,0.955555555555556
"066582304","BUENOS AIRES",324,268,23,23,0,46,0.827160493827161
"066582408","BUENOS AIRES",271,268,1,0,0,1,0.988929889298893
"066582501","BUENOS AIRES",224,223,1,0,0,1,0.995535714285714
"066582502","BUENOS AIRES",238,238,0,0,0,0,1
"066582511","BUENOS AIRES",391,118,30,231,0,261,0.301790281329923
"066582610","BUENOS AIRES",368,364,4,0,0,4,0.989130434782609
"066582701","BUENOS AIRES",389,4,98,274,0,372,0.0102827763496144
"066582711","BUENOS AIRES",422,47,89,255,3,347,0.111374407582938
"066582803","BUENOS AIRES",293,291,1,1,0,2,0.993174061433447
"020020610","CABA",228,228,0,0,0,0,1
"066582807","BUENOS AIRES",332,25,98,194,1,293,0.0753012048192771
"066582809","BUENOS AIRES",370,357,4,4,0,8,0.964864864864865
"066582904","BUENOS AIRES",258,218,34,5,0,39,0.844961240310077
"066582909","BUENOS AIRES",295,4,53,218,4,275,0.0135593220338983
"066583002","BUENOS AIRES",374,93,101,178,0,279,0.248663101604278
"066583005","BUENOS AIRES",373,27,163,179,0,342,0.0723860589812333
"066583110","BUENOS AIRES",420,7,164,242,0,406,0.0166666666666667
"066583111","BUENOS AIRES",392,6,196,186,0,382,0.0153061224489796
"066583301","BUENOS AIRES",553,365,49,128,2,179,0.66003616636528
"066583310","BUENOS AIRES",276,264,8,4,0,12,0.956521739130435
"066583401","BUENOS AIRES",403,8,212,177,0,389,0.0198511166253102
"066583408","BUENOS AIRES",340,327,6,6,0,12,0.961764705882353
"066583506","BUENOS AIRES",416,368,20,26,0,46,0.884615384615385
"066583609","BUENOS AIRES",352,24,136,175,10,321,0.0681818181818182
"066583610","BUENOS AIRES",309,24,83,201,0,284,0.0776699029126214
"066583613","BUENOS AIRES",336,17,44,249,8,301,0.0505952380952381
"066583816","BUENOS AIRES",604,243,45,265,22,332,0.402317880794702
"066583906","BUENOS AIRES",318,8,133,165,0,298,0.0251572327044025
"066584005","BUENOS AIRES",348,5,35,279,10,324,0.014367816091954
"066584011","BUENOS AIRES",212,14,65,124,0,189,0.0660377358490566
"066584103","BUENOS AIRES",421,9,198,191,3,392,0.0213776722090261
"066584108","BUENOS AIRES",425,9,132,228,1,361,0.0211764705882353
"066584208","BUENOS AIRES",341,231,83,21,0,104,0.67741935483871
"066584213","BUENOS AIRES",450,27,264,144,0,408,0.06
"066584402","BUENOS AIRES",352,20,148,150,17,315,0.0568181818181818
"066584412","BUENOS AIRES",393,6,141,199,25,365,0.0152671755725191
"066650206","BUENOS AIRES",227,141,16,48,2,66,0.621145374449339
"066650307","BUENOS AIRES",135,103,3,26,0,29,0.762962962962963
"066721209","BUENOS AIRES",287,255,10,20,0,30,0.888501742160279
"066790302","BUENOS AIRES",149,5,115,25,1,141,0.0335570469798658
"066790304","BUENOS AIRES",111,0,87,24,0,111,0
"066790602","BUENOS AIRES",265,117,73,68,2,143,0.441509433962264
"066790611","BUENOS AIRES",266,207,30,28,0,58,0.778195488721805
"066790612","BUENOS AIRES",217,158,45,13,0,58,0.728110599078341
"066791202","BUENOS AIRES",16,0,6,8,0,14,0
"066860103","BUENOS AIRES",346,299,12,34,0,46,0.864161849710983
"066860104","BUENOS AIRES",340,287,17,33,1,51,0.844117647058824
"066861301","BUENOS AIRES",140,51,25,59,1,85,0.364285714285714
"066861308","BUENOS AIRES",146,47,45,53,1,99,0.321917808219178
"066861313","BUENOS AIRES",283,276,7,0,0,7,0.975265017667845
"020132503","CABA",392,373,19,0,0,19,0.951530612244898
"066930308","BUENOS AIRES",234,150,54,28,2,84,0.641025641025641
"066930314","BUENOS AIRES",187,66,84,36,0,120,0.352941176470588
"067000212","BUENOS AIRES",236,204,14,17,1,32,0.864406779661017
"067000604","BUENOS AIRES",252,6,177,68,0,245,0.0238095238095238
"067001212","BUENOS AIRES",375,360,10,5,0,15,0.96
"067070103","BUENOS AIRES",222,174,12,35,0,47,0.783783783783784
"067070114","BUENOS AIRES",151,30,82,39,0,121,0.198675496688742
"067210205","BUENOS AIRES",367,146,111,109,0,220,0.397820163487738
"067281003","BUENOS AIRES",283,175,49,45,0,94,0.618374558303887
"067281013","BUENOS AIRES",209,105,56,47,1,104,0.502392344497608
"067281014","BUENOS AIRES",171,102,40,29,0,69,0.596491228070175
"067281017","BUENOS AIRES",182,76,54,52,0,106,0.417582417582418
"067350106","BUENOS AIRES",379,201,59,119,0,178,0.530343007915567
"067350706","BUENOS AIRES",400,114,91,188,0,279,0.285
"067420403","BUENOS AIRES",242,224,10,7,0,17,0.925619834710744
"067420407","BUENOS AIRES",249,203,13,29,0,42,0.815261044176707
"067420413","BUENOS AIRES",258,229,20,9,0,29,0.887596899224806
"067490101","BUENOS AIRES",25,5,0,18,2,20,0.2
"067490205","BUENOS AIRES",328,284,35,9,0,44,0.865853658536585
"067490207","BUENOS AIRES",246,214,17,2,13,32,0.869918699186992
"067490209","BUENOS AIRES",343,338,2,3,0,5,0.985422740524781
"020141707","CABA",316,316,0,0,0,0,1
"067490701","BUENOS AIRES",382,194,93,92,0,185,0.507853403141361
"067490707","BUENOS AIRES",375,361,7,6,0,13,0.962666666666667
"067490903","BUENOS AIRES",447,401,22,20,0,42,0.897091722595078
"067490909","BUENOS AIRES",329,47,70,212,0,282,0.142857142857143
"067490910","BUENOS AIRES",261,10,114,136,0,250,0.0383141762452107
"067491006","BUENOS AIRES",400,382,17,1,0,18,0.955
"067491101","BUENOS AIRES",295,22,120,144,0,264,0.0745762711864407
"067491110","BUENOS AIRES",329,306,3,4,0,7,0.930091185410334
"067491204","BUENOS AIRES",423,371,29,21,0,50,0.877068557919622
"067491302","BUENOS AIRES",437,416,4,1,0,5,0.951945080091533
"067491304","BUENOS AIRES",434,333,41,44,0,85,0.767281105990783
"067491319","BUENOS AIRES",337,309,16,12,0,28,0.916913946587537
"067560103","BUENOS AIRES",201,200,1,0,0,1,0.995024875621891
"067560201","BUENOS AIRES",275,268,6,1,0,7,0.974545454545454
"067560911","BUENOS AIRES",273,264,5,4,0,9,0.967032967032967
"067561110","BUENOS AIRES",242,242,0,0,0,0,1
"067561111","BUENOS AIRES",309,307,2,0,0,2,0.993527508090615
"067600204","BUENOS AIRES",279,276,2,1,0,3,0.989247311827957
"067560203","BUENOS AIRES",394,366,6,9,12,27,0.928934010152284
"067560301","BUENOS AIRES",185,185,0,0,0,0,1
"067560309","BUENOS AIRES",238,236,0,1,0,1,0.991596638655462
"067560609","BUENOS AIRES",270,270,0,0,0,0,1
"067560702","BUENOS AIRES",223,223,0,0,0,0,1
"067560703","BUENOS AIRES",150,150,0,0,0,0,1
"067560803","BUENOS AIRES",328,326,2,0,0,2,0.99390243902439
"067561204","BUENOS AIRES",513,331,110,71,0,181,0.645224171539961
"067561206","BUENOS AIRES",188,188,0,0,0,0,1
"067561304","BUENOS AIRES",328,307,8,13,0,21,0.935975609756098
"067561307","BUENOS AIRES",322,297,12,12,0,24,0.922360248447205
"067561311","BUENOS AIRES",426,414,4,7,0,11,0.971830985915493
"067561405","BUENOS AIRES",236,226,5,4,0,9,0.957627118644068
"067561413","BUENOS AIRES",207,5,30,167,3,200,0.0241545893719807
"067561509","BUENOS AIRES",213,10,82,121,0,203,0.0469483568075117
"067561603","BUENOS AIRES",340,272,51,17,0,68,0.8
"067600109","BUENOS AIRES",495,2,278,205,1,484,0.00404040404040404
"067561704","BUENOS AIRES",314,310,3,1,0,4,0.987261146496815
"067561706","BUENOS AIRES",313,305,4,4,0,8,0.97444089456869
"067562106","BUENOS AIRES",313,195,104,14,0,118,0.623003194888179
"067562207","BUENOS AIRES",283,7,162,113,0,275,0.0247349823321555
"067562310","BUENOS AIRES",307,289,6,5,0,11,0.941368078175896
"067562501","BUENOS AIRES",297,95,74,113,0,187,0.31986531986532
"067562516","BUENOS AIRES",359,14,207,135,2,344,0.0389972144846797
"067562604","BUENOS AIRES",249,227,18,4,0,22,0.911646586345382
"067562610","BUENOS AIRES",194,184,6,1,0,7,0.948453608247423
"067562611","BUENOS AIRES",400,375,20,2,0,22,0.9375
"067562703","BUENOS AIRES",342,327,5,2,0,7,0.956140350877193
"067562708","BUENOS AIRES",249,7,186,56,0,242,0.0281124497991968
"067600108","BUENOS AIRES",456,328,70,53,1,124,0.719298245614035
"067600207","BUENOS AIRES",321,312,5,1,1,7,0.97196261682243
"067600213","BUENOS AIRES",373,373,0,0,0,0,1
"067600309","BUENOS AIRES",203,186,15,2,0,17,0.916256157635468
"067600313","BUENOS AIRES",440,432,3,3,0,6,0.981818181818182
"067600510","BUENOS AIRES",597,540,38,15,0,53,0.904522613065327
"067600606","BUENOS AIRES",283,236,38,9,0,47,0.833922261484099
"067600607","BUENOS AIRES",341,6,274,56,1,331,0.0175953079178886
"067600608","BUENOS AIRES",380,14,318,44,1,363,0.0368421052631579
"067600805","BUENOS AIRES",226,189,35,2,0,37,0.836283185840708
"067600903","BUENOS AIRES",350,339,2,4,0,6,0.968571428571429
"067600910","BUENOS AIRES",427,413,12,1,0,13,0.967213114754098
"067601005","BUENOS AIRES",215,1,130,75,1,206,0.00465116279069767
"067601009","BUENOS AIRES",249,0,184,64,1,249,0
"067601103","BUENOS AIRES",587,268,169,144,1,314,0.456558773424191
"067601805","BUENOS AIRES",243,0,164,73,0,237,0
"067601109","BUENOS AIRES",243,15,186,42,0,228,0.0617283950617284
"067601112","BUENOS AIRES",226,3,142,79,0,221,0.0132743362831858
"067601114","BUENOS AIRES",171,33,112,26,0,138,0.192982456140351
"067601117","BUENOS AIRES",226,2,152,70,1,223,0.00884955752212389
"067601219","BUENOS AIRES",301,5,82,190,1,273,0.0166112956810631
"067601410","BUENOS AIRES",347,0,196,132,0,328,0
"067601412","BUENOS AIRES",412,19,145,225,0,370,0.0461165048543689
"067601601","BUENOS AIRES",290,1,185,101,0,286,0.00344827586206897
"067601605","BUENOS AIRES",364,1,225,118,0,343,0.00274725274725275
"067601610","BUENOS AIRES",277,1,169,92,1,262,0.0036101083032491
"067601702","BUENOS AIRES",353,1,254,84,1,339,0.0028328611898017
"067601709","BUENOS AIRES",292,0,172,115,0,287,0
"067601802","BUENOS AIRES",308,1,184,110,3,297,0.00324675324675325
"067601816","BUENOS AIRES",256,1,126,125,0,251,0.00390625
"067630210","BUENOS AIRES",325,319,4,2,0,6,0.981538461538462
"067630213","BUENOS AIRES",100,100,0,0,0,0,1
"067630402","BUENOS AIRES",384,375,8,0,0,8,0.9765625
"067630403","BUENOS AIRES",309,303,3,1,0,4,0.980582524271845
"067630404","BUENOS AIRES",234,218,6,6,0,12,0.931623931623932
"067630514","BUENOS AIRES",353,136,108,104,0,212,0.385269121813031
"067630613","BUENOS AIRES",305,277,13,11,0,24,0.908196721311475
"067630707","BUENOS AIRES",330,87,206,36,0,242,0.263636363636364
"067630708","BUENOS AIRES",278,122,89,22,0,111,0.438848920863309
"067630709","BUENOS AIRES",221,125,69,27,0,96,0.565610859728507
"067630903","BUENOS AIRES",101,0,42,51,2,95,0
"067631601","BUENOS AIRES",193,118,53,22,0,75,0.61139896373057
"068401410","BUENOS AIRES",307,305,1,0,0,1,0.993485342019544
"067700109","BUENOS AIRES",295,292,3,0,0,3,0.989830508474576
"067632005","BUENOS AIRES",83,0,40,43,0,83,0
"067632010","BUENOS AIRES",232,229,1,1,0,2,0.987068965517241
"067700101","BUENOS AIRES",120,23,39,57,0,96,0.191666666666667
"067700105","BUENOS AIRES",417,371,7,12,2,21,0.88968824940048
"067700106","BUENOS AIRES",394,382,6,4,0,10,0.969543147208122
"067700205","BUENOS AIRES",302,195,30,61,3,94,0.645695364238411
"067701007","BUENOS AIRES",367,314,9,42,1,52,0.85558583106267
"067701602","BUENOS AIRES",239,2,116,112,8,236,0.00836820083682008
"067910216","BUENOS AIRES",259,253,5,1,0,6,0.976833976833977
"067701601","BUENOS AIRES",296,0,98,184,3,285,0
"067702101","BUENOS AIRES",248,244,1,3,0,4,0.983870967741935
"067702104","BUENOS AIRES",291,287,2,2,0,4,0.986254295532646
"067981002","BUENOS AIRES",24,0,6,18,0,24,0
"067780107","BUENOS AIRES",227,122,51,39,0,90,0.537444933920705
"067780217","BUENOS AIRES",187,4,62,106,2,170,0.0213903743315508
"067780405","BUENOS AIRES",164,0,100,59,2,161,0
"067780501","BUENOS AIRES",206,155,13,29,3,45,0.752427184466019
"067780507","BUENOS AIRES",246,132,26,80,0,106,0.536585365853659
"067780912","BUENOS AIRES",311,272,21,16,0,37,0.87459807073955
"067781002","BUENOS AIRES",254,181,19,34,3,56,0.71259842519685
"067781006","BUENOS AIRES",205,189,11,4,0,15,0.921951219512195
"067781007","BUENOS AIRES",341,307,14,16,0,30,0.900293255131965
"067781010","BUENOS AIRES",197,193,4,0,0,4,0.979695431472081
"067781012","BUENOS AIRES",297,232,39,24,0,63,0.781144781144781
"067912109","BUENOS AIRES",479,441,19,19,0,38,0.920668058455115
"068330203","BUENOS AIRES",339,336,3,0,0,3,0.991150442477876
"067781013","BUENOS AIRES",410,171,79,152,3,234,0.417073170731707
"067910209","BUENOS AIRES",255,253,1,1,0,2,0.992156862745098
"067910403","BUENOS AIRES",225,222,3,0,0,3,0.986666666666667
"067911207","BUENOS AIRES",345,302,11,31,0,42,0.87536231884058
"067911308","BUENOS AIRES",264,175,37,46,0,83,0.662878787878788
"067911311","BUENOS AIRES",279,116,48,107,0,155,0.415770609318996
"067911802","BUENOS AIRES",221,214,7,0,0,7,0.968325791855204
"067911808","BUENOS AIRES",266,255,6,4,0,10,0.958646616541353
"067911812","BUENOS AIRES",234,184,25,25,0,50,0.786324786324786
"067911901","BUENOS AIRES",218,207,5,0,0,5,0.94954128440367
"067911903","BUENOS AIRES",294,288,3,2,0,5,0.979591836734694
"067911905","BUENOS AIRES",424,418,3,3,0,6,0.985849056603774
"067911909","BUENOS AIRES",175,175,0,0,0,0,1
"067912103","BUENOS AIRES",281,1,77,194,1,272,0.00355871886120996
"067912105","BUENOS AIRES",436,387,16,29,0,45,0.887614678899083
"067912106","BUENOS AIRES",415,359,32,24,0,56,0.865060240963855
"068401404","BUENOS AIRES",430,419,4,7,0,11,0.974418604651163
"068051413","BUENOS AIRES",375,9,219,132,0,351,0.024
"067912204","BUENOS AIRES",181,10,62,107,2,171,0.0552486187845304
"067912207","BUENOS AIRES",462,280,80,100,0,180,0.606060606060606
"067912210","BUENOS AIRES",365,363,1,1,0,2,0.994520547945206
"067912211","BUENOS AIRES",243,242,1,0,0,1,0.995884773662551
"067912218","BUENOS AIRES",132,14,43,67,0,110,0.106060606060606
"067980704","BUENOS AIRES",220,126,33,60,1,94,0.572727272727273
"068050610","BUENOS AIRES",365,346,15,3,1,19,0.947945205479452
"068051414","BUENOS AIRES",369,7,207,143,3,353,0.018970189701897
"068050202","BUENOS AIRES",204,156,34,12,2,48,0.764705882352941
"068050309","BUENOS AIRES",151,151,0,0,0,0,1
"068050506","BUENOS AIRES",293,14,112,164,0,276,0.0477815699658703
"068050611","BUENOS AIRES",303,286,6,10,0,16,0.943894389438944
"068051509","BUENOS AIRES",419,3,272,141,1,414,0.00715990453460621
"068051513","BUENOS AIRES",366,4,283,79,0,362,0.0109289617486339
"068051604","BUENOS AIRES",476,13,169,285,2,456,0.0273109243697479
"068051606","BUENOS AIRES",332,7,195,117,0,312,0.0210843373493976
"068050803","BUENOS AIRES",237,114,76,47,0,123,0.481012658227848
"068050807","BUENOS AIRES",469,394,39,30,0,69,0.840085287846482
"068050902","BUENOS AIRES",295,15,117,154,0,271,0.0508474576271186
"068051004","BUENOS AIRES",523,10,252,244,4,500,0.0191204588910134
"068051008","BUENOS AIRES",546,24,140,351,11,502,0.043956043956044
"068051608","BUENOS AIRES",350,6,116,217,3,336,0.0171428571428571
"068051709","BUENOS AIRES",526,0,379,139,0,518,0
"068051803","BUENOS AIRES",470,4,378,66,0,444,0.00851063829787234
"068051807","BUENOS AIRES",282,1,218,63,0,281,0.00354609929078014
"068051011","BUENOS AIRES",360,8,103,222,1,326,0.0222222222222222
"068051012","BUENOS AIRES",294,282,10,2,0,12,0.959183673469388
"068051203","BUENOS AIRES",361,23,252,86,0,338,0.0637119113573407
"068051207","BUENOS AIRES",263,15,145,101,0,246,0.0570342205323194
"068051302","BUENOS AIRES",396,380,12,4,0,16,0.95959595959596
"068051303","BUENOS AIRES",465,205,152,108,0,260,0.440860215053763
"068051407","BUENOS AIRES",309,10,141,148,1,290,0.0323624595469256
"068051808","BUENOS AIRES",440,5,336,96,0,432,0.0113636363636364
"068051810","BUENOS AIRES",439,12,369,56,0,425,0.0273348519362187
"068051907","BUENOS AIRES",256,3,214,39,0,253,0.01171875
"068052003","BUENOS AIRES",253,1,158,91,0,249,0.00395256916996047
"068052010","BUENOS AIRES",352,5,144,198,1,343,0.0142045454545455
"068052011","BUENOS AIRES",380,11,200,161,0,361,0.0289473684210526
"068052209","BUENOS AIRES",430,3,349,77,0,426,0.00697674418604651
"068052210","BUENOS AIRES",272,7,206,58,0,264,0.0257352941176471
"068330212","BUENOS AIRES",381,380,1,0,0,1,0.99737532808399
"068331005","BUENOS AIRES",420,364,21,35,0,56,0.866666666666667
"068400308","BUENOS AIRES",477,51,264,152,0,416,0.106918238993711
"068052508","BUENOS AIRES",217,191,26,0,0,26,0.880184331797235
"068190501","BUENOS AIRES",20,0,20,0,0,20,0
"068190504","BUENOS AIRES",102,0,74,4,24,102,0
"068331303","BUENOS AIRES",40,1,31,8,0,39,0.025
"068331704","BUENOS AIRES",33,0,10,23,0,33,0
"068190907","BUENOS AIRES",74,4,46,11,9,66,0.0540540540540541
"068260104","BUENOS AIRES",176,159,9,6,0,15,0.903409090909091
"068260105","BUENOS AIRES",184,179,3,2,0,5,0.972826086956522
"068260201","BUENOS AIRES",281,263,14,3,0,17,0.935943060498221
"068260708","BUENOS AIRES",48,1,25,22,0,47,0.0208333333333333
"068261609","BUENOS AIRES",159,127,23,9,0,32,0.79874213836478
"068261611","BUENOS AIRES",196,121,31,41,0,72,0.61734693877551
"068401507","BUENOS AIRES",195,195,0,0,0,0,1
"068261801","BUENOS AIRES",58,2,47,6,3,56,0.0344827586206897
"068330102","BUENOS AIRES",327,312,8,6,0,14,0.954128440366973
"068330114","BUENOS AIRES",395,390,3,2,0,5,0.987341772151899
"068330201","BUENOS AIRES",291,289,2,0,0,2,0.993127147766323
"068330202","BUENOS AIRES",378,369,3,6,0,9,0.976190476190476
"068400502","BUENOS AIRES",293,9,114,169,0,283,0.0307167235494881
"068400506","BUENOS AIRES",216,209,2,5,0,7,0.967592592592593
"068400507","BUENOS AIRES",295,295,0,0,0,0,1
"068400511","BUENOS AIRES",485,451,17,15,0,32,0.929896907216495
"068400606","BUENOS AIRES",410,378,14,14,0,28,0.921951219512195
"068400613","BUENOS AIRES",288,264,5,17,0,22,0.916666666666667
"068400802","BUENOS AIRES",188,180,8,0,0,8,0.957446808510638
"068400807","BUENOS AIRES",273,268,5,0,0,5,0.981684981684982
"068400810","BUENOS AIRES",242,240,0,0,0,0,0.991735537190083
"068400902","BUENOS AIRES",217,214,3,0,0,3,0.986175115207373
"068400905","BUENOS AIRES",222,222,0,0,0,0,1
"068401003","BUENOS AIRES",240,240,0,0,0,0,1
"068401012","BUENOS AIRES",180,172,5,3,0,8,0.955555555555556
"068401108","BUENOS AIRES",422,415,5,2,0,7,0.983412322274882
"068401111","BUENOS AIRES",368,364,3,1,0,4,0.989130434782609
"068401605","BUENOS AIRES",323,320,2,0,0,2,0.990712074303406
"068401612","BUENOS AIRES",210,209,1,0,0,1,0.995238095238095
"068401614","BUENOS AIRES",158,158,0,0,0,0,1
"068401705","BUENOS AIRES",313,299,7,7,0,14,0.955271565495208
"068401709","BUENOS AIRES",201,196,3,2,0,5,0.975124378109453
"068401710","BUENOS AIRES",251,234,14,2,0,16,0.932270916334661
"068401908","BUENOS AIRES",334,317,11,5,0,16,0.949101796407186
"068401810","BUENOS AIRES",360,350,7,3,0,10,0.972222222222222
"068401910","BUENOS AIRES",222,219,1,2,0,3,0.986486486486487
"068402008","BUENOS AIRES",257,242,9,6,0,15,0.941634241245136
"068402011","BUENOS AIRES",370,335,20,13,0,33,0.905405405405405
"068402104","BUENOS AIRES",237,229,5,1,0,6,0.966244725738397
"068402105","BUENOS AIRES",216,209,3,3,0,6,0.967592592592593
"068402206","BUENOS AIRES",322,299,15,8,0,23,0.928571428571429
"068402301","BUENOS AIRES",260,257,1,1,0,2,0.988461538461539
"068402303","BUENOS AIRES",172,158,9,5,0,14,0.918604651162791
"068402408","BUENOS AIRES",264,248,3,0,0,3,0.939393939393939
"068402505","BUENOS AIRES",151,70,1,76,0,77,0.463576158940397
"065602113","BUENOS AIRES",335,284,31,11,0,42,0.847761194029851
"068402506","BUENOS AIRES",332,77,39,207,0,246,0.231927710843373
"020140802","CABA",290,290,0,0,0,0,1
"068402508","BUENOS AIRES",164,126,1,2,0,3,0.768292682926829
"068402709","BUENOS AIRES",306,302,0,3,0,3,0.986928104575163
"068402713","BUENOS AIRES",288,284,2,2,0,4,0.986111111111111
"068402801","BUENOS AIRES",305,299,6,0,0,6,0.980327868852459
"068402807","BUENOS AIRES",390,382,2,5,0,7,0.979487179487179
"068403001","BUENOS AIRES",273,260,7,1,0,8,0.952380952380952
"068403002","BUENOS AIRES",157,156,0,0,0,0,0.993630573248408
"068403003","BUENOS AIRES",263,260,3,0,0,3,0.988593155893536
"068403008","BUENOS AIRES",323,319,4,0,0,4,0.987616099071207
"068403010","BUENOS AIRES",215,198,0,0,0,0,0.92093023255814
"068403203","BUENOS AIRES",243,233,8,1,0,9,0.958847736625514
"068470201","BUENOS AIRES",56,0,37,19,0,56,0
"068330803","BUENOS AIRES",7,0,5,2,0,7,0
"068331407","BUENOS AIRES",7,0,7,0,0,7,0
"063711402","BUENOS AIRES",288,0,222,65,1,288,0
"068331203","BUENOS AIRES",6,0,3,2,1,6,0
"068052619","BUENOS AIRES",119,0,73,41,5,119,0
"068120301","BUENOS AIRES",21,0,14,6,0,20,0
"068190201","BUENOS AIRES",58,0,33,12,1,46,0
"068190801","BUENOS AIRES",21,0,17,3,1,21,0
"068260601","BUENOS AIRES",28,0,17,11,0,28,0
"063711403","BUENOS AIRES",192,3,89,100,0,189,0.015625
"068541013","BUENOS AIRES",83,1,42,38,2,82,0.0120481927710843
"068541404","BUENOS AIRES",14,0,1,13,0,14,0
"068190503","BUENOS AIRES",23,0,13,7,3,23,0
"068330301","BUENOS AIRES",1,0,1,0,0,1,0
"068330503","BUENOS AIRES",5,0,1,4,0,5,0
"068610111","BUENOS AIRES",200,196,3,0,0,3,0.98
"020030805","CABA",216,216,0,0,0,0,1
"068331706","BUENOS AIRES",12,0,10,1,1,12,0
"068331915","BUENOS AIRES",50,0,4,43,0,47,0
"068470107","BUENOS AIRES",48,0,19,26,1,46,0
"068540302","BUENOS AIRES",28,0,18,10,0,28,0
"068611603","BUENOS AIRES",269,268,1,0,0,1,0.996282527881041
"068541012","BUENOS AIRES",36,0,10,25,1,36,0
"068750201","BUENOS AIRES",71,1,42,22,0,64,0.0140845070422535
"068610207","BUENOS AIRES",202,202,0,0,0,0,1
"020030804","CABA",217,217,0,0,0,0,1
"068750902","BUENOS AIRES",48,0,13,34,1,48,0
"068751201","BUENOS AIRES",120,0,62,47,4,113,0
"068610609","BUENOS AIRES",273,267,3,3,0,6,0.978021978021978
"068610610","BUENOS AIRES",393,393,0,0,0,0,1
"068610709","BUENOS AIRES",270,270,0,0,0,0,1
"068612605","BUENOS AIRES",302,302,0,0,0,0,1
"068751801","BUENOS AIRES",24,0,9,11,0,20,0
"068541002","BUENOS AIRES",248,133,61,52,0,113,0.536290322580645
"068610104","BUENOS AIRES",308,303,5,0,0,5,0.983766233766234
"068610311","BUENOS AIRES",324,324,0,0,0,0,1
"068610402","BUENOS AIRES",270,244,19,6,1,26,0.903703703703704
"068610403","BUENOS AIRES",282,279,3,0,0,3,0.98936170212766
"068610405","BUENOS AIRES",267,267,0,0,0,0,1
"068610604","BUENOS AIRES",274,274,0,0,0,0,1
"068611502","BUENOS AIRES",315,315,0,0,0,0,1
"068611504","BUENOS AIRES",96,96,0,0,0,0,1
"068610811","BUENOS AIRES",233,233,0,0,0,0,1
"068610906","BUENOS AIRES",335,333,2,0,0,2,0.994029850746269
"068610911","BUENOS AIRES",400,399,1,0,0,1,0.9975
"068611001","BUENOS AIRES",338,338,0,0,0,0,1
"068611007","BUENOS AIRES",333,331,1,0,0,1,0.993993993993994
"068611010","BUENOS AIRES",304,302,2,0,0,2,0.993421052631579
"068611105","BUENOS AIRES",207,194,7,6,0,13,0.93719806763285
"068611203","BUENOS AIRES",190,190,0,0,0,0,1
"068611208","BUENOS AIRES",323,319,1,2,0,3,0.987616099071207
"068611303","BUENOS AIRES",241,241,0,0,0,0,1
"068611306","BUENOS AIRES",327,322,5,0,0,5,0.984709480122324
"068611403","BUENOS AIRES",249,248,1,0,0,1,0.995983935742972
"068611411","BUENOS AIRES",146,146,0,0,0,0,1
"068611610","BUENOS AIRES",321,316,3,1,0,4,0.984423676012461
"068611704","BUENOS AIRES",228,228,0,0,0,0,1
"068611709","BUENOS AIRES",327,325,1,1,0,2,0.99388379204893
"068611806","BUENOS AIRES",348,348,0,0,0,0,1
"020050308","CABA",163,163,0,0,0,0,1
"068611807","BUENOS AIRES",309,307,0,1,1,2,0.993527508090615
"068611809","BUENOS AIRES",322,319,3,0,0,3,0.990683229813665
"068611810","BUENOS AIRES",371,364,6,0,0,6,0.981132075471698
"068611901","BUENOS AIRES",298,297,0,1,0,1,0.996644295302013
"068611908","BUENOS AIRES",259,256,2,1,0,3,0.988416988416988
"068612102","BUENOS AIRES",276,272,4,0,0,4,0.985507246376812
"068612208","BUENOS AIRES",375,373,2,0,0,2,0.994666666666667
"068612210","BUENOS AIRES",216,215,0,0,0,0,0.99537037037037
"068612211","BUENOS AIRES",207,206,1,0,0,1,0.995169082125604
"068612406","BUENOS AIRES",281,276,4,1,0,5,0.98220640569395
"068612911","BUENOS AIRES",252,250,2,0,0,2,0.992063492063492
"068613003","BUENOS AIRES",393,145,18,218,0,236,0.368956743002545
"068613008","BUENOS AIRES",68,66,2,0,0,2,0.970588235294118
"020150103","CABA",268,267,1,0,0,1,0.996268656716418
"068613102","BUENOS AIRES",609,593,12,0,0,12,0.973727422003284
"068613108","BUENOS AIRES",399,356,9,5,0,14,0.892230576441103
"068613110","BUENOS AIRES",410,399,9,1,0,10,0.973170731707317
"068613301","BUENOS AIRES",343,323,15,0,0,15,0.941690962099125
"068613308","BUENOS AIRES",329,313,12,0,0,12,0.951367781155015
"068680107","BUENOS AIRES",63,63,0,0,0,0,1
"068680207","BUENOS AIRES",74,68,5,0,0,5,0.918918918918919
"068680212","BUENOS AIRES",87,82,2,2,0,4,0.942528735632184
"068680302","BUENOS AIRES",310,125,104,79,1,184,0.403225806451613
"068680309","BUENOS AIRES",36,34,2,0,0,2,0.944444444444444
"068680408","BUENOS AIRES",81,76,3,0,0,3,0.938271604938272
"063712909","BUENOS AIRES",355,322,32,1,0,33,0.907042253521127
"068680601","BUENOS AIRES",31,26,3,2,0,5,0.838709677419355
"068680806","BUENOS AIRES",38,31,4,3,0,7,0.815789473684211
"068680808","BUENOS AIRES",25,25,0,0,0,0,1
"068820906","BUENOS AIRES",462,8,91,340,1,432,0.0173160173160173
"068680809","BUENOS AIRES",171,55,54,54,1,109,0.321637426900585
"068750602","BUENOS AIRES",189,2,147,40,0,187,0.0105820105820106
"068751611","BUENOS AIRES",195,158,24,11,1,36,0.81025641025641
"068751613","BUENOS AIRES",279,1,143,126,5,274,0.003584229390681
"068820109","BUENOS AIRES",287,283,3,1,0,4,0.986062717770035
"068820201","BUENOS AIRES",410,387,3,19,0,22,0.94390243902439
"068820204","BUENOS AIRES",254,254,0,0,0,0,1
"068820307","BUENOS AIRES",283,280,2,0,0,2,0.989399293286219
"068820504","BUENOS AIRES",459,258,85,99,1,185,0.562091503267974
"068820804","BUENOS AIRES",347,209,17,108,11,136,0.602305475504323
"068820805","BUENOS AIRES",322,322,0,0,0,0,1
"068820809","BUENOS AIRES",293,293,0,0,0,0,1
"068820811","BUENOS AIRES",234,217,1,16,0,17,0.927350427350427
"068820904","BUENOS AIRES",378,59,133,184,0,317,0.156084656084656
"068820908","BUENOS AIRES",320,228,28,56,0,84,0.7125
"068820913","BUENOS AIRES",299,12,79,190,3,272,0.040133779264214
"068821603","BUENOS AIRES",441,433,1,6,0,7,0.981859410430839
"068821706","BUENOS AIRES",146,6,25,108,0,133,0.0410958904109589
"065601406","BUENOS AIRES",391,239,44,96,4,144,0.611253196930946
"065601507","BUENOS AIRES",226,0,96,125,0,221,0
"066480505","BUENOS AIRES",261,0,102,139,5,246,0
"065601608","BUENOS AIRES",396,69,180,143,0,323,0.174242424242424
"067702208","BUENOS AIRES",265,244,11,7,0,18,0.920754716981132
"065601707","BUENOS AIRES",156,4,106,44,0,150,0.0256410256410256
"065601708","BUENOS AIRES",77,3,67,6,1,74,0.038961038961039
"065601722","BUENOS AIRES",225,121,85,19,0,104,0.537777777777778
"065601805","BUENOS AIRES",184,1,142,37,1,180,0.00543478260869565
"065601807","BUENOS AIRES",219,4,190,25,0,215,0.0182648401826484
"065601918","BUENOS AIRES",127,2,89,36,0,125,0.015748031496063
"065602003","BUENOS AIRES",383,114,93,164,1,258,0.297650130548303
"065602107","BUENOS AIRES",431,0,224,194,0,418,0
"065602110","BUENOS AIRES",231,0,189,42,0,231,0
"020060511","CABA",416,416,0,0,0,0,1
"065602202","BUENOS AIRES",335,7,247,75,0,322,0.0208955223880597
"065602204","BUENOS AIRES",359,227,83,44,0,127,0.632311977715877
"065602209","BUENOS AIRES",342,304,17,19,0,36,0.888888888888889
"065602210","BUENOS AIRES",344,293,30,20,0,50,0.851744186046512
"020022203","CABA",205,205,0,0,0,0,1
"065602303","BUENOS AIRES",267,1,180,83,1,264,0.00374531835205993
"065602306","BUENOS AIRES",335,94,192,44,3,239,0.280597014925373
"065602311","BUENOS AIRES",174,174,0,0,0,0,1
"065602403","BUENOS AIRES",254,245,3,6,0,9,0.964566929133858
"065602409","BUENOS AIRES",223,208,9,5,0,14,0.932735426008969
"065602410","BUENOS AIRES",205,198,4,2,0,6,0.965853658536585
"065602413","BUENOS AIRES",212,194,18,0,0,18,0.915094339622642
"065602417","BUENOS AIRES",392,278,63,41,0,104,0.709183673469388
"064970511","BUENOS AIRES",370,7,164,186,2,352,0.0189189189189189
"065602504","BUENOS AIRES",452,406,40,4,0,44,0.898230088495575
"065602506","BUENOS AIRES",249,171,53,24,0,77,0.686746987951807
"065680302","BUENOS AIRES",368,8,294,64,0,358,0.0217391304347826
"065680307","BUENOS AIRES",228,15,143,69,0,212,0.0657894736842105
"065680401","BUENOS AIRES",244,227,15,1,0,16,0.930327868852459
"065680502","BUENOS AIRES",435,426,6,1,0,7,0.979310344827586
"065680606","BUENOS AIRES",373,372,1,0,0,1,0.997319034852547
"065680609","BUENOS AIRES",379,379,0,0,0,0,1
"065680703","BUENOS AIRES",215,4,208,3,0,211,0.0186046511627907
"065680705","BUENOS AIRES",296,14,261,17,0,278,0.0472972972972973
"065680804","BUENOS AIRES",362,6,268,88,0,356,0.0165745856353591
"065680910","BUENOS AIRES",385,384,1,0,0,1,0.997402597402597
"065681002","BUENOS AIRES",161,4,107,49,1,157,0.0248447204968944
"067911801","BUENOS AIRES",214,199,12,3,0,15,0.929906542056075
"065681003","BUENOS AIRES",160,7,61,91,1,153,0.04375
"065681006","BUENOS AIRES",216,121,69,25,0,94,0.560185185185185
"065681016","BUENOS AIRES",297,293,4,0,0,4,0.986531986531986
"065681204","BUENOS AIRES",245,243,1,1,0,2,0.991836734693878
"065681210","BUENOS AIRES",280,276,1,2,0,3,0.985714285714286
"065681302","BUENOS AIRES",206,204,2,0,0,2,0.990291262135922
"065681812","BUENOS AIRES",322,191,112,19,0,131,0.593167701863354
"061261001","BUENOS AIRES",93,1,33,48,1,82,0.010752688172043
"068821802","BUENOS AIRES",18,0,0,10,6,16,0
"064904811","BUENOS AIRES",244,202,26,11,1,38,0.827868852459016
"064905003","BUENOS AIRES",299,278,2,4,0,6,0.929765886287625
"064970101","BUENOS AIRES",381,378,2,1,0,3,0.992125984251969
"064970103","BUENOS AIRES",204,199,2,3,0,5,0.975490196078431
"064970106","BUENOS AIRES",327,324,2,1,0,3,0.990825688073395
"064970107","BUENOS AIRES",214,194,16,4,0,20,0.906542056074766
"064970111","BUENOS AIRES",278,108,109,60,0,169,0.388489208633094
"064970503","BUENOS AIRES",325,300,20,4,0,24,0.923076923076923
"064970601","BUENOS AIRES",338,260,22,54,0,76,0.769230769230769
"064970603","BUENOS AIRES",164,1,60,97,2,159,0.00609756097560976
"064970703","BUENOS AIRES",147,146,1,0,0,1,0.993197278911565
"064970705","BUENOS AIRES",306,302,4,0,0,4,0.986928104575163
"064971204","BUENOS AIRES",265,216,32,16,0,48,0.815094339622642
"064971102","BUENOS AIRES",374,363,6,4,0,10,0.970588235294118
"065150604","BUENOS AIRES",287,2,187,95,0,282,0.00696864111498258
"064971104","BUENOS AIRES",402,384,12,1,0,13,0.955223880597015
"064971301","BUENOS AIRES",460,5,217,230,4,451,0.0108695652173913
"064971302","BUENOS AIRES",360,16,208,129,1,338,0.0444444444444444
"064971405","BUENOS AIRES",331,19,147,160,0,307,0.0574018126888218
"064971406","BUENOS AIRES",392,262,66,59,2,127,0.668367346938776
"065150603","BUENOS AIRES",239,1,107,100,1,208,0.00418410041841004
"065050201","BUENOS AIRES",153,117,19,12,0,31,0.764705882352941
"065050210","BUENOS AIRES",183,127,40,15,1,56,0.693989071038251
"065152002","BUENOS AIRES",273,0,191,76,0,267,0
"065050319","BUENOS AIRES",310,256,43,11,0,54,0.825806451612903
"065110505","BUENOS AIRES",306,20,89,194,0,283,0.065359477124183
"065150602","BUENOS AIRES",341,86,201,54,0,255,0.252199413489736
"020142101","CABA",399,392,2,0,0,2,0.982456140350877
"065152103","BUENOS AIRES",197,0,165,31,0,196,0
"065180606","BUENOS AIRES",86,0,75,11,0,86,0
"065180705","BUENOS AIRES",101,0,90,11,0,101,0
"065180707","BUENOS AIRES",53,0,39,14,0,53,0
"065150101","BUENOS AIRES",193,0,100,87,1,188,0
"065180709","BUENOS AIRES",105,0,78,27,0,105,0
"065180711","BUENOS AIRES",189,1,151,36,1,188,0.00529100529100529
"065180704","BUENOS AIRES",76,6,59,11,0,70,0.0789473684210526
"065150616","BUENOS AIRES",279,0,222,52,1,275,0
"065150707","BUENOS AIRES",376,6,271,97,0,368,0.0159574468085106
"020022205","CABA",528,528,0,0,0,0,1
"065180602","BUENOS AIRES",78,1,61,15,1,77,0.0128205128205128
"065180608","BUENOS AIRES",4,0,4,0,0,4,0
"065150208","BUENOS AIRES",371,278,52,41,0,93,0.749326145552561
"066860601","BUENOS AIRES",177,154,12,10,0,22,0.870056497175141
"065150305","BUENOS AIRES",217,5,142,65,1,208,0.0230414746543779
"065150407","BUENOS AIRES",318,2,245,58,0,303,0.00628930817610063
"065150408","BUENOS AIRES",355,3,228,111,1,340,0.00845070422535211
"065150502","BUENOS AIRES",247,0,151,93,0,244,0
"065150710","BUENOS AIRES",255,1,178,70,2,250,0.00392156862745098
"065150713","BUENOS AIRES",263,0,200,63,0,263,0
"065150804","BUENOS AIRES",263,0,178,85,0,263,0
"065150811","BUENOS AIRES",351,1,165,147,0,312,0.00284900284900285
"060283104","BUENOS AIRES",193,0,164,29,0,193,0
"065150902","BUENOS AIRES",409,0,355,53,0,408,0
"065150908","BUENOS AIRES",256,1,162,80,1,243,0.00390625
"065151001","BUENOS AIRES",293,1,209,80,1,290,0.00341296928327645
"066930310","BUENOS AIRES",180,54,72,51,0,123,0.3
"065151006","BUENOS AIRES",359,2,309,44,2,355,0.00557103064066852
"060490612","BUENOS AIRES",303,268,9,26,0,35,0.884488448844885
"065151501","BUENOS AIRES",424,4,289,126,3,418,0.00943396226415094
"060560404","BUENOS AIRES",470,467,2,1,0,3,0.993617021276596
"065151013","BUENOS AIRES",312,2,235,69,0,304,0.00641025641025641
"060280307","BUENOS AIRES",346,7,68,247,1,316,0.0202312138728324
"060770513","BUENOS AIRES",200,22,106,70,0,176,0.11
"065151102","BUENOS AIRES",427,3,331,64,0,395,0.00702576112412178
"060841203","BUENOS AIRES",206,180,18,7,0,25,0.87378640776699
"065151110","BUENOS AIRES",399,1,238,148,2,388,0.0025062656641604
"065151111","BUENOS AIRES",243,0,144,90,0,234,0
"065151202","BUENOS AIRES",252,175,37,39,1,77,0.694444444444444
"060911901","BUENOS AIRES",223,214,4,3,0,7,0.959641255605381
"060912004","BUENOS AIRES",216,216,0,0,0,0,1
"060980609","BUENOS AIRES",420,25,309,79,0,388,0.0595238095238095
"065151205","BUENOS AIRES",296,0,231,55,0,286,0
"061260211","BUENOS AIRES",207,141,9,57,0,66,0.681159420289855
"060070115","BUENOS AIRES",140,2,104,34,0,138,0.0142857142857143
"060070406","BUENOS AIRES",161,1,97,63,0,160,0.0062111801242236
"060070407","BUENOS AIRES",195,2,87,80,7,174,0.0102564102564103
"060070501","BUENOS AIRES",43,0,33,10,0,43,0
"060070804","BUENOS AIRES",227,146,45,36,0,81,0.643171806167401
"060070806","BUENOS AIRES",289,250,23,14,0,37,0.865051903114187
"060280606","BUENOS AIRES",531,5,301,209,2,512,0.00941619585687382
"060070808","BUENOS AIRES",251,240,8,3,0,11,0.956175298804781
"060070814","BUENOS AIRES",312,246,13,51,1,65,0.788461538461538
"060210604","BUENOS AIRES",384,352,13,19,0,32,0.916666666666667
"060210202","BUENOS AIRES",147,94,24,28,0,52,0.639455782312925
"063573704","BUENOS AIRES",143,143,0,0,0,0,1
"060280110","BUENOS AIRES",229,4,162,63,0,225,0.0174672489082969
"060280112","BUENOS AIRES",301,3,168,129,0,297,0.00996677740863787
"060280202","BUENOS AIRES",369,3,106,242,0,348,0.00813008130081301
"060280203","BUENOS AIRES",437,18,176,226,1,403,0.0411899313501144
"060280205","BUENOS AIRES",292,6,120,144,2,266,0.0205479452054795
"060280402","BUENOS AIRES",367,5,93,240,3,336,0.0136239782016349
"060280406","BUENOS AIRES",379,28,56,237,17,310,0.0738786279683377
"060280507","BUENOS AIRES",101,1,40,56,1,97,0.0099009900990099
"060280605","BUENOS AIRES",536,0,294,188,0,482,0
"060280615","BUENOS AIRES",1032,16,443,516,3,962,0.0155038759689922
"060280705","BUENOS AIRES",411,0,247,146,1,394,0
"060280802","BUENOS AIRES",73,0,42,31,0,73,0
"060280902","BUENOS AIRES",349,5,147,186,1,334,0.0143266475644699
"060281001","BUENOS AIRES",248,8,144,85,1,230,0.032258064516129
"060281007","BUENOS AIRES",354,14,106,222,2,330,0.0395480225988701
"060281102","BUENOS AIRES",284,266,6,10,0,16,0.936619718309859
"060281106","BUENOS AIRES",215,206,7,2,0,9,0.958139534883721
"060281111","BUENOS AIRES",526,39,263,208,11,482,0.0741444866920152
"060281208","BUENOS AIRES",318,313,4,1,0,5,0.984276729559748
"060281301","BUENOS AIRES",434,10,296,125,0,421,0.0230414746543779
"060281306","BUENOS AIRES",312,1,162,140,1,303,0.00320512820512821
"060281309","BUENOS AIRES",340,7,188,141,0,329,0.0205882352941176
"060281401","BUENOS AIRES",410,4,215,185,0,400,0.00975609756097561
"060281402","BUENOS AIRES",307,4,171,97,0,268,0.0130293159609121
"060281403","BUENOS AIRES",472,1,203,259,3,465,0.00211864406779661
"060281409","BUENOS AIRES",271,1,163,99,1,263,0.003690036900369
"060281503","BUENOS AIRES",279,2,180,90,2,272,0.00716845878136201
"060281602","BUENOS AIRES",362,361,1,0,0,1,0.997237569060773
"060281606","BUENOS AIRES",441,440,0,1,0,1,0.997732426303855
"060281704","BUENOS AIRES",246,244,0,2,0,2,0.991869918699187
"060281801","BUENOS AIRES",424,411,4,8,0,12,0.969339622641509
"060281811","BUENOS AIRES",237,221,3,13,0,16,0.932489451476793
"060281902","BUENOS AIRES",334,332,1,0,0,1,0.994011976047904
"060281906","BUENOS AIRES",92,0,30,47,1,78,0
"060282008","BUENOS AIRES",312,0,178,124,2,304,0
"060282009","BUENOS AIRES",283,0,118,159,0,277,0
"060282104","BUENOS AIRES",244,2,184,57,0,241,0.00819672131147541
"060282105","BUENOS AIRES",289,1,208,74,0,282,0.00346020761245675
"060282111","BUENOS AIRES",330,3,224,95,0,319,0.00909090909090909
"060282201","BUENOS AIRES",147,8,74,63,0,137,0.054421768707483
"060282207","BUENOS AIRES",185,2,107,71,1,179,0.0108108108108108
"060282213","BUENOS AIRES",267,0,160,104,1,265,0
"060282302","BUENOS AIRES",453,31,233,187,0,420,0.0684326710816777
"060282312","BUENOS AIRES",213,3,178,32,0,210,0.0140845070422535
"060282402","BUENOS AIRES",418,31,229,151,0,380,0.0741626794258373
"060282406","BUENOS AIRES",335,77,196,60,0,256,0.229850746268657
"060282504","BUENOS AIRES",183,183,0,0,0,0,1
"060282506","BUENOS AIRES",375,373,1,0,0,1,0.994666666666667
"060282509","BUENOS AIRES",197,191,2,4,0,6,0.969543147208122
"060282510","BUENOS AIRES",376,272,49,52,0,101,0.723404255319149
"060282512","BUENOS AIRES",286,275,8,3,0,11,0.961538461538462
"060282607","BUENOS AIRES",164,33,45,76,0,121,0.201219512195122
"060282810","BUENOS AIRES",316,2,137,167,0,304,0.00632911392405063
"060282811","BUENOS AIRES",183,47,101,32,0,133,0.256830601092896
"060282901","BUENOS AIRES",332,1,209,111,2,322,0.00301204819277108
"060282907","BUENOS AIRES",303,0,184,108,4,296,0
"060283004","BUENOS AIRES",334,20,140,159,1,300,0.0598802395209581
"060283013","BUENOS AIRES",237,19,145,69,0,214,0.080168776371308
"060283201","BUENOS AIRES",247,76,107,64,0,171,0.307692307692308
"060283202","BUENOS AIRES",259,229,30,0,0,30,0.884169884169884
"060283203","BUENOS AIRES",322,117,152,50,0,202,0.363354037267081
"060283302","BUENOS AIRES",428,15,318,92,0,410,0.0350467289719626
"060283306","BUENOS AIRES",1,0,0,0,1,1,0
"060283411","BUENOS AIRES",293,2,271,19,0,290,0.0068259385665529
"065151214","BUENOS AIRES",291,0,184,80,0,264,0
"060283801","BUENOS AIRES",514,0,201,295,2,498,0
"060283810","BUENOS AIRES",281,0,198,78,0,276,0
"060350107","BUENOS AIRES",245,234,0,8,1,9,0.955102040816327
"060350403","BUENOS AIRES",325,59,187,72,0,259,0.181538461538462
"060350412","BUENOS AIRES",273,255,9,6,0,15,0.934065934065934
"060351707","BUENOS AIRES",302,19,138,142,0,280,0.0629139072847682
"060350507","BUENOS AIRES",438,78,213,142,1,356,0.178082191780822
"060350511","BUENOS AIRES",269,253,5,10,0,15,0.940520446096654
"060350606","BUENOS AIRES",321,227,54,38,0,92,0.707165109034268
"060350701","BUENOS AIRES",225,153,20,50,1,71,0.68
"060350704","BUENOS AIRES",267,184,51,32,0,83,0.689138576779026
"060350709","BUENOS AIRES",124,87,16,21,0,37,0.701612903225806
"060350811","BUENOS AIRES",238,179,30,24,0,54,0.752100840336134
"060350812","BUENOS AIRES",1116,1110,2,0,0,2,0.994623655913978
"060350905","BUENOS AIRES",231,161,34,15,16,65,0.696969696969697
"060351005","BUENOS AIRES",195,188,5,2,0,7,0.964102564102564
"060351007","BUENOS AIRES",345,342,1,2,0,3,0.991304347826087
"060351008","BUENOS AIRES",230,230,0,0,0,0,1
"060351011","BUENOS AIRES",249,245,3,0,0,3,0.983935742971888
"060351202","BUENOS AIRES",330,325,4,1,0,5,0.984848484848485
"060351309","BUENOS AIRES",192,182,6,4,0,10,0.947916666666667
"060351411","BUENOS AIRES",150,146,4,0,0,4,0.973333333333333
"060351601","BUENOS AIRES",187,88,59,40,0,99,0.470588235294118
"060351602","BUENOS AIRES",333,83,153,97,0,250,0.249249249249249
"060351604","BUENOS AIRES",136,19,78,38,1,117,0.139705882352941
"060351901","BUENOS AIRES",292,131,99,62,0,161,0.448630136986301
"060351909","BUENOS AIRES",296,224,40,30,0,70,0.756756756756757
"060351910","BUENOS AIRES",389,324,18,40,0,58,0.832904884318766
"060351911","BUENOS AIRES",343,188,41,109,0,150,0.548104956268222
"060352002","BUENOS AIRES",391,391,0,0,0,0,1
"060352007","BUENOS AIRES",358,273,39,42,0,81,0.762569832402235
"060352104","BUENOS AIRES",204,197,5,2,0,7,0.965686274509804
"060352106","BUENOS AIRES",180,177,2,0,0,2,0.983333333333333
"060352212","BUENOS AIRES",49,45,2,2,0,4,0.918367346938776
"060352303","BUENOS AIRES",255,247,7,1,0,8,0.968627450980392
"060352309","BUENOS AIRES",280,240,18,22,0,40,0.857142857142857
"060352401","BUENOS AIRES",331,299,23,9,0,32,0.903323262839879
"060352410","BUENOS AIRES",347,122,137,86,0,223,0.351585014409222
"060352501","BUENOS AIRES",194,5,72,114,0,186,0.0257731958762887
"060352502","BUENOS AIRES",266,34,175,56,0,231,0.12781954887218
"060352509","BUENOS AIRES",316,261,31,20,0,51,0.825949367088608
"060352611","BUENOS AIRES",436,29,121,271,0,392,0.0665137614678899
"060352615","BUENOS AIRES",332,22,113,188,2,303,0.0662650602409639
"060352707","BUENOS AIRES",374,116,38,198,9,245,0.310160427807487
"060352805","BUENOS AIRES",299,42,123,134,0,257,0.140468227424749
"060352908","BUENOS AIRES",242,40,140,61,0,201,0.165289256198347
"060353001","BUENOS AIRES",347,240,43,63,0,106,0.69164265129683
"062241701","BUENOS AIRES",72,2,21,49,0,70,0.0277777777777778
"060353101","BUENOS AIRES",156,130,18,8,0,26,0.833333333333333
"060353102","BUENOS AIRES",161,141,10,10,0,20,0.875776397515528
"060353104","BUENOS AIRES",401,396,1,4,0,5,0.987531172069825
"060353308","BUENOS AIRES",254,250,0,4,0,4,0.984251968503937
"060353405","BUENOS AIRES",244,240,4,0,0,4,0.983606557377049
"060353407","BUENOS AIRES",242,241,1,0,0,1,0.995867768595041
"060420102","BUENOS AIRES",276,254,4,18,0,22,0.920289855072464
"060420103","BUENOS AIRES",296,271,6,7,0,13,0.915540540540541
"060420106","BUENOS AIRES",251,200,16,35,0,51,0.796812749003984
"060420108","BUENOS AIRES",399,385,10,4,0,14,0.964912280701754
"060421908","BUENOS AIRES",224,192,10,22,0,32,0.857142857142857
"060421909","BUENOS AIRES",502,350,30,114,0,144,0.697211155378486
"060490107","BUENOS AIRES",268,265,1,2,0,3,0.988805970149254
"060490110","BUENOS AIRES",289,225,28,33,1,62,0.778546712802768
"060490115","BUENOS AIRES",188,79,16,82,0,98,0.420212765957447
"060490203","BUENOS AIRES",284,258,18,8,0,26,0.908450704225352
"060490207","BUENOS AIRES",248,232,9,7,0,16,0.935483870967742
"060490212","BUENOS AIRES",297,189,30,71,0,101,0.636363636363636
"060490502","BUENOS AIRES",238,228,6,3,0,9,0.957983193277311
"060490603","BUENOS AIRES",400,308,26,62,0,88,0.77
"060560804","BUENOS AIRES",422,236,72,107,3,182,0.559241706161137
"060560910","BUENOS AIRES",185,179,2,4,0,6,0.967567567567568
"060561104","BUENOS AIRES",244,244,0,0,0,0,1
"060561106","BUENOS AIRES",214,214,0,0,0,0,1
"060561807","BUENOS AIRES",355,346,8,1,0,9,0.974647887323944
"062450407","BUENOS AIRES",272,25,171,69,0,240,0.0919117647058824
"060492007","BUENOS AIRES",202,136,52,12,0,64,0.673267326732673
"060492504","BUENOS AIRES",276,197,35,38,2,75,0.713768115942029
"060560102","BUENOS AIRES",361,360,1,0,0,1,0.997229916897507
"060560111","BUENOS AIRES",297,297,0,0,0,0,1
"060560116","BUENOS AIRES",214,213,1,0,0,1,0.995327102803738
"060561110","BUENOS AIRES",271,271,0,0,0,0,1
"060561203","BUENOS AIRES",193,193,0,0,0,0,1
"060561410","BUENOS AIRES",310,310,0,0,0,0,1
"060561603","BUENOS AIRES",244,242,2,0,0,2,0.991803278688525
"060561609","BUENOS AIRES",315,313,1,0,0,1,0.993650793650794
"060561703","BUENOS AIRES",340,340,0,0,0,0,1
"060561705","BUENOS AIRES",184,184,0,0,0,0,1
"060561707","BUENOS AIRES",319,319,0,0,0,0,1
"060560206","BUENOS AIRES",192,188,3,1,0,4,0.979166666666667
"060560403","BUENOS AIRES",317,306,11,0,0,11,0.965299684542587
"060560409","BUENOS AIRES",211,211,0,0,0,0,1
"060560504","BUENOS AIRES",395,392,1,2,0,3,0.992405063291139
"060560505","BUENOS AIRES",169,167,1,1,0,2,0.988165680473373
"060560602","BUENOS AIRES",318,312,5,0,0,5,0.981132075471698
"060560603","BUENOS AIRES",278,274,2,1,0,3,0.985611510791367
"060560607","BUENOS AIRES",401,363,31,7,0,38,0.905236907730673
"060560608","BUENOS AIRES",344,244,34,64,0,98,0.709302325581395
"060560703","BUENOS AIRES",370,360,1,6,0,7,0.972972972972973
"060561802","BUENOS AIRES",371,368,3,0,0,3,0.991913746630728
"060561901","BUENOS AIRES",349,337,7,4,0,11,0.965616045845272
"060561902","BUENOS AIRES",342,334,4,4,0,8,0.976608187134503
"060561907","BUENOS AIRES",393,333,10,46,0,56,0.847328244274809
"060562006","BUENOS AIRES",254,254,0,0,0,0,1
"060562101","BUENOS AIRES",319,317,1,1,0,2,0.993730407523511
"060562102","BUENOS AIRES",300,298,0,2,0,2,0.993333333333333
"060562108","BUENOS AIRES",214,211,1,1,0,2,0.985981308411215
"060562203","BUENOS AIRES",370,361,3,5,0,8,0.975675675675676
"060562207","BUENOS AIRES",216,210,6,0,0,6,0.972222222222222
"060562209","BUENOS AIRES",206,191,8,7,0,15,0.927184466019418
"060562303","BUENOS AIRES",334,257,41,28,1,70,0.769461077844311
"060562304","BUENOS AIRES",481,331,75,73,0,148,0.688149688149688
"060562305","BUENOS AIRES",257,256,1,0,0,1,0.996108949416342
"060630110","BUENOS AIRES",240,225,5,8,0,13,0.9375
"060630204","BUENOS AIRES",311,153,38,108,0,146,0.491961414790997
"020020508","CABA",328,327,1,0,0,1,0.996951219512195
"060562314","BUENOS AIRES",318,240,22,43,2,67,0.754716981132076
"060562315","BUENOS AIRES",263,189,29,40,2,71,0.718631178707224
"062600807","BUENOS AIRES",266,1,131,125,2,258,0.0037593984962406
"060562403","BUENOS AIRES",305,108,129,67,0,196,0.354098360655738
"060562407","BUENOS AIRES",390,369,8,13,0,21,0.946153846153846
"060562414","BUENOS AIRES",234,59,25,143,0,168,0.252136752136752
"060562506","BUENOS AIRES",421,331,57,28,2,87,0.786223277909739
"060562509","BUENOS AIRES",362,269,36,56,0,92,0.743093922651934
"060563207","BUENOS AIRES",169,0,74,89,2,165,0
"060562601","BUENOS AIRES",281,3,209,67,1,277,0.0106761565836299
"060562611","BUENOS AIRES",426,23,372,29,1,402,0.0539906103286385
"062601602","BUENOS AIRES",317,2,169,141,0,310,0.00630914826498423
"060562612","BUENOS AIRES",166,2,100,62,0,162,0.0120481927710843
"060562619","BUENOS AIRES",176,1,39,135,0,174,0.00568181818181818
"060562703","BUENOS AIRES",312,20,167,117,0,284,0.0641025641025641
"060563208","BUENOS AIRES",247,2,153,90,1,244,0.00809716599190283
"020110104","CABA",316,316,0,0,0,0,1
"060630117","BUENOS AIRES",236,219,9,7,0,16,0.927966101694915
"060630702","BUENOS AIRES",189,110,15,62,2,79,0.582010582010582
"060630901","BUENOS AIRES",82,0,36,46,0,82,0
"063573904","BUENOS AIRES",290,290,0,0,0,0,1
"060631107","BUENOS AIRES",18,0,8,10,0,18,0
"060631304","BUENOS AIRES",340,335,1,3,0,4,0.985294117647059
"062700708","BUENOS AIRES",246,1,228,17,0,245,0.0040650406504065
"060700108","BUENOS AIRES",275,270,3,1,0,4,0.981818181818182
"060700113","BUENOS AIRES",161,159,0,1,0,1,0.987577639751553
"060700216","BUENOS AIRES",201,92,18,83,0,101,0.45771144278607
"060700217","BUENOS AIRES",134,130,2,1,0,3,0.970149253731343
"062701009","BUENOS AIRES",371,4,216,139,1,356,0.0107816711590297
"060770402","BUENOS AIRES",168,0,121,46,0,167,0
"061260511","BUENOS AIRES",243,4,57,174,1,232,0.0164609053497942
"060770503","BUENOS AIRES",308,172,29,102,1,132,0.558441558441558
"060911104","BUENOS AIRES",224,223,0,1,0,1,0.995535714285714
"062740613","BUENOS AIRES",238,11,77,109,1,187,0.046218487394958
"060771402","BUENOS AIRES",380,339,23,18,0,41,0.892105263157895
"060771403","BUENOS AIRES",320,262,21,36,0,57,0.81875
"064343113","BUENOS AIRES",297,294,2,1,0,3,0.98989898989899
"060910304","BUENOS AIRES",300,279,3,12,0,15,0.93
"064343114","BUENOS AIRES",271,271,0,0,0,0,1
"062741110","BUENOS AIRES",539,24,208,283,0,491,0.0445269016697588
"060841204","BUENOS AIRES",331,269,28,33,0,61,0.812688821752266
"060841208","BUENOS AIRES",335,312,9,12,0,21,0.93134328358209
"060910313","BUENOS AIRES",220,220,0,0,0,0,1
"060910407","BUENOS AIRES",391,211,43,117,0,160,0.539641943734015
"060910506","BUENOS AIRES",252,200,37,10,0,47,0.793650793650794
"062741708","BUENOS AIRES",235,209,18,8,0,26,0.88936170212766
"062742008","BUENOS AIRES",323,7,133,174,2,309,0.021671826625387
"060910607","BUENOS AIRES",409,153,111,126,1,238,0.374083129584352
"060910703","BUENOS AIRES",245,220,15,6,0,21,0.897959183673469
"060910708","BUENOS AIRES",362,137,51,156,2,209,0.378453038674033
"060910808","BUENOS AIRES",458,422,17,14,0,31,0.921397379912664
"062742103","BUENOS AIRES",422,204,98,105,2,205,0.483412322274882
"060911303","BUENOS AIRES",303,256,14,28,0,42,0.844884488448845
"064411807","BUENOS AIRES",240,239,0,0,0,0,0.995833333333333
"060911404","BUENOS AIRES",334,299,8,12,1,21,0.895209580838323
"060911407","BUENOS AIRES",403,353,23,17,0,40,0.875930521091811
"060911411","BUENOS AIRES",448,412,11,12,0,23,0.919642857142857
"060911603","BUENOS AIRES",259,146,44,60,2,106,0.563706563706564
"060911608","BUENOS AIRES",270,224,27,19,0,46,0.82962962962963
"060911705","BUENOS AIRES",357,242,36,64,0,100,0.677871148459384
"060911803","BUENOS AIRES",551,436,47,61,0,108,0.791288566243194
"060980104","BUENOS AIRES",295,135,135,24,0,159,0.457627118644068
"060911809","BUENOS AIRES",258,188,56,12,0,68,0.728682170542636
"060911908","BUENOS AIRES",373,357,7,9,0,16,0.957104557640751
"020022103","CABA",369,369,0,0,0,0,1
"060912001","BUENOS AIRES",340,246,32,52,2,86,0.723529411764706
"060912111","BUENOS AIRES",356,4,113,227,1,341,0.0112359550561798
"060912201","BUENOS AIRES",367,263,36,57,0,93,0.716621253405995
"060912211","BUENOS AIRES",144,2,138,4,0,142,0.0138888888888889
"060912212","BUENOS AIRES",124,78,43,3,0,46,0.629032258064516
"060912215","BUENOS AIRES",410,3,204,197,0,401,0.00731707317073171
"060912309","BUENOS AIRES",179,1,93,45,0,138,0.00558659217877095
"065151404","BUENOS AIRES",515,7,274,187,1,462,0.0135922330097087
"060980101","BUENOS AIRES",296,86,161,49,0,210,0.290540540540541
"020141905","CABA",652,652,0,0,0,0,1
"060980203","BUENOS AIRES",268,11,236,18,1,255,0.041044776119403
"060980214","BUENOS AIRES",236,30,143,62,0,205,0.127118644067797
"060980215","BUENOS AIRES",246,16,154,70,0,224,0.0650406504065041
"060980303","BUENOS AIRES",363,38,202,114,1,317,0.104683195592287
"060980308","BUENOS AIRES",424,411,10,1,0,11,0.969339622641509
"060980312","BUENOS AIRES",168,167,1,0,0,1,0.994047619047619
"060980506","BUENOS AIRES",263,174,32,44,0,76,0.661596958174905
"060980601","BUENOS AIRES",264,177,69,18,0,87,0.670454545454545
"060980808","BUENOS AIRES",243,235,4,3,0,7,0.967078189300412
"060980701","BUENOS AIRES",251,173,55,15,4,74,0.689243027888446
"060980801","BUENOS AIRES",336,8,258,64,1,323,0.0238095238095238
"061340907","BUENOS AIRES",209,0,117,84,3,204,0
"060980806","BUENOS AIRES",264,254,6,4,0,10,0.962121212121212
"061050108","BUENOS AIRES",331,323,4,4,0,8,0.97583081570997
"061050206","BUENOS AIRES",277,264,3,6,0,9,0.953068592057762
"061260209","BUENOS AIRES",382,105,108,165,0,273,0.274869109947644
"061051105","BUENOS AIRES",322,0,159,160,1,320,0
"061051405","BUENOS AIRES",225,184,18,20,0,38,0.817777777777778
"061120202","BUENOS AIRES",341,192,35,113,0,148,0.563049853372434
"061120209","BUENOS AIRES",197,76,40,81,0,121,0.385786802030457
"061120501","BUENOS AIRES",156,0,44,112,0,156,0
"061121005","BUENOS AIRES",194,177,8,9,0,17,0.912371134020619
"061121103","BUENOS AIRES",181,65,44,69,1,114,0.359116022099448
"061121301","BUENOS AIRES",128,44,44,39,0,83,0.34375
"061121408","BUENOS AIRES",299,292,7,0,0,7,0.976588628762542
"061190308","BUENOS AIRES",321,34,146,133,3,282,0.105919003115265
"061190408","BUENOS AIRES",111,0,73,36,0,109,0
"061260101","BUENOS AIRES",282,273,0,8,0,8,0.968085106382979
"061260207","BUENOS AIRES",247,178,36,32,0,68,0.720647773279352
"061260505","BUENOS AIRES",377,167,42,161,0,203,0.442970822281167
"061260801","BUENOS AIRES",32,21,8,3,0,11,0.65625
"061260918","BUENOS AIRES",189,0,31,146,1,178,0
"063570404","BUENOS AIRES",160,159,1,0,0,1,0.99375
"063570611","BUENOS AIRES",290,287,2,1,0,3,0.989655172413793
"063572007","BUENOS AIRES",151,151,0,0,0,0,1
"061340112","BUENOS AIRES",225,223,2,0,0,2,0.991111111111111
"061340202","BUENOS AIRES",255,22,104,120,3,227,0.0862745098039216
"061340908","BUENOS AIRES",323,2,160,143,5,308,0.00619195046439629
"061340208","BUENOS AIRES",321,0,167,149,0,316,0
"063571106","BUENOS AIRES",333,23,95,205,1,301,0.0690690690690691
"061341004","BUENOS AIRES",291,30,115,140,2,257,0.103092783505155
"061400301","BUENOS AIRES",217,168,8,20,0,28,0.774193548387097
"061400317","BUENOS AIRES",273,265,3,3,0,6,0.970695970695971
"061470106","BUENOS AIRES",289,279,6,4,0,10,0.965397923875433
"061470107","BUENOS AIRES",291,225,27,36,2,65,0.77319587628866
"061470109","BUENOS AIRES",359,136,77,138,4,219,0.37883008356546
"061470302","BUENOS AIRES",27,0,2,22,2,26,0
"061471202","BUENOS AIRES",304,244,25,32,0,57,0.802631578947368
"061540101","BUENOS AIRES",133,0,81,51,0,132,0
"063572105","BUENOS AIRES",304,304,0,0,0,0,1
"061540201","BUENOS AIRES",342,0,274,64,1,339,0
"061540209","BUENOS AIRES",352,0,240,107,0,347,0
"061540210","BUENOS AIRES",140,0,93,43,1,137,0
"061540801","BUENOS AIRES",92,0,52,39,1,92,0
"062520214","BUENOS AIRES",287,216,33,33,0,66,0.752613240418119
"061610103","BUENOS AIRES",203,106,46,51,0,97,0.522167487684729
"061610111","BUENOS AIRES",230,149,14,64,0,78,0.647826086956522
"061610118","BUENOS AIRES",109,59,7,43,0,50,0.541284403669725
"063575901","BUENOS AIRES",353,353,0,0,0,0,1
"061680905","BUENOS AIRES",316,293,6,16,0,22,0.927215189873418
"061821005","BUENOS AIRES",284,280,3,0,0,3,0.985915492957746
"061750414","BUENOS AIRES",272,212,25,34,0,59,0.779411764705882
"061750416","BUENOS AIRES",146,60,46,39,0,85,0.410958904109589
"061750605","BUENOS AIRES",351,335,6,9,0,15,0.954415954415954
"061820109","BUENOS AIRES",387,386,1,0,0,1,0.997416020671835
"063572202","BUENOS AIRES",110,110,0,0,0,0,1
"061820208","BUENOS AIRES",279,277,1,1,0,2,0.992831541218638
"061820213","BUENOS AIRES",242,241,1,0,0,1,0.995867768595041
"061820304","BUENOS AIRES",52,51,1,0,0,1,0.980769230769231
"020021102","CABA",241,241,0,0,0,0,1
"063577617","BUENOS AIRES",67,0,42,24,0,66,0
"061891705","BUENOS AIRES",217,199,12,5,0,17,0.91705069124424
"061891708","BUENOS AIRES",269,219,24,23,1,48,0.814126394052045
"061961101","BUENOS AIRES",8,0,5,3,0,8,0
"062171004","BUENOS AIRES",295,273,6,16,0,22,0.925423728813559
"061961501","BUENOS AIRES",71,0,33,35,0,68,0
"062030203","BUENOS AIRES",201,101,50,50,0,100,0.502487562189055
"062100204","BUENOS AIRES",348,339,5,4,0,9,0.974137931034483
"062100209","BUENOS AIRES",264,261,1,2,0,3,0.988636363636364
"062100210","BUENOS AIRES",416,404,4,6,0,10,0.971153846153846
"062100611","BUENOS AIRES",64,0,21,40,3,64,0
"062101304","BUENOS AIRES",344,338,3,3,0,6,0.982558139534884
"062170107","BUENOS AIRES",285,281,2,2,0,4,0.985964912280702
"062170112","BUENOS AIRES",266,249,7,10,0,17,0.93609022556391
"020021103","CABA",672,670,1,1,0,2,0.99702380952381
"062170113","BUENOS AIRES",404,365,15,21,0,36,0.903465346534653
"062170405","BUENOS AIRES",101,1,42,57,0,99,0.0099009900990099
"062170414","BUENOS AIRES",432,43,104,277,3,384,0.099537037037037
"062170502","BUENOS AIRES",3,0,3,0,0,3,0
"062520702","BUENOS AIRES",374,4,149,219,0,368,0.0106951871657754
"062171207","BUENOS AIRES",235,228,2,4,0,6,0.970212765957447
"062240103","BUENOS AIRES",408,277,42,89,0,131,0.678921568627451
"062240106","BUENOS AIRES",284,157,42,84,0,126,0.552816901408451
"062240206","BUENOS AIRES",273,170,31,68,1,100,0.622710622710623
"062240212","BUENOS AIRES",133,33,46,54,0,100,0.24812030075188
"062240307","BUENOS AIRES",294,5,85,200,1,286,0.0170068027210884
"062240405","BUENOS AIRES",363,353,3,6,0,9,0.972451790633609
"062242002","BUENOS AIRES",129,0,83,46,0,129,0
"062242204","BUENOS AIRES",316,312,2,1,0,3,0.987341772151899
"062242207","BUENOS AIRES",242,167,20,55,0,75,0.690082644628099
"062380104","BUENOS AIRES",362,126,90,144,0,234,0.348066298342541
"062380110","BUENOS AIRES",335,136,86,113,0,199,0.405970149253731
"062380209","BUENOS AIRES",314,185,36,90,0,126,0.589171974522293
"062521307","BUENOS AIRES",233,0,171,60,0,231,0
"062450102","BUENOS AIRES",376,99,182,84,7,273,0.263297872340426
"064100415","BUENOS AIRES",87,0,50,36,0,86,0
"062450204","BUENOS AIRES",219,179,30,10,0,40,0.817351598173516
"062450208","BUENOS AIRES",309,204,62,43,0,105,0.660194174757282
"062520104","BUENOS AIRES",442,2,201,214,6,421,0.00452488687782805
"062520210","BUENOS AIRES",218,3,166,47,0,213,0.0137614678899083
"063571804","BUENOS AIRES",224,222,0,0,0,0,0.991071428571429
"062450417","BUENOS AIRES",92,3,63,26,0,89,0.0326086956521739
"062450418","BUENOS AIRES",130,4,79,44,0,123,0.0307692307692308
"062520603","BUENOS AIRES",89,1,51,33,3,87,0.0112359550561798
"062520604","BUENOS AIRES",228,1,97,122,2,221,0.0043859649122807
"064120806","BUENOS AIRES",316,2,225,83,0,308,0.00632911392405063
"062450503","BUENOS AIRES",212,46,102,64,0,166,0.216981132075472
"062520308","BUENOS AIRES",88,3,72,13,0,85,0.0340909090909091
"065151508","BUENOS AIRES",400,3,230,157,0,387,0.0075
"065151509","BUENOS AIRES",333,5,245,77,0,322,0.015015015015015
"062520501","BUENOS AIRES",399,388,8,3,0,11,0.972431077694236
"062520508","BUENOS AIRES",472,310,87,73,0,160,0.656779661016949
"062520608","BUENOS AIRES",25,0,12,13,0,25,0
"062520706","BUENOS AIRES",566,13,146,383,3,532,0.0229681978798587
"064121007","BUENOS AIRES",339,1,151,181,0,332,0.00294985250737463
"062520711","BUENOS AIRES",466,1,257,201,3,461,0.00214592274678112
"062520805","BUENOS AIRES",401,4,149,236,4,389,0.00997506234413965
"062520808","BUENOS AIRES",274,2,103,166,0,269,0.0072992700729927
"062600308","BUENOS AIRES",320,6,159,153,1,313,0.01875
"062521003","BUENOS AIRES",340,23,263,48,0,311,0.0676470588235294
"062521016","BUENOS AIRES",330,0,195,122,1,318,0
"062521102","BUENOS AIRES",469,3,380,84,0,464,0.00639658848614072
"062521207","BUENOS AIRES",420,0,216,190,2,408,0
"062521208","BUENOS AIRES",340,0,180,149,1,330,0
"063574901","BUENOS AIRES",234,234,0,0,0,0,1
"062521411","BUENOS AIRES",293,1,224,66,2,292,0.00341296928327645
"062521418","BUENOS AIRES",284,1,181,90,4,275,0.00352112676056338
"062521507","BUENOS AIRES",394,0,202,185,0,387,0
"062600109","BUENOS AIRES",380,4,150,204,7,361,0.0105263157894737
"062600118","BUENOS AIRES",176,1,114,61,0,175,0.00568181818181818
"062600203","BUENOS AIRES",481,3,206,255,3,464,0.00623700623700624
"062600304","BUENOS AIRES",534,17,105,371,18,494,0.0318352059925094
"062600504","BUENOS AIRES",371,2,206,153,3,362,0.00539083557951483
"062600509","BUENOS AIRES",378,0,251,123,0,374,0
"062600511","BUENOS AIRES",405,2,192,190,2,384,0.00493827160493827
"062600516","BUENOS AIRES",246,6,166,65,0,231,0.024390243902439
"062600601","BUENOS AIRES",398,4,271,122,0,393,0.0100502512562814
"062600612","BUENOS AIRES",346,294,33,18,0,51,0.84971098265896
"062600702","BUENOS AIRES",369,173,171,12,0,183,0.468834688346883
"062600705","BUENOS AIRES",254,2,158,91,2,251,0.0078740157480315
"062600709","BUENOS AIRES",297,4,205,84,1,290,0.0134680134680135
"062600710","BUENOS AIRES",434,0,334,98,0,432,0
"062601002","BUENOS AIRES",275,57,140,77,0,217,0.207272727272727
"062601005","BUENOS AIRES",146,45,90,11,0,101,0.308219178082192
"062601011","BUENOS AIRES",337,4,213,103,5,321,0.0118694362017804
"062601015","BUENOS AIRES",137,46,45,39,2,86,0.335766423357664
"062601304","BUENOS AIRES",349,68,200,81,0,281,0.194842406876791
"062741612","BUENOS AIRES",298,9,88,189,2,279,0.0302013422818792
"062601401","BUENOS AIRES",391,34,215,140,0,355,0.0869565217391304
"062601404","BUENOS AIRES",214,22,146,46,0,192,0.102803738317757
"062601407","BUENOS AIRES",281,2,204,74,1,279,0.00711743772241993
"062601408","BUENOS AIRES",382,4,243,101,0,344,0.0104712041884817
"062601504","BUENOS AIRES",255,2,168,84,0,252,0.00784313725490196
"063572903","BUENOS AIRES",137,137,0,0,0,0,1
"062601506","BUENOS AIRES",317,4,159,142,1,302,0.0126182965299685
"062601512","BUENOS AIRES",294,9,182,98,0,280,0.0306122448979592
"062601518","BUENOS AIRES",454,6,204,226,2,432,0.013215859030837
"062601603","BUENOS AIRES",394,12,217,160,0,377,0.0304568527918782
"062601704","BUENOS AIRES",262,0,159,93,3,255,0
"062601708","BUENOS AIRES",206,203,1,2,0,3,0.985436893203884
"062660504","BUENOS AIRES",68,0,46,21,0,67,0
"067000605","BUENOS AIRES",236,1,179,56,0,235,0.00423728813559322
"062660701","BUENOS AIRES",245,23,78,137,0,215,0.0938775510204082
"062660609","BUENOS AIRES",196,1,82,101,2,185,0.00510204081632653
"062660703","BUENOS AIRES",429,208,110,98,3,211,0.484848484848485
"064270203","BUENOS AIRES",144,144,0,0,0,0,1
"062700213","BUENOS AIRES",256,0,86,156,1,243,0
"062700506","BUENOS AIRES",361,21,254,75,5,334,0.0581717451523546
"062700614","BUENOS AIRES",235,3,156,73,2,231,0.0127659574468085
"020151501","CABA",293,274,0,0,0,0,0.935153583617747
"062700616","BUENOS AIRES",346,1,134,188,1,323,0.00289017341040462
"062700710","BUENOS AIRES",207,0,157,48,0,205,0
"062700715","BUENOS AIRES",278,7,166,100,1,267,0.0251798561151079
"062700801","BUENOS AIRES",75,4,48,21,0,69,0.0533333333333333
"064201304","BUENOS AIRES",16,13,3,0,0,3,0.8125
"062700814","BUENOS AIRES",116,0,70,40,0,110,0
"062700815","BUENOS AIRES",170,0,70,78,1,149,0
"062701007","BUENOS AIRES",377,0,243,126,1,370,0
"062701103","BUENOS AIRES",21,0,7,11,0,18,0
"062740102","BUENOS AIRES",399,390,5,2,0,7,0.977443609022556
"062740110","BUENOS AIRES",264,222,24,17,1,42,0.840909090909091
"064272206","BUENOS AIRES",308,251,16,29,3,48,0.814935064935065
"062740207","BUENOS AIRES",321,286,10,14,0,24,0.890965732087227
"062740301","BUENOS AIRES",383,30,134,211,0,345,0.0783289817232376
"062740314","BUENOS AIRES",340,20,63,245,0,308,0.0588235294117647
"062740402","BUENOS AIRES",410,12,178,205,0,383,0.0292682926829268
"062741910","BUENOS AIRES",461,6,109,329,0,438,0.0130151843817787
"062740415","BUENOS AIRES",348,19,144,169,1,314,0.0545977011494253
"062740508","BUENOS AIRES",401,24,159,212,0,371,0.0598503740648379
"062740513","BUENOS AIRES",303,21,59,211,1,271,0.0693069306930693
"062740602","BUENOS AIRES",306,13,141,150,1,292,0.042483660130719
"062740618","BUENOS AIRES",229,4,77,132,1,210,0.0174672489082969
"062740703","BUENOS AIRES",302,4,92,193,0,285,0.0132450331125828
"062740706","BUENOS AIRES",375,6,152,204,2,358,0.016
"063573006","BUENOS AIRES",247,247,0,0,0,0,1
"062740801","BUENOS AIRES",189,3,66,119,0,185,0.0158730158730159
"062740812","BUENOS AIRES",254,1,53,166,4,223,0.00393700787401575
"062740906","BUENOS AIRES",420,1,107,292,6,405,0.00238095238095238
"062740920","BUENOS AIRES",364,3,120,220,1,341,0.00824175824175824
"062741010","BUENOS AIRES",278,2,90,161,2,253,0.00719424460431655
"020010215","CABA",278,258,7,2,0,9,0.928057553956835
"062741011","BUENOS AIRES",210,0,72,111,7,190,0
"062741012","BUENOS AIRES",308,2,95,174,18,287,0.00649350649350649
"062741013","BUENOS AIRES",165,0,48,102,1,151,0
"062741103","BUENOS AIRES",304,280,4,3,2,9,0.921052631578947
"062741104","BUENOS AIRES",316,289,4,9,0,13,0.914556962025316
"062741214","BUENOS AIRES",243,3,114,119,4,237,0.0123456790123457
"062741402","BUENOS AIRES",362,359,3,0,0,3,0.99171270718232
"062741508","BUENOS AIRES",287,7,121,148,0,269,0.024390243902439
"020050905","CABA",260,260,0,0,0,0,1
"062741513","BUENOS AIRES",305,22,79,197,0,276,0.0721311475409836
"062741514","BUENOS AIRES",266,156,39,63,0,102,0.586466165413534
"063711303","BUENOS AIRES",411,383,17,10,0,27,0.931873479318735
"062741610","BUENOS AIRES",331,9,99,194,4,297,0.027190332326284
"064275107","BUENOS AIRES",331,121,118,79,0,197,0.365558912386707
"062741714","BUENOS AIRES",394,383,4,3,0,7,0.972081218274112
"062741810","BUENOS AIRES",325,63,16,240,1,257,0.193846153846154
"062741815","BUENOS AIRES",230,0,79,143,0,222,0
"062741817","BUENOS AIRES",373,21,159,181,0,340,0.0563002680965147
"062741904","BUENOS AIRES",430,7,217,175,2,394,0.0162790697674419
"062741907","BUENOS AIRES",417,1,111,278,2,391,0.00239808153477218
"062801208","BUENOS AIRES",458,290,53,107,2,162,0.633187772925764
"062801209","BUENOS AIRES",192,58,47,85,0,132,0.302083333333333
"062741908","BUENOS AIRES",217,3,87,118,0,205,0.0138248847926267
"062742116","BUENOS AIRES",249,3,121,115,3,239,0.0120481927710843
"062742119","BUENOS AIRES",327,4,126,183,0,309,0.0122324159021407
"062742122","BUENOS AIRES",261,3,116,130,0,246,0.0114942528735632
"062800206","BUENOS AIRES",244,225,8,10,0,18,0.922131147540984
"062800301","BUENOS AIRES",56,51,1,4,0,5,0.910714285714286
"062800312","BUENOS AIRES",28,28,0,0,0,0,1
"062800608","BUENOS AIRES",116,5,52,56,2,110,0.0431034482758621
"063571204","BUENOS AIRES",274,252,12,4,1,17,0.91970802919708
"062801001","BUENOS AIRES",200,199,0,0,0,0,0.995
"062801106","BUENOS AIRES",176,172,4,0,0,4,0.977272727272727
"062801110","BUENOS AIRES",134,34,57,42,0,99,0.253731343283582
"062870408","BUENOS AIRES",205,20,96,76,3,175,0.0975609756097561
"062870410","BUENOS AIRES",132,95,23,14,0,37,0.71969696969697
"062870411","BUENOS AIRES",271,212,35,24,0,59,0.782287822878229
"062940408","BUENOS AIRES",305,22,156,125,0,281,0.0721311475409836
"062940405","BUENOS AIRES",38,0,24,9,5,38,0
"062940604","BUENOS AIRES",131,0,39,85,5,129,0
"064278714","BUENOS AIRES",315,0,235,76,1,312,0
"062940802","BUENOS AIRES",206,148,38,19,1,58,0.718446601941748
"063010505","BUENOS AIRES",222,3,121,95,1,217,0.0135135135135135
"063010512","BUENOS AIRES",337,268,45,23,0,68,0.795252225519288
"063010514","BUENOS AIRES",188,144,30,14,0,44,0.765957446808511
"063010802","BUENOS AIRES",41,0,17,23,0,40,0
"063010808","BUENOS AIRES",281,249,25,7,0,32,0.886120996441281
"063010809","BUENOS AIRES",248,224,17,7,0,24,0.903225806451613
"063010810","BUENOS AIRES",146,18,66,61,1,128,0.123287671232877
"064279511","BUENOS AIRES",411,4,236,158,1,395,0.0097323600973236
"063150117","BUENOS AIRES",194,32,43,101,3,147,0.164948453608247
"065151608","BUENOS AIRES",359,1,267,86,0,353,0.00278551532033426
"063570207","BUENOS AIRES",213,212,1,0,0,1,0.995305164319249
"063220301","BUENOS AIRES",97,1,51,45,0,96,0.0103092783505155
"063570208","BUENOS AIRES",191,188,2,1,0,3,0.984293193717278
"063220605","BUENOS AIRES",212,75,104,33,0,137,0.35377358490566
"063573108","BUENOS AIRES",253,253,0,0,0,0,1
"063220613","BUENOS AIRES",142,13,93,36,0,129,0.0915492957746479
"063290306","BUENOS AIRES",217,21,114,81,1,196,0.0967741935483871
"063290308","BUENOS AIRES",318,72,175,66,0,241,0.226415094339623
"063290311","BUENOS AIRES",328,86,168,71,0,239,0.26219512195122
"064341004","BUENOS AIRES",205,20,76,90,1,167,0.0975609756097561
"063361001","BUENOS AIRES",123,1,45,72,2,119,0.00813008130081301
"063430601","BUENOS AIRES",183,3,124,53,1,178,0.0163934426229508
"063430704","BUENOS AIRES",136,94,23,18,0,41,0.691176470588235
"063711304","BUENOS AIRES",349,328,13,8,0,21,0.939828080229226
"063430705","BUENOS AIRES",236,151,32,51,0,83,0.639830508474576
"063430707","BUENOS AIRES",253,200,23,29,0,52,0.790513833992095
"063430708","BUENOS AIRES",164,97,21,46,0,67,0.591463414634146
"063430709","BUENOS AIRES",309,296,6,6,0,12,0.957928802588997
"063510604","BUENOS AIRES",371,177,79,109,0,188,0.477088948787062
"063510605","BUENOS AIRES",253,159,29,62,0,91,0.628458498023715
"063510608","BUENOS AIRES",97,24,25,43,1,69,0.247422680412371
"063570204","BUENOS AIRES",343,332,10,1,0,11,0.967930029154519
"063572008","BUENOS AIRES",44,44,0,0,0,0,1
"063510615","BUENOS AIRES",275,211,39,24,0,63,0.767272727272727
"063571202","BUENOS AIRES",196,187,3,6,0,9,0.954081632653061
"063570202","BUENOS AIRES",258,205,25,4,0,29,0.794573643410853
"063570210","BUENOS AIRES",244,240,3,1,0,4,0.983606557377049
"063570309","BUENOS AIRES",363,362,0,1,0,1,0.997245179063361
"063570407","BUENOS AIRES",266,247,2,1,0,3,0.928571428571429
"063570408","BUENOS AIRES",304,303,1,0,0,1,0.996710526315789
"063570501","BUENOS AIRES",370,369,0,0,0,0,0.997297297297297
"063570502","BUENOS AIRES",340,339,1,0,0,1,0.997058823529412
"063570604","BUENOS AIRES",381,369,9,3,0,12,0.968503937007874
"063571802","BUENOS AIRES",191,191,0,0,0,0,1
"063570707","BUENOS AIRES",282,272,7,3,0,10,0.964539007092199
"063570709","BUENOS AIRES",424,391,14,16,0,30,0.922169811320755
"063570710","BUENOS AIRES",308,282,18,4,0,22,0.915584415584416
"063571004","BUENOS AIRES",298,2,162,133,0,295,0.00671140939597315
"063571010","BUENOS AIRES",225,15,135,73,0,208,0.0666666666666667
"063571102","BUENOS AIRES",336,4,239,88,2,329,0.0119047619047619
"063571105","BUENOS AIRES",327,5,160,161,0,321,0.0152905198776758
"063573702","BUENOS AIRES",221,219,0,0,0,0,0.990950226244344
"063571210","BUENOS AIRES",338,92,161,74,3,238,0.272189349112426
"063571211","BUENOS AIRES",372,296,28,47,0,75,0.795698924731183
"063571511","BUENOS AIRES",163,162,0,0,0,0,0.993865030674847
"063571606","BUENOS AIRES",217,216,1,0,0,1,0.995391705069124
"063571612","BUENOS AIRES",158,157,0,1,0,1,0.993670886075949
"063571707","BUENOS AIRES",172,168,0,0,0,0,0.976744186046512
"063571803","BUENOS AIRES",140,140,0,0,0,0,1
"063571810","BUENOS AIRES",209,209,0,0,0,0,1
"063571902","BUENOS AIRES",166,166,0,0,0,0,1
"063571904","BUENOS AIRES",82,82,0,0,0,0,1
"063571908","BUENOS AIRES",209,208,0,1,0,1,0.995215311004785
"063572005","BUENOS AIRES",104,104,0,0,0,0,1
"063572604","BUENOS AIRES",276,276,0,0,0,0,1
"063573207","BUENOS AIRES",226,226,0,0,0,0,1
"063573307","BUENOS AIRES",277,276,1,0,0,1,0.996389891696751
"063573502","BUENOS AIRES",314,313,1,0,0,1,0.996815286624204
"063573503","BUENOS AIRES",156,156,0,0,0,0,1
"063574008","BUENOS AIRES",194,194,0,0,0,0,1
"063574203","BUENOS AIRES",92,92,0,0,0,0,1
"063574306","BUENOS AIRES",104,104,0,0,0,0,1
"063574404","BUENOS AIRES",235,235,0,0,0,0,1
"063574405","BUENOS AIRES",210,208,0,1,0,1,0.990476190476191
"063574407","BUENOS AIRES",151,151,0,0,0,0,1
"063574606","BUENOS AIRES",309,308,1,0,0,1,0.996763754045307
"063574610","BUENOS AIRES",260,260,0,0,0,0,1
"063574708","BUENOS AIRES",287,287,0,0,0,0,1
"063574811","BUENOS AIRES",299,297,2,0,0,2,0.993311036789298
"063574813","BUENOS AIRES",210,206,4,0,0,4,0.980952380952381
"063575003","BUENOS AIRES",301,297,3,1,0,4,0.98671096345515
"063575008","BUENOS AIRES",534,534,0,0,0,0,1
"063575012","BUENOS AIRES",352,350,2,0,0,2,0.994318181818182
"063575104","BUENOS AIRES",285,283,0,2,0,2,0.992982456140351
"063575109","BUENOS AIRES",418,402,7,6,0,13,0.961722488038278
"063575205","BUENOS AIRES",283,274,4,4,0,8,0.968197879858657
"063575211","BUENOS AIRES",361,265,45,45,0,90,0.734072022160665
"063575213","BUENOS AIRES",340,239,45,54,0,99,0.702941176470588
"063575301","BUENOS AIRES",332,326,3,3,0,6,0.981927710843373
"063575313","BUENOS AIRES",251,236,7,8,0,15,0.940239043824701
"063575316","BUENOS AIRES",256,234,9,10,0,19,0.9140625
"063575502","BUENOS AIRES",272,266,5,1,0,6,0.977941176470588
"063575504","BUENOS AIRES",438,436,2,0,0,2,0.995433789954338
"063575507","BUENOS AIRES",227,227,0,0,0,0,1
"063575611","BUENOS AIRES",397,397,0,0,0,0,1
"063575703","BUENOS AIRES",280,276,4,0,0,4,0.985714285714286
"063575704","BUENOS AIRES",417,416,1,0,0,1,0.997601918465228
"063575802","BUENOS AIRES",277,275,2,0,0,2,0.992779783393502
"063575908","BUENOS AIRES",309,308,0,1,0,1,0.996763754045307
"063576007","BUENOS AIRES",315,308,5,2,0,7,0.977777777777778
"063576010","BUENOS AIRES",246,224,7,8,0,15,0.910569105691057
"063576109","BUENOS AIRES",210,209,1,0,0,1,0.995238095238095
"063576408","BUENOS AIRES",140,135,3,2,0,5,0.964285714285714
"063576601","BUENOS AIRES",285,249,12,23,0,35,0.873684210526316
"063576703","BUENOS AIRES",322,316,5,1,0,6,0.981366459627329
"063576712","BUENOS AIRES",332,317,9,4,0,13,0.954819277108434
"063576808","BUENOS AIRES",234,231,1,2,0,3,0.987179487179487
"063576810","BUENOS AIRES",325,317,0,5,0,5,0.975384615384615
"063576909","BUENOS AIRES",289,264,12,8,0,20,0.913494809688581
"063577008","BUENOS AIRES",375,373,1,1,0,2,0.994666666666667
"063577011","BUENOS AIRES",261,250,2,9,0,11,0.957854406130268
"063577109","BUENOS AIRES",421,416,4,0,0,4,0.98812351543943
"063577110","BUENOS AIRES",301,254,16,20,0,36,0.843853820598007
"063577202","BUENOS AIRES",327,242,42,23,6,71,0.740061162079511
"063577203","BUENOS AIRES",256,196,22,27,0,49,0.765625
"063577204","BUENOS AIRES",370,284,32,36,0,68,0.767567567567568
"063577211","BUENOS AIRES",348,313,15,15,1,31,0.899425287356322
"063577407","BUENOS AIRES",224,0,170,54,0,224,0
"063577412","BUENOS AIRES",163,13,138,12,0,150,0.0797546012269939
"063577414","BUENOS AIRES",330,56,137,137,0,274,0.16969696969697
"063577418","BUENOS AIRES",177,4,133,39,1,173,0.0225988700564972
"063577503","BUENOS AIRES",27,20,6,1,0,7,0.740740740740741
"063577513","BUENOS AIRES",151,2,106,42,1,149,0.0132450331125828
"063577514","BUENOS AIRES",92,0,65,26,1,92,0
"063577612","BUENOS AIRES",89,0,57,30,2,89,0
"063578202","BUENOS AIRES",47,0,30,16,0,46,0
"020030705","CABA",268,265,0,0,0,0,0.988805970149254
"020151105","CABA",245,239,6,0,0,6,0.975510204081633
"063577911","BUENOS AIRES",165,4,84,75,0,159,0.0242424242424242
"063577808","BUENOS AIRES",200,0,114,78,4,196,0
"063577809","BUENOS AIRES",233,61,33,132,0,165,0.261802575107296
"063578005","BUENOS AIRES",406,2,228,166,0,394,0.00492610837438424
"063578007","BUENOS AIRES",175,0,109,62,1,172,0
"063578011","BUENOS AIRES",143,1,67,75,0,142,0.00699300699300699
"063578013","BUENOS AIRES",156,0,66,78,5,149,0
"064416610","BUENOS AIRES",219,184,7,4,0,11,0.840182648401826
"064273309","BUENOS AIRES",262,257,4,1,0,5,0.980916030534351
"063710206","BUENOS AIRES",333,10,204,117,0,321,0.03003003003003
"063578205","BUENOS AIRES",266,0,136,125,3,264,0
"063578210","BUENOS AIRES",72,3,56,13,0,69,0.0416666666666667
"063640115","BUENOS AIRES",196,183,4,9,0,13,0.933673469387755
"063640118","BUENOS AIRES",202,199,1,2,0,3,0.985148514851485
"063640201","BUENOS AIRES",176,0,103,69,1,173,0
"063640209","BUENOS AIRES",233,0,116,112,1,229,0
"063640302","BUENOS AIRES",260,7,94,146,3,243,0.0269230769230769
"063640307","BUENOS AIRES",448,9,276,156,0,432,0.0200892857142857
"063640316","BUENOS AIRES",0,0,0,0,0,0,NA
"020020302","CABA",411,411,0,0,0,0,1
"063640402","BUENOS AIRES",345,0,148,163,9,320,0
"063640716","BUENOS AIRES",183,0,61,113,1,175,0
"063640717","BUENOS AIRES",159,2,73,76,1,150,0.0125786163522013
"063640812","BUENOS AIRES",152,0,69,72,3,144,0
"063640813","BUENOS AIRES",259,1,185,65,0,250,0.00386100386100386
"063640822","BUENOS AIRES",178,0,106,63,2,171,0
"063640823","BUENOS AIRES",305,0,132,156,5,293,0
"063710110","BUENOS AIRES",483,49,190,214,22,426,0.101449275362319
"063711308","BUENOS AIRES",329,98,163,68,0,231,0.297872340425532
"020022301","CABA",435,435,0,0,0,0,1
"063710111","BUENOS AIRES",21,0,7,11,1,19,0
"063710202","BUENOS AIRES",393,6,236,149,0,385,0.0152671755725191
"063710304","BUENOS AIRES",501,252,128,121,0,249,0.502994011976048
"063710306","BUENOS AIRES",349,319,21,9,0,30,0.91404011461318
"063710308","BUENOS AIRES",400,13,264,122,1,387,0.0325
"063710406","BUENOS AIRES",428,382,29,17,0,46,0.892523364485981
"063710601","BUENOS AIRES",233,221,12,0,0,12,0.948497854077253
"063710705","BUENOS AIRES",287,276,3,3,0,6,0.961672473867596
"063710707","BUENOS AIRES",534,359,69,85,2,156,0.672284644194757
"063710812","BUENOS AIRES",354,329,6,17,1,24,0.929378531073446
"063711105","BUENOS AIRES",280,278,2,0,0,2,0.992857142857143
"063711203","BUENOS AIRES",223,221,0,1,0,1,0.991031390134529
"063711207","BUENOS AIRES",322,307,11,3,0,14,0.953416149068323
"063711209","BUENOS AIRES",273,272,1,0,0,1,0.996336996336996
"063711301","BUENOS AIRES",337,303,25,7,0,32,0.899109792284866
"063711510","BUENOS AIRES",124,2,62,56,1,119,0.0161290322580645
"063711601","BUENOS AIRES",212,21,22,137,14,173,0.0990566037735849
"063711604","BUENOS AIRES",336,41,46,227,3,276,0.12202380952381
"063711605","BUENOS AIRES",111,12,10,74,15,99,0.108108108108108
"063711608","BUENOS AIRES",341,13,246,80,0,326,0.0381231671554252
"063711613","BUENOS AIRES",345,23,127,194,0,321,0.0666666666666667
"063711614","BUENOS AIRES",265,9,52,199,0,251,0.0339622641509434
"063711806","BUENOS AIRES",370,14,194,160,1,355,0.0378378378378378
"063711807","BUENOS AIRES",372,20,215,136,0,351,0.0537634408602151
"063711813","BUENOS AIRES",434,9,227,192,1,420,0.0207373271889401
"063711909","BUENOS AIRES",394,384,9,1,0,10,0.974619289340102
"063712008","BUENOS AIRES",225,222,2,1,0,3,0.986666666666667
"063712102","BUENOS AIRES",368,367,1,0,0,1,0.997282608695652
"063712401","BUENOS AIRES",371,354,5,12,0,17,0.954177897574124
"063712708","BUENOS AIRES",215,212,2,1,0,3,0.986046511627907
"063712801","BUENOS AIRES",172,7,9,152,0,161,0.0406976744186047
"063712806","BUENOS AIRES",284,276,3,5,0,8,0.971830985915493
"063713002","BUENOS AIRES",394,47,254,90,1,345,0.119289340101523
"063713011","BUENOS AIRES",310,24,139,135,0,274,0.0774193548387097
"063713103","BUENOS AIRES",398,21,229,143,3,375,0.0527638190954774
"063713104","BUENOS AIRES",171,2,154,14,0,168,0.0116959064327485
"063713213","BUENOS AIRES",372,8,184,174,1,359,0.021505376344086
"063713308","BUENOS AIRES",257,5,187,65,0,252,0.0194552529182879
"063713401","BUENOS AIRES",251,11,160,80,0,240,0.0438247011952191
"063713403","BUENOS AIRES",160,2,115,42,0,157,0.0125
"063713409","BUENOS AIRES",247,21,104,122,0,226,0.0850202429149798
"063713504","BUENOS AIRES",235,8,154,72,0,226,0.0340425531914894
"063713512","BUENOS AIRES",292,4,212,72,0,284,0.0136986301369863
"063713603","BUENOS AIRES",402,20,192,182,0,374,0.0497512437810945
"063713608","BUENOS AIRES",347,7,211,126,0,337,0.0201729106628242
"063713706","BUENOS AIRES",207,3,67,116,1,184,0.0144927536231884
"063713709","BUENOS AIRES",501,16,261,219,0,480,0.031936127744511
"063713711","BUENOS AIRES",410,2,123,256,8,387,0.0048780487804878
"063713713","BUENOS AIRES",447,7,263,170,0,433,0.0156599552572707
"063713714","BUENOS AIRES",377,9,255,106,0,361,0.0238726790450928
"063713715","BUENOS AIRES",411,6,317,79,0,396,0.0145985401459854
"063850711","BUENOS AIRES",209,137,27,44,0,71,0.655502392344498
"063920102","BUENOS AIRES",439,212,91,127,1,219,0.482915717539863
"063920104","BUENOS AIRES",209,196,6,4,0,10,0.937799043062201
"064343906","BUENOS AIRES",281,74,89,118,0,207,0.263345195729537
"063920705","BUENOS AIRES",111,3,28,78,2,108,0.027027027027027
"063921203","BUENOS AIRES",300,27,160,103,2,265,0.09
"064080106","BUENOS AIRES",217,90,104,23,0,127,0.414746543778802
"063990706","BUENOS AIRES",222,195,12,15,0,27,0.878378378378378
"064060202","BUENOS AIRES",321,218,75,27,0,102,0.679127725856698
"064060204","BUENOS AIRES",348,253,42,50,2,94,0.727011494252874
"064080110","BUENOS AIRES",239,1,184,29,0,213,0.00418410041841004
"064080205","BUENOS AIRES",243,38,144,61,0,205,0.156378600823045
"064080301","BUENOS AIRES",105,0,6,78,12,96,0
"064080308","BUENOS AIRES",621,5,415,176,3,594,0.00805152979066022
"064080412","BUENOS AIRES",359,2,259,95,0,354,0.00557103064066852
"064080511","BUENOS AIRES",271,14,232,23,0,255,0.0516605166051661
"064080707","BUENOS AIRES",94,1,83,10,0,93,0.0106382978723404
"064080806","BUENOS AIRES",310,5,205,86,2,293,0.0161290322580645
"064080814","BUENOS AIRES",452,5,340,104,0,444,0.0110619469026549
"064080901","BUENOS AIRES",392,13,320,50,2,372,0.0331632653061225
"064080908","BUENOS AIRES",374,0,337,37,0,374,0
"064081101","BUENOS AIRES",274,4,219,47,0,266,0.0145985401459854
"064200910","BUENOS AIRES",48,44,4,0,0,4,0.916666666666667
"064081103","BUENOS AIRES",342,321,21,0,0,21,0.93859649122807
"064201307","BUENOS AIRES",86,71,10,5,0,15,0.825581395348837
"064081104","BUENOS AIRES",337,2,277,47,0,324,0.00593471810089021
"064081111","BUENOS AIRES",74,0,62,12,0,74,0
"064081204","BUENOS AIRES",352,15,254,67,3,324,0.0426136363636364
"064081205","BUENOS AIRES",488,14,358,110,0,468,0.0286885245901639
"064081209","BUENOS AIRES",297,5,250,41,1,292,0.0168350168350168
"064081307","BUENOS AIRES",359,5,253,93,1,347,0.0139275766016713
"064081313","BUENOS AIRES",226,87,113,23,0,136,0.384955752212389
"064081405","BUENOS AIRES",190,7,128,51,1,180,0.0368421052631579
"064081408","BUENOS AIRES",235,105,79,50,0,129,0.446808510638298
"064081507","BUENOS AIRES",274,271,1,1,0,2,0.989051094890511
"064081512","BUENOS AIRES",140,140,0,0,0,0,1
"064081513","BUENOS AIRES",347,230,74,42,0,116,0.662824207492795
"064100609","BUENOS AIRES",286,3,226,57,0,283,0.0104895104895105
"064100403","BUENOS AIRES",407,0,340,64,0,404,0
"020060512","CABA",159,156,1,0,0,1,0.981132075471698
"064100101","BUENOS AIRES",397,0,269,122,0,391,0
"064100113","BUENOS AIRES",183,0,133,50,0,183,0
"064100201","BUENOS AIRES",289,0,219,70,0,289,0
"064100207","BUENOS AIRES",242,0,188,54,0,242,0
"064100208","BUENOS AIRES",438,1,317,115,0,432,0.00228310502283105
"064100707","BUENOS AIRES",464,1,365,95,2,462,0.0021551724137931
"064100708","BUENOS AIRES",303,2,230,69,0,299,0.0066006600660066
"064100714","BUENOS AIRES",306,3,225,73,0,298,0.00980392156862745
"064100310","BUENOS AIRES",301,0,261,39,0,300,0
"064100405","BUENOS AIRES",233,1,194,35,0,229,0.00429184549356223
"064100407","BUENOS AIRES",251,0,224,25,1,250,0
"064100408","BUENOS AIRES",291,2,223,65,0,288,0.00687285223367698
"064100501","BUENOS AIRES",251,0,178,68,0,246,0
"064100504","BUENOS AIRES",249,1,185,62,0,247,0.00401606425702811
"064100505","BUENOS AIRES",289,1,220,62,0,282,0.00346020761245675
"064100512","BUENOS AIRES",319,4,188,117,0,305,0.0125391849529781
"064100514","BUENOS AIRES",281,1,174,93,1,268,0.00355871886120996
"064100604","BUENOS AIRES",358,3,294,59,0,353,0.00837988826815642
"064120913","BUENOS AIRES",240,2,116,117,0,233,0.00833333333333333
"064100809","BUENOS AIRES",464,283,128,51,0,179,0.609913793103448
"065050312","BUENOS AIRES",243,233,6,4,0,10,0.958847736625514
"064100908","BUENOS AIRES",282,4,257,21,0,278,0.0141843971631206
"064101206","BUENOS AIRES",286,0,243,43,0,286,0
"064101211","BUENOS AIRES",293,0,203,56,0,259,0
"064101309","BUENOS AIRES",271,1,223,44,0,267,0.003690036900369
"064120104","BUENOS AIRES",164,0,82,71,1,154,0
"064120116","BUENOS AIRES",466,0,276,173,1,450,0
"064120306","BUENOS AIRES",332,13,276,41,1,318,0.0391566265060241
"064120209","BUENOS AIRES",416,3,343,64,1,408,0.00721153846153846
"064120313","BUENOS AIRES",208,0,198,10,0,208,0
"064120411","BUENOS AIRES",364,0,293,64,0,357,0
"064130110","BUENOS AIRES",344,341,0,3,0,3,0.991279069767442
"064120504","BUENOS AIRES",242,0,191,51,0,242,0
"064120707","BUENOS AIRES",224,0,113,103,0,216,0
"064120715","BUENOS AIRES",257,0,193,61,0,254,0
"064120801","BUENOS AIRES",464,0,339,119,1,459,0
"064120808","BUENOS AIRES",258,2,119,113,0,232,0.00775193798449612
"064120812","BUENOS AIRES",284,3,148,126,0,274,0.0105633802816901
"064120815","BUENOS AIRES",291,2,128,154,0,282,0.00687285223367698
"064120901","BUENOS AIRES",218,0,81,111,3,195,0
"064120907","BUENOS AIRES",137,1,72,57,2,131,0.0072992700729927
"064120908","BUENOS AIRES",366,0,196,164,1,361,0
"064201405","BUENOS AIRES",38,36,2,0,0,2,0.947368421052632
"064120914","BUENOS AIRES",426,0,187,230,1,418,0
"064200309","BUENOS AIRES",86,11,38,29,5,72,0.127906976744186
"064120915","BUENOS AIRES",372,0,145,215,0,360,0
"064120917","BUENOS AIRES",226,0,87,104,10,201,0
"064121002","BUENOS AIRES",374,7,145,211,0,356,0.018716577540107
"065151109","BUENOS AIRES",377,1,274,65,0,339,0.0026525198938992
"064121102","BUENOS AIRES",323,2,116,185,6,307,0.00619195046439629
"064121114","BUENOS AIRES",252,0,137,112,0,249,0
"064121120","BUENOS AIRES",503,0,279,205,8,492,0
"064121201","BUENOS AIRES",322,4,202,94,0,296,0.0124223602484472
"065151312","BUENOS AIRES",363,0,271,87,1,359,0
"064121410","BUENOS AIRES",345,1,196,129,0,325,0.00289855072463768
"064121507","BUENOS AIRES",297,0,177,111,3,291,0
"020110108","CABA",295,295,0,0,0,0,1
"064121511","BUENOS AIRES",376,0,239,127,4,370,0
"064121512","BUENOS AIRES",462,0,212,228,2,442,0
"064130205","BUENOS AIRES",329,241,10,73,2,85,0.732522796352584
"064130302","BUENOS AIRES",256,254,2,0,0,2,0.9921875
"064130303","BUENOS AIRES",313,313,0,0,0,0,1
"064130307","BUENOS AIRES",363,355,3,4,0,7,0.977961432506887
"064130309","BUENOS AIRES",314,259,6,45,0,51,0.82484076433121
"064130405","BUENOS AIRES",288,287,1,0,0,1,0.996527777777778
"064130410","BUENOS AIRES",193,191,1,1,0,2,0.989637305699482
"064130411","BUENOS AIRES",351,343,3,4,0,7,0.977207977207977
"064130503","BUENOS AIRES",329,327,1,1,0,2,0.993920972644377
"064130610","BUENOS AIRES",239,214,12,10,0,22,0.895397489539749
"064131304","BUENOS AIRES",286,231,7,45,2,54,0.807692307692308
"064270401","BUENOS AIRES",301,299,2,0,0,2,0.993355481727575
"064131306","BUENOS AIRES",35,1,3,27,1,31,0.0285714285714286
"064131307","BUENOS AIRES",358,238,47,66,0,113,0.664804469273743
"064200316","BUENOS AIRES",35,29,3,2,0,5,0.828571428571429
"064131409","BUENOS AIRES",129,102,4,21,1,26,0.790697674418605
"065180506","BUENOS AIRES",67,0,25,41,1,67,0
"064131905","BUENOS AIRES",44,0,28,15,0,43,0
"064132103","BUENOS AIRES",228,225,1,1,0,2,0.986842105263158
"064132106","BUENOS AIRES",210,200,6,4,0,10,0.952380952380952
"064132208","BUENOS AIRES",110,9,43,57,0,100,0.0818181818181818
"064200104","BUENOS AIRES",222,61,108,52,0,160,0.274774774774775
"064201210","BUENOS AIRES",19,1,11,7,0,18,0.0526315789473684
"064200110","BUENOS AIRES",181,139,32,10,0,42,0.767955801104972
"064200212","BUENOS AIRES",113,108,3,2,0,5,0.955752212389381
"064200214","BUENOS AIRES",96,94,2,0,0,2,0.979166666666667
"064200307","BUENOS AIRES",97,67,20,10,0,30,0.690721649484536
"064200413","BUENOS AIRES",61,54,4,3,0,7,0.885245901639344
"064200502","BUENOS AIRES",37,34,3,0,0,3,0.918918918918919
"064200505","BUENOS AIRES",140,111,18,11,0,29,0.792857142857143
"064200506","BUENOS AIRES",228,206,18,4,0,22,0.903508771929825
"064200702","BUENOS AIRES",30,28,1,1,0,2,0.933333333333333
"064200802","BUENOS AIRES",262,65,116,80,0,196,0.248091603053435
"064200804","BUENOS AIRES",120,85,26,9,0,35,0.708333333333333
"064201107","BUENOS AIRES",57,52,3,2,0,5,0.912280701754386
"064201111","BUENOS AIRES",74,56,9,7,0,16,0.756756756756757
"064201113","BUENOS AIRES",80,62,13,4,1,18,0.775
"064201117","BUENOS AIRES",135,3,66,59,3,128,0.0222222222222222
"064201510","BUENOS AIRES",164,39,64,61,0,125,0.23780487804878
"064201608","BUENOS AIRES",25,23,1,1,0,2,0.92
"064201905","BUENOS AIRES",158,142,6,8,0,14,0.89873417721519
"064201906","BUENOS AIRES",178,158,16,4,0,20,0.887640449438202
"064201909","BUENOS AIRES",61,60,0,1,0,1,0.983606557377049
"064201912","BUENOS AIRES",54,51,3,0,0,3,0.944444444444444
"064202005","BUENOS AIRES",44,42,2,0,0,2,0.954545454545455
"064202012","BUENOS AIRES",58,58,0,0,0,0,1
"064202108","BUENOS AIRES",310,282,15,11,2,28,0.909677419354839
"064202112","BUENOS AIRES",279,206,37,33,1,71,0.738351254480287
"064202212","BUENOS AIRES",55,0,39,15,1,55,0
"064270101","BUENOS AIRES",220,218,1,1,0,2,0.990909090909091
"064270111","BUENOS AIRES",336,328,4,2,0,6,0.976190476190476
"064270206","BUENOS AIRES",176,176,0,0,0,0,1
"064270209","BUENOS AIRES",307,306,1,0,0,1,0.996742671009772
"064270213","BUENOS AIRES",238,233,2,3,0,5,0.978991596638655
"064270217","BUENOS AIRES",246,246,0,0,0,0,1
"064270508","BUENOS AIRES",257,248,9,0,0,9,0.964980544747082
"064270602","BUENOS AIRES",510,493,13,4,0,17,0.966666666666667
"064270703","BUENOS AIRES",334,306,3,0,0,3,0.916167664670659
"064270710","BUENOS AIRES",509,504,2,3,0,5,0.990176817288802
"065390903","BUENOS AIRES",316,2,214,92,2,308,0.00632911392405063
"064271003","BUENOS AIRES",258,230,10,8,0,18,0.891472868217054
"064271004","BUENOS AIRES",421,392,6,20,0,26,0.931116389548694
"064271009","BUENOS AIRES",476,455,8,10,0,18,0.955882352941177
"064271103","BUENOS AIRES",472,450,13,6,0,19,0.953389830508475
"064271104","BUENOS AIRES",366,351,5,9,0,14,0.959016393442623
"064271111","BUENOS AIRES",267,262,3,2,0,5,0.9812734082397
"064271201","BUENOS AIRES",464,454,4,4,0,8,0.978448275862069
"064271205","BUENOS AIRES",371,359,3,8,0,11,0.967654986522911
"064271206","BUENOS AIRES",436,386,6,2,0,8,0.885321100917431
"064271208","BUENOS AIRES",217,213,2,2,0,4,0.981566820276498
"064271304","BUENOS AIRES",510,467,27,16,0,43,0.915686274509804
"064271305","BUENOS AIRES",525,495,20,6,0,26,0.942857142857143
"064271308","BUENOS AIRES",282,273,6,3,0,9,0.968085106382979
"064271310","BUENOS AIRES",401,375,18,4,0,22,0.935162094763092
"064271405","BUENOS AIRES",399,297,11,62,18,91,0.744360902255639
"064271413","BUENOS AIRES",797,743,14,2,0,16,0.932245922208281
"064271601","BUENOS AIRES",429,389,13,24,0,37,0.906759906759907
"064272507","BUENOS AIRES",214,210,4,0,0,4,0.981308411214953
"064271603","BUENOS AIRES",406,389,7,10,0,17,0.958128078817734
"064271606","BUENOS AIRES",372,310,15,30,0,45,0.833333333333333
"064271702","BUENOS AIRES",327,323,1,3,0,4,0.987767584097859
"064271909","BUENOS AIRES",399,372,15,8,0,23,0.932330827067669
"064272003","BUENOS AIRES",274,267,5,1,0,6,0.974452554744526
"064272006","BUENOS AIRES",330,323,3,3,0,6,0.978787878787879
"064272010","BUENOS AIRES",298,282,2,12,0,14,0.946308724832215
"064272011","BUENOS AIRES",459,435,13,9,0,22,0.947712418300654
"064272015","BUENOS AIRES",330,85,178,62,3,243,0.257575757575758
"064272105","BUENOS AIRES",315,306,8,1,0,9,0.971428571428571
"064272203","BUENOS AIRES",438,382,23,18,0,41,0.872146118721461
"064273103","BUENOS AIRES",332,330,2,0,0,2,0.993975903614458
"064273108","BUENOS AIRES",172,170,1,1,0,2,0.988372093023256
"064272204","BUENOS AIRES",405,363,11,18,5,34,0.896296296296296
"064272302","BUENOS AIRES",358,342,10,4,1,15,0.955307262569832
"064272501","BUENOS AIRES",236,234,2,0,0,2,0.991525423728814
"064272506","BUENOS AIRES",303,301,1,1,0,2,0.993399339933993
"064272510","BUENOS AIRES",964,589,278,83,1,362,0.610995850622407
"064272513","BUENOS AIRES",184,183,0,0,0,0,0.994565217391304
"064272603","BUENOS AIRES",436,436,0,0,0,0,1
"064272608","BUENOS AIRES",409,398,3,5,0,8,0.973105134474328
"064272701","BUENOS AIRES",582,549,24,9,0,33,0.943298969072165
"064272709","BUENOS AIRES",459,407,21,28,2,51,0.886710239651416
"064272901","BUENOS AIRES",396,375,14,7,0,21,0.946969696969697
"064272905","BUENOS AIRES",368,361,6,1,0,7,0.980978260869565
"064272906","BUENOS AIRES",326,325,1,0,0,1,0.996932515337423
"064272911","BUENOS AIRES",412,364,27,20,1,48,0.883495145631068
"065392804","BUENOS AIRES",396,7,161,216,0,377,0.0176767676767677
"064273006","BUENOS AIRES",339,274,31,31,0,62,0.808259587020649
"020142604","CABA",850,850,0,0,0,0,1
"064273407","BUENOS AIRES",357,353,3,1,0,4,0.988795518207283
"020031006","CABA",390,390,0,0,0,0,1
"064273409","BUENOS AIRES",420,419,1,0,0,1,0.997619047619048
"064273507","BUENOS AIRES",278,260,12,2,0,14,0.935251798561151
"064273510","BUENOS AIRES",250,245,2,2,0,4,0.98
"064273610","BUENOS AIRES",309,309,0,0,0,0,1
"064273611","BUENOS AIRES",355,354,1,0,0,1,0.997183098591549
"064273709","BUENOS AIRES",456,377,37,37,0,74,0.826754385964912
"064273803","BUENOS AIRES",578,520,15,37,0,52,0.899653979238754
"064273805","BUENOS AIRES",305,299,3,1,0,4,0.980327868852459
"064273906","BUENOS AIRES",293,238,14,35,0,49,0.812286689419795
"064273911","BUENOS AIRES",343,326,15,2,0,17,0.950437317784257
"064274008","BUENOS AIRES",596,592,1,2,0,3,0.993288590604027
"064274101","BUENOS AIRES",603,476,63,51,0,114,0.7893864013267
"064274412","BUENOS AIRES",447,398,9,26,1,36,0.890380313199105
"064274508","BUENOS AIRES",510,471,24,9,0,33,0.923529411764706
"064274601","BUENOS AIRES",386,190,167,26,0,193,0.492227979274611
"064277407","BUENOS AIRES",436,3,297,120,0,417,0.00688073394495413
"064274608","BUENOS AIRES",226,4,92,126,0,218,0.0176991150442478
"064274703","BUENOS AIRES",143,86,36,17,1,54,0.601398601398601
"064274807","BUENOS AIRES",419,410,2,4,0,6,0.978520286396181
"064274812","BUENOS AIRES",538,470,47,15,0,62,0.87360594795539
"064274904","BUENOS AIRES",390,362,13,13,0,26,0.928205128205128
"064275213","BUENOS AIRES",472,22,140,296,1,437,0.0466101694915254
"064275202","BUENOS AIRES",493,430,46,15,0,61,0.872210953346856
"064275208","BUENOS AIRES",374,12,93,247,3,343,0.0320855614973262
"064275305","BUENOS AIRES",607,16,139,427,12,578,0.0263591433278418
"064275403","BUENOS AIRES",334,299,10,14,4,28,0.895209580838323
"064275411","BUENOS AIRES",332,303,17,8,0,25,0.912650602409639
"064275412","BUENOS AIRES",481,437,17,19,0,36,0.908523908523909
"064275510","BUENOS AIRES",425,388,18,12,0,30,0.912941176470588
"020021008","CABA",443,443,0,0,0,0,1
"064275511","BUENOS AIRES",494,457,24,7,0,31,0.925101214574899
"064275703","BUENOS AIRES",292,19,209,40,0,249,0.0650684931506849
"064275709","BUENOS AIRES",212,9,156,43,0,199,0.0424528301886792
"064279313","BUENOS AIRES",453,1,273,157,1,431,0.0022075055187638
"064275805","BUENOS AIRES",248,3,157,83,0,240,0.0120967741935484
"064275905","BUENOS AIRES",504,13,311,165,0,476,0.0257936507936508
"064275912","BUENOS AIRES",296,11,188,94,0,282,0.0371621621621622
"064275913","BUENOS AIRES",298,5,196,94,0,290,0.0167785234899329
"064276006","BUENOS AIRES",555,7,332,204,0,536,0.0126126126126126
"064276009","BUENOS AIRES",472,21,277,162,3,442,0.0444915254237288
"064276013","BUENOS AIRES",272,4,162,97,0,259,0.0147058823529412
"064276213","BUENOS AIRES",383,12,229,124,0,353,0.031331592689295
"064276301","BUENOS AIRES",472,31,288,145,1,434,0.0656779661016949
"064276302","BUENOS AIRES",104,22,28,46,2,76,0.211538461538462
"064276412","BUENOS AIRES",369,19,240,99,2,341,0.0514905149051491
"064276510","BUENOS AIRES",279,25,64,177,2,243,0.0896057347670251
"020030401","CABA",354,353,0,0,0,0,0.997175141242938
"064276605","BUENOS AIRES",484,4,378,92,0,470,0.00826446280991736
"064276608","BUENOS AIRES",335,10,256,66,1,323,0.0298507462686567
"064277316","BUENOS AIRES",329,12,73,217,10,300,0.0364741641337386
"020051401","CABA",274,272,1,1,0,2,0.992700729927007
"064276704","BUENOS AIRES",840,23,390,352,17,759,0.0273809523809524
"064276708","BUENOS AIRES",342,17,193,120,1,314,0.0497076023391813
"064276710","BUENOS AIRES",250,0,164,72,9,245,0
"064276711","BUENOS AIRES",314,4,209,98,0,307,0.0127388535031847
"064276716","BUENOS AIRES",289,14,152,115,1,268,0.0484429065743945
"064276807","BUENOS AIRES",299,3,179,110,0,289,0.0100334448160535
"064276808","BUENOS AIRES",340,0,269,52,1,322,0
"064276909","BUENOS AIRES",523,5,428,85,1,514,0.00956022944550669
"064277011","BUENOS AIRES",287,19,195,61,0,256,0.0662020905923345
"065601304","BUENOS AIRES",321,2,162,151,2,315,0.00623052959501558
"064277102","BUENOS AIRES",427,5,286,128,0,414,0.0117096018735363
"064277104","BUENOS AIRES",240,9,152,75,0,227,0.0375
"064277204","BUENOS AIRES",350,30,231,82,0,313,0.0857142857142857
"064277308","BUENOS AIRES",510,28,249,218,1,468,0.0549019607843137
"064277502","BUENOS AIRES",579,37,309,214,8,531,0.0639032815198618
"064277510","BUENOS AIRES",471,10,118,317,1,436,0.0212314225053079
"064277705","BUENOS AIRES",301,1,115,171,2,288,0.00332225913621262
"064277708","BUENOS AIRES",306,7,118,173,0,291,0.0228758169934641
"064277714","BUENOS AIRES",301,4,153,127,0,280,0.0132890365448505
"064277715","BUENOS AIRES",268,0,163,98,0,261,0
"064277901","BUENOS AIRES",568,33,385,135,1,521,0.0580985915492958
"064277911","BUENOS AIRES",495,1,309,159,3,471,0.00202020202020202
"064278008","BUENOS AIRES",458,1,264,168,5,437,0.00218340611353712
"064278016","BUENOS AIRES",293,4,60,213,8,281,0.0136518771331058
"064278108","BUENOS AIRES",35,1,12,18,3,33,0.0285714285714286
"064278204","BUENOS AIRES",312,4,212,89,0,301,0.0128205128205128
"064278206","BUENOS AIRES",433,18,195,204,3,402,0.0415704387990762
"065601914","BUENOS AIRES",243,2,181,59,1,241,0.00823045267489712
"064278209","BUENOS AIRES",747,88,220,374,8,602,0.117804551539491
"065602002","BUENOS AIRES",363,8,173,175,1,349,0.0220385674931129
"064278310","BUENOS AIRES",355,21,144,180,3,327,0.0591549295774648
"064340906","BUENOS AIRES",282,43,64,163,0,227,0.152482269503546
"064278311","BUENOS AIRES",351,14,261,72,0,333,0.0398860398860399
"064278404","BUENOS AIRES",399,5,201,179,1,381,0.012531328320802
"064278405","BUENOS AIRES",508,6,222,248,3,473,0.0118110236220472
"064278408","BUENOS AIRES",403,1,211,182,0,393,0.00248138957816377
"064278613","BUENOS AIRES",386,13,246,120,0,366,0.0336787564766839
"064278704","BUENOS AIRES",382,2,273,98,2,373,0.00523560209424084
"064278708","BUENOS AIRES",477,8,261,190,3,454,0.0167714884696017
"064278713","BUENOS AIRES",336,1,267,59,0,326,0.00297619047619048
"065151808","BUENOS AIRES",309,7,108,178,0,286,0.0226537216828479
"064278902","BUENOS AIRES",572,8,217,314,8,539,0.013986013986014
"064278907","BUENOS AIRES",561,6,183,313,14,510,0.0106951871657754
"064279312","BUENOS AIRES",415,4,280,119,2,401,0.00963855421686747
"064278914","BUENOS AIRES",559,6,152,363,5,520,0.0107334525939177
"064279009","BUENOS AIRES",599,5,336,245,3,584,0.00834724540901502
"064279011","BUENOS AIRES",295,16,200,70,4,274,0.0542372881355932
"064279106","BUENOS AIRES",308,8,214,73,3,290,0.025974025974026
"064279108","BUENOS AIRES",374,2,173,181,7,361,0.0053475935828877
"064341511","BUENOS AIRES",173,173,0,0,0,0,1
"064279208","BUENOS AIRES",488,9,219,222,10,451,0.0184426229508197
"065151709","BUENOS AIRES",117,0,70,45,0,115,0
"065151801","BUENOS AIRES",488,11,231,228,1,460,0.0225409836065574
"065151802","BUENOS AIRES",333,1,176,147,6,329,0.003003003003003
"064279309","BUENOS AIRES",451,0,278,159,1,438,0
"064279310","BUENOS AIRES",445,3,313,124,1,438,0.00674157303370787
"064279409","BUENOS AIRES",426,1,290,124,2,416,0.00234741784037559
"064279410","BUENOS AIRES",380,5,240,125,1,366,0.0131578947368421
"064279503","BUENOS AIRES",485,11,202,244,1,447,0.022680412371134
"065681310","BUENOS AIRES",347,323,15,5,0,20,0.930835734870317
"064341709","BUENOS AIRES",250,174,43,33,0,76,0.696
"064279610","BUENOS AIRES",498,3,268,187,3,458,0.00602409638554217
"064279612","BUENOS AIRES",391,4,109,228,6,343,0.010230179028133
"064340703","BUENOS AIRES",304,211,29,64,0,93,0.694078947368421
"064340805","BUENOS AIRES",287,10,128,148,0,276,0.0348432055749129
"064279614","BUENOS AIRES",437,13,161,223,10,394,0.0297482837528604
"065151806","BUENOS AIRES",351,1,156,172,7,335,0.00284900284900285
"064279714","BUENOS AIRES",377,178,70,117,3,190,0.472148541114058
"020022304","CABA",381,380,1,0,0,1,0.99737532808399
"064279712","BUENOS AIRES",140,10,61,63,2,126,0.0714285714285714
"065682218","BUENOS AIRES",129,112,15,2,0,17,0.868217054263566
"064279723","BUENOS AIRES",289,2,159,118,4,281,0.0069204152249135
"065682510","BUENOS AIRES",326,0,89,211,3,303,0
"064340102","BUENOS AIRES",285,234,26,24,0,50,0.821052631578947
"064340109","BUENOS AIRES",256,244,6,4,0,10,0.953125
"064340111","BUENOS AIRES",309,294,11,4,0,15,0.951456310679612
"064340309","BUENOS AIRES",502,421,47,34,0,81,0.838645418326693
"065682807","BUENOS AIRES",243,1,203,35,0,238,0.00411522633744856
"064340908","BUENOS AIRES",271,7,72,180,0,252,0.025830258302583
"064341002","BUENOS AIRES",167,7,72,82,1,155,0.0419161676646707
"064341202","BUENOS AIRES",380,101,130,149,0,279,0.265789473684211
"064341302","BUENOS AIRES",219,174,28,16,0,44,0.794520547945205
"064341309","BUENOS AIRES",360,96,142,122,0,264,0.266666666666667
"064341408","BUENOS AIRES",347,25,141,180,0,321,0.0720461095100865
"064341501","BUENOS AIRES",180,175,5,0,0,5,0.972222222222222
"064341503","BUENOS AIRES",177,167,10,0,0,10,0.943502824858757
"064341504","BUENOS AIRES",218,178,24,16,0,40,0.81651376146789
"064341510","BUENOS AIRES",178,177,1,0,0,1,0.99438202247191
"064341804","BUENOS AIRES",219,198,9,12,0,21,0.904109589041096
"064341806","BUENOS AIRES",384,373,2,9,0,11,0.971354166666667
"064341808","BUENOS AIRES",261,256,5,0,0,5,0.980842911877395
"064341810","BUENOS AIRES",167,166,0,0,0,0,0.994011976047904
"064341813","BUENOS AIRES",302,277,13,12,0,25,0.917218543046358
"064341905","BUENOS AIRES",354,264,48,42,0,90,0.745762711864407
"064342006","BUENOS AIRES",406,320,53,33,0,86,0.788177339901478
"064342009","BUENOS AIRES",292,49,165,78,0,243,0.167808219178082
"064342112","BUENOS AIRES",313,22,165,125,0,290,0.0702875399361022
"064411113","BUENOS AIRES",323,297,0,0,0,0,0.919504643962848
"064342212","BUENOS AIRES",311,129,97,84,0,181,0.414790996784566
"064342303","BUENOS AIRES",367,63,74,221,1,296,0.171662125340599
"064342310","BUENOS AIRES",257,25,91,137,0,228,0.0972762645914397
"064342403","BUENOS AIRES",242,28,148,66,0,214,0.115702479338843
"064342503","BUENOS AIRES",179,4,99,76,0,175,0.0223463687150838
"065810712","BUENOS AIRES",158,1,47,106,3,156,0.00632911392405063
"064342509","BUENOS AIRES",225,16,73,134,0,207,0.0711111111111111
"064343201","BUENOS AIRES",337,324,3,10,0,13,0.961424332344214
"064342606","BUENOS AIRES",128,4,47,63,0,110,0.03125
"064342804","BUENOS AIRES",308,2,132,170,0,302,0.00649350649350649
"064342812","BUENOS AIRES",238,8,91,139,0,230,0.0336134453781513
"064342901","BUENOS AIRES",357,15,172,166,0,338,0.0420168067226891
"064343108","BUENOS AIRES",183,180,2,0,0,2,0.983606557377049
"064343208","BUENOS AIRES",273,197,40,36,0,76,0.721611721611722
"064343307","BUENOS AIRES",326,9,151,165,0,316,0.0276073619631902
"064343404","BUENOS AIRES",229,8,133,87,1,221,0.0349344978165939
"064343414","BUENOS AIRES",309,18,104,176,1,281,0.058252427184466
"064343501","BUENOS AIRES",371,15,195,160,0,355,0.0404312668463612
"064343504","BUENOS AIRES",429,15,163,249,0,412,0.034965034965035
"064343512","BUENOS AIRES",164,12,53,87,1,141,0.0731707317073171
"064343603","BUENOS AIRES",325,114,150,61,0,211,0.350769230769231
"064343606","BUENOS AIRES",342,11,143,188,0,331,0.0321637426900585
"064343708","BUENOS AIRES",235,218,13,4,0,17,0.927659574468085
"064343807","BUENOS AIRES",217,214,3,0,0,3,0.986175115207373
"064344006","BUENOS AIRES",221,178,28,14,0,42,0.805429864253394
"064344105","BUENOS AIRES",306,11,115,180,0,295,0.0359477124183007
"064344305","BUENOS AIRES",244,95,72,77,0,149,0.389344262295082
"064344504","BUENOS AIRES",320,9,71,234,0,305,0.028125
"064410102","BUENOS AIRES",303,297,0,4,0,4,0.98019801980198
"020142308","CABA",482,452,3,0,0,3,0.937759336099585
"064410104","BUENOS AIRES",258,255,0,3,0,3,0.988372093023256
"064410209","BUENOS AIRES",392,392,0,0,0,0,1
"064410107","BUENOS AIRES",244,243,0,0,0,0,0.995901639344262
"064410305","BUENOS AIRES",258,258,0,0,0,0,1
"064410308","BUENOS AIRES",239,238,0,0,0,0,0.99581589958159
"064410509","BUENOS AIRES",157,155,2,0,0,2,0.987261146496815
"064410603","BUENOS AIRES",227,223,0,0,0,0,0.982378854625551
"064410805","BUENOS AIRES",157,156,1,0,0,1,0.993630573248408
"064410808","BUENOS AIRES",231,230,1,0,0,1,0.995670995670996
"064410901","BUENOS AIRES",153,151,2,0,0,2,0.986928104575163
"064410902","BUENOS AIRES",293,293,0,0,0,0,1
"064410909","BUENOS AIRES",243,242,1,0,0,1,0.995884773662551
"064410911","BUENOS AIRES",210,210,0,0,0,0,1
"064411011","BUENOS AIRES",193,193,0,0,0,0,1
"064411116","BUENOS AIRES",203,203,0,0,0,0,1
"064411209","BUENOS AIRES",163,163,0,0,0,0,1
"064411212","BUENOS AIRES",161,160,1,0,0,1,0.993788819875776
"064411308","BUENOS AIRES",200,200,0,0,0,0,1
"064411401","BUENOS AIRES",173,171,1,0,0,1,0.988439306358382
"064411402","BUENOS AIRES",155,155,0,0,0,0,1
"064411512","BUENOS AIRES",195,195,0,0,0,0,1
"064411603","BUENOS AIRES",214,213,1,0,0,1,0.995327102803738
"064411613","BUENOS AIRES",166,165,1,0,0,1,0.993975903614458
"064411705","BUENOS AIRES",314,313,1,0,0,1,0.996815286624204
"020021803","CABA",397,397,0,0,0,0,1
"064411706","BUENOS AIRES",190,189,0,1,0,1,0.994736842105263
"064411708","BUENOS AIRES",245,243,2,0,0,2,0.991836734693878
"064411710","BUENOS AIRES",179,179,0,0,0,0,1
"064412004","BUENOS AIRES",166,164,2,0,0,2,0.987951807228916
"064412008","BUENOS AIRES",228,228,0,0,0,0,1
"064412012","BUENOS AIRES",131,131,0,0,0,0,1
"064412015","BUENOS AIRES",163,158,0,0,0,0,0.969325153374233
"064412016","BUENOS AIRES",151,151,0,0,0,0,1
"064412017","BUENOS AIRES",147,147,0,0,0,0,1
"065950413","BUENOS AIRES",346,12,172,162,0,334,0.0346820809248555
"064412107","BUENOS AIRES",199,199,0,0,0,0,1
"064412206","BUENOS AIRES",233,230,0,3,0,3,0.987124463519313
"064412303","BUENOS AIRES",234,234,0,0,0,0,1
"064412401","BUENOS AIRES",204,204,0,0,0,0,1
"064412410","BUENOS AIRES",187,185,2,0,0,2,0.989304812834225
"064412505","BUENOS AIRES",331,331,0,0,0,0,1
"064412610","BUENOS AIRES",400,396,3,0,0,3,0.99
"064412705","BUENOS AIRES",384,381,3,0,0,3,0.9921875
"064412802","BUENOS AIRES",307,285,3,1,0,4,0.928338762214984
"064412901","BUENOS AIRES",212,208,2,0,0,2,0.981132075471698
"064412902","BUENOS AIRES",210,206,3,1,0,4,0.980952380952381
"064412903","BUENOS AIRES",241,239,1,1,0,2,0.991701244813278
"064412910","BUENOS AIRES",202,201,1,0,0,1,0.995049504950495
"064413002","BUENOS AIRES",360,25,204,126,0,330,0.0694444444444444
"064413008","BUENOS AIRES",225,219,4,0,0,4,0.973333333333333
"065952403","BUENOS AIRES",289,283,5,1,0,6,0.97923875432526
"064413104","BUENOS AIRES",177,177,0,0,0,0,1
"064413110","BUENOS AIRES",218,218,0,0,0,0,1
"064413115","BUENOS AIRES",238,235,3,0,0,3,0.987394957983193
"064413205","BUENOS AIRES",390,375,7,7,0,14,0.961538461538462
"064413208","BUENOS AIRES",319,280,20,14,0,34,0.877742946708464
"064413303","BUENOS AIRES",277,272,2,2,0,4,0.981949458483754
"064413402","BUENOS AIRES",252,234,8,9,0,17,0.928571428571429
"064413404","BUENOS AIRES",258,250,4,4,0,8,0.968992248062015
"064413413","BUENOS AIRES",301,18,145,119,5,269,0.0598006644518272
"064413504","BUENOS AIRES",201,193,5,3,0,8,0.960199004975124
"064413511","BUENOS AIRES",430,429,1,0,0,1,0.997674418604651
"064413601","BUENOS AIRES",289,282,3,2,0,5,0.975778546712803
"064413605","BUENOS AIRES",358,297,16,31,8,55,0.829608938547486
"064620701","BUENOS AIRES",319,161,70,80,1,151,0.504702194357367
"064413606","BUENOS AIRES",340,30,106,179,6,291,0.0882352941176471
"064413612","BUENOS AIRES",325,247,42,33,0,75,0.76
"064413705","BUENOS AIRES",337,6,112,204,0,316,0.0178041543026706
"064413708","BUENOS AIRES",297,208,68,12,0,80,0.7003367003367
"064413713","BUENOS AIRES",255,24,123,97,1,221,0.0941176470588235
"064413805","BUENOS AIRES",288,272,10,6,0,16,0.944444444444444
"064413807","BUENOS AIRES",349,329,11,8,0,19,0.94269340974212
"064413902","BUENOS AIRES",232,227,5,0,0,5,0.978448275862069
"064414006","BUENOS AIRES",348,330,4,13,0,17,0.948275862068966
"064414007","BUENOS AIRES",293,251,26,12,0,38,0.856655290102389
"064414008","BUENOS AIRES",265,212,23,27,0,50,0.8
"064414209","BUENOS AIRES",283,65,94,110,1,205,0.229681978798587
"064414213","BUENOS AIRES",137,4,53,74,0,127,0.0291970802919708
"064414214","BUENOS AIRES",131,1,37,81,1,119,0.00763358778625954
"064414301","BUENOS AIRES",265,65,107,90,2,199,0.245283018867925
"064414315","BUENOS AIRES",461,37,152,249,6,407,0.0802603036876356
"064414401","BUENOS AIRES",283,14,167,98,0,265,0.049469964664311
"064414606","BUENOS AIRES",232,162,63,6,0,69,0.698275862068966
"064414701","BUENOS AIRES",520,258,147,108,2,257,0.496153846153846
"064414704","BUENOS AIRES",456,194,197,64,0,261,0.425438596491228
"064414901","BUENOS AIRES",314,296,13,4,0,17,0.942675159235669
"064415008","BUENOS AIRES",235,232,3,0,0,3,0.987234042553191
"064415106","BUENOS AIRES",178,55,35,76,0,111,0.308988764044944
"064415201","BUENOS AIRES",296,113,24,137,0,161,0.381756756756757
"064415210","BUENOS AIRES",252,248,2,1,0,3,0.984126984126984
"064903108","BUENOS AIRES",401,26,136,220,1,357,0.0648379052369077
"064415806","BUENOS AIRES",197,195,2,0,0,2,0.989847715736041
"064415410","BUENOS AIRES",293,275,8,10,0,18,0.938566552901024
"064415412","BUENOS AIRES",308,181,102,25,0,127,0.587662337662338
"064415501","BUENOS AIRES",487,89,246,135,3,384,0.182751540041068
"064415509","BUENOS AIRES",246,20,179,43,0,222,0.0813008130081301
"064415602","BUENOS AIRES",369,363,4,2,0,6,0.983739837398374
"064415604","BUENOS AIRES",265,252,10,3,0,13,0.950943396226415
"064415708","BUENOS AIRES",289,209,62,18,0,80,0.72318339100346
"064415709","BUENOS AIRES",245,70,127,44,4,175,0.285714285714286
"064903301","BUENOS AIRES",239,2,88,142,1,231,0.00836820083682008
"064415713","BUENOS AIRES",244,205,31,8,0,39,0.840163934426229
"064415904","BUENOS AIRES",282,282,0,0,0,0,1
"064416105","BUENOS AIRES",288,245,32,11,0,43,0.850694444444444
"064416108","BUENOS AIRES",95,37,24,34,0,58,0.389473684210526
"064416303","BUENOS AIRES",274,4,248,21,0,269,0.0145985401459854
"064690204","BUENOS AIRES",394,277,56,53,2,111,0.703045685279188
"064690211","BUENOS AIRES",262,136,44,81,0,125,0.519083969465649
"064830110","BUENOS AIRES",306,304,1,1,0,2,0.993464052287582
"064416304","BUENOS AIRES",293,5,190,88,5,283,0.0170648464163823
"064416403","BUENOS AIRES",137,0,30,101,0,131,0
"064416504","BUENOS AIRES",40,2,11,26,1,38,0.05
"064416508","BUENOS AIRES",45,0,30,12,0,42,0
"064416802","BUENOS AIRES",446,33,220,183,0,403,0.0739910313901345
"064416910","BUENOS AIRES",232,181,31,18,1,50,0.780172413793103
"064417006","BUENOS AIRES",298,10,58,217,5,280,0.0335570469798658
"066380710","BUENOS AIRES",341,1,185,151,0,336,0.00293255131964809
"064480608","BUENOS AIRES",385,209,74,101,0,175,0.542857142857143
"066380804","BUENOS AIRES",160,158,0,0,0,0,0.9875
"064550111","BUENOS AIRES",143,10,21,110,0,131,0.0699300699300699
"066381302","BUENOS AIRES",303,0,141,152,2,295,0
"020152104","CABA",343,342,1,0,0,1,0.997084548104956
"064691001","BUENOS AIRES",125,0,91,34,0,125,0
"064691307","BUENOS AIRES",259,2,140,114,0,254,0.00772200772200772
"064760102","BUENOS AIRES",292,266,10,12,1,23,0.910958904109589
"064760201","BUENOS AIRES",407,4,254,146,3,403,0.00982800982800983
"066440101","BUENOS AIRES",65,32,21,12,0,33,0.492307692307692
"066440203","BUENOS AIRES",48,39,6,3,0,9,0.8125
"064760707","BUENOS AIRES",133,21,29,75,3,107,0.157894736842105
"066440402","BUENOS AIRES",68,36,29,2,0,31,0.529411764705882
"064761101","BUENOS AIRES",10,0,2,7,1,10,0
"064761201","BUENOS AIRES",3,0,3,0,0,3,0
"064761403","BUENOS AIRES",322,286,8,27,0,35,0.888198757763975
"064830107","BUENOS AIRES",215,214,1,0,0,1,0.995348837209302
"064830402","BUENOS AIRES",180,0,111,67,0,178,0
"064830416","BUENOS AIRES",228,7,108,110,0,218,0.0307017543859649
"064900203","BUENOS AIRES",356,34,89,214,0,303,0.0955056179775281
"064900107","BUENOS AIRES",229,19,52,158,0,210,0.0829694323144105
"064900210","BUENOS AIRES",368,16,105,233,2,340,0.0434782608695652
"064900304","BUENOS AIRES",134,2,42,82,1,125,0.0149253731343284
"064900406","BUENOS AIRES",348,19,106,201,2,309,0.0545977011494253
"064900410","BUENOS AIRES",301,16,98,179,0,277,0.053156146179402
"064900411","BUENOS AIRES",441,17,221,193,0,414,0.0385487528344671
"064900414","BUENOS AIRES",494,18,236,228,0,464,0.0364372469635627
"064900503","BUENOS AIRES",286,17,115,145,0,260,0.0594405594405594
"064900509","BUENOS AIRES",259,31,136,78,0,214,0.11969111969112
"064900510","BUENOS AIRES",458,54,196,201,1,398,0.117903930131004
"064900615","BUENOS AIRES",308,293,15,0,0,15,0.951298701298701
"064903110","BUENOS AIRES",275,5,194,75,0,269,0.0181818181818182
"064903207","BUENOS AIRES",338,6,126,200,1,327,0.0177514792899408
"064900713","BUENOS AIRES",247,14,143,88,0,231,0.0566801619433198
"064901001","BUENOS AIRES",233,190,13,12,0,25,0.815450643776824
"064901005","BUENOS AIRES",354,349,3,2,0,5,0.985875706214689
"064901009","BUENOS AIRES",263,130,54,77,0,131,0.494296577946768
"064901011","BUENOS AIRES",396,350,32,13,0,45,0.883838383838384
"064901102","BUENOS AIRES",287,277,4,6,0,10,0.965156794425087
"064901107","BUENOS AIRES",185,184,1,0,0,1,0.994594594594595
"064901112","BUENOS AIRES",239,237,1,1,0,2,0.99163179916318
"064901206","BUENOS AIRES",354,352,2,0,0,2,0.994350282485876
"064901207","BUENOS AIRES",329,287,23,19,0,42,0.872340425531915
"064901401","BUENOS AIRES",312,7,157,145,1,303,0.0224358974358974
"064901404","BUENOS AIRES",242,15,81,139,0,220,0.0619834710743802
"064901408","BUENOS AIRES",253,8,54,137,0,191,0.0316205533596838
"064901502","BUENOS AIRES",296,5,129,153,0,282,0.0168918918918919
"064901703","BUENOS AIRES",254,14,73,135,3,211,0.0551181102362205
"064901704","BUENOS AIRES",385,14,164,201,0,365,0.0363636363636364
"064903204","BUENOS AIRES",301,8,89,193,1,283,0.026578073089701
"064901709","BUENOS AIRES",297,21,125,124,0,249,0.0707070707070707
"066580414","BUENOS AIRES",198,196,2,0,0,2,0.98989898989899
"064902003","BUENOS AIRES",336,74,171,91,0,262,0.220238095238095
"064902004","BUENOS AIRES",215,213,2,0,0,2,0.990697674418605
"064902105","BUENOS AIRES",337,333,2,2,0,4,0.98813056379822
"066580704","BUENOS AIRES",302,302,0,0,0,0,1
"064902201","BUENOS AIRES",265,264,1,0,0,1,0.99622641509434
"064902210","BUENOS AIRES",378,378,0,0,0,0,1
"064902301","BUENOS AIRES",286,263,17,6,0,23,0.91958041958042
"064902302","BUENOS AIRES",240,236,1,2,0,3,0.983333333333333
"064902408","BUENOS AIRES",183,182,1,0,0,1,0.994535519125683
"064902602","BUENOS AIRES",265,141,64,60,0,124,0.532075471698113
"064902702","BUENOS AIRES",421,12,257,151,0,408,0.0285035629453682
"064902710","BUENOS AIRES",492,11,379,100,0,479,0.0223577235772358
"064902806","BUENOS AIRES",413,15,266,131,0,397,0.036319612590799
"064902811","BUENOS AIRES",313,12,151,149,0,300,0.0383386581469649
"064902903","BUENOS AIRES",304,26,158,112,1,271,0.0855263157894737
"064903004","BUENOS AIRES",276,2,129,138,1,268,0.0072463768115942
"064903103","BUENOS AIRES",413,6,183,198,2,383,0.0145278450363196
"064903302","BUENOS AIRES",283,7,122,142,2,266,0.0247349823321555
"064903303","BUENOS AIRES",441,20,187,187,2,376,0.0453514739229025
"064903413","BUENOS AIRES",359,9,124,208,10,342,0.0250696378830084
"064903501","BUENOS AIRES",259,15,83,136,0,219,0.0579150579150579
"064903502","BUENOS AIRES",270,17,81,162,2,245,0.062962962962963
"064903511","BUENOS AIRES",271,4,70,142,1,213,0.014760147601476
"064903515","BUENOS AIRES",243,4,116,116,1,233,0.0164609053497942
"064903707","BUENOS AIRES",251,2,82,152,1,235,0.00796812749003984
"066582208","BUENOS AIRES",223,221,0,1,0,1,0.991031390134529
"064903902","BUENOS AIRES",188,3,43,125,5,173,0.0159574468085106
"064903910","BUENOS AIRES",240,2,103,122,2,227,0.00833333333333333
"064903913","BUENOS AIRES",203,8,56,124,0,180,0.0394088669950739
"064904204","BUENOS AIRES",325,6,226,93,0,319,0.0184615384615385
"064904206","BUENOS AIRES",331,7,254,70,0,324,0.0211480362537764
"060070109","BUENOS AIRES",8,0,0,8,0,8,0
"060070112","BUENOS AIRES",7,0,4,3,0,7,0
"060070301","BUENOS AIRES",5,0,2,3,0,5,0
"064904301","BUENOS AIRES",15,1,11,1,0,12,0.0666666666666667
"064904302","BUENOS AIRES",245,13,171,60,0,231,0.0530612244897959
"064904609","BUENOS AIRES",288,263,17,7,0,24,0.913194444444444
"064904702","BUENOS AIRES",309,15,39,255,0,294,0.0485436893203883
"064904712","BUENOS AIRES",278,3,228,47,0,275,0.0107913669064748
"064904802","BUENOS AIRES",271,270,0,1,0,1,0.996309963099631
"065391206","BUENOS AIRES",334,1,219,109,1,329,0.0029940119760479
"065391211","BUENOS AIRES",300,0,204,87,0,291,0
"065391214","BUENOS AIRES",345,1,286,53,0,339,0.00289855072463768
"065391303","BUENOS AIRES",281,1,178,99,1,278,0.00355871886120996
"065391305","BUENOS AIRES",298,3,208,77,0,285,0.0100671140939597
"065391306","BUENOS AIRES",317,4,222,84,0,306,0.0126182965299685
"065391401","BUENOS AIRES",351,319,24,6,0,30,0.908831908831909
"065391403","BUENOS AIRES",305,243,49,12,0,61,0.79672131147541
"061120308","BUENOS AIRES",9,0,6,3,0,9,0
"061610603","BUENOS AIRES",6,0,1,5,0,6,0
"061680404","BUENOS AIRES",3,0,0,3,0,3,0
"065391511","BUENOS AIRES",289,10,247,29,0,276,0.0346020761245675
"060070512","BUENOS AIRES",5,0,1,4,0,5,0
"060070515","BUENOS AIRES",11,0,6,3,1,10,0
"060070605","BUENOS AIRES",9,0,6,3,0,9,0
"060070608","BUENOS AIRES",6,0,1,5,0,6,0
"060070615","BUENOS AIRES",8,0,7,1,0,8,0
"065391603","BUENOS AIRES",204,189,11,3,0,14,0.926470588235294
"060071006","BUENOS AIRES",13,0,8,5,0,13,0
"060071101","BUENOS AIRES",11,0,6,5,0,11,0
"060210401","BUENOS AIRES",12,0,7,5,0,12,0
"062170701","BUENOS AIRES",8,0,1,7,0,8,0
"060630602","BUENOS AIRES",22,0,11,9,0,20,0
"060770901","BUENOS AIRES",12,0,2,10,0,12,0
"060630804","BUENOS AIRES",27,0,11,12,3,26,0
"061190805","BUENOS AIRES",15,0,5,10,0,15,0
"060420201","BUENOS AIRES",55,1,17,35,1,53,0.0181818181818182
"060421701","BUENOS AIRES",36,0,13,23,0,36,0
"060491102","BUENOS AIRES",42,3,15,22,1,38,0.0714285714285714
"060630903","BUENOS AIRES",17,0,7,9,0,16,0
"060631002","BUENOS AIRES",122,4,63,54,1,118,0.0327868852459016
"060771102","BUENOS AIRES",8,0,3,3,2,8,0
"061470704","BUENOS AIRES",16,0,5,10,0,15,0
"060491301","BUENOS AIRES",38,0,8,29,0,37,0
"060491401","BUENOS AIRES",18,0,6,12,0,18,0
"060563201","BUENOS AIRES",23,0,11,12,0,23,0
"062310606","BUENOS AIRES",23,0,5,16,0,21,0
"060770903","BUENOS AIRES",13,0,3,9,1,13,0
"065392311","BUENOS AIRES",353,6,199,142,0,341,0.0169971671388102
"060563007","BUENOS AIRES",27,0,12,15,0,27,0
"060630305","BUENOS AIRES",32,0,15,13,1,29,0
"060631003","BUENOS AIRES",43,0,14,28,1,43,0
"060700402","BUENOS AIRES",19,0,13,6,0,19,0
"060700903","BUENOS AIRES",13,0,2,11,0,13,0
"065391717","BUENOS AIRES",237,231,5,0,0,5,0.974683544303797
"060770506","BUENOS AIRES",30,0,5,25,0,30,0
"060770801","BUENOS AIRES",14,0,4,10,0,14,0
"060770905","BUENOS AIRES",11,0,7,4,0,11,0
"060840907","BUENOS AIRES",30,0,7,23,0,30,0
"062800508","BUENOS AIRES",19,0,1,15,0,16,0
"062800811","BUENOS AIRES",8,0,3,5,0,8,0
"062940101","BUENOS AIRES",9,0,2,6,0,8,0
"065391902","BUENOS AIRES",350,302,34,9,0,43,0.862857142857143
"061050501","BUENOS AIRES",40,0,24,14,1,39,0
"061120302","BUENOS AIRES",9,0,8,1,0,9,0
"062031003","BUENOS AIRES",12,0,9,3,0,12,0
"061120303","BUENOS AIRES",7,0,7,0,0,7,0
"061120602","BUENOS AIRES",9,0,8,0,0,8,0
"061120603","BUENOS AIRES",14,0,10,4,0,14,0
"061120605","BUENOS AIRES",10,0,2,7,0,9,0
"061120802","BUENOS AIRES",25,0,10,15,0,25,0
"061120805","BUENOS AIRES",13,0,5,8,0,13,0
"061121001","BUENOS AIRES",46,0,30,14,0,44,0
"061121303","BUENOS AIRES",24,0,4,18,0,22,0
"063220201","BUENOS AIRES",16,0,0,6,10,16,0
"061121304","BUENOS AIRES",13,0,7,6,0,13,0
"061190101","BUENOS AIRES",27,0,21,6,0,27,0
"065392012","BUENOS AIRES",439,1,286,137,0,423,0.00227790432801822
"061190402","BUENOS AIRES",12,0,6,6,0,12,0
"061190601","BUENOS AIRES",19,0,8,10,0,18,0
"061190703","BUENOS AIRES",23,0,15,8,0,23,0
"061190806","BUENOS AIRES",20,0,14,6,0,20,0
"061260406","BUENOS AIRES",15,1,9,4,0,13,0.0666666666666667
"065392002","BUENOS AIRES",12,0,12,0,0,12,0
"061400202","BUENOS AIRES",15,0,4,11,0,15,0
"061470204","BUENOS AIRES",9,0,0,8,0,8,0
"061470907","BUENOS AIRES",22,0,13,8,1,22,0
"061471002","BUENOS AIRES",23,0,6,17,0,23,0
"061471003","BUENOS AIRES",15,0,8,7,0,15,0
"061540203","BUENOS AIRES",23,0,8,14,1,23,0
"061540805","BUENOS AIRES",22,0,16,6,0,22,0
"061610202","BUENOS AIRES",11,0,0,10,1,11,0
"061610203","BUENOS AIRES",7,0,6,1,0,7,0
"061610605","BUENOS AIRES",24,0,19,5,0,24,0
"062030302","BUENOS AIRES",13,0,6,7,0,13,0
"061750104","BUENOS AIRES",7,0,4,3,0,7,0
"061960401","BUENOS AIRES",19,0,9,8,1,18,0
"061960602","BUENOS AIRES",3,0,0,3,0,3,0
"065392106","BUENOS AIRES",267,5,185,75,0,260,0.0187265917602996
"061750502","BUENOS AIRES",31,0,24,7,0,31,0
"061890205","BUENOS AIRES",1,0,1,0,0,1,0
"061890502","BUENOS AIRES",4,0,2,0,0,2,0
"061890802","BUENOS AIRES",9,0,6,3,0,9,0
"062030604","BUENOS AIRES",12,0,11,1,0,12,0
"062031201","BUENOS AIRES",7,0,4,3,0,7,0
"061891102","BUENOS AIRES",10,0,7,3,0,10,0
"061891105","BUENOS AIRES",15,0,11,3,0,14,0
"061891506","BUENOS AIRES",2,0,2,0,0,2,0
"020011405","CABA",226,211,3,0,0,3,0.933628318584071
"061961001","BUENOS AIRES",9,0,2,6,0,8,0
"065392202","BUENOS AIRES",525,14,372,123,3,498,0.0266666666666667
"063640503","BUENOS AIRES",15,0,9,5,0,14,0
"062030602","BUENOS AIRES",8,0,7,1,0,8,0
"062030205","BUENOS AIRES",18,0,0,18,0,18,0
"062030709","BUENOS AIRES",2,0,1,1,0,2,0
"062031407","BUENOS AIRES",3,0,0,3,0,3,0
"062800501","BUENOS AIRES",7,0,2,2,1,5,0
"062030710","BUENOS AIRES",9,0,3,4,1,8,0
"065392305","BUENOS AIRES",428,4,321,99,0,420,0.00934579439252336
"065392306","BUENOS AIRES",382,1,187,190,0,377,0.00261780104712042
"062030811","BUENOS AIRES",94,0,53,38,0,91,0
"062030812","BUENOS AIRES",167,38,91,37,0,128,0.227544910179641
"065392310","BUENOS AIRES",338,3,248,79,0,327,0.00887573964497041
"062031306","BUENOS AIRES",9,0,0,9,0,9,0
"068051409","BUENOS AIRES",333,7,205,119,0,324,0.021021021021021
"062031408","BUENOS AIRES",0,0,0,0,0,0,NA
"062100701","BUENOS AIRES",64,0,32,31,1,64,0
"062170508","BUENOS AIRES",19,0,10,9,0,19,0
"062170802","BUENOS AIRES",21,0,6,15,0,21,0
"063850204","BUENOS AIRES",11,0,5,6,0,11,0
"065392414","BUENOS AIRES",422,4,193,215,1,409,0.00947867298578199
"065392505","BUENOS AIRES",287,2,172,108,0,280,0.00696864111498258
"065392506","BUENOS AIRES",280,3,120,151,0,271,0.0107142857142857
"062380801","BUENOS AIRES",22,0,12,10,0,22,0
"020021903","CABA",305,305,0,0,0,0,1
"062240503","BUENOS AIRES",25,0,11,14,0,25,0
"062800503","BUENOS AIRES",7,0,5,0,0,5,0
"062171105","BUENOS AIRES",37,0,11,26,0,37,0
"065392605","BUENOS AIRES",371,6,213,146,0,359,0.0161725067385445
"062241904","BUENOS AIRES",18,0,6,12,0,18,0
"062242008","BUENOS AIRES",11,0,1,9,1,11,0
"067210104","BUENOS AIRES",32,0,5,27,0,32,0
"062171106","BUENOS AIRES",13,0,1,10,2,13,0
"062240502","BUENOS AIRES",8,0,8,0,0,8,0
"062241002","BUENOS AIRES",21,0,6,14,0,20,0
"062241501","BUENOS AIRES",8,0,1,7,0,8,0
"062241801","BUENOS AIRES",10,0,9,1,0,10,0
"062310701","BUENOS AIRES",14,0,11,3,0,14,0
"062310805","BUENOS AIRES",6,0,3,3,0,6,0
"062311101","BUENOS AIRES",2,0,0,2,0,2,0
"065392611","BUENOS AIRES",307,11,139,153,0,292,0.0358306188925081
"062660203","BUENOS AIRES",26,1,15,10,0,25,0.0384615384615385
"062770101","BUENOS AIRES",4,0,1,3,0,4,0
"020022506","CABA",355,355,0,0,0,0,1
"062800701","BUENOS AIRES",10,0,4,6,0,10,0
"062800703","BUENOS AIRES",21,0,10,11,0,21,0
"062800802","BUENOS AIRES",4,0,1,3,0,4,0
"062800805","BUENOS AIRES",3,0,0,3,0,3,0
"062800815","BUENOS AIRES",14,0,8,5,1,14,0
"063220306","BUENOS AIRES",11,0,0,11,0,11,0
"063221008","BUENOS AIRES",16,0,7,9,0,16,0
"020151307","CABA",292,291,0,0,0,0,0.996575342465753
"062870301","BUENOS AIRES",9,0,6,3,0,9,0
"062870402","BUENOS AIRES",9,1,1,7,0,8,0.111111111111111
"064060208","BUENOS AIRES",23,0,20,2,0,22,0
"062870501","BUENOS AIRES",27,0,17,10,0,27,0
"062940206","BUENOS AIRES",8,0,2,6,0,8,0
"062940302","BUENOS AIRES",5,0,0,5,0,5,0
"062940303","BUENOS AIRES",7,0,0,7,0,7,0
"065392705","BUENOS AIRES",317,260,28,23,0,51,0.82018927444795
"064131103","BUENOS AIRES",0,0,0,0,0,0,NA
"063010502","BUENOS AIRES",55,2,37,16,0,53,0.0363636363636364
"063010503","BUENOS AIRES",29,0,23,6,0,29,0
"065392708","BUENOS AIRES",391,333,26,27,0,53,0.851662404092072
"063150502","BUENOS AIRES",122,0,40,52,1,93,0
"063221203","BUENOS AIRES",7,0,5,2,0,7,0
"065392904","BUENOS AIRES",72,0,20,49,0,69,0
"063921005","BUENOS AIRES",46,0,28,13,2,43,0
"063921103","BUENOS AIRES",2,0,2,0,0,2,0
"020151209","CABA",245,245,0,0,0,0,1
"063290102","BUENOS AIRES",36,0,17,19,0,36,0
"063290301","BUENOS AIRES",33,0,21,12,0,33,0
"063290601","BUENOS AIRES",25,0,9,16,0,25,0
"065392806","BUENOS AIRES",456,9,237,179,2,418,0.0197368421052632
"063430102","BUENOS AIRES",28,0,20,8,0,28,0
"065392809","BUENOS AIRES",318,9,143,163,0,306,0.0283018867924528
"063430302","BUENOS AIRES",16,0,10,5,0,15,0
"063510101","BUENOS AIRES",12,0,5,5,0,10,0
"063510610","BUENOS AIRES",4,0,1,2,0,3,0
"065392811","BUENOS AIRES",399,6,230,155,2,387,0.0150375939849624
"063921403","BUENOS AIRES",2,0,2,0,0,2,0
"063990201","BUENOS AIRES",11,0,6,5,0,11,0
"064060101","BUENOS AIRES",3,0,1,2,0,3,0
"063578101","BUENOS AIRES",95,0,29,55,1,85,0
"064691005","BUENOS AIRES",3,0,3,0,0,3,0
"064830505","BUENOS AIRES",42,1,23,14,4,41,0.0238095238095238
"063850102","BUENOS AIRES",14,0,3,9,2,14,0
"063850203","BUENOS AIRES",20,0,6,13,0,19,0
"063850902","BUENOS AIRES",25,0,16,9,0,25,0
"063920304","BUENOS AIRES",6,0,2,4,0,6,0
"063920703","BUENOS AIRES",58,0,25,31,2,58,0
"064060106","BUENOS AIRES",8,0,7,1,0,8,0
"064131503","BUENOS AIRES",22,0,1,21,0,22,0
"064131504","BUENOS AIRES",2,0,0,2,0,2,0
"064131603","BUENOS AIRES",0,0,0,0,0,0,NA
"065392906","BUENOS AIRES",143,0,52,85,1,138,0
"064132002","BUENOS AIRES",0,0,0,0,0,0,NA
"065811102","BUENOS AIRES",8,0,0,8,0,8,0
"065952106","BUENOS AIRES",1,0,0,1,0,1,0
"066090502","BUENOS AIRES",29,0,16,11,0,27,0
"065810912","BUENOS AIRES",9,0,1,7,0,8,0
"020151306","CABA",238,235,0,0,0,0,0.987394957983193
"064416408","BUENOS AIRES",48,0,22,26,0,48,0
"064416511","BUENOS AIRES",326,1,126,187,4,317,0.00306748466257669
"064480901","BUENOS AIRES",5,0,0,5,0,5,0
"064481204","BUENOS AIRES",4,0,4,0,0,4,0
"064550401","BUENOS AIRES",80,1,23,55,1,79,0.0125
"064550501","BUENOS AIRES",27,0,9,16,1,26,0
"064550601","BUENOS AIRES",61,0,22,37,0,59,0
"064760301","BUENOS AIRES",29,0,8,19,1,28,0
"064551201","BUENOS AIRES",62,0,18,42,1,61,0
"064620502","BUENOS AIRES",12,0,8,2,0,10,0
"064620603","BUENOS AIRES",18,0,11,7,0,18,0
"064621206","BUENOS AIRES",13,0,1,12,0,13,0
"064690302","BUENOS AIRES",12,1,1,8,2,11,0.0833333333333333
"064690701","BUENOS AIRES",10,0,2,7,0,9,0
"064690805","BUENOS AIRES",23,0,4,18,1,23,0
"064690806","BUENOS AIRES",32,1,5,25,0,30,0.03125
"064691003","BUENOS AIRES",26,0,14,12,0,26,0
"064691404","BUENOS AIRES",12,0,8,3,0,11,0
"065682702","BUENOS AIRES",338,0,187,151,0,338,0
"064760402","BUENOS AIRES",8,0,2,6,0,8,0
"064760802","BUENOS AIRES",17,0,5,12,0,17,0
"064830203","BUENOS AIRES",22,0,11,11,0,22,0
"064830903","BUENOS AIRES",74,1,34,38,1,73,0.0135135135135135
"065601112","BUENOS AIRES",374,0,221,146,1,368,0
"064970203","BUENOS AIRES",41,1,32,8,0,40,0.024390243902439
"064971209","BUENOS AIRES",45,1,28,16,0,44,0.0222222222222222
"066720101","BUENOS AIRES",10,0,1,9,0,10,0
"066720301","BUENOS AIRES",3,0,1,2,0,3,0
"066720401","BUENOS AIRES",14,0,6,5,2,13,0
"066720702","BUENOS AIRES",29,0,10,19,0,29,0
"065110101","BUENOS AIRES",18,0,0,18,0,18,0
"065110201","BUENOS AIRES",17,0,1,16,0,17,0
"065110303","BUENOS AIRES",22,0,14,7,0,21,0
"065180303","BUENOS AIRES",67,0,33,31,1,65,0
"065180401","BUENOS AIRES",13,0,9,4,0,13,0
"065601010","BUENOS AIRES",403,26,212,158,1,371,0.0645161290322581
"065393006","BUENOS AIRES",261,1,96,150,1,247,0.00383141762452107
"065180407","BUENOS AIRES",6,0,5,0,1,6,0
"067210212","BUENOS AIRES",14,0,7,5,0,12,0
"067281025","BUENOS AIRES",42,0,16,22,0,38,0
"065320801","BUENOS AIRES",22,0,8,14,0,22,0
"065320804","BUENOS AIRES",35,0,18,16,0,34,0
"065880601","BUENOS AIRES",59,1,22,31,4,57,0.0169491525423729
"065320902","BUENOS AIRES",215,62,76,72,4,152,0.288372093023256
"065470101","BUENOS AIRES",35,0,19,15,0,34,0
"065470301","BUENOS AIRES",32,0,17,15,0,32,0
"065470402","BUENOS AIRES",58,1,34,23,0,57,0.0172413793103448
"065601104","BUENOS AIRES",244,0,105,129,1,235,0
"065393001","BUENOS AIRES",451,7,162,266,1,429,0.0155210643015521
"065810503","BUENOS AIRES",123,122,1,0,0,1,0.991869918699187
"065880701","BUENOS AIRES",49,0,33,14,0,47,0
"065881003","BUENOS AIRES",17,0,6,11,0,17,0
"068190102","BUENOS AIRES",29,0,20,8,1,29,0
"065881607","BUENOS AIRES",0,0,0,0,0,0,NA
"065951101","BUENOS AIRES",45,0,18,25,0,43,0
"065470603","BUENOS AIRES",80,1,62,15,2,79,0.0125
"067701606","BUENOS AIRES",8,0,3,5,0,8,0
"067701901","BUENOS AIRES",4,0,1,3,0,4,0
"067701902","BUENOS AIRES",3,0,1,2,0,3,0
"065740201","BUENOS AIRES",14,0,2,12,0,14,0
"065740804","BUENOS AIRES",23,0,13,8,2,23,0
"065740902","BUENOS AIRES",25,0,10,14,1,25,0
"065600912","BUENOS AIRES",99,78,8,11,1,20,0.787878787878788
"065951501","BUENOS AIRES",50,1,29,19,1,49,0.02
"065951604","BUENOS AIRES",90,1,45,39,2,86,0.0111111111111111
"065952002","BUENOS AIRES",13,0,2,10,1,13,0
"065393008","BUENOS AIRES",232,0,99,128,2,229,0
"065393009","BUENOS AIRES",370,0,213,141,7,361,0
"065393106","BUENOS AIRES",429,1,253,127,2,382,0.00233100233100233
"066090503","BUENOS AIRES",37,0,21,13,2,36,0
"066020202","BUENOS AIRES",52,0,23,20,9,52,0
"066020306","BUENOS AIRES",32,0,11,20,1,32,0
"066020601","BUENOS AIRES",12,0,1,10,1,12,0
"065393012","BUENOS AIRES",299,2,181,113,1,295,0.00668896321070234
"066020902","BUENOS AIRES",28,0,8,14,1,23,0
"066231701","BUENOS AIRES",19,0,4,14,0,18,0
"066232401","BUENOS AIRES",20,0,6,13,1,20,0
"066021002","BUENOS AIRES",6,0,0,6,0,6,0
"068331601","BUENOS AIRES",14,0,7,7,0,14,0
"065393101","BUENOS AIRES",375,0,250,111,1,362,0
"065393102","BUENOS AIRES",395,2,222,150,2,374,0.00506329113924051
"066090606","BUENOS AIRES",25,1,13,11,0,24,0.04
"066091306","BUENOS AIRES",24,0,21,0,1,22,0
"066091601","BUENOS AIRES",7,0,4,3,0,7,0
"066091603","BUENOS AIRES",16,0,12,4,0,16,0
"066231001","BUENOS AIRES",7,0,3,4,0,7,0
"066231404","BUENOS AIRES",65,0,43,22,0,65,0
"066232502","BUENOS AIRES",17,0,7,10,0,17,0
"066232503","BUENOS AIRES",11,0,6,5,0,11,0
"068541302","BUENOS AIRES",38,0,15,21,1,37,0
"066860703","BUENOS AIRES",15,0,15,0,0,15,0
"068751001","BUENOS AIRES",27,0,14,12,0,26,0
"066480408","BUENOS AIRES",7,0,6,1,0,7,0
"066510303","BUENOS AIRES",6,0,1,5,0,6,0
"066510609","BUENOS AIRES",7,0,7,0,0,7,0
"066510713","BUENOS AIRES",11,0,3,7,0,10,0
"066510817","BUENOS AIRES",15,0,13,2,0,15,0
"065393114","BUENOS AIRES",241,1,114,123,0,237,0.004149377593361
"066511004","BUENOS AIRES",4,0,2,2,0,4,0
"066511307","BUENOS AIRES",18,0,12,6,0,18,0
"067700401","BUENOS AIRES",8,0,3,4,1,8,0
"066550102","BUENOS AIRES",17,0,8,8,0,16,0
"067600507","BUENOS AIRES",387,349,20,13,0,33,0.901808785529716
"066860606","BUENOS AIRES",18,0,9,9,0,18,0
"065393208","BUENOS AIRES",363,0,132,215,5,352,0
"066651201","BUENOS AIRES",0,0,0,0,0,0,NA
"065393117","BUENOS AIRES",379,1,262,109,0,371,0.00263852242744063
"066720202","BUENOS AIRES",15,1,8,6,0,14,0.0666666666666667
"066720303","BUENOS AIRES",12,0,2,10,0,12,0
"066720403","BUENOS AIRES",40,0,13,25,2,40,0
"066720501","BUENOS AIRES",14,0,3,10,0,13,0
"067912108","BUENOS AIRES",232,220,5,7,0,12,0.948275862068966
"066720504","BUENOS AIRES",6,0,2,4,0,6,0
"067841104","BUENOS AIRES",3,0,0,3,0,3,0
"066790404","BUENOS AIRES",8,0,3,5,0,8,0
"066790502","BUENOS AIRES",26,0,13,10,2,25,0
"066790802","BUENOS AIRES",31,0,11,11,0,22,0
"066790902","BUENOS AIRES",30,0,9,20,0,29,0
"066791003","BUENOS AIRES",22,0,17,4,0,21,0
"066791101","BUENOS AIRES",18,0,1,14,2,17,0
"066791103","BUENOS AIRES",17,0,13,3,1,17,0
"066860301","BUENOS AIRES",14,0,9,5,0,14,0
"065682711","BUENOS AIRES",323,2,220,100,0,320,0.00619195046439629
"067000704","BUENOS AIRES",8,0,6,2,0,8,0
"066860802","BUENOS AIRES",5,0,1,4,0,5,0
"066860804","BUENOS AIRES",8,0,4,4,0,8,0
"066860902","BUENOS AIRES",7,0,2,5,0,7,0
"066930203","BUENOS AIRES",16,0,5,10,1,16,0
"066930501","BUENOS AIRES",16,0,12,4,0,16,0
"065393303","BUENOS AIRES",295,4,207,78,1,286,0.0135593220338983
"067000202","BUENOS AIRES",11,0,2,9,0,11,0
"067000505","BUENOS AIRES",19,0,8,11,0,19,0
"020021703","CABA",454,450,2,0,0,2,0.991189427312775
"067000705","BUENOS AIRES",15,0,0,13,2,15,0
"067000706","BUENOS AIRES",9,0,3,5,0,8,0
"067000802","BUENOS AIRES",6,0,4,2,0,6,0
"067000803","BUENOS AIRES",4,0,1,3,0,4,0
"067000901","BUENOS AIRES",6,0,4,2,0,6,0
"067070803","BUENOS AIRES",47,0,15,30,0,45,0
"067070901","BUENOS AIRES",57,0,24,32,1,57,0
"067071111","BUENOS AIRES",231,179,31,21,0,52,0.774891774891775
"067140404","BUENOS AIRES",11,0,1,8,0,9,0
"067140808","BUENOS AIRES",14,0,3,11,0,14,0
"067140505","BUENOS AIRES",29,0,14,15,0,29,0
"020010802","CABA",567,566,1,0,0,1,0.998236331569665
"067280503","BUENOS AIRES",15,0,4,11,0,15,0
"067280301","BUENOS AIRES",14,0,12,2,0,14,0
"067280801","BUENOS AIRES",38,0,19,13,3,35,0
"067281202","BUENOS AIRES",21,0,13,8,0,21,0
"067281406","BUENOS AIRES",54,0,23,29,0,52,0
"067281602","BUENOS AIRES",9,0,5,4,0,9,0
"067350304","BUENOS AIRES",16,0,6,10,0,16,0
"065393310","BUENOS AIRES",301,0,179,111,4,294,0
"067350401","BUENOS AIRES",12,1,6,5,0,11,0.0833333333333333
"065881001","BUENOS AIRES",129,0,40,87,1,128,0
"067420101","BUENOS AIRES",19,0,2,16,0,18,0
"067420301","BUENOS AIRES",27,0,8,19,0,27,0
"065530311","BUENOS AIRES",18,18,0,0,0,0,1
"067700504","BUENOS AIRES",4,0,3,1,0,4,0
"067631001","BUENOS AIRES",17,0,10,5,2,17,0
"067631002","BUENOS AIRES",3,0,1,2,0,3,0
"067631402","BUENOS AIRES",12,0,6,3,0,9,0
"067631902","BUENOS AIRES",7,0,0,7,0,7,0
"065600904","BUENOS AIRES",133,68,23,39,1,63,0.511278195488722
"067700402","BUENOS AIRES",4,0,0,4,0,4,0
"067700902","BUENOS AIRES",20,0,18,1,0,19,0
"067701302","BUENOS AIRES",14,0,3,10,0,13,0
"067701403","BUENOS AIRES",4,0,1,3,0,4,0
"067780901","BUENOS AIRES",9,1,8,0,0,8,0.111111111111111
"067840203","BUENOS AIRES",16,0,8,7,0,15,0
"067840402","BUENOS AIRES",13,0,9,4,0,13,0
"067840801","BUENOS AIRES",24,2,12,10,0,22,0.0833333333333333
"067841102","BUENOS AIRES",8,0,1,7,0,8,0
"020021604","CABA",284,284,0,0,0,0,1
"067841204","BUENOS AIRES",6,0,4,2,0,6,0
"020021507","CABA",367,367,0,0,0,0,1
"067491402","BUENOS AIRES",303,289,8,1,0,9,0.953795379537954
"067632101","BUENOS AIRES",10,0,0,5,5,10,0
"067910503","BUENOS AIRES",8,0,5,1,0,6,0
"067911009","BUENOS AIRES",29,0,11,15,0,26,0
"067911402","BUENOS AIRES",47,0,5,42,0,47,0
"067980503","BUENOS AIRES",8,0,0,8,0,8,0
"067981005","BUENOS AIRES",15,0,4,10,1,15,0
"065470903","BUENOS AIRES",315,54,103,153,0,256,0.171428571428571
"067601511","BUENOS AIRES",260,2,61,187,0,248,0.00769230769230769
"065530306","BUENOS AIRES",82,68,11,3,0,14,0.829268292682927
"065530308","BUENOS AIRES",37,33,1,3,0,4,0.891891891891892
"065600103","BUENOS AIRES",393,0,196,185,1,382,0
"065600105","BUENOS AIRES",488,4,319,152,4,475,0.00819672131147541
"066582509","BUENOS AIRES",231,222,6,2,0,8,0.961038961038961
"020022001","CABA",457,456,0,1,0,1,0.99781181619256
"020151403","CABA",302,302,0,0,0,0,1
"065601116","BUENOS AIRES",238,2,157,70,0,227,0.00840336134453781
"065600214","BUENOS AIRES",372,0,183,176,2,361,0
"065601205","BUENOS AIRES",338,2,225,103,0,328,0.00591715976331361
"065600307","BUENOS AIRES",496,0,293,188,0,481,0
"065600308","BUENOS AIRES",412,0,82,221,43,346,0
"065600313","BUENOS AIRES",225,1,148,75,0,223,0.00444444444444444
"065600315","BUENOS AIRES",358,0,139,205,0,344,0
"065600907","BUENOS AIRES",108,90,18,0,0,18,0.833333333333333
"065390302","BUENOS AIRES",311,271,34,5,0,39,0.871382636655949
"065600419","BUENOS AIRES",403,3,224,163,1,388,0.00744416873449132
"065600501","BUENOS AIRES",216,6,110,84,3,197,0.0277777777777778
"065600505","BUENOS AIRES",87,0,51,33,2,86,0
"065600507","BUENOS AIRES",356,3,177,172,0,349,0.00842696629213483
"065600509","BUENOS AIRES",79,0,50,27,0,77,0
"065600514","BUENOS AIRES",349,2,245,99,2,346,0.00573065902578797
"065601216","BUENOS AIRES",241,2,143,96,0,239,0.00829875518672199
"065600612","BUENOS AIRES",385,0,294,81,0,375,0
"065600613","BUENOS AIRES",234,2,133,93,1,227,0.00854700854700855
"065601302","BUENOS AIRES",386,6,209,156,2,367,0.0155440414507772
"065250401","BUENOS AIRES",413,8,233,166,2,401,0.0193704600484262
"065600701","BUENOS AIRES",244,0,137,101,0,238,0
"065180609","BUENOS AIRES",62,0,50,11,0,61,0
"065180611","BUENOS AIRES",52,0,40,12,0,52,0
"065810409","BUENOS AIRES",240,237,3,0,0,3,0.9875
"065180714","BUENOS AIRES",115,3,83,27,0,110,0.0260869565217391
"065600704","BUENOS AIRES",304,301,2,0,0,2,0.990131578947368
"065681111","BUENOS AIRES",259,257,2,0,0,2,0.992277992277992
"065600707","BUENOS AIRES",245,1,125,109,3,237,0.00408163265306122
"065600905","BUENOS AIRES",103,44,24,33,0,57,0.427184466019417
"065601309","BUENOS AIRES",313,3,227,78,1,306,0.00958466453674121
"065250111","BUENOS AIRES",399,82,188,125,0,313,0.205513784461153
"020151308","CABA",194,194,0,0,0,0,1
"065250417","BUENOS AIRES",437,148,132,152,1,285,0.338672768878719
"065250602","BUENOS AIRES",116,3,39,71,2,112,0.0258620689655172
"065250603","BUENOS AIRES",147,1,68,73,2,143,0.00680272108843537
"065250604","BUENOS AIRES",190,25,100,60,0,160,0.131578947368421
"065250613","BUENOS AIRES",303,252,30,20,0,50,0.831683168316832
"065320201","BUENOS AIRES",235,233,2,0,0,2,0.991489361702128
"065320312","BUENOS AIRES",230,224,5,1,0,6,0.973913043478261
"065321512","BUENOS AIRES",431,360,28,5,0,33,0.835266821345708
"065321406","BUENOS AIRES",276,275,1,0,0,1,0.996376811594203
"065321504","BUENOS AIRES",304,66,69,168,0,237,0.217105263157895
"065321506","BUENOS AIRES",341,298,23,16,0,39,0.873900293255132
"065390102","BUENOS AIRES",361,8,278,70,0,348,0.0221606648199446
"065390203","BUENOS AIRES",277,25,206,41,0,247,0.0902527075812274
"065390214","BUENOS AIRES",227,211,14,2,0,16,0.929515418502203
"065390402","BUENOS AIRES",478,472,6,0,0,6,0.98744769874477
"065390409","BUENOS AIRES",437,427,8,2,0,10,0.977116704805492
"065390503","BUENOS AIRES",443,341,88,12,0,100,0.769751693002257
"068052605","BUENOS AIRES",52,0,23,25,2,50,0
"065390812","BUENOS AIRES",819,2,531,263,4,798,0.00244200244200244
"065390906","BUENOS AIRES",462,3,279,162,2,443,0.00649350649350649
"065390910","BUENOS AIRES",388,1,308,76,1,385,0.00257731958762887
"065391002","BUENOS AIRES",381,3,229,136,2,367,0.0078740157480315
"065391006","BUENOS AIRES",267,2,173,87,0,260,0.00749063670411985
"065391010","BUENOS AIRES",494,1,326,134,0,460,0.00202429149797571
"065391017","BUENOS AIRES",112,0,60,50,0,110,0
"065391103","BUENOS AIRES",301,0,194,104,0,298,0
"068821701","BUENOS AIRES",353,70,46,230,0,276,0.198300283286119
"061051406","BUENOS AIRES",271,180,37,54,0,91,0.664206642066421
"067420410","BUENOS AIRES",104,35,3,62,0,65,0.336538461538462
"062100802","BUENOS AIRES",265,63,95,105,0,200,0.237735849056604
"061121108","BUENOS AIRES",336,234,58,42,0,100,0.696428571428571
"061121204","BUENOS AIRES",4,0,4,0,0,4,0
"061340101","BUENOS AIRES",288,0,147,132,1,280,0
"066650308","BUENOS AIRES",96,65,11,8,0,19,0.677083333333333
"063510403","BUENOS AIRES",18,0,4,14,0,18,0
"065682804","BUENOS AIRES",257,3,189,63,1,253,0.0116731517509728
"061340108","BUENOS AIRES",63,1,38,19,0,57,0.0158730158730159
"061470602","BUENOS AIRES",125,116,6,3,0,9,0.928
"061470603","BUENOS AIRES",20,1,5,12,0,17,0.05
"061470708","BUENOS AIRES",26,1,12,11,1,24,0.0384615384615385
"061540105","BUENOS AIRES",21,0,14,7,0,21,0
"061540610","BUENOS AIRES",120,0,88,32,0,120,0
"061610601","BUENOS AIRES",111,2,70,27,0,97,0.018018018018018
"061610606","BUENOS AIRES",28,0,14,14,0,28,0
"020151303","CABA",298,297,1,0,0,1,0.996644295302013
"065952401","BUENOS AIRES",285,271,10,2,0,12,0.950877192982456
"061680501","BUENOS AIRES",47,0,14,33,0,47,0
"062100805","BUENOS AIRES",534,230,97,194,9,300,0.430711610486891
"062311001","BUENOS AIRES",361,336,7,17,0,24,0.930747922437673
"062310104","BUENOS AIRES",80,0,64,15,0,79,0
"062241204","BUENOS AIRES",102,1,71,27,2,100,0.00980392156862745
"062660508","BUENOS AIRES",223,3,123,93,0,216,0.0134529147982063
"062770204","BUENOS AIRES",68,0,45,22,1,68,0
"062870401","BUENOS AIRES",66,0,10,37,19,66,0
"062660704","BUENOS AIRES",107,3,53,50,0,103,0.0280373831775701
"062660705","BUENOS AIRES",458,1,176,264,6,446,0.00218340611353712
"062700101","BUENOS AIRES",181,159,11,11,0,22,0.878453038674033
"063430606","BUENOS AIRES",4,0,0,4,0,4,0
"065682207","BUENOS AIRES",143,125,16,2,0,18,0.874125874125874
"063578015","BUENOS AIRES",3,0,2,1,0,3,0
"063850801","BUENOS AIRES",33,0,19,13,1,33,0
"063990302","BUENOS AIRES",59,0,14,44,0,58,0
"064060210","BUENOS AIRES",102,65,16,21,0,37,0.637254901960784
"064131806","BUENOS AIRES",17,0,6,10,1,17,0
"064416801","BUENOS AIRES",232,2,87,133,0,220,0.00862068965517241
"065682311","BUENOS AIRES",250,242,3,4,0,7,0.968
"068400405","BUENOS AIRES",287,18,127,135,0,262,0.0627177700348432
"064417007","BUENOS AIRES",224,5,128,81,0,209,0.0223214285714286
"064480610","BUENOS AIRES",63,0,26,36,0,62,0
"064620802","BUENOS AIRES",327,290,10,25,0,35,0.886850152905199
"064621205","BUENOS AIRES",98,0,19,73,3,95,0
"064690605","BUENOS AIRES",388,272,40,66,3,109,0.701030927835051
"064830901","BUENOS AIRES",87,0,63,23,1,87,0
"065320907","BUENOS AIRES",116,0,48,64,4,116,0
"066231102","BUENOS AIRES",29,1,9,16,2,27,0.0344827586206897
"066090705","BUENOS AIRES",22,0,6,12,3,21,0
"066232210","BUENOS AIRES",170,102,19,49,0,68,0.6
"066381402","BUENOS AIRES",234,169,22,39,1,62,0.722222222222222
"066860604","BUENOS AIRES",24,0,17,6,1,24,0
"067070403","BUENOS AIRES",271,26,99,140,6,245,0.0959409594095941
"067140301","BUENOS AIRES",618,2,295,312,3,610,0.00323624595469256
"065682401","BUENOS AIRES",365,345,12,7,0,19,0.945205479452055
"065682503","BUENOS AIRES",358,351,5,2,0,7,0.980446927374302
"067630904","BUENOS AIRES",103,0,42,61,0,103,0
"067911403","BUENOS AIRES",63,1,31,30,1,62,0.0158730158730159
"068331001","BUENOS AIRES",72,4,31,35,0,66,0.0555555555555556
"068750403","BUENOS AIRES",50,0,33,17,0,50,0
"065681410","BUENOS AIRES",363,357,3,3,0,6,0.983471074380165
"065681605","BUENOS AIRES",328,328,0,0,0,0,1
"065681611","BUENOS AIRES",315,307,7,1,0,8,0.974603174603175
"065681902","BUENOS AIRES",356,330,3,0,0,3,0.926966292134832
"066581004","BUENOS AIRES",255,253,1,1,0,2,0.992156862745098
"065682002","BUENOS AIRES",239,239,0,0,0,0,1
"067980601","BUENOS AIRES",77,22,15,38,2,55,0.285714285714286
"065682101","BUENOS AIRES",175,175,0,0,0,0,1
"065682106","BUENOS AIRES",121,121,0,0,0,0,1
"065682111","BUENOS AIRES",119,115,0,4,0,4,0.966386554621849
"065682214","BUENOS AIRES",351,278,72,1,0,73,0.792022792022792
"065682907","BUENOS AIRES",334,0,250,71,1,322,0
"065683002","BUENOS AIRES",440,1,335,96,0,431,0.00227272727272727
"065683009","BUENOS AIRES",314,3,205,62,0,267,0.00955414012738853
"065683010","BUENOS AIRES",429,5,319,103,0,422,0.0116550116550117
"065683101","BUENOS AIRES",416,9,350,56,0,406,0.0216346153846154
"065810101","BUENOS AIRES",359,309,14,30,1,45,0.860724233983287
"065740406","BUENOS AIRES",236,124,9,96,2,107,0.525423728813559
"065740408","BUENOS AIRES",311,280,19,12,0,31,0.90032154340836
"065740415","BUENOS AIRES",278,53,99,126,0,225,0.190647482014388
"065810110","BUENOS AIRES",263,168,31,55,1,87,0.638783269961977
"065810210","BUENOS AIRES",248,193,17,37,0,54,0.778225806451613
"065810308","BUENOS AIRES",208,202,2,2,0,4,0.971153846153846
"065810406","BUENOS AIRES",151,148,1,2,0,3,0.980132450331126
"068051110","BUENOS AIRES",487,22,208,242,0,450,0.0451745379876797
"066581005","BUENOS AIRES",417,417,0,0,0,0,1
"068051304","BUENOS AIRES",403,6,260,136,0,396,0.0148883374689826
"068051408","BUENOS AIRES",295,6,137,141,0,278,0.0203389830508475
"065811306","BUENOS AIRES",522,518,2,2,0,4,0.992337164750958
"065811309","BUENOS AIRES",181,156,11,14,0,25,0.861878453038674
"065811406","BUENOS AIRES",143,55,24,63,1,88,0.384615384615385
"065811503","BUENOS AIRES",194,176,5,13,0,18,0.907216494845361
"065811505","BUENOS AIRES",301,268,17,12,1,30,0.890365448504983
"065811601","BUENOS AIRES",313,309,3,1,0,4,0.987220447284345
"065811605","BUENOS AIRES",225,216,7,1,0,8,0.96
"065811801","BUENOS AIRES",292,291,1,0,0,1,0.996575342465753
"065811807","BUENOS AIRES",179,179,0,0,0,0,1
"065811808","BUENOS AIRES",145,145,0,0,0,0,1
"065811902","BUENOS AIRES",40,20,7,12,1,20,0.5
"065880204","BUENOS AIRES",333,286,12,28,5,45,0.858858858858859
"065880905","BUENOS AIRES",103,0,65,38,0,103,0
"065880913","BUENOS AIRES",345,242,30,71,0,101,0.701449275362319
"065952503","BUENOS AIRES",364,335,14,15,0,29,0.92032967032967
"065881302","BUENOS AIRES",21,0,8,10,1,19,0
"068190404","BUENOS AIRES",339,293,26,18,0,44,0.864306784660767
"065881603","BUENOS AIRES",242,40,62,137,0,199,0.165289256198347
"065950102","BUENOS AIRES",244,1,137,103,0,240,0.00409836065573771
"065950103","BUENOS AIRES",400,50,178,167,0,345,0.125
"065950104","BUENOS AIRES",367,41,135,186,1,322,0.111716621253406
"065950107","BUENOS AIRES",302,279,16,6,0,22,0.923841059602649
"065950201","BUENOS AIRES",278,275,2,1,0,3,0.989208633093525
"065950211","BUENOS AIRES",217,208,5,4,0,9,0.95852534562212
"065950213","BUENOS AIRES",197,196,1,0,0,1,0.99492385786802
"065950309","BUENOS AIRES",234,234,0,0,0,0,1
"065950310","BUENOS AIRES",386,257,91,37,0,128,0.66580310880829
"065950313","BUENOS AIRES",221,133,53,35,0,88,0.601809954751131
"066581105","BUENOS AIRES",162,162,0,0,0,0,1
"065951607","BUENOS AIRES",262,6,138,113,0,251,0.0229007633587786
"065951609","BUENOS AIRES",237,235,0,0,0,0,0.991561181434599
"065952606","BUENOS AIRES",172,72,81,18,0,99,0.418604651162791
"065952608","BUENOS AIRES",323,5,174,140,0,314,0.0154798761609907
"066020801","BUENOS AIRES",240,12,174,51,2,227,0.05
"066021102","BUENOS AIRES",207,69,76,49,4,129,0.333333333333333
"066090208","BUENOS AIRES",450,13,254,172,7,433,0.0288888888888889
"066021104","BUENOS AIRES",325,322,0,0,0,0,0.990769230769231
"066090109","BUENOS AIRES",297,3,124,169,0,293,0.0101010101010101
"066090201","BUENOS AIRES",347,196,95,54,1,150,0.564841498559078
"066090204","BUENOS AIRES",272,245,20,7,0,27,0.900735294117647
"066090214","BUENOS AIRES",257,4,172,78,2,252,0.0155642023346304
"066091901","BUENOS AIRES",425,239,40,141,2,183,0.562352941176471
"066091902","BUENOS AIRES",210,89,85,34,2,121,0.423809523809524
"066091903","BUENOS AIRES",402,239,91,67,3,161,0.59452736318408
"067071110","BUENOS AIRES",380,317,31,30,1,62,0.83421052631579
"066021402","BUENOS AIRES",40,0,34,5,0,39,0
"020010908","CABA",149,149,0,0,0,0,1
"066090102","BUENOS AIRES",402,159,124,119,0,243,0.395522388059701
"066090107","BUENOS AIRES",321,15,135,162,0,297,0.0467289719626168
"066090108","BUENOS AIRES",215,1,121,87,2,210,0.00465116279069767
"020142305","CABA",516,515,1,0,0,1,0.998062015503876
"066160307","BUENOS AIRES",188,151,13,23,0,36,0.803191489361702
"066230107","BUENOS AIRES",354,328,14,12,0,26,0.926553672316384
"066230302","BUENOS AIRES",383,325,35,21,0,56,0.848563968668407
"066230311","BUENOS AIRES",231,211,15,4,0,19,0.913419913419913
"066230407","BUENOS AIRES",332,310,7,14,0,21,0.933734939759036
"066230503","BUENOS AIRES",343,296,12,35,0,47,0.862973760932945
"066230701","BUENOS AIRES",180,3,114,60,1,175,0.0166666666666667
"066231103","BUENOS AIRES",159,3,77,76,0,153,0.0188679245283019
"066232008","BUENOS AIRES",396,379,15,2,0,17,0.957070707070707
"066232107","BUENOS AIRES",142,0,86,53,0,139,0
"066581207","BUENOS AIRES",286,284,1,1,0,2,0.993006993006993
"066232205","BUENOS AIRES",321,252,35,34,0,69,0.785046728971963
"066232213","BUENOS AIRES",201,107,55,39,0,94,0.532338308457711
"066232306","BUENOS AIRES",160,0,129,31,0,160,0
"068540203","BUENOS AIRES",332,146,51,132,1,184,0.439759036144578
"066232803","BUENOS AIRES",174,154,18,2,0,20,0.885057471264368
"066380102","BUENOS AIRES",473,0,268,193,4,465,0
"066380103","BUENOS AIRES",275,0,184,88,0,272,0
"066380207","BUENOS AIRES",269,0,133,131,1,265,0
"066380209","BUENOS AIRES",303,0,203,94,1,298,0
"066380303","BUENOS AIRES",400,10,216,167,0,383,0.025
"066380313","BUENOS AIRES",407,24,197,170,0,367,0.058968058968059
"066380405","BUENOS AIRES",556,1,212,330,0,542,0.00179856115107914
"066380505","BUENOS AIRES",191,65,124,2,0,126,0.340314136125654
"066380412","BUENOS AIRES",270,257,12,1,0,13,0.951851851851852
"066380506","BUENOS AIRES",148,92,50,5,0,55,0.621621621621622
"067490706","BUENOS AIRES",304,230,34,5,0,39,0.756578947368421
"066380507","BUENOS AIRES",216,0,146,63,1,210,0
"066380510","BUENOS AIRES",364,1,237,107,2,346,0.00274725274725275
"066380511","BUENOS AIRES",350,0,237,105,3,345,0
"066380513","BUENOS AIRES",307,6,93,198,5,296,0.0195439739413681
"066380604","BUENOS AIRES",413,3,245,149,2,396,0.00726392251815981
"066380608","BUENOS AIRES",228,8,165,55,0,220,0.0350877192982456
"066380611","BUENOS AIRES",325,3,120,191,4,315,0.00923076923076923
"066380707","BUENOS AIRES",420,16,329,68,1,398,0.0380952380952381
"066380802","BUENOS AIRES",220,182,34,4,0,38,0.827272727272727
"066380805","BUENOS AIRES",152,137,1,13,0,14,0.901315789473684
"066381802","BUENOS AIRES",435,4,168,240,6,414,0.00919540229885057
"066380815","BUENOS AIRES",45,2,29,13,0,42,0.0444444444444444
"066380912","BUENOS AIRES",343,0,177,157,0,334,0
"067630406","BUENOS AIRES",280,279,0,1,0,1,0.996428571428571
"066381003","BUENOS AIRES",361,3,253,97,0,350,0.00831024930747922
"066381010","BUENOS AIRES",431,5,197,218,3,418,0.0116009280742459
"066381105","BUENOS AIRES",333,2,223,103,3,329,0.00600600600600601
"066381112","BUENOS AIRES",187,2,83,93,2,178,0.0106951871657754
"068612402","BUENOS AIRES",394,386,3,1,0,4,0.979695431472081
"066381304","BUENOS AIRES",239,2,158,77,0,235,0.00836820083682008
"066381513","BUENOS AIRES",465,1,294,158,1,453,0.0021505376344086
"066381514","BUENOS AIRES",341,1,141,182,4,327,0.00293255131964809
"066381607","BUENOS AIRES",393,346,36,8,0,44,0.880407124681934
"066510801","BUENOS AIRES",91,0,65,25,0,90,0
"066381807","BUENOS AIRES",336,0,161,165,4,330,0
"066382002","BUENOS AIRES",262,1,210,50,1,261,0.00381679389312977
"066382008","BUENOS AIRES",162,0,133,28,0,161,0
"068750804","BUENOS AIRES",167,2,131,31,0,162,0.0119760479041916
"066440202","BUENOS AIRES",95,65,25,5,0,30,0.684210526315789
"066440204","BUENOS AIRES",33,27,6,0,0,6,0.818181818181818
"066440313","BUENOS AIRES",80,31,34,15,0,49,0.3875
"066440314","BUENOS AIRES",21,0,18,3,0,21,0
"066440401","BUENOS AIRES",77,37,35,5,0,40,0.480519480519481
"066480107","BUENOS AIRES",265,0,199,64,1,264,0
"066440509","BUENOS AIRES",99,91,7,1,0,8,0.919191919191919
"066440606","BUENOS AIRES",122,13,91,16,0,107,0.10655737704918
"066440608","BUENOS AIRES",286,38,154,89,2,245,0.132867132867133
"066440610","BUENOS AIRES",194,3,125,65,0,190,0.0154639175257732
"066440614","BUENOS AIRES",157,2,98,54,1,153,0.0127388535031847
"066440619","BUENOS AIRES",86,5,67,13,0,80,0.0581395348837209
"066480206","BUENOS AIRES",278,1,66,180,6,252,0.00359712230215827
"066480209","BUENOS AIRES",329,8,236,80,0,316,0.0243161094224924
"066480304","BUENOS AIRES",321,1,166,143,3,312,0.00311526479750779
"066480314","BUENOS AIRES",111,0,97,13,1,111,0
"066580310","BUENOS AIRES",311,305,2,4,0,6,0.980707395498392
"066510802","BUENOS AIRES",137,0,116,20,1,137,0
"066511001","BUENOS AIRES",52,0,38,14,0,52,0
"066511309","BUENOS AIRES",141,0,112,28,0,140,0
"066550206","BUENOS AIRES",166,56,59,44,1,104,0.337349397590361
"066550312","BUENOS AIRES",209,203,5,0,0,5,0.971291866028708
"066580109","BUENOS AIRES",315,303,7,3,0,10,0.961904761904762
"066580113","BUENOS AIRES",28,25,0,2,0,2,0.892857142857143
"066580201","BUENOS AIRES",103,5,4,51,27,82,0.0485436893203883
"066580209","BUENOS AIRES",287,134,63,87,0,150,0.466898954703833
"066580210","BUENOS AIRES",280,192,48,31,0,79,0.685714285714286
"066580304","BUENOS AIRES",299,285,11,2,0,13,0.953177257525084
"066580305","BUENOS AIRES",386,383,3,0,0,3,0.992227979274611
"066580407","BUENOS AIRES",292,276,3,9,0,12,0.945205479452055
"066580411","BUENOS AIRES",339,338,0,1,0,1,0.997050147492625
"066580507","BUENOS AIRES",413,404,3,3,0,6,0.978208232445521
"066580604","BUENOS AIRES",284,284,0,0,0,0,1
"066580610","BUENOS AIRES",358,356,0,0,0,0,0.994413407821229
"066580703","BUENOS AIRES",275,273,2,0,0,2,0.992727272727273
"066580810","BUENOS AIRES",198,197,1,0,0,1,0.994949494949495
"066580903","BUENOS AIRES",278,278,0,0,0,0,1
"066580905","BUENOS AIRES",208,208,0,0,0,0,1
"066580912","BUENOS AIRES",222,222,0,0,0,0,1
"066581304","BUENOS AIRES",241,8,28,189,4,221,0.033195020746888
"066581308","BUENOS AIRES",235,59,50,121,3,174,0.251063829787234
"066581310","BUENOS AIRES",226,35,42,146,3,191,0.154867256637168
"066581410","BUENOS AIRES",203,41,14,144,0,158,0.201970443349754
"066581501","BUENOS AIRES",254,230,11,13,0,24,0.905511811023622
"066581512","BUENOS AIRES",234,232,1,1,0,2,0.991452991452991
"066581608","BUENOS AIRES",251,249,2,0,0,2,0.99203187250996
"066581702","BUENOS AIRES",268,267,0,0,0,0,0.996268656716418
"066581708","BUENOS AIRES",380,376,3,0,0,3,0.989473684210526
"066581803","BUENOS AIRES",192,191,1,0,0,1,0.994791666666667
"066581805","BUENOS AIRES",271,265,1,2,0,3,0.977859778597786
"066582002","BUENOS AIRES",319,317,2,0,0,2,0.993730407523511
"066582008","BUENOS AIRES",386,324,12,47,0,59,0.839378238341969
"066582010","BUENOS AIRES",510,486,7,9,0,16,0.952941176470588
"066582011","BUENOS AIRES",441,363,40,35,0,75,0.82312925170068
"066582107","BUENOS AIRES",596,82,96,399,1,496,0.13758389261745
"066582211","BUENOS AIRES",368,363,2,1,0,3,0.986413043478261
"066582308","BUENOS AIRES",216,212,1,3,0,4,0.981481481481482
"066582503","BUENOS AIRES",304,275,5,2,0,7,0.904605263157895
"066582505","BUENOS AIRES",281,278,3,0,0,3,0.98932384341637
"066582507","BUENOS AIRES",265,256,3,6,0,9,0.966037735849057
"066582512","BUENOS AIRES",329,193,23,99,1,123,0.586626139817629
"066582602","BUENOS AIRES",463,381,18,48,4,70,0.822894168466523
"066582608","BUENOS AIRES",266,259,5,1,0,6,0.973684210526316
"066582703","BUENOS AIRES",181,13,27,122,9,158,0.0718232044198895
"066582707","BUENOS AIRES",288,32,51,190,7,248,0.111111111111111
"066582714","BUENOS AIRES",233,34,30,156,1,187,0.145922746781116
"066582715","BUENOS AIRES",291,9,79,189,0,268,0.0309278350515464
"066582802","BUENOS AIRES",359,354,1,4,0,5,0.986072423398329
"066582804","BUENOS AIRES",368,344,9,14,0,23,0.934782608695652
"066582805","BUENOS AIRES",268,212,30,25,0,55,0.791044776119403
"066582906","BUENOS AIRES",370,169,93,102,0,195,0.456756756756757
"066583006","BUENOS AIRES",336,43,120,165,1,286,0.12797619047619
"066583007","BUENOS AIRES",406,17,110,269,1,380,0.041871921182266
"066583210","BUENOS AIRES",445,421,8,11,0,19,0.946067415730337
"066583312","BUENOS AIRES",312,239,36,36,0,72,0.766025641025641
"066583508","BUENOS AIRES",406,267,42,79,0,121,0.657635467980296
"066583606","BUENOS AIRES",243,13,69,152,1,222,0.0534979423868313
"068820812","BUENOS AIRES",315,314,1,0,0,1,0.996825396825397
"066583607","BUENOS AIRES",522,22,157,330,1,488,0.0421455938697318
"066583707","BUENOS AIRES",447,15,113,300,1,414,0.0335570469798658
"066583801","BUENOS AIRES",525,19,74,394,4,472,0.0361904761904762
"066583808","BUENOS AIRES",255,7,17,209,0,226,0.0274509803921569
"066583901","BUENOS AIRES",449,360,24,51,0,75,0.801781737193764
"066583903","BUENOS AIRES",403,322,32,40,0,72,0.799007444168734
"066583904","BUENOS AIRES",242,191,15,28,0,43,0.789256198347107
"066584001","BUENOS AIRES",438,23,71,267,41,379,0.0525114155251142
"066584010","BUENOS AIRES",172,3,77,68,1,146,0.0174418604651163
"066584102","BUENOS AIRES",631,16,144,393,2,539,0.0253565768621236
"066584110","BUENOS AIRES",482,4,211,252,1,464,0.00829875518672199
"066584201","BUENOS AIRES",250,17,91,114,20,225,0.068
"066584202","BUENOS AIRES",283,53,101,125,1,227,0.187279151943463
"066584204","BUENOS AIRES",338,65,124,146,0,270,0.192307692307692
"066584205","BUENOS AIRES",288,29,59,167,9,235,0.100694444444444
"066584210","BUENOS AIRES",386,302,38,44,1,83,0.782383419689119
"066651008","BUENOS AIRES",385,42,75,258,3,336,0.109090909090909
"066651302","BUENOS AIRES",0,0,0,0,0,0,NA
"066721207","BUENOS AIRES",380,364,6,8,0,14,0.957894736842105
"066790604","BUENOS AIRES",270,154,66,48,0,114,0.57037037037037
"066790606","BUENOS AIRES",266,216,30,16,1,47,0.81203007518797
"066860106","BUENOS AIRES",267,241,1,18,0,19,0.902621722846442
"066861303","BUENOS AIRES",181,178,2,1,0,3,0.983425414364641
"066861306","BUENOS AIRES",182,177,3,2,0,5,0.972527472527473
"066930306","BUENOS AIRES",184,2,93,86,0,179,0.0108695652173913
"066930316","BUENOS AIRES",315,246,22,40,4,66,0.780952380952381
"067000101","BUENOS AIRES",115,1,60,54,0,114,0.00869565217391304
"067000110","BUENOS AIRES",192,0,126,65,1,192,0
"067140605","BUENOS AIRES",302,21,70,210,0,280,0.0695364238410596
"067070112","BUENOS AIRES",231,4,98,126,0,224,0.0173160173160173
"067071101","BUENOS AIRES",334,246,41,45,0,86,0.736526946107784
"067071106","BUENOS AIRES",278,270,5,3,0,8,0.971223021582734
"067071107","BUENOS AIRES",304,293,7,4,0,11,0.963815789473684
"067140114","BUENOS AIRES",298,9,111,165,1,277,0.0302013422818792
"067140615","BUENOS AIRES",124,1,51,66,2,119,0.00806451612903226
"067140616","BUENOS AIRES",205,5,56,138,1,195,0.024390243902439
"067281011","BUENOS AIRES",228,98,85,45,0,130,0.429824561403509
"067281022","BUENOS AIRES",289,42,119,121,0,240,0.145328719723183
"067281401","BUENOS AIRES",40,0,14,25,0,39,0
"067350109","BUENOS AIRES",397,147,118,129,1,248,0.370277078085642
"067490212","BUENOS AIRES",237,227,7,3,0,10,0.957805907172996
"067490213","BUENOS AIRES",262,258,2,2,0,4,0.984732824427481
"067490510","BUENOS AIRES",236,232,3,1,0,4,0.983050847457627
"067490703","BUENOS AIRES",292,171,73,48,0,121,0.585616438356164
"020022507","CABA",386,386,0,0,0,0,1
"067490808","BUENOS AIRES",378,322,35,18,0,53,0.851851851851852
"067491001","BUENOS AIRES",482,448,15,5,0,20,0.929460580912863
"067491114","BUENOS AIRES",393,278,46,58,0,104,0.707379134860051
"067491205","BUENOS AIRES",417,414,3,0,0,3,0.992805755395683
"067491210","BUENOS AIRES",377,6,204,159,1,364,0.0159151193633952
"067491417","BUENOS AIRES",467,359,28,34,0,62,0.768736616702355
"067562305","BUENOS AIRES",344,280,22,9,0,31,0.813953488372093
"067560101","BUENOS AIRES",245,205,28,12,0,40,0.836734693877551
"067560109","BUENOS AIRES",219,219,0,0,0,0,1
"067560111","BUENOS AIRES",198,196,2,0,0,2,0.98989898989899
"060280103","BUENOS AIRES",326,9,117,189,1,307,0.0276073619631902
"067560117","BUENOS AIRES",344,321,14,9,0,23,0.933139534883721
"067560207","BUENOS AIRES",331,324,3,4,0,7,0.978851963746224
"067560306","BUENOS AIRES",148,148,0,0,0,0,1
"067560403","BUENOS AIRES",328,273,45,10,0,55,0.832317073170732
"060141015","BUENOS AIRES",282,249,12,19,0,31,0.882978723404255
"067561207","BUENOS AIRES",167,167,0,0,0,0,1
"020010712","CABA",175,175,0,0,0,0,1
"067560405","BUENOS AIRES",308,284,0,0,0,0,0.922077922077922
"067560407","BUENOS AIRES",301,300,1,0,0,1,0.996677740863787
"067560701","BUENOS AIRES",280,279,1,0,0,1,0.996428571428571
"067560705","BUENOS AIRES",293,293,0,0,0,0,1
"067560706","BUENOS AIRES",317,316,0,1,0,1,0.996845425867508
"067560708","BUENOS AIRES",252,247,4,1,0,5,0.98015873015873
"067560806","BUENOS AIRES",418,417,1,0,0,1,0.997607655502392
"067560908","BUENOS AIRES",389,380,7,2,0,9,0.976863753213368
"067560910","BUENOS AIRES",337,335,0,1,0,1,0.99406528189911
"067560914","BUENOS AIRES",356,352,4,0,0,4,0.98876404494382
"067561003","BUENOS AIRES",330,330,0,0,0,0,1
"067561006","BUENOS AIRES",374,374,0,0,0,0,1
"067561011","BUENOS AIRES",317,315,1,1,0,2,0.993690851735016
"067561201","BUENOS AIRES",409,396,10,3,0,13,0.968215158924205
"067561203","BUENOS AIRES",252,248,2,2,0,4,0.984126984126984
"067561209","BUENOS AIRES",337,304,14,19,0,33,0.902077151335312
"067561301","BUENOS AIRES",285,280,0,0,0,0,0.982456140350877
"067561310","BUENOS AIRES",272,223,13,6,0,19,0.819852941176471
"067561408","BUENOS AIRES",348,282,26,32,5,63,0.810344827586207
"067561507","BUENOS AIRES",229,182,30,17,0,47,0.794759825327511
"067630106","BUENOS AIRES",208,207,0,1,0,1,0.995192307692308
"060280108","BUENOS AIRES",428,12,201,203,1,405,0.0280373831775701
"067561610","BUENOS AIRES",200,187,9,4,0,13,0.935
"067561705","BUENOS AIRES",205,200,3,2,0,5,0.975609756097561
"067561710","BUENOS AIRES",329,328,1,0,0,1,0.996960486322188
"067561808","BUENOS AIRES",62,62,0,0,0,0,1
"067561907","BUENOS AIRES",376,371,0,5,0,5,0.986702127659574
"067562005","BUENOS AIRES",226,31,121,74,0,195,0.13716814159292
"067562201","BUENOS AIRES",608,606,2,0,0,2,0.996710526315789
"067562203","BUENOS AIRES",471,471,0,0,0,0,1
"067562206","BUENOS AIRES",391,54,18,288,6,312,0.138107416879795
"067562302","BUENOS AIRES",274,271,2,0,0,2,0.989051094890511
"067562408","BUENOS AIRES",210,210,0,0,0,0,1
"067562409","BUENOS AIRES",235,234,1,0,0,1,0.995744680851064
"067562504","BUENOS AIRES",171,4,136,31,0,167,0.0233918128654971
"067630405","BUENOS AIRES",324,315,9,0,0,9,0.972222222222222
"067562510","BUENOS AIRES",352,11,197,142,0,339,0.03125
"067562601","BUENOS AIRES",388,360,22,4,0,26,0.927835051546392
"067600110","BUENOS AIRES",400,16,244,130,1,375,0.04
"067600201","BUENOS AIRES",426,402,18,6,0,24,0.943661971830986
"067600205","BUENOS AIRES",278,275,2,1,0,3,0.989208633093525
"067600206","BUENOS AIRES",267,266,1,0,0,1,0.99625468164794
"063574207","BUENOS AIRES",93,92,1,0,0,1,0.989247311827957
"067600212","BUENOS AIRES",283,280,3,0,0,3,0.989399293286219
"067600502","BUENOS AIRES",329,288,25,15,1,41,0.875379939209726
"067600506","BUENOS AIRES",298,266,21,9,0,30,0.89261744966443
"067600604","BUENOS AIRES",291,229,47,14,1,62,0.786941580756014
"067600704","BUENOS AIRES",397,269,85,40,0,125,0.677581863979849
"067600705","BUENOS AIRES",436,3,384,49,0,433,0.00688073394495413
"067600812","BUENOS AIRES",382,344,32,6,0,38,0.900523560209424
"067600901","BUENOS AIRES",237,86,119,31,0,150,0.362869198312236
"067600905","BUENOS AIRES",264,253,6,5,0,11,0.958333333333333
"067600908","BUENOS AIRES",222,211,8,2,0,10,0.95045045045045
"067601104","BUENOS AIRES",431,31,255,141,0,396,0.0719257540603248
"067601111","BUENOS AIRES",544,3,343,193,0,536,0.00551470588235294
"067601216","BUENOS AIRES",368,8,119,227,3,349,0.0217391304347826
"067601402","BUENOS AIRES",266,3,149,111,0,260,0.0112781954887218
"067601409","BUENOS AIRES",383,1,262,116,1,379,0.00261096605744125
"067601515","BUENOS AIRES",201,2,78,118,1,197,0.00995024875621891
"067601608","BUENOS AIRES",368,0,214,140,0,354,0
"067601809","BUENOS AIRES",304,0,158,136,0,294,0
"067630203","BUENOS AIRES",258,252,4,0,0,4,0.976744186046512
"067630207","BUENOS AIRES",318,308,4,5,1,10,0.968553459119497
"067630301","BUENOS AIRES",342,340,2,0,0,2,0.994152046783626
"067630307","BUENOS AIRES",379,379,0,0,0,0,1
"060280114","BUENOS AIRES",294,0,173,110,1,284,0
"067630408","BUENOS AIRES",316,314,1,0,0,1,0.993670886075949
"067630410","BUENOS AIRES",214,209,2,3,0,5,0.976635514018692
"067630507","BUENOS AIRES",335,232,77,25,1,103,0.692537313432836
"067630518","BUENOS AIRES",305,170,46,80,0,126,0.557377049180328
"067630614","BUENOS AIRES",347,11,168,163,2,333,0.031700288184438
"067630702","BUENOS AIRES",256,2,71,154,14,239,0.0078125
"067630807","BUENOS AIRES",301,6,170,122,0,292,0.0199335548172757
"067631401","BUENOS AIRES",289,183,60,43,1,104,0.633217993079585
"067631801","BUENOS AIRES",346,18,194,132,1,327,0.0520231213872832
"067631909","BUENOS AIRES",283,255,11,16,0,27,0.901060070671378
"067632003","BUENOS AIRES",234,3,154,74,1,229,0.0128205128205128
"067632011","BUENOS AIRES",188,115,48,21,0,69,0.611702127659574
"067700102","BUENOS AIRES",196,136,9,43,0,52,0.693877551020408
"067700207","BUENOS AIRES",281,82,27,160,1,188,0.291814946619217
"067701008","BUENOS AIRES",371,317,9,34,6,49,0.8544474393531
"067780604","BUENOS AIRES",338,39,159,119,2,280,0.115384615384615
"067911212","BUENOS AIRES",223,181,17,25,0,42,0.811659192825112
"067701011","BUENOS AIRES",146,143,1,1,1,3,0.979452054794521
"067701201","BUENOS AIRES",466,89,72,275,5,352,0.190987124463519
"067780102","BUENOS AIRES",233,210,17,5,0,22,0.901287553648069
"067780104","BUENOS AIRES",221,126,26,66,0,92,0.570135746606335
"067780108","BUENOS AIRES",243,41,63,130,1,194,0.168724279835391
"067780212","BUENOS AIRES",212,91,43,73,2,118,0.429245283018868
"068050612","BUENOS AIRES",351,347,2,2,0,4,0.988603988603989
"067780407","BUENOS AIRES",309,4,156,144,0,300,0.0129449838187702
"067911206","BUENOS AIRES",400,242,67,78,2,147,0.605
"067780911","BUENOS AIRES",334,297,23,10,0,33,0.889221556886228
"067781015","BUENOS AIRES",239,0,78,139,5,222,0
"067840806","BUENOS AIRES",235,151,36,46,0,82,0.642553191489362
"067910205","BUENOS AIRES",270,250,15,5,0,20,0.925925925925926
"067910301","BUENOS AIRES",310,297,7,5,0,12,0.958064516129032
"067910309","BUENOS AIRES",328,276,33,19,0,52,0.841463414634146
"067910401","BUENOS AIRES",225,222,3,0,0,3,0.986666666666667
"067911006","BUENOS AIRES",322,7,125,182,1,308,0.0217391304347826
"067911005","BUENOS AIRES",44,0,4,38,0,42,0
"067911201","BUENOS AIRES",246,4,26,187,22,235,0.016260162601626
"067912110","BUENOS AIRES",373,2,119,241,5,365,0.00536193029490617
"067912113","BUENOS AIRES",188,76,30,79,1,110,0.404255319148936
"068050102","BUENOS AIRES",207,0,120,83,1,204,0
"068050701","BUENOS AIRES",161,152,6,1,0,7,0.944099378881988
"020142306","CABA",212,212,0,0,0,0,1
"068050103","BUENOS AIRES",221,4,105,86,17,208,0.0180995475113122
"068050311","BUENOS AIRES",381,379,2,0,0,2,0.994750656167979
"068050401","BUENOS AIRES",225,159,30,35,1,66,0.706666666666667
"068050412","BUENOS AIRES",687,659,27,1,0,28,0.95924308588064
"068050503","BUENOS AIRES",412,381,17,14,0,31,0.924757281553398
"020142307","CABA",341,337,0,0,0,0,0.988269794721408
"068050805","BUENOS AIRES",186,173,9,4,0,13,0.93010752688172
"068050812","BUENOS AIRES",239,13,66,156,2,224,0.0543933054393305
"068051506","BUENOS AIRES",503,7,342,148,0,490,0.0139165009940358
"068051607","BUENOS AIRES",361,2,239,111,0,350,0.00554016620498615
"068050905","BUENOS AIRES",611,601,7,1,1,9,0.983633387888707
"068051003","BUENOS AIRES",302,6,143,146,1,290,0.0198675496688742
"068051006","BUENOS AIRES",429,6,298,118,0,416,0.013986013986014
"068051009","BUENOS AIRES",485,2,119,311,1,431,0.00412371134020619
"068051105","BUENOS AIRES",405,9,191,187,0,378,0.0222222222222222
"068051208","BUENOS AIRES",255,4,162,88,0,250,0.0156862745098039
"068051212","BUENOS AIRES",429,14,325,90,0,415,0.0326340326340326
"068051214","BUENOS AIRES",272,58,166,48,0,214,0.213235294117647
"068051314","BUENOS AIRES",352,3,210,96,2,308,0.00852272727272727
"068400806","BUENOS AIRES",231,227,2,2,0,4,0.982683982683983
"068051415","BUENOS AIRES",353,2,167,168,1,336,0.0056657223796034
"068051502","BUENOS AIRES",285,11,178,94,0,272,0.0385964912280702
"068051504","BUENOS AIRES",336,5,241,89,0,330,0.0148809523809524
"068051611","BUENOS AIRES",384,11,242,119,5,366,0.0286458333333333
"068051708","BUENOS AIRES",469,0,336,129,0,465,0
"068051802","BUENOS AIRES",249,0,196,51,0,247,0
"068051805","BUENOS AIRES",351,5,248,95,0,343,0.0142450142450142
"068051812","BUENOS AIRES",431,278,128,17,1,146,0.645011600928074
"068260117","BUENOS AIRES",165,145,7,7,0,14,0.878787878787879
"068052103","BUENOS AIRES",506,11,258,221,4,483,0.0217391304347826
"068052302","BUENOS AIRES",411,0,157,233,2,392,0
"068052401","BUENOS AIRES",415,2,265,137,1,403,0.00481927710843374
"068190406","BUENOS AIRES",326,270,32,23,0,55,0.828220858895706
"068260107","BUENOS AIRES",313,284,22,7,0,29,0.907348242811502
"068260111","BUENOS AIRES",200,182,11,5,0,16,0.91
"068260112","BUENOS AIRES",204,194,3,6,0,9,0.950980392156863
"068260114","BUENOS AIRES",196,186,7,3,0,10,0.948979591836735
"068261604","BUENOS AIRES",89,55,14,20,0,34,0.617977528089888
"068261608","BUENOS AIRES",394,273,55,61,3,119,0.692893401015228
"068261911","BUENOS AIRES",194,187,4,3,0,7,0.963917525773196
"068331803","BUENOS AIRES",105,0,68,37,0,105,0
"068331805","BUENOS AIRES",97,6,49,42,0,91,0.0618556701030928
"068331811","BUENOS AIRES",58,0,33,24,0,57,0
"068331913","BUENOS AIRES",373,189,50,123,1,174,0.506702412868633
"068331914","BUENOS AIRES",110,6,18,84,1,103,0.0545454545454545
"068400907","BUENOS AIRES",287,287,0,0,0,0,1
"068401008","BUENOS AIRES",258,258,0,0,0,0,1
"068400101","BUENOS AIRES",121,3,58,57,0,115,0.0247933884297521
"068400113","BUENOS AIRES",572,6,366,195,0,561,0.0104895104895105
"068400211","BUENOS AIRES",303,103,135,61,0,196,0.33993399339934
"068400302","BUENOS AIRES",427,10,249,164,1,414,0.0234192037470726
"068400404","BUENOS AIRES",247,27,167,51,0,218,0.109311740890688
"068400411","BUENOS AIRES",311,198,64,47,0,111,0.636655948553055
"068400417","BUENOS AIRES",406,403,3,0,0,3,0.992610837438424
"068400512","BUENOS AIRES",418,405,5,3,0,8,0.9688995215311
"068400603","BUENOS AIRES",266,199,48,14,0,62,0.74812030075188
"068400609","BUENOS AIRES",223,217,5,1,0,6,0.973094170403587
"068400702","BUENOS AIRES",402,394,5,2,0,7,0.980099502487562
"068401210","BUENOS AIRES",320,316,2,1,0,3,0.9875
"068402704","BUENOS AIRES",363,350,7,2,0,9,0.964187327823691
"068401211","BUENOS AIRES",358,356,2,0,0,2,0.994413407821229
"068401303","BUENOS AIRES",403,393,5,4,0,9,0.975186104218362
"068401501","BUENOS AIRES",214,213,1,0,0,1,0.995327102803738
"068401505","BUENOS AIRES",388,377,11,0,0,11,0.971649484536082
"068401506","BUENOS AIRES",381,377,0,1,0,1,0.989501312335958
"068401613","BUENOS AIRES",325,325,0,0,0,0,1
"068401706","BUENOS AIRES",419,412,6,1,0,7,0.983293556085919
"068401808","BUENOS AIRES",398,385,8,3,0,11,0.967336683417085
"068401814","BUENOS AIRES",275,257,10,7,0,17,0.934545454545455
"068401903","BUENOS AIRES",338,337,1,0,0,1,0.997041420118343
"068401904","BUENOS AIRES",480,477,2,1,0,3,0.99375
"068402101","BUENOS AIRES",271,261,6,2,0,8,0.96309963099631
"068402103","BUENOS AIRES",176,169,6,1,0,7,0.960227272727273
"068402208","BUENOS AIRES",407,391,5,6,0,11,0.960687960687961
"068402406","BUENOS AIRES",280,268,8,1,0,9,0.957142857142857
"068402409","BUENOS AIRES",279,279,0,0,0,0,1
"068402507","BUENOS AIRES",123,62,4,38,0,42,0.504065040650406
"068402602","BUENOS AIRES",1015,999,12,2,0,14,0.98423645320197
"068402808","BUENOS AIRES",232,227,4,1,0,5,0.978448275862069
"068402810","BUENOS AIRES",245,230,5,0,0,5,0.938775510204082
"068402907","BUENOS AIRES",315,295,10,9,0,19,0.936507936507937
"068403012","BUENOS AIRES",189,186,3,0,0,3,0.984126984126984
"068403102","BUENOS AIRES",343,329,11,1,0,12,0.959183673469388
"068403106","BUENOS AIRES",352,344,3,3,0,6,0.977272727272727
"068470103","BUENOS AIRES",331,0,219,92,0,311,0
"068470105","BUENOS AIRES",270,0,227,41,0,268,0
"068120202","BUENOS AIRES",9,0,2,6,0,8,0
"068330602","BUENOS AIRES",3,0,2,1,0,3,0
"068190202","BUENOS AIRES",31,0,17,14,0,31,0
"068540105","BUENOS AIRES",309,202,46,61,0,107,0.653721682847896
"068540107","BUENOS AIRES",270,264,1,5,0,6,0.977777777777778
"068190409","BUENOS AIRES",68,1,28,37,1,66,0.0147058823529412
"068540113","BUENOS AIRES",353,73,122,157,0,279,0.206798866855524
"068540208","BUENOS AIRES",281,256,13,12,0,25,0.911032028469751
"068330705","BUENOS AIRES",21,0,8,13,0,21,0
"068610909","BUENOS AIRES",126,126,0,0,0,0,1
"068331402","BUENOS AIRES",34,0,27,7,0,34,0
"068331603","BUENOS AIRES",6,0,1,5,0,6,0
"068190908","BUENOS AIRES",12,0,11,1,0,12,0
"068260401","BUENOS AIRES",19,0,2,15,0,17,0
"068260502","BUENOS AIRES",12,1,1,10,0,11,0.0833333333333333
"068260705","BUENOS AIRES",25,0,15,10,0,25,0
"068261201","BUENOS AIRES",23,0,13,8,0,21,0
"068330302","BUENOS AIRES",6,0,6,0,0,6,0
"068330402","BUENOS AIRES",22,0,9,13,0,22,0
"068331902","BUENOS AIRES",73,0,37,35,0,72,0
"068541203","BUENOS AIRES",29,0,9,20,0,29,0
"068610702","BUENOS AIRES",250,250,0,0,0,0,1
"068610705","BUENOS AIRES",310,310,0,0,0,0,1
"068610802","BUENOS AIRES",306,306,0,0,0,0,1
"068610804","BUENOS AIRES",288,285,1,0,0,1,0.989583333333333
"068541403","BUENOS AIRES",62,0,25,35,1,61,0
"068821501","BUENOS AIRES",39,0,19,19,1,39,0
"068610101","BUENOS AIRES",243,243,0,0,0,0,1
"068610103","BUENOS AIRES",250,250,0,0,0,0,1
"068610108","BUENOS AIRES",261,260,1,0,0,1,0.996168582375479
"068610406","BUENOS AIRES",284,284,0,0,0,0,1
"068610408","BUENOS AIRES",214,212,0,1,0,1,0.990654205607477
"068610501","BUENOS AIRES",252,238,7,7,0,14,0.944444444444444
"068610506","BUENOS AIRES",0,0,0,0,0,0,NA
"068610910","BUENOS AIRES",277,277,0,0,0,0,1
"068611008","BUENOS AIRES",337,330,7,0,0,7,0.979228486646884
"068611009","BUENOS AIRES",280,272,7,1,0,8,0.971428571428571
"068611102","BUENOS AIRES",243,237,6,0,0,6,0.975308641975309
"068611202","BUENOS AIRES",264,263,1,0,0,1,0.996212121212121
"068611204","BUENOS AIRES",189,189,0,0,0,0,1
"068611209","BUENOS AIRES",281,280,1,0,0,1,0.99644128113879
"068611407","BUENOS AIRES",322,321,1,0,0,1,0.996894409937888
"068611510","BUENOS AIRES",322,318,4,0,0,4,0.987577639751553
"068611705","BUENOS AIRES",254,254,0,0,0,0,1
"068611913","BUENOS AIRES",267,267,0,0,0,0,1
"068612007","BUENOS AIRES",306,285,16,0,0,16,0.931372549019608
"068612109","BUENOS AIRES",284,280,4,0,0,4,0.985915492957746
"068612202","BUENOS AIRES",332,329,2,0,0,2,0.990963855421687
"068612403","BUENOS AIRES",251,247,3,0,0,3,0.98406374501992
"068612404","BUENOS AIRES",237,237,0,0,0,0,1
"068612501","BUENOS AIRES",230,222,5,2,0,7,0.965217391304348
"068612601","BUENOS AIRES",396,394,1,1,0,2,0.994949494949495
"068612608","BUENOS AIRES",412,407,2,2,0,4,0.987864077669903
"068612706","BUENOS AIRES",292,287,3,2,0,5,0.982876712328767
"068612903","BUENOS AIRES",349,348,1,0,0,1,0.997134670487106
"063574402","BUENOS AIRES",74,63,0,0,0,0,0.851351351351351
"068613009","BUENOS AIRES",453,427,7,4,1,12,0.942604856512141
"068613305","BUENOS AIRES",357,333,18,0,0,18,0.932773109243697
"068680101","BUENOS AIRES",489,6,237,239,0,476,0.0122699386503067
"068680109","BUENOS AIRES",284,218,35,26,0,61,0.767605633802817
"068680110","BUENOS AIRES",278,132,91,52,2,145,0.474820143884892
"068680305","BUENOS AIRES",112,100,12,0,0,12,0.892857142857143
"068680311","BUENOS AIRES",33,32,1,0,0,1,0.96969696969697
"068680506","BUENOS AIRES",68,6,57,5,0,62,0.0882352941176471
"068680509","BUENOS AIRES",119,0,91,24,0,115,0
"068820306","BUENOS AIRES",342,339,3,0,0,3,0.991228070175439
"068680510","BUENOS AIRES",71,2,56,13,0,69,0.028169014084507
"068680608","BUENOS AIRES",29,26,3,0,0,3,0.896551724137931
"068680706","BUENOS AIRES",107,100,4,2,0,6,0.934579439252336
"068680805","BUENOS AIRES",24,22,1,0,0,1,0.916666666666667
"068750805","BUENOS AIRES",137,0,77,50,6,133,0
"068751610","BUENOS AIRES",386,189,44,103,23,170,0.489637305699482
"068751612","BUENOS AIRES",207,0,134,54,3,191,0
"068820105","BUENOS AIRES",496,415,5,67,1,73,0.836693548387097
"068820213","BUENOS AIRES",321,320,0,1,0,1,0.996884735202492
"068820301","BUENOS AIRES",59,9,0,29,18,47,0.152542372881356
"068820303","BUENOS AIRES",376,331,21,15,6,42,0.88031914893617
"020010711","CABA",140,140,0,0,0,0,1
"068820903","BUENOS AIRES",368,288,12,66,0,78,0.782608695652174
"068820909","BUENOS AIRES",275,259,6,4,0,10,0.941818181818182
"068821005","BUENOS AIRES",254,251,3,0,0,3,0.988188976377953
"065152012","BUENOS AIRES",242,0,146,84,0,230,0
"068821601","BUENOS AIRES",346,343,0,2,0,2,0.991329479768786
"065601405","BUENOS AIRES",399,250,53,79,0,132,0.6265664160401
"065601414","BUENOS AIRES",343,9,174,150,2,326,0.0262390670553936
"065601501","BUENOS AIRES",293,2,157,130,2,289,0.0068259385665529
"066581305","BUENOS AIRES",136,7,9,112,0,121,0.0514705882352941
"065601504","BUENOS AIRES",285,5,175,102,1,278,0.0175438596491228
"065601516","BUENOS AIRES",409,18,229,151,0,380,0.0440097799511002
"065601604","BUENOS AIRES",329,0,191,124,3,318,0
"065601605","BUENOS AIRES",331,13,139,171,0,310,0.0392749244712991
"065601607","BUENOS AIRES",330,9,127,185,0,312,0.0272727272727273
"065601702","BUENOS AIRES",327,2,113,173,6,292,0.00611620795107034
"065602112","BUENOS AIRES",229,116,58,51,0,109,0.506550218340611
"065601709","BUENOS AIRES",53,2,48,3,0,51,0.0377358490566038
"065601710","BUENOS AIRES",117,4,98,15,0,113,0.0341880341880342
"065601719","BUENOS AIRES",380,1,255,111,0,366,0.00263157894736842
"065601720","BUENOS AIRES",231,6,163,51,2,216,0.025974025974026
"065601721","BUENOS AIRES",217,0,124,87,1,212,0
"065601904","BUENOS AIRES",308,1,174,120,3,297,0.00324675324675325
"065601905","BUENOS AIRES",200,2,86,106,1,193,0.01
"065601912","BUENOS AIRES",234,0,179,55,0,234,0
"065602004","BUENOS AIRES",393,4,202,175,0,377,0.0101781170483461
"060280115","BUENOS AIRES",426,2,212,208,0,420,0.00469483568075117
"065602304","BUENOS AIRES",418,363,25,30,0,55,0.868421052631579
"065601920","BUENOS AIRES",202,0,75,112,3,190,0
"020050205","CABA",222,222,0,0,0,0,1
"065602307","BUENOS AIRES",347,328,19,0,0,19,0.945244956772334
"065602308","BUENOS AIRES",207,198,4,5,0,9,0.956521739130435
"065602404","BUENOS AIRES",287,286,0,0,1,1,0.996515679442509
"067910218","BUENOS AIRES",453,358,33,55,4,92,0.790286975717439
"065602414","BUENOS AIRES",222,214,7,1,0,8,0.963963963963964
"065680206","BUENOS AIRES",348,271,47,29,0,76,0.778735632183908
"065602514","BUENOS AIRES",346,256,49,29,0,78,0.739884393063584
"065680205","BUENOS AIRES",297,243,27,27,0,54,0.818181818181818
"065680209","BUENOS AIRES",451,29,248,174,0,422,0.0643015521064302
"065680212","BUENOS AIRES",271,1,191,79,0,270,0.003690036900369
"065680308","BUENOS AIRES",314,2,188,117,1,306,0.00636942675159236
"065680309","BUENOS AIRES",324,9,199,116,0,315,0.0277777777777778
"065680312","BUENOS AIRES",337,281,42,4,0,46,0.833827893175074
"065680316","BUENOS AIRES",330,317,8,0,0,8,0.960606060606061
"065680409","BUENOS AIRES",381,379,1,0,0,1,0.994750656167979
"065680507","BUENOS AIRES",338,334,4,0,0,4,0.988165680473373
"065680601","BUENOS AIRES",400,400,0,0,0,0,1
"065680607","BUENOS AIRES",391,389,1,1,0,2,0.994884910485934
"065680808","BUENOS AIRES",345,4,260,80,0,340,0.0115942028985507
"065680902","BUENOS AIRES",251,4,219,28,0,247,0.0159362549800797
"065681209","BUENOS AIRES",238,233,4,1,0,5,0.978991596638655
"065681401","BUENOS AIRES",191,2,152,37,0,189,0.0104712041884817
"065881009","BUENOS AIRES",4,0,2,2,0,4,0
"066510705","BUENOS AIRES",4,0,0,4,0,4,0
"060070202","BUENOS AIRES",7,0,1,6,0,7,0
"060070509","BUENOS AIRES",6,0,4,2,0,6,0
"060070703","BUENOS AIRES",6,0,2,4,0,6,0
"064904810","BUENOS AIRES",258,213,29,16,0,45,0.825581395348837
"064904908","BUENOS AIRES",191,174,7,9,0,16,0.910994764397906
"064905105","BUENOS AIRES",416,13,286,113,0,399,0.03125
"064905109","BUENOS AIRES",279,48,137,93,1,231,0.172043010752688
"066583409","BUENOS AIRES",288,281,3,3,1,7,0.975694444444444
"064970110","BUENOS AIRES",253,126,88,38,0,126,0.49802371541502
"065151908","BUENOS AIRES",396,1,229,154,0,383,0.00252525252525253
"065151910","BUENOS AIRES",448,2,252,188,1,441,0.00446428571428571
"064970404","BUENOS AIRES",218,0,124,91,0,215,0
"064970408","BUENOS AIRES",103,0,46,40,0,86,0
"064970607","BUENOS AIRES",361,5,141,205,1,347,0.0138504155124654
"064970610","BUENOS AIRES",205,1,79,123,0,202,0.0048780487804878
"064970810","BUENOS AIRES",298,1,197,94,0,291,0.00335570469798658
"064970812","BUENOS AIRES",502,1,347,152,0,499,0.00199203187250996
"064970813","BUENOS AIRES",205,3,166,36,0,202,0.0146341463414634
"064971202","BUENOS AIRES",419,4,219,186,1,406,0.00954653937947494
"064971401","BUENOS AIRES",419,150,174,92,0,266,0.35799522673031
"064971402","BUENOS AIRES",394,202,81,110,0,191,0.512690355329949
"065810408","BUENOS AIRES",261,259,1,1,0,2,0.992337164750958
"065151913","BUENOS AIRES",151,1,82,68,0,150,0.00662251655629139
"066651311","BUENOS AIRES",381,364,5,9,1,15,0.955380577427822
"065152010","BUENOS AIRES",466,2,271,184,1,456,0.00429184549356223
"065050303","BUENOS AIRES",62,0,39,20,0,59,0
"065050314","BUENOS AIRES",265,210,32,21,0,53,0.792452830188679
"065152105","BUENOS AIRES",255,2,159,92,0,251,0.00784313725490196
"065152108","BUENOS AIRES",274,2,211,58,0,269,0.0072992700729927
"065180114","BUENOS AIRES",144,119,12,12,0,24,0.826388888888889
"065150605","BUENOS AIRES",194,0,118,75,0,193,0
"065150614","BUENOS AIRES",310,1,233,72,0,305,0.0032258064516129
"065150102","BUENOS AIRES",1,0,1,0,0,1,0
"065250112","BUENOS AIRES",190,11,38,136,1,175,0.0578947368421053
"065150202","BUENOS AIRES",318,0,200,113,2,315,0
"065150301","BUENOS AIRES",368,0,211,141,0,352,0
"065150306","BUENOS AIRES",291,0,179,106,0,285,0
"065150312","BUENOS AIRES",306,1,183,119,0,302,0.00326797385620915
"065150314","BUENOS AIRES",289,2,216,69,0,285,0.0069204152249135
"065150402","BUENOS AIRES",319,1,222,84,3,309,0.00313479623824451
"065150509","BUENOS AIRES",339,2,297,33,1,331,0.00589970501474926
"065150613","BUENOS AIRES",194,1,172,18,0,190,0.00515463917525773
"065150810","BUENOS AIRES",348,3,145,142,1,288,0.00862068965517241
"065150812","BUENOS AIRES",318,5,251,59,0,310,0.0157232704402516
"065150907","BUENOS AIRES",209,8,152,48,0,200,0.0382775119617225
"060283907","BUENOS AIRES",273,0,53,204,3,260,0
"060283909","BUENOS AIRES",454,0,264,179,1,444,0
"060350306","BUENOS AIRES",363,363,0,0,0,0,1
"060490402","BUENOS AIRES",89,25,26,37,0,63,0.280898876404494
"060560901","BUENOS AIRES",309,308,1,0,0,1,0.996763754045307
"065151009","BUENOS AIRES",322,0,199,113,0,312,0
"060561408","BUENOS AIRES",305,305,0,0,0,0,1
"060562406","BUENOS AIRES",434,425,7,0,0,7,0.97926267281106
"065151101","BUENOS AIRES",354,12,268,72,0,340,0.0338983050847458
"065151103","BUENOS AIRES",393,3,322,64,1,387,0.00763358778625954
"060280304","BUENOS AIRES",216,9,28,159,3,190,0.0416666666666667
"065151112","BUENOS AIRES",249,0,143,91,1,235,0
"060912303","BUENOS AIRES",248,7,120,89,0,209,0.0282258064516129
"060980704","BUENOS AIRES",293,187,69,35,0,104,0.638225255972696
"065151203","BUENOS AIRES",286,0,170,101,2,273,0
"061260512","BUENOS AIRES",394,4,64,316,1,381,0.0101522842639594
"061260915","BUENOS AIRES",165,0,24,131,1,156,0
"060070601","BUENOS AIRES",165,0,101,62,0,163,0
"061820210","BUENOS AIRES",277,273,1,1,0,2,0.985559566787004
"060140301","BUENOS AIRES",56,0,25,30,0,55,0
"060141004","BUENOS AIRES",183,76,72,34,0,106,0.415300546448087
"060352613","BUENOS AIRES",207,17,58,123,7,188,0.0821256038647343
"060141011","BUENOS AIRES",307,256,33,18,0,51,0.833876221498371
"060210606","BUENOS AIRES",294,290,3,1,0,4,0.986394557823129
"020010909","CABA",237,237,0,0,0,0,1
"060280401","BUENOS AIRES",459,21,117,301,4,422,0.0457516339869281
"060280412","BUENOS AIRES",474,8,217,236,4,457,0.0168776371308017
"060280505","BUENOS AIRES",24,0,18,5,0,23,0
"060280512","BUENOS AIRES",36,0,23,13,0,36,0
"060280803","BUENOS AIRES",20,0,9,10,0,19,0
"060280809","BUENOS AIRES",32,0,13,18,0,31,0
"060280812","BUENOS AIRES",359,1,251,107,0,358,0.00278551532033426
"060280903","BUENOS AIRES",281,5,167,101,0,268,0.0177935943060498
"060280908","BUENOS AIRES",364,10,176,162,4,342,0.0274725274725275
"060281002","BUENOS AIRES",229,6,119,103,0,222,0.0262008733624454
"060281009","BUENOS AIRES",280,7,139,126,0,265,0.025
"060281108","BUENOS AIRES",131,127,4,0,0,4,0.969465648854962
"060281201","BUENOS AIRES",416,370,6,5,0,11,0.889423076923077
"060281204","BUENOS AIRES",321,302,9,10,0,19,0.940809968847352
"060281304","BUENOS AIRES",465,7,285,165,1,451,0.0150537634408602
"060281305","BUENOS AIRES",339,8,196,114,0,310,0.023598820058997
"020011004","CABA",223,222,0,0,0,0,0.995515695067265
"060281313","BUENOS AIRES",218,20,110,88,0,198,0.0917431192660551
"060350109","BUENOS AIRES",142,122,9,11,0,20,0.859154929577465
"060281507","BUENOS AIRES",445,2,302,138,0,440,0.00449438202247191
"060281508","BUENOS AIRES",232,2,153,71,1,225,0.00862068965517241
"060281511","BUENOS AIRES",220,0,144,72,0,216,0
"060281604","BUENOS AIRES",309,306,3,0,0,3,0.990291262135922
"060281802","BUENOS AIRES",301,295,0,6,0,6,0.980066445182724
"060281807","BUENOS AIRES",302,0,122,162,2,286,0
"060281810","BUENOS AIRES",315,3,173,108,1,282,0.00952380952380952
"060282202","BUENOS AIRES",292,7,233,51,0,284,0.023972602739726
"060282206","BUENOS AIRES",406,18,185,194,3,382,0.0443349753694581
"060282211","BUENOS AIRES",286,2,137,141,1,279,0.00699300699300699
"060282215","BUENOS AIRES",217,5,143,66,2,211,0.0230414746543779
"060282303","BUENOS AIRES",265,1,163,96,3,262,0.00377358490566038
"060282310","BUENOS AIRES",268,5,152,111,0,263,0.0186567164179104
"060282313","BUENOS AIRES",203,2,147,53,0,200,0.00985221674876847
"062030804","BUENOS AIRES",356,211,89,56,0,145,0.592696629213483
"060282407","BUENOS AIRES",381,105,208,68,0,276,0.275590551181102
"060282505","BUENOS AIRES",356,356,0,0,0,0,1
"060282702","BUENOS AIRES",289,9,157,119,2,278,0.0311418685121107
"060282706","BUENOS AIRES",347,5,73,255,1,329,0.0144092219020173
"060282803","BUENOS AIRES",380,10,222,133,0,355,0.0263157894736842
"060282912","BUENOS AIRES",301,2,146,140,2,288,0.00664451827242525
"060283002","BUENOS AIRES",232,4,159,67,0,226,0.0172413793103448
"060283205","BUENOS AIRES",225,1,184,40,0,224,0.00444444444444444
"060283208","BUENOS AIRES",386,1,252,130,0,382,0.00259067357512953
"060283209","BUENOS AIRES",453,3,325,123,0,448,0.00662251655629139
"060283303","BUENOS AIRES",250,107,94,18,0,112,0.428
"060283311","BUENOS AIRES",354,0,301,52,0,353,0
"060350604","BUENOS AIRES",269,246,10,11,0,21,0.91449814126394
"060283412","BUENOS AIRES",368,30,276,61,0,337,0.0815217391304348
"060283506","BUENOS AIRES",373,31,248,79,1,328,0.0831099195710456
"060283508","BUENOS AIRES",309,3,220,82,0,302,0.00970873786407767
"060283601","BUENOS AIRES",199,0,106,93,0,199,0
"060283604","BUENOS AIRES",441,3,372,62,0,434,0.00680272108843537
"060283609","BUENOS AIRES",268,0,123,140,1,264,0
"060283706","BUENOS AIRES",368,1,182,168,1,351,0.00271739130434783
"065151215","BUENOS AIRES",278,0,171,94,0,265,0
"060350309","BUENOS AIRES",180,180,0,0,0,0,1
"060350310","BUENOS AIRES",223,223,0,0,0,0,1
"060350313","BUENOS AIRES",334,17,126,191,0,317,0.0508982035928144
"060350401","BUENOS AIRES",406,68,126,203,0,329,0.167487684729064
"060350404","BUENOS AIRES",365,88,108,159,1,268,0.241095890410959
"060350509","BUENOS AIRES",319,283,22,14,0,36,0.887147335423197
"060350510","BUENOS AIRES",295,262,11,22,0,33,0.888135593220339
"060350607","BUENOS AIRES",207,151,21,35,0,56,0.729468599033816
"060350710","BUENOS AIRES",138,96,19,23,0,42,0.695652173913043
"060350804","BUENOS AIRES",321,306,15,0,0,15,0.953271028037383
"060350813","BUENOS AIRES",344,179,59,87,3,149,0.520348837209302
"060351609","BUENOS AIRES",325,16,120,188,1,309,0.0492307692307692
"060350903","BUENOS AIRES",159,145,6,4,2,12,0.911949685534591
"060350909","BUENOS AIRES",193,135,12,35,2,49,0.699481865284974
"060351004","BUENOS AIRES",310,274,12,3,0,15,0.883870967741936
"060351101","BUENOS AIRES",203,150,21,7,1,29,0.738916256157635
"060351109","BUENOS AIRES",275,274,1,0,0,1,0.996363636363636
"060351303","BUENOS AIRES",291,273,14,0,0,14,0.938144329896907
"060351307","BUENOS AIRES",219,133,31,55,0,86,0.607305936073059
"060351405","BUENOS AIRES",246,245,0,1,0,1,0.995934959349594
"060351501","BUENOS AIRES",207,184,5,13,0,18,0.888888888888889
"060561206","BUENOS AIRES",265,263,0,0,0,0,0.992452830188679
"060351504","BUENOS AIRES",277,264,8,5,0,13,0.953068592057762
"060351505","BUENOS AIRES",256,243,4,5,0,9,0.94921875
"060351605","BUENOS AIRES",264,8,92,163,0,255,0.0303030303030303
"060351803","BUENOS AIRES",264,51,92,121,0,213,0.193181818181818
"060351902","BUENOS AIRES",333,124,82,125,2,209,0.372372372372372
"060351908","BUENOS AIRES",273,65,93,115,0,208,0.238095238095238
"060352001","BUENOS AIRES",365,319,31,15,0,46,0.873972602739726
"060352009","BUENOS AIRES",312,281,20,11,0,31,0.900641025641026
"060352202","BUENOS AIRES",262,255,6,0,0,6,0.973282442748092
"060352206","BUENOS AIRES",275,272,2,1,0,3,0.989090909090909
"060352209","BUENOS AIRES",227,223,0,4,0,4,0.982378854625551
"060352404","BUENOS AIRES",347,246,38,61,0,99,0.708933717579251
"060352601","BUENOS AIRES",410,324,20,58,0,78,0.790243902439024
"060352704","BUENOS AIRES",611,429,36,124,5,165,0.702127659574468
"060352801","BUENOS AIRES",354,46,220,88,0,308,0.129943502824859
"060352906","BUENOS AIRES",296,73,116,73,1,190,0.246621621621622
"060352907","BUENOS AIRES",263,69,111,83,0,194,0.262357414448669
"060353007","BUENOS AIRES",341,274,45,21,0,66,0.803519061583578
"060353009","BUENOS AIRES",284,130,113,41,0,154,0.457746478873239
"060353204","BUENOS AIRES",301,286,6,9,0,15,0.950166112956811
"060561010","BUENOS AIRES",230,229,0,1,0,1,0.995652173913044
"060560807","BUENOS AIRES",248,236,2,6,1,9,0.951612903225806
"060353501","BUENOS AIRES",332,254,24,54,0,78,0.765060240963855
"060353502","BUENOS AIRES",288,274,12,2,0,14,0.951388888888889
"060353505","BUENOS AIRES",463,265,33,163,0,196,0.572354211663067
"060421902","BUENOS AIRES",300,272,8,16,1,25,0.906666666666667
"060421903","BUENOS AIRES",367,279,12,65,3,80,0.760217983651226
"060421904","BUENOS AIRES",311,293,9,8,0,17,0.942122186495177
"060490101","BUENOS AIRES",219,213,4,2,0,6,0.972602739726027
"060561304","BUENOS AIRES",172,172,0,0,0,0,1
"060490111","BUENOS AIRES",253,175,19,59,0,78,0.691699604743083
"060490112","BUENOS AIRES",163,46,26,88,1,115,0.282208588957055
"060490205","BUENOS AIRES",360,300,21,37,0,58,0.833333333333333
"060490503","BUENOS AIRES",236,228,5,3,0,8,0.966101694915254
"020010809","CABA",257,257,0,0,0,0,1
"060490504","BUENOS AIRES",414,363,32,19,0,51,0.876811594202899
"060490508","BUENOS AIRES",382,259,51,71,0,122,0.678010471204188
"060490601","BUENOS AIRES",317,313,1,3,0,4,0.987381703470032
"060490605","BUENOS AIRES",268,262,5,1,0,6,0.977611940298508
"060490607","BUENOS AIRES",345,278,18,46,0,64,0.805797101449275
"062450107","BUENOS AIRES",259,251,5,2,0,7,0.969111969111969
"060490611","BUENOS AIRES",335,200,39,92,0,131,0.597014925373134
"060490614","BUENOS AIRES",291,195,28,67,1,96,0.670103092783505
"060491003","BUENOS AIRES",188,53,51,84,0,135,0.281914893617021
"063572009","BUENOS AIRES",92,92,0,0,0,0,1
"060560406","BUENOS AIRES",439,433,3,3,0,6,0.986332574031891
"060561403","BUENOS AIRES",261,261,0,0,0,0,1
"060492506","BUENOS AIRES",249,208,39,1,0,40,0.835341365461847
"060560107","BUENOS AIRES",239,239,0,0,0,0,1
"060560115","BUENOS AIRES",229,226,2,0,0,2,0.986899563318777
"062940804","BUENOS AIRES",126,107,7,12,0,19,0.849206349206349
"060560208","BUENOS AIRES",364,356,6,2,0,8,0.978021978021978
"060560301","BUENOS AIRES",181,181,0,0,0,0,1
"060560305","BUENOS AIRES",123,119,3,1,0,4,0.967479674796748
"060560306","BUENOS AIRES",335,335,0,0,0,0,1
"060560311","BUENOS AIRES",363,355,4,4,0,8,0.977961432506887
"060560402","BUENOS AIRES",233,215,9,6,0,15,0.92274678111588
"063573803","BUENOS AIRES",212,212,0,0,0,0,1
"060560410","BUENOS AIRES",150,148,2,0,0,2,0.986666666666667
"065151305","BUENOS AIRES",487,7,326,145,0,471,0.0143737166324435
"060560509","BUENOS AIRES",373,362,7,1,0,8,0.970509383378016
"060560609","BUENOS AIRES",361,306,31,22,0,53,0.847645429362881
"060561517","BUENOS AIRES",173,164,5,3,0,8,0.947976878612717
"060560815","BUENOS AIRES",202,61,31,101,0,132,0.301980198019802
"060560906","BUENOS AIRES",326,326,0,0,0,0,1
"060560911","BUENOS AIRES",208,195,4,2,0,6,0.9375
"060561103","BUENOS AIRES",148,148,0,0,0,0,1
"060561205","BUENOS AIRES",284,282,1,0,0,1,0.992957746478873
"060561501","BUENOS AIRES",302,248,21,29,0,50,0.821192052980132
"060561511","BUENOS AIRES",236,233,3,0,0,3,0.98728813559322
"060561514","BUENOS AIRES",341,321,7,10,0,17,0.941348973607038
"060561606","BUENOS AIRES",171,168,2,1,0,3,0.982456140350877
"060561701","BUENOS AIRES",344,344,0,0,0,0,1
"060561702","BUENOS AIRES",331,329,1,0,0,1,0.993957703927492
"060561706","BUENOS AIRES",311,311,0,0,0,0,1
"060562008","BUENOS AIRES",189,172,5,12,0,17,0.91005291005291
"060562009","BUENOS AIRES",193,192,0,1,0,1,0.994818652849741
"060562010","BUENOS AIRES",204,201,3,0,0,3,0.985294117647059
"060562202","BUENOS AIRES",345,338,5,2,0,7,0.979710144927536
"060562204","BUENOS AIRES",410,387,15,6,0,21,0.94390243902439
"060562213","BUENOS AIRES",295,245,23,24,0,47,0.830508474576271
"062870404","BUENOS AIRES",178,42,46,86,1,133,0.235955056179775
"060562302","BUENOS AIRES",280,202,27,41,0,68,0.721428571428571
"060562308","BUENOS AIRES",292,292,0,0,0,0,1
"060562311","BUENOS AIRES",179,175,4,0,0,4,0.977653631284916
"060562402","BUENOS AIRES",473,47,192,221,1,414,0.0993657505285412
"060562405","BUENOS AIRES",325,217,46,55,2,103,0.667692307692308
"060562410","BUENOS AIRES",267,143,46,74,0,120,0.535580524344569
"063573901","BUENOS AIRES",206,205,0,0,0,0,0.995145631067961
"060562513","BUENOS AIRES",289,283,3,3,0,6,0.97923875432526
"060562515","BUENOS AIRES",259,256,3,0,0,3,0.988416988416988
"060562614","BUENOS AIRES",375,143,132,91,4,227,0.381333333333333
"060562608","BUENOS AIRES",309,2,259,48,0,307,0.00647249190938511
"067000210","BUENOS AIRES",216,208,4,3,0,7,0.962962962962963
"060630115","BUENOS AIRES",351,238,30,67,0,97,0.678062678062678
"060630101","BUENOS AIRES",286,122,47,99,1,147,0.426573426573427
"060630701","BUENOS AIRES",430,318,17,75,2,94,0.73953488372093
"060630703","BUENOS AIRES",314,282,6,25,0,31,0.898089171974522
"060630704","BUENOS AIRES",258,211,5,40,0,45,0.817829457364341
"060630705","BUENOS AIRES",178,62,37,78,1,116,0.348314606741573
"060631306","BUENOS AIRES",282,276,2,4,0,6,0.978723404255319
"060631307","BUENOS AIRES",372,353,2,17,0,19,0.948924731182796
"060700111","BUENOS AIRES",151,147,3,1,0,4,0.973509933774834
"062700905","BUENOS AIRES",302,2,149,139,4,292,0.00662251655629139
"060700801","BUENOS AIRES",135,2,52,80,1,133,0.0148148148148148
"063573906","BUENOS AIRES",93,93,0,0,0,0,1
"060770109","BUENOS AIRES",293,284,2,6,0,8,0.969283276450512
"063572103","BUENOS AIRES",214,210,4,0,0,4,0.981308411214953
"060771405","BUENOS AIRES",249,247,0,0,0,0,0.991967871485944
"060840706","BUENOS AIRES",285,249,19,16,0,35,0.873684210526316
"062741005","BUENOS AIRES",237,3,87,139,0,226,0.0126582278481013
"060840904","BUENOS AIRES",138,3,120,15,0,135,0.0217391304347826
"060910301","BUENOS AIRES",400,399,0,0,0,0,0.9975
"060841205","BUENOS AIRES",233,196,12,23,0,35,0.841201716738197
"060910110","BUENOS AIRES",271,227,21,22,1,44,0.837638376383764
"060910203","BUENOS AIRES",212,210,0,2,0,2,0.990566037735849
"060910207","BUENOS AIRES",224,223,1,0,0,1,0.995535714285714
"064410410","BUENOS AIRES",272,272,0,0,0,0,1
"060910409","BUENOS AIRES",518,329,33,139,0,172,0.635135135135135
"060910701","BUENOS AIRES",374,346,8,20,0,28,0.925133689839572
"060910710","BUENOS AIRES",390,188,92,94,0,186,0.482051282051282
"060910902","BUENOS AIRES",402,398,0,3,0,3,0.990049751243781
"060911001","BUENOS AIRES",354,349,4,0,0,4,0.985875706214689
"060911102","BUENOS AIRES",453,448,3,2,0,5,0.988962472406181
"060911307","BUENOS AIRES",298,282,8,4,1,13,0.946308724832215
"060911310","BUENOS AIRES",413,352,19,33,0,52,0.852300242130751
"060911312","BUENOS AIRES",277,180,21,68,0,89,0.649819494584838
"060911402","BUENOS AIRES",400,320,22,31,5,58,0.8
"060911412","BUENOS AIRES",305,286,5,12,0,17,0.937704918032787
"060911711","BUENOS AIRES",361,318,11,23,0,34,0.880886426592798
"060911513","BUENOS AIRES",246,238,2,5,0,7,0.967479674796748
"060911604","BUENOS AIRES",416,388,11,6,0,17,0.932692307692308
"060911605","BUENOS AIRES",437,408,11,13,0,24,0.933638443935927
"060911606","BUENOS AIRES",261,219,14,21,1,36,0.839080459770115
"060911612","BUENOS AIRES",234,155,19,59,1,79,0.662393162393162
"060911613","BUENOS AIRES",432,370,17,37,0,54,0.856481481481482
"060911712","BUENOS AIRES",363,320,22,16,0,38,0.881542699724518
"060911810","BUENOS AIRES",225,54,40,127,0,167,0.24
"060911903","BUENOS AIRES",349,255,4,58,24,86,0.730659025787966
"062870405","BUENOS AIRES",291,211,31,48,0,79,0.725085910652921
"060911906","BUENOS AIRES",196,184,5,7,0,12,0.938775510204082
"062800401","BUENOS AIRES",250,248,2,0,0,2,0.992
"062800402","BUENOS AIRES",56,54,2,0,0,2,0.964285714285714
"063573907","BUENOS AIRES",209,209,0,0,0,0,1
"060912012","BUENOS AIRES",227,7,99,120,0,219,0.0308370044052863
"060912115","BUENOS AIRES",281,5,172,98,2,272,0.0177935943060498
"060912207","BUENOS AIRES",309,18,91,191,0,282,0.058252427184466
"060912209","BUENOS AIRES",224,7,67,144,0,211,0.03125
"062801007","BUENOS AIRES",64,63,1,0,0,1,0.984375
"060912311","BUENOS AIRES",322,5,125,175,1,301,0.015527950310559
"060912404","BUENOS AIRES",403,2,114,250,4,368,0.00496277915632754
"060980201","BUENOS AIRES",283,147,115,19,0,134,0.519434628975265
"060980205","BUENOS AIRES",321,214,71,31,0,102,0.666666666666667
"060980307","BUENOS AIRES",258,254,2,0,0,2,0.984496124031008
"060980508","BUENOS AIRES",264,193,35,31,0,66,0.731060606060606
"060980502","BUENOS AIRES",370,129,112,122,2,236,0.348648648648649
"060980615","BUENOS AIRES",254,29,177,42,0,219,0.114173228346457
"060980616","BUENOS AIRES",309,7,207,83,2,292,0.0226537216828479
"060980809","BUENOS AIRES",242,227,7,8,0,15,0.93801652892562
"061050104","BUENOS AIRES",378,375,3,0,0,3,0.992063492063492
"061050106","BUENOS AIRES",253,246,7,0,0,7,0.972332015810277
"061050207","BUENOS AIRES",365,358,4,3,0,7,0.980821917808219
"061051302","BUENOS AIRES",128,63,42,22,1,65,0.4921875
"061051403","BUENOS AIRES",182,148,5,29,0,34,0.813186813186813
"061051404","BUENOS AIRES",195,96,35,63,1,99,0.492307692307692
"061051410","BUENOS AIRES",314,291,8,14,0,22,0.926751592356688
"061120102","BUENOS AIRES",365,265,16,80,1,97,0.726027397260274
"061120107","BUENOS AIRES",271,264,0,7,0,7,0.974169741697417
"061120109","BUENOS AIRES",409,365,6,34,1,41,0.89242053789731
"061120203","BUENOS AIRES",395,236,61,93,0,154,0.59746835443038
"062030214","BUENOS AIRES",26,0,4,20,1,25,0
"061120207","BUENOS AIRES",274,225,19,30,0,49,0.821167883211679
"063150103","BUENOS AIRES",180,78,32,60,0,92,0.433333333333333
"063571603","BUENOS AIRES",288,284,1,0,0,1,0.986111111111111
"061121405","BUENOS AIRES",299,288,8,3,0,11,0.963210702341137
"061121409","BUENOS AIRES",272,270,0,2,0,2,0.992647058823529
"064411808","BUENOS AIRES",290,290,0,0,0,0,1
"061190301","BUENOS AIRES",296,244,29,5,0,34,0.824324324324324
"063573601","BUENOS AIRES",247,239,0,1,0,1,0.967611336032389
"061190407","BUENOS AIRES",321,114,146,61,0,207,0.355140186915888
"061190409","BUENOS AIRES",246,2,169,65,0,234,0.00813008130081301
"061260201","BUENOS AIRES",393,4,40,343,1,384,0.0101781170483461
"061260204","BUENOS AIRES",324,163,90,70,0,160,0.503086419753086
"061260311","BUENOS AIRES",308,301,6,0,0,6,0.977272727272727
"061260514","BUENOS AIRES",246,1,48,190,1,239,0.0040650406504065
"063574506","BUENOS AIRES",315,314,1,0,0,1,0.996825396825397
"061260609","BUENOS AIRES",108,76,30,2,0,32,0.703703703703704
"061260702","BUENOS AIRES",296,8,96,192,0,288,0.027027027027027
"061260708","BUENOS AIRES",328,6,91,229,0,320,0.0182926829268293
"061260802","BUENOS AIRES",182,178,3,1,0,4,0.978021978021978
"061260804","BUENOS AIRES",273,237,22,10,4,36,0.868131868131868
"061340102","BUENOS AIRES",152,0,95,50,1,146,0
"061340107","BUENOS AIRES",183,2,139,42,0,181,0.0109289617486339
"063573604","BUENOS AIRES",253,253,0,0,0,0,1
"061340110","BUENOS AIRES",145,0,69,70,0,139,0
"061340111","BUENOS AIRES",124,3,85,34,0,119,0.0241935483870968
"061340114","BUENOS AIRES",42,0,23,18,0,41,0
"061340301","BUENOS AIRES",550,176,160,213,1,374,0.32
"061340308","BUENOS AIRES",463,252,87,121,0,208,0.544276457883369
"061340406","BUENOS AIRES",158,1,74,81,0,155,0.00632911392405063
"061340910","BUENOS AIRES",280,1,173,84,1,258,0.00357142857142857
"061341003","BUENOS AIRES",319,0,153,154,2,309,0
"061341010","BUENOS AIRES",405,236,103,61,0,164,0.582716049382716
"061400305","BUENOS AIRES",326,300,6,8,0,14,0.920245398773006
"061400316","BUENOS AIRES",338,304,12,15,0,27,0.899408284023669
"063572603","BUENOS AIRES",264,264,0,0,0,0,1
"061470105","BUENOS AIRES",291,285,1,5,0,6,0.979381443298969
"061470801","BUENOS AIRES",185,0,96,85,1,182,0
"061471001","BUENOS AIRES",73,0,25,46,2,73,0
"061540612","BUENOS AIRES",249,0,170,78,1,249,0
"061471208","BUENOS AIRES",365,299,11,47,1,59,0.819178082191781
"061540604","BUENOS AIRES",137,0,100,37,0,137,0
"061540607","BUENOS AIRES",235,0,160,74,0,234,0
"061610109","BUENOS AIRES",275,250,8,15,0,23,0.909090909090909
"061610110","BUENOS AIRES",182,124,12,44,0,56,0.681318681318681
"061610114","BUENOS AIRES",217,167,21,26,1,48,0.769585253456221
"061610404","BUENOS AIRES",85,62,7,13,0,20,0.729411764705882
"061610801","BUENOS AIRES",41,0,26,14,1,41,0
"063572108","BUENOS AIRES",216,215,1,0,0,1,0.99537037037037
"063576112","BUENOS AIRES",84,82,2,0,0,2,0.976190476190476
"063572201","BUENOS AIRES",194,194,0,0,0,0,1
"061750402","BUENOS AIRES",335,149,72,112,0,184,0.444776119402985
"061750408","BUENOS AIRES",370,357,8,4,0,12,0.964864864864865
"063572203","BUENOS AIRES",193,193,0,0,0,0,1
"061750410","BUENOS AIRES",324,308,5,10,0,15,0.950617283950617
"061750411","BUENOS AIRES",198,194,1,3,0,4,0.97979797979798
"061750415","BUENOS AIRES",164,4,119,39,1,159,0.024390243902439
"061750610","BUENOS AIRES",301,113,52,131,2,185,0.375415282392027
"061820108","BUENOS AIRES",203,201,1,0,0,1,0.990147783251232
"061820207","BUENOS AIRES",272,269,3,0,0,3,0.988970588235294
"063574515","BUENOS AIRES",162,162,0,0,0,0,1
"061820310","BUENOS AIRES",18,14,3,1,0,4,0.777777777777778
"061820606","BUENOS AIRES",403,155,114,126,0,240,0.384615384615385
"061820608","BUENOS AIRES",317,204,70,39,1,110,0.643533123028391
"061820708","BUENOS AIRES",276,177,58,38,0,96,0.641304347826087
"061820709","BUENOS AIRES",281,179,57,41,0,98,0.637010676156584
"061820710","BUENOS AIRES",371,303,35,30,0,65,0.816711590296496
"061820901","BUENOS AIRES",96,1,88,7,0,95,0.0104166666666667
"061821107","BUENOS AIRES",199,166,13,20,0,33,0.834170854271357
"061960105","BUENOS AIRES",98,9,25,60,0,85,0.0918367346938776
"061960102","BUENOS AIRES",311,279,6,25,0,31,0.897106109324759
"061960205","BUENOS AIRES",357,345,5,6,0,11,0.966386554621849
"062030202","BUENOS AIRES",226,98,67,61,0,128,0.433628318584071
"020050404","CABA",341,338,0,0,0,0,0.991202346041056
"062031401","BUENOS AIRES",152,11,111,30,0,141,0.0723684210526316
"062031607","BUENOS AIRES",322,23,168,131,0,299,0.0714285714285714
"062031608","BUENOS AIRES",306,34,171,99,0,270,0.111111111111111
"062031612","BUENOS AIRES",274,0,69,198,2,269,0
"062100116","BUENOS AIRES",303,302,0,1,0,1,0.996699669966997
"063711311","BUENOS AIRES",329,312,8,9,0,17,0.948328267477204
"062100205","BUENOS AIRES",212,210,1,1,0,2,0.990566037735849
"062100605","BUENOS AIRES",117,3,71,43,0,114,0.0256410256410256
"062521006","BUENOS AIRES",322,3,184,109,0,293,0.0093167701863354
"062100809","BUENOS AIRES",285,221,32,27,2,61,0.775438596491228
"062101308","BUENOS AIRES",419,400,3,10,0,13,0.954653937947494
"062170409","BUENOS AIRES",175,0,82,86,2,170,0
"062170415","BUENOS AIRES",244,203,12,27,0,39,0.831967213114754
"062240112","BUENOS AIRES",339,316,12,10,0,22,0.932153392330384
"062171002","BUENOS AIRES",440,375,36,26,0,62,0.852272727272727
"062240117","BUENOS AIRES",237,25,45,166,0,211,0.105485232067511
"062240209","BUENOS AIRES",273,204,20,44,0,64,0.747252747252747
"062240402","BUENOS AIRES",433,178,123,130,0,253,0.41108545034642
"062240408","BUENOS AIRES",268,268,0,0,0,0,1
"062242009","BUENOS AIRES",79,0,32,46,0,78,0
"062241103","BUENOS AIRES",68,0,31,35,1,67,0
"062242010","BUENOS AIRES",134,2,70,59,0,129,0.0149253731343284
"062242001","BUENOS AIRES",117,1,73,43,0,116,0.00854700854700855
"062311204","BUENOS AIRES",324,268,19,37,0,56,0.827160493827161
"062380111","BUENOS AIRES",227,158,14,53,0,67,0.696035242290749
"062380114","BUENOS AIRES",156,22,27,106,0,133,0.141025641025641
"062380211","BUENOS AIRES",90,0,12,78,0,90,0
"062380214","BUENOS AIRES",176,4,34,134,3,171,0.0227272727272727
"062380604","BUENOS AIRES",260,178,33,47,1,81,0.684615384615385
"063572801","BUENOS AIRES",246,246,0,0,0,0,1
"062380609","BUENOS AIRES",140,14,22,103,0,125,0.1
"062450103","BUENOS AIRES",420,101,287,32,0,319,0.24047619047619
"062450106","BUENOS AIRES",424,195,145,74,1,220,0.459905660377358
"062450108","BUENOS AIRES",290,190,78,19,1,98,0.655172413793103
"062450109","BUENOS AIRES",262,234,13,15,0,28,0.893129770992366
"062450202","BUENOS AIRES",248,35,141,64,2,207,0.141129032258065
"062450209","BUENOS AIRES",356,253,55,36,0,91,0.710674157303371
"064121306","BUENOS AIRES",458,1,228,220,1,449,0.00218340611353712
"062450212","BUENOS AIRES",417,32,259,109,4,372,0.0767386091127098
"062450215","BUENOS AIRES",242,59,144,33,0,177,0.243801652892562
"062450303","BUENOS AIRES",366,275,52,36,0,88,0.751366120218579
"062450402","BUENOS AIRES",145,6,62,74,1,137,0.0413793103448276
"062450406","BUENOS AIRES",191,16,111,61,1,173,0.0837696335078534
"064100905","BUENOS AIRES",417,222,179,16,0,195,0.532374100719424
"062450415","BUENOS AIRES",453,18,171,218,15,404,0.0397350993377483
"062601014","BUENOS AIRES",258,0,118,130,1,249,0
"062450505","BUENOS AIRES",529,335,66,119,0,185,0.633270321361059
"062520111","BUENOS AIRES",236,228,2,3,0,5,0.966101694915254
"062520114","BUENOS AIRES",267,3,170,91,0,261,0.0112359550561798
"062520216","BUENOS AIRES",291,2,110,173,1,284,0.00687285223367698
"062520412","BUENOS AIRES",535,5,230,275,4,509,0.00934579439252336
"062520505","BUENOS AIRES",288,285,3,0,0,3,0.989583333333333
"062520605","BUENOS AIRES",327,2,195,125,0,320,0.00611620795107034
"062520809","BUENOS AIRES",85,55,19,11,0,30,0.647058823529412
"062521007","BUENOS AIRES",286,0,162,112,0,274,0
"062601106","BUENOS AIRES",189,42,106,41,0,147,0.222222222222222
"062520901","BUENOS AIRES",841,380,179,226,20,425,0.451843043995244
"062520906","BUENOS AIRES",337,3,166,148,1,315,0.00890207715133531
"062520907","BUENOS AIRES",331,1,174,147,1,322,0.00302114803625378
"062520913","BUENOS AIRES",637,2,209,344,15,568,0.00313971742543171
"062520914","BUENOS AIRES",504,84,190,217,1,408,0.166666666666667
"062521004","BUENOS AIRES",343,38,244,55,0,299,0.110787172011662
"063574807","BUENOS AIRES",199,198,1,0,0,1,0.994974874371859
"062521008","BUENOS AIRES",218,0,131,87,0,218,0
"062521017","BUENOS AIRES",205,0,142,63,0,205,0
"062521103","BUENOS AIRES",234,1,159,58,0,217,0.00427350427350427
"062521202","BUENOS AIRES",520,0,318,193,2,513,0
"062600517","BUENOS AIRES",283,9,209,63,0,272,0.0318021201413428
"062521306","BUENOS AIRES",318,3,246,64,0,310,0.00943396226415094
"062521409","BUENOS AIRES",336,4,212,119,1,332,0.0119047619047619
"062521413","BUENOS AIRES",590,2,274,293,2,569,0.00338983050847458
"062600102","BUENOS AIRES",359,18,135,195,1,331,0.0501392757660167
"064131101","BUENOS AIRES",47,0,13,28,1,42,0
"062600204","BUENOS AIRES",388,2,140,239,0,379,0.00515463917525773
"062600209","BUENOS AIRES",443,8,279,149,0,428,0.018058690744921
"062600316","BUENOS AIRES",409,11,291,77,0,368,0.0268948655256724
"062600401","BUENOS AIRES",277,2,152,121,0,273,0.0072202166064982
"062600408","BUENOS AIRES",364,2,242,119,0,361,0.00549450549450549
"062600602","BUENOS AIRES",295,34,190,70,1,261,0.115254237288136
"062600712","BUENOS AIRES",305,257,41,7,0,48,0.842622950819672
"062600713","BUENOS AIRES",332,326,4,1,0,5,0.981927710843373
"062600802","BUENOS AIRES",440,20,272,136,0,408,0.0454545454545455
"062600811","BUENOS AIRES",390,28,150,198,11,359,0.0717948717948718
"062600913","BUENOS AIRES",425,3,206,189,1,396,0.00705882352941176
"062600914","BUENOS AIRES",314,1,241,70,0,311,0.00318471337579618
"062601003","BUENOS AIRES",367,1,294,69,0,363,0.00272479564032698
"062601006","BUENOS AIRES",1270,1050,117,101,0,218,0.826771653543307
"064200205","BUENOS AIRES",23,23,0,0,0,0,1
"063712505","BUENOS AIRES",340,330,2,7,0,9,0.970588235294118
"064200213","BUENOS AIRES",197,180,10,6,0,16,0.913705583756345
"062601110","BUENOS AIRES",389,0,305,81,1,387,0
"062601206","BUENOS AIRES",353,101,220,30,0,250,0.286118980169972
"062601303","BUENOS AIRES",360,70,238,52,0,290,0.194444444444444
"062601306","BUENOS AIRES",344,319,16,9,0,25,0.927325581395349
"062601412","BUENOS AIRES",249,11,200,37,0,237,0.0441767068273092
"062601604","BUENOS AIRES",306,2,152,150,0,302,0.0065359477124183
"062601703","BUENOS AIRES",1223,5,158,389,85,632,0.00408830744071954
"062601710","BUENOS AIRES",107,96,9,2,0,11,0.897196261682243
"062660305","BUENOS AIRES",114,7,28,73,0,101,0.0614035087719298
"062660311","BUENOS AIRES",271,231,12,20,0,32,0.85239852398524
"062741605","BUENOS AIRES",269,226,20,16,1,37,0.840148698884758
"062660401","BUENOS AIRES",53,0,19,22,1,42,0
"062660507","BUENOS AIRES",39,0,26,10,0,36,0
"062660607","BUENOS AIRES",65,0,58,7,0,65,0
"062660709","BUENOS AIRES",403,308,48,45,0,93,0.764267990074442
"062700105","BUENOS AIRES",169,169,0,0,0,0,1
"062700209","BUENOS AIRES",464,1,247,197,2,446,0.0021551724137931
"062700212","BUENOS AIRES",429,4,253,148,1,402,0.00932400932400932
"062740909","BUENOS AIRES",204,173,5,26,0,31,0.848039215686274
"062700304","BUENOS AIRES",506,15,246,233,0,479,0.0296442687747036
"062700501","BUENOS AIRES",294,0,236,56,1,293,0
"062700507","BUENOS AIRES",384,2,308,69,0,377,0.00520833333333333
"062740315","BUENOS AIRES",272,8,120,134,2,256,0.0294117647058824
"062740408","BUENOS AIRES",243,32,110,94,0,204,0.131687242798354
"062700603","BUENOS AIRES",111,6,90,15,0,105,0.0540540540540541
"062700705","BUENOS AIRES",337,11,208,111,2,321,0.0326409495548961
"062700713","BUENOS AIRES",273,0,137,129,2,268,0
"062741702","BUENOS AIRES",244,229,9,3,0,12,0.938524590163934
"062700807","BUENOS AIRES",72,0,47,23,0,70,0
"062700912","BUENOS AIRES",280,1,195,78,0,273,0.00357142857142857
"062700913","BUENOS AIRES",297,1,186,91,12,289,0.00336700336700337
"062700902","BUENOS AIRES",385,2,227,138,3,368,0.00519480519480519
"062700906","BUENOS AIRES",369,1,199,155,1,355,0.002710027100271
"064272014","BUENOS AIRES",684,334,168,164,10,342,0.488304093567251
"062740101","BUENOS AIRES",374,337,18,14,0,32,0.901069518716578
"062740107","BUENOS AIRES",253,243,8,1,1,10,0.960474308300395
"063573003","BUENOS AIRES",77,77,0,0,0,0,1
"062740210","BUENOS AIRES",298,167,22,101,2,125,0.560402684563758
"062740309","BUENOS AIRES",269,8,109,146,0,255,0.0297397769516729
"062740507","BUENOS AIRES",322,7,96,189,3,288,0.0217391304347826
"062740601","BUENOS AIRES",405,26,194,174,2,370,0.0641975308641975
"062740604","BUENOS AIRES",293,2,194,91,1,286,0.0068259385665529
"062740607","BUENOS AIRES",255,9,84,150,2,236,0.0352941176470588
"062740610","BUENOS AIRES",279,1,161,113,0,274,0.003584229390681
"062740620","BUENOS AIRES",364,7,121,224,0,345,0.0192307692307692
"062740708","BUENOS AIRES",417,5,133,248,9,390,0.0119904076738609
"062740713","BUENOS AIRES",357,4,81,242,5,328,0.0112044817927171
"062740810","BUENOS AIRES",301,1,36,243,1,280,0.00332225913621262
"065151603","BUENOS AIRES",235,0,178,52,1,231,0
"062740814","BUENOS AIRES",323,6,142,164,2,308,0.0185758513931889
"062740815","BUENOS AIRES",329,3,112,182,1,295,0.00911854103343465
"063712903","BUENOS AIRES",204,197,4,3,0,7,0.965686274509804
"062740820","BUENOS AIRES",340,5,141,180,3,324,0.0147058823529412
"062741102","BUENOS AIRES",342,325,5,2,0,7,0.950292397660819
"062741111","BUENOS AIRES",271,0,73,178,13,264,0
"062741205","BUENOS AIRES",211,205,2,1,0,3,0.971563981042654
"062741216","BUENOS AIRES",331,29,127,165,0,292,0.0876132930513595
"062741301","BUENOS AIRES",393,370,10,7,0,17,0.94147582697201
"062741518","BUENOS AIRES",428,366,18,33,0,51,0.855140186915888
"062741614","BUENOS AIRES",299,2,84,200,0,284,0.00668896321070234
"062741601","BUENOS AIRES",373,4,52,309,1,362,0.0107238605898123
"062770110","BUENOS AIRES",243,181,47,15,0,62,0.744855967078189
"062770112","BUENOS AIRES",219,198,14,7,0,21,0.904109589041096
"020011203","CABA",314,292,1,0,0,1,0.929936305732484
"062741603","BUENOS AIRES",374,2,117,220,5,342,0.0053475935828877
"062741706","BUENOS AIRES",322,6,104,197,2,303,0.0186335403726708
"062741807","BUENOS AIRES",390,294,10,36,0,46,0.753846153846154
"062741905","BUENOS AIRES",489,1,141,313,1,455,0.00204498977505112
"062742002","BUENOS AIRES",396,12,106,257,0,363,0.0303030303030303
"062742120","BUENOS AIRES",234,6,94,126,0,220,0.0256410256410256
"062742201","BUENOS AIRES",253,1,49,166,7,222,0.00395256916996047
"062742203","BUENOS AIRES",447,5,163,248,3,414,0.0111856823266219
"062742210","BUENOS AIRES",345,0,92,213,1,306,0
"062770107","BUENOS AIRES",260,81,56,111,4,171,0.311538461538462
"062800105","BUENOS AIRES",145,9,42,75,1,118,0.0620689655172414
"063573201","BUENOS AIRES",243,242,1,0,0,1,0.995884773662551
"062800110","BUENOS AIRES",171,6,61,100,1,162,0.0350877192982456
"062800410","BUENOS AIRES",99,87,6,6,0,12,0.878787878787879
"063573102","BUENOS AIRES",213,213,0,0,0,0,1
"063573103","BUENOS AIRES",179,179,0,0,0,0,1
"064276801","BUENOS AIRES",288,13,196,73,0,269,0.0451388888888889
"062800901","BUENOS AIRES",36,0,15,21,0,36,0
"064277613","BUENOS AIRES",239,56,134,46,0,180,0.234309623430962
"062801004","BUENOS AIRES",118,117,1,0,0,1,0.991525423728814
"062801101","BUENOS AIRES",238,128,66,34,1,101,0.53781512605042
"062801105","BUENOS AIRES",174,173,1,0,0,1,0.994252873563218
"062870407","BUENOS AIRES",248,102,57,88,0,145,0.411290322580645
"062940401","BUENOS AIRES",233,84,38,109,0,147,0.360515021459227
"063010513","BUENOS AIRES",401,128,149,122,0,271,0.319201995012469
"063570705","BUENOS AIRES",379,371,3,3,0,6,0.978891820580475
"063010806","BUENOS AIRES",276,16,152,107,1,260,0.0579710144927536
"063080501","BUENOS AIRES",101,0,76,25,0,101,0
"063080601","BUENOS AIRES",131,0,82,44,2,128,0
"063150101","BUENOS AIRES",234,121,64,46,0,110,0.517094017094017
"063150102","BUENOS AIRES",386,325,25,35,1,61,0.841968911917098
"063150105","BUENOS AIRES",321,301,13,6,0,19,0.937694704049844
"063150114","BUENOS AIRES",372,136,119,114,0,233,0.365591397849462
"064279608","BUENOS AIRES",477,3,338,115,3,456,0.00628930817610063
"064340104","BUENOS AIRES",337,310,15,12,0,27,0.919881305637982
"063220614","BUENOS AIRES",177,115,39,23,0,62,0.649717514124294
"020050807","CABA",399,397,1,0,1,2,0.994987468671679
"063290317","BUENOS AIRES",147,46,63,36,0,99,0.312925170068027
"063290501","BUENOS AIRES",95,0,46,47,1,94,0
"063570101","BUENOS AIRES",260,242,12,6,0,18,0.930769230769231
"063570303","BUENOS AIRES",129,128,0,1,0,1,0.992248062015504
"063570406","BUENOS AIRES",187,187,0,0,0,0,1
"063570503","BUENOS AIRES",251,251,0,0,0,0,1
"063570510","BUENOS AIRES",306,303,3,0,0,3,0.990196078431373
"063570511","BUENOS AIRES",171,171,0,0,0,0,1
"063570605","BUENOS AIRES",260,252,7,1,0,8,0.969230769230769
"063570610","BUENOS AIRES",313,310,2,1,0,3,0.990415335463259
"063570702","BUENOS AIRES",346,339,4,3,0,7,0.979768786127168
"063570703","BUENOS AIRES",261,256,3,1,0,4,0.980842911877395
"063570802","BUENOS AIRES",281,262,9,6,0,15,0.932384341637011
"063570808","BUENOS AIRES",262,256,5,1,0,6,0.977099236641221
"063570809","BUENOS AIRES",350,345,4,0,0,4,0.985714285714286
"063570902","BUENOS AIRES",318,16,93,202,3,298,0.050314465408805
"063570909","BUENOS AIRES",304,28,163,110,0,273,0.0921052631578947
"063570910","BUENOS AIRES",379,352,12,14,0,26,0.928759894459103
"063570913","BUENOS AIRES",308,298,5,5,0,10,0.967532467532468
"063571001","BUENOS AIRES",228,8,196,24,0,220,0.0350877192982456
"063571007","BUENOS AIRES",286,9,135,137,0,272,0.0314685314685315
"063571008","BUENOS AIRES",406,68,126,206,3,335,0.167487684729064
"063571207","BUENOS AIRES",327,295,7,21,0,28,0.902140672782875
"063571304","BUENOS AIRES",472,456,9,4,0,13,0.966101694915254
"063573304","BUENOS AIRES",306,306,0,0,0,0,1
"063571402","BUENOS AIRES",328,318,6,4,0,10,0.969512195121951
"063571403","BUENOS AIRES",422,411,7,4,0,11,0.9739336492891
"063571409","BUENOS AIRES",319,311,5,2,0,7,0.974921630094044
"063571508","BUENOS AIRES",361,357,3,0,0,3,0.988919667590028
"063571510","BUENOS AIRES",303,297,5,0,0,5,0.98019801980198
"063571608","BUENOS AIRES",218,217,1,0,0,1,0.995412844036697
"063571610","BUENOS AIRES",166,166,0,0,0,0,1
"063571801","BUENOS AIRES",282,281,0,0,0,0,0.99645390070922
"063571808","BUENOS AIRES",310,306,1,0,0,1,0.987096774193548
"063571901","BUENOS AIRES",288,286,2,0,0,2,0.993055555555556
"063571907","BUENOS AIRES",234,234,0,0,0,0,1
"063571911","BUENOS AIRES",146,146,0,0,0,0,1
"063572001","BUENOS AIRES",178,175,3,0,0,3,0.98314606741573
"063572006","BUENOS AIRES",112,112,0,0,0,0,1
"063572304","BUENOS AIRES",166,166,0,0,0,0,1
"063572306","BUENOS AIRES",176,176,0,0,0,0,1
"064411707","BUENOS AIRES",193,192,1,0,0,1,0.994818652849741
"063572403","BUENOS AIRES",156,155,0,1,0,1,0.993589743589744
"063573204","BUENOS AIRES",311,311,0,0,0,0,1
"063573206","BUENOS AIRES",219,219,0,0,0,0,1
"063573208","BUENOS AIRES",117,117,0,0,0,0,1
"063573210","BUENOS AIRES",200,197,3,0,0,3,0.985
"063574810","BUENOS AIRES",321,319,2,0,0,2,0.993769470404984
"063574905","BUENOS AIRES",287,286,1,0,0,1,0.996515679442509
"063574908","BUENOS AIRES",246,246,0,0,0,0,1
"063575002","BUENOS AIRES",310,303,4,2,0,6,0.97741935483871
"063575009","BUENOS AIRES",624,623,1,0,0,1,0.998397435897436
"063575014","BUENOS AIRES",201,201,0,0,0,0,1
"063575103","BUENOS AIRES",358,352,2,3,0,5,0.983240223463687
"063575107","BUENOS AIRES",360,353,4,1,0,5,0.980555555555556
"063575201","BUENOS AIRES",432,34,176,216,2,394,0.0787037037037037
"063575207","BUENOS AIRES",382,354,14,8,0,22,0.926701570680628
"063575209","BUENOS AIRES",243,238,3,1,0,4,0.979423868312757
"063575303","BUENOS AIRES",378,373,4,1,0,5,0.986772486772487
"063575308","BUENOS AIRES",346,315,13,12,1,26,0.910404624277457
"063575309","BUENOS AIRES",413,404,5,2,0,7,0.978208232445521
"063575404","BUENOS AIRES",401,394,4,3,0,7,0.982543640897756
"063575405","BUENOS AIRES",280,278,2,0,0,2,0.992857142857143
"063712701","BUENOS AIRES",245,232,10,2,0,12,0.946938775510204
"063575408","BUENOS AIRES",232,231,1,0,0,1,0.995689655172414
"063575505","BUENOS AIRES",185,183,2,0,0,2,0.989189189189189
"063575605","BUENOS AIRES",288,287,1,0,0,1,0.996527777777778
"063575608","BUENOS AIRES",322,322,0,0,0,0,1
"063575612","BUENOS AIRES",287,287,0,0,0,0,1
"063575803","BUENOS AIRES",280,279,1,0,0,1,0.996428571428571
"063576006","BUENOS AIRES",337,337,0,0,0,0,1
"063576011","BUENOS AIRES",230,204,18,5,0,23,0.88695652173913
"063576102","BUENOS AIRES",388,382,4,2,0,6,0.984536082474227
"063576202","BUENOS AIRES",188,187,1,0,0,1,0.99468085106383
"063576205","BUENOS AIRES",276,274,2,0,0,2,0.992753623188406
"063576206","BUENOS AIRES",267,265,1,0,0,1,0.99250936329588
"063576302","BUENOS AIRES",56,54,2,0,0,2,0.964285714285714
"063576304","BUENOS AIRES",124,91,23,10,0,33,0.733870967741935
"063576403","BUENOS AIRES",201,182,8,11,0,19,0.90547263681592
"063576409","BUENOS AIRES",81,81,0,0,0,0,1
"063576605","BUENOS AIRES",263,256,5,2,0,7,0.973384030418251
"063711708","BUENOS AIRES",304,86,154,62,0,216,0.282894736842105
"063710612","BUENOS AIRES",324,320,4,0,0,4,0.987654320987654
"063576503","BUENOS AIRES",3,0,0,0,0,0,0
"063576505","BUENOS AIRES",216,215,0,0,0,0,0.99537037037037
"063576511","BUENOS AIRES",199,192,7,0,0,7,0.964824120603015
"063576514","BUENOS AIRES",98,98,0,0,0,0,1
"063576603","BUENOS AIRES",408,351,12,34,2,48,0.860294117647059
"063576701","BUENOS AIRES",186,182,1,2,0,3,0.978494623655914
"063576809","BUENOS AIRES",280,270,4,5,0,9,0.964285714285714
"063577002","BUENOS AIRES",341,328,4,7,0,11,0.961876832844575
"063577013","BUENOS AIRES",267,238,9,17,0,26,0.891385767790262
"064414708","BUENOS AIRES",340,30,168,134,0,302,0.0882352941176471
"064414906","BUENOS AIRES",264,259,3,2,0,5,0.981060606060606
"063577209","BUENOS AIRES",371,219,34,103,2,139,0.590296495956873
"063710501","BUENOS AIRES",331,309,9,13,0,22,0.933534743202417
"063577812","BUENOS AIRES",428,6,156,251,0,407,0.014018691588785
"063577814","BUENOS AIRES",342,2,84,249,0,333,0.00584795321637427
"063577405","BUENOS AIRES",224,8,21,187,5,213,0.0357142857142857
"063577406","BUENOS AIRES",389,4,105,256,3,364,0.0102827763496144
"063577411","BUENOS AIRES",131,5,119,7,0,126,0.0381679389312977
"063577413","BUENOS AIRES",211,38,98,75,0,173,0.180094786729858
"063577510","BUENOS AIRES",73,24,29,20,0,49,0.328767123287671
"063577511","BUENOS AIRES",112,19,73,19,0,92,0.169642857142857
"063577604","BUENOS AIRES",103,1,83,19,0,102,0.00970873786407767
"063577905","BUENOS AIRES",225,0,100,120,0,220,0
"063577914","BUENOS AIRES",427,294,50,64,0,114,0.688524590163934
"063577915","BUENOS AIRES",560,400,60,81,2,143,0.714285714285714
"063578006","BUENOS AIRES",326,2,190,130,1,321,0.00613496932515337
"063578009","BUENOS AIRES",129,0,78,45,1,124,0
"063578112","BUENOS AIRES",168,3,126,38,0,164,0.0178571428571429
"063578204","BUENOS AIRES",175,1,108,60,0,168,0.00571428571428571
"063578302","BUENOS AIRES",141,0,64,69,5,138,0
"063640107","BUENOS AIRES",220,10,77,125,1,203,0.0454545454545455
"063640108","BUENOS AIRES",257,0,78,166,2,246,0
"063710703","BUENOS AIRES",335,318,12,2,0,14,0.949253731343284
"063640111","BUENOS AIRES",274,2,169,77,1,247,0.0072992700729927
"063640114","BUENOS AIRES",411,259,91,59,0,150,0.630170316301703
"063710506","BUENOS AIRES",379,367,6,4,0,10,0.968337730870712
"063640212","BUENOS AIRES",100,0,76,22,1,99,0
"063640311","BUENOS AIRES",136,134,1,1,0,2,0.985294117647059
"063640709","BUENOS AIRES",397,377,16,2,0,18,0.949622166246851
"063640715","BUENOS AIRES",227,70,75,80,1,156,0.308370044052863
"063640805","BUENOS AIRES",284,2,63,175,3,241,0.00704225352112676
"063640806","BUENOS AIRES",208,0,90,107,2,199,0
"063710309","BUENOS AIRES",292,10,184,96,0,280,0.0342465753424658
"063710314","BUENOS AIRES",230,180,42,8,0,50,0.782608695652174
"063710402","BUENOS AIRES",386,347,25,12,0,37,0.898963730569948
"063710403","BUENOS AIRES",249,218,14,14,0,28,0.875502008032129
"063710404","BUENOS AIRES",211,197,6,4,0,10,0.933649289099526
"063710604","BUENOS AIRES",235,228,5,1,0,6,0.970212765957447
"063710608","BUENOS AIRES",246,186,12,43,0,55,0.75609756097561
"063710711","BUENOS AIRES",228,177,35,16,0,51,0.776315789473684
"063710713","BUENOS AIRES",276,270,4,2,0,6,0.978260869565217
"063710804","BUENOS AIRES",317,304,1,0,0,1,0.958990536277603
"063710811","BUENOS AIRES",326,319,5,2,0,7,0.978527607361963
"063710904","BUENOS AIRES",219,207,6,3,0,9,0.945205479452055
"063710913","BUENOS AIRES",238,234,4,0,0,4,0.983193277310924
"063711006","BUENOS AIRES",361,358,3,0,0,3,0.991689750692521
"063711014","BUENOS AIRES",304,298,4,2,0,6,0.980263157894737
"063711110","BUENOS AIRES",402,394,5,1,0,6,0.980099502487562
"063711310","BUENOS AIRES",396,345,18,33,0,51,0.871212121212121
"063711401","BUENOS AIRES",403,22,189,166,14,369,0.054590570719603
"063711407","BUENOS AIRES",197,18,12,130,12,154,0.0913705583756345
"063711408","BUENOS AIRES",254,7,22,149,53,224,0.0275590551181102
"063711413","BUENOS AIRES",268,7,188,73,0,261,0.0261194029850746
"063711511","BUENOS AIRES",381,24,219,136,0,355,0.062992125984252
"063711612","BUENOS AIRES",128,11,69,44,0,113,0.0859375
"063711703","BUENOS AIRES",323,36,210,77,0,287,0.111455108359133
"063711802","BUENOS AIRES",244,99,80,65,0,145,0.405737704918033
"063711803","BUENOS AIRES",382,348,24,9,0,33,0.910994764397906
"063711812","BUENOS AIRES",227,5,132,90,0,222,0.0220264317180617
"063711906","BUENOS AIRES",242,229,8,3,0,11,0.946280991735537
"063712103","BUENOS AIRES",251,235,13,3,0,16,0.936254980079681
"063712105","BUENOS AIRES",421,416,3,2,0,5,0.98812351543943
"063712112","BUENOS AIRES",200,196,2,2,0,4,0.98
"063712115","BUENOS AIRES",343,313,22,0,0,22,0.912536443148688
"063712202","BUENOS AIRES",259,234,15,9,0,24,0.903474903474903
"063712210","BUENOS AIRES",189,189,0,0,0,0,1
"063712305","BUENOS AIRES",239,227,3,0,0,3,0.949790794979079
"063712307","BUENOS AIRES",274,270,4,0,0,4,0.985401459854015
"063712315","BUENOS AIRES",433,404,16,12,0,28,0.933025404157044
"063712407","BUENOS AIRES",235,232,1,2,0,3,0.987234042553191
"063712408","BUENOS AIRES",217,204,9,4,0,13,0.940092165898618
"063712702","BUENOS AIRES",339,329,3,6,0,9,0.970501474926254
"020011706","CABA",367,366,0,0,0,0,0.997275204359673
"063712808","BUENOS AIRES",321,312,6,3,0,9,0.97196261682243
"063712906","BUENOS AIRES",178,171,5,2,0,7,0.960674157303371
"063713009","BUENOS AIRES",234,127,63,43,0,106,0.542735042735043
"063713107","BUENOS AIRES",288,34,184,66,1,251,0.118055555555556
"063713302","BUENOS AIRES",420,216,38,153,1,192,0.514285714285714
"063713307","BUENOS AIRES",317,4,207,104,0,311,0.0126182965299685
"063713502","BUENOS AIRES",221,5,128,88,0,216,0.0226244343891403
"063713506","BUENOS AIRES",370,30,219,118,1,338,0.0810810810810811
"063713507","BUENOS AIRES",35,8,17,9,0,26,0.228571428571429
"063713606","BUENOS AIRES",299,5,162,129,0,291,0.0167224080267559
"063713609","BUENOS AIRES",496,9,368,115,0,483,0.0181451612903226
"063713707","BUENOS AIRES",450,11,209,212,2,423,0.0244444444444444
"063850106","BUENOS AIRES",184,2,50,115,11,176,0.0108695652173913
"063850201","BUENOS AIRES",117,1,63,53,0,116,0.00854700854700855
"063850707","BUENOS AIRES",327,325,2,0,0,2,0.99388379204893
"064270503","BUENOS AIRES",269,266,3,0,0,3,0.988847583643123
"063920115","BUENOS AIRES",262,179,25,53,0,78,0.683206106870229
"063920501","BUENOS AIRES",6,0,0,6,0,6,0
"064121308","BUENOS AIRES",424,3,283,126,1,410,0.00707547169811321
"063921202","BUENOS AIRES",290,35,63,161,12,236,0.120689655172414
"063990107","BUENOS AIRES",130,95,7,27,0,34,0.730769230769231
"063990108","BUENOS AIRES",178,137,20,21,0,41,0.769662921348315
"064060203","BUENOS AIRES",307,200,67,36,2,105,0.651465798045603
"064080102","BUENOS AIRES",288,30,243,15,0,258,0.104166666666667
"064080104","BUENOS AIRES",394,150,219,25,0,244,0.380710659898477
"064080105","BUENOS AIRES",367,5,280,81,0,361,0.0136239782016349
"064080108","BUENOS AIRES",425,30,288,99,0,387,0.0705882352941176
"064080210","BUENOS AIRES",447,4,347,88,0,435,0.00894854586129754
"064080306","BUENOS AIRES",335,88,176,48,0,224,0.262686567164179
"064081504","BUENOS AIRES",342,48,186,78,19,283,0.140350877192982
"064080408","BUENOS AIRES",563,6,451,105,0,556,0.0106571936056838
"064080602","BUENOS AIRES",177,3,158,16,0,174,0.0169491525423729
"064080605","BUENOS AIRES",372,6,333,33,0,366,0.0161290322580645
"064341908","BUENOS AIRES",234,202,25,7,0,32,0.863247863247863
"064080703","BUENOS AIRES",263,53,82,76,49,207,0.201520912547529
"064080903","BUENOS AIRES",282,0,224,57,0,281,0
"064904906","BUENOS AIRES",360,357,3,0,0,3,0.991666666666667
"064081007","BUENOS AIRES",415,5,302,105,0,407,0.0120481927710843
"064081106","BUENOS AIRES",321,111,182,27,0,209,0.345794392523364
"064081302","BUENOS AIRES",294,1,179,102,0,281,0.00340136054421769
"064081306","BUENOS AIRES",385,31,284,63,0,347,0.0805194805194805
"064081402","BUENOS AIRES",399,11,268,116,0,384,0.0275689223057644
"064081404","BUENOS AIRES",445,6,330,104,0,434,0.0134831460674157
"064081508","BUENOS AIRES",235,148,66,18,0,84,0.629787234042553
"064081510","BUENOS AIRES",212,162,42,7,0,49,0.764150943396226
"064100105","BUENOS AIRES",258,1,188,64,0,252,0.00387596899224806
"064100608","BUENOS AIRES",440,5,333,100,0,433,0.0113636363636364
"064100106","BUENOS AIRES",231,0,190,41,0,231,0
"064100110","BUENOS AIRES",339,189,131,17,0,148,0.557522123893805
"064100203","BUENOS AIRES",226,0,186,40,0,226,0
"064100304","BUENOS AIRES",342,1,259,77,0,336,0.00292397660818713
"064101305","BUENOS AIRES",256,0,214,39,0,253,0
"064270408","BUENOS AIRES",355,331,23,0,0,23,0.932394366197183
"064100312","BUENOS AIRES",155,1,123,30,0,153,0.00645161290322581
"064100413","BUENOS AIRES",286,0,224,53,4,281,0
"064100414","BUENOS AIRES",375,23,259,77,8,344,0.0613333333333333
"064100510","BUENOS AIRES",372,0,276,87,2,365,0
"064270811","BUENOS AIRES",409,399,9,0,0,9,0.975550122249389
"064100613","BUENOS AIRES",440,1,333,103,0,436,0.00227272727272727
"064100614","BUENOS AIRES",391,0,345,45,0,390,0
"064100710","BUENOS AIRES",417,0,376,39,0,415,0
"064100713","BUENOS AIRES",394,3,340,50,1,391,0.00761421319796954
"064100904","BUENOS AIRES",376,317,50,9,0,59,0.843085106382979
"064101009","BUENOS AIRES",350,0,316,33,0,349,0
"064101212","BUENOS AIRES",300,1,245,52,0,297,0.00333333333333333
"064101302","BUENOS AIRES",256,0,231,25,0,256,0
"064120102","BUENOS AIRES",177,0,144,32,1,177,0
"064120106","BUENOS AIRES",299,3,217,73,0,290,0.0100334448160535
"065150104","BUENOS AIRES",462,1,243,200,0,443,0.00216450216450216
"064120117","BUENOS AIRES",433,0,170,243,1,414,0
"064120118","BUENOS AIRES",445,1,250,171,2,423,0.00224719101123596
"064120204","BUENOS AIRES",401,0,242,147,0,389,0
"064120307","BUENOS AIRES",419,2,337,79,1,417,0.00477326968973747
"064120502","BUENOS AIRES",356,6,283,66,0,349,0.0168539325842697
"064120506","BUENOS AIRES",212,1,171,40,0,211,0.00471698113207547
"064120602","BUENOS AIRES",283,2,229,52,0,281,0.00706713780918728
"064120702","BUENOS AIRES",372,1,216,147,2,365,0.00268817204301075
"064120811","BUENOS AIRES",293,1,140,124,0,264,0.00341296928327645
"064120911","BUENOS AIRES",381,1,143,211,6,360,0.0026246719160105
"064121017","BUENOS AIRES",516,175,134,197,3,334,0.339147286821705
"064121103","BUENOS AIRES",496,0,270,209,2,481,0
"064121105","BUENOS AIRES",402,0,206,186,2,394,0
"064121304","BUENOS AIRES",267,0,152,113,0,265,0
"064121305","BUENOS AIRES",470,2,173,278,1,452,0.00425531914893617
"064270911","BUENOS AIRES",343,77,8,238,0,246,0.224489795918367
"064121408","BUENOS AIRES",407,270,64,70,1,135,0.663390663390663
"064121409","BUENOS AIRES",341,25,220,82,1,303,0.0733137829912024
"064121411","BUENOS AIRES",378,2,230,140,1,371,0.00529100529100529
"064121506","BUENOS AIRES",299,0,213,83,0,296,0
"064130103","BUENOS AIRES",295,271,10,9,0,19,0.91864406779661
"064130207","BUENOS AIRES",368,343,15,9,0,24,0.932065217391304
"064130308","BUENOS AIRES",217,181,8,24,0,32,0.834101382488479
"064130403","BUENOS AIRES",324,321,3,0,0,3,0.990740740740741
"064130404","BUENOS AIRES",403,393,1,9,0,10,0.975186104218362
"064130408","BUENOS AIRES",439,435,2,2,0,4,0.990888382687927
"064130504","BUENOS AIRES",318,317,1,0,0,1,0.99685534591195
"064130507","BUENOS AIRES",384,381,2,1,0,3,0.9921875
"064130508","BUENOS AIRES",271,271,0,0,0,0,1
"064130510","BUENOS AIRES",210,195,4,10,0,14,0.928571428571429
"064130512","BUENOS AIRES",339,330,5,2,0,7,0.973451327433628
"064130604","BUENOS AIRES",373,361,4,7,0,11,0.967828418230563
"064130607","BUENOS AIRES",378,344,3,3,0,6,0.91005291005291
"064130608","BUENOS AIRES",250,245,1,3,0,4,0.98
"064130612","BUENOS AIRES",246,222,4,17,1,22,0.902439024390244
"064130704","BUENOS AIRES",32,25,0,7,0,7,0.78125
"064131309","BUENOS AIRES",217,137,22,55,0,77,0.631336405529954
"064131405","BUENOS AIRES",1,0,1,0,0,1,0
"064200302","BUENOS AIRES",78,73,5,0,0,5,0.935897435897436
"064131904","BUENOS AIRES",46,0,37,9,0,46,0
"064132105","BUENOS AIRES",287,280,3,4,0,7,0.975609756097561
"064132201","BUENOS AIRES",118,2,45,66,0,111,0.0169491525423729
"064200107","BUENOS AIRES",59,56,2,1,0,3,0.949152542372881
"064200111","BUENOS AIRES",121,119,0,2,0,2,0.983471074380165
"064201812","BUENOS AIRES",174,161,3,9,1,13,0.925287356321839
"065151704","BUENOS AIRES",173,1,146,26,0,172,0.00578034682080925
"064200113","BUENOS AIRES",63,60,2,1,0,3,0.952380952380952
"064200116","BUENOS AIRES",171,161,7,3,0,10,0.941520467836257
"064200301","BUENOS AIRES",76,69,5,2,0,7,0.907894736842105
"064200313","BUENOS AIRES",40,0,24,16,0,40,0
"064201213","BUENOS AIRES",49,1,25,23,0,48,0.0204081632653061
"064201214","BUENOS AIRES",110,49,40,19,0,59,0.445454545454545
"064201310","BUENOS AIRES",77,54,16,7,0,23,0.701298701298701
"064201410","BUENOS AIRES",25,22,3,0,0,3,0.88
"064200401","BUENOS AIRES",53,45,6,2,0,8,0.849056603773585
"064200412","BUENOS AIRES",103,2,63,38,0,101,0.0194174757281553
"064270110","BUENOS AIRES",307,300,0,6,1,7,0.977198697068404
"065250415","BUENOS AIRES",263,121,32,104,3,139,0.460076045627376
"064200605","BUENOS AIRES",50,47,1,1,0,2,0.94
"064200608","BUENOS AIRES",77,75,2,0,0,2,0.974025974025974
"064200609","BUENOS AIRES",66,64,2,0,0,2,0.96969696969697
"064200701","BUENOS AIRES",55,52,2,1,0,3,0.945454545454545
"064200902","BUENOS AIRES",163,11,93,54,0,147,0.0674846625766871
"064200907","BUENOS AIRES",86,76,7,3,0,10,0.883720930232558
"064201005","BUENOS AIRES",122,38,51,28,1,80,0.311475409836066
"064201108","BUENOS AIRES",39,33,6,0,0,6,0.846153846153846
"064201904","BUENOS AIRES",133,125,7,1,0,8,0.93984962406015
"064201908","BUENOS AIRES",79,78,0,1,0,1,0.987341772151899
"065321509","BUENOS AIRES",363,70,132,160,0,292,0.192837465564738
"064202211","BUENOS AIRES",59,1,23,33,1,57,0.0169491525423729
"064202213","BUENOS AIRES",64,0,37,27,0,64,0
"064270509","BUENOS AIRES",240,209,3,0,0,3,0.870833333333333
"064270601","BUENOS AIRES",346,333,11,2,0,13,0.96242774566474
"064270609","BUENOS AIRES",386,368,12,3,0,15,0.953367875647668
"064270709","BUENOS AIRES",326,324,1,0,0,1,0.993865030674847
"064271102","BUENOS AIRES",377,363,4,1,0,5,0.962864721485411
"064271203","BUENOS AIRES",174,172,1,1,0,2,0.988505747126437
"064271209","BUENOS AIRES",240,236,1,1,0,2,0.983333333333333
"064271403","BUENOS AIRES",318,265,32,17,1,50,0.833333333333333
"064271412","BUENOS AIRES",219,206,6,4,0,10,0.940639269406393
"064271514","BUENOS AIRES",324,309,7,6,0,13,0.953703703703704
"064271609","BUENOS AIRES",386,379,2,1,0,3,0.981865284974093
"064271704","BUENOS AIRES",246,239,2,1,0,3,0.971544715447154
"065392204","BUENOS AIRES",373,11,268,93,0,361,0.0294906166219839
"064272311","BUENOS AIRES",589,574,8,3,0,11,0.974533106960951
"064272403","BUENOS AIRES",411,327,32,38,3,73,0.795620437956204
"064272503","BUENOS AIRES",391,385,5,1,0,6,0.9846547314578
"064272505","BUENOS AIRES",511,392,61,40,3,104,0.767123287671233
"064272508","BUENOS AIRES",153,153,0,0,0,0,1
"064272509","BUENOS AIRES",387,376,1,9,0,10,0.971576227390181
"064272602","BUENOS AIRES",310,298,7,3,0,10,0.961290322580645
"020051202","CABA",840,834,3,0,0,3,0.992857142857143
"064272607","BUENOS AIRES",511,374,88,45,0,133,0.731898238747554
"064272609","BUENOS AIRES",381,375,5,1,0,6,0.984251968503937
"064272610","BUENOS AIRES",361,359,0,2,0,2,0.994459833795014
"064272702","BUENOS AIRES",195,195,0,0,0,0,1
"064272707","BUENOS AIRES",412,401,10,1,0,11,0.973300970873786
"064272807","BUENOS AIRES",395,370,15,7,0,22,0.936708860759494
"064272808","BUENOS AIRES",305,283,18,4,0,22,0.927868852459016
"064272910","BUENOS AIRES",215,202,3,9,0,12,0.93953488372093
"064272912","BUENOS AIRES",432,410,14,7,0,21,0.949074074074074
"064273003","BUENOS AIRES",281,210,31,22,1,54,0.747330960854093
"064273105","BUENOS AIRES",429,421,8,0,0,8,0.981351981351981
"064273206","BUENOS AIRES",287,282,3,2,0,5,0.982578397212544
"064273301","BUENOS AIRES",242,124,1,7,0,8,0.512396694214876
"064273304","BUENOS AIRES",150,146,2,2,0,4,0.973333333333333
"064273408","BUENOS AIRES",336,330,3,3,0,6,0.982142857142857
"064273414","BUENOS AIRES",308,305,2,1,0,3,0.99025974025974
"064273502","BUENOS AIRES",238,235,1,2,0,3,0.987394957983193
"064273505","BUENOS AIRES",326,313,6,6,1,13,0.960122699386503
"020151410","CABA",272,271,0,0,0,0,0.996323529411765
"064273701","BUENOS AIRES",188,171,8,8,0,16,0.909574468085106
"064273706","BUENOS AIRES",598,556,17,20,0,37,0.929765886287625
"064273708","BUENOS AIRES",375,335,13,20,0,33,0.893333333333333
"064273801","BUENOS AIRES",363,351,9,1,0,10,0.966942148760331
"064273807","BUENOS AIRES",422,406,6,8,0,14,0.962085308056872
"064273905","BUENOS AIRES",397,374,12,7,0,19,0.942065491183879
"064274004","BUENOS AIRES",446,336,54,48,1,103,0.753363228699552
"064274009","BUENOS AIRES",215,213,0,1,0,1,0.990697674418605
"064274012","BUENOS AIRES",237,225,7,3,0,10,0.949367088607595
"064274102","BUENOS AIRES",659,474,81,79,0,160,0.719271623672231
"064274110","BUENOS AIRES",323,38,49,226,0,275,0.117647058823529
"064274202","BUENOS AIRES",476,466,3,4,0,7,0.978991596638655
"064274203","BUENOS AIRES",604,595,2,2,1,5,0.985099337748344
"064274204","BUENOS AIRES",584,566,9,4,0,13,0.969178082191781
"064274307","BUENOS AIRES",382,374,5,0,0,5,0.979057591623037
"064274410","BUENOS AIRES",310,294,10,5,0,15,0.948387096774194
"064274502","BUENOS AIRES",373,361,8,3,1,12,0.967828418230563
"064274511","BUENOS AIRES",364,332,23,9,0,32,0.912087912087912
"064274701","BUENOS AIRES",301,186,75,39,0,114,0.617940199335548
"064274707","BUENOS AIRES",222,37,95,80,1,176,0.166666666666667
"064274711","BUENOS AIRES",295,274,8,10,0,18,0.928813559322034
"064274803","BUENOS AIRES",473,307,89,66,1,156,0.649048625792812
"064274804","BUENOS AIRES",379,286,32,58,0,90,0.754617414248021
"064274909","BUENOS AIRES",537,62,183,269,3,455,0.115456238361266
"064275004","BUENOS AIRES",412,400,6,2,0,8,0.970873786407767
"064275011","BUENOS AIRES",399,375,13,9,1,23,0.93984962406015
"064275104","BUENOS AIRES",314,274,19,21,0,40,0.872611464968153
"064275210","BUENOS AIRES",297,16,122,138,2,262,0.0538720538720539
"064275402","BUENOS AIRES",560,506,16,33,0,49,0.903571428571429
"064275404","BUENOS AIRES",305,287,10,5,0,15,0.940983606557377
"064275407","BUENOS AIRES",415,383,16,6,0,22,0.92289156626506
"064278306","BUENOS AIRES",401,2,145,234,3,382,0.00498753117206983
"064275409","BUENOS AIRES",467,427,11,13,0,24,0.914346895074946
"064275506","BUENOS AIRES",461,427,20,7,0,27,0.926247288503254
"064275509","BUENOS AIRES",310,290,8,7,0,15,0.935483870967742
"064275603","BUENOS AIRES",1157,911,202,37,0,239,0.787381158167675
"064275606","BUENOS AIRES",488,414,41,26,1,68,0.848360655737705
"064275611","BUENOS AIRES",373,364,4,4,0,8,0.975871313672922
"064275612","BUENOS AIRES",433,325,81,25,0,106,0.750577367205543
"064275706","BUENOS AIRES",433,26,257,144,0,401,0.0600461893764434
"064275707","BUENOS AIRES",452,9,313,121,0,434,0.0199115044247788
"064275802","BUENOS AIRES",434,19,239,170,0,409,0.043778801843318
"064275901","BUENOS AIRES",543,10,350,171,3,524,0.0184162062615101
"064342607","BUENOS AIRES",186,2,62,108,0,170,0.010752688172043
"064276007","BUENOS AIRES",518,26,339,139,0,478,0.0501930501930502
"064276014","BUENOS AIRES",258,5,191,61,0,252,0.0193798449612403
"064276111","BUENOS AIRES",301,0,212,71,0,283,0
"064276114","BUENOS AIRES",387,3,247,133,0,380,0.00775193798449612
"064276202","BUENOS AIRES",425,300,76,39,1,116,0.705882352941177
"064276307","BUENOS AIRES",364,36,192,130,0,322,0.0989010989010989
"064276309","BUENOS AIRES",551,20,413,107,1,521,0.0362976406533575
"064276504","BUENOS AIRES",529,21,248,181,2,431,0.0396975425330813
"064276610","BUENOS AIRES",346,9,237,88,0,325,0.0260115606936416
"064276709","BUENOS AIRES",282,4,171,92,1,264,0.0141843971631206
"064276713","BUENOS AIRES",306,8,158,131,1,290,0.0261437908496732
"064276714","BUENOS AIRES",279,11,83,157,5,245,0.039426523297491
"064276805","BUENOS AIRES",267,5,248,13,0,261,0.0187265917602996
"064276902","BUENOS AIRES",370,10,295,62,0,357,0.027027027027027
"064276904","BUENOS AIRES",379,3,301,68,2,371,0.0079155672823219
"064276905","BUENOS AIRES",654,9,492,145,4,641,0.0137614678899083
"064276913","BUENOS AIRES",459,7,337,108,0,445,0.0152505446623094
"064277013","BUENOS AIRES",256,2,194,53,0,247,0.0078125
"064277112","BUENOS AIRES",494,5,298,182,0,480,0.0101214574898785
"064277202","BUENOS AIRES",279,1,190,84,1,275,0.003584229390681
"020110912","CABA",297,297,0,0,0,0,1
"064277302","BUENOS AIRES",507,9,312,165,2,479,0.0177514792899408
"064277305","BUENOS AIRES",397,5,190,185,0,375,0.0125944584382872
"064277409","BUENOS AIRES",276,8,159,98,1,258,0.0289855072463768
"064277418","BUENOS AIRES",1043,42,473,475,12,960,0.0402684563758389
"064277617","BUENOS AIRES",276,1,154,114,0,268,0.0036231884057971
"064277711","BUENOS AIRES",355,1,228,112,1,341,0.0028169014084507
"064277803","BUENOS AIRES",416,12,265,124,1,390,0.0288461538461538
"064277804","BUENOS AIRES",342,7,214,95,1,310,0.0204678362573099
"064279014","BUENOS AIRES",333,8,143,156,3,302,0.024024024024024
"065680501","BUENOS AIRES",300,299,1,0,0,1,0.996666666666667
"064278003","BUENOS AIRES",465,4,117,306,13,436,0.00860215053763441
"064278005","BUENOS AIRES",411,10,220,170,0,390,0.024330900243309
"064278006","BUENOS AIRES",470,2,164,270,3,437,0.00425531914893617
"064278212","BUENOS AIRES",301,10,207,73,3,283,0.0332225913621262
"064278305","BUENOS AIRES",506,21,265,189,7,461,0.041501976284585
"064343403","BUENOS AIRES",283,16,83,183,0,266,0.0565371024734982
"064278411","BUENOS AIRES",454,19,169,255,0,424,0.0418502202643172
"064278414","BUENOS AIRES",243,1,29,189,14,232,0.00411522633744856
"064278507","BUENOS AIRES",431,4,280,130,1,411,0.00928074245939675
"064278606","BUENOS AIRES",309,7,233,62,1,296,0.0226537216828479
"064278614","BUENOS AIRES",374,3,283,77,0,360,0.00802139037433155
"064278808","BUENOS AIRES",440,16,263,149,1,413,0.0363636363636364
"064278809","BUENOS AIRES",427,7,266,145,0,411,0.0163934426229508
"064279116","BUENOS AIRES",87,1,63,23,0,86,0.0114942528735632
"065680707","BUENOS AIRES",302,67,231,4,0,235,0.221854304635762
"065151710","BUENOS AIRES",334,1,218,69,1,288,0.0029940119760479
"064340310","BUENOS AIRES",326,230,60,34,0,94,0.705521472392638
"020151406","CABA",286,286,0,0,0,0,1
"064279404","BUENOS AIRES",470,3,327,129,1,457,0.00638297872340425
"064279408","BUENOS AIRES",310,11,101,177,5,283,0.0354838709677419
"064279504","BUENOS AIRES",575,25,230,291,3,524,0.0434782608695652
"064279507","BUENOS AIRES",940,20,469,371,5,845,0.0212765957446809
"064279512","BUENOS AIRES",566,16,305,218,0,523,0.0282685512367491
"064279609","BUENOS AIRES",514,5,351,141,1,493,0.00972762645914397
"064341108","BUENOS AIRES",220,35,87,97,0,184,0.159090909090909
"064279710","BUENOS AIRES",225,0,130,81,4,215,0
"065151810","BUENOS AIRES",319,4,109,189,2,300,0.0125391849529781
"064279720","BUENOS AIRES",358,2,160,179,1,340,0.00558659217877095
"064279721","BUENOS AIRES",328,0,64,225,5,294,0
"064340106","BUENOS AIRES",380,326,20,27,1,48,0.857894736842105
"064340206","BUENOS AIRES",294,278,9,7,0,16,0.945578231292517
"064341809","BUENOS AIRES",198,198,0,0,0,0,1
"064340403","BUENOS AIRES",293,275,12,6,0,18,0.938566552901024
"064340409","BUENOS AIRES",200,178,10,11,0,21,0.89
"064340507","BUENOS AIRES",355,300,24,31,0,55,0.845070422535211
"064340603","BUENOS AIRES",335,249,26,59,0,85,0.743283582089552
"064340816","BUENOS AIRES",404,10,180,207,0,387,0.0247524752475248
"064340917","BUENOS AIRES",211,9,64,136,0,200,0.042654028436019
"064341008","BUENOS AIRES",366,11,148,207,0,355,0.0300546448087432
"064341009","BUENOS AIRES",350,9,115,225,0,340,0.0257142857142857
"064341105","BUENOS AIRES",249,137,43,65,0,108,0.550200803212851
"064341113","BUENOS AIRES",370,17,195,156,1,352,0.0459459459459459
"064341203","BUENOS AIRES",342,117,105,120,0,225,0.342105263157895
"064341305","BUENOS AIRES",367,259,57,49,0,106,0.705722070844687
"064341306","BUENOS AIRES",278,90,51,136,0,187,0.323741007194245
"064341514","BUENOS AIRES",244,152,64,28,0,92,0.622950819672131
"064341601","BUENOS AIRES",317,270,21,26,0,47,0.851735015772871
"064341603","BUENOS AIRES",300,283,12,5,0,17,0.943333333333333
"064341607","BUENOS AIRES",254,246,3,2,0,5,0.968503937007874
"064341708","BUENOS AIRES",270,171,50,49,0,99,0.633333333333333
"064341710","BUENOS AIRES",131,73,55,2,0,57,0.557251908396947
"064341909","BUENOS AIRES",279,226,42,11,0,53,0.810035842293907
"064342010","BUENOS AIRES",295,164,100,31,0,131,0.555932203389831
"064342408","BUENOS AIRES",401,101,134,158,0,292,0.251870324189526
"064342301","BUENOS AIRES",371,54,160,147,6,313,0.1455525606469
"064342302","BUENOS AIRES",284,37,79,157,2,238,0.130281690140845
"064342304","BUENOS AIRES",438,102,147,182,2,331,0.232876712328767
"064342305","BUENOS AIRES",394,153,70,153,2,225,0.388324873096447
"064342313","BUENOS AIRES",14,0,5,8,0,13,0
"065810711","BUENOS AIRES",173,1,107,63,2,172,0.00578034682080925
"064342618","BUENOS AIRES",342,21,87,224,1,312,0.0614035087719298
"064342619","BUENOS AIRES",368,22,130,193,0,323,0.0597826086956522
"064342701","BUENOS AIRES",295,24,197,74,0,271,0.0813559322033898
"064342801","BUENOS AIRES",362,16,203,139,2,344,0.0441988950276243
"064343101","BUENOS AIRES",367,271,44,50,1,95,0.73841961852861
"064343209","BUENOS AIRES",349,57,97,194,0,291,0.163323782234957
"064343210","BUENOS AIRES",334,136,124,74,0,198,0.407185628742515
"064343211","BUENOS AIRES",248,146,52,50,0,102,0.588709677419355
"064343402","BUENOS AIRES",376,18,170,184,0,354,0.0478723404255319
"064343412","BUENOS AIRES",492,15,230,239,0,469,0.0304878048780488
"064343507","BUENOS AIRES",265,14,78,173,0,251,0.0528301886792453
"064343705","BUENOS AIRES",320,303,9,7,0,16,0.946875
"064343707","BUENOS AIRES",295,221,39,35,0,74,0.749152542372881
"064343802","BUENOS AIRES",308,285,12,9,0,21,0.925324675324675
"064343805","BUENOS AIRES",267,251,8,8,0,16,0.940074906367041
"064343808","BUENOS AIRES",334,325,5,3,0,8,0.973053892215569
"064343901","BUENOS AIRES",271,86,113,72,0,185,0.317343173431734
"064344004","BUENOS AIRES",158,88,20,49,0,69,0.556962025316456
"064344107","BUENOS AIRES",178,12,86,80,0,166,0.0674157303370786
"064344201","BUENOS AIRES",330,36,101,192,1,294,0.109090909090909
"020112008","CABA",191,191,0,0,0,0,1
"064344202","BUENOS AIRES",343,30,123,165,1,289,0.0874635568513119
"064344206","BUENOS AIRES",273,39,98,133,0,231,0.142857142857143
"065811710","BUENOS AIRES",179,175,4,0,0,4,0.977653631284916
"064344403","BUENOS AIRES",271,29,99,141,0,240,0.107011070110701
"064344405","BUENOS AIRES",297,209,15,61,0,76,0.703703703703704
"064344507","BUENOS AIRES",310,3,91,201,0,292,0.00967741935483871
"065880108","BUENOS AIRES",230,193,14,23,0,37,0.839130434782609
"064410110","BUENOS AIRES",340,340,0,0,0,0,1
"064410111","BUENOS AIRES",195,193,0,1,0,1,0.98974358974359
"064410206","BUENOS AIRES",305,305,0,0,0,0,1
"020060908","CABA",196,196,0,0,0,0,1
"064410207","BUENOS AIRES",412,412,0,0,0,0,1
"064410210","BUENOS AIRES",382,377,0,5,0,5,0.986910994764398
"064410301","BUENOS AIRES",214,212,1,1,0,2,0.990654205607477
"064410307","BUENOS AIRES",365,365,0,0,0,0,1
"064410413","BUENOS AIRES",208,206,0,1,0,1,0.990384615384615
"064410505","BUENOS AIRES",176,176,0,0,0,0,1
"064410508","BUENOS AIRES",210,210,0,0,0,0,1
"064410801","BUENOS AIRES",316,316,0,0,0,0,1
"064410802","BUENOS AIRES",256,256,0,0,0,0,1
"064410906","BUENOS AIRES",266,266,0,0,0,0,1
"064410907","BUENOS AIRES",247,245,1,0,0,1,0.991902834008097
"064411005","BUENOS AIRES",179,178,1,0,0,1,0.994413407821229
"064411006","BUENOS AIRES",312,308,4,0,0,4,0.987179487179487
"064411102","BUENOS AIRES",275,274,0,0,0,0,0.996363636363636
"064411111","BUENOS AIRES",298,297,1,0,0,1,0.996644295302013
"064411204","BUENOS AIRES",217,215,2,0,0,2,0.990783410138249
"064411205","BUENOS AIRES",308,307,1,0,0,1,0.996753246753247
"064411404","BUENOS AIRES",262,262,0,0,0,0,1
"064411511","BUENOS AIRES",247,246,1,0,0,1,0.995951417004049
"064412115","BUENOS AIRES",350,350,0,0,0,0,1
"064412306","BUENOS AIRES",227,224,2,1,0,3,0.986784140969163
"064412613","BUENOS AIRES",216,215,1,0,0,1,0.99537037037037
"064412801","BUENOS AIRES",232,232,0,0,0,0,1
"064412805","BUENOS AIRES",213,212,1,0,0,1,0.995305164319249
"065151812","BUENOS AIRES",402,4,170,197,2,369,0.00995024875621891
"064412908","BUENOS AIRES",191,191,0,0,0,0,1
"064412909","BUENOS AIRES",303,303,0,0,0,0,1
"064413001","BUENOS AIRES",316,75,133,102,1,236,0.237341772151899
"020031003","CABA",257,257,0,0,0,0,1
"064413004","BUENOS AIRES",367,355,6,6,0,12,0.967302452316076
"064413102","BUENOS AIRES",231,209,7,13,0,20,0.904761904761905
"064413211","BUENOS AIRES",379,283,43,52,0,95,0.746701846965699
"064413304","BUENOS AIRES",223,215,6,2,0,8,0.964125560538117
"064413306","BUENOS AIRES",433,394,20,15,0,35,0.909930715935335
"064413310","BUENOS AIRES",314,310,3,1,0,4,0.987261146496815
"064413403","BUENOS AIRES",379,340,17,9,1,27,0.897097625329815
"064413408","BUENOS AIRES",358,348,6,2,0,8,0.972067039106145
"064413412","BUENOS AIRES",165,161,2,1,1,4,0.975757575757576
"064900803","BUENOS AIRES",408,380,17,11,0,28,0.931372549019608
"064413505","BUENOS AIRES",377,371,1,5,0,6,0.984084880636605
"064413513","BUENOS AIRES",369,366,1,1,0,2,0.991869918699187
"064413608","BUENOS AIRES",264,234,21,9,0,30,0.886363636363636
"064413701","BUENOS AIRES",338,42,151,139,1,291,0.124260355029586
"064413704","BUENOS AIRES",209,2,44,147,5,196,0.00956937799043062
"064413904","BUENOS AIRES",268,253,11,1,0,12,0.944029850746269
"064415007","BUENOS AIRES",179,179,0,0,0,0,1
"064413907","BUENOS AIRES",238,225,7,5,0,12,0.945378151260504
"064414013","BUENOS AIRES",431,369,20,30,3,53,0.85614849187935
"064414102","BUENOS AIRES",336,6,90,225,2,317,0.0178571428571429
"066021404","BUENOS AIRES",41,0,36,5,0,41,0
"064414107","BUENOS AIRES",293,258,19,8,0,27,0.880546075085324
"064414108","BUENOS AIRES",446,342,51,43,0,94,0.766816143497758
"064414110","BUENOS AIRES",288,54,83,133,2,218,0.1875
"064414204","BUENOS AIRES",341,3,176,142,3,321,0.00879765395894428
"064414406","BUENOS AIRES",294,101,115,74,1,190,0.343537414965986
"064414502","BUENOS AIRES",264,8,181,73,1,255,0.0303030303030303
"064414504","BUENOS AIRES",347,10,175,153,1,329,0.0288184438040346
"064414602","BUENOS AIRES",355,3,175,167,3,345,0.00845070422535211
"064414804","BUENOS AIRES",417,414,2,0,0,2,0.992805755395683
"064414806","BUENOS AIRES",283,178,28,67,0,95,0.628975265017668
"064414910","BUENOS AIRES",201,201,0,0,0,0,1
"064415105","BUENOS AIRES",402,363,22,10,0,32,0.902985074626866
"064415206","BUENOS AIRES",171,167,4,0,0,4,0.976608187134503
"064415414","BUENOS AIRES",245,3,159,81,0,240,0.0122448979591837
"064415418","BUENOS AIRES",318,310,7,0,0,7,0.974842767295597
"064415506","BUENOS AIRES",335,313,13,9,0,22,0.934328358208955
"066230205","BUENOS AIRES",232,227,1,4,0,5,0.978448275862069
"064415706","BUENOS AIRES",410,103,247,59,0,306,0.251219512195122
"064415802","BUENOS AIRES",243,239,2,0,0,2,0.983539094650206
"064416006","BUENOS AIRES",247,151,68,28,0,96,0.611336032388664
"064900903","BUENOS AIRES",205,167,17,21,0,38,0.814634146341463
"064416007","BUENOS AIRES",290,12,172,102,1,275,0.0413793103448276
"064416107","BUENOS AIRES",264,6,149,106,2,257,0.0227272727272727
"064902809","BUENOS AIRES",189,10,95,83,0,178,0.0529100529100529
"064416203","BUENOS AIRES",228,214,7,5,0,12,0.93859649122807
"064416401","BUENOS AIRES",402,2,280,116,1,397,0.00497512437810945
"064416402","BUENOS AIRES",140,0,104,30,0,134,0
"064416414","BUENOS AIRES",164,0,132,31,1,164,0
"066300203","BUENOS AIRES",173,110,26,37,0,63,0.635838150289017
"064416606","BUENOS AIRES",261,9,107,136,0,243,0.0344827586206897
"064416618","BUENOS AIRES",293,4,176,104,0,280,0.0136518771331058
"064416905","BUENOS AIRES",310,12,134,154,2,290,0.0387096774193548
"064416912","BUENOS AIRES",115,1,72,25,0,97,0.00869565217391304
"064901205","BUENOS AIRES",198,194,2,1,0,3,0.97979797979798
"064417003","BUENOS AIRES",224,3,166,52,1,219,0.0133928571428571
"064417005","BUENOS AIRES",346,7,169,157,1,327,0.0202312138728324
"064480606","BUENOS AIRES",333,181,38,110,4,152,0.543543543543544
"020060305","CABA",260,258,2,0,0,2,0.992307692307692
"064550103","BUENOS AIRES",251,243,3,4,0,7,0.968127490039841
"064550112","BUENOS AIRES",186,43,67,74,2,143,0.231182795698925
"064550115","BUENOS AIRES",154,96,26,31,0,57,0.623376623376623
"065151905","BUENOS AIRES",300,0,137,145,1,283,0
"064551402","BUENOS AIRES",427,156,68,200,0,268,0.365339578454333
"064620702","BUENOS AIRES",292,228,41,19,1,61,0.780821917808219
"064620704","BUENOS AIRES",302,178,32,86,1,119,0.589403973509934
"064690201","BUENOS AIRES",280,278,2,0,0,2,0.992857142857143
"064690202","BUENOS AIRES",345,286,30,29,0,59,0.828985507246377
"064690210","BUENOS AIRES",279,124,26,125,0,151,0.444444444444444
"064901008","BUENOS AIRES",292,289,3,0,0,3,0.98972602739726
"064901014","BUENOS AIRES",243,243,0,0,0,0,1
"066381806","BUENOS AIRES",341,0,174,154,4,332,0
"020031106","CABA",415,415,0,0,0,0,1
"066382006","BUENOS AIRES",173,3,78,87,2,167,0.0173410404624277
"064691507","BUENOS AIRES",68,1,32,35,0,67,0.0147058823529412
"064691508","BUENOS AIRES",274,0,182,88,3,273,0
"064760107","BUENOS AIRES",265,253,4,5,2,11,0.954716981132075
"064761406","BUENOS AIRES",208,198,6,4,0,10,0.951923076923077
"064830105","BUENOS AIRES",277,272,5,0,0,5,0.981949458483754
"064830111","BUENOS AIRES",257,17,196,44,0,240,0.066147859922179
"064830113","BUENOS AIRES",243,14,155,69,0,224,0.0576131687242798
"064830116","BUENOS AIRES",224,4,129,88,1,218,0.0178571428571429
"064830408","BUENOS AIRES",259,44,151,63,1,215,0.16988416988417
"064830411","BUENOS AIRES",201,19,122,60,0,182,0.0945273631840796
"064830908","BUENOS AIRES",85,1,51,32,0,83,0.0117647058823529
"064901109","BUENOS AIRES",210,208,1,1,0,2,0.990476190476191
"064901118","BUENOS AIRES",252,247,2,3,0,5,0.98015873015873
"064901302","BUENOS AIRES",350,243,61,46,0,107,0.694285714285714
"064902803","BUENOS AIRES",407,12,260,133,1,394,0.0294840294840295
"064900101","BUENOS AIRES",196,25,50,121,0,171,0.127551020408163
"064900113","BUENOS AIRES",147,13,34,96,0,130,0.0884353741496599
"064900205","BUENOS AIRES",372,6,136,218,3,357,0.0161290322580645
"064900206","BUENOS AIRES",376,5,223,145,0,368,0.0132978723404255
"064900308","BUENOS AIRES",236,7,118,108,0,226,0.0296610169491525
"064900508","BUENOS AIRES",427,43,183,195,0,378,0.100702576112412
"064900405","BUENOS AIRES",344,68,79,176,3,258,0.197674418604651
"064900408","BUENOS AIRES",345,99,73,137,6,216,0.28695652173913
"064900504","BUENOS AIRES",242,10,136,92,0,228,0.0413223140495868
"064900601","BUENOS AIRES",252,210,22,18,0,40,0.833333333333333
"064900609","BUENOS AIRES",246,17,99,129,0,228,0.0691056910569106
"064900710","BUENOS AIRES",308,15,186,78,0,264,0.0487012987012987
"064900714","BUENOS AIRES",262,13,131,115,1,247,0.049618320610687
"066580204","BUENOS AIRES",290,11,46,187,24,257,0.0379310344827586
"064901411","BUENOS AIRES",319,12,157,148,1,306,0.0376175548589342
"064901506","BUENOS AIRES",169,6,15,147,0,162,0.0355029585798817
"064901608","BUENOS AIRES",318,8,185,125,0,310,0.0251572327044025
"064901609","BUENOS AIRES",355,11,287,57,0,344,0.0309859154929577
"064901702","BUENOS AIRES",353,16,115,199,0,314,0.0453257790368272
"064901809","BUENOS AIRES",354,136,126,87,0,213,0.384180790960452
"064901814","BUENOS AIRES",432,12,198,213,0,411,0.0277777777777778
"064902402","BUENOS AIRES",345,341,2,2,0,4,0.988405797101449
"064902404","BUENOS AIRES",379,375,4,0,0,4,0.989445910290237
"064902405","BUENOS AIRES",281,279,1,0,0,1,0.99288256227758
"064902606","BUENOS AIRES",327,229,75,23,0,98,0.700305810397553
"066581011","BUENOS AIRES",353,306,10,27,1,38,0.86685552407932
"064902610","BUENOS AIRES",378,326,39,12,0,51,0.862433862433862
"064902704","BUENOS AIRES",262,18,159,85,0,244,0.0687022900763359
"064902709","BUENOS AIRES",300,7,256,37,0,293,0.0233333333333333
"064902712","BUENOS AIRES",419,24,146,235,5,386,0.0572792362768496
"064902902","BUENOS AIRES",481,17,327,131,0,458,0.0353430353430353
"064902907","BUENOS AIRES",424,15,134,262,1,397,0.035377358490566
"064903001","BUENOS AIRES",268,1,84,178,0,262,0.00373134328358209
"064903102","BUENOS AIRES",280,9,107,159,2,268,0.0321428571428571
"064903104","BUENOS AIRES",392,3,160,216,1,377,0.0076530612244898
"064903404","BUENOS AIRES",364,11,80,224,3,307,0.0302197802197802
"064903705","BUENOS AIRES",291,2,121,139,2,262,0.00687285223367698
"064903709","BUENOS AIRES",544,9,207,303,0,510,0.0165441176470588
"064903807","BUENOS AIRES",350,4,90,245,4,339,0.0114285714285714
"064903815","BUENOS AIRES",228,11,84,129,0,213,0.0482456140350877
"064903817","BUENOS AIRES",520,13,129,342,8,479,0.025
"064903901","BUENOS AIRES",388,10,77,266,1,344,0.0257731958762887
"064903903","BUENOS AIRES",898,10,128,681,11,820,0.0111358574610245
"064904711","BUENOS AIRES",306,0,248,58,0,306,0
"064904806","BUENOS AIRES",143,139,3,1,0,4,0.972027972027972
"064903904","BUENOS AIRES",408,8,53,332,2,387,0.0196078431372549
"064903905","BUENOS AIRES",473,6,94,280,40,414,0.0126849894291755
"064903907","BUENOS AIRES",212,4,31,159,0,190,0.0188679245283019
"064904004","BUENOS AIRES",469,20,67,359,4,430,0.0426439232409382
"066582514","BUENOS AIRES",141,131,8,2,0,10,0.929078014184397
"064904405","BUENOS AIRES",411,15,201,192,0,393,0.0364963503649635
"064904501","BUENOS AIRES",264,18,139,101,1,241,0.0681818181818182
"064904503","BUENOS AIRES",325,3,117,204,0,321,0.00923076923076923
"064904508","BUENOS AIRES",231,14,150,67,0,217,0.0606060606060606
"064904607","BUENOS AIRES",304,276,16,12,0,28,0.907894736842105
"064904610","BUENOS AIRES",25,19,1,5,0,6,0.76
"064904704","BUENOS AIRES",230,7,116,78,0,194,0.0304347826086957
"064904707","BUENOS AIRES",346,52,188,106,0,294,0.15028901734104
"064904708","BUENOS AIRES",292,1,176,114,1,291,0.00342465753424658
"065391215","BUENOS AIRES",291,2,197,89,0,286,0.00687285223367698
"065391412","BUENOS AIRES",271,4,197,67,1,265,0.014760147601476
"065391413","BUENOS AIRES",272,0,178,87,1,266,0
"065391416","BUENOS AIRES",265,1,175,82,0,257,0.00377358490566038
"065391501","BUENOS AIRES",233,232,1,0,0,1,0.995708154506438
"060700304","BUENOS AIRES",78,0,31,46,1,78,0
"061680103","BUENOS AIRES",12,0,4,7,1,12,0
"061680406","BUENOS AIRES",2,0,0,2,0,2,0
"060070206","BUENOS AIRES",15,7,4,4,0,8,0.466666666666667
"060070507","BUENOS AIRES",4,0,1,3,0,4,0
"060070514","BUENOS AIRES",8,0,0,8,0,8,0
"060070604","BUENOS AIRES",1,0,1,0,0,1,0
"060070607","BUENOS AIRES",1,0,0,1,0,1,0
"060070704","BUENOS AIRES",5,0,0,5,0,5,0
"065391605","BUENOS AIRES",213,208,5,0,0,5,0.976525821596244
"060071002","BUENOS AIRES",3,0,1,2,0,3,0
"065391715","BUENOS AIRES",224,197,23,3,0,26,0.879464285714286
"065391716","BUENOS AIRES",191,175,4,9,0,13,0.916230366492147
"060071008","BUENOS AIRES",2,0,2,0,0,2,0
"060071011","BUENOS AIRES",9,0,7,2,0,9,0
"060071103","BUENOS AIRES",6,0,1,5,0,6,0
"060071106","BUENOS AIRES",3,0,3,0,0,3,0
"060071108","BUENOS AIRES",6,0,3,3,0,6,0
"060071110","BUENOS AIRES",6,0,4,2,0,6,0
"060071111","BUENOS AIRES",6,0,5,1,0,6,0
"060140201","BUENOS AIRES",11,0,2,8,1,11,0
"060140901","BUENOS AIRES",15,0,11,4,0,15,0
"061890203","BUENOS AIRES",3,0,0,3,0,3,0
"060210102","BUENOS AIRES",6,0,2,4,0,6,0
"060210402","BUENOS AIRES",6,0,5,1,0,6,0
"065600801","BUENOS AIRES",347,5,262,78,1,341,0.0144092219020173
"060211001","BUENOS AIRES",11,0,4,7,0,11,0
"061960709","BUENOS AIRES",19,0,11,7,0,18,0
"062031304","BUENOS AIRES",12,0,2,10,0,12,0
"062240504","BUENOS AIRES",4,0,3,1,0,4,0
"060420401","BUENOS AIRES",41,0,3,38,0,41,0
"060421501","BUENOS AIRES",37,0,3,32,2,37,0
"060421801","BUENOS AIRES",18,0,1,17,0,18,0
"060491101","BUENOS AIRES",32,0,4,26,1,31,0
"060492201","BUENOS AIRES",79,1,40,31,1,72,0.0126582278481013
"060491201","BUENOS AIRES",42,0,7,35,0,42,0
"060491701","BUENOS AIRES",40,0,8,32,0,40,0
"060491901","BUENOS AIRES",56,2,24,30,0,54,0.0357142857142857
"065600716","BUENOS AIRES",538,18,204,298,5,507,0.033457249070632
"060562801","BUENOS AIRES",22,0,9,11,2,22,0
"060630303","BUENOS AIRES",48,0,19,22,2,43,0
"060630405","BUENOS AIRES",12,0,8,4,0,12,0
"060630601","BUENOS AIRES",43,1,13,29,0,42,0.0232558139534884
"060630605","BUENOS AIRES",30,1,21,8,0,29,0.0333333333333333
"060700303","BUENOS AIRES",75,1,38,36,0,74,0.0133333333333333
"060700601","BUENOS AIRES",16,0,10,6,0,16,0
"060701101","BUENOS AIRES",5,0,3,2,0,5,0
"060770201","BUENOS AIRES",22,0,14,8,0,22,0
"060770202","BUENOS AIRES",17,0,6,11,0,17,0
"060770404","BUENOS AIRES",11,0,4,7,0,11,0
"060770507","BUENOS AIRES",12,2,4,5,0,9,0.166666666666667
"060771103","BUENOS AIRES",11,0,3,8,0,11,0
"060840102","BUENOS AIRES",16,0,4,11,1,16,0
"060840202","BUENOS AIRES",13,0,2,9,2,13,0
"060841101","BUENOS AIRES",8,0,7,1,0,8,0
"061120401","BUENOS AIRES",6,0,1,5,0,6,0
"063080604","BUENOS AIRES",4,0,1,3,0,4,0
"062030503","BUENOS AIRES",10,0,3,7,0,10,0
"020031501","CABA",282,281,1,0,0,1,0.99645390070922
"060841102","BUENOS AIRES",33,0,6,27,0,33,0
"060841201","BUENOS AIRES",75,1,21,52,0,73,0.0133333333333333
"060980707","BUENOS AIRES",13,0,6,6,1,13,0
"062940503","BUENOS AIRES",5,0,0,5,0,5,0
"065391808","BUENOS AIRES",402,345,34,21,0,55,0.858208955223881
"061050601","BUENOS AIRES",65,0,27,38,0,65,0
"061050807","BUENOS AIRES",38,0,8,29,0,37,0
"061050808","BUENOS AIRES",57,0,11,45,1,57,0
"061120305","BUENOS AIRES",12,0,0,12,0,12,0
"061960704","BUENOS AIRES",6,0,0,5,1,6,0
"061120503","BUENOS AIRES",4,0,2,2,0,4,0
"061120704","BUENOS AIRES",10,0,3,6,0,9,0
"061120804","BUENOS AIRES",6,0,4,2,0,6,0
"061120904","BUENOS AIRES",14,0,10,4,0,14,0
"061121202","BUENOS AIRES",5,0,1,4,0,5,0
"061190603","BUENOS AIRES",26,0,17,9,0,26,0
"061190704","BUENOS AIRES",12,0,6,6,0,12,0
"061190903","BUENOS AIRES",17,0,4,12,0,16,0
"065391905","BUENOS AIRES",343,302,29,8,0,37,0.880466472303207
"061340113","BUENOS AIRES",33,0,17,12,0,29,0
"061340403","BUENOS AIRES",55,0,28,27,0,55,0
"061340601","BUENOS AIRES",45,0,14,30,1,45,0
"061341011","BUENOS AIRES",73,0,51,20,0,71,0
"065392004","BUENOS AIRES",287,0,198,87,0,285,0
"061400311","BUENOS AIRES",17,0,8,9,0,17,0
"061470709","BUENOS AIRES",8,0,5,2,0,7,0
"061470805","BUENOS AIRES",20,0,18,2,0,20,0
"061540405","BUENOS AIRES",17,0,11,5,0,16,0
"061540502","BUENOS AIRES",12,0,8,4,0,12,0
"061540902","BUENOS AIRES",11,0,5,6,0,11,0
"061680203","BUENOS AIRES",13,0,3,9,1,13,0
"061680302","BUENOS AIRES",3,0,1,1,0,2,0
"062030304","BUENOS AIRES",14,0,9,5,0,14,0
"061680401","BUENOS AIRES",6,0,1,5,0,6,0
"061680602","BUENOS AIRES",5,0,0,5,0,5,0
"061680701","BUENOS AIRES",10,0,3,6,0,9,0
"061750103","BUENOS AIRES",12,0,8,4,0,12,0
"061890504","BUENOS AIRES",5,0,4,1,0,5,0
"065392103","BUENOS AIRES",426,14,318,94,0,412,0.0328638497652582
"061891402","BUENOS AIRES",2,0,0,2,0,2,0
"061891405","BUENOS AIRES",4,0,3,1,0,4,0
"061891508","BUENOS AIRES",9,0,2,7,0,9,0
"065392104","BUENOS AIRES",459,10,367,81,0,448,0.0217864923747277
"065392105","BUENOS AIRES",248,1,195,49,0,244,0.00403225806451613
"061891709","BUENOS AIRES",11,0,8,3,0,11,0
"061960301","BUENOS AIRES",9,0,3,6,0,9,0
"061960306","BUENOS AIRES",10,0,8,1,1,10,0
"061960708","BUENOS AIRES",34,3,11,20,0,31,0.0882352941176471
"061961002","BUENOS AIRES",9,0,7,2,0,9,0
"061961004","BUENOS AIRES",5,0,0,5,0,5,0
"061961103","BUENOS AIRES",12,0,4,5,0,9,0
"065392205","BUENOS AIRES",418,11,354,51,0,405,0.0263157894736842
"061961204","BUENOS AIRES",2,0,2,0,0,2,0
"061961401","BUENOS AIRES",5,0,4,0,0,4,0
"061961504","BUENOS AIRES",6,0,4,2,0,6,0
"062030504","BUENOS AIRES",14,0,1,13,0,14,0
"062030707","BUENOS AIRES",4,0,2,1,0,3,0
"065392301","BUENOS AIRES",279,6,131,135,2,268,0.021505376344086
"065392302","BUENOS AIRES",360,13,230,117,0,347,0.0361111111111111
"065392307","BUENOS AIRES",289,1,143,124,3,270,0.00346020761245675
"062030711","BUENOS AIRES",5,0,3,1,1,5,0
"062030901","BUENOS AIRES",9,0,4,5,0,9,0
"062030904","BUENOS AIRES",4,0,1,3,0,4,0
"062031101","BUENOS AIRES",12,0,5,5,1,11,0
"062031106","BUENOS AIRES",3,0,1,2,0,3,0
"062031205","BUENOS AIRES",13,0,6,7,0,13,0
"062031501","BUENOS AIRES",4,0,4,0,0,4,0
"062031502","BUENOS AIRES",17,1,6,10,0,16,0.0588235294117647
"062100806","BUENOS AIRES",208,1,43,160,0,203,0.00480769230769231
"062100903","BUENOS AIRES",65,1,38,22,0,60,0.0153846153846154
"062101201","BUENOS AIRES",81,1,18,62,0,80,0.0123456790123457
"065392501","BUENOS AIRES",457,7,324,120,0,444,0.0153172866520788
"063921002","BUENOS AIRES",11,0,4,7,0,11,0
"064060308","BUENOS AIRES",37,0,28,8,0,36,0
"062240601","BUENOS AIRES",19,0,0,19,0,19,0
"020120501","CABA",212,212,0,0,0,0,1
"063990601","BUENOS AIRES",51,0,33,17,0,50,0
"020010808","CABA",189,185,3,0,0,3,0.978835978835979
"062170204","BUENOS AIRES",23,0,5,18,0,23,0
"062170401","BUENOS AIRES",146,1,71,72,1,144,0.00684931506849315
"065392403","BUENOS AIRES",251,1,204,44,0,248,0.00398406374501992
"065392412","BUENOS AIRES",258,13,182,56,0,238,0.0503875968992248
"062171008","BUENOS AIRES",21,0,12,9,0,21,0
"062310804","BUENOS AIRES",2,0,2,0,0,2,0
"062241101","BUENOS AIRES",33,0,8,25,0,33,0
"062241202","BUENOS AIRES",10,0,1,3,1,5,0
"062241503","BUENOS AIRES",10,0,0,10,0,10,0
"062241602","BUENOS AIRES",7,0,3,4,0,7,0
"062310202","BUENOS AIRES",21,0,17,4,0,21,0
"062310204","BUENOS AIRES",8,0,1,7,0,8,0
"062310402","BUENOS AIRES",7,0,0,7,0,7,0
"062310502","BUENOS AIRES",10,0,9,1,0,10,0
"062310601","BUENOS AIRES",3,0,1,2,0,3,0
"062770205","BUENOS AIRES",11,0,2,7,0,9,0
"062310802","BUENOS AIRES",2,0,0,2,0,2,0
"062310901","BUENOS AIRES",16,0,6,10,0,16,0
"065392610","BUENOS AIRES",345,6,197,136,0,333,0.0173913043478261
"062380501","BUENOS AIRES",51,1,5,44,0,49,0.0196078431372549
"062380901","BUENOS AIRES",43,0,12,30,1,43,0
"062381101","BUENOS AIRES",27,0,3,24,0,27,0
"065392614","BUENOS AIRES",259,3,115,132,4,251,0.0115830115830116
"064131602","BUENOS AIRES",0,0,0,0,0,0,NA
"062700509","BUENOS AIRES",11,1,4,6,0,10,0.0909090909090909
"065600802","BUENOS AIRES",321,7,222,84,0,306,0.0218068535825545
"020011606","CABA",228,225,3,0,0,3,0.986842105263158
"062800904","BUENOS AIRES",11,0,8,1,0,9,0
"063220501","BUENOS AIRES",10,0,5,5,0,10,0
"062700812","BUENOS AIRES",28,6,8,14,0,22,0.214285714285714
"062701105","BUENOS AIRES",13,1,5,7,0,12,0.0769230769230769
"062770203","BUENOS AIRES",29,0,14,15,0,29,0
"062940201","BUENOS AIRES",6,0,6,0,0,6,0
"064481101","BUENOS AIRES",6,0,0,5,0,5,0
"062940506","BUENOS AIRES",26,0,13,13,0,26,0
"062940706","BUENOS AIRES",0,0,0,0,0,0,NA
"062940811","BUENOS AIRES",3,0,2,1,0,3,0
"062940815","BUENOS AIRES",12,0,1,9,1,11,0
"063010301","BUENOS AIRES",44,0,9,30,0,39,0
"063080201","BUENOS AIRES",16,0,5,11,0,16,0
"065392709","BUENOS AIRES",369,15,181,165,1,347,0.040650406504065
"065881011","BUENOS AIRES",9,0,3,6,0,9,0
"063220204","BUENOS AIRES",7,0,6,1,0,7,0
"063220404","BUENOS AIRES",6,0,0,5,0,5,0
"020152109","CABA",392,392,0,0,0,0,1
"063220503","BUENOS AIRES",9,0,1,8,0,9,0
"065392710","BUENOS AIRES",316,42,175,95,0,270,0.132911392405063
"063221003","BUENOS AIRES",9,0,1,8,0,9,0
"063290203","BUENOS AIRES",30,0,10,20,0,30,0
"063290302","BUENOS AIRES",44,1,13,29,0,42,0.0227272727272727
"063290504","BUENOS AIRES",25,0,15,10,0,25,0
"063290602","BUENOS AIRES",16,0,10,6,0,16,0
"064060211","BUENOS AIRES",20,1,7,12,0,19,0.05
"063360301","BUENOS AIRES",27,4,16,6,1,23,0.148148148148148
"063850404","BUENOS AIRES",10,0,4,6,0,10,0
"063430503","BUENOS AIRES",32,0,10,22,0,32,0
"065392807","BUENOS AIRES",360,7,220,115,0,335,0.0194444444444444
"065392808","BUENOS AIRES",437,6,260,159,3,422,0.0137299771167048
"063430603","BUENOS AIRES",25,0,7,18,0,25,0
"063510611","BUENOS AIRES",9,0,5,3,0,8,0
"063510613","BUENOS AIRES",15,0,14,1,0,15,0
"063510701","BUENOS AIRES",16,0,15,1,0,16,0
"063511001","BUENOS AIRES",7,0,3,4,0,7,0
"065320105","BUENOS AIRES",295,291,1,0,0,1,0.986440677966102
"063577704","BUENOS AIRES",43,0,33,8,2,43,0
"065600804","BUENOS AIRES",294,2,220,69,0,289,0.00680272108843537
"063577806","BUENOS AIRES",52,0,22,20,1,43,0
"063920402","BUENOS AIRES",12,0,7,4,0,11,0
"063921003","BUENOS AIRES",6,0,3,3,0,6,0
"063921102","BUENOS AIRES",20,2,10,7,1,18,0.1
"063990602","BUENOS AIRES",39,0,10,27,1,38,0
"064060305","BUENOS AIRES",16,0,11,3,2,16,0
"064130904","BUENOS AIRES",0,0,0,0,0,0,NA
"064131401","BUENOS AIRES",36,0,8,26,1,35,0
"064131804","BUENOS AIRES",3,0,3,0,0,3,0
"065470701","BUENOS AIRES",16,1,3,11,0,14,0.0625
"020030302","CABA",373,373,0,0,0,0,1
"064551001","BUENOS AIRES",25,0,11,13,0,24,0
"064620202","BUENOS AIRES",12,0,6,6,0,12,0
"064620712","BUENOS AIRES",3,0,3,0,0,3,0
"064690305","BUENOS AIRES",10,0,4,6,0,10,0
"064690306","BUENOS AIRES",17,1,3,8,3,14,0.0588235294117647
"064690402","BUENOS AIRES",20,0,4,16,0,20,0
"064690405","BUENOS AIRES",12,0,7,5,0,12,0
"064690703","BUENOS AIRES",15,1,2,12,0,14,0.0666666666666667
"064691401","BUENOS AIRES",17,1,3,13,0,16,0.0588235294117647
"064970206","BUENOS AIRES",17,0,7,8,0,15,0
"065050203","BUENOS AIRES",11,0,7,4,0,11,0
"064760502","BUENOS AIRES",26,0,15,7,0,22,0
"064760503","BUENOS AIRES",16,1,13,1,0,14,0.0625
"020130601","CABA",283,282,1,0,0,1,0.996466431095406
"065600809","BUENOS AIRES",297,162,58,73,0,131,0.545454545454545
"064760706","BUENOS AIRES",6,0,0,6,0,6,0
"064760709","BUENOS AIRES",15,0,7,7,0,14,0
"064760903","BUENOS AIRES",16,0,1,12,1,14,0
"064760904","BUENOS AIRES",8,0,7,0,1,8,0
"064760905","BUENOS AIRES",7,0,5,1,0,6,0
"064761202","BUENOS AIRES",26,0,8,16,1,25,0
"064761301","BUENOS AIRES",38,0,18,20,0,38,0
"064830202","BUENOS AIRES",33,0,3,29,0,32,0
"064830304","BUENOS AIRES",53,0,18,33,0,51,0
"066090704","BUENOS AIRES",5,0,3,1,0,4,0
"064830804","BUENOS AIRES",36,1,15,20,0,35,0.0277777777777778
"064831002","BUENOS AIRES",47,0,25,21,1,47,0
"066510704","BUENOS AIRES",5,0,2,3,0,5,0
"066510805","BUENOS AIRES",2,0,1,1,0,2,0
"066511305","BUENOS AIRES",9,0,5,4,0,9,0
"065050206","BUENOS AIRES",44,0,29,14,1,44,0
"065050403","BUENOS AIRES",30,1,16,13,0,29,0.0333333333333333
"067980903","BUENOS AIRES",12,0,7,5,0,12,0
"065110102","BUENOS AIRES",10,0,1,8,0,9,0
"066721213","BUENOS AIRES",13,1,2,7,2,11,0.0769230769230769
"065110302","BUENOS AIRES",14,0,1,11,0,12,0
"066791205","BUENOS AIRES",2,0,1,1,0,2,0
"065180104","BUENOS AIRES",55,0,13,42,0,55,0
"065180107","BUENOS AIRES",11,0,5,6,0,11,0
"065180208","BUENOS AIRES",35,0,6,28,0,34,0
"065180406","BUENOS AIRES",6,0,6,0,0,6,0
"067491506","BUENOS AIRES",24,0,1,9,10,20,0
"065810702","BUENOS AIRES",7,0,0,7,0,7,0
"067420801","BUENOS AIRES",29,0,11,18,0,29,0
"065250502","BUENOS AIRES",33,0,25,8,0,33,0
"065321203","BUENOS AIRES",16,0,1,15,0,16,0
"065320601","BUENOS AIRES",7,0,1,5,0,6,0
"065320802","BUENOS AIRES",29,0,20,9,0,29,0
"065740903","BUENOS AIRES",39,0,4,33,0,37,0
"065470401","BUENOS AIRES",11,0,9,2,0,11,0
"065470703","BUENOS AIRES",37,0,34,3,0,37,0
"065470802","BUENOS AIRES",42,0,20,21,0,41,0
"065530201","BUENOS AIRES",5,0,3,2,0,5,0
"067701503","BUENOS AIRES",6,0,3,3,0,6,0
"067980904","BUENOS AIRES",15,0,1,14,0,15,0
"065740101","BUENOS AIRES",21,0,1,20,0,21,0
"065740202","BUENOS AIRES",56,0,10,45,1,56,0
"065810803","BUENOS AIRES",33,0,9,24,0,33,0
"065392918","BUENOS AIRES",265,1,122,130,2,254,0.00377358490566038
"066090303","BUENOS AIRES",5,0,1,3,1,5,0
"065810807","BUENOS AIRES",2,0,1,1,0,2,0
"065393002","BUENOS AIRES",427,7,237,166,0,403,0.0163934426229508
"065393005","BUENOS AIRES",307,11,117,165,3,285,0.0358306188925081
"065880305","BUENOS AIRES",16,0,9,7,0,16,0
"065880505","BUENOS AIRES",62,0,20,35,0,55,0
"065393215","BUENOS AIRES",466,1,279,175,3,457,0.00214592274678112
"065881201","BUENOS AIRES",35,0,15,19,1,35,0
"065881403","BUENOS AIRES",6,0,1,5,0,6,0
"065881502","BUENOS AIRES",11,0,6,5,0,11,0
"065881504","BUENOS AIRES",18,0,6,12,0,18,0
"066090403","BUENOS AIRES",14,0,4,10,0,14,0
"066090609","BUENOS AIRES",17,1,9,7,0,16,0.0588235294117647
"020151801","CABA",257,257,0,0,0,0,1
"065951913","BUENOS AIRES",47,0,30,17,0,47,0
"068261102","BUENOS AIRES",23,0,6,17,0,23,0
"068261302","BUENOS AIRES",25,0,13,12,0,25,0
"068330501","BUENOS AIRES",7,0,5,2,0,7,0
"066020303","BUENOS AIRES",14,0,5,5,2,12,0
"066020401","BUENOS AIRES",20,0,7,11,2,20,0
"068331406","BUENOS AIRES",0,0,0,0,0,0,NA
"066091004","BUENOS AIRES",11,0,4,6,0,10,0
"066091006","BUENOS AIRES",5,0,3,2,0,5,0
"066091201","BUENOS AIRES",14,0,4,8,2,14,0
"066160109","BUENOS AIRES",11,0,10,1,0,11,0
"066231002","BUENOS AIRES",15,0,8,7,0,15,0
"065393304","BUENOS AIRES",227,0,99,117,4,220,0
"066231003","BUENOS AIRES",6,0,0,6,0,6,0
"066232303","BUENOS AIRES",13,0,6,7,0,13,0
"066232305","BUENOS AIRES",25,0,12,12,1,25,0
"066232402","BUENOS AIRES",6,0,1,5,0,6,0
"066232602","BUENOS AIRES",26,0,22,4,0,26,0
"020121705","CABA",437,437,0,0,0,0,1
"066232703","BUENOS AIRES",10,0,2,8,0,10,0
"065393113","BUENOS AIRES",339,0,215,114,0,329,0
"068751301","BUENOS AIRES",18,0,10,4,1,15,0
"068820403","BUENOS AIRES",65,3,17,41,4,62,0.0461538461538462
"067000203","BUENOS AIRES",5,0,1,4,0,5,0
"066510201","BUENOS AIRES",13,0,7,5,0,12,0
"066510605","BUENOS AIRES",3,0,2,1,0,3,0
"066510707","BUENOS AIRES",11,0,8,2,0,10,0
"066510710","BUENOS AIRES",5,0,0,5,0,5,0
"066510812","BUENOS AIRES",3,0,2,1,0,3,0
"066511201","BUENOS AIRES",7,0,2,4,1,7,0
"066511301","BUENOS AIRES",3,0,3,0,0,3,0
"066511303","BUENOS AIRES",15,1,9,5,0,14,0.0666666666666667
"067700501","BUENOS AIRES",1,0,1,0,0,1,0
"066550103","BUENOS AIRES",39,1,15,22,0,37,0.0256410256410256
"066550201","BUENOS AIRES",36,0,14,22,0,36,0
"066550306","BUENOS AIRES",51,0,35,16,0,51,0
"066550307","BUENOS AIRES",45,2,32,8,0,40,0.0444444444444444
"066650404","BUENOS AIRES",18,0,7,9,2,18,0
"066650601","BUENOS AIRES",13,0,4,9,0,13,0
"066650701","BUENOS AIRES",36,0,8,28,0,36,0
"067140807","BUENOS AIRES",8,0,0,8,0,8,0
"020120609","CABA",302,300,1,0,0,1,0.993377483443709
"066650901","BUENOS AIRES",26,0,10,15,0,25,0
"065390103","BUENOS AIRES",287,4,153,107,0,260,0.0139372822299652
"066720201","BUENOS AIRES",12,0,2,9,1,12,0
"066720402","BUENOS AIRES",19,0,5,13,1,19,0
"065393201","BUENOS AIRES",391,0,162,214,5,381,0
"066791203","BUENOS AIRES",20,0,9,7,2,18,0
"066860207","BUENOS AIRES",2,0,2,0,0,2,0
"065393414","BUENOS AIRES",438,2,321,102,0,423,0.0045662100456621
"066860607","BUENOS AIRES",8,0,7,1,0,8,0
"020130901","CABA",287,287,0,0,0,0,1
"065320110","BUENOS AIRES",284,283,0,1,0,1,0.996478873239437
"020130305","CABA",312,312,0,0,0,0,1
"066860702","BUENOS AIRES",10,0,7,3,0,10,0
"065393210","BUENOS AIRES",274,0,195,76,1,272,0
"066860803","BUENOS AIRES",9,0,1,8,0,9,0
"065393211","BUENOS AIRES",411,3,230,168,0,398,0.0072992700729927
"065393213","BUENOS AIRES",225,0,105,110,4,219,0
"066930301","BUENOS AIRES",53,0,23,27,1,51,0
"065600110","BUENOS AIRES",356,0,198,146,1,345,0
"066930401","BUENOS AIRES",64,2,35,25,2,62,0.03125
"067001203","BUENOS AIRES",8,0,8,0,0,8,0
"067001208","BUENOS AIRES",2,0,2,0,0,2,0
"067070301","BUENOS AIRES",87,0,24,63,0,87,0
"067631403","BUENOS AIRES",18,0,10,7,1,18,0
"067631904","BUENOS AIRES",21,0,6,13,0,19,0
"020130704","CABA",344,344,0,0,0,0,1
"067701305","BUENOS AIRES",9,0,4,5,0,9,0
"067701307","BUENOS AIRES",11,0,0,11,0,11,0
"065320313","BUENOS AIRES",192,22,121,47,1,169,0.114583333333333
"067070802","BUENOS AIRES",62,2,28,30,0,58,0.032258064516129
"067070902","BUENOS AIRES",67,0,17,49,0,66,0
"067070903","BUENOS AIRES",30,0,9,20,1,30,0
"067071002","BUENOS AIRES",33,2,18,12,1,31,0.0606060606060606
"067140202","BUENOS AIRES",15,0,7,6,2,15,0
"067140805","BUENOS AIRES",19,1,8,10,0,18,0.0526315789473684
"067140902","BUENOS AIRES",13,1,4,8,0,12,0.0769230769230769
"067280802","BUENOS AIRES",23,0,14,7,1,22,0
"067281601","BUENOS AIRES",10,0,4,6,0,10,0
"067350208","BUENOS AIRES",14,0,3,11,0,14,0
"067350602","BUENOS AIRES",9,0,3,6,0,9,0
"067700304","BUENOS AIRES",5,0,2,3,0,5,0
"067700903","BUENOS AIRES",23,2,2,19,0,21,0.0869565217391304
"067701103","BUENOS AIRES",48,0,12,31,0,43,0
"067841103","BUENOS AIRES",12,0,0,12,0,12,0
"067420501","BUENOS AIRES",29,0,4,22,3,29,0
"067420601","BUENOS AIRES",10,0,3,6,1,10,0
"065393407","BUENOS AIRES",394,3,250,129,1,380,0.00761421319796954
"067840813","BUENOS AIRES",27,0,17,9,0,26,0
"067420702","BUENOS AIRES",55,0,16,39,0,55,0
"065393314","BUENOS AIRES",192,40,94,54,0,148,0.208333333333333
"065393402","BUENOS AIRES",334,7,99,209,5,313,0.0209580838323353
"067491507","BUENOS AIRES",29,0,2,4,16,22,0
"067491502","BUENOS AIRES",75,0,12,13,43,68,0
"067841002","BUENOS AIRES",3,0,2,1,0,3,0
"067701401","BUENOS AIRES",7,0,3,3,0,6,0
"067701504","BUENOS AIRES",5,0,1,4,0,5,0
"067841201","BUENOS AIRES",11,0,1,10,0,11,0
"067780702","BUENOS AIRES",17,1,5,11,0,16,0.0588235294117647
"067780703","BUENOS AIRES",11,0,1,10,0,11,0
"067780803","BUENOS AIRES",16,0,11,5,0,16,0
"067840401","BUENOS AIRES",3,0,2,1,0,3,0
"020130708","CABA",309,308,1,0,0,1,0.996763754045307
"067841003","BUENOS AIRES",11,0,0,11,0,11,0
"067841004","BUENOS AIRES",8,0,0,8,0,8,0
"067910601","BUENOS AIRES",71,1,36,29,1,66,0.0140845070422535
"067910801","BUENOS AIRES",15,0,0,15,0,15,0
"067910803","BUENOS AIRES",23,0,10,12,1,23,0
"067911101","BUENOS AIRES",27,0,20,6,1,27,0
"065390109","BUENOS AIRES",261,9,88,110,0,198,0.0344827586206897
"067911404","BUENOS AIRES",45,0,12,31,2,45,0
"065600204","BUENOS AIRES",450,2,199,239,1,439,0.00444444444444444
"067911405","BUENOS AIRES",78,0,8,50,10,68,0
"067911406","BUENOS AIRES",41,0,11,27,1,39,0
"067911506","BUENOS AIRES",14,0,0,14,0,14,0
"065470312","BUENOS AIRES",406,344,27,31,1,59,0.847290640394089
"065470907","BUENOS AIRES",415,392,16,6,1,23,0.944578313253012
"065530304","BUENOS AIRES",77,44,19,13,0,32,0.571428571428571
"065600109","BUENOS AIRES",370,1,202,153,2,357,0.0027027027027027
"065600205","BUENOS AIRES",368,98,125,110,4,239,0.266304347826087
"065320206","BUENOS AIRES",248,247,1,0,0,1,0.995967741935484
"067911702","BUENOS AIRES",34,3,12,15,1,28,0.0882352941176471
"067981003","BUENOS AIRES",17,0,1,16,0,17,0
"068052606","BUENOS AIRES",44,0,21,21,2,44,0
"065600403","BUENOS AIRES",516,4,272,218,3,493,0.00775193798449612
"067630407","BUENOS AIRES",198,157,6,29,1,36,0.792929292929293
"065601209","BUENOS AIRES",491,6,343,133,0,476,0.0122199592668024
"065601211","BUENOS AIRES",226,3,102,121,0,223,0.0132743362831858
"065600304","BUENOS AIRES",280,3,167,94,1,262,0.0107142857142857
"065600306","BUENOS AIRES",297,1,193,99,1,293,0.00336700336700337
"065601214","BUENOS AIRES",431,10,338,79,0,417,0.0232018561484919
"065600420","BUENOS AIRES",370,0,170,192,0,362,0
"065600511","BUENOS AIRES",305,0,208,91,0,299,0
"065600606","BUENOS AIRES",445,2,295,140,0,435,0.00449438202247191
"065600616","BUENOS AIRES",343,0,189,139,3,331,0
"020131602","CABA",430,429,1,0,0,1,0.997674418604651
"065600617","BUENOS AIRES",351,1,151,179,2,332,0.00284900284900285
"065180703","BUENOS AIRES",70,0,56,14,0,70,0
"065180712","BUENOS AIRES",189,3,143,42,0,185,0.0158730158730159
"065600711","BUENOS AIRES",198,0,92,96,1,189,0
"065600713","BUENOS AIRES",356,0,167,173,0,340,0
"065180807","BUENOS AIRES",36,1,23,12,0,35,0.0277777777777778
"065180809","BUENOS AIRES",113,1,97,14,0,111,0.00884955752212389
"065250101","BUENOS AIRES",155,4,38,106,2,146,0.0258064516129032
"065250102","BUENOS AIRES",156,0,50,101,0,151,0
"065320101","BUENOS AIRES",574,530,19,24,0,43,0.923344947735192
"065320103","BUENOS AIRES",299,287,6,6,0,12,0.959866220735786
"065320909","BUENOS AIRES",159,0,102,51,3,156,0
"065321001","BUENOS AIRES",336,0,144,183,3,330,0
"065321507","BUENOS AIRES",255,124,29,102,0,131,0.486274509803922
"065390101","BUENOS AIRES",386,10,208,158,0,366,0.0259067357512953
"065390111","BUENOS AIRES",369,22,246,97,1,344,0.0596205962059621
"065390112","BUENOS AIRES",287,15,139,126,0,265,0.0522648083623693
"065390211","BUENOS AIRES",272,243,13,12,0,25,0.893382352941177
"065390309","BUENOS AIRES",278,275,2,0,0,2,0.989208633093525
"065390311","BUENOS AIRES",411,397,9,4,0,13,0.965936739659367
"065390406","BUENOS AIRES",483,473,6,1,0,7,0.979296066252588
"065390505","BUENOS AIRES",268,170,77,19,0,96,0.634328358208955
"065390603","BUENOS AIRES",268,0,217,49,0,266,0
"065390605","BUENOS AIRES",256,16,175,63,0,238,0.0625
"065390606","BUENOS AIRES",428,3,346,71,0,417,0.00700934579439252
"065390702","BUENOS AIRES",344,19,265,34,0,299,0.0552325581395349
"065390703","BUENOS AIRES",438,8,306,122,0,428,0.0182648401826484
"065390705","BUENOS AIRES",357,4,137,210,1,348,0.0112044817927171
"065390706","BUENOS AIRES",353,7,225,111,3,339,0.0198300283286119
"065390811","BUENOS AIRES",266,0,161,95,0,256,0
"065391014","BUENOS AIRES",370,1,254,112,0,366,0.0027027027027027
"065391102","BUENOS AIRES",419,1,328,84,1,413,0.00238663484486874
"065391105","BUENOS AIRES",282,0,191,78,1,270,0
"064201902","BUENOS AIRES",17,15,1,1,0,2,0.882352941176471
"065180204","BUENOS AIRES",332,290,17,25,0,42,0.873493975903614
"067490702","BUENOS AIRES",284,154,47,81,0,128,0.542253521126761
"068401313","BUENOS AIRES",205,205,0,0,0,0,1
"020130102","CABA",343,343,0,0,0,0,1
"020130105","CABA",421,417,0,0,0,0,0.990498812351544
"020130302","CABA",270,268,2,0,0,2,0.992592592592593
"020131101","CABA",172,167,0,0,4,4,0.970930232558139
"020131306","CABA",132,131,0,0,0,0,0.992424242424242
"020130104","CABA",367,366,1,0,0,1,0.997275204359673
"020130103","CABA",258,258,0,0,0,0,1
"020051109","CABA",459,458,0,0,0,0,0.997821350762527
"020130101","CABA",296,296,0,0,0,0,1
"020130107","CABA",185,185,0,0,0,0,1
"020130110","CABA",314,314,0,0,0,0,1
"020130106","CABA",386,384,1,0,0,1,0.994818652849741
"020120405","CABA",249,249,0,0,0,0,1
"020130109","CABA",217,216,0,0,0,0,0.995391705069124
"020130111","CABA",300,300,0,0,0,0,1
"020130108","CABA",241,234,0,0,0,0,0.970954356846473
"020120407","CABA",499,499,0,0,0,0,1
"020120404","CABA",295,295,0,0,0,0,1
"020120402","CABA",287,282,5,0,0,5,0.982578397212544
"020130205","CABA",330,330,0,0,0,0,1
"020130112","CABA",246,246,0,0,0,0,1
"020120502","CABA",283,283,0,0,0,0,1
"020120401","CABA",277,277,0,0,0,0,1
"020130113","CABA",245,245,0,0,0,0,1
"020130211","CABA",293,291,2,0,0,2,0.993174061433447
"020120406","CABA",297,296,0,0,0,0,0.996632996632997
"020120306","CABA",451,446,3,0,0,3,0.988913525498891
"020120303","CABA",270,270,0,0,0,0,1
"020130204","CABA",239,239,0,0,0,0,1
"020130202","CABA",359,358,0,0,0,0,0.997214484679666
"020120403","CABA",418,415,2,1,0,3,0.992822966507177
"020130114","CABA",283,256,0,0,0,0,0.904593639575972
"020130206","CABA",470,466,3,0,0,3,0.991489361702128
"020120302","CABA",249,243,3,3,0,6,0.975903614457831
"020120408","CABA",289,289,0,0,0,0,1
"020130207","CABA",300,300,0,0,0,0,1
"020120301","CABA",104,104,0,0,0,0,1
"020120304","CABA",268,267,1,0,0,1,0.996268656716418
"020130201","CABA",545,540,3,0,0,3,0.990825688073395
"020130210","CABA",468,456,1,0,0,1,0.974358974358974
"020120505","CABA",348,341,5,0,0,5,0.979885057471264
"020130203","CABA",259,259,0,0,0,0,1
"020130208","CABA",253,252,1,0,0,1,0.99604743083004
"020131102","CABA",241,240,1,0,0,1,0.995850622406639
"020120504","CABA",277,277,0,0,0,0,1
"020130402","CABA",350,346,4,0,0,4,0.988571428571429
"020130209","CABA",396,396,0,0,0,0,1
"020120409","CABA",224,223,1,0,0,1,0.995535714285714
"020120107","CABA",360,359,1,0,0,1,0.997222222222222
"020130304","CABA",433,431,1,0,0,1,0.995381062355658
"020120305","CABA",292,290,0,0,0,0,0.993150684931507
"020120108","CABA",182,181,1,0,0,1,0.994505494505495
"020120106","CABA",286,281,0,2,0,2,0.982517482517482
"020120410","CABA",243,242,1,0,0,1,0.995884773662551
"020130303","CABA",353,352,0,0,0,0,0.997167138810198
"020120506","CABA",301,301,0,0,0,0,1
"020130301","CABA",377,377,0,0,0,0,1
"020120308","CABA",253,251,2,0,0,2,0.992094861660079
"020120105","CABA",217,213,3,0,0,3,0.981566820276498
"020120503","CABA",543,543,0,0,0,0,1
"020120309","CABA",223,219,3,0,0,3,0.982062780269058
"020120104","CABA",313,302,7,4,0,11,0.964856230031949
"020131205","CABA",218,214,3,0,0,3,0.981651376146789
"020130401","CABA",291,291,0,0,0,0,1
"020130403","CABA",304,290,0,0,0,0,0.953947368421053
"020130306","CABA",271,271,0,0,0,0,1
"020120310","CABA",305,303,2,0,0,2,0.99344262295082
"020131103","CABA",207,204,3,0,0,3,0.985507246376812
"020120507","CABA",327,327,0,0,0,0,1
"020120307","CABA",378,374,2,1,0,3,0.989417989417989
"020130404","CABA",430,428,2,0,0,2,0.995348837209302
"020130310","CABA",448,447,0,0,0,0,0.997767857142857
"020130503","CABA",530,529,0,0,0,0,0.99811320754717
"020131106","CABA",408,407,1,0,0,1,0.997549019607843
"020130406","CABA",400,400,0,0,0,0,1
"020130309","CABA",354,351,3,0,0,3,0.991525423728814
"020120109","CABA",356,354,1,0,0,1,0.99438202247191
"020120511","CABA",332,327,2,0,0,2,0.984939759036145
"020120510","CABA",284,284,0,0,0,0,1
"020141001","CABA",6,6,0,0,0,0,1
"020131104","CABA",229,228,1,0,0,1,0.995633187772926
"020130504","CABA",478,478,0,0,0,0,1
"020130408","CABA",265,265,0,0,0,0,1
"020131105","CABA",222,222,0,0,0,0,1
"020120604","CABA",349,347,1,1,0,2,0.994269340974212
"020131107","CABA",284,282,2,0,0,2,0.992957746478873
"020130307","CABA",290,290,0,0,0,0,1
"020130502","CABA",403,403,0,0,0,0,1
"020130407","CABA",296,296,0,0,0,0,1
"020131003","CABA",427,427,0,0,0,0,1
"020130405","CABA",363,363,0,0,0,0,1
"020120202","CABA",316,316,0,0,0,0,1
"020120111","CABA",374,370,4,0,0,4,0.989304812834225
"020120110","CABA",361,361,0,0,0,0,1
"020120103","CABA",187,187,0,0,0,0,1
"020120703","CABA",325,325,0,0,0,0,1
"020130412","CABA",613,612,1,0,0,1,0.99836867862969
"020120201","CABA",371,370,0,0,0,0,0.997304582210243
"020130505","CABA",359,352,3,4,0,7,0.98050139275766
"020120603","CABA",257,255,1,0,0,1,0.992217898832685
"020130507","CABA",327,327,0,0,0,0,1
"020120606","CABA",380,378,2,0,0,2,0.994736842105263
"020131202","CABA",320,320,0,0,0,0,1
"020130501","CABA",344,344,0,0,0,0,1
"020130409","CABA",341,339,2,0,0,2,0.994134897360704
"020130411","CABA",370,345,0,0,0,0,0.932432432432432
"020131002","CABA",404,404,0,0,0,0,1
"020120605","CABA",387,385,1,0,0,1,0.994832041343669
"020131005","CABA",252,252,0,0,0,0,1
"020120602","CABA",353,352,1,0,0,1,0.997167138810198
"020131001","CABA",415,415,0,0,0,0,1
"020130410","CABA",237,236,0,0,0,0,0.9957805907173
"020130804","CABA",388,387,0,0,1,1,0.997422680412371
"020131206","CABA",240,239,0,0,0,0,0.995833333333333
"020130413","CABA",337,315,0,1,0,1,0.934718100890208
"020131203","CABA",237,237,0,0,0,0,1
"020120702","CABA",310,309,1,0,0,1,0.996774193548387
"020131210","CABA",249,248,0,1,0,1,0.995983935742972
"020130602","CABA",425,425,0,0,0,0,1
"020130805","CABA",452,451,0,0,0,0,0.997787610619469
"020130802","CABA",275,275,0,0,0,0,1
"020131312","CABA",327,327,0,0,0,0,1
"020131006","CABA",388,361,1,0,0,1,0.930412371134021
"020130606","CABA",368,368,0,0,0,0,1
"020120204","CABA",379,379,0,0,0,0,1
"020120208","CABA",345,342,3,0,0,3,0.991304347826087
"020130603","CABA",368,368,0,0,0,0,1
"020131207","CABA",341,341,0,0,0,0,1
"020120608","CABA",288,286,2,0,0,2,0.993055555555556
"020120701","CABA",318,317,1,0,0,1,0.99685534591195
"020130607","CABA",425,424,1,0,0,1,0.997647058823529
"020130801","CABA",314,314,0,0,0,0,1
"020131011","CABA",314,314,0,0,0,0,1
"020131007","CABA",321,321,0,0,0,0,1
"020130806","CABA",295,295,0,0,0,0,1
"020131208","CABA",282,281,1,0,0,1,0.99645390070922
"020120205","CABA",401,400,1,0,0,1,0.997506234413965
"020130809","CABA",326,326,0,0,0,0,1
"020120610","CABA",316,314,1,0,0,1,0.993670886075949
"020130703","CABA",457,457,0,0,0,0,1
"020131010","CABA",424,424,0,0,0,0,1
"020120704","CABA",359,357,2,0,0,2,0.994428969359331
"020130807","CABA",364,364,0,0,0,0,1
"020130810","CABA",292,292,0,0,0,0,1
"020120705","CABA",290,288,1,1,0,2,0.993103448275862
"020131209","CABA",384,383,1,0,0,1,0.997395833333333
"020131303","CABA",322,322,0,0,0,0,1
"020130808","CABA",439,436,0,0,0,0,0.993166287015945
"020130608","CABA",339,339,0,0,0,0,1
"020120801","CABA",548,546,0,2,0,2,0.996350364963504
"020130906","CABA",320,320,0,0,0,0,1
"020130902","CABA",303,300,1,0,0,1,0.99009900990099
"020131009","CABA",325,324,1,0,0,1,0.996923076923077
"020120206","CABA",344,343,1,0,0,1,0.997093023255814
"020130702","CABA",221,221,0,0,0,0,1
"020130705","CABA",476,476,0,0,0,0,1
"020130706","CABA",381,381,0,0,0,0,1
"020131305","CABA",411,411,0,0,0,0,1
"020120706","CABA",347,343,2,0,0,2,0.988472622478386
"020130907","CABA",296,296,0,0,0,0,1
"020131302","CABA",155,155,0,0,0,0,1
"020131603","CABA",252,252,0,0,0,0,1
"020130707","CABA",346,346,0,0,0,0,1
"020130905","CABA",488,488,0,0,0,0,1
"020120802","CABA",273,273,0,0,0,0,1
"020130903","CABA",247,247,0,0,0,0,1
"020130701","CABA",271,271,0,0,0,0,1
"020131304","CABA",394,390,2,0,0,2,0.989847715736041
"020131008","CABA",432,432,0,0,0,0,1
"020130908","CABA",344,344,0,0,0,0,1
"020120207","CABA",319,317,1,0,0,1,0.993730407523511
"020131403","CABA",367,366,1,0,0,1,0.997275204359673
"020130909","CABA",363,362,1,0,0,1,0.997245179063361
"020131301","CABA",376,376,0,0,0,0,1
"020130904","CABA",293,293,0,0,0,0,1
"020120803","CABA",325,324,1,0,0,1,0.996923076923077
"020131307","CABA",305,305,0,0,0,0,1
"020120907","CABA",307,307,0,0,0,0,1
"020120708","CABA",365,364,0,0,0,0,0.997260273972603
"020131604","CABA",368,368,0,0,0,0,1
"020131402","CABA",162,162,0,0,0,0,1
"020130910","CABA",239,239,0,0,0,0,1
"020131313","CABA",556,556,0,0,0,0,1
"020131601","CABA",392,392,0,0,0,0,1
"020131605","CABA",252,252,0,0,0,0,1
"020130709","CABA",373,373,0,0,0,0,1
"020131404","CABA",291,291,0,0,0,0,1
"020131401","CABA",341,341,0,0,0,0,1
"020120707","CABA",301,300,1,0,0,1,0.996677740863787
"020131308","CABA",249,249,0,0,0,0,1
"020132105","CABA",291,291,0,0,0,0,1
"020131608","CABA",352,352,0,0,0,0,1
"020131409","CABA",238,238,0,0,0,0,1
"020132208","CABA",377,375,0,0,0,0,0.994694960212202
"020120102","CABA",196,194,1,1,0,2,0.989795918367347
"020131610","CABA",391,391,0,0,0,0,1
"020131606","CABA",183,183,0,0,0,0,1
"020131405","CABA",228,226,2,0,0,2,0.991228070175439
"020131406","CABA",359,359,0,0,0,0,1
"020131314","CABA",348,347,1,0,0,1,0.997126436781609
"020120806","CABA",352,351,1,0,0,1,0.997159090909091
"020131701","CABA",476,473,3,0,0,3,0.993697478991597
"020131502","CABA",360,360,0,0,0,0,1
"020120804","CABA",262,259,2,0,0,2,0.988549618320611
"020120709","CABA",557,551,1,0,0,1,0.989228007181329
"020120906","CABA",377,365,11,0,0,11,0.96816976127321
"020131501","CABA",350,349,1,0,0,1,0.997142857142857
"020131609","CABA",380,380,0,0,0,0,1
"020131410","CABA",298,298,0,0,0,0,1
"020120903","CABA",385,382,2,1,0,3,0.992207792207792
"020131702","CABA",472,472,0,0,0,0,1
"020131309","CABA",287,287,0,0,0,0,1
"020121004","CABA",270,263,2,0,0,2,0.974074074074074
"020131611","CABA",381,380,1,0,0,1,0.99737532808399
"020120101","CABA",191,190,1,0,0,1,0.994764397905759
"020132104","CABA",319,319,0,0,0,0,1
"020120905","CABA",358,357,0,1,0,1,0.997206703910615
"020120807","CABA",364,364,0,0,0,0,1
"020131408","CABA",254,254,0,0,0,0,1
"020121003","CABA",287,287,0,0,0,0,1
"020132209","CABA",220,219,1,0,0,1,0.995454545454545
"020131509","CABA",416,416,0,0,0,0,1
"020131703","CABA",389,389,0,0,0,0,1
"020131705","CABA",345,345,0,0,0,0,1
"020131311","CABA",215,215,0,0,0,0,1
"020132206","CABA",391,391,0,0,0,0,1
"020132106","CABA",312,312,0,0,0,0,1
"020120901","CABA",331,324,4,0,0,4,0.978851963746224
"020120805","CABA",344,344,0,0,0,0,1
"020140203","CABA",349,349,0,0,0,0,1
"020140208","CABA",402,402,0,0,0,0,1
"020120904","CABA",392,385,1,0,0,1,0.982142857142857
"020131504","CABA",199,197,2,0,0,2,0.989949748743719
"020132107","CABA",450,449,1,0,0,1,0.997777777777778
"020131709","CABA",403,402,1,0,0,1,0.997518610421836
"020132102","CABA",149,149,0,0,0,0,1
"020120808","CABA",415,414,0,0,0,0,0.997590361445783
"020121001","CABA",366,362,3,0,0,3,0.989071038251366
"020132110","CABA",342,342,0,0,0,0,1
"020131505","CABA",391,390,1,0,0,1,0.997442455242967
"020140202","CABA",271,271,0,0,0,0,1
"020140204","CABA",320,320,0,0,0,0,1
"020132108","CABA",345,345,0,0,0,0,1
"020132101","CABA",244,244,0,0,0,0,1
"020120809","CABA",396,396,0,0,0,0,1
"020131803","CABA",397,397,0,0,0,0,1
"020131510","CABA",331,328,2,0,0,2,0.990936555891239
"020132204","CABA",327,327,0,0,0,0,1
"020120810","CABA",290,289,1,0,0,1,0.996551724137931
"020131507","CABA",383,383,0,0,0,0,1
"020131706","CABA",360,360,0,0,0,0,1
"020121002","CABA",390,389,1,0,0,1,0.997435897435897
"020121005","CABA",298,285,2,0,0,2,0.956375838926175
"020140201","CABA",505,503,0,1,0,1,0.996039603960396
"020140209","CABA",380,380,0,0,0,0,1
"020120902","CABA",420,419,1,0,0,1,0.997619047619048
"020140207","CABA",317,317,0,0,0,0,1
"020132005","CABA",312,312,0,0,0,0,1
"020131708","CABA",316,316,0,0,0,0,1
"020131511","CABA",369,358,0,0,0,0,0.970189701897019
"020121006","CABA",353,352,1,0,0,1,0.997167138810198
"020140205","CABA",340,338,2,0,0,2,0.994117647058824
"020131802","CABA",407,407,0,0,0,0,1
"020132109","CABA",360,359,1,0,0,1,0.997222222222222
"020140108","CABA",299,299,0,0,0,0,1
"020121704","CABA",306,300,3,0,0,3,0.980392156862745
"020121701","CABA",355,354,1,0,0,1,0.997183098591549
"020140304","CABA",297,297,0,0,0,0,1
"020131512","CABA",328,328,0,0,0,0,1
"020131707","CABA",386,385,0,0,1,1,0.99740932642487
"020140210","CABA",474,474,0,0,0,0,1
"020131903","CABA",295,294,0,0,0,0,0.996610169491525
"020140206","CABA",268,268,0,0,0,0,1
"020140109","CABA",398,398,0,0,0,0,1
"020132006","CABA",428,427,1,0,0,1,0.997663551401869
"020131711","CABA",247,247,0,0,0,0,1
"020132004","CABA",316,316,0,0,0,0,1
"020121007","CABA",295,294,0,0,0,0,0.996610169491525
"020121011","CABA",345,344,0,1,0,1,0.997101449275362
"020131902","CABA",397,396,1,0,0,1,0.997481108312343
"020121802","CABA",323,320,3,0,0,3,0.990712074303406
"020140301","CABA",758,757,1,0,0,1,0.99868073878628
"020140303","CABA",226,222,3,1,0,4,0.982300884955752
"020121107","CABA",330,330,0,0,0,0,1
"020140104","CABA",362,362,0,0,0,0,1
"020140110","CABA",462,461,1,0,0,1,0.997835497835498
"020132003","CABA",175,175,0,0,0,0,1
"020132203","CABA",222,222,0,0,0,0,1
"020132201","CABA",251,250,0,0,0,0,0.99601593625498
"020132012","CABA",277,277,0,0,0,0,1
"020131904","CABA",227,225,2,0,0,2,0.991189427312775
"020121702","CABA",380,377,2,0,0,2,0.992105263157895
"020140312","CABA",305,304,1,0,0,1,0.99672131147541
"020131807","CABA",383,383,0,0,0,0,1
"020131901","CABA",340,338,1,0,0,1,0.994117647058824
"020121009","CABA",318,317,1,0,0,1,0.99685534591195
"020132007","CABA",372,372,0,0,0,0,1
"020131801","CABA",334,333,1,0,0,1,0.997005988023952
"020131804","CABA",294,294,0,0,0,0,1
"020132002","CABA",394,394,0,0,0,0,1
"020140306","CABA",164,164,0,0,0,0,1
"020132305","CABA",236,236,0,0,0,0,1
"020121109","CABA",373,373,0,0,0,0,1
"020131905","CABA",366,356,0,0,0,0,0.972677595628415
"020132011","CABA",261,261,0,0,0,0,1
"020140302","CABA",226,225,0,0,0,0,0.995575221238938
"020140402","CABA",220,220,0,0,0,0,1
"020132306","CABA",368,367,0,0,0,0,0.997282608695652
"020140906","CABA",296,295,1,0,0,1,0.996621621621622
"020121708","CABA",557,554,2,0,0,2,0.994614003590664
"020121806","CABA",312,310,2,0,0,2,0.993589743589744
"020131909","CABA",332,331,1,0,0,1,0.996987951807229
"020121108","CABA",344,344,0,0,0,0,1
"020140311","CABA",347,346,1,0,0,1,0.997118155619596
"020131805","CABA",282,282,0,0,0,0,1
"020132010","CABA",272,272,0,0,0,0,1
"020121703","CABA",333,333,0,0,0,0,1
"020121010","CABA",299,297,2,0,0,2,0.993311036789298
"020140307","CABA",297,297,0,0,0,0,1
"020132008","CABA",386,386,0,0,0,0,1
"020132311","CABA",424,424,0,0,0,0,1
"020132304","CABA",294,293,1,0,0,1,0.996598639455782
"020140103","CABA",400,400,0,0,0,0,1
"020140907","CABA",264,264,0,0,0,0,1
"020121803","CABA",318,300,11,1,0,12,0.943396226415094
"020121801","CABA",231,226,4,0,1,5,0.978354978354978
"020140105","CABA",585,582,1,0,0,1,0.994871794871795
"020131908","CABA",329,329,0,0,0,0,1
"020132009","CABA",258,258,0,0,0,0,1
"020140101","CABA",210,210,0,0,0,0,1
"020140905","CABA",198,198,0,0,0,0,1
"020132702","CABA",399,399,0,0,0,0,1
"020121106","CABA",319,317,1,0,0,1,0.993730407523511
"020121008","CABA",477,475,2,0,0,2,0.9958071278826
"020132303","CABA",538,537,0,0,0,0,0.99814126394052
"020140403","CABA",218,217,1,0,0,1,0.995412844036697
"020140106","CABA",446,446,0,0,0,0,1
"020131806","CABA",302,302,0,0,0,0,1
"020140310","CABA",308,308,0,0,0,0,1
"020132307","CABA",257,257,0,0,0,0,1
"020140908","CABA",391,391,0,0,0,0,1
"020140904","CABA",537,537,0,0,0,0,1
"020140102","CABA",255,246,1,1,0,2,0.964705882352941
"020121706","CABA",414,414,0,0,0,0,1
"020121102","CABA",267,265,1,0,0,1,0.99250936329588
"020121606","CABA",647,613,33,1,0,34,0.947449768160742
"020132703","CABA",440,440,0,0,0,0,1
"020140913","CABA",349,348,0,0,0,0,0.997134670487106
"020121804","CABA",308,307,1,0,0,1,0.996753246753247
"020132302","CABA",270,269,0,0,0,0,0.996296296296296
"020140308","CABA",430,430,0,0,0,0,1
"020121604","CABA",521,500,1,0,0,1,0.959692898272553
"020140107","CABA",367,367,0,0,0,0,1
"020131912","CABA",268,268,0,0,0,0,1
"020131906","CABA",215,215,0,0,0,0,1
"020132706","CABA",529,526,3,0,0,3,0.994328922495274
"020140309","CABA",456,456,0,0,0,0,1
"020132308","CABA",505,502,2,0,0,2,0.994059405940594
"020132301","CABA",545,544,0,0,0,0,0.998165137614679
"020140405","CABA",384,374,0,0,0,0,0.973958333333333
"020121901","CABA",352,351,1,0,0,1,0.997159090909091
"020131808","CABA",280,280,0,0,0,0,1
"020121103","CABA",254,254,0,0,0,0,1
"020131907","CABA",257,242,1,0,0,1,0.941634241245136
"020132701","CABA",175,175,0,0,0,0,1
"020121805","CABA",301,301,0,0,0,0,1
"020121101","CABA",328,327,1,0,0,1,0.996951219512195
"020121302","CABA",389,387,2,0,0,2,0.994858611825193
"020132704","CABA",387,387,0,0,0,0,1
"020132709","CABA",407,407,0,0,0,0,1
"020131809","CABA",170,170,0,0,0,0,1
"020121707","CABA",373,369,1,0,0,1,0.989276139410188
"020121603","CABA",359,359,0,0,0,0,1
"020140406","CABA",454,454,0,0,0,0,1
"020140401","CABA",413,411,2,0,0,2,0.995157384987893
"020020101","CABA",21,16,4,1,0,5,0.761904761904762
"020132802","CABA",213,212,1,0,0,1,0.995305164319249
"020121807","CABA",336,334,2,0,0,2,0.994047619047619
"020132404","CABA",364,364,0,0,0,0,1
"020132705","CABA",311,311,0,0,0,0,1
"020140901","CABA",491,490,1,0,0,1,0.9979633401222
"020121110","CABA",283,281,1,0,0,1,0.992932862190813
"020121602","CABA",363,360,3,0,0,3,0.991735537190083
"020140404","CABA",293,293,0,0,0,0,1
"020020102","CABA",133,38,41,47,2,90,0.285714285714286
"020121105","CABA",307,286,1,14,5,20,0.931596091205212
"020121607","CABA",338,335,2,1,0,3,0.99112426035503
"020131810","CABA",274,273,0,0,0,0,0.996350364963504
"020132410","CABA",283,281,2,0,0,2,0.992932862190813
"020132809","CABA",393,393,0,0,0,0,1
"020121907","CABA",346,344,2,0,0,2,0.994219653179191
"020132708","CABA",368,367,1,0,0,1,0.997282608695652
"020121808","CABA",328,324,3,1,0,4,0.98780487804878
"020121304","CABA",526,525,1,0,0,1,0.998098859315589
"020121104","CABA",343,342,1,0,0,1,0.997084548104956
"020121301","CABA",407,405,2,0,0,2,0.995085995085995
"020121609","CABA",362,362,0,0,0,0,1
"020121601","CABA",395,394,0,1,0,1,0.99746835443038
"020132408","CABA",339,338,0,0,0,0,0.997050147492625
"020140910","CABA",462,462,0,0,0,0,1
"020132801","CABA",268,263,0,0,0,0,0.98134328358209
"020121809","CABA",290,289,1,0,0,1,0.996551724137931
"020140912","CABA",418,418,0,0,0,0,1
"020132403","CABA",283,282,0,0,0,0,0.996466431095406
"020141102","CABA",468,465,2,0,0,2,0.993589743589744
"020121111","CABA",278,275,3,0,0,3,0.989208633093525
"020121610","CABA",330,329,1,0,0,1,0.996969696969697
"020121203","CABA",509,508,0,0,0,0,0.99803536345776
"020121902","CABA",225,225,0,0,0,0,1
"020143101","CABA",217,216,1,0,0,1,0.995391705069124
"020121811","CABA",238,230,1,0,0,1,0.966386554621849
"020141103","CABA",237,236,1,0,0,1,0.9957805907173
"020140504","CABA",284,282,1,0,0,1,0.992957746478873
"020132806","CABA",356,356,0,0,0,0,1
"020150307","CABA",251,251,0,0,0,0,1
"020121305","CABA",475,475,0,0,0,0,1
"020132406","CABA",318,316,2,0,0,2,0.993710691823899
"020121903","CABA",283,282,1,0,0,1,0.996466431095406
"020132602","CABA",325,322,2,0,0,2,0.990769230769231
"020132409","CABA",381,350,1,0,0,1,0.918635170603675
"020132807","CABA",329,329,0,0,0,0,1
"020132402","CABA",252,252,0,0,0,0,1
"020132805","CABA",217,215,2,0,0,2,0.990783410138249
"020121614","CABA",175,174,1,0,0,1,0.994285714285714
"020121307","CABA",249,248,1,0,0,1,0.995983935742972
"020132610","CABA",436,436,0,0,0,0,1
"020141104","CABA",279,279,0,0,0,0,1
"020121810","CABA",284,284,0,0,0,0,1
"020121611","CABA",334,334,0,0,0,0,1
"020140505","CABA",507,506,1,0,0,1,0.998027613412229
"020132604","CABA",419,402,1,0,0,1,0.959427207637232
"020121202","CABA",501,501,0,0,0,0,1
"020132611","CABA",281,277,0,0,0,0,0.98576512455516
"020121504","CABA",418,417,1,0,0,1,0.997607655502392
"020140503","CABA",412,409,1,2,0,3,0.992718446601942
"020132401","CABA",198,198,0,0,0,0,1
"020141113","CABA",399,399,0,0,0,0,1
"020121204","CABA",356,356,0,0,0,0,1
"020141105","CABA",379,378,1,0,0,1,0.997361477572559
"020121306","CABA",395,395,0,0,0,0,1
"020140510","CABA",546,546,0,0,0,0,1
"020121612","CABA",316,316,0,0,0,0,1
"020140409","CABA",433,431,2,0,0,2,0.995381062355658
"020150306","CABA",272,271,1,0,0,1,0.996323529411765
"020121205","CABA",328,328,0,0,0,0,1
"020140506","CABA",277,276,1,0,0,1,0.996389891696751
"020121402","CABA",400,400,0,0,0,0,1
"020121906","CABA",356,354,2,0,0,2,0.99438202247191
"020132407","CABA",367,367,0,0,0,0,1
"020121908","CABA",351,333,1,0,0,1,0.948717948717949
"020132501","CABA",262,262,0,0,0,0,1
"020132605","CABA",317,316,0,0,0,0,0.996845425867508
"020150305","CABA",242,238,3,0,0,3,0.983471074380165
"020140509","CABA",502,501,1,0,0,1,0.99800796812749
"020141106","CABA",353,352,0,0,0,0,0.997167138810198
"020121201","CABA",272,271,1,0,0,1,0.996323529411765
"020121613","CABA",202,200,2,0,0,2,0.99009900990099
"020121401","CABA",373,364,1,0,0,1,0.975871313672922
"020140408","CABA",482,481,1,0,0,1,0.99792531120332
"020121812","CABA",436,436,0,0,0,0,1
"020132601","CABA",316,291,2,0,0,2,0.920886075949367
"020141114","CABA",231,229,2,0,0,2,0.991341991341991
"020140507","CABA",236,236,0,0,0,0,1
"020121910","CABA",360,355,5,0,0,5,0.986111111111111
"020140605","CABA",387,379,2,0,0,2,0.979328165374677
"020143108","CABA",269,268,1,0,0,1,0.996282527881041
"020141101","CABA",284,284,0,0,0,0,1
"020150308","CABA",329,328,1,0,0,1,0.996960486322188
"020132502","CABA",279,279,0,0,0,0,1
"020121905","CABA",406,404,1,0,1,2,0.995073891625616
"020121909","CABA",316,316,0,0,0,0,1
"020140410","CABA",697,692,5,0,0,5,0.992826398852224
"020132609","CABA",202,198,4,0,0,4,0.98019801980198
"020140502","CABA",370,370,0,0,0,0,1
"020121208","CABA",267,265,1,0,0,1,0.99250936329588
"020140601","CABA",512,511,0,0,0,0,0.998046875
"020140501","CABA",357,353,3,0,1,4,0.988795518207283
"020121407","CABA",432,428,3,0,0,3,0.990740740740741
"020150304","CABA",269,263,0,3,0,3,0.977695167286245
"020121813","CABA",306,305,1,0,0,1,0.996732026143791
"020121206","CABA",260,260,0,0,0,0,1
"020141107","CABA",267,266,1,0,0,1,0.99625468164794
"020121403","CABA",308,307,0,0,0,0,0.996753246753247
"020141601","CABA",591,591,0,0,0,0,1
"020031502","CABA",399,399,0,0,0,0,1
"020121503","CABA",420,420,0,0,0,0,1
"020143102","CABA",327,326,0,0,0,0,0.996941896024465
"020150309","CABA",349,348,1,0,0,1,0.997134670487106
"020121505","CABA",393,392,0,0,0,0,0.997455470737914
"020141108","CABA",529,528,1,0,0,1,0.998109640831758
"020140508","CABA",190,187,0,3,0,3,0.984210526315789
"020132504","CABA",269,268,1,0,0,1,0.996282527881041
"020132606","CABA",265,264,1,0,0,1,0.99622641509434
"020121404","CABA",407,406,1,0,0,1,0.997542997542998
"020132903","CABA",247,242,2,0,0,2,0.979757085020243
"020132911","CABA",327,324,3,0,0,3,0.990825688073395
"020121207","CABA",386,385,1,0,0,1,0.99740932642487
"020132908","CABA",420,420,0,0,0,0,1
"020140606","CABA",511,511,0,0,0,0,1
"020141112","CABA",362,359,2,0,0,2,0.99171270718232
"020141605","CABA",374,373,1,0,0,1,0.997326203208556
"020132505","CABA",221,220,1,0,0,1,0.995475113122172
"020150313","CABA",291,290,0,0,0,0,0.996563573883162
"020140604","CABA",361,361,0,0,0,0,1
"020132608","CABA",214,213,0,1,0,1,0.995327102803738
"020132506","CABA",274,274,0,0,0,0,1
"020150310","CABA",340,340,0,0,0,0,1
"020143103","CABA",279,279,0,0,0,0,1
"020121904","CABA",367,365,2,0,0,2,0.994550408719346
"020121913","CABA",286,283,3,0,0,3,0.989510489510489
"020132907","CABA",355,354,1,0,0,1,0.997183098591549
"020140610","CABA",213,213,0,0,0,0,1
"020150301","CABA",289,289,0,0,0,0,1
"020121502","CABA",422,422,0,0,0,0,1
"020141606","CABA",122,122,0,0,0,0,1
"020140602","CABA",401,391,0,0,0,0,0.975062344139651
"020150403","CABA",401,401,0,0,0,0,1
"020121408","CABA",469,466,0,0,0,0,0.993603411513859
"020141109","CABA",412,411,1,0,0,1,0.997572815533981
"020143106","CABA",406,406,0,0,0,0,1
"020121506","CABA",343,343,0,0,0,0,1
"020140609","CABA",402,401,1,0,0,1,0.997512437810945
"020121501","CABA",378,359,2,0,0,2,0.94973544973545
"020140607","CABA",359,359,0,0,0,0,1
"020140805","CABA",482,480,1,1,0,2,0.995850622406639
"020141706","CABA",274,273,0,0,0,0,0.996350364963504
"020121912","CABA",333,305,1,0,0,1,0.915915915915916
"020121406","CABA",318,313,5,0,0,5,0.984276729559748
"020132607","CABA",189,189,0,0,0,0,1
"020132901","CABA",274,274,0,0,0,0,1
"020141604","CABA",397,397,0,0,0,0,1
"020140806","CABA",469,468,0,0,0,0,0.997867803837953
"020121507","CABA",383,383,0,0,0,0,1
"020150303","CABA",382,380,1,0,0,1,0.994764397905759
"020121911","CABA",372,370,0,1,0,1,0.994623655913978
"020143104","CABA",250,249,1,0,0,1,0.996
"020140603","CABA",380,380,0,0,0,0,1
"020143109","CABA",225,225,0,0,0,0,1
"020132508","CABA",364,363,1,0,0,1,0.997252747252747
"020132902","CABA",281,281,0,0,0,0,1
"020121410","CABA",441,438,3,0,0,3,0.993197278911565
"020141110","CABA",208,208,0,0,0,0,1
"020140804","CABA",245,245,0,0,0,0,1
"020132507","CABA",504,503,0,0,0,0,0.998015873015873
"020140608","CABA",253,253,0,0,0,0,1
"020121508","CABA",364,363,0,0,0,0,0.997252747252747
"020141607","CABA",324,323,0,0,0,0,0.996913580246914
"020150312","CABA",411,403,5,0,0,5,0.980535279805353
"020150311","CABA",340,333,7,0,0,7,0.979411764705882
"020151001","CABA",348,345,1,0,0,1,0.991379310344828
"020140807","CABA",301,301,0,0,0,0,1
"020143107","CABA",315,315,0,0,0,0,1
"020151002","CABA",341,340,1,0,0,1,0.997067448680352
"020150402","CABA",256,254,1,0,0,1,0.9921875
"020150302","CABA",399,399,0,0,0,0,1
"020150404","CABA",206,205,1,0,0,1,0.995145631067961
"020143001","CABA",327,325,1,0,0,1,0.99388379204893
"020143105","CABA",251,250,0,1,0,1,0.99601593625498
"020141705","CABA",328,328,0,0,0,0,1
"020141201","CABA",230,229,1,0,0,1,0.995652173913044
"020121513","CABA",262,260,2,0,0,2,0.99236641221374
"020121409","CABA",324,324,0,0,0,0,1
"020151003","CABA",409,407,2,0,0,2,0.995110024449878
"020122008","CABA",365,351,14,0,0,14,0.961643835616438
"020141111","CABA",316,316,0,0,0,0,1
"020141603","CABA",524,524,0,0,0,0,1
"020140705","CABA",260,249,3,0,0,3,0.957692307692308
"020121509","CABA",426,426,0,0,0,0,1
"020150205","CABA",208,208,0,0,0,0,1
"020150501","CABA",303,302,1,0,0,1,0.996699669966997
"020140808","CABA",306,306,0,0,0,0,1
"020143110","CABA",195,194,1,0,0,1,0.994871794871795
"020010201","CABA",161,124,2,8,0,10,0.770186335403727
"020010301","CABA",191,124,20,32,1,53,0.649214659685864
"020010204","CABA",163,155,5,2,0,7,0.950920245398773
"020150401","CABA",337,336,1,0,0,1,0.997032640949555
"020010202","CABA",128,111,9,6,0,15,0.8671875
"020122007","CABA",346,341,0,0,0,0,0.985549132947977
"020141702","CABA",390,390,0,0,0,0,1
"020151005","CABA",277,275,1,0,0,1,0.992779783393502
"020150405","CABA",230,230,0,0,0,0,1
"020140704","CABA",402,400,1,1,0,2,0.995024875621891
"020143003","CABA",407,406,0,0,0,0,0.997542997542998
"020150406","CABA",270,270,0,0,0,0,1
"020010101","CABA",65,60,3,1,1,5,0.923076923076923
"020020203","CABA",229,229,0,0,0,0,1
"020122005","CABA",382,382,0,0,0,0,1
"020143002","CABA",429,429,0,0,0,0,1
"020141205","CABA",380,379,0,1,0,1,0.997368421052632
"020121512","CABA",284,284,0,0,0,0,1
"020151006","CABA",216,212,3,0,0,3,0.981481481481482
"020140809","CABA",476,476,0,0,0,0,1
"020141602","CABA",331,331,0,0,0,0,1
"020143004","CABA",305,305,0,0,0,0,1
"020010302","CABA",161,127,15,12,1,28,0.788819875776398
"020150502","CABA",358,358,0,0,0,0,1
"020150204","CABA",208,206,2,0,0,2,0.990384615384615
"020141206","CABA",264,264,0,0,0,0,1
"020121510","CABA",297,297,0,0,0,0,1
"020141202","CABA",382,357,1,1,0,2,0.934554973821989
"020151007","CABA",402,401,1,0,0,1,0.997512437810945
"020122004","CABA",391,391,0,0,0,0,1
"020140801","CABA",366,366,0,0,0,0,1
"020010203","CABA",104,87,9,3,0,12,0.836538461538462
"020122104","CABA",421,421,0,0,0,0,1
"020143005","CABA",378,378,0,0,0,0,1
"020122202","CABA",362,360,1,0,0,1,0.994475138121547
"020150407","CABA",308,304,1,0,0,1,0.987012987012987
"020142901","CABA",277,276,1,0,0,1,0.996389891696751
"020110101","CABA",324,322,2,0,0,2,0.993827160493827
"020141703","CABA",338,338,0,0,0,0,1
"020151010","CABA",257,231,3,0,0,3,0.898832684824903
"020010322","CABA",205,87,24,81,0,105,0.424390243902439
"020150408","CABA",297,293,1,0,0,1,0.986531986531986
"020010323","CABA",267,172,18,53,4,75,0.644194756554307
"020121511","CABA",272,271,1,0,0,1,0.996323529411765
"020010303","CABA",200,134,23,26,3,52,0.67
"020122201","CABA",294,289,4,1,0,5,0.982993197278912
"020141204","CABA",344,344,0,0,0,0,1
"020132910","CABA",258,258,0,0,0,0,1
"020141211","CABA",274,271,3,0,0,3,0.989051094890511
"020150503","CABA",278,278,0,0,0,0,1
"020010205","CABA",95,89,1,0,0,1,0.936842105263158
"020141708","CABA",623,623,0,0,0,0,1
"020010212","CABA",366,332,3,1,0,4,0.907103825136612
"020150206","CABA",268,264,4,0,0,4,0.985074626865672
"020150504","CABA",235,231,2,0,0,2,0.982978723404255
"020142902","CABA",280,274,0,0,0,0,0.978571428571429
"020141701","CABA",352,352,0,0,0,0,1
"020141203","CABA",329,325,2,2,0,4,0.987841945288754
"020140703","CABA",289,287,1,0,0,1,0.993079584775087
"020141801","CABA",355,355,0,0,0,0,1
"020150203","CABA",292,292,0,0,0,0,1
"020122006","CABA",407,406,1,0,0,1,0.997542997542998
"020151101","CABA",308,286,1,0,0,1,0.928571428571429
"020151004","CABA",337,335,2,0,0,2,0.99406528189911
"020141302","CABA",313,282,5,1,1,7,0.900958466453674
"020140706","CABA",301,300,0,0,0,0,0.996677740863787
"020141207","CABA",145,145,0,0,0,0,1
"020142907","CABA",379,378,0,1,0,1,0.997361477572559
"020020202","CABA",362,362,0,0,0,0,1
"020132909","CABA",208,208,0,0,0,0,1
"020150412","CABA",353,341,3,0,0,3,0.96600566572238
"020122001","CABA",317,315,2,0,0,2,0.993690851735016
"020122103","CABA",360,357,3,0,0,3,0.991666666666667
"020141503","CABA",350,347,3,0,0,3,0.991428571428571
"020010602","CABA",210,210,0,0,0,0,1
"020010206","CABA",215,198,3,2,0,5,0.92093023255814
"020010304","CABA",132,109,7,11,0,18,0.825757575757576
"020122203","CABA",299,297,0,2,0,2,0.993311036789298
"020122003","CABA",411,411,0,0,0,0,1
"020151009","CABA",297,296,1,0,0,1,0.996632996632997
"020142903","CABA",270,270,0,0,0,0,1
"020150505","CABA",301,299,0,0,0,0,0.993355481727575
"020141210","CABA",352,352,0,0,0,0,1
"020010319","CABA",343,298,16,10,0,26,0.868804664723032
"020140707","CABA",240,237,3,0,0,3,0.9875
"020140702","CABA",411,411,0,0,0,0,1
"020143008","CABA",675,672,0,0,0,0,0.995555555555556
"020142906","CABA",448,446,1,0,0,1,0.995535714285714
"020150202","CABA",300,300,0,0,0,0,1
"020151008","CABA",324,318,0,0,0,0,0.981481481481482
"020151102","CABA",358,354,3,0,1,4,0.988826815642458
"020143006","CABA",233,233,0,0,0,0,1
"020141804","CABA",391,391,0,0,0,0,1
"020142905","CABA",280,278,0,1,0,1,0.992857142857143
"020010207","CABA",151,124,4,1,0,5,0.821192052980132
"020141504","CABA",379,373,1,0,0,1,0.984168865435356
"020010320","CABA",115,51,10,48,0,58,0.443478260869565
"020141208","CABA",188,188,0,0,0,0,1
"020051204","CABA",328,328,0,0,0,0,1
"020122204","CABA",299,299,0,0,0,0,1
"020141805","CABA",466,464,1,0,0,1,0.995708154506438
"020143009","CABA",579,578,0,1,0,1,0.998272884283247
"020122105","CABA",297,297,0,0,0,0,1
"020010305","CABA",412,320,41,16,1,58,0.776699029126214
"020010321","CABA",109,95,3,1,0,4,0.871559633027523
"020141502","CABA",351,344,2,0,0,2,0.98005698005698
"020142908","CABA",267,266,1,0,0,1,0.99625468164794
"020150507","CABA",281,280,0,1,0,1,0.99644128113879
"020142904","CABA",358,358,0,0,0,0,1
"020010306","CABA",341,321,3,4,1,8,0.941348973607038
"020143111","CABA",214,214,0,0,0,0,1
"020141209","CABA",327,322,0,0,0,0,0.984709480122324
"020141303","CABA",406,403,3,0,0,3,0.992610837438424
"020141508","CABA",886,882,3,1,0,4,0.99548532731377
"020142909","CABA",336,317,18,0,0,18,0.943452380952381
"020150409","CABA",264,256,0,0,0,0,0.96969696969697
"020031305","CABA",329,328,1,0,0,1,0.996960486322188
"020010317","CABA",182,149,12,13,5,30,0.818681318681319
"020150201","CABA",280,279,1,0,0,1,0.996428571428571
"020151103","CABA",305,302,0,0,0,0,0.99016393442623
"020150908","CABA",727,555,39,98,1,138,0.763411279229711
"020150411","CABA",296,296,0,0,0,0,1
"020122102","CABA",476,434,1,0,0,1,0.911764705882353
"020140709","CABA",275,274,0,1,0,1,0.996363636363636
"020141803","CABA",476,474,2,0,0,2,0.995798319327731
"020151011","CABA",253,250,2,0,0,2,0.988142292490119
"020143007","CABA",204,204,0,0,0,0,1
"020010208","CABA",145,133,3,3,0,6,0.917241379310345
"020150207","CABA",279,276,2,1,0,3,0.989247311827957
"020122106","CABA",326,323,1,1,0,2,0.99079754601227
"020143112","CABA",260,259,0,0,0,0,0.996153846153846
"020150506","CABA",282,269,13,0,0,13,0.953900709219858
"020142911","CABA",281,281,0,0,0,0,1
"020010211","CABA",200,188,3,0,0,3,0.94
"020141505","CABA",443,443,0,0,0,0,1
"020140701","CABA",375,375,0,0,0,0,1
"020141501","CABA",319,319,0,0,0,0,1
"020150413","CABA",328,326,1,1,0,2,0.99390243902439
"020010318","CABA",231,207,5,11,0,16,0.896103896103896
"020010307","CABA",148,137,4,2,0,6,0.925675675675676
"020010213","CABA",162,141,1,1,0,2,0.87037037037037
"020141401","CABA",460,460,0,0,0,0,1
"020141802","CABA",314,312,2,0,0,2,0.993630573248408
"020141507","CABA",348,348,0,0,0,0,1
"020122110","CABA",258,256,2,0,0,2,0.992248062015504
"020141304","CABA",242,238,0,0,0,0,0.983471074380165
"020010210","CABA",88,84,0,2,0,2,0.954545454545455
"020142910","CABA",366,366,0,0,0,0,1
"020151104","CABA",308,307,0,0,0,0,0.996753246753247
"020150208","CABA",236,235,0,0,0,0,0.995762711864407
"020122002","CABA",559,559,0,0,0,0,1
"020122205","CABA",435,434,0,1,0,1,0.997701149425287
"020150410","CABA",257,255,2,0,0,2,0.992217898832685
"020141806","CABA",354,353,1,0,0,1,0.997175141242938
"020110103","CABA",247,245,2,0,0,2,0.991902834008097
"020021104","CABA",668,645,0,0,0,0,0.965568862275449
"020150509","CABA",258,258,0,0,0,0,1
"020021106","CABA",305,305,0,0,0,0,1
"020010316","CABA",254,229,11,3,2,16,0.901574803149606
"020010209","CABA",156,144,3,0,0,3,0.923076923076923
"020141506","CABA",440,425,0,0,0,0,0.965909090909091
"020010314","CABA",147,119,11,10,2,23,0.80952380952381
"020010315","CABA",310,274,8,4,0,12,0.883870967741936
"020010214","CABA",261,241,12,1,0,13,0.923371647509579
"020010313","CABA",118,114,1,2,0,3,0.966101694915254
"020122101","CABA",467,467,0,0,0,0,1
"020141402","CABA",290,290,0,0,0,0,1
"020140708","CABA",239,239,0,0,0,0,1
"020020201","CABA",252,236,13,3,0,16,0.936507936507937
"020141901","CABA",276,276,0,0,0,0,1
"020151012","CABA",338,337,0,0,0,0,0.997041420118343
"020150111","CABA",220,219,1,0,0,1,0.995454545454545
"020010218","CABA",148,141,4,0,0,4,0.952702702702703
"020021101","CABA",621,620,1,0,0,1,0.998389694041868
"020122107","CABA",340,337,3,0,0,3,0.991176470588235
"020141305","CABA",301,301,0,0,0,0,1
"020141807","CABA",282,282,0,0,0,0,1
"020142803","CABA",288,288,0,0,0,0,1
"020122206","CABA",448,448,0,0,0,0,1
"020110102","CABA",339,339,0,0,0,0,1
"020010217","CABA",227,199,17,4,0,21,0.876651982378855
"020010219","CABA",200,177,14,1,0,15,0.885
"020150209","CABA",212,211,1,0,0,1,0.995283018867924
"020010309","CABA",380,343,14,10,0,24,0.902631578947368
"020150512","CABA",272,269,3,0,0,3,0.988970588235294
"020142003","CABA",470,469,1,0,0,1,0.997872340425532
"020141904","CABA",628,627,0,0,0,0,0.998407643312102
"020141902","CABA",529,528,1,0,0,1,0.998109640831758
"020151109","CABA",382,381,1,0,0,1,0.99738219895288
"020010308","CABA",257,240,4,1,2,7,0.933852140077821
"020141808","CABA",489,487,2,0,0,2,0.995910020449898
"020141403","CABA",358,358,0,0,0,0,1
"020150508","CABA",334,332,1,0,0,1,0.994011976047904
"020010216","CABA",444,404,9,3,1,13,0.90990990990991
"020150902","CABA",209,208,0,0,0,0,0.995215311004785
"020142802","CABA",266,265,0,1,0,1,0.996240601503759
"020142804","CABA",314,314,0,0,0,0,1
"020141404","CABA",194,194,0,0,0,0,1
"020010312","CABA",181,154,6,1,5,12,0.850828729281768
"020122109","CABA",286,284,2,0,0,2,0.993006993006993
"020150110","CABA",340,310,2,0,0,2,0.911764705882353
"020010310","CABA",261,238,5,5,0,10,0.911877394636015
"020151013","CABA",364,336,2,1,0,3,0.923076923076923
"020021202","CABA",402,395,7,0,0,7,0.982587064676617
"020020208","CABA",282,280,2,0,0,2,0.99290780141844
"020110105","CABA",221,212,2,0,0,2,0.959276018099548
"020020303","CABA",100,100,0,0,0,0,1
"020150414","CABA",318,299,1,1,0,2,0.940251572327044
"020150210","CABA",233,229,4,0,0,4,0.982832618025751
"020141301","CABA",267,240,3,24,0,27,0.898876404494382
"020142004","CABA",374,374,0,0,0,0,1
"020142801","CABA",299,299,0,0,0,0,1
"020141405","CABA",197,197,0,0,0,0,1
"020122209","CABA",365,365,0,0,0,0,1
"020151108","CABA",276,270,4,0,2,6,0.978260869565217
"020142002","CABA",661,661,0,0,0,0,1
"020021003","CABA",209,209,0,0,0,0,1
"020141903","CABA",546,546,0,0,0,0,1
"020142810","CABA",381,381,0,0,0,0,1
"020142805","CABA",228,221,7,0,0,7,0.969298245614035
"020020403","CABA",149,72,0,0,0,0,0.483221476510067
"020141408","CABA",462,462,0,0,0,0,1
"020010311","CABA",267,242,9,3,0,12,0.906367041198502
"020020204","CABA",205,204,1,0,0,1,0.995121951219512
"020150109","CABA",342,341,1,0,0,1,0.997076023391813
"020020206","CABA",197,195,2,0,0,2,0.989847715736041
"020142811","CABA",392,392,0,0,0,0,1
"020021203","CABA",457,455,1,0,0,1,0.99562363238512
"020150901","CABA",228,228,0,0,0,0,1
"020021105","CABA",169,168,1,0,0,1,0.994082840236686
"020021201","CABA",435,435,0,0,0,0,1
"020020401","CABA",313,313,0,0,0,0,1
"020141306","CABA",278,278,0,0,0,0,1
"020142806","CABA",413,413,0,0,0,0,1
"020142601","CABA",526,525,1,0,0,1,0.998098859315589
"020141406","CABA",202,202,0,0,0,0,1
"020142809","CABA",263,263,0,0,0,0,1
"020020205","CABA",259,259,0,0,0,0,1
"020110106","CABA",278,277,1,0,0,1,0.996402877697842
"020141308","CABA",275,269,5,0,0,5,0.978181818181818
"020021004","CABA",344,344,0,0,0,0,1
"020150112","CABA",283,268,12,3,0,15,0.946996466431095
"020150513","CABA",289,289,0,0,0,0,1
"020142001","CABA",604,604,0,0,0,0,1
"020142005","CABA",375,370,1,0,0,1,0.986666666666667
"020141409","CABA",483,482,0,0,0,0,0.997929606625259
"020021002","CABA",366,366,0,0,0,0,1
"020122108","CABA",319,315,3,0,0,3,0.987460815047022
"020141407","CABA",210,210,0,0,0,0,1
"020150108","CABA",276,276,0,0,0,0,1
"020020207","CABA",141,141,0,0,0,0,1
"020020408","CABA",427,424,0,0,0,0,0.992974238875878
"020142807","CABA",374,371,3,0,0,3,0.991978609625668
"020142602","CABA",357,356,0,0,0,0,0.997198879551821
"020021204","CABA",704,703,0,0,0,0,0.998579545454545
"020151106","CABA",266,262,4,0,0,4,0.984962406015038
"020021206","CABA",498,498,0,0,0,0,1
"020151111","CABA",531,529,2,0,0,2,0.99623352165725
"020142812","CABA",270,269,1,0,0,1,0.996296296296296
"020150105","CABA",268,267,0,1,0,1,0.996268656716418
"020150514","CABA",261,261,0,0,0,0,1
"020150701","CABA",300,299,0,0,0,0,0.996666666666667
"020122207","CABA",459,457,2,0,0,2,0.995642701525055
"020021009","CABA",299,299,0,0,0,0,1
"020020402","CABA",109,109,0,0,0,0,1
"020142808","CABA",302,302,0,0,0,0,1
"020142006","CABA",275,275,0,0,0,0,1
"020141410","CABA",349,349,0,0,0,0,1
"020142106","CABA",246,245,1,0,0,1,0.995934959349594
"020150510","CABA",224,223,1,0,0,1,0.995535714285714
"020151110","CABA",268,266,2,0,0,2,0.992537313432836
"020020409","CABA",333,331,0,0,0,0,0.993993993993994
"020142606","CABA",387,384,3,0,0,3,0.992248062015504
"020142603","CABA",184,184,0,0,0,0,1
"020151107","CABA",258,254,4,0,0,4,0.984496124031008
"020020407","CABA",235,235,0,0,0,0,1
"020141307","CABA",147,147,0,0,0,0,1
"020020301","CABA",399,399,0,0,0,0,1
"020021006","CABA",321,321,0,0,0,0,1
"020150107","CABA",290,290,0,0,0,0,1
"020141309","CABA",337,335,2,0,0,2,0.99406528189911
"020142007","CABA",168,168,0,0,0,0,1
"020021205","CABA",615,615,0,0,0,0,1
"020022302","CABA",512,512,0,0,0,0,1
"020122210","CABA",370,368,1,0,0,1,0.994594594594595
"020142502","CABA",216,216,0,0,0,0,1
"020150511","CABA",274,269,2,1,2,5,0.981751824817518
"020142607","CABA",532,531,1,0,0,1,0.99812030075188
"020022306","CABA",203,203,0,0,0,0,1
"020020902","CABA",218,218,0,0,0,0,1
"020142107","CABA",309,308,1,0,0,1,0.996763754045307
"020141411","CABA",411,411,0,0,0,0,1
"020142105","CABA",158,156,2,0,0,2,0.987341772151899
"020021007","CABA",483,482,1,0,0,1,0.997929606625259
"020110107","CABA",252,252,0,0,0,0,1
"020020501","CABA",256,254,2,0,0,2,0.9921875
"020141311","CABA",260,258,1,1,0,2,0.992307692307692
"020110202","CABA",361,357,4,0,0,4,0.988919667590028
"020020406","CABA",212,211,0,0,0,0,0.995283018867924
"020021303","CABA",516,516,0,0,0,0,1
"020142504","CABA",285,285,0,0,0,0,1
"020020404","CABA",195,195,0,0,0,0,1
"020022303","CABA",441,441,0,0,0,0,1
"020010401","CABA",663,661,2,0,0,2,0.996983408748115
"020020304","CABA",188,188,0,0,0,0,1
"020142703","CABA",284,283,0,0,0,0,0.996478873239437
"020142108","CABA",323,322,1,0,0,1,0.996904024767802
"020142503","CABA",353,353,0,0,0,0,1
"020142605","CABA",458,457,1,0,0,1,0.997816593886463
"020021301","CABA",595,593,2,0,0,2,0.996638655462185
"020022305","CABA",295,295,0,0,0,0,1
"020151113","CABA",364,360,3,0,0,3,0.989010989010989
"020022307","CABA",237,237,0,0,0,0,1
"020150106","CABA",257,257,0,0,0,0,1
"020110109","CABA",304,301,3,0,0,3,0.990131578947368
"020122208","CABA",365,363,0,0,0,0,0.994520547945206
"020151201","CABA",277,272,0,1,1,2,0.981949458483754
"020142505","CABA",239,239,0,0,0,0,1
"020142704","CABA",396,396,0,0,0,0,1
"020141310","CABA",294,294,0,0,0,0,1
"020020306","CABA",274,257,0,0,0,0,0.937956204379562
"020151202","CABA",283,279,1,0,0,1,0.985865724381625
"020020903","CABA",451,451,0,0,0,0,1
"020020405","CABA",284,284,0,0,0,0,1
"020010402","CABA",616,615,0,0,0,0,0.998376623376623
"020021306","CABA",382,380,0,0,0,0,0.994764397905759
"020020503","CABA",255,255,0,0,0,0,1
"020021304","CABA",555,555,0,0,0,0,1
"020142701","CABA",616,615,0,0,0,0,0.998376623376623
"020020901","CABA",399,399,0,0,0,0,1
"020022308","CABA",187,187,0,0,0,0,1
"020020305","CABA",293,291,2,0,0,2,0.993174061433447
"020142506","CABA",277,277,0,0,0,0,1
"020151112","CABA",376,376,0,0,0,0,1
"020110201","CABA",286,283,1,0,0,1,0.989510489510489
"020142203","CABA",233,233,0,0,0,0,1
"020110203","CABA",286,286,0,0,0,0,1
"020020803","CABA",457,457,0,0,0,0,1
"020022403","CABA",335,335,0,0,0,0,1
"020142109","CABA",266,263,3,0,0,3,0.988721804511278
"020150101","CABA",417,416,0,0,0,0,0.997601918465228
"020150104","CABA",237,234,2,0,1,3,0.987341772151899
"020022204","CABA",483,483,0,0,0,0,1
"020142402","CABA",232,231,0,1,0,1,0.995689655172414
"020010601","CABA",326,311,15,0,0,15,0.95398773006135
"020142208","CABA",340,338,1,0,0,1,0.994117647058824
"020150903","CABA",230,230,0,0,0,0,1
"020022202","CABA",281,281,0,0,0,0,1
"020122211","CABA",371,369,2,0,0,2,0.994609164420485
"020142102","CABA",303,301,0,0,0,0,0.993399339933993
"020142705","CABA",487,487,0,0,0,0,1
"020142508","CABA",355,354,1,0,0,1,0.997183098591549
"020110110","CABA",340,339,1,0,0,1,0.997058823529412
"020150702","CABA",244,242,1,0,0,1,0.991803278688525
"020142204","CABA",240,240,0,0,0,0,1
"020010501","CABA",257,257,0,0,0,0,1
"020010403","CABA",469,467,2,0,0,2,0.995735607675906
"020021307","CABA",634,629,0,0,0,0,0.99211356466877
"020020905","CABA",488,488,0,0,0,0,1
"020010405","CABA",384,384,0,0,0,0,1
"020022201","CABA",368,367,0,0,1,1,0.997282608695652
"020142401","CABA",301,293,8,0,0,8,0.973421926910299
"020022406","CABA",468,466,2,0,0,2,0.995726495726496
"020020505","CABA",324,324,0,0,0,0,1
"020020507","CABA",329,313,0,0,0,0,0.951367781155015
"020020804","CABA",478,477,0,0,0,0,0.997907949790795
"020150102","CABA",344,341,3,0,0,3,0.991279069767442
"020020308","CABA",234,234,0,0,0,0,1
"020020909","CABA",550,548,0,0,0,0,0.996363636363636
"020022401","CABA",450,450,0,0,0,0,1
"020020802","CABA",306,306,0,0,0,0,1
"020110204","CABA",223,221,2,0,0,2,0.991031390134529
"020110112","CABA",266,263,2,0,0,2,0.988721804511278
"020021401","CABA",248,248,0,0,0,0,1
"020150905","CABA",249,248,1,0,0,1,0.995983935742972
"020142707","CABA",217,216,0,0,0,0,0.995391705069124
"020142404","CABA",210,208,2,0,0,2,0.990476190476191
"020010603","CABA",426,424,2,0,0,2,0.995305164319249
"020151301","CABA",304,298,5,0,0,5,0.980263157894737
"020110205","CABA",389,388,0,0,0,0,0.997429305912596
"020151205","CABA",333,332,0,0,0,0,0.996996996996997
"020142202","CABA",407,402,3,0,0,3,0.987714987714988
"020142301","CABA",281,280,1,0,0,1,0.99644128113879
"020151203","CABA",309,307,2,0,0,2,0.993527508090615
"020020906","CABA",441,441,0,0,0,0,1
"020010406","CABA",486,484,1,0,0,1,0.995884773662551
"020022404","CABA",464,452,0,0,0,0,0.974137931034483
"020022101","CABA",462,461,1,0,0,1,0.997835497835498
"020022206","CABA",557,556,1,0,0,1,0.998204667863555
"020020908","CABA",649,648,1,0,0,1,0.998459167950693
"020142706","CABA",212,212,0,0,0,0,1
"020142405","CABA",436,436,0,0,0,0,1
"020142407","CABA",331,330,1,0,0,1,0.996978851963746
"020010408","CABA",451,451,0,0,0,0,1
"020020805","CABA",413,412,1,0,0,1,0.997578692493947
"020020506","CABA",328,327,0,0,0,0,0.996951219512195
"020151206","CABA",308,304,2,0,0,2,0.987012987012987
"020020808","CABA",357,357,0,0,0,0,1
"020021402","CABA",306,305,0,0,1,1,0.996732026143791
"020150703","CABA",230,221,9,0,0,9,0.960869565217391
"020022405","CABA",506,506,0,0,0,0,1
"020142110","CABA",252,242,0,0,0,0,0.96031746031746
"020020801","CABA",347,347,0,0,0,0,1
"020151204","CABA",324,323,1,0,0,1,0.996913580246914
"020142111","CABA",284,278,5,1,0,6,0.97887323943662
"020150704","CABA",216,210,6,0,0,6,0.972222222222222
"020142302","CABA",218,218,0,0,0,0,1
"020142205","CABA",423,399,0,0,0,0,0.943262411347518
"020010604","CABA",397,397,0,0,0,0,1
"020150606","CABA",183,183,0,0,0,0,1
"020010702","CABA",117,117,0,0,0,0,1
"020142408","CABA",267,267,0,0,0,0,1
"020020907","CABA",472,472,0,0,0,0,1
"020021501","CABA",266,266,0,0,0,0,1
"020142406","CABA",343,343,0,0,0,0,1
"020022102","CABA",442,442,0,0,0,0,1
"020022501","CABA",312,312,0,0,0,0,1
"020150605","CABA",192,189,3,0,0,3,0.984375
"020151302","CABA",257,236,4,0,0,4,0.918287937743191
"020150904","CABA",253,252,0,1,0,1,0.99604743083004
"020010407","CABA",549,546,1,2,0,3,0.994535519125683
"020021403","CABA",175,174,1,0,0,1,0.994285714285714
"020021407","CABA",348,331,0,1,0,1,0.951149425287356
"020010503","CABA",405,405,0,0,0,0,1
"020020601","CABA",175,175,0,0,0,0,1
"020020509","CABA",271,271,0,0,0,0,1
"020020806","CABA",625,623,1,1,0,2,0.9968
"020020701","CABA",573,573,0,0,0,0,1
"020020807","CABA",707,704,2,0,0,2,0.995756718528996
"020142206","CABA",415,415,0,0,0,0,1
"020151502","CABA",235,232,3,0,0,3,0.987234042553191
"020021502","CABA",388,388,0,0,0,0,1
"020022502","CABA",349,349,0,0,0,0,1
"020021404","CABA",369,369,0,0,0,0,1
"020110111","CABA",402,401,0,1,0,1,0.997512437810945
"020142210","CABA",336,330,5,0,0,5,0.982142857142857
"020020704","CABA",267,267,0,0,0,0,1
"020010713","CABA",64,64,0,0,0,0,1
"020151207","CABA",235,234,0,1,0,1,0.995744680851064
"020022504","CABA",427,425,2,0,0,2,0.995316159250585
"020010605","CABA",169,169,0,0,0,0,1
"020151304","CABA",262,260,2,0,0,2,0.99236641221374
"020142409","CABA",348,347,1,0,0,1,0.997126436781609
"020151208","CABA",373,373,0,0,0,0,1
"020150604","CABA",250,249,1,0,0,1,0.996
"020152012","CABA",342,342,0,0,0,0,1
"020010502","CABA",240,240,0,0,0,0,1
"020150705","CABA",293,290,3,0,0,3,0.989761092150171
"020142201","CABA",368,366,1,1,0,2,0.994565217391304
"020021406","CABA",532,529,0,0,0,0,0.994360902255639
"020150603","CABA",286,286,0,0,0,0,1
"020021408","CABA",380,378,2,0,0,2,0.994736842105263
"020021503","CABA",630,630,0,0,0,0,1
"020142303","CABA",243,242,1,0,0,1,0.995884773662551
"020021505","CABA",267,267,0,0,0,0,1
"020142304","CABA",368,368,0,0,0,0,1
"020150601","CABA",291,291,0,0,0,0,1
"020110206","CABA",358,358,0,0,0,0,1
"020022104","CABA",530,529,1,0,0,1,0.99811320754717
"020020702","CABA",493,493,0,0,0,0,1
"020022503","CABA",177,177,0,0,0,0,1
"020152011","CABA",344,343,1,0,0,1,0.997093023255814
"020150906","CABA",213,212,0,0,1,1,0.995305164319249
"020021405","CABA",499,497,1,0,0,1,0.995991983967936
"020022505","CABA",469,468,0,0,0,0,0.997867803837953
"020021601","CABA",321,321,0,0,0,0,1
"020021504","CABA",310,310,0,0,0,0,1
"020022105","CABA",508,506,2,0,0,2,0.996062992125984
"020020602","CABA",572,572,0,0,0,0,1
"020010504","CABA",490,490,0,0,0,0,1
"020150602","CABA",285,285,0,0,0,0,1
"020010606","CABA",252,249,2,0,0,2,0.988095238095238
"020142207","CABA",322,319,3,0,0,3,0.990683229813665
"020110303","CABA",240,240,0,0,0,0,1
"020021409","CABA",605,604,0,0,0,0,0.998347107438017
"020021506","CABA",286,286,0,0,0,0,1
"020110306","CABA",287,287,0,0,0,0,1
"020152009","CABA",225,224,0,0,0,0,0.995555555555556
"020110308","CABA",299,297,2,0,0,2,0.993311036789298
"020151305","CABA",212,212,0,0,0,0,1
"020021603","CABA",305,304,1,0,0,1,0.99672131147541
"020022106","CABA",481,481,0,0,0,0,1
"020150907","CABA",270,261,3,0,0,3,0.966666666666667
"020110302","CABA",292,292,0,0,0,0,1
"020010703","CABA",126,126,0,0,0,0,1
"020151310","CABA",297,296,1,0,0,1,0.996632996632997
"020021410","CABA",537,537,0,0,0,0,1
"020110307","CABA",283,273,2,1,0,3,0.964664310954064
"020020703","CABA",361,359,1,0,0,1,0.994459833795014
"020152008","CABA",268,267,1,0,0,1,0.996268656716418
"020021901","CABA",393,393,0,0,0,0,1
"020021508","CABA",339,338,0,0,0,0,0.997050147492625
"020151401","CABA",364,362,1,0,1,2,0.994505494505495
"020151504","CABA",352,351,1,0,0,1,0.997159090909091
"020021801","CABA",458,458,0,0,0,0,1
"020020604","CABA",333,333,0,0,0,0,1
"020110211","CABA",328,327,1,0,0,1,0.996951219512195
"020010507","CABA",270,269,1,0,0,1,0.996296296296296
"020152103","CABA",293,292,0,0,0,0,0.996587030716723
"020021606","CABA",318,318,0,0,0,0,1
"020151505","CABA",297,296,0,0,0,0,0.996632996632997
"020010506","CABA",365,364,1,0,0,1,0.997260273972603
"020021605","CABA",386,383,0,0,0,0,0.992227979274611
"020021902","CABA",306,306,0,0,0,0,1
"020010505","CABA",242,242,0,0,0,0,1
"020021802","CABA",548,538,0,0,0,0,0.981751824817518
"020021608","CABA",196,194,1,0,0,1,0.989795918367347
"020020603","CABA",226,226,0,0,0,0,1
"020150607","CABA",255,253,2,0,0,2,0.992156862745098
"020022003","CABA",372,368,2,0,0,2,0.989247311827957
"020110207","CABA",312,312,0,0,0,0,1
"020151402","CABA",386,381,5,0,0,5,0.987046632124352
"020151309","CABA",462,426,1,0,0,1,0.922077922077922
"020020705","CABA",244,244,0,0,0,0,1
"020022006","CABA",356,354,0,0,0,0,0.99438202247191
"020110304","CABA",210,210,0,0,0,0,1
"020110301","CABA",264,264,0,0,0,0,1
"020142309","CABA",492,492,0,0,0,0,1
"020150706","CABA",321,171,9,73,4,86,0.532710280373832
"020010701","CABA",264,264,0,0,0,0,1
"020022509","CABA",411,411,0,0,0,0,1
"020021701","CABA",571,568,3,0,0,3,0.994746059544658
"020152005","CABA",274,271,1,0,0,1,0.989051094890511
"020021905","CABA",361,360,1,0,0,1,0.997229916897507
"020010804","CABA",295,295,0,0,0,0,1
"020110309","CABA",298,298,0,0,0,0,1
"020022005","CABA",251,250,1,0,0,1,0.99601593625498
"020110907","CABA",312,312,0,0,0,0,1
"020021702","CABA",382,382,0,0,0,0,1
"020150802","CABA",237,223,3,0,0,3,0.940928270042194
"020010803","CABA",448,446,0,1,0,1,0.995535714285714
"020150801","CABA",336,333,2,1,0,3,0.991071428571429
"020011314","CABA",659,85,66,452,22,540,0.128983308042489
"020152007","CABA",289,289,0,0,0,0,1
"020151408","CABA",326,318,6,0,0,6,0.975460122699387
"020110908","CABA",331,331,0,0,0,0,1
"020111001","CABA",315,315,0,0,0,0,1
"020021805","CABA",250,250,0,0,0,0,1
"020152113","CABA",389,389,0,0,0,0,1
"020142209","CABA",500,500,0,0,0,0,1
"020010801","CABA",188,187,0,0,0,0,0.99468085106383
"020021704","CABA",168,167,0,0,0,0,0.994047619047619
"020111002","CABA",384,382,2,0,0,2,0.994791666666667
"020020606","CABA",320,319,1,0,0,1,0.996875
"020020605","CABA",183,183,0,0,0,0,1
"020020707","CABA",409,409,0,0,0,0,1
"020110208","CABA",302,274,0,0,0,0,0.907284768211921
"020020708","CABA",172,170,0,2,0,2,0.988372093023256
"020110404","CABA",296,296,0,0,0,0,1
"020021904","CABA",499,499,0,0,0,0,1
"020152102","CABA",374,373,1,0,0,1,0.997326203208556
"020022004","CABA",386,385,1,0,0,1,0.99740932642487
"020022007","CABA",247,247,0,0,0,0,1
"020152004","CABA",278,278,0,0,0,0,1
"020110906","CABA",248,248,0,0,0,0,1
"020111006","CABA",458,458,0,0,0,0,1
"020142310","CABA",378,376,2,0,0,2,0.994708994708995
"020150804","CABA",330,330,0,0,0,0,1
"020021804","CABA",267,265,1,0,0,1,0.99250936329588
"020152112","CABA",217,216,1,0,0,1,0.995391705069124
"020152006","CABA",321,321,0,0,0,0,1
"020111008","CABA",318,318,0,0,0,0,1
"020151409","CABA",347,347,0,0,0,0,1
"020110305","CABA",233,228,5,0,0,5,0.978540772532189
"020022510","CABA",299,299,0,0,0,0,1
"020021806","CABA",367,366,1,0,0,1,0.997275204359673
"020010704","CABA",278,277,0,0,0,0,0.996402877697842
"020021907","CABA",324,321,0,0,0,0,0.990740740740741
"020010706","CABA",80,80,0,0,0,0,1
"020010705","CABA",147,146,0,0,1,1,0.993197278911565
"020022511","CABA",501,501,0,0,0,0,1
"020010707","CABA",249,249,0,0,0,0,1
"020111003","CABA",317,315,1,0,0,1,0.993690851735016
"020010708","CABA",240,239,1,0,0,1,0.995833333333333
"020151405","CABA",421,419,2,0,0,2,0.995249406175772
"020151404","CABA",308,284,0,0,0,0,0.922077922077922
"020152001","CABA",347,346,1,0,0,1,0.997118155619596
"020010805","CABA",214,210,3,1,0,4,0.981308411214953
"020022008","CABA",301,301,0,0,0,0,1
"020111005","CABA",386,381,0,0,0,0,0.987046632124352
"020151506","CABA",311,307,4,0,0,4,0.987138263665595
"020152105","CABA",201,201,0,0,0,0,1
"020111007","CABA",401,401,0,0,0,0,1
"020110905","CABA",308,308,0,0,0,0,1
"020152003","CABA",346,346,0,0,0,0,1
"020152111","CABA",335,331,0,0,0,0,0.988059701492537
"020110310","CABA",317,317,0,0,0,0,1
"020010806","CABA",572,572,0,0,0,0,1
"020110210","CABA",348,348,0,0,0,0,1
"020021908","CABA",377,376,1,0,0,1,0.997347480106101
"020010807","CABA",561,561,0,0,0,0,1
"020111010","CABA",281,281,0,0,0,0,1
"020020607","CABA",175,174,1,0,0,1,0.994285714285714
"020021707","CABA",577,577,0,0,0,0,1
"020020608","CABA",219,213,0,0,0,0,0.972602739726027
"020021705","CABA",290,288,2,0,0,2,0.993103448275862
"020020709","CABA",278,278,0,0,0,0,1
"020021706","CABA",452,451,1,0,0,1,0.997787610619469
"020152101","CABA",320,318,2,0,0,2,0.99375
"020050106","CABA",209,203,0,0,0,0,0.971291866028708
"020050104","CABA",314,313,0,0,0,0,0.996815286624204
"020050105","CABA",472,472,0,0,0,0,1
"020151407","CABA",392,390,0,0,0,0,0.994897959183674
"020021807","CABA",277,276,1,0,0,1,0.996389891696751
"020050103","CABA",361,359,0,2,0,2,0.994459833795014
"020050201","CABA",336,333,2,0,0,2,0.991071428571429
"020152106","CABA",418,417,0,0,0,0,0.997607655502392
"020050102","CABA",411,410,0,1,0,1,0.997566909975669
"020110911","CABA",258,257,0,0,0,0,0.996124031007752
"020151803","CABA",310,308,0,0,0,0,0.993548387096774
"020050203","CABA",325,324,1,0,0,1,0.996923076923077
"020152002","CABA",366,365,0,0,0,0,0.997267759562842
"020110904","CABA",255,255,0,0,0,0,1
"020110909","CABA",246,243,2,0,0,2,0.98780487804878
"020030101","CABA",488,486,2,0,0,2,0.995901639344262
"020010710","CABA",232,231,0,1,0,1,0.995689655172414
"020050107","CABA",302,302,0,0,0,0,1
"020150808","CABA",323,321,1,0,0,1,0.993808049535604
"020010709","CABA",183,183,0,0,0,0,1
"020150803","CABA",373,371,2,0,0,2,0.994638069705094
"020030102","CABA",419,416,2,0,0,2,0.992840095465394
"020111004","CABA",364,364,0,0,0,0,1
"020030103","CABA",467,467,0,0,0,0,1
"020030201","CABA",323,323,0,0,0,0,1
"020030202","CABA",333,332,1,0,0,1,0.996996996996997
"020030301","CABA",476,475,1,0,0,1,0.997899159663866
"020151507","CABA",361,324,9,0,0,9,0.897506925207756
"020010810","CABA",186,186,0,0,0,0,1
"020151903","CABA",310,307,0,0,0,0,0.990322580645161
"020050101","CABA",253,251,2,0,0,2,0.992094861660079
"020110903","CABA",379,377,2,0,0,2,0.994722955145119
"020150708","CABA",328,324,4,0,0,4,0.98780487804878
"020111009","CABA",319,319,0,0,0,0,1
"020110405","CABA",308,308,0,0,0,0,1
"020011301","CABA",163,163,0,0,0,0,1
"020110403","CABA",221,219,1,0,0,1,0.990950226244344
"020110910","CABA",352,352,0,0,0,0,1
"020021708","CABA",489,478,2,0,0,2,0.977505112474438
"020151411","CABA",376,373,2,0,0,2,0.992021276595745
"020050109","CABA",349,348,0,1,0,1,0.997134670487106
"020050202","CABA",270,270,0,0,0,0,1
"020150707","CABA",351,348,3,0,0,3,0.991452991452991
"020010913","CABA",201,200,1,0,0,1,0.995024875621891
"020151902","CABA",335,335,0,0,0,0,1
"020110311","CABA",254,254,0,0,0,0,1
"020030303","CABA",260,259,1,0,0,1,0.996153846153846
"020021709","CABA",366,366,0,0,0,0,1
"020010911","CABA",116,116,0,0,0,0,1
"020151508","CABA",260,254,6,0,0,6,0.976923076923077
"020010910","CABA",108,106,1,1,0,2,0.981481481481482
"020151904","CABA",343,343,0,0,0,0,1
"020110209","CABA",238,210,0,0,0,0,0.882352941176471
"020050206","CABA",258,255,3,0,0,3,0.988372093023256
"020150810","CABA",382,381,1,0,0,1,0.99738219895288
"020150709","CABA",283,283,0,0,0,0,1
"020151701","CABA",323,322,1,0,0,1,0.996904024767802
"020010904","CABA",134,133,1,0,0,1,0.992537313432836
"020010903","CABA",195,178,0,5,0,5,0.912820512820513
"020151510","CABA",413,402,4,0,0,4,0.973365617433414
"020050211","CABA",394,394,0,0,0,0,1
"020151802","CABA",213,213,0,0,0,0,1
"020151804","CABA",209,209,0,0,0,0,1
"020050501","CABA",348,347,1,0,0,1,0.997126436781609
"020030104","CABA",248,248,0,0,0,0,1
"020111104","CABA",102,102,0,0,0,0,1
"020050209","CABA",339,336,0,0,0,0,0.991150442477876
"020050504","CABA",288,288,0,0,0,0,1
"020010901","CABA",161,161,0,0,0,0,1
"020011302","CABA",60,60,0,0,0,0,1
"020011001","CABA",120,120,0,0,0,0,1
"020030403","CABA",279,279,0,0,0,0,1
"020030204","CABA",288,286,2,0,0,2,0.993055555555556
"020011002","CABA",278,278,0,0,0,0,1
"020030203","CABA",336,335,1,0,0,1,0.99702380952381
"020151905","CABA",383,383,0,0,0,0,1
"020011003","CABA",515,507,1,0,0,1,0.984466019417476
"020111101","CABA",293,293,0,0,0,0,1
"020111103","CABA",325,322,1,0,0,1,0.990769230769231
"020030501","CABA",373,373,0,0,0,0,1
"020150807","CABA",357,354,3,0,0,3,0.991596638655462
"020111301","CABA",346,346,0,0,0,0,1
"020030306","CABA",302,302,0,0,0,0,1
"020030507","CABA",368,368,0,0,0,0,1
"020050210","CABA",301,262,2,0,0,2,0.870431893687708
"020050506","CABA",315,315,0,0,0,0,1
"020030506","CABA",215,215,0,0,0,0,1
"020151911","CABA",383,383,0,0,0,0,1
"020050110","CABA",312,312,0,0,0,0,1
"020030505","CABA",330,328,0,0,0,0,0.993939393939394
"020050207","CABA",246,233,0,0,0,0,0.947154471544715
"020151901","CABA",230,229,0,0,0,0,0.995652173913044
"020151602","CABA",327,327,0,0,0,0,1
"020111203","CABA",360,359,1,0,0,1,0.997222222222222
"020030305","CABA",245,245,0,0,0,0,1
"020050507","CABA",422,422,0,0,0,0,1
"020152108","CABA",261,261,0,0,0,0,1
"020010912","CABA",76,76,0,0,0,0,1
"020030304","CABA",213,213,0,0,0,0,1
"020111201","CABA",233,233,0,0,0,0,1
"020150710","CABA",379,377,2,0,0,2,0.994722955145119
"020151702","CABA",271,270,0,1,0,1,0.996309963099631
"020030402","CABA",216,215,0,0,0,0,0.99537037037037
"020050401","CABA",420,417,3,0,0,3,0.992857142857143
"020030106","CABA",262,262,0,0,0,0,1
"020151805","CABA",215,215,0,0,0,0,1
"020110902","CABA",312,312,0,0,0,0,1
"020151906","CABA",338,335,2,0,0,2,0.99112426035503
"020010906","CABA",175,172,3,0,0,3,0.982857142857143
"020111303","CABA",321,321,0,0,0,0,1
"020110901","CABA",315,314,0,1,0,1,0.996825396825397
"020030105","CABA",374,370,3,0,0,3,0.989304812834225
"020010905","CABA",192,191,1,0,0,1,0.994791666666667
"020050402","CABA",347,345,2,0,0,2,0.994236311239193
"020050502","CABA",592,591,1,0,0,1,0.998310810810811
"020111302","CABA",387,387,0,0,0,0,1
"020030205","CABA",369,369,0,0,0,0,1
"020110804","CABA",329,329,0,0,0,0,1
"020151603","CABA",388,363,0,0,0,0,0.935567010309278
"020050403","CABA",319,317,1,0,0,1,0.993730407523511
"020150809","CABA",433,427,5,0,0,5,0.986143187066975
"020150712","CABA",348,346,2,0,0,2,0.994252873563218
"020151910","CABA",412,412,0,0,0,0,1
"020050503","CABA",370,370,0,0,0,0,1
"020110312","CABA",282,282,0,0,0,0,1
"020150805","CABA",285,281,3,0,0,3,0.985964912280702
"020010902","CABA",193,192,0,0,0,0,0.994818652849741
"020151703","CABA",368,368,0,0,0,0,1
"020030307","CABA",308,295,12,0,0,12,0.957792207792208
"020111102","CABA",309,309,0,0,0,0,1
"020011008","CABA",153,152,1,0,0,1,0.993464052287582
"020151806","CABA",210,210,0,0,0,0,1
"020110803","CABA",210,210,0,0,0,0,1
"020151807","CABA",316,290,26,0,0,26,0.917721518987342
"020011007","CABA",159,158,0,0,0,0,0.993710691823899
"020030308","CABA",263,263,0,0,0,0,1
"020011006","CABA",265,255,0,0,0,0,0.962264150943396
"020010914","CABA",148,147,1,0,0,1,0.993243243243243
"020011005","CABA",236,230,0,0,0,0,0.974576271186441
"020110406","CABA",241,241,0,0,0,0,1
"020011303","CABA",20,20,0,0,0,0,1
"020151809","CABA",222,222,0,0,0,0,1
"020030309","CABA",159,159,0,0,0,0,1
"020050208","CABA",433,433,0,0,0,0,1
"020050505","CABA",244,243,1,0,0,1,0.995901639344262
"020112101","CABA",323,306,1,1,0,2,0.947368421052632
"020030504","CABA",262,262,0,0,0,0,1
"020030206","CABA",367,366,1,0,0,1,0.997275204359673
"020030404","CABA",326,326,0,0,0,0,1
"020151907","CABA",374,374,0,0,0,0,1
"020030503","CABA",469,468,1,0,0,1,0.997867803837953
"020030502","CABA",291,291,0,0,0,0,1
"020111305","CABA",393,391,2,0,0,2,0.994910941475827
"020050508","CABA",324,324,0,0,0,0,1
"020110409","CABA",309,308,0,1,0,1,0.996763754045307
"020030107","CABA",347,317,0,0,0,0,0.913544668587896
"020151909","CABA",286,286,0,0,0,0,1
"020111105","CABA",335,335,0,0,0,0,1
"020010915","CABA",118,105,0,0,0,0,0.889830508474576
"020050301","CABA",320,319,0,0,0,0,0.996875
"020150806","CABA",260,258,1,0,0,1,0.992307692307692
"020050409","CABA",337,323,0,0,0,0,0.958456973293769
"020110802","CABA",338,338,0,0,0,0,1
"020010916","CABA",337,333,4,0,0,4,0.98813056379822
"020150711","CABA",329,324,4,1,0,5,0.984802431610942
"020111109","CABA",296,296,0,0,0,0,1
"020151509","CABA",430,429,1,0,0,1,0.997674418604651
"020111204","CABA",272,272,0,0,0,0,1
"020050408","CABA",516,510,6,0,0,6,0.988372093023256
"020110402","CABA",297,297,0,0,0,0,1
"020110401","CABA",284,284,0,0,0,0,1
"020151704","CABA",409,407,1,1,0,2,0.995110024449878
"020030207","CABA",420,420,0,0,0,0,1
"020050302","CABA",507,441,2,0,0,2,0.869822485207101
"020110502","CABA",316,314,2,0,0,2,0.993670886075949
"020050407","CABA",253,251,2,0,0,2,0.992094861660079
"020110413","CABA",327,327,0,0,0,0,1
"020151908","CABA",294,294,0,0,0,0,1
"020050604","CABA",660,659,0,0,0,0,0.998484848484849
"020011009","CABA",161,157,0,1,0,1,0.975155279503106
"020030109","CABA",227,226,1,0,0,1,0.995594713656388
"020030310","CABA",393,388,0,0,0,0,0.987277353689567
"020011010","CABA",296,296,0,0,0,0,1
"020050405","CABA",331,330,1,0,0,1,0.996978851963746
"020112104","CABA",318,312,5,0,0,5,0.981132075471698
"020111306","CABA",373,371,2,0,0,2,0.994638069705094
"020011011","CABA",351,351,0,0,0,0,1
"020112002","CABA",317,315,2,0,0,2,0.993690851735016
"020050605","CABA",558,558,0,0,0,0,1
"020030405","CABA",288,287,0,0,0,0,0.996527777777778
"020030603","CABA",312,312,0,0,0,0,1
"020151708","CABA",270,270,0,0,0,0,1
"020050702","CABA",222,214,0,0,0,0,0.963963963963964
"020030602","CABA",175,174,1,0,0,1,0.994285714285714
"020030406","CABA",308,308,0,0,0,0,1
"020030601","CABA",354,354,0,0,0,0,1
"020151607","CABA",316,314,0,1,0,1,0.993670886075949
"020060701","CABA",280,280,0,0,0,0,1
"020151601","CABA",355,344,1,0,0,1,0.969014084507042
"020010919","CABA",61,61,0,0,0,0,1
"020111206","CABA",320,320,0,0,0,0,1
"020110412","CABA",352,352,0,0,0,0,1
"020110501","CABA",242,242,0,0,0,0,1
"020110801","CABA",347,345,2,0,0,2,0.994236311239193
"020110805","CABA",265,265,0,0,0,0,1
"020060703","CABA",278,276,0,0,0,0,0.992805755395683
"020050801","CABA",547,522,4,0,0,4,0.954296160877514
"020151811","CABA",294,294,0,0,0,0,1
"020151813","CABA",254,254,0,0,0,0,1
"020010918","CABA",169,169,0,0,0,0,1
"020112102","CABA",271,270,0,0,0,0,0.996309963099631
"020151711","CABA",356,356,0,0,0,0,1
"020010917","CABA",207,207,0,0,0,0,1
"020111106","CABA",396,394,2,0,0,2,0.994949494949495
"020050802","CABA",320,320,0,0,0,0,1
"020050303","CABA",177,177,0,0,0,0,1
"020151608","CABA",354,353,0,1,0,1,0.997175141242938
"020112105","CABA",391,390,1,0,0,1,0.997442455242967
"020111108","CABA",315,312,2,1,0,3,0.990476190476191
"020030210","CABA",193,193,0,0,0,0,1
"020110410","CABA",281,277,0,0,0,0,0.98576512455516
"020110408","CABA",282,282,0,0,0,0,1
"020110407","CABA",279,279,0,0,0,0,1
"020151705","CABA",349,348,1,0,0,1,0.997134670487106
"020151706","CABA",308,307,0,0,0,0,0.996753246753247
"020030209","CABA",311,310,0,0,0,0,0.996784565916399
"020011014","CABA",111,111,0,0,0,0,1
"020111308","CABA",281,279,2,0,0,2,0.99288256227758
"020151709","CABA",266,265,1,0,0,1,0.996240601503759
"020050703","CABA",276,275,1,0,0,1,0.996376811594203
"020050901","CABA",472,472,0,0,0,0,1
"020011013","CABA",339,328,0,0,0,0,0.967551622418879
"020112106","CABA",385,383,0,0,0,0,0.994805194805195
"020030208","CABA",354,354,0,0,0,0,1
"020011012","CABA",291,291,0,0,0,0,1
"020050902","CABA",287,287,0,0,0,0,1
"020030604","CABA",320,317,0,0,0,0,0.990625
"020151712","CABA",302,301,1,0,0,1,0.996688741721854
"020011211","CABA",136,133,0,0,0,0,0.977941176470588
"020030311","CABA",305,305,0,0,0,0,1
"020030605","CABA",329,328,1,0,0,1,0.996960486322188
"020030607","CABA",312,312,0,0,0,0,1
"020030606","CABA",255,255,0,0,0,0,1
"020030407","CABA",270,270,0,0,0,0,1
"020030408","CABA",271,267,0,0,0,0,0.985239852398524
"020050306","CABA",303,303,0,0,0,0,1
"020110809","CABA",365,364,1,0,0,1,0.997260273972603
"020151606","CABA",308,308,0,0,0,0,1
"020060702","CABA",343,343,0,0,0,0,1
"020011210","CABA",101,101,0,0,0,0,1
"020111307","CABA",299,299,0,0,0,0,1
"020112001","CABA",356,351,0,0,0,0,0.985955056179775
"020060103","CABA",347,347,0,0,0,0,1
"020060104","CABA",274,272,0,0,0,0,0.992700729927007
"020011212","CABA",90,74,0,0,0,0,0.822222222222222
"020110503","CABA",353,353,0,0,0,0,1
"020060706","CABA",260,255,4,0,0,4,0.980769230769231
"020050304","CABA",235,233,2,0,0,2,0.991489361702128
"020110808","CABA",355,354,1,0,0,1,0.997183098591549
"020050704","CABA",605,604,1,0,0,1,0.998347107438017
"020030110","CABA",192,170,1,0,0,1,0.885416666666667
"020030111","CABA",230,222,0,0,0,0,0.965217391304348
"020011209","CABA",342,336,0,0,0,0,0.982456140350877
"020110707","CABA",273,269,1,0,0,1,0.985347985347985
"020151610","CABA",337,337,0,0,0,0,1
"020050705","CABA",618,618,0,0,0,0,1
"020110806","CABA",379,378,1,0,0,1,0.997361477572559
"020151609","CABA",306,306,0,0,0,0,1
"020011202","CABA",129,129,0,0,0,0,1
"020050904","CABA",232,232,0,0,0,0,1
"020011201","CABA",116,112,0,0,0,0,0.96551724137931
"020111107","CABA",305,305,0,0,0,0,1
"020110411","CABA",313,313,0,0,0,0,1
"020030212","CABA",365,365,0,0,0,0,1
"020011104","CABA",336,325,0,0,0,0,0.967261904761905
"020050706","CABA",300,266,1,0,0,1,0.886666666666667
"020112108","CABA",256,253,2,0,0,2,0.98828125
"020112003","CABA",389,383,5,1,0,6,0.984575835475578
"020011103","CABA",198,198,0,0,0,0,1
"020050903","CABA",268,268,0,0,0,0,1
"020011102","CABA",284,284,0,0,0,0,1
"020050805","CABA",175,175,0,0,0,0,1
"020060102","CABA",345,345,0,0,0,0,1
"020011101","CABA",219,211,0,0,0,0,0.963470319634703
"020060105","CABA",431,429,0,0,0,0,0.995359628770302
"020030801","CABA",321,320,1,0,0,1,0.996884735202492
"020050607","CABA",418,417,1,0,0,1,0.997607655502392
"020111208","CABA",272,272,0,0,0,0,1
"020030704","CABA",369,368,1,0,0,1,0.997289972899729
"020030703","CABA",453,449,0,0,0,0,0.991169977924945
"020030702","CABA",415,415,0,0,0,0,1
"020030803","CABA",341,341,0,0,0,0,1
"020112111","CABA",374,374,0,0,0,0,1
"020110807","CABA",345,345,0,0,0,0,1
"020151611","CABA",307,307,0,0,0,0,1
"020030901","CABA",388,386,2,0,0,2,0.994845360824742
"020030902","CABA",206,205,1,0,0,1,0.995145631067961
"020111901","CABA",221,211,0,0,0,0,0.95475113122172
"020110601","CABA",317,317,0,0,0,0,1
"020050906","CABA",245,245,0,0,0,0,1
"020060505","CABA",392,390,1,0,0,1,0.994897959183674
"020011306","CABA",100,100,0,0,0,0,1
"020030903","CABA",342,342,0,0,0,0,1
"020011304","CABA",136,136,0,0,0,0,1
"020111402","CABA",332,328,3,0,0,3,0.987951807228916
"020060106","CABA",348,345,3,0,0,3,0.991379310344828
"020110505","CABA",339,338,1,0,0,1,0.997050147492625
"020030904","CABA",414,406,1,7,0,8,0.980676328502415
"020060107","CABA",260,258,2,0,0,2,0.992307692307692
"020050907","CABA",220,220,0,0,0,0,1
"020051003","CABA",164,151,0,1,0,1,0.920731707317073
"020111309","CABA",371,371,0,0,0,0,1
"020011204","CABA",209,193,2,0,0,2,0.923444976076555
"020030905","CABA",222,222,0,0,0,0,1
"020011205","CABA",275,275,0,0,0,0,1
"020112004","CABA",303,303,0,0,0,0,1
"020050310","CABA",241,239,2,0,0,2,0.991701244813278
"020110708","CABA",249,244,5,0,0,5,0.979919678714859
"020060307","CABA",370,369,1,0,0,1,0.997297297297297
"020030802","CABA",212,212,0,0,0,0,1
"020111902","CABA",322,322,0,0,0,0,1
"020011105","CABA",251,248,2,0,0,2,0.98804780876494
"020060704","CABA",372,354,0,12,0,12,0.951612903225806
"020051102","CABA",389,387,2,0,0,2,0.994858611825193
"020051101","CABA",536,523,0,1,0,1,0.975746268656716
"020050707","CABA",196,192,3,1,0,4,0.979591836734694
"020011106","CABA",209,208,1,0,0,1,0.995215311004785
"020011107","CABA",296,295,1,0,0,1,0.996621621621622
"020050309","CABA",309,290,1,0,0,1,0.938511326860841
"020110706","CABA",291,288,2,1,0,3,0.989690721649485
"020060503","CABA",372,372,0,0,0,0,1
"020050806","CABA",394,394,0,0,0,0,1
"020112109","CABA",218,217,0,0,0,0,0.995412844036697
"020060302","CABA",303,276,0,1,0,1,0.910891089108911
"020111310","CABA",250,250,0,0,0,0,1
"020060101","CABA",242,242,0,0,0,0,1
"020060108","CABA",310,298,0,0,0,0,0.961290322580645
"020111210","CABA",261,261,0,0,0,0,1
"020110506","CABA",319,318,1,0,0,1,0.996865203761755
"020030706","CABA",283,282,0,0,0,0,0.996466431095406
"020060308","CABA",305,302,2,0,0,2,0.99016393442623
"020030707","CABA",504,503,0,0,0,0,0.998015873015873
"020110603","CABA",347,321,1,0,0,1,0.92507204610951
"020110504","CABA",252,251,1,0,0,1,0.996031746031746
"020030908","CABA",312,309,0,3,0,3,0.990384615384615
"020110602","CABA",351,350,1,0,0,1,0.997150997150997
"020060504","CABA",293,293,0,0,0,0,1
"020110709","CABA",296,293,3,0,0,3,0.989864864864865
"020030708","CABA",159,159,0,0,0,0,1
"020111209","CABA",240,240,0,0,0,0,1
"020030709","CABA",404,404,0,0,0,0,1
"020060502","CABA",453,453,0,0,0,0,1
"020030806","CABA",203,203,0,0,0,0,1
"020030807","CABA",166,125,0,0,0,0,0.753012048192771
"020030808","CABA",207,205,0,0,0,0,0.990338164251208
"020112009","CABA",260,260,0,0,0,0,1
"020060309","CABA",451,451,0,0,0,0,1
"020030809","CABA",304,302,0,0,0,0,0.993421052631579
"020011206","CABA",202,197,1,0,0,1,0.975247524752475
"020030907","CABA",292,274,4,0,0,4,0.938356164383562
"020030810","CABA",256,256,0,0,0,0,1
"020030906","CABA",196,195,1,0,0,1,0.994897959183674
"020111403","CABA",365,363,1,0,0,1,0.994520547945206
"020112005","CABA",328,327,0,0,0,0,0.996951219512195
"020050909","CABA",438,431,0,0,1,1,0.984018264840183
"020112110","CABA",292,289,2,0,0,2,0.98972602739726
"020011111","CABA",126,126,0,0,0,0,1
"020060705","CABA",359,358,0,0,0,0,0.997214484679666
"020051103","CABA",281,281,0,0,0,0,1
"020050908","CABA",454,450,2,0,0,2,0.991189427312775
"020011110","CABA",272,272,0,0,0,0,1
"020060306","CABA",356,352,4,0,0,4,0.98876404494382
"020111903","CABA",279,278,1,0,0,1,0.996415770609319
"020050311","CABA",386,386,0,0,0,0,1
"020060310","CABA",393,393,0,0,0,0,1
"020011109","CABA",219,219,0,0,0,0,1
"020111401","CABA",364,362,2,0,0,2,0.994505494505495
"020011108","CABA",353,352,1,0,0,1,0.997167138810198
"020060109","CABA",227,227,0,0,0,0,1
"020031104","CABA",386,384,1,0,0,1,0.994818652849741
"020011402","CABA",226,224,2,0,0,2,0.991150442477876
"020050708","CABA",394,393,1,0,0,1,0.99746192893401
"020110705","CABA",349,349,0,0,0,0,1
"020050809","CABA",333,333,0,0,0,0,1
"020050808","CABA",353,339,4,0,0,4,0.960339943342776
"020050910","CABA",341,338,3,0,0,3,0.991202346041056
"020110507","CABA",280,280,0,0,0,0,1
"020111507","CABA",281,262,3,0,0,3,0.932384341637011
"020031103","CABA",384,369,0,1,0,1,0.9609375
"020111311","CABA",336,336,0,0,0,0,1
"020060501","CABA",383,383,0,0,0,0,1
"020060507","CABA",334,334,0,0,0,0,1
"020031102","CABA",454,454,0,0,0,0,1
"020060506","CABA",304,303,1,0,0,1,0.996710526315789
"020031101","CABA",367,367,0,0,0,0,1
"020112010","CABA",292,290,1,0,0,1,0.993150684931507
"020031004","CABA",298,298,0,0,0,0,1
"020111405","CABA",328,327,0,1,0,1,0.996951219512195
"020111904","CABA",339,337,2,0,0,2,0.994100294985251
"020110508","CABA",307,307,0,0,0,0,1
"020110604","CABA",333,333,0,0,0,0,1
"020031002","CABA",323,322,1,0,0,1,0.996904024767802
"020031001","CABA",377,377,0,0,0,0,1
"020011208","CABA",129,126,0,0,0,0,0.976744186046512
"020112201","CABA",345,345,0,0,0,0,1
"020060301","CABA",367,366,1,0,0,1,0.997275204359673
"020011207","CABA",347,322,0,0,0,0,0.927953890489914
"020011112","CABA",407,406,0,0,1,1,0.997542997542998
"020111506","CABA",313,312,1,0,0,1,0.996805111821086
"020110704","CABA",325,324,1,0,0,1,0.996923076923077
"020100607","CABA",284,283,1,0,0,1,0.996478873239437
"020011113","CABA",291,291,0,0,0,0,1
"020110710","CABA",292,291,1,0,0,1,0.996575342465753
"020051006","CABA",314,308,1,0,0,1,0.980891719745223
"020060303","CABA",349,346,3,0,0,3,0.991404011461318
"020060508","CABA",205,205,0,0,0,0,1
"020011114","CABA",289,288,0,1,0,1,0.996539792387543
"020111508","CABA",372,344,0,0,0,0,0.924731182795699
"020031105","CABA",316,299,2,0,0,2,0.94620253164557
"020060111","CABA",253,253,0,0,0,0,1
"020051004","CABA",254,250,4,0,0,4,0.984251968503937
"020060707","CABA",399,399,0,0,0,0,1
"020060710","CABA",326,325,0,1,0,1,0.996932515337423
"020051002","CABA",548,547,0,0,0,0,0.998175182481752
"020011401","CABA",247,188,7,1,0,8,0.761133603238866
"020051005","CABA",269,269,0,0,0,0,1
"020051001","CABA",538,532,0,0,0,0,0.988847583643123
"020051107","CABA",470,465,1,0,0,1,0.98936170212766
"020060711","CABA",293,293,0,0,0,0,1
"020031107","CABA",437,437,0,0,0,0,1
"020060712","CABA",286,286,0,0,0,0,1
"020051104","CABA",331,330,1,0,0,1,0.996978851963746
"020051106","CABA",315,314,0,0,0,0,0.996825396825397
"020051105","CABA",321,318,1,0,0,1,0.990654205607477
"020111510","CABA",331,330,1,0,0,1,0.996978851963746
"020031108","CABA",284,283,0,1,0,1,0.996478873239437
"020060404","CABA",319,319,0,0,0,0,1
"020112011","CABA",252,246,2,0,0,2,0.976190476190476
"020011502","CABA",249,247,0,1,0,1,0.991967871485944
"020110509","CABA",292,291,0,1,0,1,0.996575342465753
"020031005","CABA",202,202,0,0,0,0,1
"020011501","CABA",170,162,0,0,0,0,0.952941176470588
"020111509","CABA",337,335,1,0,0,1,0.99406528189911
"020060510","CABA",407,406,1,0,0,1,0.997542997542998
"020112007","CABA",232,232,0,0,0,0,1
"020011305","CABA",154,154,0,0,0,0,1
"020031007","CABA",340,335,0,0,0,0,0.985294117647059
"020031008","CABA",274,274,0,0,0,0,1
"020011601","CABA",189,161,0,0,0,0,0.851851851851852
"020060110","CABA",145,145,0,0,0,0,1
"020112209","CABA",269,261,1,0,0,1,0.970260223048327
"020110703","CABA",297,293,4,0,0,4,0.986531986531986
"020111905","CABA",306,306,0,0,0,0,1
"020060304","CABA",243,243,0,0,0,0,1
"020030910","CABA",326,291,0,0,0,0,0.892638036809816
"020011603","CABA",413,409,4,0,0,4,0.990314769975787
"020060709","CABA",320,320,0,0,0,0,1
"020111505","CABA",329,323,1,0,0,1,0.981762917933131
"020111406","CABA",409,406,2,1,0,3,0.992665036674817
"020060509","CABA",237,237,0,0,0,0,1
"020111604","CABA",252,252,0,0,0,0,1
"020030909","CABA",371,370,0,0,0,0,0.997304582210243
"020011607","CABA",475,447,17,0,0,17,0.941052631578947
"020112202","CABA",358,358,0,0,0,0,1
"020100604","CABA",319,318,1,0,0,1,0.996865203761755
"020112006","CABA",267,263,4,0,0,4,0.98501872659176
"020060403","CABA",339,339,0,0,0,0,1
"020011609","CABA",160,160,0,0,0,0,1
"020051007","CABA",548,547,0,1,0,1,0.998175182481752
"020100101","CABA",250,248,2,0,0,2,0.992
"020031206","CABA",66,50,1,0,0,1,0.757575757575758
"020051008","CABA",309,303,4,0,0,4,0.980582524271845
"020031205","CABA",491,491,0,0,0,0,1
"020051009","CABA",344,341,0,0,0,0,0.991279069767442
"020060406","CABA",322,319,3,0,0,3,0.990683229813665
"020111504","CABA",356,356,0,0,0,0,1
"020051010","CABA",256,255,0,1,0,1,0.99609375
"020031204","CABA",249,238,0,0,0,0,0.955823293172691
"020011604","CABA",348,345,0,0,0,0,0.991379310344828
"020110702","CABA",328,323,3,1,0,4,0.984756097560976
"020051207","CABA",336,336,0,0,0,0,1
"020031203","CABA",310,309,0,1,0,1,0.996774193548387
"020060405","CABA",288,282,5,0,0,5,0.979166666666667
"020100606","CABA",298,297,1,0,0,1,0.996644295302013
"020031202","CABA",428,407,0,0,0,0,0.950934579439252
"020110605","CABA",304,304,0,0,0,0,1
"020111404","CABA",279,277,2,0,0,2,0.992831541218638
"020111907","CABA",319,318,1,0,0,1,0.996865203761755
"020110711","CABA",323,323,0,0,0,0,1
"020031201","CABA",350,348,0,0,0,0,0.994285714285714
"020111906","CABA",341,340,1,0,0,1,0.997067448680352
"020060713","CABA",236,235,1,0,0,1,0.995762711864407
"020031509","CABA",116,116,0,0,0,0,1
"020051108","CABA",321,321,0,0,0,0,1
"020060708","CABA",307,307,0,0,0,0,1
"020031506","CABA",362,333,2,0,0,2,0.919889502762431
"020011307","CABA",241,241,0,0,0,0,1
"020031505","CABA",382,379,1,1,0,2,0.992146596858639
"020060603","CABA",509,508,0,0,0,0,0.99803536345776
"020110510","CABA",334,334,0,0,0,0,1
"020031504","CABA",334,333,1,0,0,1,0.997005988023952
"020011602","CABA",164,163,1,0,0,1,0.99390243902439
"020060203","CABA",243,242,0,0,0,0,0.995884773662551
"020111511","CABA",434,387,2,0,0,2,0.891705069124424
"020011605","CABA",208,208,0,0,0,0,1
"020111605","CABA",288,288,0,0,0,0,1
"020111503","CABA",368,365,3,0,0,3,0.991847826086957
"020060801","CABA",355,355,0,0,0,0,1
"020060402","CABA",227,227,0,0,0,0,1
"020031604","CABA",178,178,0,0,0,0,1
"020011608","CABA",220,220,0,0,0,0,1
"020110701","CABA",171,171,0,0,0,0,1
"020060602","CABA",792,791,0,0,0,0,0.998737373737374
"020031603","CABA",388,386,2,0,0,2,0.994845360824742
"020111603","CABA",267,263,4,0,0,4,0.98501872659176
"020031602","CABA",504,470,0,0,0,0,0.932539682539683
"020031601","CABA",375,374,0,0,0,0,0.997333333333333
"020112203","CABA",360,360,0,0,0,0,1
"020060112","CABA",292,290,2,0,0,2,0.993150684931507
"020060809","CABA",266,266,0,0,0,0,1
"020031207","CABA",466,448,0,0,0,0,0.96137339055794
"020110606","CABA",306,304,2,0,0,2,0.993464052287582
"020051501","CABA",521,497,2,0,0,2,0.953934740882918
"020051206","CABA",769,768,1,0,0,1,0.998699609882965
"020031208","CABA",291,291,0,0,0,0,1
"020060401","CABA",208,199,9,0,0,9,0.956730769230769
"020051502","CABA",530,530,0,0,0,0,1
"020031209","CABA",214,214,0,0,0,0,1
"020051201","CABA",293,289,0,0,1,1,0.986348122866894
"020051503","CABA",267,264,1,0,0,1,0.98876404494382
"020031210","CABA",363,327,0,0,0,0,0.900826446280992
"020111607","CABA",350,319,5,0,0,5,0.911428571428571
"020060802","CABA",457,455,1,0,0,1,0.99562363238512
"020111407","CABA",696,695,0,1,0,1,0.998563218390805
"020051404","CABA",421,421,0,0,0,0,1
"020060601","CABA",546,546,0,0,0,0,1
"020112208","CABA",269,268,0,0,0,0,0.996282527881041
"020051403","CABA",540,538,1,0,0,1,0.996296296296296
"020031508","CABA",617,614,0,2,1,3,0.995137763371151
"020100608","CABA",339,339,0,0,0,0,1
"020011503","CABA",200,200,0,0,0,0,1
"020112210","CABA",307,307,0,0,0,0,1
"020031507","CABA",600,600,0,0,0,0,1
"020011308","CABA",156,154,0,0,0,0,0.987179487179487
"020111602","CABA",359,354,1,0,0,1,0.986072423398329
"020112204","CABA",265,264,1,0,0,1,0.99622641509434
"020011702","CABA",303,295,4,0,0,4,0.973597359735974
"020060202","CABA",334,334,0,0,0,0,1
"020060808","CABA",509,508,1,0,0,1,0.99803536345776
"020011701","CABA",389,387,2,0,0,2,0.994858611825193
"020031503","CABA",271,267,4,0,0,4,0.985239852398524
"020051402","CABA",347,325,1,0,0,1,0.936599423631124
"020051110","CABA",354,353,0,0,0,0,0.997175141242938
"020051205","CABA",198,198,0,0,0,0,1
"020110607","CABA",308,305,0,2,0,2,0.99025974025974
"020100605","CABA",353,352,0,0,0,0,0.997167138810198
"020060408","CABA",370,368,1,1,0,2,0.994594594594595
"020011612","CABA",139,137,2,0,0,2,0.985611510791367
"020031605","CABA",267,258,0,0,0,0,0.966292134831461
"020051505","CABA",454,453,1,0,0,1,0.997797356828194
"020100102","CABA",353,352,1,0,0,1,0.997167138810198
"020031606","CABA",275,269,5,0,0,5,0.978181818181818
"020011611","CABA",217,200,0,0,0,0,0.921658986175115
"020060810","CABA",334,334,0,0,0,0,1
"020060205","CABA",226,225,1,0,0,1,0.995575221238938
"020011610","CABA",291,291,0,0,0,0,1
"020060803","CABA",260,260,0,0,0,0,1
"020031307","CABA",251,251,0,0,0,0,1
"020100201","CABA",353,353,0,0,0,0,1
"020011403","CABA",196,195,0,0,0,0,0.994897959183674
"020051504","CABA",568,568,0,0,0,0,1
"020011310","CABA",235,235,0,0,0,0,1
"020111601","CABA",319,304,1,1,0,2,0.952978056426332
"020111501","CABA",349,343,3,0,0,3,0.982808022922636
"020031306","CABA",323,318,3,0,0,3,0.984520123839009
"020031607","CABA",312,294,1,0,0,1,0.942307692307692
"020060407","CABA",242,238,4,0,0,4,0.983471074380165
"020011404","CABA",39,39,0,0,0,0,1
"020100603","CABA",388,388,0,0,0,0,1
"020031304","CABA",208,208,0,0,0,0,1
"020011504","CABA",335,335,0,0,0,0,1
"020031303","CABA",393,389,0,0,0,0,0.989821882951654
"020110712","CABA",306,306,0,0,0,0,1
"020060604","CABA",226,226,0,0,0,0,1
"020031302","CABA",356,355,1,0,0,1,0.997191011235955
"020060606","CABA",333,331,0,0,0,0,0.993993993993994
"020111606","CABA",335,335,0,0,0,0,1
"020112205","CABA",310,298,11,0,0,11,0.961290322580645
"020060204","CABA",247,247,0,0,0,0,1
"020011309","CABA",157,155,0,0,0,0,0.987261146496815
"020031405","CABA",365,340,4,0,0,4,0.931506849315068
"020011703","CABA",324,310,0,0,0,0,0.95679012345679
"020100609","CABA",357,355,1,1,0,2,0.994397759103641
"020031404","CABA",299,297,0,2,0,2,0.993311036789298
"020112211","CABA",248,240,5,0,0,5,0.967741935483871
"020011704","CABA",287,287,0,0,0,0,1
"020051405","CABA",787,781,1,0,0,1,0.992376111817027
"020051303","CABA",365,365,0,0,0,0,1
"020060605","CABA",201,200,0,0,0,0,0.995024875621891
"020051203","CABA",426,423,1,0,0,1,0.992957746478873
"020060804","CABA",300,300,0,0,0,0,1
"020031403","CABA",454,452,2,0,0,2,0.995594713656388
"020100103","CABA",341,339,2,0,0,2,0.994134897360704
"020111608","CABA",393,393,0,0,0,0,1
"020031402","CABA",418,411,0,1,0,1,0.983253588516746
"020060409","CABA",322,322,0,0,0,0,1
"020051506","CABA",330,329,1,0,0,1,0.996969696969697
"020011707","CABA",323,321,0,0,0,0,0.993808049535604
"020031401","CABA",346,314,0,0,0,0,0.907514450867052
"020011313","CABA",104,93,10,0,0,10,0.894230769230769
"020011803","CABA",292,288,3,0,0,3,0.986301369863014
"020031608","CABA",339,336,1,0,0,1,0.991150442477876
"020060807","CABA",319,310,9,0,0,9,0.971786833855799
"020051406","CABA",538,526,0,0,0,0,0.977695167286245
"020111502","CABA",324,324,0,0,0,0,1
"020011407","CABA",215,215,0,0,0,0,1
"020011802","CABA",357,355,2,0,0,2,0.994397759103641
"020060201","CABA",387,387,0,0,0,0,1
"020011801","CABA",442,442,0,0,0,0,1
"020110610","CABA",271,271,0,0,0,0,1
"020031308","CABA",241,224,0,0,0,0,0.929460580912863
"020031309","CABA",369,368,0,0,0,0,0.997289972899729
"020051302","CABA",321,317,0,0,0,0,0.987538940809969
"020051407","CABA",168,168,0,0,0,0,1
"020011406","CABA",293,263,0,0,0,0,0.897610921501707
"020060806","CABA",533,533,0,0,0,0,1
"020060910","CABA",324,324,0,0,0,0,1
"020111908","CABA",301,301,0,0,0,0,1
"020031310","CABA",315,288,0,0,0,0,0.914285714285714
"020111702","CABA",286,286,0,0,0,0,1
"020031311","CABA",267,267,0,0,0,0,1
"020111609","CABA",256,254,2,0,0,2,0.9921875
"020111806","CABA",521,519,2,0,0,2,0.99616122840691
"020070403","CABA",450,446,1,0,0,1,0.991111111111111
"020051507","CABA",313,309,3,1,0,4,0.987220447284345
"020011505","CABA",187,173,2,0,0,2,0.925133689839572
"020100705","CABA",366,356,1,0,0,1,0.972677595628415
"020031301","CABA",305,304,1,0,0,1,0.99672131147541
"020031406","CABA",514,500,2,0,0,2,0.972762645914397
"020110608","CABA",284,279,5,0,0,5,0.982394366197183
"020100602","CABA",247,230,1,0,0,1,0.931174089068826
"020051304","CABA",330,315,1,0,0,1,0.954545454545455
"020031407","CABA",259,259,0,0,0,0,1
"020031408","CABA",316,316,0,0,0,0,1
"020031409","CABA",43,43,0,0,0,0,1
"020051301","CABA",396,396,0,0,0,0,1
"020100610","CABA",422,418,3,0,0,3,0.990521327014218
"020060411","CABA",345,345,0,0,0,0,1
"020060805","CABA",251,246,2,0,0,2,0.9800796812749
"020011705","CABA",256,256,0,0,0,0,1
"020111701","CABA",290,286,4,0,0,4,0.986206896551724
"020031410","CABA",313,313,0,0,0,0,1
"020112207","CABA",345,344,1,0,0,1,0.997101449275362
"020060608","CABA",408,407,0,0,0,0,0.997549019607843
"020011708","CABA",267,267,0,0,0,0,1
"020051409","CABA",426,425,0,0,0,0,0.997652582159624
"020112206","CABA",409,407,0,0,0,0,0.995110024449878
"020111805","CABA",318,317,0,0,0,0,0.99685534591195
"020011804","CABA",341,336,0,0,0,0,0.98533724340176
"020100706","CABA",342,341,0,0,0,0,0.997076023391813
"020011408","CABA",196,194,0,1,0,1,0.989795918367347
"020060609","CABA",356,356,0,0,0,0,1
"020060907","CABA",249,227,0,0,0,0,0.911646586345382
"020011805","CABA",274,274,0,0,0,0,1
"020100611","CABA",280,280,0,0,0,0,1
"020031609","CABA",507,499,0,0,0,0,0.98422090729783
"020110609","CABA",302,300,0,1,0,1,0.993377483443709
"020032003","CABA",315,312,2,0,0,2,0.990476190476191
"020051509","CABA",168,168,0,0,0,0,1
"020060410","CABA",339,339,0,0,0,0,1
"020011409","CABA",246,246,0,0,0,0,1
"020070404","CABA",560,559,0,1,0,1,0.998214285714286
"020060909","CABA",362,362,0,0,0,0,1
"020070402","CABA",334,334,0,0,0,0,1
"020032002","CABA",444,431,2,0,0,2,0.970720720720721
"020051408","CABA",275,274,1,0,0,1,0.996363636363636
"020111610","CABA",236,236,0,0,0,0,1
"020051508","CABA",331,308,2,0,0,2,0.930513595166163
"020032001","CABA",318,302,0,0,0,0,0.949685534591195
"020100202","CABA",257,254,3,0,0,3,0.988326848249027
"020031903","CABA",310,310,0,0,0,0,1
"020060607","CABA",350,350,0,0,0,0,1
"020011507","CABA",270,270,0,0,0,0,1
"020031902","CABA",152,138,0,0,0,0,0.907894736842105
"020011506","CABA",305,277,4,0,0,4,0.908196721311475
"020031901","CABA",516,513,2,0,0,2,0.994186046511628
"020031805","CABA",171,171,0,0,0,0,1
"020070401","CABA",534,534,0,0,0,0,1
"020111802","CABA",303,300,3,0,0,3,0.99009900990099
"020111703","CABA",336,334,1,1,0,2,0.994047619047619
"020031804","CABA",377,377,0,0,0,0,1
"020100601","CABA",231,230,1,0,0,1,0.995670995670996
"020051306","CABA",377,373,2,0,0,2,0.989389920424403
"020011711","CABA",218,218,0,0,0,0,1
"020011710","CABA",279,279,0,0,0,0,1
"020051308","CABA",421,421,0,0,0,0,1
"020060906","CABA",381,381,0,0,0,0,1
"020061807","CABA",526,525,1,0,0,1,0.998098859315589
"020031802","CABA",302,299,3,0,0,3,0.990066225165563
"020011709","CABA",239,235,2,0,0,2,0.98326359832636
"020031703","CABA",208,208,0,0,0,0,1
"020100104","CABA",294,294,0,0,0,0,1
"020031904","CABA",295,283,12,0,0,12,0.959322033898305
"020100203","CABA",245,245,0,0,0,0,1
"020070303","CABA",477,474,0,0,0,0,0.993710691823899
"020060206","CABA",342,342,0,0,0,0,1
"020031702","CABA",325,304,2,0,0,2,0.935384615384615
"020060209","CABA",252,252,0,0,0,0,1
"020032004","CABA",290,266,24,0,0,24,0.917241379310345
"020061101","CABA",429,428,1,0,0,1,0.997668997668998
"020060905","CABA",170,169,1,0,0,1,0.994117647058824
"020060207","CABA",346,346,0,0,0,0,1
"020032005","CABA",232,219,0,0,0,0,0.943965517241379
"020110611","CABA",314,312,1,1,0,2,0.993630573248408
"020061102","CABA",242,240,2,0,0,2,0.991735537190083
"020070405","CABA",397,395,2,0,0,2,0.994962216624685
"020061806","CABA",454,454,0,0,0,0,1
"020031905","CABA",344,344,0,0,0,0,1
"020011410","CABA",220,220,0,0,0,0,1
"020100612","CABA",266,266,0,0,0,0,1
"020011411","CABA",253,229,1,0,0,1,0.905138339920949
"020032006","CABA",189,185,2,0,0,2,0.978835978835979
"020061103","CABA",368,346,1,0,0,1,0.940217391304348
"020011312","CABA",138,138,0,0,0,0,1
"020011412","CABA",217,217,0,0,0,0,1
"020051604","CABA",389,382,2,0,0,2,0.982005141388175
"020100504","CABA",323,323,0,0,0,0,1
"020011508","CABA",310,306,4,0,0,4,0.987096774193548
"020051603","CABA",214,214,0,0,0,0,1
"020061106","CABA",309,309,0,0,0,0,1
"020061108","CABA",369,369,0,0,0,0,1
"020011509","CABA",352,320,3,0,0,3,0.909090909090909
"020061105","CABA",249,249,0,0,0,0,1
"020100707","CABA",515,514,1,0,0,1,0.998058252427184
"020031807","CABA",275,275,0,0,0,0,1
"020031806","CABA",255,248,4,0,0,4,0.972549019607843
"020061003","CABA",383,383,0,0,0,0,1
"020051602","CABA",286,280,0,0,0,0,0.979020979020979
"020060901","CABA",297,294,3,0,0,3,0.98989898989899
"020070302","CABA",381,369,1,0,0,1,0.968503937007874
"020111803","CABA",310,307,3,0,0,3,0.990322580645161
"020051305","CABA",332,330,2,0,0,2,0.993975903614458
"020051701","CABA",290,290,0,0,0,0,1
"020111909","CABA",348,346,0,0,0,0,0.994252873563218
"020100704","CABA",434,430,3,0,0,3,0.990783410138249
"020011905","CABA",271,270,0,1,0,1,0.996309963099631
"020101002","CABA",350,348,1,0,0,1,0.994285714285714
"020011904","CABA",303,302,1,0,0,1,0.996699669966997
"020061805","CABA",390,389,0,0,0,0,0.997435897435897
"020011903","CABA",145,145,0,0,0,0,1
"020060904","CABA",430,430,0,0,0,0,1
"020011902","CABA",498,498,0,0,0,0,1
"020011901","CABA",424,395,4,0,0,4,0.931603773584906
"020011807","CABA",317,309,0,0,0,0,0.974763406940063
"020011806","CABA",507,484,2,2,0,4,0.954635108481262
"020031808","CABA",254,254,0,0,0,0,1
"020061107","CABA",357,354,2,1,0,3,0.991596638655462
"020100613","CABA",395,392,2,1,0,3,0.992405063291139
"020100106","CABA",309,309,0,0,0,0,1
"020032008","CABA",380,351,0,0,0,0,0.923684210526316
"020070406","CABA",436,431,5,0,0,5,0.988532110091743
"020032007","CABA",349,346,1,0,0,1,0.991404011461318
"020060902","CABA",260,260,0,0,0,0,1
"020061104","CABA",343,343,0,0,0,0,1
"020061804","CABA",309,309,0,0,0,0,1
"020111705","CABA",297,271,7,8,0,15,0.912457912457912
"020031907","CABA",413,402,0,0,0,0,0.973365617433414
"020111704","CABA",324,317,5,0,0,5,0.978395061728395
"020012402","CABA",145,145,0,0,0,0,1
"020060210","CABA",334,333,1,0,0,1,0.997005988023952
"020060208","CABA",368,368,0,0,0,0,1
"020111807","CABA",324,321,1,0,0,1,0.990740740740741
"020012401","CABA",113,113,0,0,0,0,1
"020061109","CABA",288,288,0,0,0,0,1
"020100204","CABA",303,300,3,0,0,3,0.99009900990099
"020031704","CABA",332,332,0,0,0,0,1
"020100105","CABA",258,252,5,0,0,5,0.976744186046512
"020012304","CABA",131,130,0,0,0,0,0.99236641221374
"020012305","CABA",228,213,5,0,0,5,0.934210526315789
"020111801","CABA",279,279,0,0,0,0,1
"020031705","CABA",324,308,0,0,0,0,0.950617283950617
"020070301","CABA",301,295,6,0,0,6,0.980066445182724
"020051702","CABA",353,348,1,0,0,1,0.985835694050991
"020051607","CABA",249,239,0,0,0,0,0.959839357429719
"020012303","CABA",373,356,0,0,0,0,0.954423592493298
"020111804","CABA",370,360,2,0,0,2,0.972972972972973
"020012301","CABA",272,272,0,0,0,0,1
"020031810","CABA",208,207,0,0,0,0,0.995192307692308
"020100107","CABA",258,254,3,0,0,3,0.984496124031008
"020011311","CABA",142,142,0,0,0,0,1
"020011511","CABA",281,281,0,0,0,0,1
"020060903","CABA",293,283,10,0,0,10,0.965870307167236
"020011510","CABA",291,290,1,0,0,1,0.996563573883162
"020051309","CABA",422,422,0,0,0,0,1
"020061004","CABA",337,337,0,0,0,0,1
"020070202","CABA",370,370,0,0,0,0,1
"020070408","CABA",396,395,0,0,0,0,0.997474747474748
"020011906","CABA",216,181,0,0,0,0,0.837962962962963
"020060211","CABA",508,508,0,0,0,0,1
"020061808","CABA",512,511,1,0,0,1,0.998046875
"020011907","CABA",325,315,2,0,0,2,0.969230769230769
"020011909","CABA",223,223,0,0,0,0,1
"020011908","CABA",160,154,0,0,0,0,0.9625
"020061809","CABA",395,395,0,0,0,0,1
"020011808","CABA",301,296,2,0,0,2,0.983388704318937
"020011809","CABA",303,286,0,0,0,0,0.943894389438944
"020061201","CABA",256,256,0,0,0,0,1
"020051605","CABA",376,376,0,0,0,0,1
"020100505","CABA",299,298,1,0,0,1,0.996655518394649
"020100708","CABA",384,382,2,0,0,2,0.994791666666667
"020100503","CABA",355,353,2,0,0,2,0.994366197183099
"020032010","CABA",287,287,0,0,0,0,1
"020051606","CABA",309,309,0,0,0,0,1
"020061005","CABA",461,458,3,0,0,3,0.993492407809111
"020032011","CABA",239,239,0,0,0,0,1
"020070304","CABA",395,392,2,0,0,2,0.992405063291139
"020031908","CABA",499,486,0,0,0,0,0.973947895791583
"020061203","CABA",288,286,2,0,0,2,0.993055555555556
"020101005","CABA",313,312,1,0,0,1,0.996805111821086
"020061110","CABA",240,239,0,0,0,0,0.995833333333333
"020012403","CABA",200,192,6,0,0,6,0.96
"020100206","CABA",393,390,1,1,0,2,0.99236641221374
"020031909","CABA",304,304,0,0,0,0,1
"020051703","CABA",317,317,0,0,0,0,1
"020031709","CABA",281,258,1,0,0,1,0.918149466192171
"020031910","CABA",236,219,3,0,0,3,0.927966101694915
"020070306","CABA",338,332,3,1,0,4,0.982248520710059
"020051704","CABA",298,298,0,0,0,0,1
"020100108","CABA",353,347,3,0,0,3,0.98300283286119
"020012307","CABA",265,257,1,0,0,1,0.969811320754717
"020061001","CABA",303,303,0,0,0,0,1
"020061002","CABA",288,286,2,0,0,2,0.993055555555556
"020031708","CABA",383,363,3,1,0,4,0.947780678851175
"020012202","CABA",422,419,0,0,0,0,0.992890995260663
"020051705","CABA",309,306,3,0,0,3,0.990291262135922
"020061801","CABA",263,262,1,0,0,1,0.996197718631179
"020012201","CABA",261,260,0,0,0,0,0.996168582375479
"020070407","CABA",472,470,0,0,0,0,0.995762711864407
"020101001","CABA",281,280,1,0,0,1,0.99644128113879
"020100703","CABA",471,471,0,0,0,0,1
"020051610","CABA",388,369,0,0,0,0,0.951030927835051
"020012102","CABA",266,265,0,0,0,0,0.996240601503759
"020061904","CABA",453,453,0,0,0,0,1
"020070409","CABA",223,222,0,0,0,0,0.995515695067265
"020101003","CABA",318,318,0,0,0,0,1
"020012101","CABA",266,233,1,0,0,1,0.87593984962406
"020111707","CABA",331,331,0,0,0,0,1
"020012002","CABA",298,298,0,0,0,0,1
"020061903","CABA",603,601,0,0,0,0,0.996683250414594
"020100508","CABA",357,355,0,1,0,1,0.994397759103641
"020051609","CABA",394,390,1,0,0,1,0.989847715736041
"020111808","CABA",346,333,1,0,0,1,0.96242774566474
"020061007","CABA",335,335,0,0,0,0,1
"020012001","CABA",259,255,0,1,0,1,0.984555984555985
"020041801","CABA",45,20,4,0,17,21,0.444444444444444
"020070201","CABA",289,287,2,0,0,2,0.993079584775087
"020032101","CABA",376,367,9,0,0,9,0.976063829787234
"020061902","CABA",641,639,2,0,0,2,0.996879875195008
"020011315","CABA",0,0,0,0,0,0,NA
"020032202","CABA",294,280,0,0,0,0,0.952380952380952
"020061703","CABA",309,309,0,0,0,0,1
"020070203","CABA",303,297,0,0,0,0,0.98019801980198
"020051608","CABA",376,376,0,0,0,0,1
"020032201","CABA",342,339,2,0,0,2,0.991228070175439
"020100709","CABA",339,336,2,1,0,3,0.991150442477876
"020061901","CABA",385,384,0,0,0,0,0.997402597402597
"020032302","CABA",347,347,0,0,0,0,1
"020051708","CABA",385,385,0,0,0,0,1
"020032301","CABA",330,330,0,0,0,0,1
"020031707","CABA",344,344,0,0,0,0,1
"020032403","CABA",276,275,0,1,0,1,0.996376811594203
"020061803","CABA",313,313,0,0,0,0,1
"020111706","CABA",408,399,6,0,0,6,0.977941176470588
"020051707","CABA",329,329,0,0,0,0,1
"020061705","CABA",839,839,0,0,0,0,1
"020070307","CABA",448,444,2,2,0,4,0.991071428571429
"020032402","CABA",336,327,0,0,0,0,0.973214285714286
"020100502","CABA",292,287,5,0,0,5,0.982876712328767
"020061008","CABA",568,568,0,0,0,0,1
"020012103","CABA",170,155,2,0,0,2,0.911764705882353
"020032401","CABA",303,301,1,0,0,1,0.993399339933993
"020012405","CABA",168,168,0,0,0,0,1
"020012203","CABA",371,370,1,0,0,1,0.997304582210243
"020012104","CABA",500,467,1,0,0,1,0.934
"020012404","CABA",168,158,1,0,0,1,0.94047619047619
"020100205","CABA",297,293,3,1,0,4,0.986531986531986
"020012105","CABA",275,249,1,0,0,1,0.905454545454545
"020012310","CABA",150,148,2,0,0,2,0.986666666666667
"020012308","CABA",315,265,0,0,0,0,0.841269841269841
"020012309","CABA",405,388,0,0,0,0,0.958024691358025
"020012106","CABA",264,262,2,0,0,2,0.992424242424242
"020061802","CABA",256,253,3,0,0,3,0.98828125
"020061702","CABA",419,418,1,0,0,1,0.997613365155131
"020051706","CABA",341,338,3,0,0,3,0.991202346041056
"020012003","CABA",238,233,5,0,0,5,0.978991596638655
"020012004","CABA",343,329,0,0,0,0,0.959183673469388
"020101011","CABA",304,304,0,0,0,0,1
"020061905","CABA",305,305,0,0,0,0,1
"020061204","CABA",193,193,0,0,0,0,1
"020032503","CABA",207,204,0,0,0,0,0.985507246376812
"020012005","CABA",352,351,1,0,0,1,0.997159090909091
"020070305","CABA",309,309,0,0,0,0,1
"020032103","CABA",308,308,0,0,0,0,1
"020061906","CABA",439,436,2,1,0,3,0.993166287015945
"020070410","CABA",365,365,0,0,0,0,1
"020100509","CABA",263,263,0,0,0,0,1
"020061009","CABA",246,246,0,0,0,0,1
"020070209","CABA",394,393,1,0,0,1,0.99746192893401
"020100506","CABA",339,339,0,0,0,0,1
"020061907","CABA",444,444,0,0,0,0,1
"020051611","CABA",424,424,0,0,0,0,1
"020100710","CABA",402,400,1,0,0,1,0.995024875621891
"020061704","CABA",360,358,0,0,0,0,0.994444444444444
"020070102","CABA",306,305,0,1,0,1,0.996732026143791
"020061202","CABA",228,224,3,0,0,3,0.982456140350877
"020012406","CABA",365,365,0,0,0,0,1
"020100501","CABA",243,237,4,2,0,6,0.975308641975309
"020032102","CABA",397,395,0,0,0,0,0.994962216624685
"020032203","CABA",181,170,0,0,0,0,0.939226519337017
"020061010","CABA",463,463,0,0,0,0,1
"020101004","CABA",284,283,1,0,0,1,0.996478873239437
"020061908","CABA",431,427,2,0,0,2,0.990719257540603
"020032502","CABA",295,294,0,0,0,0,0.996610169491525
"020032303","CABA",367,367,0,0,0,0,1
"020111809","CABA",304,293,11,0,0,11,0.963815789473684
"020012407","CABA",261,259,1,1,0,2,0.992337164750958
"020062005","CABA",384,384,0,0,0,0,1
"020012503","CABA",221,221,0,0,0,0,1
"020051709","CABA",253,252,0,1,0,1,0.99604743083004
"020012502","CABA",179,177,2,0,0,2,0.988826815642458
"020051710","CABA",280,280,0,0,0,0,1
"020062004","CABA",256,256,0,0,0,0,1
"020061205","CABA",384,384,0,0,0,0,1
"020012501","CABA",175,172,1,0,0,1,0.982857142857143
"020012110","CABA",376,365,3,0,0,3,0.970744680851064
"020012205","CABA",186,186,0,0,0,0,1
"020012602","CABA",320,319,0,0,0,0,0.996875
"020012108","CABA",240,236,1,0,0,1,0.983333333333333
"020012204","CABA",207,201,3,3,0,6,0.971014492753623
"020012601","CABA",249,241,2,0,0,2,0.967871485943775
"020070204","CABA",660,640,8,0,0,8,0.96969696969697
"020012107","CABA",332,317,1,0,0,1,0.954819277108434
"020100904","CABA",310,310,0,0,0,0,1
"020051711","CABA",428,427,1,0,0,1,0.997663551401869
"020012008","CABA",218,213,0,0,1,1,0.977064220183486
"020032504","CABA",272,272,0,0,0,0,1
"020032501","CABA",510,507,0,0,0,0,0.994117647058824
"020012007","CABA",207,207,0,0,0,0,1
"020070101","CABA",223,220,3,0,0,3,0.986547085201794
"020100512","CABA",265,263,2,0,0,2,0.992452830188679
"020062009","CABA",317,317,0,0,0,0,1
"020111708","CABA",322,318,4,0,0,4,0.987577639751553
"020051906","CABA",330,330,0,0,0,0,1
"020070505","CABA",462,462,0,0,0,0,1
"020100208","CABA",316,315,1,0,0,1,0.996835443037975
"020101006","CABA",314,314,0,0,0,0,1
"020070308","CABA",307,300,1,0,0,1,0.977198697068404
"020062008","CABA",483,482,1,0,0,1,0.997929606625259
"020062001","CABA",214,213,1,0,0,1,0.995327102803738
"020061502","CABA",770,769,0,1,0,1,0.998701298701299
"020051904","CABA",397,397,0,0,0,0,1
"020100702","CABA",407,407,0,0,0,0,1
"020032204","CABA",246,245,0,0,0,0,0.995934959349594
"020061207","CABA",349,348,1,0,0,1,0.997134670487106
"020062007","CABA",254,254,0,0,0,0,1
"020032205","CABA",359,358,1,0,0,1,0.997214484679666
"020062006","CABA",380,379,1,0,0,1,0.997368421052632
"020051903","CABA",407,402,5,0,0,5,0.987714987714988
"020032505","CABA",296,293,1,1,0,2,0.989864864864865
"020070205","CABA",358,329,2,0,0,2,0.918994413407821
"020051901","CABA",344,344,0,0,0,0,1
"020032405","CABA",225,224,1,0,0,1,0.995555555555556
"020100905","CABA",302,301,0,1,0,1,0.996688741721854
"020051806","CABA",242,239,2,1,0,3,0.987603305785124
"020032406","CABA",375,374,0,1,0,1,0.997333333333333
"020070309","CABA",273,270,1,0,0,1,0.989010989010989
"020051805","CABA",336,309,26,1,0,27,0.919642857142857
"020012505","CABA",226,226,0,0,0,0,1
"020061707","CABA",277,277,0,0,0,0,1
"020061208","CABA",303,301,1,0,0,1,0.993399339933993
"020012603","CABA",217,216,1,0,0,1,0.995391705069124
"020100511","CABA",248,246,1,0,0,1,0.991935483870968
"020100507","CABA",306,306,0,0,0,0,1
"020012207","CABA",268,236,14,0,0,14,0.880597014925373
"020012604","CABA",244,243,1,0,0,1,0.995901639344262
"020012206","CABA",259,249,0,0,0,0,0.961389961389961
"020051803","CABA",343,343,0,0,0,0,1
"020061706","CABA",507,507,0,0,0,0,1
"020012109","CABA",328,328,0,0,0,0,1
"020070507","CABA",269,267,2,0,0,2,0.992565055762082
"020061501","CABA",284,284,0,0,0,0,1
"020100207","CABA",340,335,5,0,0,5,0.985294117647059
"020101007","CABA",308,306,2,0,0,2,0.993506493506494
"020051801","CABA",423,422,1,0,0,1,0.997635933806147
"020101105","CABA",301,300,1,0,0,1,0.996677740863787
"020032506","CABA",337,324,3,1,0,4,0.961424332344214
"020012009","CABA",247,243,0,1,0,1,0.983805668016194
"020101010","CABA",262,261,0,0,0,0,0.99618320610687
"020062002","CABA",258,258,0,0,0,0,1
"020061209","CABA",362,362,0,0,0,0,1
"020012010","CABA",316,283,1,0,0,1,0.895569620253165
"020101012","CABA",346,346,0,0,0,0,1
"020070208","CABA",296,293,3,0,0,3,0.989864864864865
"020100903","CABA",303,300,3,0,0,3,0.99009900990099
"020032105","CABA",219,219,0,0,0,0,1
"020062106","CABA",231,231,0,0,0,0,1
"020032106","CABA",387,384,3,0,0,3,0.992248062015504
"020032206","CABA",302,285,3,0,0,3,0.943708609271523
"020070310","CABA",425,423,0,0,0,0,0.995294117647059
"020101008","CABA",254,249,4,0,0,4,0.980314960629921
"020061404","CABA",531,530,1,0,0,1,0.998116760828625
"020032306","CABA",242,242,0,0,0,0,1
"020070508","CABA",345,345,0,0,0,0,1
"020051905","CABA",334,330,4,0,0,4,0.988023952095808
"020032305","CABA",291,291,0,0,0,0,1
"020062105","CABA",330,330,0,0,0,0,1
"020032108","CABA",314,313,1,0,0,1,0.996815286624204
"020100401","CABA",370,370,0,0,0,0,1
"020100510","CABA",296,294,1,0,0,1,0.993243243243243
"020061210","CABA",236,236,0,0,0,0,1
"020070207","CABA",245,225,19,0,0,19,0.918367346938776
"020032409","CABA",185,181,1,0,0,1,0.978378378378378
"020100513","CABA",288,285,1,2,0,3,0.989583333333333
"020062104","CABA",262,261,1,0,0,1,0.99618320610687
"020032408","CABA",320,319,1,0,0,1,0.996875
"020012504","CABA",430,429,1,0,0,1,0.997674418604651
"020070601","CABA",372,371,1,0,0,1,0.997311827956989
"020070103","CABA",316,313,0,2,0,2,0.990506329113924
"020061503","CABA",358,358,0,0,0,0,1
"020070506","CABA",269,269,0,0,0,0,1
"020012606","CABA",214,212,1,0,1,2,0.990654205607477
"020032601","CABA",398,386,2,0,0,2,0.969849246231156
"020061601","CABA",283,282,0,0,0,0,0.996466431095406
"020012605","CABA",310,300,0,0,0,0,0.967741935483871
"020100701","CABA",381,380,0,0,0,0,0.99737532808399
"020062103","CABA",454,453,1,0,0,1,0.997797356828194
"020051902","CABA",282,281,1,0,0,1,0.99645390070922
"020012208","CABA",276,273,0,0,0,0,0.989130434782609
"020061603","CABA",393,388,3,2,0,5,0.987277353689567
"020061403","CABA",384,383,1,0,0,1,0.997395833333333
"020012209","CABA",377,326,18,2,0,20,0.864721485411141
"020012807","CABA",314,285,2,0,0,2,0.907643312101911
"020051911","CABA",437,435,2,0,0,2,0.995423340961098
"020012805","CABA",354,353,1,0,0,1,0.997175141242938
"020061211","CABA",372,370,2,0,0,2,0.994623655913978
"020061604","CABA",310,310,0,0,0,0,1
"020032602","CABA",440,436,0,0,0,0,0.990909090909091
"020012804","CABA",280,277,0,0,0,0,0.989285714285714
"020100301","CABA",222,222,0,0,0,0,1
"020062102","CABA",452,441,0,0,0,0,0.975663716814159
"020061605","CABA",393,393,0,0,0,0,1
"020051804","CABA",277,276,0,0,0,0,0.996389891696751
"020012801","CABA",220,196,0,0,0,0,0.890909090909091
"020070104","CABA",255,254,1,0,0,1,0.996078431372549
"020032507","CABA",228,222,2,0,0,2,0.973684210526316
"020061401","CABA",382,381,0,1,0,1,0.99738219895288
"020100902","CABA",321,317,4,0,0,4,0.987538940809969
"020101104","CABA",394,394,0,0,0,0,1
"020100909","CABA",250,248,2,0,0,2,0.992
"020032107","CABA",199,199,0,0,0,0,1
"020100801","CABA",406,396,7,0,2,9,0.975369458128079
"020070602","CABA",299,299,0,0,0,0,1
"020032508","CABA",716,711,3,0,0,3,0.993016759776536
"020032207","CABA",330,302,0,0,0,0,0.915151515151515
"020032208","CABA",375,356,4,0,0,4,0.949333333333333
"020101103","CABA",354,352,0,1,0,1,0.994350282485876
"020101009","CABA",350,347,3,0,0,3,0.991428571428571
"020032307","CABA",274,272,2,0,0,2,0.992700729927007
"020032509","CABA",319,318,1,0,0,1,0.996865203761755
"020051909","CABA",294,294,0,0,0,0,1
"020101106","CABA",183,183,0,0,0,0,1
"020061405","CABA",407,407,0,0,0,0,1
"020012408","CABA",184,184,0,0,0,0,1
"020062107","CABA",378,376,1,1,0,2,0.994708994708995
"020032308","CABA",336,330,6,0,0,6,0.982142857142857
"020070509","CABA",460,458,0,0,0,0,0.995652173913044
"020061602","CABA",284,284,0,0,0,0,1
"020012507","CABA",193,193,0,0,0,0,1
"020100906","CABA",343,340,2,0,0,2,0.991253644314869
"020101301","CABA",226,215,11,0,0,11,0.951327433628319
"020061504","CABA",270,269,0,1,0,1,0.996296296296296
"020070603","CABA",243,243,0,0,0,0,1
"020061302","CABA",586,586,0,0,0,0,1
"020070503","CABA",328,328,0,0,0,0,1
"020061212","CABA",208,208,0,0,0,0,1
"020012802","CABA",345,268,2,0,0,2,0.776811594202899
"020100302","CABA",290,289,1,0,0,1,0.996551724137931
"020032703","CABA",355,355,0,0,0,0,1
"020012506","CABA",351,349,2,0,0,2,0.994301994301994
"020061505","CABA",320,318,2,0,0,2,0.99375
"020062108","CABA",465,455,0,0,0,0,0.978494623655914
"020012607","CABA",142,141,0,0,1,1,0.992957746478873
"020061402","CABA",250,249,1,0,0,1,0.996
"020012806","CABA",281,265,4,0,0,4,0.943060498220641
"020100803","CABA",319,318,0,0,0,0,0.996865203761755
"020032702","CABA",330,330,0,0,0,0,1
"020012210","CABA",582,572,5,1,1,7,0.982817869415808
"020070704","CABA",266,266,0,0,0,0,1
"020100514","CABA",269,268,0,1,0,1,0.996282527881041
"020051907","CABA",199,198,1,0,0,1,0.994974874371859
"020070206","CABA",396,392,3,1,0,4,0.98989898989899
"020051910","CABA",364,363,1,0,0,1,0.997252747252747
"020062109","CABA",294,293,0,1,0,1,0.996598639455782
"020100901","CABA",329,325,4,0,0,4,0.987841945288754
"020012803","CABA",241,241,0,0,0,0,1
"020062101","CABA",293,292,0,0,0,0,0.996587030716723
"020051908","CABA",429,429,0,0,0,0,1
"020070605","CABA",414,353,1,0,0,1,0.852657004830918
"020061606","CABA",415,414,1,0,0,1,0.997590361445783
"020061406","CABA",484,470,2,0,0,2,0.971074380165289
"020070502","CABA",243,243,0,0,0,0,1
"020032701","CABA",400,386,1,0,0,1,0.965
"020061301","CABA",307,307,0,0,0,0,1
"020032605","CABA",341,339,2,0,0,2,0.994134897360704
"020070504","CABA",457,457,0,0,0,0,1
"020061303","CABA",302,301,1,0,0,1,0.996688741721854
"020051807","CABA",309,309,0,0,0,0,1
"020070604","CABA",305,305,0,0,0,0,1
"020100908","CABA",259,256,1,2,0,3,0.988416988416988
"020032604","CABA",227,227,0,0,0,0,1
"020051808","CABA",149,147,1,0,0,1,0.986577181208054
"020100402","CABA",402,401,1,0,0,1,0.997512437810945
"020101303","CABA",261,260,0,1,0,1,0.996168582375479
"020101102","CABA",433,431,0,0,0,0,0.995381062355658
"020100910","CABA",279,278,0,0,0,0,0.996415770609319
"020061506","CABA",283,278,4,0,0,4,0.982332155477032
"020012508","CABA",321,321,0,0,0,0,1
"020051809","CABA",267,264,2,1,0,3,0.98876404494382
"020101108","CABA",344,344,0,0,0,0,1
"020012509","CABA",212,201,4,1,0,5,0.94811320754717
"020051810","CABA",344,344,0,0,0,0,1
"020041701","CABA",221,221,0,0,0,0,1
"020061608","CABA",560,560,0,0,0,0,1
"020032603","CABA",334,300,5,0,0,5,0.898203592814371
"020070702","CABA",204,203,1,0,0,1,0.995098039215686
"020100804","CABA",367,365,1,1,0,2,0.994550408719346
"020012510","CABA",227,227,0,0,0,0,1
"020062111","CABA",387,386,1,0,0,1,0.997416020671835
"020012608","CABA",213,213,0,0,0,0,1
"020052002","CABA",410,410,0,0,0,0,1
"020070606","CABA",394,391,1,0,2,3,0.99238578680203
"020070705","CABA",287,263,1,0,0,1,0.916376306620209
"020012808","CABA",110,109,0,0,0,0,0.990909090909091
"020032704","CABA",313,312,0,1,0,1,0.996805111821086
"020012809","CABA",262,242,0,1,0,1,0.923664122137405
"020012810","CABA",353,324,1,0,0,1,0.917847025495751
"020101101","CABA",309,309,0,0,0,0,1
"020071101","CABA",315,313,2,0,0,2,0.993650793650794
"020012811","CABA",249,182,0,0,0,0,0.730923694779116
"020012812","CABA",235,204,4,0,0,4,0.868085106382979
"020101107","CABA",377,376,1,0,0,1,0.997347480106101
"020070701","CABA",245,243,0,0,0,0,0.991836734693878
"020052001","CABA",316,302,1,0,0,1,0.955696202531646
"020070501","CABA",341,341,0,0,0,0,1
"020012813","CABA",261,221,1,1,0,2,0.846743295019157
"020052105","CABA",266,266,0,0,0,0,1
"020061304","CABA",497,497,0,0,0,0,1
"020070706","CABA",365,362,2,1,0,3,0.991780821917808
"020032110","CABA",416,410,5,0,0,5,0.985576923076923
"020100403","CABA",300,300,0,0,0,0,1
"020061307","CABA",369,366,3,0,0,3,0.991869918699187
"020101302","CABA",255,255,0,0,0,0,1
"020032109","CABA",188,186,2,0,0,2,0.98936170212766
"020012710","CABA",248,231,0,0,0,0,0.931451612903226
"020061611","CABA",390,389,1,0,0,1,0.997435897435897
"020052104","CABA",370,367,0,1,0,1,0.991891891891892
"020071102","CABA",402,401,0,1,0,1,0.997512437810945
"020032209","CABA",373,364,2,1,0,3,0.975871313672922
"020070106","CABA",269,266,3,0,0,3,0.988847583643123
"020051811","CABA",315,315,0,0,0,0,1
"020061607","CABA",388,388,0,0,0,0,1
"020032705","CABA",317,315,1,1,0,2,0.993690851735016
"020070607","CABA",379,379,0,0,0,0,1
"020100303","CABA",293,293,0,0,0,0,1
"020101402","CABA",315,313,2,0,0,2,0.993650793650794
"020012511","CABA",252,252,0,0,0,0,1
"020041601","CABA",259,259,0,0,0,0,1
"020032310","CABA",397,383,13,0,0,13,0.964735516372796
"020061408","CABA",218,218,0,0,0,0,1
"020062110","CABA",368,365,2,1,0,3,0.991847826086957
"020101111","CABA",251,251,0,0,0,0,1
"020052103","CABA",209,209,0,0,0,0,1
"020032309","CABA",342,339,0,0,0,0,0.991228070175439
"020061306","CABA",267,267,0,0,0,0,1
"020101304","CABA",248,248,0,0,0,0,1
"020012609","CABA",316,314,2,0,0,2,0.993670886075949
"020071103","CABA",367,367,0,0,0,0,1
"020012709","CABA",324,306,0,0,1,1,0.944444444444444
"020052102","CABA",350,343,0,0,0,0,0.98
"020070707","CABA",248,244,4,0,0,4,0.983870967741935
"020061507","CABA",335,335,0,0,0,0,1
"020070609","CABA",289,288,1,0,0,1,0.996539792387543
"020032606","CABA",246,244,1,0,0,1,0.991869918699187
"020071105","CABA",229,224,2,0,0,2,0.978165938864629
"020100802","CABA",428,422,4,2,0,6,0.985981308411215
"020070105","CABA",172,172,0,0,0,0,1
"020061508","CABA",445,441,3,1,0,4,0.991011235955056
"020101109","CABA",381,380,1,0,0,1,0.99737532808399
"020100805","CABA",302,300,2,0,0,2,0.993377483443709
"020061305","CABA",361,347,0,0,0,0,0.961218836565097
"020052101","CABA",378,378,0,0,0,0,1
"020052003","CABA",385,371,11,2,0,13,0.963636363636364
"020071003","CABA",254,251,3,0,0,3,0.988188976377953
"020070608","CABA",185,185,0,0,0,0,1
"020061610","CABA",499,459,0,0,0,0,0.919839679358717
"020101206","CABA",214,214,0,0,0,0,1
"020100907","CABA",312,307,0,0,0,0,0.983974358974359
"020070107","CABA",185,184,1,0,0,1,0.994594594594595
"020100405","CABA",286,282,3,1,0,4,0.986013986013986
"020101305","CABA",315,313,1,0,1,2,0.993650793650794
"020101110","CABA",296,296,0,0,0,0,1
"020071104","CABA",380,376,4,0,0,4,0.989473684210526
"020012708","CABA",255,253,0,0,0,0,0.992156862745098
"020061409","CABA",309,308,1,0,0,1,0.996763754045307
"020072304","CABA",272,270,2,0,0,2,0.992647058823529
"020070708","CABA",220,220,0,0,0,0,1
"020052106","CABA",337,337,0,0,0,0,1
"020041704","CABA",296,296,0,0,0,0,1
"020101205","CABA",189,189,0,0,0,0,1
"020061609","CABA",418,417,1,0,0,1,0.997607655502392
"020071002","CABA",185,182,3,0,0,3,0.983783783783784
"020072303","CABA",318,312,0,0,0,0,0.981132075471698
"020052107","CABA",257,255,2,0,0,2,0.992217898832685
"020101203","CABA",309,293,1,0,0,1,0.948220064724919
"020100807","CABA",425,420,2,1,0,3,0.988235294117647
"020100304","CABA",218,218,0,0,0,0,1
"020072302","CABA",388,381,0,0,0,0,0.981958762886598
"020041403","CABA",277,249,5,1,0,6,0.898916967509025
"020041702","CABA",240,240,0,0,0,0,1
"020032608","CABA",246,244,2,0,0,2,0.991869918699187
"020041402","CABA",259,257,2,0,0,2,0.992277992277992
"020041705","CABA",328,328,0,0,0,0,1
"020071001","CABA",303,303,0,0,0,0,1
"020032707","CABA",367,364,2,1,0,3,0.991825613079019
"020012701","CABA",234,232,2,0,0,2,0.991452991452991
"020070711","CABA",282,282,0,0,0,0,1
"020012702","CABA",275,265,0,0,0,0,0.963636363636364
"020101204","CABA",243,243,0,0,0,0,1
"020100305","CABA",283,280,2,0,0,2,0.989399293286219
"020052109","CABA",236,224,3,0,0,3,0.949152542372881
"020012902","CABA",266,220,1,0,0,1,0.827067669172932
"020101306","CABA",278,278,0,0,0,0,1
"020061308","CABA",497,493,4,0,0,4,0.991951710261569
"020032607","CABA",312,307,4,0,0,4,0.983974358974359
"020061410","CABA",392,392,0,0,0,0,1
"020072206","CABA",365,362,1,0,0,1,0.991780821917808
"020041602","CABA",929,927,2,0,0,2,0.997847147470398
"020012901","CABA",420,402,0,0,0,0,0.957142857142857
"020040711","CABA",212,205,5,0,0,5,0.966981132075472
"020040712","CABA",272,258,0,0,0,0,0.948529411764706
"020072301","CABA",303,300,3,0,0,3,0.99009900990099
"020070709","CABA",410,383,0,1,0,1,0.934146341463415
"020061309","CABA",426,424,0,0,0,0,0.995305164319249
"020061510","CABA",305,304,1,0,0,1,0.99672131147541
"020070710","CABA",355,355,0,0,0,0,1
"020100404","CABA",288,288,0,0,0,0,1
"020100406","CABA",235,235,0,0,0,0,1
"020041710","CABA",280,274,2,0,0,2,0.978571428571429
"020072208","CABA",235,235,0,0,0,0,1
"020052110","CABA",253,251,2,0,0,2,0.992094861660079
"020041401","CABA",272,263,1,0,0,1,0.966911764705882
"020041706","CABA",280,280,0,0,0,0,1
"020072207","CABA",221,220,1,0,0,1,0.995475113122172
"020032706","CABA",306,302,3,1,0,4,0.986928104575163
"020071004","CABA",295,294,0,1,0,1,0.996610169491525
"020072305","CABA",290,289,0,1,0,1,0.996551724137931
"020101401","CABA",334,328,3,1,0,4,0.982035928143713
"020072205","CABA",386,386,0,0,0,0,1
"020032609","CABA",292,292,0,0,0,0,1
"020070908","CABA",397,395,2,0,0,2,0.994962216624685
"020012707","CABA",265,259,5,1,0,6,0.977358490566038
"020071006","CABA",351,339,0,0,0,0,0.965811965811966
"020012706","CABA",359,280,11,0,0,11,0.779944289693593
"020101202","CABA",370,369,1,0,0,1,0.997297297297297
"020040703","CABA",302,300,0,0,0,0,0.993377483443709
"020072306","CABA",276,274,1,0,0,1,0.992753623188406
"020041407","CABA",289,289,0,0,0,0,1
"020041709","CABA",337,337,0,0,0,0,1
"020071108","CABA",452,433,2,0,0,2,0.957964601769911
"020072202","CABA",365,356,0,0,0,0,0.975342465753425
"020101308","CABA",290,290,0,0,0,0,1
"020101403","CABA",322,322,0,0,0,0,1
"020041707","CABA",255,251,4,0,0,4,0.984313725490196
"020012703","CABA",293,272,12,1,0,13,0.928327645051195
"020100308","CABA",344,340,4,0,0,4,0.988372093023256
"020101201","CABA",347,346,1,0,0,1,0.997118155619596
"020100808","CABA",408,405,2,0,0,2,0.992647058823529
"020041703","CABA",217,214,3,0,0,3,0.986175115207373
"020070109","CABA",291,254,1,0,0,1,0.872852233676976
"020041404","CABA",495,493,2,0,0,2,0.995959595959596
"020070108","CABA",319,319,0,0,0,0,1
"020040702","CABA",290,290,0,0,0,0,1
"020052004","CABA",314,309,3,0,0,3,0.984076433121019
"020101207","CABA",238,237,1,0,0,1,0.995798319327731
"020071005","CABA",240,239,0,0,0,0,0.995833333333333
"020041408","CABA",410,391,19,0,0,19,0.953658536585366
"020100307","CABA",342,334,1,0,0,1,0.976608187134503
"020100806","CABA",290,288,1,1,0,2,0.993103448275862
"020072201","CABA",297,296,1,0,0,1,0.996632996632997
"020040701","CABA",304,302,2,0,0,2,0.993421052631579
"020052111","CABA",245,243,2,0,0,2,0.991836734693878
"020041604","CABA",267,262,1,1,0,2,0.9812734082397
"020072102","CABA",466,466,0,0,0,0,1
"020070910","CABA",307,293,0,0,0,0,0.954397394136808
"020040607","CABA",310,305,5,0,0,5,0.983870967741935
"020100408","CABA",264,264,0,0,0,0,1
"020071008","CABA",428,423,5,0,0,5,0.988317757009346
"020012903","CABA",276,270,1,1,0,2,0.978260869565217
"020071107","CABA",496,495,1,0,0,1,0.997983870967742
"020041301","CABA",357,357,0,0,0,0,1
"020012904","CABA",272,269,0,0,0,0,0.988970588235294
"020052108","CABA",248,238,7,0,0,7,0.959677419354839
"020100407","CABA",301,301,0,0,0,0,1
"020052006","CABA",288,285,0,0,0,0,0.989583333333333
"020041708","CABA",358,347,3,1,0,4,0.96927374301676
"020070802","CABA",356,354,0,0,0,0,0.99438202247191
"020101903","CABA",355,340,8,0,0,8,0.957746478873239
"020012905","CABA",306,290,3,0,0,3,0.947712418300654
"020040603","CABA",285,280,5,0,0,5,0.982456140350877
"020101309","CABA",281,275,0,0,0,0,0.97864768683274
"020041607","CABA",156,155,0,0,0,0,0.993589743589744
"020101307","CABA",254,254,0,0,0,0,1
"020101405","CABA",262,259,2,0,0,2,0.988549618320611
"020040601","CABA",431,420,1,0,0,1,0.974477958236659
"020041608","CABA",219,210,1,0,0,1,0.958904109589041
"020070801","CABA",326,326,0,0,0,0,1
"020072101","CABA",424,421,1,1,0,2,0.992924528301887
"020040704","CABA",814,790,5,0,0,5,0.97051597051597
"020072103","CABA",433,418,4,0,0,4,0.965357967667437
"020072203","CABA",361,359,1,0,0,1,0.994459833795014
"020041405","CABA",302,302,0,0,0,0,1
"020071010","CABA",332,329,0,0,0,0,0.990963855421687
"020101404","CABA",296,296,0,0,0,0,1
"020071109","CABA",366,366,0,0,0,0,1
"020101210","CABA",246,246,0,0,0,0,1
"020041603","CABA",438,438,0,0,0,0,1
"020070110","CABA",419,415,2,0,0,2,0.990453460620525
"020101208","CABA",311,311,0,0,0,0,1
"020041501","CABA",259,259,0,0,0,0,1
"020101311","CABA",287,287,0,0,0,0,1
"020072104","CABA",240,237,3,0,0,3,0.9875
"020052204","CABA",362,358,4,0,0,4,0.988950276243094
"020071201","CABA",422,419,3,0,0,3,0.992890995260663
"020071009","CABA",307,302,5,0,0,5,0.98371335504886
"020072209","CABA",224,223,1,0,0,1,0.995535714285714
"020012704","CABA",325,312,6,0,0,6,0.96
"020070911","CABA",263,258,3,1,0,4,0.980988593155893
"020072307","CABA",313,313,0,0,0,0,1
"020040608","CABA",317,316,1,0,0,1,0.996845425867508
"020012909","CABA",376,372,1,0,0,1,0.98936170212766
"020052203","CABA",260,255,0,1,0,1,0.980769230769231
"020101209","CABA",308,307,1,0,0,1,0.996753246753247
"020052005","CABA",332,328,4,0,0,4,0.987951807228916
"020012908","CABA",260,257,2,0,0,2,0.988461538461539
"020052202","CABA",292,292,0,0,0,0,1
"020100409","CABA",305,305,0,0,0,0,1
"020071110","CABA",249,248,1,0,0,1,0.995983935742972
"020101902","CABA",436,415,0,0,0,0,0.951834862385321
"020072105","CABA",250,250,0,0,0,0,1
"020072108","CABA",175,175,0,0,0,0,1
"020072308","CABA",322,304,3,0,0,3,0.944099378881988
"020070907","CABA",329,328,1,0,0,1,0.996960486322188
"020101502","CABA",347,346,1,0,0,1,0.997118155619596
"020072204","CABA",378,377,1,0,0,1,0.997354497354497
"020101310","CABA",230,230,0,0,0,0,1
"020040606","CABA",375,375,0,0,0,0,1
"020041406","CABA",208,208,0,0,0,0,1
"020041610","CABA",280,274,0,0,0,0,0.978571428571429
"020040705","CABA",297,291,6,0,0,6,0.97979797979798
"020072309","CABA",289,288,0,0,0,0,0.996539792387543
"020040602","CABA",320,319,0,0,0,0,0.996875
"020052201","CABA",260,260,0,0,0,0,1
"020071304","CABA",216,215,0,0,0,0,0.99537037037037
"020101904","CABA",340,314,3,0,0,3,0.923529411764706
"020070906","CABA",356,335,0,0,0,0,0.941011235955056
"020070803","CABA",247,247,0,0,0,0,1
"020071202","CABA",216,216,0,0,0,0,1
"020100809","CABA",264,261,3,0,0,3,0.988636363636364
"020041904","CABA",375,326,10,3,0,13,0.869333333333333
"020101312","CABA",267,266,1,0,0,1,0.99625468164794
"020071203","CABA",278,278,0,0,0,0,1
"020012705","CABA",288,268,2,0,0,2,0.930555555555556
"020041605","CABA",412,412,0,0,0,0,1
"020070901","CABA",259,258,1,0,0,1,0.996138996138996
"020041201","CABA",229,208,1,0,0,1,0.908296943231441
"020041502","CABA",624,624,0,0,0,0,1
"020040609","CABA",274,272,2,0,0,2,0.992700729927007
"020070804","CABA",358,356,2,0,0,2,0.994413407821229
"020090102","CABA",184,184,0,0,0,0,1
"020072210","CABA",268,268,0,0,0,0,1
"020101503","CABA",202,197,3,0,0,3,0.975247524752475
"020101504","CABA",247,247,0,0,0,0,1
"020041306","CABA",204,204,0,0,0,0,1
"020100306","CABA",278,274,2,0,0,2,0.985611510791367
"020072106","CABA",423,423,0,0,0,0,1
"020101901","CABA",265,223,0,0,0,0,0.841509433962264
"020012906","CABA",323,309,6,0,0,6,0.956656346749226
"020101501","CABA",263,260,2,1,0,3,0.988593155893536
"020070805","CABA",392,392,0,0,0,0,1
"020041503","CABA",483,483,0,0,0,0,1
"020090101","CABA",206,206,0,0,0,0,1
"020052007","CABA",315,307,8,0,0,8,0.974603174603175
"020041609","CABA",431,426,0,2,0,2,0.988399071925754
"020040605","CABA",275,275,0,0,0,0,1
"020041303","CABA",253,246,1,0,0,1,0.972332015810277
"020101406","CABA",205,205,0,0,0,0,1
"020040706","CABA",287,286,1,0,0,1,0.996515679442509
"020101905","CABA",348,339,0,0,0,0,0.974137931034483
"020052206","CABA",332,332,0,0,0,0,1
"020070902","CABA",276,273,2,0,0,2,0.989130434782609
"020072211","CABA",286,285,0,0,0,0,0.996503496503496
"020070905","CABA",197,196,1,0,0,1,0.99492385786802
"020040604","CABA",320,318,1,1,0,2,0.99375
"020041302","CABA",240,240,0,0,0,0,1
"020041908","CABA",459,424,15,6,0,21,0.923747276688453
"020071303","CABA",415,408,7,0,0,7,0.983132530120482
"020101407","CABA",291,282,0,0,0,0,0.969072164948454
"020071305","CABA",329,326,1,0,0,1,0.990881458966565
"020041202","CABA",216,208,1,0,0,1,0.962962962962963
"020041903","CABA",323,315,2,0,0,2,0.975232198142415
"020070903","CABA",226,226,0,0,0,0,1
"020072404","CABA",379,379,0,0,0,0,1
"020070807","CABA",319,319,0,0,0,0,1
"020101906","CABA",347,335,6,4,1,11,0.965417867435158
"020101806","CABA",280,258,22,0,0,22,0.921428571428571
"020101910","CABA",400,380,0,0,0,0,0.95
"020072403","CABA",384,319,2,0,0,2,0.830729166666667
"020090107","CABA",257,252,2,2,0,4,0.980544747081712
"020072107","CABA",303,303,0,0,0,0,1
"020070904","CABA",415,415,0,0,0,0,1
"020070806","CABA",373,360,1,0,0,1,0.96514745308311
"020101805","CABA",277,272,1,0,0,1,0.981949458483754
"020041901","CABA",255,233,17,0,1,18,0.913725490196078
"020052205","CABA",277,271,5,0,1,6,0.978339350180505
"020012907","CABA",328,300,1,0,0,1,0.914634146341463
"020071204","CABA",319,318,1,0,0,1,0.996865203761755
"020071302","CABA",294,292,1,1,0,2,0.993197278911565
"020072212","CABA",256,256,0,0,0,0,1
"020040710","CABA",287,283,4,0,0,4,0.986062717770035
"020052008","CABA",317,316,1,0,0,1,0.996845425867508
"020071315","CABA",185,185,0,0,0,0,1
"020072402","CABA",318,317,1,0,0,1,0.99685534591195
"020101505","CABA",298,298,0,0,0,0,1
"020072213","CABA",289,289,0,0,0,0,1
"020071306","CABA",265,264,1,0,0,1,0.99622641509434
"020101809","CABA",458,456,1,1,0,2,0.995633187772926
"020101909","CABA",276,266,0,0,0,0,0.963768115942029
"020041606","CABA",248,225,0,0,0,0,0.907258064516129
"020101409","CABA",337,326,3,0,1,4,0.967359050445104
"020041504","CABA",297,297,0,0,0,0,1
"020040709","CABA",273,263,0,0,1,1,0.963369963369963
"020041304","CABA",226,226,0,0,0,0,1
"020052207","CABA",724,723,0,0,1,1,0.998618784530387
"020090108","CABA",278,263,0,1,0,1,0.946043165467626
"020040610","CABA",215,215,0,0,0,0,1
"020071314","CABA",220,220,0,0,0,0,1
"020070808","CABA",368,363,5,0,0,5,0.986413043478261
"020071205","CABA",297,296,1,0,0,1,0.996632996632997
"020041902","CABA",259,255,4,0,0,4,0.984555984555985
"020040708","CABA",286,283,2,0,0,2,0.989510489510489
"020101804","CABA",396,381,9,0,0,9,0.962121212121212
"020071310","CABA",193,190,1,1,0,2,0.984455958549223
"020071402","CABA",298,298,0,0,0,0,1
"020101911","CABA",344,343,1,0,0,1,0.997093023255814
"020041305","CABA",391,391,0,0,0,0,1
"020072401","CABA",345,343,2,0,0,2,0.994202898550725
"020040502","CABA",260,259,1,0,0,1,0.996153846153846
"020072405","CABA",344,343,1,0,0,1,0.997093023255814
"020041905","CABA",286,283,2,0,0,2,0.989510489510489
"020042006","CABA",305,286,6,2,0,8,0.937704918032787
"020041308","CABA",174,149,0,0,0,0,0.85632183908046
"020040707","CABA",314,313,1,0,0,1,0.996815286624204
"020101908","CABA",215,212,3,0,0,3,0.986046511627907
"020101408","CABA",253,253,0,0,0,0,1
"020052210","CABA",296,293,2,0,0,2,0.989864864864865
"020041203","CABA",302,294,4,0,0,4,0.973509933774834
"020041907","CABA",287,217,2,1,0,3,0.75609756097561
"020041506","CABA",240,236,1,0,0,1,0.983333333333333
"020052012","CABA",297,286,10,0,0,10,0.962962962962963
"020101411","CABA",267,233,1,0,0,1,0.872659176029963
"020101803","CABA",337,335,2,0,0,2,0.99406528189911
"020052009","CABA",326,322,3,0,0,3,0.987730061349693
"020041505","CABA",219,218,1,0,0,1,0.995433789954338
"020101508","CABA",375,369,2,2,1,5,0.984
"020071206","CABA",302,302,0,0,0,0,1
"020072001","CABA",380,372,8,0,0,8,0.978947368421053
"020052209","CABA",278,276,2,0,0,2,0.992805755395683
"020090106","CABA",291,288,1,1,0,2,0.989690721649485
"020040806","CABA",274,267,4,0,0,4,0.974452554744526
"020071307","CABA",202,200,2,0,0,2,0.99009900990099
"020101808","CABA",184,184,0,0,0,0,1
"020071309","CABA",166,166,0,0,0,0,1
"020071311","CABA",253,253,0,0,0,0,1
"020041906","CABA",363,315,14,0,0,14,0.867768595041322
"020101410","CABA",341,341,0,0,0,0,1
"020040501","CABA",369,366,3,0,0,3,0.991869918699187
"020071403","CABA",257,257,0,0,0,0,1
"020040503","CABA",331,330,1,0,0,1,0.996978851963746
"020071401","CABA",313,312,1,0,0,1,0.996805111821086
"020090109","CABA",344,338,6,0,0,6,0.982558139534884
"020101507","CABA",225,225,0,0,0,0,1
"020042001","CABA",324,308,11,1,0,12,0.950617283950617
"020101912","CABA",429,428,1,0,0,1,0.997668997668998
"020072111","CABA",339,339,0,0,0,0,1
"020042008","CABA",243,226,9,3,0,12,0.930041152263374
"020041307","CABA",400,399,1,0,0,1,0.9975
"020040805","CABA",268,267,1,0,0,1,0.996268656716418
"020072110","CABA",376,375,1,0,0,1,0.997340425531915
"020040611","CABA",246,246,0,0,0,0,1
"020101506","CABA",248,247,1,0,0,1,0.995967741935484
"020101810","CABA",191,181,1,0,0,1,0.947643979057592
"020052010","CABA",380,368,4,0,0,4,0.968421052631579
"020072406","CABA",371,369,1,0,0,1,0.994609164420485
"020041204","CABA",371,369,2,0,0,2,0.994609164420485
"020041507","CABA",274,273,0,0,0,0,0.996350364963504
"020101601","CABA",270,259,1,0,0,1,0.959259259259259
"020101802","CABA",270,270,0,0,0,0,1
"020090105","CABA",294,294,0,0,0,0,1
"020041309","CABA",170,168,2,0,0,2,0.988235294117647
"020040505","CABA",203,202,1,0,0,1,0.995073891625616
"020072109","CABA",307,304,3,0,0,3,0.990228013029316
"020072006","CABA",283,277,6,0,0,6,0.978798586572438
"020040807","CABA",837,801,13,0,0,13,0.956989247311828
"020042004","CABA",221,192,2,1,0,3,0.868778280542986
"020071207","CABA",218,217,1,0,0,1,0.995412844036697
"020042009","CABA",293,266,10,2,1,13,0.907849829351536
"020041909","CABA",339,314,4,4,1,9,0.926253687315634
"020052208","CABA",246,240,5,0,0,5,0.975609756097561
"020040804","CABA",293,291,1,0,0,1,0.993174061433447
"020072407","CABA",289,287,2,0,0,2,0.993079584775087
"020091104","CABA",370,370,0,0,0,0,1
"020071404","CABA",258,258,0,0,0,0,1
"020071405","CABA",295,295,0,0,0,0,1
"020072112","CABA",313,300,3,0,0,3,0.958466453674121
"020101701","CABA",313,313,0,0,0,0,1
"020071313","CABA",196,195,1,0,0,1,0.994897959183674
"020101602","CABA",408,403,1,0,0,1,0.987745098039216
"020101509","CABA",459,459,0,0,0,0,1
"020101801","CABA",280,278,1,0,0,1,0.992857142857143
"020040506","CABA",349,349,0,0,0,0,1
"020090103","CABA",261,260,1,0,0,1,0.996168582375479
"020101703","CABA",360,356,4,0,0,4,0.988888888888889
"020091102","CABA",355,353,2,0,0,2,0.994366197183099
"020052211","CABA",320,317,3,0,0,3,0.990625
"020101702","CABA",372,371,1,0,0,1,0.997311827956989
"020042010","CABA",364,337,17,2,0,19,0.925824175824176
"020040803","CABA",240,240,0,0,0,0,1
"020041508","CABA",270,270,0,0,0,0,1
"020090104","CABA",269,266,3,0,0,3,0.988847583643123
"020071407","CABA",272,272,0,0,0,0,1
"020072408","CABA",331,327,4,0,0,4,0.987915407854985
"020071308","CABA",194,193,1,0,0,1,0.994845360824742
"020041311","CABA",448,447,1,0,0,1,0.997767857142857
"020041310","CABA",202,202,0,0,0,0,1
"020040802","CABA",311,302,8,0,0,8,0.971061093247588
"020072002","CABA",192,189,0,0,0,0,0.984375
"020101706","CABA",308,305,3,0,0,3,0.99025974025974
"020091101","CABA",430,424,6,0,0,6,0.986046511627907
"020052213","CABA",218,210,0,0,0,0,0.963302752293578
"020071209","CABA",290,287,3,0,0,3,0.989655172413793
"020071312","CABA",222,222,0,0,0,0,1
"020041910","CABA",263,258,3,0,0,3,0.980988593155893
"020042002","CABA",257,253,3,0,0,3,0.98443579766537
"020042005","CABA",211,195,4,2,0,6,0.924170616113744
"020101705","CABA",367,363,4,0,0,4,0.989100817438692
"020101603","CABA",282,279,2,0,0,2,0.98936170212766
"020071411","CABA",323,322,0,0,0,0,0.996904024767802
"020071604","CABA",241,226,10,1,0,11,0.937759336099585
"020091105","CABA",397,394,2,0,0,2,0.992443324937028
"020041510","CABA",188,186,1,0,0,1,0.98936170212766
"020071406","CABA",379,378,1,0,0,1,0.997361477572559
"020052212","CABA",326,325,1,0,0,1,0.996932515337423
"020101811","CABA",224,224,0,0,0,0,1
"020041509","CABA",254,253,0,0,0,0,0.996062992125984
"020090202","CABA",301,300,1,0,0,1,0.996677740863787
"020040507","CABA",251,250,1,0,0,1,0.99601593625498
"020101704","CABA",378,377,1,0,0,1,0.997354497354497
"020041205","CABA",231,223,8,0,0,8,0.965367965367965
"020072003","CABA",259,256,2,1,0,3,0.988416988416988
"020042011","CABA",323,310,4,2,0,6,0.959752321981424
"020040808","CABA",97,97,0,0,0,0,1
"020072410","CABA",323,316,5,1,0,6,0.978328173374613
"020090305","CABA",271,271,0,0,0,0,1
"020072005","CABA",278,276,2,0,0,2,0.992805755395683
"020090306","CABA",298,298,0,0,0,0,1
"020101812","CABA",297,295,2,0,0,2,0.993265993265993
"020090304","CABA",242,241,1,0,0,1,0.995867768595041
"020090201","CABA",349,347,2,0,0,2,0.994269340974212
"020042003","CABA",281,261,7,3,0,10,0.928825622775801
"020090303","CABA",239,239,0,0,0,0,1
"020101604","CABA",344,344,0,0,0,0,1
"020091103","CABA",292,291,1,0,0,1,0.996575342465753
"020090302","CABA",255,254,1,0,0,1,0.996078431372549
"020090301","CABA",263,260,3,0,0,3,0.988593155893536
"020040508","CABA",247,244,3,0,0,3,0.987854251012146
"020090203","CABA",330,330,0,0,0,0,1
"020090204","CABA",414,414,0,0,0,0,1
"020040809","CABA",350,345,2,1,0,3,0.985714285714286
"020071412","CABA",339,337,2,0,0,2,0.994100294985251
"020091009","CABA",170,170,0,0,0,0,1
"020072007","CABA",279,272,1,0,0,1,0.974910394265233
"020040801","CABA",304,301,3,0,0,3,0.990131578947368
"020040403","CABA",320,316,4,0,0,4,0.9875
"020101605","CABA",389,387,2,0,0,2,0.994858611825193
"020072411","CABA",371,371,0,0,0,0,1
"020071602","CABA",253,251,2,0,0,2,0.992094861660079
"020042012","CABA",471,468,2,0,0,2,0.993630573248408
"020042201","CABA",257,257,0,0,0,0,1
"020071605","CABA",274,273,1,0,0,1,0.996350364963504
"020041208","CABA",184,176,0,0,0,0,0.956521739130435
"020040810","CABA",238,230,7,1,0,8,0.966386554621849
"020091107","CABA",385,381,1,0,0,1,0.98961038961039
"020041207","CABA",157,154,2,0,0,2,0.980891719745223
"020071208","CABA",213,209,4,0,0,4,0.981220657276995
"020091111","CABA",329,329,0,0,0,0,1
"020042103","CABA",207,207,0,0,0,0,1
"020091008","CABA",322,322,0,0,0,0,1
"020042202","CABA",297,272,0,0,0,0,0.915824915824916
"020072004","CABA",190,187,3,0,0,3,0.984210526315789
"020101607","CABA",289,288,1,0,0,1,0.996539792387543
"020040402","CABA",295,294,1,0,0,1,0.996610169491525
"020090205","CABA",428,425,3,0,0,3,0.992990654205608
"020041206","CABA",249,244,2,0,0,2,0.979919678714859
"020071408","CABA",300,300,0,0,0,0,1
"020040401","CABA",236,232,4,0,0,4,0.983050847457627
"020071413","CABA",251,250,1,0,0,1,0.99601593625498
"020072409","CABA",341,341,0,0,0,0,1
"020101606","CABA",356,355,1,0,0,1,0.997191011235955
"020091106","CABA",327,325,1,1,0,2,0.99388379204893
"020090307","CABA",316,315,1,0,0,1,0.996835443037975
"020101707","CABA",289,285,0,0,0,0,0.986159169550173
"020041209","CABA",312,312,0,0,0,0,1
"020090506","CABA",315,315,0,0,0,0,1
"020071410","CABA",233,227,2,0,0,2,0.974248927038627
"020071603","CABA",264,262,2,0,0,2,0.992424242424242
"020091108","CABA",311,309,2,0,0,2,0.993569131832797
"020090206","CABA",255,255,0,0,0,0,1
"020042102","CABA",263,219,12,2,0,14,0.832699619771863
"020040811","CABA",281,270,5,0,0,5,0.96085409252669
"020042101","CABA",245,212,12,2,0,14,0.86530612244898
"020091010","CABA",304,304,0,0,0,0,1
"020072008","CABA",441,434,0,0,0,0,0.984126984126984
"020101708","CABA",246,244,1,0,0,1,0.991869918699187
"020072009","CABA",302,300,0,1,0,1,0.993377483443709
"020091007","CABA",249,249,0,0,0,0,1
"020040308","CABA",275,274,0,0,0,0,0.996363636363636
"020090209","CABA",358,357,1,0,0,1,0.997206703910615
"020101709","CABA",239,238,0,0,0,0,0.99581589958159
"020071601","CABA",248,246,2,0,0,2,0.991935483870968
"020041210","CABA",284,282,2,0,0,2,0.992957746478873
"020090210","CABA",305,303,2,0,0,2,0.99344262295082
"020071606","CABA",352,344,1,1,0,2,0.977272727272727
"020042203","CABA",352,350,1,0,0,1,0.994318181818182
"020040307","CABA",229,222,1,0,0,1,0.96943231441048
"020042104","CABA",249,201,9,2,0,11,0.807228915662651
"020071609","CABA",335,331,3,1,0,4,0.988059701492537
"020090509","CABA",330,276,0,0,0,0,0.836363636363636
"020040404","CABA",330,322,7,1,0,8,0.975757575757576
"020040405","CABA",366,361,5,0,0,5,0.986338797814208
"020091202","CABA",191,186,5,0,0,5,0.973821989528796
"020101609","CABA",338,332,4,1,0,5,0.982248520710059
"020040306","CABA",296,294,2,0,0,2,0.993243243243243
"020041001","CABA",23,22,1,0,0,1,0.956521739130435
"020071504","CABA",232,227,0,0,0,0,0.978448275862069
"020040305","CABA",361,359,1,1,0,2,0.994459833795014
"020091006","CABA",282,279,3,0,0,3,0.98936170212766
"020041211","CABA",260,260,0,0,0,0,1
"020042105","CABA",238,237,1,0,0,1,0.995798319327731
"020101608","CABA",312,309,3,0,0,3,0.990384615384615
"020042205","CABA",284,275,5,0,0,5,0.96830985915493
"020091109","CABA",314,311,3,0,0,3,0.990445859872611
"020040309","CABA",183,181,2,0,0,2,0.989071038251366
"020071607","CABA",320,313,2,3,0,5,0.978125
"020040301","CABA",342,340,2,0,0,2,0.994152046783626
"020090510","CABA",319,314,4,0,0,4,0.984326018808777
"020071409","CABA",289,284,5,0,0,5,0.982698961937716
"020090207","CABA",300,300,0,0,0,0,1
"020090211","CABA",341,341,0,0,0,0,1
"020091011","CABA",245,244,1,0,0,1,0.995918367346939
"020090310","CABA",283,283,0,0,0,0,1
"020071901","CABA",274,199,7,59,0,66,0.726277372262774
"020042106","CABA",270,262,1,1,0,2,0.97037037037037
"020091004","CABA",237,237,0,0,0,0,1
"020101710","CABA",269,269,0,0,0,0,1
"020090313","CABA",313,309,4,0,0,4,0.987220447284345
"020072012","CABA",223,216,4,0,0,4,0.968609865470852
"020091012","CABA",224,223,1,0,0,1,0.995535714285714
"020091005","CABA",342,337,4,1,0,5,0.985380116959064
"020071503","CABA",316,313,2,0,0,2,0.990506329113924
"020090208","CABA",245,244,1,0,0,1,0.995918367346939
"020040406","CABA",286,283,3,0,0,3,0.989510489510489
"020091110","CABA",306,281,0,0,0,0,0.918300653594771
"020072011","CABA",363,357,3,2,0,5,0.983471074380165
"020071505","CABA",233,231,2,0,0,2,0.991416309012876
"020042204","CABA",495,495,0,0,0,0,1
"020071502","CABA",360,357,1,2,0,3,0.991666666666667
"020090308","CABA",279,278,1,0,0,1,0.996415770609319
"020091003","CABA",328,321,7,0,0,7,0.978658536585366
"020040310","CABA",293,289,3,0,0,3,0.986348122866894
"020040509","CABA",634,618,3,1,0,4,0.974763406940063
"020042207","CABA",402,397,1,3,0,4,0.987562189054726
"020042109","CABA",253,212,10,2,0,12,0.837944664031621
"020090311","CABA",294,293,1,0,0,1,0.996598639455782
"020090212","CABA",223,221,2,0,0,2,0.991031390134529
"020090608","CABA",281,274,5,0,0,5,0.97508896797153
"020042108","CABA",294,268,10,2,0,12,0.91156462585034
"020090508","CABA",292,290,1,1,0,2,0.993150684931507
"020071608","CABA",352,349,2,0,0,2,0.991477272727273
"020072010","CABA",368,337,4,1,0,5,0.915760869565217
"020040407","CABA",329,324,1,0,0,1,0.984802431610942
"020091302","CABA",404,403,1,0,0,1,0.997524752475248
"020071506","CABA",334,334,0,0,0,0,1
"020042206","CABA",255,254,0,1,0,1,0.996078431372549
"020041212","CABA",223,222,1,0,0,1,0.995515695067265
"020090609","CABA",373,373,0,0,0,0,1
"020090511","CABA",317,315,2,0,0,2,0.993690851735016
"020091112","CABA",414,404,0,0,0,0,0.975845410628019
"020042107","CABA",275,262,6,4,0,10,0.952727272727273
"020040304","CABA",298,288,0,2,0,2,0.966442953020134
"020071902","CABA",507,490,0,0,0,0,0.96646942800789
"020071904","CABA",455,444,7,0,0,7,0.975824175824176
"020040408","CABA",288,288,0,0,0,0,1
"020090501","CABA",310,310,0,0,0,0,1
"020042110","CABA",234,175,6,0,1,7,0.747863247863248
"020040311","CABA",307,298,1,0,0,1,0.970684039087948
"020040409","CABA",285,285,0,0,0,0,1
"020072013","CABA",575,562,13,0,0,13,0.977391304347826
"020042208","CABA",363,352,7,2,0,9,0.96969696969697
"020040302","CABA",297,290,2,1,0,3,0.976430976430976
"020090503","CABA",261,260,0,1,0,1,0.996168582375479
"020090606","CABA",259,247,10,0,0,10,0.953667953667954
"020090610","CABA",345,341,4,0,0,4,0.988405797101449
"020091001","CABA",298,298,0,0,0,0,1
"020071701","CABA",439,429,5,3,0,8,0.977220956719818
"020091002","CABA",336,318,1,0,0,1,0.946428571428571
"020042305","CABA",227,212,15,0,0,15,0.933920704845815
"020071507","CABA",285,285,0,0,0,0,1
"020091301","CABA",315,305,4,6,0,10,0.968253968253968
"020090309","CABA",257,257,0,0,0,0,1
"020071903","CABA",363,351,11,1,0,12,0.966942148760331
"020042111","CABA",281,264,10,4,0,14,0.939501779359431
"020091201","CABA",338,338,0,0,0,0,1
"020090312","CABA",213,213,0,0,0,0,1
"020040312","CABA",341,336,1,0,0,1,0.98533724340176
"020040510","CABA",397,390,3,0,0,3,0.982367758186398
"020090607","CABA",374,344,0,0,0,0,0.919786096256685
"020040303","CABA",221,218,3,0,0,3,0.986425339366516
"020071508","CABA",293,291,2,0,0,2,0.993174061433447
"020090507","CABA",314,314,0,0,0,0,1
"020091303","CABA",402,383,0,2,0,2,0.95273631840796
"020040511","CABA",340,327,12,0,0,12,0.961764705882353
"020042304","CABA",265,256,9,0,0,9,0.966037735849057
"020040101","CABA",247,247,0,0,0,0,1
"020071509","CABA",397,396,1,0,0,1,0.997481108312343
"020071510","CABA",327,315,6,5,0,11,0.963302752293578
"020040411","CABA",344,325,9,1,0,10,0.944767441860465
"020090605","CABA",412,411,1,0,0,1,0.997572815533981
"020042112","CABA",190,173,3,8,0,11,0.910526315789474
"020090502","CABA",322,319,1,2,0,3,0.990683229813665
"020091203","CABA",283,281,2,0,0,2,0.992932862190813
"020090611","CABA",309,303,3,1,0,4,0.980582524271845
"020042209","CABA",259,258,1,0,0,1,0.996138996138996
"020090504","CABA",303,301,1,1,0,2,0.993399339933993
"020042303","CABA",258,231,5,0,0,5,0.895348837209302
"020071501","CABA",225,220,3,2,0,5,0.977777777777778
"020042301","CABA",272,263,7,2,0,9,0.966911764705882
"020071905","CABA",392,378,9,2,0,11,0.964285714285714
"020071706","CABA",375,331,18,17,1,36,0.882666666666667
"020090907","CABA",359,356,3,0,0,3,0.991643454038997
"020071807","CABA",286,285,0,0,0,0,0.996503496503496
"020091304","CABA",250,246,3,1,0,4,0.984
"020090404","CABA",329,329,0,0,0,0,1
"020090403","CABA",342,340,2,0,0,2,0.994152046783626
"020090604","CABA",341,315,1,0,0,1,0.92375366568915
"020090402","CABA",325,318,7,0,0,7,0.978461538461538
"020071705","CABA",268,257,8,1,0,9,0.958955223880597
"020090401","CABA",361,360,1,0,0,1,0.997229916897507
"020090408","CABA",270,269,1,0,0,1,0.996296296296296
"020071702","CABA",500,430,46,16,2,64,0.86
"020071808","CABA",246,244,2,0,0,2,0.991869918699187
"020041101","CABA",293,287,2,1,0,3,0.979522184300341
"020090411","CABA",341,319,2,0,0,2,0.935483870967742
"020091208","CABA",320,314,3,3,0,6,0.98125
"020091204","CABA",296,295,0,0,0,0,0.996621621621622
"020042210","CABA",229,225,4,0,0,4,0.982532751091703
"020040313","CABA",197,164,7,8,0,15,0.83248730964467
"020040102","CABA",263,251,4,0,0,4,0.954372623574145
"020090601","CABA",408,406,1,0,0,1,0.995098039215686
"020040103","CABA",215,212,2,1,0,3,0.986046511627907
"020071906","CABA",440,434,3,1,0,4,0.986363636363636
"020090505","CABA",384,382,1,1,0,2,0.994791666666667
"020090612","CABA",286,285,0,0,0,0,0.996503496503496
"020041002","CABA",661,545,25,43,5,73,0.824508320726172
"020090714","CABA",297,294,3,0,0,3,0.98989898989899
"020091207","CABA",250,250,0,0,0,0,1
"020040410","CABA",273,255,8,0,0,8,0.934065934065934
"020090908","CABA",205,205,0,0,0,0,1
"020042603","CABA",340,320,13,2,0,15,0.941176470588235
"020071805","CABA",292,284,5,0,0,5,0.972602739726027
"020042211","CABA",290,286,4,0,0,4,0.986206896551724
"020041005","CABA",519,459,19,19,0,38,0.884393063583815
"020071707","CABA",764,703,23,6,0,29,0.920157068062827
"020071804","CABA",254,242,2,2,0,4,0.952755905511811
"020040210","CABA",316,305,4,3,0,7,0.965189873417722
"020042306","CABA",304,298,6,0,0,6,0.980263157894737
"020071803","CABA",288,262,11,0,1,12,0.909722222222222
"020071511","CABA",367,364,0,1,0,1,0.991825613079019
"020071709","CABA",618,602,7,0,1,8,0.97411003236246
"020090410","CABA",290,289,0,0,0,0,0.996551724137931
"020042302","CABA",288,282,5,0,0,5,0.979166666666667
"020091212","CABA",232,231,0,1,0,1,0.995689655172414
"020090602","CABA",259,258,1,0,0,1,0.996138996138996
"020071809","CABA",377,317,18,4,1,23,0.840848806366048
"020071703","CABA",416,381,10,4,0,14,0.915865384615385
"020071708","CABA",338,322,4,0,0,4,0.952662721893491
"020071704","CABA",509,455,9,8,1,18,0.893909626719057
"020090909","CABA",256,256,0,0,0,0,1
"020071806","CABA",485,425,21,23,0,44,0.876288659793814
"020090706","CABA",308,307,1,0,0,1,0.996753246753247
"020042212","CABA",218,216,1,0,0,1,0.990825688073395
"020071802","CABA",124,113,11,0,0,11,0.911290322580645
"020090901","CABA",282,242,4,0,0,4,0.858156028368794
"020042308","CABA",288,285,0,0,0,0,0.989583333333333
"020091205","CABA",290,290,0,0,0,0,1
"020041102","CABA",327,324,3,0,0,3,0.990825688073395
"020042307","CABA",233,226,4,1,1,6,0.969957081545064
"020041003","CABA",507,356,48,94,1,143,0.702169625246548
"020090603","CABA",373,362,5,6,0,11,0.970509383378016
"020090708","CABA",275,273,0,0,0,0,0.992727272727273
"020091306","CABA",300,293,3,2,1,6,0.976666666666667
"020040207","CABA",314,298,6,2,0,8,0.949044585987261
"020080304","CABA",250,199,7,0,0,7,0.796
"020090906","CABA",304,287,14,3,0,17,0.944078947368421
"020041105","CABA",185,185,0,0,0,0,1
"020090405","CABA",355,349,6,0,0,6,0.983098591549296
"020091206","CABA",338,333,4,1,0,5,0.985207100591716
"020091305","CABA",303,298,3,0,0,3,0.983498349834984
"020071811","CABA",403,331,21,34,2,57,0.821339950372208
"020091209","CABA",292,291,0,1,0,1,0.996575342465753
"020090910","CABA",285,284,1,0,0,1,0.996491228070175
"020071810","CABA",414,367,38,8,0,46,0.886473429951691
"020071801","CABA",395,355,38,0,0,38,0.89873417721519
"020071710","CABA",500,470,16,3,0,19,0.94
"020090914","CABA",310,306,2,0,0,2,0.987096774193548
"020042311","CABA",206,205,1,0,0,1,0.995145631067961
"020041108","CABA",313,312,1,0,0,1,0.996805111821086
"020040209","CABA",209,204,4,1,0,5,0.976076555023923
"020090902","CABA",268,267,0,1,0,1,0.996268656716418
"020040108","CABA",225,222,0,0,0,0,0.986666666666667
"020040208","CABA",189,185,4,0,0,4,0.978835978835979
"020091211","CABA",310,304,4,0,0,4,0.980645161290323
"020040203","CABA",383,371,11,1,0,12,0.968668407310705
"020071711","CABA",190,185,1,0,1,2,0.973684210526316
"020040201","CABA",274,269,3,1,0,4,0.981751824817518
"020091210","CABA",343,337,2,4,0,6,0.982507288629738
"020090707","CABA",232,232,0,0,0,0,1
"020041104","CABA",250,242,8,0,0,8,0.968
"020040904","CABA",176,173,2,0,0,2,0.982954545454545
"020042602","CABA",283,273,7,0,0,7,0.964664310954064
"020090409","CABA",256,255,0,1,0,1,0.99609375
"020091403","CABA",263,258,2,3,0,5,0.980988593155893
"020041004","CABA",124,108,4,6,0,10,0.870967741935484
"020090709","CABA",313,312,1,0,0,1,0.996805111821086
"020040104","CABA",236,231,0,2,0,2,0.978813559322034
"020090903","CABA",396,389,6,1,0,7,0.982323232323232
"020090911","CABA",275,244,4,1,0,5,0.887272727272727
"020080904","CABA",186,184,0,2,0,2,0.989247311827957
"020081404","CABA",793,568,61,83,3,147,0.716267339218159
"020091307","CABA",358,349,5,2,1,8,0.974860335195531
"020041103","CABA",282,275,7,0,0,7,0.975177304964539
"020081405","CABA",385,361,1,18,1,20,0.937662337662338
"020042503","CABA",1093,994,25,36,8,69,0.909423604757548
"020042310","CABA",259,249,4,0,0,4,0.961389961389961
"020040206","CABA",257,256,1,0,0,1,0.996108949416342
"020090407","CABA",271,268,1,2,0,3,0.988929889298893
"020042601","CABA",261,233,11,1,0,12,0.89272030651341
"020091504","CABA",272,258,6,4,0,10,0.948529411764706
"020040109","CABA",224,223,1,0,0,1,0.995535714285714
"020040202","CABA",282,272,7,0,0,7,0.964539007092199
"020041008","CABA",492,300,48,131,4,183,0.609756097560976
"020041007","CABA",273,212,20,21,2,43,0.776556776556777
"020042309","CABA",150,142,4,4,0,8,0.946666666666667
"020090710","CABA",245,211,7,1,0,8,0.861224489795918
"020090913","CABA",209,208,1,0,0,1,0.995215311004785
"020090705","CABA",257,257,0,0,0,0,1
"020041006","CABA",306,280,14,8,1,23,0.915032679738562
"020041106","CABA",320,308,10,2,0,12,0.9625
"020040105","CABA",234,223,6,2,0,8,0.952991452991453
"020040903","CABA",186,181,3,1,0,4,0.973118279569892
"020090406","CABA",251,251,0,0,0,0,1
"020090912","CABA",227,222,3,2,0,5,0.977973568281938
"020091401","CABA",388,384,2,0,2,4,0.989690721649485
"020090905","CABA",261,259,0,2,0,2,0.992337164750958
"020040110","CABA",157,140,2,15,0,17,0.89171974522293
"020042504","CABA",573,477,35,43,2,80,0.832460732984293
"020090713","CABA",324,310,2,3,0,5,0.95679012345679
"020040205","CABA",231,224,6,1,0,7,0.96969696969697
"020090704","CABA",242,242,0,0,0,0,1
"020090808","CABA",335,325,8,1,0,9,0.970149253731343
"020090711","CABA",278,274,4,0,0,4,0.985611510791367
"020091611","CABA",247,246,1,0,0,1,0.995951417004049
"020042402","CABA",538,496,18,9,0,27,0.921933085501859
"020041107","CABA",328,270,13,1,40,54,0.823170731707317
"020090712","CABA",315,315,0,0,0,0,1
"020040905","CABA",189,186,3,0,0,3,0.984126984126984
"020041009","CABA",624,571,23,17,2,42,0.915064102564103
"020090904","CABA",211,204,7,0,0,7,0.966824644549763
"020081409","CABA",336,327,3,4,1,8,0.973214285714286
"020040204","CABA",273,265,1,7,0,8,0.970695970695971
"020090703","CABA",220,219,1,0,0,1,0.995454545454545
"020040112","CABA",183,178,2,3,0,5,0.972677595628415
"020091404","CABA",249,242,3,2,0,5,0.971887550200803
"020091502","CABA",290,285,1,3,0,4,0.982758620689655
"020090805","CABA",329,327,2,0,0,2,0.993920972644377
"020042312","CABA",232,189,11,6,20,37,0.814655172413793
"020091505","CABA",319,318,1,0,0,1,0.996865203761755
"020091503","CABA",290,283,3,3,0,6,0.975862068965517
"020040107","CABA",168,163,3,1,0,4,0.970238095238095
"020040111","CABA",200,192,8,0,0,8,0.96
"020040106","CABA",206,199,4,0,0,4,0.966019417475728
"020081403","CABA",518,481,30,2,0,32,0.928571428571429
"020042401","CABA",415,374,20,8,0,28,0.901204819277108
"020091402","CABA",307,307,0,0,0,0,1
"020090701","CABA",269,269,0,0,0,0,1
"020040902","CABA",254,241,1,6,4,11,0.948818897637795
"020042502","CABA",624,537,22,33,9,64,0.860576923076923
"020080502","CABA",263,255,3,5,0,8,0.96958174904943
"020081410","CABA",313,292,7,9,0,16,0.932907348242812
"020040901","CABA",463,412,25,3,20,48,0.889848812095032
"020042403","CABA",373,336,25,10,0,35,0.900804289544236
"020090702","CABA",300,300,0,0,0,0,1
"020091506","CABA",336,336,0,0,0,0,1
"020090807","CABA",330,327,3,0,0,3,0.990909090909091
"020081307","CABA",253,241,4,5,0,9,0.952569169960474
"020041109","CABA",269,162,55,10,37,102,0.602230483271376
"020090801","CABA",287,284,2,1,0,3,0.989547038327526
"020091501","CABA",217,209,5,3,0,8,0.963133640552995
"020081402","CABA",382,366,8,0,0,8,0.958115183246073
"020091508","CABA",283,272,3,8,0,11,0.96113074204947
"020040114","CABA",236,209,7,20,0,27,0.885593220338983
"020091405","CABA",457,444,3,4,0,7,0.971553610503282
"020040906","CABA",279,244,13,0,0,13,0.874551971326165
"020081506","CABA",233,217,6,6,0,12,0.931330472103004
"020090809","CABA",250,244,5,1,0,6,0.976
"020081407","CABA",297,281,10,6,0,16,0.946127946127946
"020040113","CABA",136,131,1,4,0,5,0.963235294117647
"020081401","CABA",464,460,1,0,0,1,0.991379310344828
"020091507","CABA",348,341,4,3,0,7,0.979885057471264
"020090802","CABA",294,293,1,0,0,1,0.996598639455782
"020091406","CABA",659,588,25,9,0,34,0.892261001517451
"020040907","CABA",263,226,8,0,0,8,0.859315589353612
"020081505","CABA",877,854,8,5,0,13,0.973774230330673
"020042404","CABA",534,485,20,12,1,33,0.908239700374532
"020090803","CABA",293,286,5,0,0,5,0.976109215017065
"020081501","CABA",852,629,25,39,11,75,0.738262910798122
"020081504","CABA",231,217,3,4,0,7,0.939393939393939
"020042405","CABA",406,321,15,51,5,71,0.79064039408867
"020091408","CABA",426,389,22,5,0,27,0.913145539906103
"020081408","CABA",259,243,3,4,0,7,0.938223938223938
"020091509","CABA",293,281,5,6,0,11,0.959044368600683
"020090806","CABA",353,343,4,1,0,5,0.971671388101983
"020081705","CABA",173,173,0,0,0,0,1
"020081507","CABA",259,248,9,0,0,9,0.957528957528958
"020091604","CABA",247,242,4,0,0,4,0.979757085020243
"020091409","CABA",252,222,11,4,3,18,0.880952380952381
"020091410","CABA",489,424,16,31,1,48,0.867075664621677
"020091407","CABA",351,328,5,10,0,15,0.934472934472934
"020042501","CABA",688,358,93,217,4,314,0.520348837209302
"020081701","CABA",223,223,0,0,0,0,1
"020081306","CABA",221,211,2,7,0,9,0.95475113122172
"020090810","CABA",326,321,4,0,0,4,0.984662576687117
"020080501","CABA",277,266,5,0,0,5,0.96028880866426
"020042406","CABA",377,257,50,39,26,115,0.681697612732096
"020080503","CABA",270,267,3,0,0,3,0.988888888888889
"020091511","CABA",311,307,3,1,0,4,0.987138263665595
"020081308","CABA",297,271,9,16,0,25,0.912457912457912
"020081503","CABA",667,637,5,3,0,8,0.955022488755622
"020081508","CABA",358,323,4,10,0,14,0.902234636871508
"020081704","CABA",290,290,0,0,0,0,1
"020081304","CABA",333,322,8,2,0,10,0.966966966966967
"020081509","CABA",519,501,7,8,1,16,0.965317919075145
"020081305","CABA",315,311,2,1,0,3,0.987301587301587
"020091510","CABA",229,226,1,1,0,2,0.986899563318777
"020081510","CABA",389,364,5,6,0,11,0.93573264781491
"020081406","CABA",250,243,5,2,0,7,0.972
"020080404","CABA",224,196,1,1,0,2,0.875
"020080507","CABA",336,336,0,0,0,0,1
"020090811","CABA",323,314,3,2,0,5,0.972136222910217
"020080405","CABA",332,326,2,4,0,6,0.981927710843373
"020080401","CABA",287,278,6,2,0,8,0.968641114982578
"020081502","CABA",655,481,70,47,51,168,0.734351145038168
"020090804","CABA",286,284,0,2,0,2,0.993006993006993
"020081703","CABA",327,326,1,0,0,1,0.996941896024465
"020091603","CABA",228,222,5,0,0,5,0.973684210526316
"020080504","CABA",291,280,2,8,1,11,0.962199312714777
"020080508","CABA",254,254,0,0,0,0,1
"020081302","CABA",118,110,5,1,0,6,0.932203389830508
"020091602","CABA",314,312,2,0,0,2,0.993630573248408
"020081303","CABA",311,294,9,7,0,16,0.945337620578778
"020080402","CABA",214,179,4,0,0,4,0.836448598130841
"020081702","CABA",221,221,0,0,0,0,1
"020080506","CABA",282,270,7,4,0,11,0.957446808510638
"020080403","CABA",220,211,3,4,0,7,0.959090909090909
"020080601","CABA",302,302,0,0,0,0,1
"020090812","CABA",331,327,2,2,0,4,0.987915407854985
"020091605","CABA",283,270,4,4,0,8,0.954063604240283
"020080505","CABA",201,194,5,1,0,6,0.965174129353234
"020090813","CABA",207,201,5,0,0,5,0.971014492753623
"020080406","CABA",350,345,1,4,0,5,0.985714285714286
"020080509","CABA",298,298,0,0,0,0,1
"020080602","CABA",397,394,2,0,0,2,0.992443324937028
"020091601","CABA",309,305,3,0,1,4,0.98705501618123
"020081603","CABA",289,288,0,0,0,0,0.996539792387543
"020080603","CABA",402,402,0,0,0,0,1
"020081602","CABA",183,182,0,0,0,0,0.994535519125683
"020080606","CABA",320,281,2,6,0,8,0.878125
"020080510","CABA",411,411,0,0,0,0,1
"020080108","CABA",374,341,7,6,0,13,0.911764705882353
"020080410","CABA",306,303,2,1,0,3,0.990196078431373
"020081610","CABA",279,255,0,0,0,0,0.913978494623656
"020091607","CABA",336,330,1,2,0,3,0.982142857142857
"020080411","CABA",252,251,0,0,0,0,0.996031746031746
"020081301","CABA",20,3,5,1,0,6,0.15
"020091606","CABA",326,325,0,1,0,1,0.996932515337423
"020081601","CABA",299,298,1,0,0,1,0.996655518394649
"020091610","CABA",297,295,2,0,0,2,0.993265993265993
"020081604","CABA",266,264,2,0,0,2,0.992481203007519
"020080407","CABA",278,270,5,3,0,8,0.971223021582734
"020080107","CABA",460,317,36,99,0,135,0.689130434782609
"020080511","CABA",319,318,1,0,0,1,0.996865203761755
"020080607","CABA",208,185,3,2,0,5,0.889423076923077
"020091612","CABA",259,257,2,0,0,2,0.992277992277992
"020080605","CABA",320,312,4,1,0,5,0.975
"020081605","CABA",294,294,0,0,0,0,1
"020080106","CABA",627,525,24,72,0,96,0.837320574162679
"020081609","CABA",280,280,0,0,0,0,1
"020080409","CABA",258,256,1,1,0,2,0.992248062015504
"020081606","CABA",267,267,0,0,0,0,1
"020080104","CABA",482,361,40,70,0,110,0.74896265560166
"020081608","CABA",236,234,1,0,0,1,0.991525423728814
"020091609","CABA",340,335,5,0,0,5,0.985294117647059
"020080301","CABA",334,332,0,2,0,2,0.994011976047904
"020080105","CABA",449,430,11,3,0,14,0.957683741648107
"020081607","CABA",276,275,1,0,0,1,0.996376811594203
"020091613","CABA",296,293,2,1,0,3,0.989864864864865
"020080109","CABA",810,660,68,60,0,128,0.814814814814815
"020080604","CABA",233,227,4,2,0,6,0.974248927038627
"020080712","CABA",395,375,10,5,0,15,0.949367088607595
"020080110","CABA",440,393,14,15,0,29,0.893181818181818
"020080408","CABA",278,265,10,3,0,13,0.953237410071942
"020080305","CABA",238,230,2,6,0,8,0.966386554621849
"020091608","CABA",301,296,1,2,0,3,0.983388704318937
"020080111","CABA",182,154,6,12,2,20,0.846153846153846
"020080102","CABA",517,337,40,123,1,164,0.65183752417795
"020080608","CABA",241,235,3,0,0,3,0.975103734439834
"020080302","CABA",256,253,2,1,0,3,0.98828125
"020080103","CABA",351,336,5,3,0,8,0.957264957264957
"020080714","CABA",574,499,42,11,1,54,0.869337979094077
"020080112","CABA",1019,746,43,205,0,248,0.732090284592738
"020080705","CABA",543,478,19,8,2,29,0.880294659300184
"020080703","CABA",493,437,22,25,0,47,0.886409736308316
"020080704","CABA",446,361,24,37,0,61,0.809417040358744
"020080609","CABA",284,283,1,0,0,1,0.996478873239437
"020080709","CABA",814,721,34,38,1,73,0.885749385749386
"020080303","CABA",187,182,5,0,0,5,0.973262032085562
"020080706","CABA",395,371,7,6,3,16,0.939240506329114
"020080610","CABA",219,211,2,6,0,8,0.963470319634703
"020080702","CABA",478,434,12,13,2,27,0.907949790794979
"020080805","CABA",240,232,3,0,0,3,0.966666666666667
"020080707","CABA",661,588,25,9,0,34,0.889561270801815
"020080708","CABA",457,397,19,7,0,26,0.86870897155361
"020080611","CABA",203,192,7,2,0,9,0.945812807881773
"020081008","CABA",320,320,0,0,0,0,1
"020080205","CABA",174,171,2,0,0,2,0.982758620689655
"020080806","CABA",321,313,6,2,0,8,0.975077881619938
"020080710","CABA",285,280,3,0,0,3,0.982456140350877
"020080701","CABA",359,345,7,2,0,9,0.96100278551532
"020080202","CABA",168,168,0,0,0,0,1
"020080711","CABA",411,380,11,15,0,26,0.924574209245742
"020080306","CABA",144,139,3,2,0,5,0.965277777777778
"020080206","CABA",249,242,7,0,0,7,0.971887550200803
"020080101","CABA",331,315,7,5,1,13,0.95166163141994
"020080207","CABA",404,403,1,0,0,1,0.997524752475248
"020080201","CABA",387,384,3,0,0,3,0.992248062015504
"020080807","CABA",308,307,1,0,0,1,0.996753246753247
"020080208","CABA",307,306,1,0,0,1,0.996742671009772
"020080307","CABA",245,237,3,2,0,5,0.96734693877551
"020080203","CABA",161,161,0,0,0,0,1
"020080804","CABA",300,294,0,6,0,6,0.98
"020080713","CABA",391,376,6,3,0,9,0.961636828644501
"020080810","CABA",289,283,6,0,0,6,0.97923875432526
"020081001","CABA",278,278,0,0,0,0,1
"020080210","CABA",188,185,2,1,0,3,0.984042553191489
"020080209","CABA",271,271,0,0,0,0,1
"020080308","CABA",547,369,25,97,0,122,0.674588665447898
"020080803","CABA",235,231,2,2,0,4,0.982978723404255
"020080808","CABA",206,206,0,0,0,0,1
"020081003","CABA",380,380,0,0,0,0,1
"020080809","CABA",232,227,4,0,0,4,0.978448275862069
"020081006","CABA",579,575,3,0,0,3,0.993091537132988
"020081207","CABA",278,270,4,1,0,5,0.971223021582734
"020080802","CABA",309,307,1,1,0,2,0.993527508090615
"020080811","CABA",338,318,1,0,0,1,0.940828402366864
"020080905","CABA",385,375,0,0,0,0,0.974025974025974
"020080309","CABA",569,540,11,8,0,19,0.949033391915642
"020080903","CABA",352,349,1,2,0,3,0.991477272727273
"020081004","CABA",719,719,0,0,0,0,1
"020081007","CABA",543,543,0,0,0,0,1
"020080310","CABA",478,443,19,5,0,24,0.926778242677824
"020081002","CABA",237,232,1,0,0,1,0.978902953586498
"020080801","CABA",281,272,5,2,0,7,0.96797153024911
"020080902","CABA",298,292,4,1,0,5,0.979865771812081
"020081005","CABA",842,841,0,0,0,0,0.998812351543943
"020081103","CABA",1057,1056,1,0,0,1,0.999053926206244
"020080909","CABA",315,313,0,2,0,2,0.993650793650794
"020081101","CABA",910,907,3,0,0,3,0.996703296703297
"020081105","CABA",449,445,4,0,0,4,0.99109131403118
"020081104","CABA",643,641,2,0,0,2,0.996889580093313
"020081102","CABA",718,714,3,1,0,4,0.994428969359331
"020081203","CABA",331,324,3,2,0,5,0.978851963746224
"020080901","CABA",271,265,2,3,0,5,0.977859778597786
"020080908","CABA",258,255,3,0,0,3,0.988372093023256
"020081204","CABA",302,280,15,5,0,20,0.927152317880795
"020080906","CABA",294,294,0,0,0,0,1
"020081202","CABA",356,352,1,3,0,4,0.98876404494382
"020080907","CABA",260,257,2,1,0,3,0.988461538461539
"020081205","CABA",341,336,4,1,0,5,0.98533724340176
"020081201","CABA",306,292,4,5,1,10,0.954248366013072
"020081206","CABA",249,246,1,2,0,3,0.987951807228916
"620490105","RIO NEGRO",114,0,7,50,40,97,0
"620420903","RIO NEGRO",256,2,98,119,7,224,0.0078125
"620070614","RIO NEGRO",133,0,0,106,4,110,0
"620422808","RIO NEGRO",202,198,2,2,0,4,0.98019801980198
"620350111","RIO NEGRO",298,0,4,88,147,239,0
"620424202","RIO NEGRO",317,292,4,13,0,17,0.921135646687697
"620423203","RIO NEGRO",203,201,2,0,0,2,0.990147783251232
"820630318","SANTA FE",10,0,0,3,5,8,0
"620423006","RIO NEGRO",39,1,27,9,0,36,0.0256410256410256
"620422907","RIO NEGRO",278,264,7,5,0,12,0.949640287769784
"620140901","RIO NEGRO",180,42,77,47,3,127,0.233333333333333
"620070604","RIO NEGRO",117,3,55,48,5,108,0.0256410256410256
"620424112","RIO NEGRO",247,244,1,2,0,3,0.987854251012146
"620424104","RIO NEGRO",123,120,3,0,0,3,0.975609756097561
"620424103","RIO NEGRO",201,201,0,0,0,0,1
"620424004","RIO NEGRO",311,4,106,192,1,299,0.0128617363344051
"580350105","NEUQUEN",24,1,7,12,1,20,0.0416666666666667
"620700106","RIO NEGRO",146,0,25,34,52,111,0
"620423609","RIO NEGRO",241,240,1,0,0,1,0.995850622406639
"620423007","RIO NEGRO",348,326,12,4,0,16,0.936781609195402
"620422509","RIO NEGRO",282,267,4,4,0,8,0.946808510638298
"620421403","RIO NEGRO",297,10,173,96,4,273,0.0336700336700337
"620560103","RIO NEGRO",212,0,7,24,154,185,0
"620421405","RIO NEGRO",319,4,150,151,4,305,0.0125391849529781
"620420102","RIO NEGRO",57,0,21,26,2,49,0
"620421213","RIO NEGRO",203,203,0,0,0,0,1
"620770102","RIO NEGRO",158,1,92,60,0,152,0.00632911392405063
"620630109","RIO NEGRO",294,246,36,12,0,48,0.836734693877551
"620630106","RIO NEGRO",328,143,124,44,0,168,0.435975609756098
"620560102","RIO NEGRO",96,0,37,32,25,94,0
"620424203","RIO NEGRO",256,252,3,0,0,3,0.984375
"620424001","RIO NEGRO",225,7,24,165,6,195,0.0311111111111111
"620423912","RIO NEGRO",222,219,0,3,0,3,0.986486486486487
"620423911","RIO NEGRO",243,243,0,0,0,0,1
"620423906","RIO NEGRO",281,281,0,0,0,0,1
"620423807","RIO NEGRO",152,147,5,0,0,5,0.967105263157895
"620423804","RIO NEGRO",216,190,14,9,0,23,0.87962962962963
"620423707","RIO NEGRO",315,4,74,230,1,305,0.0126984126984127
"620423701","RIO NEGRO",216,112,14,59,4,77,0.518518518518518
"620423210","RIO NEGRO",226,226,0,0,0,0,1
"620423107","RIO NEGRO",294,164,23,88,1,112,0.557823129251701
"620422807","RIO NEGRO",196,192,4,0,0,4,0.979591836734694
"620422711","RIO NEGRO",148,148,0,0,0,0,1
"620422708","RIO NEGRO",310,305,4,0,0,4,0.983870967741935
"620422706","RIO NEGRO",188,184,1,2,0,3,0.978723404255319
"620422703","RIO NEGRO",188,186,2,0,0,2,0.98936170212766
"620422615","RIO NEGRO",147,142,5,0,0,5,0.965986394557823
"620422614","RIO NEGRO",198,192,3,3,0,6,0.96969696969697
"620422610","RIO NEGRO",183,139,24,16,2,42,0.759562841530055
"620422602","RIO NEGRO",237,90,34,89,2,125,0.379746835443038
"620422601","RIO NEGRO",270,134,43,87,0,130,0.496296296296296
"620421508","RIO NEGRO",119,111,1,0,0,1,0.932773109243697
"620421412","RIO NEGRO",96,0,38,44,1,83,0
"620421207","RIO NEGRO",328,325,1,2,0,3,0.990853658536585
"620421202","RIO NEGRO",301,292,5,3,0,8,0.970099667774086
"620420701","RIO NEGRO",411,133,107,115,13,235,0.32360097323601
"620071107","RIO NEGRO",222,179,19,20,0,39,0.806306306306306
"620422205","RIO NEGRO",324,67,133,84,22,239,0.20679012345679
"620422201","RIO NEGRO",407,256,82,53,3,138,0.628992628992629
"620422311","RIO NEGRO",311,242,45,23,1,69,0.778135048231511
"620422007","RIO NEGRO",243,218,25,0,0,25,0.897119341563786
"620421904","RIO NEGRO",260,65,72,97,4,173,0.25
"620421903","RIO NEGRO",257,225,24,7,0,31,0.875486381322957
"620421901","RIO NEGRO",284,200,38,39,1,78,0.704225352112676
"620421112","RIO NEGRO",224,0,11,156,24,191,0
"620420905","RIO NEGRO",243,234,5,2,0,7,0.962962962962963
"620420808","RIO NEGRO",258,258,0,0,0,0,1
"620420806","RIO NEGRO",231,204,18,9,0,27,0.883116883116883
"620420605","RIO NEGRO",216,176,28,7,2,37,0.814814814814815
"620211707","RIO NEGRO",232,169,19,28,2,49,0.728448275862069
"620420612","RIO NEGRO",165,145,1,0,0,1,0.878787878787879
"620070505","RIO NEGRO",182,181,1,0,0,1,0.994505494505495
"620210805","RIO NEGRO",264,234,5,12,1,18,0.886363636363636
"540281926","MISIONES",348,250,67,25,0,92,0.718390804597701
"620211901","RIO NEGRO",185,158,17,5,0,22,0.854054054054054
"620211802","RIO NEGRO",248,226,19,2,1,22,0.911290322580645
"620211411","RIO NEGRO",303,215,55,15,2,72,0.70957095709571
"620211404","RIO NEGRO",334,4,73,168,54,295,0.0119760479041916
"620422406","RIO NEGRO",188,182,5,0,0,5,0.968085106382979
"620210906","RIO NEGRO",190,116,27,1,1,29,0.610526315789474
"340141706","FORMOSA",285,102,157,17,0,174,0.357894736842105
"620211801","RIO NEGRO",240,159,36,39,5,80,0.6625
"620423509","RIO NEGRO",291,291,0,0,0,0,1
"620423504","RIO NEGRO",225,221,3,1,0,4,0.982222222222222
"620423503","RIO NEGRO",286,280,3,2,0,5,0.979020979020979
"620211704","RIO NEGRO",201,73,8,46,55,109,0.36318407960199
"620211511","RIO NEGRO",195,190,2,3,0,5,0.974358974358974
"620211417","RIO NEGRO",216,3,195,16,1,212,0.0138888888888889
"620211307","RIO NEGRO",213,98,105,10,0,115,0.460093896713615
"620211104","RIO NEGRO",194,35,146,10,3,159,0.180412371134021
"620211209","RIO NEGRO",37,17,15,5,0,20,0.459459459459459
"620210908","RIO NEGRO",394,260,85,34,6,125,0.65989847715736
"620140202","RIO NEGRO",200,190,6,1,0,7,0.95
"620210601","RIO NEGRO",108,85,10,12,0,22,0.787037037037037
"620211601","RIO NEGRO",321,304,8,2,0,10,0.947040498442368
"620210313","RIO NEGRO",219,209,6,4,0,10,0.954337899543379
"620210306","RIO NEGRO",116,115,1,0,0,1,0.991379310344828
"620210304","RIO NEGRO",146,146,0,0,0,0,1
"620210212","RIO NEGRO",177,29,10,112,17,139,0.163841807909605
"620210211","RIO NEGRO",316,6,127,156,4,287,0.0189873417721519
"620071103","RIO NEGRO",338,296,9,19,0,28,0.875739644970414
"620071102","RIO NEGRO",185,183,2,0,0,2,0.989189189189189
"620071003","RIO NEGRO",236,234,2,0,0,2,0.991525423728814
"620071002","RIO NEGRO",180,178,2,0,0,2,0.988888888888889
"620071012","RIO NEGRO",218,205,10,0,0,10,0.940366972477064
"620770502","RIO NEGRO",14,0,12,2,0,14,0
"620210103","RIO NEGRO",94,2,84,8,0,92,0.0212765957446809
"540280508","MISIONES",231,115,83,8,0,91,0.497835497835498
"620422704","RIO NEGRO",187,187,0,0,0,0,1
"620770304","RIO NEGRO",77,76,0,1,0,1,0.987012987012987
"620070814","RIO NEGRO",188,187,1,0,0,1,0.99468085106383
"620070807","RIO NEGRO",185,185,0,0,0,0,1
"620070709","RIO NEGRO",137,123,9,3,0,12,0.897810218978102
"620070510","RIO NEGRO",373,367,2,4,0,6,0.983914209115281
"620140605","RIO NEGRO",225,181,22,18,1,41,0.804444444444444
"300844110","ENTRE RIOS",155,127,18,8,0,26,0.819354838709677
"620070609","RIO NEGRO",325,325,0,0,0,0,1
"620140608","RIO NEGRO",232,132,31,50,5,86,0.568965517241379
"620424304","RIO NEGRO",196,195,1,0,0,1,0.994897959183674
"620910307","RIO NEGRO",223,5,175,42,0,217,0.0224215246636771
"620910202","RIO NEGRO",303,4,176,82,30,288,0.0132013201320132
"620420801","RIO NEGRO",292,224,63,4,0,67,0.767123287671233
"620211910","RIO NEGRO",192,84,50,32,12,94,0.4375
"620840203","RIO NEGRO",23,0,12,11,0,23,0
"620211603","RIO NEGRO",357,336,6,7,1,14,0.941176470588235
"620770604","RIO NEGRO",93,82,9,2,0,11,0.881720430107527
"620770109","RIO NEGRO",273,23,187,56,2,245,0.0842490842490843
"620700101","RIO NEGRO",236,110,62,32,22,116,0.466101694915254
"620210403","RIO NEGRO",26,0,23,3,0,26,0
"620070601","RIO NEGRO",87,3,40,33,1,74,0.0344827586206897
"620070507","RIO NEGRO",235,231,3,1,0,4,0.982978723404255
"620280301","RIO NEGRO",23,0,2,20,0,22,0
"620140903","RIO NEGRO",17,0,13,2,2,17,0
"620423305","RIO NEGRO",228,222,1,0,0,1,0.973684210526316
"620840208","RIO NEGRO",144,0,15,54,44,113,0
"620210708","RIO NEGRO",128,4,73,39,12,124,0.03125
"620210502","RIO NEGRO",121,0,57,30,28,115,0
"620630114","RIO NEGRO",152,132,17,2,0,19,0.868421052631579
"620630113","RIO NEGRO",316,310,1,5,0,6,0.981012658227848
"620210909","RIO NEGRO",196,177,10,4,0,14,0.903061224489796
"620424309","RIO NEGRO",335,309,4,7,0,11,0.922388059701493
"620421602","RIO NEGRO",131,0,30,76,16,122,0
"620421502","RIO NEGRO",219,1,47,125,21,193,0.0045662100456621
"620421410","RIO NEGRO",111,2,69,28,0,97,0.018018018018018
"620422905","RIO NEGRO",244,215,11,17,0,28,0.881147540983607
"620422805","RIO NEGRO",333,317,4,10,0,14,0.951951951951952
"620422802","RIO NEGRO",193,123,33,36,0,69,0.637305699481865
"620140108","RIO NEGRO",172,100,40,24,0,64,0.581395348837209
"860420305","SANTIAGO DEL ESTERO",135,0,45,83,4,132,0
"620424207","RIO NEGRO",414,352,24,24,1,49,0.85024154589372
"620424107","RIO NEGRO",181,181,0,0,0,0,1
"620423704","RIO NEGRO",233,109,26,88,4,118,0.467811158798283
"620423612","RIO NEGRO",230,215,8,1,0,9,0.934782608695652
"620423310","RIO NEGRO",231,226,5,0,0,5,0.978354978354978
"620423308","RIO NEGRO",163,161,2,0,0,2,0.987730061349693
"620423004","RIO NEGRO",254,239,9,4,0,13,0.940944881889764
"620423011","RIO NEGRO",291,211,13,29,21,63,0.725085910652921
"620422909","RIO NEGRO",294,187,46,59,1,106,0.636054421768708
"620210901","RIO NEGRO",212,211,1,0,0,1,0.995283018867924
"620422715","RIO NEGRO",165,155,7,2,0,9,0.939393939393939
"620422710","RIO NEGRO",257,242,3,9,0,12,0.941634241245136
"620424308","RIO NEGRO",265,261,0,0,0,0,0.984905660377358
"620422607","RIO NEGRO",176,123,9,36,2,47,0.698863636363636
"620422504","RIO NEGRO",216,195,6,5,0,11,0.902777777777778
"620422308","RIO NEGRO",180,169,6,4,0,10,0.938888888888889
"620422106","RIO NEGRO",184,1,80,95,0,175,0.00543478260869565
"620422006","RIO NEGRO",248,145,51,45,0,96,0.584677419354839
"620422001","RIO NEGRO",69,4,8,36,12,56,0.0579710144927536
"620421804","RIO NEGRO",247,180,30,17,0,47,0.728744939271255
"620421803","RIO NEGRO",316,7,150,136,2,288,0.0221518987341772
"620211006","RIO NEGRO",218,174,7,17,1,25,0.798165137614679
"620421802","RIO NEGRO",138,40,51,16,0,67,0.289855072463768
"620421507","RIO NEGRO",241,241,0,0,0,0,1
"620421209","RIO NEGRO",231,231,0,0,0,0,1
"620421201","RIO NEGRO",282,251,9,15,1,25,0.890070921985816
"220700501","CHACO",67,0,15,21,22,58,0
"620421011","RIO NEGRO",234,226,3,3,0,6,0.965811965811966
"620421002","RIO NEGRO",246,194,21,26,0,47,0.788617886178862
"620421001","RIO NEGRO",326,237,28,48,1,77,0.726993865030675
"620280407","RIO NEGRO",140,8,115,14,2,131,0.0571428571428571
"620420610","RIO NEGRO",219,217,2,0,0,2,0.990867579908676
"620280404","RIO NEGRO",268,97,139,27,1,167,0.361940298507463
"620211004","RIO NEGRO",191,162,7,9,4,20,0.848167539267016
"620423808","RIO NEGRO",218,218,0,0,0,0,1
"620211501","RIO NEGRO",147,147,0,0,0,0,1
"620211508","RIO NEGRO",155,152,1,0,0,1,0.980645161290323
"620211504","RIO NEGRO",149,146,2,1,0,3,0.979865771812081
"620211413","RIO NEGRO",192,22,154,15,0,169,0.114583333333333
"620070803","RIO NEGRO",32,1,10,20,0,30,0.03125
"141050509","CORDOBA",211,3,205,2,0,207,0.014218009478673
"620211204","RIO NEGRO",128,5,105,18,0,123,0.0390625
"620210808","RIO NEGRO",241,218,3,5,2,10,0.904564315352697
"620070802","RIO NEGRO",139,139,0,0,0,0,1
"140145812","CORDOBA",275,271,3,1,0,4,0.985454545454545
"620210606","RIO NEGRO",180,171,6,1,0,7,0.95
"620210604","RIO NEGRO",232,218,11,2,0,13,0.939655172413793
"620210905","RIO NEGRO",328,307,10,6,0,16,0.935975609756098
"620420712","RIO NEGRO",132,0,17,57,13,87,0
"620420702","RIO NEGRO",446,27,56,272,56,384,0.0605381165919283
"620420401","RIO NEGRO",347,286,42,13,0,55,0.824207492795389
"620210904","RIO NEGRO",379,354,4,6,0,10,0.934036939313984
"620210101","RIO NEGRO",119,38,65,13,0,78,0.319327731092437
"620140402","RIO NEGRO",343,325,11,6,0,17,0.947521865889213
"620070905","RIO NEGRO",32,0,29,3,0,32,0
"620070817","RIO NEGRO",154,151,3,0,0,3,0.980519480519481
"620070816","RIO NEGRO",155,147,2,4,1,7,0.948387096774194
"620070811","RIO NEGRO",258,240,8,9,1,18,0.930232558139535
"540280410","MISIONES",373,347,10,3,0,13,0.93029490616622
"620910301","RIO NEGRO",221,4,100,81,26,207,0.0180995475113122
"620910104","RIO NEGRO",193,4,134,39,14,187,0.0207253886010363
"620420609","RIO NEGRO",250,250,0,0,0,0,1
"620910302","RIO NEGRO",153,19,87,40,4,131,0.124183006535948
"620211911","RIO NEGRO",270,189,55,18,1,74,0.7
"620840204","RIO NEGRO",54,0,30,22,0,52,0
"620840107","RIO NEGRO",175,27,77,51,10,138,0.154285714285714
"620770605","RIO NEGRO",113,5,61,47,0,108,0.0442477876106195
"620770205","RIO NEGRO",240,131,75,30,0,105,0.545833333333333
"620424209","RIO NEGRO",277,268,6,1,0,7,0.967509025270758
"620770115","RIO NEGRO",139,99,23,16,0,39,0.712230215827338
"620770114","RIO NEGRO",153,56,71,25,0,96,0.366013071895425
"620770112","RIO NEGRO",282,8,230,33,1,264,0.0283687943262411
"620910402","RIO NEGRO",51,1,11,26,12,49,0.0196078431372549
"620422009","RIO NEGRO",151,151,0,0,0,0,1
"620770103","RIO NEGRO",156,102,44,9,0,53,0.653846153846154
"620210303","RIO NEGRO",194,194,0,0,0,0,1
"620141103","RIO NEGRO",172,5,80,85,1,166,0.0290697674418605
"620141102","RIO NEGRO",300,280,10,9,1,20,0.933333333333333
"620140407","RIO NEGRO",217,200,13,4,0,17,0.921658986175115
"620070302","RIO NEGRO",183,104,58,21,0,79,0.568306010928962
"620421108","RIO NEGRO",160,1,59,82,3,144,0.00625
"620421905","RIO NEGRO",89,1,42,39,0,81,0.0112359550561798
"620210704","RIO NEGRO",128,0,45,34,19,98,0
"540282302","MISIONES",254,130,110,10,1,121,0.511811023622047
"620280103","RIO NEGRO",62,0,21,14,24,59,0
"620210703","RIO NEGRO",130,0,76,27,15,118,0
"620140801","RIO NEGRO",48,0,0,32,6,38,0
"620421701","RIO NEGRO",265,5,104,118,20,242,0.0188679245283019
"620421407","RIO NEGRO",278,35,169,62,1,232,0.12589928057554
"620423907","RIO NEGRO",309,276,0,1,0,1,0.893203883495146
"620420902","RIO NEGRO",357,6,195,125,9,329,0.0168067226890756
"620350109","RIO NEGRO",38,0,15,13,3,31,0
"620490101","RIO NEGRO",232,0,192,35,1,228,0
"620424311","RIO NEGRO",311,277,11,7,1,19,0.890675241157556
"620424302","RIO NEGRO",123,122,0,1,0,1,0.991869918699187
"620280102","RIO NEGRO",31,0,15,5,5,25,0
"620423903","RIO NEGRO",169,167,1,1,0,2,0.988165680473373
"620070606","RIO NEGRO",51,0,36,13,0,49,0
"620422107","RIO NEGRO",257,2,155,83,2,240,0.00778210116731518
"620421109","RIO NEGRO",237,2,92,112,13,217,0.00843881856540084
"620210201","RIO NEGRO",93,4,63,19,6,88,0.043010752688172
"620630117","RIO NEGRO",214,0,173,38,1,212,0
"620630108","RIO NEGRO",215,36,71,103,3,177,0.167441860465116
"620422506","RIO NEGRO",245,238,0,2,0,2,0.971428571428571
"620630103","RIO NEGRO",220,181,24,14,0,38,0.822727272727273
"620420810","RIO NEGRO",249,247,2,0,0,2,0.991967871485944
"620700107","RIO NEGRO",127,0,42,33,42,117,0
"620210710","RIO NEGRO",140,2,127,7,4,138,0.0142857142857143
"620700203","RIO NEGRO",298,4,240,43,3,286,0.0134228187919463
"620424206","RIO NEGRO",336,132,124,62,0,186,0.392857142857143
"620424204","RIO NEGRO",271,265,2,2,0,4,0.977859778597786
"620424305","RIO NEGRO",248,248,0,0,0,0,1
"620424105","RIO NEGRO",239,235,0,0,0,0,0.98326359832636
"620424102","RIO NEGRO",236,236,0,0,0,0,1
"620423910","RIO NEGRO",195,195,0,0,0,0,1
"620423908","RIO NEGRO",208,206,1,1,0,2,0.990384615384615
"620423402","RIO NEGRO",383,372,4,5,2,11,0.971279373368146
"620423401","RIO NEGRO",228,228,0,0,0,0,1
"620423211","RIO NEGRO",251,246,3,2,0,5,0.9800796812749
"620423205","RIO NEGRO",197,190,1,2,0,3,0.964467005076142
"620423202","RIO NEGRO",228,221,2,1,0,3,0.969298245614035
"620423103","RIO NEGRO",265,240,4,10,1,15,0.905660377358491
"620423010","RIO NEGRO",233,205,7,15,3,25,0.879828326180258
"620423009","RIO NEGRO",328,253,19,48,0,67,0.771341463414634
"620423005","RIO NEGRO",200,181,7,8,0,15,0.905
"620422901","RIO NEGRO",235,119,44,70,1,115,0.506382978723404
"620422707","RIO NEGRO",171,169,2,0,0,2,0.988304093567251
"620422705","RIO NEGRO",207,206,1,0,0,1,0.995169082125604
"620422613","RIO NEGRO",247,240,4,1,0,5,0.97165991902834
"620423307","RIO NEGRO",168,163,5,0,0,5,0.970238095238095
"620422503","RIO NEGRO",386,324,15,3,0,18,0.839378238341969
"620422301","RIO NEGRO",246,14,104,121,0,225,0.0569105691056911
"620422011","RIO NEGRO",224,222,2,0,0,2,0.991071428571429
"620422008","RIO NEGRO",170,168,2,0,0,2,0.988235294117647
"620421107","RIO NEGRO",232,1,35,169,9,213,0.00431034482758621
"620420910","RIO NEGRO",234,209,14,8,1,23,0.893162393162393
"620420901","RIO NEGRO",201,191,6,1,0,7,0.950248756218905
"620211505","RIO NEGRO",160,147,9,1,1,11,0.91875
"620420201","RIO NEGRO",66,1,42,23,0,65,0.0151515151515152
"620420606","RIO NEGRO",204,161,5,23,0,28,0.78921568627451
"620420410","RIO NEGRO",249,197,32,13,0,45,0.791164658634538
"620350101","RIO NEGRO",161,0,92,54,3,149,0
"620280402","RIO NEGRO",320,12,275,33,0,308,0.0375
"620211410","RIO NEGRO",344,7,170,136,6,312,0.0203488372093023
"860560401","SANTIAGO DEL ESTERO",65,0,1,3,5,9,0
"620211902","RIO NEGRO",234,72,92,43,23,158,0.307692307692308
"620420608","RIO NEGRO",184,182,1,1,0,2,0.989130434782609
"620420809","RIO NEGRO",196,193,3,0,0,3,0.98469387755102
"620211912","RIO NEGRO",229,5,87,83,48,218,0.0218340611353712
"620420412","RIO NEGRO",232,142,64,14,5,83,0.612068965517241
"620211903","RIO NEGRO",267,219,42,5,0,47,0.820224719101124
"861610306","SANTIAGO DEL ESTERO",152,0,22,65,43,130,0
"620211308","RIO NEGRO",207,200,7,0,0,7,0.966183574879227
"620211306","RIO NEGRO",219,93,118,7,0,125,0.424657534246575
"620210810","RIO NEGRO",336,252,10,40,5,55,0.75
"620423301","RIO NEGRO",195,180,13,2,0,15,0.923076923076923
"620071110","RIO NEGRO",197,98,57,40,1,98,0.49746192893401
"620211415","RIO NEGRO",260,6,233,18,2,253,0.0230769230769231
"620210307","RIO NEGRO",116,115,1,0,0,1,0.991379310344828
"620210204","RIO NEGRO",242,1,67,104,42,213,0.00413223140495868
"900840912","TUCUMAN",145,112,1,0,0,1,0.772413793103448
"620211809","RIO NEGRO",280,223,11,35,2,48,0.796428571428571
"620211808","RIO NEGRO",133,131,0,0,0,0,0.984962406015038
"620423502","RIO NEGRO",247,243,3,0,0,3,0.983805668016194
"620211706","RIO NEGRO",239,131,26,42,21,89,0.548117154811716
"620071009","RIO NEGRO",167,155,7,4,0,11,0.92814371257485
"620211702","RIO NEGRO",210,170,12,10,1,23,0.80952380952381
"620211310","RIO NEGRO",200,164,35,1,0,36,0.82
"620211114","RIO NEGRO",157,3,117,32,4,153,0.0191082802547771
"620211113","RIO NEGRO",224,6,186,31,1,218,0.0267857142857143
"620211007","RIO NEGRO",186,169,12,2,0,14,0.908602150537634
"900070506","TUCUMAN",87,0,11,66,6,83,0
"620210109","RIO NEGRO",170,0,158,8,0,166,0
"620210108","RIO NEGRO",212,2,199,9,1,209,0.00943396226415094
"620210107","RIO NEGRO",219,7,192,18,2,212,0.0319634703196347
"620420613","RIO NEGRO",189,175,5,6,0,11,0.925925925925926
"620420603","RIO NEGRO",168,164,4,0,0,4,0.976190476190476
"620420804","RIO NEGRO",191,180,8,3,0,11,0.942408376963351
"620071005","RIO NEGRO",205,203,1,0,0,1,0.990243902439024
"620140607","RIO NEGRO",237,189,19,23,0,42,0.79746835443038
"620070710","RIO NEGRO",57,39,4,12,1,17,0.684210526315789
"620070705","RIO NEGRO",339,331,3,0,0,3,0.976401179941003
"620421210","RIO NEGRO",202,201,1,0,0,1,0.995049504950495
"620070704","RIO NEGRO",330,312,7,4,0,11,0.945454545454545
"620070611","RIO NEGRO",164,0,44,98,10,152,0
"620070501","RIO NEGRO",191,183,4,2,0,6,0.958115183246073
"620140301","RIO NEGRO",363,322,36,5,0,41,0.887052341597796
"620421805","RIO NEGRO",240,3,122,102,6,230,0.0125
"620630201","RIO NEGRO",305,3,251,44,5,300,0.00983606557377049
"620630102","RIO NEGRO",188,170,16,1,0,17,0.904255319148936
"620424111","RIO NEGRO",224,224,0,0,0,0,1
"620910102","RIO NEGRO",240,11,164,50,8,222,0.0458333333333333
"620422004","RIO NEGRO",191,191,0,0,0,0,1
"620420717","RIO NEGRO",140,0,31,88,10,129,0
"620211604","RIO NEGRO",254,246,8,0,0,8,0.968503937007874
"620421505","RIO NEGRO",195,185,2,3,0,5,0.948717948717949
"580351502","NEUQUEN",260,256,3,0,0,3,0.984615384615385
"620840105","RIO NEGRO",167,1,80,67,3,150,0.00598802395209581
"620770111","RIO NEGRO",305,8,162,119,2,283,0.0262295081967213
"620770110","RIO NEGRO",243,144,87,11,0,98,0.592592592592593
"620770108","RIO NEGRO",179,4,130,41,0,171,0.0223463687150838
"620910403","RIO NEGRO",30,0,4,8,18,30,0
"620840103","RIO NEGRO",122,35,38,42,6,86,0.286885245901639
"620700202","RIO NEGRO",191,1,160,18,6,184,0.00523560209424084
"620211111","RIO NEGRO",258,28,109,70,24,203,0.108527131782946
"620770411","RIO NEGRO",118,22,83,13,0,96,0.186440677966102
"620770410","RIO NEGRO",84,10,39,34,0,73,0.119047619047619
"860560201","SANTIAGO DEL ESTERO",53,0,2,5,11,18,0
"620140203","RIO NEGRO",240,231,2,5,0,7,0.9625
"620770407","RIO NEGRO",38,18,16,4,0,20,0.473684210526316
"620140110","RIO NEGRO",305,274,4,5,0,9,0.898360655737705
"620140104","RIO NEGRO",331,242,55,26,2,83,0.731117824773414
"620070812","RIO NEGRO",167,159,2,5,0,7,0.952095808383233
"620070511","RIO NEGRO",241,230,1,0,0,1,0.954356846473029
"620421408","RIO NEGRO",233,3,123,98,5,226,0.0128755364806867
"620420502","RIO NEGRO",146,2,92,48,3,143,0.0136986301369863
"620420104","RIO NEGRO",31,0,5,15,6,26,0
"620421702","RIO NEGRO",207,0,96,82,17,195,0
"580630101","NEUQUEN",43,0,10,21,1,32,0
"620210503","RIO NEGRO",16,0,4,2,9,15,0
"620140501","RIO NEGRO",24,0,12,12,0,24,0
"620420301","RIO NEGRO",19,0,0,14,0,14,0
"620840209","RIO NEGRO",68,0,14,35,6,55,0
"620421103","RIO NEGRO",179,1,64,96,9,169,0.00558659217877095
"620421206","RIO NEGRO",166,165,0,0,0,0,0.993975903614458
"220211201","CHACO",41,0,13,16,4,33,0
"620420103","RIO NEGRO",131,4,47,72,2,121,0.0305343511450382
"620840206","RIO NEGRO",34,0,16,6,9,31,0
"620210402","RIO NEGRO",75,0,49,15,10,74,0
"620070605","RIO NEGRO",6,0,1,5,0,6,0
"620424011","RIO NEGRO",250,250,0,0,0,0,1
"620424005","RIO NEGRO",183,55,69,52,2,123,0.300546448087432
"620422105","RIO NEGRO",215,60,83,61,3,147,0.27906976744186
"620421902","RIO NEGRO",193,28,118,23,14,155,0.145077720207254
"620423814","RIO NEGRO",316,282,1,0,0,1,0.892405063291139
"620423806","RIO NEGRO",220,218,1,0,0,1,0.990909090909091
"620421010","RIO NEGRO",273,147,26,89,1,116,0.538461538461538
"620420708","RIO NEGRO",184,4,92,76,6,174,0.0217391304347826
"620420501","RIO NEGRO",139,32,64,41,2,107,0.23021582733813
"620210702","RIO NEGRO",121,0,58,24,34,116,0
"620423711","RIO NEGRO",192,182,8,2,0,10,0.947916666666667
"620423606","RIO NEGRO",190,189,0,0,0,0,0.994736842105263
"620420909","RIO NEGRO",210,197,4,5,0,9,0.938095238095238
"620423403","RIO NEGRO",216,213,3,0,0,3,0.986111111111111
"620140109","RIO NEGRO",58,0,32,23,1,56,0
"620630205","LA PAMPA",193,3,125,57,3,185,0.0155440414507772
"620770501","RIO NEGRO",34,1,13,19,1,33,0.0294117647058824
"620840201","RIO NEGRO",9,0,3,1,5,9,0
"620070707","RIO NEGRO",403,401,2,0,0,2,0.995037220843672
"620423208","RIO NEGRO",199,188,3,1,0,4,0.944723618090452
"620423108","RIO NEGRO",244,240,2,1,0,3,0.983606557377049
"620423001","RIO NEGRO",279,275,4,0,0,4,0.985663082437276
"620630101","RIO NEGRO",204,139,38,27,0,65,0.681372549019608
"620424307","RIO NEGRO",291,291,0,0,0,0,1
"620424108","RIO NEGRO",268,264,2,2,0,4,0.985074626865672
"620424106","RIO NEGRO",210,207,3,0,0,3,0.985714285714286
"620424013","RIO NEGRO",129,129,0,0,0,0,1
"620424012","RIO NEGRO",197,195,2,0,0,2,0.989847715736041
"620422910","RIO NEGRO",302,89,123,77,1,201,0.294701986754967
"620422906","RIO NEGRO",272,141,96,31,1,128,0.518382352941177
"620422904","RIO NEGRO",312,268,21,22,0,43,0.858974358974359
"620422902","RIO NEGRO",171,13,97,58,0,155,0.0760233918128655
"620422701","RIO NEGRO",214,194,3,5,0,8,0.906542056074766
"620422408","RIO NEGRO",344,325,8,5,2,15,0.944767441860465
"620423306","RIO NEGRO",192,187,1,2,0,3,0.973958333333333
"620422302","RIO NEGRO",208,9,106,87,1,194,0.0432692307692308
"620422402","RIO NEGRO",218,215,1,1,0,2,0.986238532110092
"620422010","RIO NEGRO",134,134,0,0,0,0,1
"620420805","RIO NEGRO",164,160,1,3,0,4,0.975609756097561
"620350105","RIO NEGRO",48,0,3,41,3,47,0
"620211909","RIO NEGRO",175,101,21,37,9,67,0.577142857142857
"620211905","RIO NEGRO",197,90,71,21,12,104,0.456852791878173
"620211807","RIO NEGRO",188,15,66,102,0,168,0.0797872340425532
"620211806","RIO NEGRO",206,184,9,4,1,14,0.893203883495146
"620423602","RIO NEGRO",234,233,1,0,0,1,0.995726495726496
"620423507","RIO NEGRO",283,255,8,20,0,28,0.901060070671378
"620423501","RIO NEGRO",227,225,2,0,0,2,0.991189427312775
"620211208","RIO NEGRO",316,1,261,36,6,303,0.00316455696202532
"620211710","RIO NEGRO",249,130,15,49,17,81,0.522088353413655
"620211705","RIO NEGRO",291,169,12,51,6,69,0.580756013745705
"620211510","RIO NEGRO",152,152,0,0,0,0,1
"620211507","RIO NEGRO",163,156,6,0,0,6,0.957055214723926
"620211506","RIO NEGRO",281,273,2,2,0,4,0.97153024911032
"620211409","RIO NEGRO",379,12,277,56,19,352,0.0316622691292876
"620211406","RIO NEGRO",206,3,41,102,22,165,0.0145631067961165
"620210310","RIO NEGRO",159,159,0,0,0,0,1
"620210209","RIO NEGRO",181,2,97,62,0,159,0.0110497237569061
"620423109","RIO NEGRO",297,282,4,4,0,8,0.94949494949495
"620211303","RIO NEGRO",222,210,10,2,0,12,0.945945945945946
"620211305","RIO NEGRO",129,60,59,7,1,67,0.465116279069767
"620211205","RIO NEGRO",142,5,130,6,0,136,0.0352112676056338
"620210907","RIO NEGRO",226,148,66,11,1,78,0.654867256637168
"620210803","RIO NEGRO",258,241,4,5,2,11,0.934108527131783
"620210709","RIO NEGRO",301,5,144,82,46,272,0.0166112956810631
"620210903","RIO NEGRO",336,282,7,20,18,45,0.839285714285714
"620210312","RIO NEGRO",161,156,4,1,0,5,0.968944099378882
"620210207","RIO NEGRO",201,197,4,0,0,4,0.980099502487562
"620910203","RIO NEGRO",185,1,101,63,17,181,0.00540540540540541
"620420715","RIO NEGRO",215,1,70,126,2,198,0.00465116279069767
"620420604","RIO NEGRO",212,192,6,9,1,16,0.905660377358491
"620420405","RIO NEGRO",301,59,199,34,2,235,0.196013289036545
"620140902","RIO NEGRO",121,89,25,6,0,31,0.735537190082645
"620140409","RIO NEGRO",208,192,8,7,0,15,0.923076923076923
"620140408","RIO NEGRO",355,293,8,37,0,45,0.825352112676056
"620140105","RIO NEGRO",286,85,118,79,0,197,0.297202797202797
"620423611","RIO NEGRO",231,222,6,2,0,8,0.961038961038961
"620140112","RIO NEGRO",180,85,13,75,1,89,0.472222222222222
"620071111","RIO NEGRO",315,172,38,78,2,118,0.546031746031746
"620071106","RIO NEGRO",188,151,3,33,0,36,0.803191489361702
"620071101","RIO NEGRO",331,303,17,11,0,28,0.915407854984894
"620071013","RIO NEGRO",220,211,3,4,0,7,0.959090909090909
"620070904","RIO NEGRO",57,7,32,12,3,47,0.12280701754386
"620070713","RIO NEGRO",249,249,0,0,0,0,1
"620070712","RIO NEGRO",225,225,0,0,0,0,1
"620070711","RIO NEGRO",658,656,1,0,0,1,0.996960486322188
"620070509","RIO NEGRO",166,165,1,0,0,1,0.993975903614458
"620070502","RIO NEGRO",157,146,5,6,0,11,0.929936305732484
"620422404","RIO NEGRO",330,326,0,0,0,0,0.987878787878788
"620490106","RIO NEGRO",217,0,181,25,2,208,0
"620840104","RIO NEGRO",248,135,75,29,6,110,0.544354838709677
"620770607","RIO NEGRO",87,0,56,28,0,84,0
"620211207","RIO NEGRO",204,3,174,25,2,201,0.0147058823529412
"620840101","RIO NEGRO",168,3,87,60,4,151,0.0178571428571429
"620770405","RIO NEGRO",291,12,240,39,0,279,0.0412371134020619
"620140406","RIO NEGRO",244,217,9,15,0,24,0.889344262295082
"620422505","RIO NEGRO",374,355,9,3,0,12,0.949197860962567
"620070902","RIO NEGRO",78,1,64,12,0,76,0.0128205128205128
"620421503","RIO NEGRO",236,14,112,88,3,203,0.0593220338983051
"620211302","RIO NEGRO",276,256,19,1,0,20,0.927536231884058
"620422108","RIO NEGRO",123,1,68,52,0,120,0.00813008130081301
"620421406","RIO NEGRO",114,1,46,62,0,108,0.0087719298245614
"620420101","RIO NEGRO",26,0,16,6,2,24,0
"620421409","RIO NEGRO",174,1,78,83,5,166,0.00574712643678161
"620421104","RIO NEGRO",231,1,106,112,0,218,0.00432900432900433
"620423102","RIO NEGRO",369,346,9,5,3,17,0.937669376693767
"620420614","RIO NEGRO",198,192,0,5,0,5,0.96969696969697
"620421305","RIO NEGRO",312,75,128,90,6,224,0.240384615384615
"620560101","RIO NEGRO",148,0,112,29,1,142,0
"620421102","RIO NEGRO",234,19,90,96,0,186,0.0811965811965812
"620210104","RIO NEGRO",201,0,171,18,9,198,0
"620070603","RIO NEGRO",204,0,135,60,4,199,0
"620422806","RIO NEGRO",352,335,7,8,0,15,0.951704545454545
"620141101","RIO NEGRO",160,1,76,67,10,153,0.00625
"620424310","RIO NEGRO",231,104,56,69,0,125,0.45021645021645
"620560104","RIO NEGRO",181,0,13,16,130,159,0
"620424301","RIO NEGRO",218,1,54,131,18,203,0.00458715596330275
"620424210","RIO NEGRO",244,244,0,0,0,0,1
"620424208","RIO NEGRO",316,315,0,0,0,0,0.996835443037975
"620424101","RIO NEGRO",236,235,0,1,0,1,0.995762711864407
"620424014","RIO NEGRO",338,256,49,28,0,77,0.757396449704142
"620422714","RIO NEGRO",237,223,7,5,0,12,0.940928270042194
"620422709","RIO NEGRO",213,213,0,0,0,0,1
"620422612","RIO NEGRO",230,214,13,2,0,15,0.930434782608696
"620422611","RIO NEGRO",155,136,16,3,0,19,0.87741935483871
"620070101","RIO NEGRO",17,1,8,7,0,15,0.0588235294117647
"620700103","RIO NEGRO",182,0,96,68,12,176,0
"620700204","RIO NEGRO",181,5,158,14,3,175,0.0276243093922652
"620630110","RIO NEGRO",171,158,9,4,0,13,0.923976608187134
"620630107","RIO NEGRO",79,0,50,23,2,75,0
"620424002","RIO NEGRO",229,1,37,142,5,184,0.00436681222707424
"620423909","RIO NEGRO",189,189,0,0,0,0,1
"620423902","RIO NEGRO",159,157,2,0,0,2,0.987421383647799
"620423710","RIO NEGRO",329,326,0,0,0,0,0.990881458966565
"620423709","RIO NEGRO",316,315,1,0,0,1,0.996835443037975
"140145619","CORDOBA",165,164,1,0,0,1,0.993939393939394
"620423703","RIO NEGRO",263,92,14,106,10,130,0.349809885931559
"620423702","RIO NEGRO",193,147,19,24,1,44,0.761658031088083
"620423605","RIO NEGRO",204,199,4,1,0,5,0.975490196078431
"620423309","RIO NEGRO",230,216,7,5,0,12,0.939130434782609
"620422608","RIO NEGRO",173,143,9,13,1,23,0.826589595375723
"620422502","RIO NEGRO",301,288,3,2,0,5,0.956810631229236
"620422501","RIO NEGRO",320,316,3,0,0,3,0.9875
"620423105","RIO NEGRO",345,344,1,0,0,1,0.997101449275362
"620422310","RIO NEGRO",170,151,8,8,0,16,0.888235294117647
"620422303","RIO NEGRO",191,18,95,73,1,169,0.0942408376963351
"620422012","RIO NEGRO",226,225,1,0,0,1,0.995575221238938
"620422003","RIO NEGRO",151,151,0,0,0,0,1
"620421601","RIO NEGRO",246,2,192,43,6,241,0.00813008130081301
"620421411","RIO NEGRO",211,1,85,109,3,197,0.004739336492891
"620421302","RIO NEGRO",331,9,88,214,7,309,0.027190332326284
"620421301","RIO NEGRO",233,5,65,137,3,205,0.0214592274678112
"620421004","RIO NEGRO",174,123,13,27,0,40,0.706896551724138
"620420807","RIO NEGRO",263,256,2,2,0,4,0.973384030418251
"620211203","RIO NEGRO",164,2,149,10,3,162,0.0121951219512195
"620423304","RIO NEGRO",295,288,4,1,0,5,0.976271186440678
"620140604","RIO NEGRO",212,121,34,55,1,90,0.570754716981132
"620280401","RIO NEGRO",342,17,256,60,2,318,0.0497076023391813
"620422407","RIO NEGRO",185,180,3,2,0,5,0.972972972972973
"620280405","RIO NEGRO",181,1,154,24,0,178,0.00552486187845304
"620211908","RIO NEGRO",294,67,99,78,26,203,0.227891156462585
"620211907","RIO NEGRO",117,1,92,22,2,116,0.00854700854700855
"620211904","RIO NEGRO",244,212,19,10,0,29,0.868852459016393
"620423508","RIO NEGRO",201,190,3,2,0,5,0.945273631840796
"620423408","RIO NEGRO",160,80,69,10,0,79,0.5
"620423406","RIO NEGRO",166,153,12,1,0,13,0.921686746987952
"620211509","RIO NEGRO",145,144,1,0,0,1,0.993103448275862
"620211206","RIO NEGRO",217,2,207,5,0,212,0.00921658986175115
"180490702","CORRIENTES",117,0,3,32,74,109,0
"620211112","RIO NEGRO",311,12,208,71,9,288,0.0385852090032154
"620211110","RIO NEGRO",193,2,171,16,2,189,0.0103626943005181
"620211108","RIO NEGRO",174,11,144,17,1,162,0.0632183908045977
"620211003","RIO NEGRO",254,183,13,34,2,49,0.720472440944882
"620210806","RIO NEGRO",218,196,2,12,1,15,0.899082568807339
"620210105","RIO NEGRO",101,3,81,11,5,97,0.0297029702970297
"620210208","RIO NEGRO",267,259,6,0,0,6,0.970037453183521
"620210206","RIO NEGRO",319,5,158,126,4,288,0.0156739811912226
"620420713","RIO NEGRO",355,4,59,156,42,257,0.0112676056338028
"620420506","RIO NEGRO",230,162,29,34,0,63,0.704347826086957
"620420504","RIO NEGRO",191,177,3,7,0,10,0.926701570680628
"260211004","CHUBUT",235,227,2,0,0,2,0.965957446808511
"620140603","RIO NEGRO",214,165,39,7,2,48,0.771028037383178
"620140403","RIO NEGRO",264,253,3,6,0,9,0.958333333333333
"620140111","RIO NEGRO",323,226,26,65,0,91,0.69969040247678
"620071105","RIO NEGRO",126,126,0,0,0,0,1
"620071006","RIO NEGRO",212,207,3,2,0,5,0.976415094339623
"620070901","RIO NEGRO",25,0,16,9,0,25,0
"620070808","RIO NEGRO",207,182,11,11,0,22,0.879227053140097
"620070805","RIO NEGRO",322,322,0,0,0,0,1
"620070804","RIO NEGRO",279,276,2,0,0,2,0.989247311827957
"620423104","RIO NEGRO",307,302,5,0,0,5,0.98371335504886
"620070801","RIO NEGRO",174,173,1,0,0,1,0.994252873563218
"620071010","RIO NEGRO",171,167,1,3,0,4,0.976608187134503
"620070703","RIO NEGRO",198,189,3,0,0,3,0.954545454545455
"620424109","RIO NEGRO",183,183,0,0,0,0,1
"620910201","RIO NEGRO",206,6,116,46,33,195,0.029126213592233
"620421506","RIO NEGRO",185,1,66,105,0,171,0.00540540540540541
"620421003","RIO NEGRO",222,154,43,15,0,58,0.693693693693694
"620420402","RIO NEGRO",261,1,203,52,4,259,0.00383141762452107
"620350110","RIO NEGRO",191,0,143,35,5,183,0
"620422605","RIO NEGRO",186,90,11,76,2,89,0.483870967741935
"620421801","RIO NEGRO",245,170,57,14,0,71,0.693877551020408
"620421501","RIO NEGRO",380,354,9,12,0,21,0.931578947368421
"620770606","RIO NEGRO",55,13,34,8,0,42,0.236363636363636
"620770204","RIO NEGRO",113,91,13,9,0,22,0.805309734513274
"620770305","RIO NEGRO",153,91,48,13,0,61,0.594771241830065
"620770107","RIO NEGRO",253,8,207,38,0,245,0.0316205533596838
"620422604","RIO NEGRO",172,76,49,43,1,93,0.441860465116279
"620422103","RIO NEGRO",295,237,35,23,0,58,0.803389830508475
"620770106","RIO NEGRO",198,85,70,40,2,112,0.429292929292929
"620770503","RIO NEGRO",35,0,31,4,0,35,0
"620211101","RIO NEGRO",163,130,30,2,1,33,0.797546012269939
"620770209","RIO NEGRO",197,18,108,68,1,177,0.0913705583756345
"620770207","RIO NEGRO",128,128,0,0,0,0,1
"620420711","RIO NEGRO",189,181,3,3,2,8,0.957671957671958
"620350106","RIO NEGRO",88,0,73,13,1,87,0
"620211418","RIO NEGRO",47,8,21,3,11,35,0.170212765957447
"620210401","RIO NEGRO",40,1,28,6,3,37,0.025
"620421402","RIO NEGRO",23,0,10,9,0,19,0
"620210608","RIO NEGRO",303,101,91,70,28,189,0.333333333333333
"620770412","RIO NEGRO",113,33,58,20,0,78,0.292035398230089
"620770406","RIO NEGRO",320,8,279,32,1,312,0.025
"620071104","RIO NEGRO",266,264,0,2,0,2,0.992481203007519
"620770302","RIO NEGRO",67,66,1,0,0,1,0.985074626865672
"620070607","RIO NEGRO",145,0,81,59,4,144,0
"620770210","RIO NEGRO",275,35,153,82,0,235,0.127272727272727
"620420710","RIO NEGRO",206,2,52,102,21,175,0.00970873786407767
"620630301","RIO NEGRO",18,0,3,10,2,15,0
"620423002","RIO NEGRO",392,371,9,6,0,15,0.946428571428571
"620070702","RIO NEGRO",240,234,4,1,0,5,0.975
"620141001","RIO NEGRO",70,0,36,20,6,62,0
"620630203","RIO NEGRO",68,1,21,39,1,61,0.0147058823529412
"620630202","RIO NEGRO",108,0,77,26,3,106,0
"620770211","RIO NEGRO",255,247,6,2,0,8,0.968627450980392
"620423206","RIO NEGRO",205,193,2,5,0,7,0.941463414634146
"620422101","RIO NEGRO",268,139,58,60,1,119,0.51865671641791
"620422002","RIO NEGRO",237,236,1,0,0,1,0.9957805907173
"620421303","RIO NEGRO",281,57,132,69,3,204,0.202846975088968
"620350108","RIO NEGRO",26,0,0,22,3,25,0
"620420709","RIO NEGRO",193,2,92,89,2,183,0.0103626943005181
"620420503","RIO NEGRO",45,4,18,20,1,39,0.0888888888888889
"620210501","RIO NEGRO",203,1,119,48,23,190,0.00492610837438424
"540281906","MISIONES",358,357,1,0,0,1,0.997206703910615
"620140102","RIO NEGRO",227,2,131,77,2,210,0.00881057268722467
"620490107","RIO NEGRO",80,0,21,17,15,53,0
"620421401","RIO NEGRO",224,6,132,71,0,203,0.0267857142857143
"620700205","RIO NEGRO",213,4,184,23,1,208,0.0187793427230047
"620700102","RIO NEGRO",232,1,113,81,20,214,0.00431034482758621
"140145618","CORDOBA",216,210,0,0,0,0,0.972222222222222
"620070401","RIO NEGRO",33,0,7,19,2,28,0
"620630115","RIO NEGRO",191,77,53,58,0,111,0.403141361256544
"620630112","RIO NEGRO",228,8,163,53,0,216,0.0350877192982456
"620422713","RIO NEGRO",330,322,2,3,0,5,0.975757575757576
"620422702","RIO NEGRO",263,245,3,1,0,4,0.931558935361217
"620422609","RIO NEGRO",278,215,16,35,2,53,0.773381294964029
"580350103","NEUQUEN",18,0,8,7,0,15,0
"620630401","RIO NEGRO",56,0,40,14,2,56,0
"620423201","RIO NEGRO",262,260,1,0,0,1,0.99236641221374
"620630104","RIO NEGRO",242,192,38,12,0,50,0.793388429752066
"620424113","RIO NEGRO",190,186,3,1,0,4,0.978947368421053
"620424006","RIO NEGRO",182,3,131,43,0,174,0.0164835164835165
"620423904","RIO NEGRO",211,211,0,0,0,0,1
"620423901","RIO NEGRO",268,268,0,0,0,0,1
"620423805","RIO NEGRO",246,240,2,4,0,6,0.975609756097561
"620423803","RIO NEGRO",231,196,9,19,0,28,0.848484848484849
"620423207","RIO NEGRO",205,200,0,3,0,3,0.975609756097561
"620423204","RIO NEGRO",384,382,2,0,0,2,0.994791666666667
"620421204","RIO NEGRO",235,224,6,4,0,10,0.953191489361702
"620421212","RIO NEGRO",194,194,0,0,0,0,1
"620421007","RIO NEGRO",202,160,12,25,0,37,0.792079207920792
"620421005","RIO NEGRO",256,183,29,38,0,67,0.71484375
"620420908","RIO NEGRO",213,179,12,18,2,32,0.84037558685446
"620420906","RIO NEGRO",325,293,6,0,0,6,0.901538461538462
"620211502","RIO NEGRO",133,133,0,0,0,0,1
"620424009","RIO NEGRO",318,279,9,24,0,33,0.877358490566038
"620350112","RIO NEGRO",165,0,118,38,2,158,0
"620420611","RIO NEGRO",212,211,0,1,0,1,0.995283018867924
"221330309","CHACO",97,3,4,24,54,82,0.0309278350515464
"620211906","RIO NEGRO",150,1,129,7,3,139,0.00666666666666667
"620211805","RIO NEGRO",240,235,4,1,0,5,0.979166666666667
"620211804","RIO NEGRO",179,131,22,18,1,41,0.731843575418994
"620423601","RIO NEGRO",271,256,6,7,0,13,0.944649446494465
"620423410","RIO NEGRO",348,346,1,1,0,2,0.994252873563218
"620423409","RIO NEGRO",188,173,10,5,0,15,0.920212765957447
"620211416","RIO NEGRO",292,46,185,30,6,221,0.157534246575342
"620211412","RIO NEGRO",253,249,3,0,1,4,0.984189723320158
"620210602","RIO NEGRO",184,127,26,20,6,52,0.690217391304348
"620211311","RIO NEGRO",247,25,200,21,1,222,0.101214574898785
"620211602","RIO NEGRO",267,230,14,11,2,27,0.861423220973783
"620210309","RIO NEGRO",243,241,1,0,0,1,0.991769547325103
"620210202","RIO NEGRO",148,5,123,16,3,142,0.0337837837837838
"620423303","RIO NEGRO",373,360,6,3,0,9,0.96514745308311
"620423302","RIO NEGRO",201,197,3,1,0,4,0.980099502487562
"620140204","RIO NEGRO",298,281,1,11,0,12,0.942953020134228
"620420802","RIO NEGRO",288,279,3,4,0,7,0.96875
"620420404","RIO NEGRO",222,100,60,50,7,117,0.45045045045045
"620423212","RIO NEGRO",194,191,2,0,1,3,0.984536082474227
"620211202","RIO NEGRO",186,7,165,10,4,179,0.0376344086021505
"620211607","RIO NEGRO",337,258,29,27,5,61,0.765578635014837
"620211009","RIO NEGRO",189,187,2,0,0,2,0.989417989417989
"620210804","RIO NEGRO",156,152,2,0,0,2,0.974358974358974
"620210809","RIO NEGRO",344,283,18,26,4,48,0.822674418604651
"620210807","RIO NEGRO",243,217,18,5,0,23,0.893004115226337
"620210603","RIO NEGRO",148,144,3,1,0,4,0.972972972972973
"620140405","RIO NEGRO",211,209,1,1,0,2,0.990521327014218
"620140106","RIO NEGRO",26,0,22,3,0,25,0
"620424008","RIO NEGRO",169,145,16,6,1,23,0.857988165680473
"620071004","RIO NEGRO",183,182,1,0,0,1,0.994535519125683
"620071001","RIO NEGRO",177,176,1,0,0,1,0.994350282485876
"620140606","RIO NEGRO",173,116,35,22,0,57,0.670520231213873
"620070815","RIO NEGRO",162,127,25,9,0,34,0.783950617283951
"620070613","RIO NEGRO",110,107,3,0,0,3,0.972727272727273
"220211003","CHACO",35,0,16,15,4,35,0
"620070504","RIO NEGRO",163,161,1,1,0,2,0.987730061349693
"620070503","RIO NEGRO",275,268,3,3,0,6,0.974545454545454
"620070708","RIO NEGRO",440,437,3,0,0,3,0.993181818181818
"620421214","RIO NEGRO",128,127,1,0,0,1,0.9921875
"620770206","RIO NEGRO",165,128,15,22,0,37,0.775757575757576
"620423802","RIO NEGRO",323,290,16,9,0,25,0.897832817337461
"620211001","RIO NEGRO",293,237,21,18,2,41,0.808873720136519
"620770408","RIO NEGRO",12,0,1,8,3,12,0
"620770402","RIO NEGRO",132,1,58,51,7,116,0.00757575757575758
"620910308","RIO NEGRO",282,4,128,91,40,259,0.0141843971631206
"620422305","RIO NEGRO",388,371,9,8,0,17,0.956185567010309
"620910103","RIO NEGRO",385,9,310,45,3,358,0.0233766233766234
"620420411","RIO NEGRO",182,161,12,9,0,21,0.884615384615385
"620840205","RIO NEGRO",14,0,8,5,1,14,0
"620770202","RIO NEGRO",165,13,83,66,1,150,0.0787878787878788
"620770113","RIO NEGRO",170,1,140,26,1,167,0.00588235294117647
"620770413","RIO NEGRO",154,7,138,9,0,147,0.0454545454545455
"620770105","RIO NEGRO",127,70,27,30,0,57,0.551181102362205
"620770104","RIO NEGRO",241,159,59,19,0,78,0.659751037344398
"861330304","SANTIAGO DEL ESTERO",30,0,1,18,7,26,0
"620770601","RIO NEGRO",60,49,10,1,0,11,0.816666666666667
"620420409","RIO NEGRO",124,1,48,54,7,109,0.00806451612903226
"620420406","RIO NEGRO",216,2,77,104,26,207,0.00925925925925926
"620140701","RIO NEGRO",44,0,19,14,10,43,0
"620140107","RIO NEGRO",0,0,0,0,0,0,NA
"620070301","RIO NEGRO",23,2,12,8,0,20,0.0869565217391304
"620423706","RIO NEGRO",331,192,22,92,1,115,0.580060422960725
"620210705","RIO NEGRO",276,3,149,90,16,255,0.0108695652173913
"620140201","RIO NEGRO",261,243,8,7,0,15,0.931034482758621
"620630302","RIO NEGRO",67,0,60,5,0,65,0
"620422109","RIO NEGRO",113,2,64,41,3,108,0.0176991150442478
"620424007","RIO NEGRO",221,220,1,0,0,1,0.995475113122172
"260211005","CHUBUT",149,148,1,0,0,1,0.993288590604027
"620910407","RIO NEGRO",102,0,8,18,59,85,0
"620420407","RIO NEGRO",81,0,36,28,4,68,0
"620840207","RIO NEGRO",39,0,5,9,20,34,0
"620280101","RIO NEGRO",9,0,2,5,2,9,0
"620424003","RIO NEGRO",355,354,0,0,0,0,0.997183098591549
"620422206","RIO NEGRO",241,2,119,79,14,212,0.00829875518672199
"620421306","RIO NEGRO",369,99,123,140,1,264,0.268292682926829
"620423905","RIO NEGRO",272,271,0,1,0,1,0.996323529411765
"620423812","RIO NEGRO",179,178,0,0,0,0,0.994413407821229
"620423811","RIO NEGRO",315,313,0,2,0,2,0.993650793650794
"620424010","RIO NEGRO",146,92,31,23,0,54,0.63013698630137
"620423801","RIO NEGRO",286,275,5,1,0,6,0.961538461538462
"620421101","RIO NEGRO",211,79,40,54,7,101,0.374407582938389
"620420707","RIO NEGRO",237,3,79,110,5,194,0.0126582278481013
"620420704","RIO NEGRO",212,5,130,65,1,196,0.0235849056603774
"620423810","RIO NEGRO",211,211,0,0,0,0,1
"620141002","RIO NEGRO",163,48,43,42,11,96,0.294478527607362
"620140302","RIO NEGRO",156,1,51,78,7,136,0.00641025641025641
"620140303","RIO NEGRO",236,62,102,58,3,163,0.26271186440678
"620630105","RIO NEGRO",224,100,108,13,0,121,0.446428571428571
"620424312","RIO NEGRO",312,263,22,6,0,28,0.842948717948718
"620424306","RIO NEGRO",352,349,1,0,0,1,0.991477272727273
"620424201","RIO NEGRO",284,271,4,8,0,12,0.954225352112676
"620423708","RIO NEGRO",108,1,5,85,4,94,0.00925925925925926
"620700104","RIO NEGRO",217,0,49,96,37,182,0
"620910406","RIO NEGRO",116,0,2,28,79,109,0
"620910405","RIO NEGRO",187,0,12,51,119,182,0
"620420706","RIO NEGRO",117,0,23,67,9,99,0
"620350103","RIO NEGRO",82,0,18,36,14,68,0
"620630118","RIO NEGRO",145,2,80,53,1,134,0.0137931034482759
"620630116","RIO NEGRO",150,148,2,0,0,2,0.986666666666667
"620423809","RIO NEGRO",203,187,5,0,0,5,0.921182266009852
"620423705","RIO NEGRO",291,282,2,1,0,3,0.969072164948454
"620423404","RIO NEGRO",177,167,4,6,0,10,0.943502824858757
"620423209","RIO NEGRO",239,236,2,0,0,2,0.98744769874477
"620423106","RIO NEGRO",269,268,0,0,0,0,0.996282527881041
"620423101","RIO NEGRO",356,343,2,8,0,10,0.963483146067416
"620423003","RIO NEGRO",247,244,3,0,0,3,0.987854251012146
"620423012","RIO NEGRO",107,77,10,18,0,28,0.719626168224299
"620422908","RIO NEGRO",309,182,63,60,0,123,0.588996763754045
"620422804","RIO NEGRO",320,319,1,0,0,1,0.996875
"620422803","RIO NEGRO",367,359,1,0,0,1,0.978201634877384
"620422801","RIO NEGRO",315,283,16,16,0,32,0.898412698412698
"620422712","RIO NEGRO",196,196,0,0,0,0,1
"620421013","RIO NEGRO",188,188,0,0,0,0,1
"140145617","CORDOBA",179,178,1,0,0,1,0.994413407821229
"620421203","RIO NEGRO",348,343,4,0,0,4,0.985632183908046
"620421012","RIO NEGRO",198,195,2,1,0,3,0.984848484848485
"540282007","MISIONES",313,2,220,84,4,308,0.00638977635782748
"620422606","RIO NEGRO",212,130,8,59,0,67,0.613207547169811
"620422603","RIO NEGRO",312,154,62,88,0,150,0.493589743589744
"620422507","RIO NEGRO",290,273,6,6,0,12,0.941379310344828
"620422307","RIO NEGRO",204,176,13,15,0,28,0.862745098039216
"620422403","RIO NEGRO",222,216,5,1,0,6,0.972972972972973
"620422104","RIO NEGRO",143,74,34,28,0,62,0.517482517482518
"620422005","RIO NEGRO",150,150,0,0,0,0,1
"620421603","RIO NEGRO",201,6,87,98,0,185,0.0298507462686567
"620421806","RIO NEGRO",203,38,101,44,3,148,0.187192118226601
"620421304","RIO NEGRO",321,24,176,105,1,282,0.0747663551401869
"620421208","RIO NEGRO",255,248,3,3,0,6,0.972549019607843
"620421008","RIO NEGRO",241,143,13,63,0,76,0.593360995850622
"620421006","RIO NEGRO",252,186,21,31,0,52,0.738095238095238
"620420904","RIO NEGRO",201,191,4,4,0,8,0.950248756218905
"620421211","RIO NEGRO",169,169,0,0,0,0,1
"620350104","RIO NEGRO",85,0,37,34,9,80,0
"620350102","RIO NEGRO",181,0,60,112,2,174,0
"620280406","RIO NEGRO",304,8,239,52,2,293,0.0263157894736842
"620420607","RIO NEGRO",282,256,16,3,0,19,0.907801418439716
"620423506","RIO NEGRO",255,251,1,2,0,3,0.984313725490196
"620423505","RIO NEGRO",244,241,3,0,0,3,0.987704918032787
"620423405","RIO NEGRO",295,293,1,1,0,2,0.993220338983051
"620211708","RIO NEGRO",314,302,2,0,0,2,0.961783439490446
"620211102","RIO NEGRO",215,6,176,29,4,209,0.027906976744186
"861330305","SANTIAGO DEL ESTERO",46,0,0,25,5,30,0
"900841902","TUCUMAN",285,285,0,0,0,0,1
"620211703","RIO NEGRO",148,144,2,1,0,3,0.972972972972973
"620211408","RIO NEGRO",249,114,36,54,2,92,0.457831325301205
"620211407","RIO NEGRO",202,1,34,131,14,179,0.00495049504950495
"620211304","RIO NEGRO",153,130,23,0,0,23,0.849673202614379
"620140602","RIO NEGRO",252,157,45,41,3,89,0.623015873015873
"620140601","RIO NEGRO",237,177,32,24,0,56,0.746835443037975
"620071108","RIO NEGRO",194,99,28,59,4,91,0.510309278350515
"620071008","RIO NEGRO",185,182,2,0,0,2,0.983783783783784
"620211201","RIO NEGRO",196,1,172,22,1,195,0.00510204081632653
"620211105","RIO NEGRO",222,65,145,10,2,157,0.292792792792793
"620211606","RIO NEGRO",286,282,4,0,0,4,0.986013986013986
"620211010","RIO NEGRO",184,183,0,0,0,0,0.994565217391304
"620211008","RIO NEGRO",209,172,13,10,0,23,0.822966507177033
"620211005","RIO NEGRO",340,261,24,21,8,53,0.767647058823529
"620210802","RIO NEGRO",188,182,4,1,0,5,0.968085106382979
"620210801","RIO NEGRO",204,191,0,2,0,2,0.936274509803922
"620210902","RIO NEGRO",318,304,14,0,0,14,0.955974842767296
"620210607","RIO NEGRO",255,165,38,28,9,75,0.647058823529412
"620210605","RIO NEGRO",136,136,0,0,0,0,1
"620211605","RIO NEGRO",175,167,7,0,0,7,0.954285714285714
"620210308","RIO NEGRO",142,137,5,0,0,5,0.964788732394366
"620210203","RIO NEGRO",311,69,36,107,75,218,0.221864951768489
"620210302","RIO NEGRO",149,149,0,0,0,0,1
"620210106","RIO NEGRO",223,4,194,19,4,217,0.0179372197309417
"620210205","RIO NEGRO",246,5,93,125,6,224,0.0203252032520325
"620420602","RIO NEGRO",327,291,17,13,0,30,0.889908256880734
"620420601","RIO NEGRO",262,210,24,21,1,46,0.801526717557252
"620211701","RIO NEGRO",246,207,12,16,2,30,0.841463414634146
"620211414","RIO NEGRO",224,1,216,7,0,223,0.00446428571428571
"620071109","RIO NEGRO",232,171,16,37,2,55,0.737068965517241
"620140103","RIO NEGRO",319,287,13,11,0,24,0.899686520376176
"620210102","RIO NEGRO",331,4,187,82,25,294,0.0120845921450151
"620071007","RIO NEGRO",263,259,3,1,0,4,0.984790874524715
"620070906","RIO NEGRO",58,4,33,21,0,54,0.0689655172413793
"620071011","RIO NEGRO",158,148,4,5,0,9,0.936708860759494
"620070813","RIO NEGRO",223,223,0,0,0,0,1
"620070810","RIO NEGRO",309,291,12,4,0,16,0.941747572815534
"620070809","RIO NEGRO",176,176,0,0,0,0,1
"620070806","RIO NEGRO",347,345,2,0,0,2,0.994236311239193
"620070506","RIO NEGRO",214,210,4,0,0,4,0.981308411214953
"620910303","RIO NEGRO",266,5,188,62,3,253,0.018796992481203
"620910101","RIO NEGRO",395,10,309,62,6,377,0.0253164556962025
"620070303","RIO NEGRO",116,0,89,26,0,115,0
"140145616","CORDOBA",145,143,0,0,0,0,0.986206896551724
"620211608","RIO NEGRO",331,326,4,0,0,4,0.984894259818731
"620211403","RIO NEGRO",347,3,92,206,31,329,0.00864553314121038
"620910306","RIO NEGRO",203,4,84,82,26,192,0.0197044334975369
"620910305","RIO NEGRO",354,74,92,76,79,247,0.209039548022599
"620910304","RIO NEGRO",261,8,144,64,34,242,0.0306513409961686
"620421106","RIO NEGRO",228,0,75,131,3,209,0
"620280403","RIO NEGRO",199,11,148,33,1,182,0.0552763819095477
"620770201","RIO NEGRO",336,310,20,4,0,24,0.922619047619048
"620770117","RIO NEGRO",197,2,162,29,0,191,0.0101522842639594
"620700201","RIO NEGRO",246,4,230,8,3,241,0.016260162601626
"620211107","RIO NEGRO",191,7,149,10,24,183,0.0366492146596859
"620770504","RIO NEGRO",36,0,28,8,0,36,0
"620770409","RIO NEGRO",167,11,97,54,1,152,0.0658682634730539
"620770404","RIO NEGRO",313,3,268,38,0,306,0.00958466453674121
"620770403","RIO NEGRO",334,4,267,61,0,328,0.0119760479041916
"900841405","TUCUMAN",348,306,1,2,0,3,0.879310344827586
"260070901","CHUBUT",335,333,1,0,0,1,0.994029850746269
"620770401","RIO NEGRO",120,2,101,12,3,116,0.0166666666666667
"260211408","CHUBUT",244,243,0,1,0,1,0.995901639344262
"620770303","RIO NEGRO",68,60,8,0,0,8,0.882352941176471
"620420703","RIO NEGRO",158,0,80,74,1,155,0
"620280201","RIO NEGRO",25,0,15,3,6,24,0
"620423008","RIO NEGRO",350,313,13,15,1,29,0.894285714285714
"620422903","RIO NEGRO",312,248,45,17,0,62,0.794871794871795
"100490613","CATAMARCA",367,309,40,14,1,55,0.841961852861035
"620280105","RIO NEGRO",126,0,37,49,28,114,0
"620424205","RIO NEGRO",170,105,14,32,0,46,0.617647058823529
"220211102","CHACO",18,0,0,13,2,15,0
"620070602","RIO NEGRO",253,0,163,73,9,245,0
"620490104","RIO NEGRO",126,0,23,50,31,104,0
"620422510","RIO NEGRO",332,320,4,3,0,7,0.963855421686747
"620422204","RIO NEGRO",80,0,39,34,1,74,0
"620422203","RIO NEGRO",254,120,51,68,6,125,0.47244094488189
"620423607","RIO NEGRO",267,258,1,8,0,9,0.966292134831461
"620422102","RIO NEGRO",154,7,72,69,4,145,0.0454545454545455
"620422508","RIO NEGRO",412,394,7,6,0,13,0.956310679611651
"620422309","RIO NEGRO",212,203,3,6,0,9,0.957547169811321
"620422401","RIO NEGRO",220,209,8,0,0,8,0.95
"620421604","RIO NEGRO",199,0,80,103,4,187,0
"620420705","RIO NEGRO",383,6,187,166,4,357,0.0156657963446475
"620420202","RIO NEGRO",177,6,28,102,6,136,0.0338983050847458
"620630204","RIO NEGRO",127,0,50,69,1,120,0
"620210112","RIO NEGRO",121,1,102,14,2,118,0.00826446280991736
"620420408","RIO NEGRO",168,0,55,93,6,154,0
"620422306","RIO NEGRO",217,16,140,61,0,201,0.0737327188940092
"620422202","RIO NEGRO",67,3,52,12,0,64,0.0447761194029851
"620422013","RIO NEGRO",244,242,2,0,0,2,0.991803278688525
"620280104","RIO NEGRO",224,0,108,73,15,196,0
"620211401","RIO NEGRO",203,29,67,89,9,165,0.142857142857143
"620424114","RIO NEGRO",179,176,1,0,0,1,0.983240223463687
"620423813","RIO NEGRO",188,187,0,0,0,0,0.99468085106383
"620423610","RIO NEGRO",158,156,1,0,0,1,0.987341772151899
"620423608","RIO NEGRO",243,238,1,2,0,3,0.979423868312757
"140145615","CORDOBA",129,129,0,0,0,0,1
"620422304","RIO NEGRO",220,116,46,54,2,102,0.527272727272727
"900700701","TUCUMAN",92,0,40,47,0,87,0
"620210701","RIO NEGRO",233,9,145,38,7,190,0.0386266094420601
"620910404","RIO NEGRO",283,1,72,68,111,251,0.00353356890459364
"620211512","RIO NEGRO",207,201,5,0,0,5,0.971014492753623
"620770101","RIO NEGRO",211,3,154,50,3,207,0.014218009478673
"620630111","RIO NEGRO",184,163,10,11,0,21,0.885869565217391
"620070201","RIO NEGRO",38,2,12,20,3,35,0.0526315789473684
"620490103","RIO NEGRO",76,0,20,52,1,73,0
"620490102","RIO NEGRO",278,0,126,118,3,247,0
"620424303","RIO NEGRO",192,187,3,2,0,5,0.973958333333333
"620423311","RIO NEGRO",331,329,2,0,0,2,0.993957703927492
"620700105","RIO NEGRO",91,1,36,17,29,82,0.010989010989011
"620421807","RIO NEGRO",301,93,162,40,0,202,0.308970099667774
"620421404","RIO NEGRO",169,0,110,56,0,166,0
"620421205","RIO NEGRO",153,151,1,1,0,2,0.986928104575163
"620421111","RIO NEGRO",166,106,4,47,1,52,0.63855421686747
"620421110","RIO NEGRO",299,143,11,116,11,138,0.478260869565217
"620421105","RIO NEGRO",235,7,50,168,4,222,0.0297872340425532
"140145614","CORDOBA",126,126,0,0,0,0,1
"620421009","RIO NEGRO",292,232,24,18,0,42,0.794520547945205
"620420907","RIO NEGRO",277,165,64,41,2,107,0.595667870036101
"620420803","RIO NEGRO",212,183,10,8,0,18,0.863207547169811
"620211503","RIO NEGRO",280,277,1,0,0,1,0.989285714285714
"620211405","RIO NEGRO",363,165,70,84,10,164,0.454545454545455
"620141003","RIO NEGRO",177,72,38,45,9,92,0.406779661016949
"300150714","ENTRE RIOS",182,181,0,0,0,0,0.994505494505495
"620350114","RIO NEGRO",206,0,138,58,1,197,0
"620350113","RIO NEGRO",230,0,99,107,9,215,0
"060351209","BUENOS AIRES",106,106,0,0,0,0,1
"620211002","RIO NEGRO",307,274,18,8,0,26,0.892508143322476
"620210707","RIO NEGRO",412,2,220,96,51,367,0.00485436893203883
"620770307","RIO NEGRO",156,141,11,4,0,15,0.903846153846154
"580352326","NEUQUEN",224,224,0,0,0,0,1
"620211803","RIO NEGRO",218,179,13,16,1,30,0.821100917431193
"620423604","RIO NEGRO",245,228,3,12,0,15,0.930612244897959
"620423603","RIO NEGRO",276,272,2,2,0,4,0.985507246376812
"620423407","RIO NEGRO",159,148,6,4,0,10,0.930817610062893
"620211709","RIO NEGRO",211,3,88,112,0,200,0.014218009478673
"620211011","RIO NEGRO",166,158,8,0,0,8,0.951807228915663
"620211309","RIO NEGRO",124,107,15,2,0,17,0.862903225806452
"620211402","RIO NEGRO",347,5,140,163,19,322,0.0144092219020173
"620422405","RIO NEGRO",315,290,3,19,0,22,0.920634920634921
"620211109","RIO NEGRO",188,2,170,14,1,185,0.0106382978723404
"861190203","SANTIAGO DEL ESTERO",80,0,21,19,31,71,0
"620140404","RIO NEGRO",291,254,12,21,0,33,0.872852233676976
"580351710","NEUQUEN",358,347,5,2,0,7,0.96927374301676
"581120412","NEUQUEN",199,174,5,2,0,7,0.874371859296482
"620211106","RIO NEGRO",257,7,242,8,0,250,0.0272373540856031
"620211103","RIO NEGRO",279,180,91,7,0,98,0.645161290322581
"620210706","RIO NEGRO",306,2,172,91,27,290,0.0065359477124183
"620210311","RIO NEGRO",171,165,3,3,0,6,0.964912280701754
"620210111","RIO NEGRO",230,114,100,11,3,114,0.495652173913044
"620210110","RIO NEGRO",241,0,168,46,10,224,0
"620071112","RIO NEGRO",306,143,43,93,7,143,0.467320261437909
"620770603","RIO NEGRO",79,69,9,1,0,10,0.873417721518987
"140145613","CORDOBA",145,144,1,0,0,1,0.993103448275862
"900841912","TUCUMAN",206,205,0,0,0,0,0.995145631067961
"140145612","CORDOBA",113,109,1,0,0,1,0.964601769911504
"620210301","RIO NEGRO",134,132,2,0,0,2,0.985074626865672
"620210210","RIO NEGRO",240,8,142,73,3,218,0.0333333333333333
"620420716","RIO NEGRO",210,1,108,85,3,196,0.00476190476190476
"620420714","RIO NEGRO",356,151,15,154,15,184,0.424157303370786
"620420615","RIO NEGRO",270,241,6,11,0,17,0.892592592592593
"620420505","RIO NEGRO",185,169,9,7,0,16,0.913513513513514
"620140609","RIO NEGRO",224,83,58,66,12,136,0.370535714285714
"620210305","RIO NEGRO",133,133,0,0,0,0,1
"620070903","RIO NEGRO",30,0,25,5,0,30,0
"620070818","RIO NEGRO",154,143,5,3,0,8,0.928571428571429
"620070706","RIO NEGRO",210,193,4,6,0,10,0.919047619047619
"620070608","RIO NEGRO",368,365,3,0,0,3,0.991847826086957
"620070701","RIO NEGRO",194,182,9,2,0,11,0.938144329896907
"620070612","RIO NEGRO",308,308,0,0,0,0,1
"620211609","RIO NEGRO",246,243,3,0,0,3,0.98780487804878
"620424110","RIO NEGRO",155,153,2,0,0,2,0.987096774193548
"620420403","RIO NEGRO",172,83,47,32,3,82,0.482558139534884
"620840202","RIO NEGRO",43,0,17,19,1,37,0
"620840106","RIO NEGRO",134,33,54,41,3,98,0.246268656716418
"620770602","RIO NEGRO",29,26,3,0,0,3,0.896551724137931
"620770203","RIO NEGRO",183,5,112,65,0,177,0.0273224043715847
"620770116","RIO NEGRO",181,92,56,31,1,88,0.50828729281768
"620910401","RIO NEGRO",34,0,9,12,13,34,0
"620840102","RIO NEGRO",153,3,95,50,3,148,0.0196078431372549
"620211301","RIO NEGRO",185,67,105,13,0,118,0.362162162162162
"660281311","SALTA",143,141,0,0,0,0,0.986013986013986
"620770306","RIO NEGRO",59,57,1,1,0,2,0.966101694915254
"620140410","RIO NEGRO",270,261,4,0,0,4,0.966666666666667
"620770208","RIO NEGRO",227,213,10,2,0,12,0.938325991189427
"900841303","TUCUMAN",177,172,2,1,0,3,0.971751412429379
"540420510","MISIONES",181,8,160,13,0,173,0.0441988950276243
"580351707","NEUQUEN",374,337,16,11,0,27,0.901069518716578
"620140401","RIO NEGRO",368,235,46,74,2,122,0.638586956521739
"620140304","RIO NEGRO",300,240,16,42,0,58,0.8
"620070610","RIO NEGRO",210,4,32,154,1,187,0.019047619047619
"620070508","RIO NEGRO",191,190,0,0,0,0,0.994764397905759
"620770301","RIO NEGRO",69,66,2,1,0,3,0.956521739130435
"620421504","RIO NEGRO",213,2,85,103,4,192,0.00938967136150235
"620350107","RIO NEGRO",70,0,4,16,23,43,0
"620140101","RIO NEGRO",15,0,11,3,0,14,0
"580910205","NEUQUEN",46,1,23,18,0,41,0.0217391304347826
"580560408","NEUQUEN",226,79,103,44,0,147,0.349557522123894
"100350307","CATAMARCA",82,0,20,50,5,75,0
"580352414","NEUQUEN",196,52,117,25,0,142,0.26530612244898
"580351901","NEUQUEN",210,2,128,73,3,204,0.00952380952380952
"580351812","NEUQUEN",399,2,227,120,23,370,0.0050125313283208
"221330402","CHACO",66,0,4,36,24,64,0
"580351619","NEUQUEN",132,31,67,34,0,101,0.234848484848485
"580350801","NEUQUEN",202,3,21,143,4,168,0.0148514851485149
"580352409","NEUQUEN",251,129,13,66,2,81,0.51394422310757
"580352310","NEUQUEN",264,257,2,2,0,4,0.973484848484849
"580770201","NEUQUEN",135,1,51,57,4,112,0.00740740740740741
"580910312","NEUQUEN",170,144,13,12,0,25,0.847058823529412
"580910309","NEUQUEN",196,154,12,27,0,39,0.785714285714286
"580560510","NEUQUEN",207,202,2,2,0,4,0.975845410628019
"580352212","NEUQUEN",133,131,1,0,0,1,0.984962406015038
"580560505","NEUQUEN",353,324,6,7,0,13,0.917847025495751
"580560503","NEUQUEN",101,98,3,0,0,3,0.97029702970297
"580352114","NEUQUEN",256,225,21,5,0,26,0.87890625
"221400717","CHACO",164,1,90,68,2,160,0.00609756097560976
"580560404","NEUQUEN",211,136,71,4,0,75,0.644549763033175
"580560309","NEUQUEN",211,210,1,0,0,1,0.995260663507109
"580352204","NEUQUEN",15,14,0,1,0,1,0.933333333333333
"581120416","NEUQUEN",130,125,5,0,0,5,0.961538461538462
"580352514","NEUQUEN",305,3,170,124,0,294,0.00983606557377049
"581120314","NEUQUEN",257,245,12,0,0,12,0.953307392996109
"581120403","NEUQUEN",22,4,4,8,1,13,0.181818181818182
"580560306","NEUQUEN",324,309,5,1,1,7,0.953703703703704
"580490414","NEUQUEN",211,153,5,12,6,23,0.725118483412322
"580560301","NEUQUEN",187,164,12,8,0,20,0.877005347593583
"580420206","NEUQUEN",243,50,128,58,1,187,0.205761316872428
"580352104","NEUQUEN",355,349,6,0,0,6,0.983098591549296
"580352103","NEUQUEN",274,270,2,0,0,2,0.985401459854015
"580352012","NEUQUEN",398,6,341,47,0,388,0.0150753768844221
"580352008","NEUQUEN",438,16,334,83,0,417,0.0365296803652968
"580351902","NEUQUEN",315,221,57,30,0,87,0.701587301587302
"580351826","NEUQUEN",235,47,94,77,8,179,0.2
"580351821","NEUQUEN",241,3,192,42,1,235,0.012448132780083
"580351609","NEUQUEN",159,2,43,82,5,130,0.0125786163522013
"580351509","NEUQUEN",313,308,4,1,0,5,0.984025559105431
"580351505","NEUQUEN",435,421,7,6,0,13,0.967816091954023
"580351416","NEUQUEN",143,133,9,1,0,10,0.93006993006993
"580351405","NEUQUEN",295,286,6,2,0,8,0.969491525423729
"580350616","NEUQUEN",193,188,2,2,0,4,0.974093264248705
"580350501","NEUQUEN",220,219,1,0,0,1,0.995454545454545
"580350512","NEUQUEN",119,118,1,0,0,1,0.991596638655462
"580352413","NEUQUEN",208,183,2,15,0,17,0.879807692307692
"580350402","NEUQUEN",306,304,2,0,0,2,0.993464052287582
"580350510","NEUQUEN",282,282,0,0,0,0,1
"580350518","NEUQUEN",133,132,0,1,0,1,0.992481203007519
"100490611","CATAMARCA",305,281,15,9,0,24,0.921311475409836
"580350608","NEUQUEN",378,372,4,2,0,6,0.984126984126984
"580350413","NEUQUEN",177,175,1,1,0,2,0.988700564971751
"580280109","NEUQUEN",264,156,65,38,0,103,0.590909090909091
"580140109","NEUQUEN",491,480,5,3,0,8,0.977596741344195
"580350410","NEUQUEN",354,317,3,0,0,3,0.895480225988701
"580351401","NEUQUEN",186,156,22,6,0,28,0.838709677419355
"580351211","NEUQUEN",171,161,3,7,0,10,0.941520467836257
"580351110","NEUQUEN",243,227,10,5,0,15,0.934156378600823
"580351004","NEUQUEN",294,288,3,3,0,6,0.979591836734694
"580350822","NEUQUEN",363,305,15,36,0,51,0.840220385674931
"580351806","NEUQUEN",214,8,183,21,0,204,0.0373831775700935
"580352410","NEUQUEN",281,232,12,29,0,41,0.825622775800712
"580351805","NEUQUEN",275,16,239,18,1,258,0.0581818181818182
"580350821","NEUQUEN",194,133,7,40,1,48,0.685567010309278
"580350819","NEUQUEN",219,219,0,0,0,0,1
"580350818","NEUQUEN",180,179,0,1,0,1,0.994444444444444
"580980104","NEUQUEN",461,408,9,25,5,39,0.885032537960954
"580910324","NEUQUEN",286,168,62,53,0,115,0.587412587412587
"580352112","NEUQUEN",201,189,5,4,0,9,0.940298507462687
"580352109","NEUQUEN",258,256,2,0,0,2,0.992248062015504
"581120303","NEUQUEN",402,384,6,1,0,7,0.955223880597015
"580351702","NEUQUEN",272,242,2,6,0,8,0.889705882352941
"580351506","NEUQUEN",404,389,9,3,0,12,0.962871287128713
"580420216","NEUQUEN",196,7,154,34,0,188,0.0357142857142857
"580351711","NEUQUEN",424,386,17,16,0,33,0.910377358490566
"580420105","NEUQUEN",107,46,44,17,0,61,0.429906542056075
"580352501","NEUQUEN",345,32,190,112,0,302,0.0927536231884058
"580352323","NEUQUEN",189,183,1,0,0,1,0.968253968253968
"581050207","NEUQUEN",58,0,4,42,3,49,0
"580350509","NEUQUEN",253,252,0,1,0,1,0.99604743083004
"580490205","NEUQUEN",103,0,11,41,16,68,0
"581050208","NEUQUEN",20,0,4,5,2,11,0
"580420101","NEUQUEN",92,0,0,29,19,48,0
"580351508","NEUQUEN",294,292,2,0,0,2,0.993197278911565
"900350114","TUCUMAN",285,0,210,59,6,275,0
"580350108","NEUQUEN",20,0,12,8,0,20,0
"581050213","NEUQUEN",29,0,1,12,14,27,0
"580352406","NEUQUEN",256,9,28,194,14,236,0.03515625
"580352316","NEUQUEN",226,219,1,1,0,2,0.969026548672566
"580352405","NEUQUEN",250,244,2,1,0,3,0.976
"580210102","NEUQUEN",36,0,7,4,23,34,0
"580352315","NEUQUEN",210,201,3,3,0,6,0.957142857142857
"580350517","NEUQUEN",206,205,0,0,0,0,0.995145631067961
"580140111","NEUQUEN",117,0,59,41,0,100,0
"580351213","NEUQUEN",277,263,3,7,1,11,0.949458483754513
"580910202","NEUQUEN",13,6,0,0,7,7,0.461538461538462
"580840107","NEUQUEN",88,0,20,36,10,66,0
"580351601","NEUQUEN",179,8,106,42,10,158,0.0446927374301676
"580560407","NEUQUEN",420,345,15,27,0,42,0.821428571428571
"540910406","MISIONES",188,0,113,34,35,182,0
"580070205","NEUQUEN",209,1,48,87,51,186,0.00478468899521531
"580630107","NEUQUEN",14,0,0,5,5,10,0
"580560102","NEUQUEN",12,0,4,1,3,8,0
"580490302","NEUQUEN",25,1,23,1,0,24,0.04
"580210108","NEUQUEN",20,0,7,1,2,10,0
"580350102","NEUQUEN",95,2,48,37,1,86,0.0210526315789474
"581050214","NEUQUEN",20,0,1,11,3,15,0
"580560203","NEUQUEN",12,0,9,3,0,12,0
"580700108","NEUQUEN",199,2,185,11,0,196,0.0100502512562814
"220211202","CHACO",64,0,7,22,28,57,0
"580351914","NEUQUEN",180,2,128,50,0,178,0.0111111111111111
"580560202","NEUQUEN",17,0,12,5,0,17,0
"900770413","TUCUMAN",171,0,115,44,0,159,0
"580352007","NEUQUEN",422,0,260,106,12,378,0
"580560504","NEUQUEN",174,171,2,0,0,2,0.982758620689655
"580352311","NEUQUEN",318,303,5,6,0,11,0.952830188679245
"820841902","SANTA FE",249,248,1,0,0,1,0.995983935742972
"580350701","NEUQUEN",55,53,1,1,0,2,0.963636363636364
"580350204","NEUQUEN",330,2,65,172,31,268,0.00606060606060606
"580350201","NEUQUEN",130,11,32,65,3,100,0.0846153846153846
"580560508","NEUQUEN",268,255,3,0,0,3,0.951492537313433
"580910107","NEUQUEN",436,120,196,110,1,307,0.275229357798165
"580350610","NEUQUEN",223,221,2,0,0,2,0.991031390134529
"580630113","NEUQUEN",333,273,15,31,0,46,0.81981981981982
"580910320","NEUQUEN",232,149,28,50,0,78,0.642241379310345
"220211301","CHACO",30,0,6,8,15,29,0
"580350505","NEUQUEN",212,212,0,0,0,0,1
"580700107","NEUQUEN",434,15,331,69,0,400,0.0345622119815668
"580420202","NEUQUEN",218,17,182,17,0,199,0.0779816513761468
"580351819","NEUQUEN",185,123,47,14,0,61,0.664864864864865
"580420109","NEUQUEN",55,0,47,6,0,53,0
"580351406","NEUQUEN",200,194,6,0,0,6,0.97
"580352308","NEUQUEN",298,294,1,3,0,4,0.986577181208054
"580352215","NEUQUEN",187,181,0,4,0,4,0.967914438502674
"580352214","NEUQUEN",286,276,2,1,0,3,0.965034965034965
"580352209","NEUQUEN",277,270,3,3,0,6,0.974729241877256
"581120420","NEUQUEN",307,291,9,6,0,15,0.947882736156352
"581120407","NEUQUEN",207,192,5,1,0,6,0.927536231884058
"581120305","NEUQUEN",333,299,10,6,0,16,0.897897897897898
"581120302","NEUQUEN",370,358,5,1,0,6,0.967567567567568
"580560406","NEUQUEN",286,65,200,19,0,219,0.227272727272727
"580351420","NEUQUEN",48,4,39,5,0,44,0.0833333333333333
"580560402","NEUQUEN",204,177,23,2,0,25,0.867647058823529
"580490413","NEUQUEN",286,271,5,2,0,7,0.947552447552448
"580490412","NEUQUEN",189,168,2,2,0,4,0.888888888888889
"581120207","NEUQUEN",90,79,4,4,1,9,0.877777777777778
"580352111","NEUQUEN",271,246,10,8,0,18,0.907749077490775
"580352108","NEUQUEN",271,267,2,1,0,3,0.985239852398524
"580351419","NEUQUEN",317,294,9,11,0,20,0.927444794952681
"580351414","NEUQUEN",419,405,6,8,0,14,0.966587112171838
"580350708","NEUQUEN",395,370,11,4,0,15,0.936708860759494
"580350617","NEUQUEN",239,238,1,0,0,1,0.99581589958159
"580350609","NEUQUEN",296,295,0,1,0,1,0.996621621621622
"580350604","NEUQUEN",223,222,0,1,0,1,0.995515695067265
"580350507","NEUQUEN",196,195,0,0,0,0,0.994897959183674
"580350419","NEUQUEN",364,358,4,1,0,5,0.983516483516483
"580350414","NEUQUEN",316,314,1,0,0,1,0.993670886075949
"580352506","NEUQUEN",166,165,0,0,0,0,0.993975903614458
"580352412","NEUQUEN",315,311,0,1,0,1,0.987301587301587
"580350207","NEUQUEN",151,2,9,95,2,106,0.0132450331125828
"580350206","NEUQUEN",45,0,6,31,2,39,0
"580350205","NEUQUEN",160,1,18,98,2,118,0.00625
"580140114","NEUQUEN",264,7,154,84,7,245,0.0265151515151515
"580351808","NEUQUEN",292,240,33,17,0,50,0.821917808219178
"580350516","NEUQUEN",322,320,1,0,0,1,0.993788819875776
"580350515","NEUQUEN",202,201,1,0,0,1,0.995049504950495
"580351214","NEUQUEN",247,230,10,4,1,15,0.931174089068826
"580351212","NEUQUEN",249,232,7,8,0,15,0.931726907630522
"580351117","NEUQUEN",386,282,30,43,14,87,0.730569948186529
"580351113","NEUQUEN",309,280,16,8,0,24,0.906148867313916
"580351106","NEUQUEN",374,362,5,4,0,9,0.967914438502674
"580351018","NEUQUEN",150,3,115,31,0,146,0.02
"140840406","CORDOBA",214,21,130,63,0,193,0.0981308411214953
"580351013","NEUQUEN",512,506,3,3,0,6,0.98828125
"580350816","NEUQUEN",378,200,40,114,4,158,0.529100529100529
"580350513","NEUQUEN",262,255,6,1,0,7,0.973282442748092
"580910322","NEUQUEN",245,189,30,19,0,49,0.771428571428571
"581120405","NEUQUEN",261,238,10,4,0,14,0.911877394636015
"580351411","NEUQUEN",418,354,26,25,0,51,0.84688995215311
"580280116","NEUQUEN",63,56,3,3,0,6,0.888888888888889
"580140115","NEUQUEN",140,4,13,79,23,115,0.0285714285714286
"580352516","NEUQUEN",277,150,43,76,1,120,0.541516245487365
"581050212","NEUQUEN",28,0,0,17,7,24,0
"580910203","NEUQUEN",14,2,0,1,9,10,0.142857142857143
"580840116","NEUQUEN",180,172,5,3,0,8,0.955555555555556
"580351210","NEUQUEN",248,243,3,1,0,4,0.979838709677419
"581120107","NEUQUEN",25,0,3,16,4,23,0
"580352201","NEUQUEN",184,3,37,121,7,165,0.016304347826087
"900840118","TUCUMAN",162,161,1,0,0,1,0.993827160493827
"580560507","NEUQUEN",366,330,7,9,2,18,0.901639344262295
"580351209","NEUQUEN",349,333,11,3,0,14,0.954154727793696
"581120104","NEUQUEN",30,0,1,23,3,27,0
"581120101","NEUQUEN",100,2,21,41,2,64,0.02
"580070301","NEUQUEN",111,0,71,29,2,102,0
"580350101","NEUQUEN",26,1,0,16,8,24,0.0384615384615385
"580210103","NEUQUEN",78,0,19,12,30,61,0
"580630104","NEUQUEN",147,1,12,54,65,131,0.00680272108843537
"540282009","MISIONES",290,2,233,49,1,283,0.00689655172413793
"260211805","CHUBUT",246,239,0,0,0,0,0.971544715447154
"580280104","NEUQUEN",55,0,8,32,8,48,0
"580490204","NEUQUEN",71,0,3,15,50,68,0
"580630109","NEUQUEN",91,1,25,24,2,51,0.010989010989011
"581050203","NEUQUEN",12,0,5,4,2,11,0
"580840104","NEUQUEN",40,0,14,13,0,27,0
"581120310","NEUQUEN",330,330,0,0,0,0,1
"580351908","NEUQUEN",366,234,101,28,0,129,0.639344262295082
"580630103","NEUQUEN",26,0,0,14,1,15,0
"580840102","NEUQUEN",206,82,41,68,0,109,0.398058252427184
"220700502","CHACO",33,0,8,10,13,31,0
"580560310","NEUQUEN",114,2,51,28,11,90,0.0175438596491228
"581050101","NEUQUEN",49,0,29,16,0,45,0
"580770204","NEUQUEN",81,36,13,20,4,37,0.444444444444444
"580352317","NEUQUEN",257,243,4,4,0,8,0.945525291828794
"580420106","NEUQUEN",145,0,50,71,9,130,0
"580351911","NEUQUEN",370,17,191,145,5,341,0.0459459459459459
"580351814","NEUQUEN",142,1,64,64,1,129,0.00704225352112676
"580351811","NEUQUEN",286,7,127,115,13,255,0.0244755244755245
"580351606","NEUQUEN",188,35,96,52,2,150,0.186170212765957
"580351603","NEUQUEN",65,0,26,34,2,62,0
"260910411","CHUBUT",176,143,16,9,1,26,0.8125
"580910103","NEUQUEN",242,4,143,92,0,235,0.0165289256198347
"580840106","NEUQUEN",252,132,67,43,0,110,0.523809523809524
"580840103","NEUQUEN",87,58,21,7,0,28,0.666666666666667
"580700113","NEUQUEN",334,5,282,42,0,324,0.0149700598802395
"580700104","NEUQUEN",200,2,183,14,0,197,0.01
"580352509","NEUQUEN",205,205,0,0,0,0,1
"580350506","NEUQUEN",252,251,1,0,0,1,0.996031746031746
"580560410","NEUQUEN",166,116,49,0,0,49,0.698795180722892
"580352313","NEUQUEN",295,294,0,0,0,0,0.996610169491525
"540282003","MISIONES",445,62,299,71,8,378,0.139325842696629
"580352009","NEUQUEN",241,118,91,28,2,121,0.489626556016597
"580560405","NEUQUEN",471,452,11,4,0,15,0.959660297239915
"580560509","NEUQUEN",309,302,2,3,0,5,0.977346278317152
"580352306","NEUQUEN",163,153,3,4,0,7,0.938650306748466
"580352208","NEUQUEN",313,300,8,1,0,9,0.958466453674121
"580352207","NEUQUEN",272,269,1,0,1,2,0.988970588235294
"581120208","NEUQUEN",224,159,37,23,0,60,0.709821428571429
"581120206","NEUQUEN",214,22,108,73,2,183,0.102803738317757
"581050103","NEUQUEN",215,198,6,5,0,11,0.92093023255814
"580560308","NEUQUEN",387,275,25,52,2,79,0.710594315245478
"580490409","NEUQUEN",269,256,3,7,0,10,0.951672862453532
"580420204","NEUQUEN",177,157,14,5,0,19,0.887005649717514
"580420210","NEUQUEN",185,33,124,26,0,150,0.178378378378378
"580352513","NEUQUEN",280,13,126,129,0,255,0.0464285714285714
"580351912","NEUQUEN",109,0,85,23,0,108,0
"580351818","NEUQUEN",273,84,156,33,0,189,0.307692307692308
"580351817","NEUQUEN",209,0,52,124,13,189,0
"580351815","NEUQUEN",269,0,232,35,0,267,0
"580351804","NEUQUEN",180,103,63,13,0,76,0.572222222222222
"580351617","NEUQUEN",54,0,11,24,3,38,0
"580351616","NEUQUEN",344,298,9,31,0,40,0.866279069767442
"580351614","NEUQUEN",138,20,28,73,2,103,0.144927536231884
"260211806","CHUBUT",191,185,2,1,0,3,0.968586387434555
"580351120","NEUQUEN",202,194,5,1,0,6,0.96039603960396
"580351514","NEUQUEN",301,290,0,9,0,9,0.963455149501661
"580351503","NEUQUEN",355,347,5,1,0,6,0.977464788732394
"580351421","NEUQUEN",198,44,10,134,0,144,0.222222222222222
"580351415","NEUQUEN",166,153,2,10,0,12,0.921686746987952
"580351410","NEUQUEN",380,335,17,24,0,41,0.881578947368421
"580351403","NEUQUEN",302,290,9,3,0,12,0.960264900662252
"580350703","NEUQUEN",323,323,0,0,0,0,1
"580350602","NEUQUEN",224,223,1,0,0,1,0.995535714285714
"580350508","NEUQUEN",177,177,0,0,0,0,1
"580350405","NEUQUEN",281,268,2,7,0,9,0.953736654804271
"580350403","NEUQUEN",136,133,1,0,0,1,0.977941176470588
"580350314","NEUQUEN",64,63,1,0,0,1,0.984375
"580350412","NEUQUEN",352,346,4,0,0,4,0.982954545454545
"580351215","NEUQUEN",336,328,4,2,0,6,0.976190476190476
"580420215","NEUQUEN",232,44,139,36,0,175,0.189655172413793
"580910301","NEUQUEN",25,0,2,4,0,6,0
"580350306","NEUQUEN",348,152,164,31,0,195,0.436781609195402
"580350214","NEUQUEN",154,0,11,93,14,118,0
"580350213","NEUQUEN",132,3,11,96,1,108,0.0227272727272727
"580350109","NEUQUEN",13,0,9,4,0,13,0
"580630105","NEUQUEN",92,7,48,24,4,76,0.0760869565217391
"580351125","NEUQUEN",164,123,28,13,0,41,0.75
"580351109","NEUQUEN",103,77,10,1,0,11,0.747572815533981
"580351014","NEUQUEN",197,195,2,0,0,2,0.989847715736041
"580350911","NEUQUEN",301,297,0,0,0,0,0.98671096345515
"580350908","NEUQUEN",323,321,1,1,0,2,0.993808049535604
"580350907","NEUQUEN",339,338,0,0,0,0,0.997050147492625
"580350902","NEUQUEN",270,267,0,0,0,0,0.988888888888889
"580350815","NEUQUEN",296,277,4,2,2,8,0.935810810810811
"580350809","NEUQUEN",306,306,0,0,0,0,1
"580350303","NEUQUEN",263,262,1,0,0,1,0.996197718631179
"580910316","NEUQUEN",133,122,5,6,0,11,0.917293233082707
"581120103","NEUQUEN",98,85,13,0,0,13,0.86734693877551
"581120304","NEUQUEN",375,370,3,0,0,3,0.986666666666667
"580351810","NEUQUEN",359,280,66,13,0,79,0.779944289693593
"580351103","NEUQUEN",409,398,4,3,0,7,0.973105134474328
"580351618","NEUQUEN",60,2,43,14,0,57,0.0333333333333333
"580350203","NEUQUEN",7,0,0,7,0,7,0
"580210104","NEUQUEN",42,0,0,10,19,29,0
"580140112","NEUQUEN",72,2,34,31,0,65,0.0277777777777778
"580070204","NEUQUEN",32,0,20,6,4,30,0
"100490612","CATAMARCA",228,204,5,11,0,16,0.894736842105263
"581120414","NEUQUEN",114,31,33,39,0,72,0.271929824561404
"581120410","NEUQUEN",181,174,4,2,0,6,0.961325966850829
"580352321","NEUQUEN",168,166,1,0,0,1,0.988095238095238
"580070201","NEUQUEN",93,0,30,14,32,76,0
"580910321","NEUQUEN",234,124,26,79,1,106,0.52991452991453
"580700204","NEUQUEN",102,0,88,12,0,100,0
"580910317","NEUQUEN",229,176,30,22,0,52,0.768558951965066
"580070105","NEUQUEN",90,9,60,16,3,79,0.1
"580980204","NEUQUEN",69,0,46,13,7,66,0
"580630108","NEUQUEN",35,0,2,11,0,13,0
"580560515","NEUQUEN",174,171,3,0,0,3,0.982758620689655
"580490405","NEUQUEN",191,188,2,0,0,2,0.984293193717278
"580490103","NEUQUEN",10,0,8,0,2,10,0
"580420102","NEUQUEN",69,0,23,15,4,42,0
"580420211","NEUQUEN",299,1,222,72,0,294,0.00334448160535117
"580420208","NEUQUEN",277,106,138,33,0,171,0.382671480144404
"580420212","NEUQUEN",205,136,41,22,0,63,0.663414634146341
"580560105","NEUQUEN",121,1,38,38,37,113,0.00826446280991736
"580560101","NEUQUEN",72,1,23,19,14,56,0.0138888888888889
"580490101","NEUQUEN",4,0,4,0,0,4,0
"580351801","NEUQUEN",4,0,1,1,1,3,0
"580350106","NEUQUEN",27,0,1,12,3,16,0
"580070102","NEUQUEN",133,0,15,31,27,73,0
"580352401","NEUQUEN",242,211,2,18,1,21,0.871900826446281
"581120401","NEUQUEN",175,4,39,95,5,139,0.0228571428571429
"580980202","NEUQUEN",151,6,102,29,7,138,0.0397350993377483
"580490401","NEUQUEN",281,238,41,2,0,43,0.846975088967972
"580352301","NEUQUEN",55,11,8,23,4,35,0.2
"580352325","NEUQUEN",244,242,2,0,0,2,0.991803278688525
"580352211","NEUQUEN",384,380,2,0,0,2,0.989583333333333
"580351402","NEUQUEN",61,38,20,3,0,23,0.622950819672131
"580560514","NEUQUEN",113,113,0,0,0,0,1
"580560513","NEUQUEN",139,137,1,1,0,2,0.985611510791367
"580350311","NEUQUEN",123,12,26,77,0,103,0.0975609756097561
"580280106","NEUQUEN",16,6,1,5,2,8,0.375
"580700110","NEUQUEN",175,9,141,23,1,165,0.0514285714285714
"581120404","NEUQUEN",345,335,4,0,0,4,0.971014492753623
"581120307","NEUQUEN",331,310,9,6,0,15,0.936555891238671
"581120313","NEUQUEN",233,227,4,1,1,6,0.974248927038627
"581050106","NEUQUEN",454,408,20,22,0,42,0.898678414096916
"260070904","CHUBUT",301,286,10,4,0,14,0.950166112956811
"580351412","NEUQUEN",343,333,8,1,0,9,0.970845481049563
"540420314","MISIONES",264,8,228,18,9,255,0.0303030303030303
"581050102","NEUQUEN",128,4,62,59,0,121,0.03125
"580352115","NEUQUEN",185,180,1,1,0,2,0.972972972972973
"580352113","NEUQUEN",139,3,29,95,0,124,0.0215827338129496
"580352110","NEUQUEN",308,296,4,6,0,10,0.961038961038961
"580352107","NEUQUEN",346,341,3,1,0,4,0.985549132947977
"580352106","NEUQUEN",290,275,4,5,0,9,0.948275862068966
"580352217","NEUQUEN",350,332,6,1,0,7,0.948571428571429
"260070905","CHUBUT",315,307,8,0,0,8,0.974603174603175
"580352220","NEUQUEN",250,240,3,2,0,5,0.96
"580351913","NEUQUEN",182,2,112,63,0,175,0.010989010989011
"580351903","NEUQUEN",259,208,35,15,0,50,0.803088803088803
"580351809","NEUQUEN",333,246,52,32,0,84,0.738738738738739
"580351802","NEUQUEN",275,58,155,61,0,216,0.210909090909091
"580351910","NEUQUEN",242,9,153,74,0,227,0.0371900826446281
"580351704","NEUQUEN",303,277,15,9,0,24,0.914191419141914
"580352219","NEUQUEN",298,291,3,2,0,5,0.976510067114094
"580351504","NEUQUEN",272,258,6,6,0,12,0.948529411764706
"580351413","NEUQUEN",415,396,12,2,0,14,0.95421686746988
"580350804","NEUQUEN",219,72,16,116,0,132,0.328767123287671
"580350714","NEUQUEN",251,234,4,10,0,14,0.932270916334661
"580350711","NEUQUEN",361,330,10,3,1,14,0.914127423822715
"580350710","NEUQUEN",314,297,8,8,0,16,0.945859872611465
"580350707","NEUQUEN",310,292,5,1,0,6,0.941935483870968
"580350706","NEUQUEN",333,319,8,1,0,9,0.957957957957958
"580350704","NEUQUEN",409,399,6,3,0,9,0.975550122249389
"580350709","NEUQUEN",329,296,12,16,0,28,0.899696048632219
"580350208","NEUQUEN",138,0,17,103,2,122,0
"221330401","CHACO",101,0,16,26,53,95,0
"580350601","NEUQUEN",383,335,9,35,1,45,0.87467362924282
"580350519","NEUQUEN",148,147,1,0,0,1,0.993243243243243
"580350420","NEUQUEN",292,292,0,0,0,0,1
"580350417","NEUQUEN",290,286,1,3,0,4,0.986206896551724
"580352508","NEUQUEN",178,174,3,0,0,3,0.97752808988764
"580352411","NEUQUEN",391,386,1,0,0,1,0.987212276214834
"580350408","NEUQUEN",327,324,3,0,0,3,0.990825688073395
"580350406","NEUQUEN",287,285,1,1,0,2,0.993031358885017
"580350316","NEUQUEN",301,295,6,0,0,6,0.980066445182724
"580350511","NEUQUEN",302,297,0,2,0,2,0.983443708609272
"580280107","NEUQUEN",282,252,15,11,0,26,0.893617021276596
"580350309","NEUQUEN",345,343,1,0,0,1,0.994202898550725
"580350308","NEUQUEN",436,200,56,158,9,223,0.458715596330275
"580350307","NEUQUEN",376,373,3,0,0,3,0.992021276595745
"580140106","NEUQUEN",340,329,7,3,0,10,0.967647058823529
"260070906","CHUBUT",280,270,9,1,0,10,0.964285714285714
"580140104","NEUQUEN",278,4,176,88,1,265,0.0143884892086331
"580350411","NEUQUEN",311,309,0,2,0,2,0.993569131832797
"580350514","NEUQUEN",194,194,0,0,0,0,1
"580351310","NEUQUEN",373,335,5,9,1,15,0.898123324396783
"580351114","NEUQUEN",246,240,1,1,0,2,0.975609756097561
"580351107","NEUQUEN",408,386,9,13,0,22,0.946078431372549
"580351104","NEUQUEN",452,447,4,0,0,4,0.988938053097345
"580351016","NEUQUEN",234,209,19,6,0,25,0.893162393162393
"580351010","NEUQUEN",160,6,68,65,2,135,0.0375
"580350904","NEUQUEN",359,354,2,0,0,2,0.986072423398329
"580350915","NEUQUEN",247,239,2,1,0,3,0.967611336032389
"580350820","NEUQUEN",277,270,6,0,0,6,0.974729241877256
"580350813","NEUQUEN",246,243,1,0,0,1,0.98780487804878
"580352517","NEUQUEN",332,274,29,24,0,53,0.825301204819277
"580352407","NEUQUEN",287,5,45,216,5,266,0.0174216027874564
"580350807","NEUQUEN",300,59,78,152,2,232,0.196666666666667
"580351001","NEUQUEN",178,176,1,1,0,2,0.98876404494382
"580910315","NEUQUEN",159,154,5,0,0,5,0.968553459119497
"580910306","NEUQUEN",205,169,15,14,0,29,0.824390243902439
"580351604","NEUQUEN",170,1,130,35,0,165,0.00588235294117647
"580350104","NEUQUEN",25,2,13,10,0,23,0.08
"580140116","NEUQUEN",289,135,48,97,1,146,0.467128027681661
"580630112","NEUQUEN",506,431,21,18,6,45,0.851778656126482
"580980105","NEUQUEN",93,0,16,59,9,84,0
"580630102","NEUQUEN",76,0,8,32,28,68,0
"580210109","NEUQUEN",44,0,5,11,26,42,0
"580210106","NEUQUEN",13,0,4,5,1,10,0
"580700101","NEUQUEN",13,0,8,3,1,12,0
"580490203","NEUQUEN",68,0,9,19,16,44,0
"580490201","NEUQUEN",16,1,9,3,1,13,0.0625
"581120102","NEUQUEN",23,1,7,6,0,13,0.0434782608695652
"580770202","NEUQUEN",45,0,9,8,3,20,0
"580352001","NEUQUEN",116,64,36,12,1,49,0.551724137931034
"580352319","NEUQUEN",334,324,5,0,0,5,0.970059880239521
"580560411","NEUQUEN",69,20,36,8,2,46,0.289855072463768
"580910310","NEUQUEN",165,130,10,23,1,34,0.787878787878788
"580910108","NEUQUEN",312,45,159,104,0,263,0.144230769230769
"580770205","NEUQUEN",226,217,6,2,1,9,0.960176991150443
"581120315","NEUQUEN",145,138,7,0,0,7,0.951724137931034
"580352309","NEUQUEN",347,341,2,2,0,4,0.982708933717579
"580352305","NEUQUEN",245,233,7,2,0,9,0.951020408163265
"580770207","NEUQUEN",220,1,144,69,1,214,0.00454545454545455
"580910325","NEUQUEN",216,190,16,10,0,26,0.87962962962963
"580560304","NEUQUEN",283,271,2,2,0,4,0.957597173144876
"900841511","TUCUMAN",171,164,6,1,0,7,0.95906432748538
"580560502","NEUQUEN",156,89,62,5,0,67,0.57051282051282
"580490410","NEUQUEN",198,190,2,1,0,3,0.95959595959596
"580352304","NEUQUEN",294,292,1,0,1,2,0.993197278911565
"900841317","TUCUMAN",242,241,1,0,0,1,0.995867768595041
"581120415","NEUQUEN",313,248,17,20,2,39,0.792332268370607
"581120205","NEUQUEN",207,2,114,72,6,192,0.00966183574879227
"581050104","NEUQUEN",308,288,6,8,0,14,0.935064935064935
"580910307","NEUQUEN",147,124,16,6,0,22,0.843537414965986
"580352116","NEUQUEN",195,159,4,7,0,11,0.815384615384615
"580350615","NEUQUEN",238,238,0,0,0,0,1
"580351803","NEUQUEN",275,124,70,57,5,132,0.450909090909091
"580351708","NEUQUEN",398,361,13,13,1,27,0.907035175879397
"580351612","NEUQUEN",216,148,10,46,0,56,0.685185185185185
"580351607","NEUQUEN",103,1,18,69,6,93,0.00970873786407767
"580351605","NEUQUEN",257,1,117,98,2,217,0.00389105058365759
"580351510","NEUQUEN",370,359,9,0,0,9,0.97027027027027
"580351501","NEUQUEN",414,400,2,2,0,4,0.966183574879227
"580351418","NEUQUEN",379,348,20,9,0,29,0.91820580474934
"580352511","NEUQUEN",234,165,26,36,0,62,0.705128205128205
"580352503","NEUQUEN",337,171,73,92,0,165,0.507418397626113
"580350407","NEUQUEN",233,231,1,1,0,2,0.991416309012876
"580350310","NEUQUEN",287,274,11,0,0,11,0.954703832752613
"580350302","NEUQUEN",245,242,1,0,0,1,0.987755102040816
"580350212","NEUQUEN",143,4,19,90,9,118,0.027972027972028
"580350211","NEUQUEN",151,1,13,99,1,113,0.00662251655629139
"900841015","TUCUMAN",180,158,13,6,0,19,0.877777777777778
"580070305","NEUQUEN",92,3,33,28,23,84,0.0326086956521739
"580070304","NEUQUEN",363,338,16,6,3,25,0.931129476584022
"580070303","NEUQUEN",338,320,8,6,0,14,0.946745562130177
"580070302","NEUQUEN",547,427,78,22,1,101,0.780621572212066
"580351312","NEUQUEN",316,311,1,1,0,2,0.984177215189873
"580351311","NEUQUEN",259,256,3,0,0,3,0.988416988416988
"580351203","NEUQUEN",223,216,4,3,0,7,0.968609865470852
"580351201","NEUQUEN",353,333,7,2,0,9,0.943342776203966
"580351119","NEUQUEN",218,217,1,0,0,1,0.995412844036697
"580351111","NEUQUEN",0,0,0,0,0,0,NA
"580351108","NEUQUEN",238,234,1,1,0,2,0.983193277310924
"580351101","NEUQUEN",254,235,13,5,0,18,0.925196850393701
"260070710","CHUBUT",281,243,4,31,0,35,0.864768683274021
"580351012","NEUQUEN",299,288,3,3,0,6,0.963210702341137
"580490102","NEUQUEN",52,1,22,25,0,47,0.0192307692307692
"580351009","NEUQUEN",314,271,34,8,0,42,0.863057324840764
"580351008","NEUQUEN",277,266,7,4,0,11,0.96028880866426
"580350817","NEUQUEN",284,279,3,0,0,3,0.982394366197183
"580700111","NEUQUEN",313,3,232,65,0,297,0.00958466453674121
"580700105","NEUQUEN",456,11,377,57,0,434,0.0241228070175439
"580630111","NEUQUEN",584,531,22,9,1,32,0.909246575342466
"580352206","NEUQUEN",286,286,0,0,0,0,1
"581120419","NEUQUEN",267,214,8,30,5,43,0.801498127340824
"580352010","NEUQUEN",296,55,159,77,0,236,0.185810810810811
"580352005","NEUQUEN",20,1,12,7,0,19,0.05
"580351507","NEUQUEN",357,327,17,8,0,25,0.915966386554622
"581050205","NEUQUEN",25,1,1,5,5,11,0.04
"580770203","NEUQUEN",79,0,15,58,1,74,0
"580980201","NEUQUEN",36,0,1,10,22,33,0
"580280103","NEUQUEN",50,0,5,14,12,31,0
"580140103","NEUQUEN",78,0,38,29,1,68,0
"580140102","NEUQUEN",131,0,79,21,4,104,0
"580070103","NEUQUEN",136,0,78,38,6,122,0
"581120105","NEUQUEN",70,0,10,49,7,66,0
"580840114","NEUQUEN",17,0,5,9,2,16,0
"580070202","NEUQUEN",31,1,8,18,3,29,0.032258064516129
"580070101","NEUQUEN",0,0,0,0,0,0,NA
"580350803","NEUQUEN",386,340,25,12,0,37,0.880829015544041
"580980203","NEUQUEN",20,0,1,3,13,17,0
"580560206","NEUQUEN",27,0,23,1,2,26,0
"580840115","NEUQUEN",0,0,0,0,0,0,NA
"580490202","NEUQUEN",121,0,10,30,16,56,0
"580350305","NEUQUEN",367,362,4,1,0,5,0.986376021798365
"580980102","NEUQUEN",3,0,1,1,1,3,0
"580700102","NEUQUEN",32,5,12,9,5,26,0.15625
"580630110","NEUQUEN",42,11,6,14,0,20,0.261904761904762
"580490301","NEUQUEN",77,0,43,27,5,75,0
"580350909","NEUQUEN",337,331,2,0,0,2,0.982195845697329
"581120108","NEUQUEN",32,0,4,13,7,24,0
"581050209","NEUQUEN",63,0,22,31,5,58,0
"581120202","NEUQUEN",95,5,7,58,3,68,0.0526315789473684
"580910102","NEUQUEN",74,0,23,40,5,68,0
"580351824","NEUQUEN",253,10,172,63,4,239,0.0395256916996047
"581120308","NEUQUEN",332,312,5,0,0,5,0.939759036144578
"580420201","NEUQUEN",229,22,115,72,1,188,0.0960698689956332
"581120406","NEUQUEN",176,157,12,0,1,13,0.892045454545455
"580350913","NEUQUEN",374,369,0,1,0,1,0.986631016042781
"580351825","NEUQUEN",238,101,82,55,0,137,0.42436974789916
"580352318","NEUQUEN",171,170,0,1,0,1,0.994152046783626
"580770210","NEUQUEN",91,5,57,28,1,86,0.0549450549450549
"580700112","NEUQUEN",164,2,142,20,0,162,0.0121951219512195
"580700106","NEUQUEN",273,4,246,22,0,268,0.0146520146520147
"580910318","NEUQUEN",304,274,17,12,0,29,0.901315789473684
"580560403","NEUQUEN",274,256,13,5,0,18,0.934306569343066
"580352216","NEUQUEN",177,168,1,4,0,5,0.949152542372881
"580352213","NEUQUEN",232,217,10,1,0,11,0.935344827586207
"581120411","NEUQUEN",198,183,7,1,1,9,0.924242424242424
"580490415","NEUQUEN",185,120,6,28,13,47,0.648648648648649
"580490403","NEUQUEN",261,249,7,0,0,7,0.954022988505747
"580560307","NEUQUEN",215,135,50,15,1,66,0.627906976744186
"580490402","NEUQUEN",122,100,21,1,0,22,0.819672131147541
"580420207","NEUQUEN",276,114,124,33,1,158,0.41304347826087
"580420205","NEUQUEN",216,179,15,1,0,16,0.828703703703704
"580420203","NEUQUEN",214,8,165,39,0,204,0.0373831775700935
"580352515","NEUQUEN",264,83,78,93,2,173,0.314393939393939
"141050507","CORDOBA",234,4,214,11,0,225,0.0170940170940171
"580352404","NEUQUEN",362,302,22,25,1,48,0.834254143646409
"580352403","NEUQUEN",444,373,14,43,0,57,0.84009009009009
"260070907","CHUBUT",320,296,21,3,0,24,0.925
"580910305","NEUQUEN",283,177,74,30,0,104,0.625441696113074
"580352105","NEUQUEN",277,267,6,3,1,10,0.963898916967509
"580352102","NEUQUEN",294,289,4,1,0,5,0.982993197278912
"580351823","NEUQUEN",205,179,20,5,0,25,0.873170731707317
"580351701","NEUQUEN",331,319,8,2,0,10,0.963746223564955
"580351909","NEUQUEN",314,132,128,49,0,177,0.420382165605096
"580350912","NEUQUEN",285,283,1,1,0,2,0.992982456140351
"580351513","NEUQUEN",287,278,4,4,0,8,0.968641114982578
"580351408","NEUQUEN",350,331,13,6,0,19,0.945714285714286
"580351407","NEUQUEN",351,329,1,1,0,2,0.937321937321937
"260070908","CHUBUT",317,279,28,10,0,38,0.8801261829653
"580350715","NEUQUEN",247,214,9,15,2,26,0.866396761133603
"580350713","NEUQUEN",244,231,4,7,0,11,0.94672131147541
"580350712","NEUQUEN",401,364,13,19,0,32,0.907730673316708
"580350614","NEUQUEN",285,285,0,0,0,0,1
"580350607","NEUQUEN",205,202,1,0,0,1,0.985365853658537
"580350606","NEUQUEN",182,178,2,2,0,4,0.978021978021978
"580350603","NEUQUEN",208,207,1,0,0,1,0.995192307692308
"580350502","NEUQUEN",256,256,0,0,0,0,1
"580352510","NEUQUEN",279,276,0,0,0,0,0.989247311827957
"580350216","NEUQUEN",47,0,46,1,0,47,0
"900700307","TUCUMAN",256,30,81,133,4,218,0.1171875
"580350210","NEUQUEN",245,33,19,149,18,186,0.13469387755102
"580350522","NEUQUEN",209,208,1,0,0,1,0.995215311004785
"580210112","NEUQUEN",221,0,132,78,1,211,0
"580140107","NEUQUEN",211,193,1,4,1,6,0.914691943127962
"580351301","NEUQUEN",253,248,0,2,0,2,0.980237154150198
"580351204","NEUQUEN",396,389,4,3,0,7,0.982323232323232
"580351202","NEUQUEN",167,165,2,0,0,2,0.988023952095808
"580351123","NEUQUEN",198,191,7,0,0,7,0.964646464646465
"580351118","NEUQUEN",222,207,7,8,0,15,0.932432432432432
"580351115","NEUQUEN",242,11,114,115,0,229,0.0454545454545455
"580351017","NEUQUEN",256,249,5,2,0,7,0.97265625
"580351007","NEUQUEN",247,245,0,1,0,1,0.991902834008097
"580351003","NEUQUEN",238,229,4,2,0,6,0.96218487394958
"580070104","NEUQUEN",179,17,137,17,8,162,0.0949720670391061
"580351304","NEUQUEN",152,143,0,0,0,0,0.940789473684211
"580351303","NEUQUEN",120,120,0,0,0,0,1
"260070909","CHUBUT",156,144,9,3,0,12,0.923076923076923
"580350901","NEUQUEN",211,91,8,92,2,102,0.431279620853081
"580350826","NEUQUEN",218,204,4,3,1,8,0.935779816513762
"580420214","NEUQUEN",280,196,60,23,0,83,0.7
"700700301","SAN JUAN",187,1,73,67,30,170,0.0053475935828877
"580350825","NEUQUEN",228,137,18,63,0,81,0.600877192982456
"580350823","NEUQUEN",281,214,12,45,0,57,0.761565836298932
"580350814","NEUQUEN",388,360,3,7,0,10,0.927835051546392
"580350808","NEUQUEN",215,214,0,1,0,1,0.995348837209302
"580350520","NEUQUEN",124,123,1,0,0,1,0.991935483870968
"580980205","NEUQUEN",66,4,53,7,0,60,0.0606060606060606
"580910323","NEUQUEN",253,10,62,169,2,233,0.0395256916996047
"900630415","TUCUMAN",207,191,6,8,0,14,0.922705314009662
"580770208","NEUQUEN",376,334,33,8,0,41,0.888297872340426
"580700114","NEUQUEN",295,3,191,85,5,281,0.0101694915254237
"580280102","NEUQUEN",15,0,7,8,0,15,0
"580140105","NEUQUEN",84,1,59,14,1,74,0.0119047619047619
"260071001","CHUBUT",88,88,0,0,0,0,1
"580910302","NEUQUEN",147,1,38,79,5,122,0.00680272108843537
"580910204","NEUQUEN",9,1,0,6,2,8,0.111111111111111
"580351511","NEUQUEN",339,321,4,12,0,16,0.946902654867257
"260070910","CHUBUT",214,204,5,5,0,10,0.953271028037383
"580910106","NEUQUEN",127,3,31,75,1,107,0.0236220472440945
"580352507","NEUQUEN",215,214,0,0,0,0,0.995348837209302
"580352505","NEUQUEN",174,174,0,0,0,0,1
"580210110","NEUQUEN",32,0,11,21,0,32,0
"580140113","RIO NEGRO",70,0,24,34,2,60,0
"580351422","NEUQUEN",236,219,5,11,1,17,0.927966101694915
"500070307","MENDOZA",96,96,0,0,0,0,1
"580980101","NEUQUEN",96,7,32,47,4,83,0.0729166666666667
"580910201","NEUQUEN",10,0,1,0,8,9,0
"580910109","NEUQUEN",55,0,0,27,9,36,0
"580210107","NEUQUEN",48,0,5,12,25,42,0
"580840113","NEUQUEN",3,0,0,3,0,3,0
"580840111","NEUQUEN",110,0,0,37,16,53,0
"580140101","NEUQUEN",110,1,22,43,5,70,0.00909090909090909
"580070203","NEUQUEN",78,0,24,40,5,69,0
"580351417","NEUQUEN",305,188,12,83,4,99,0.616393442622951
"580910101","NEUQUEN",22,0,3,1,1,5,0
"580770206","NEUQUEN",92,0,32,46,4,82,0
"580351409","NEUQUEN",311,293,9,6,0,15,0.942122186495177
"580350802","NEUQUEN",480,394,8,62,0,70,0.820833333333333
"581120301","NEUQUEN",127,108,7,9,0,16,0.850393700787402
"580352504","NEUQUEN",223,213,9,0,0,9,0.955156950672646
"580352502","NEUQUEN",324,84,156,83,1,240,0.259259259259259
"580700203","NEUQUEN",15,1,8,3,2,13,0.0666666666666667
"580840105","NEUQUEN",133,2,80,39,5,124,0.0150375939849624
"580770104","NEUQUEN",104,0,58,31,4,93,0
"580350702","NEUQUEN",167,167,0,0,0,0,1
"580350618","NEUQUEN",98,97,1,0,0,1,0.989795918367347
"580560501","NEUQUEN",17,0,9,8,0,17,0
"580352322","NEUQUEN",9,2,0,0,5,5,0.222222222222222
"580420104","NEUQUEN",62,1,20,27,6,53,0.0161290322580645
"580350613","NEUQUEN",301,289,5,1,0,6,0.960132890365448
"580350612","NEUQUEN",275,275,0,0,0,0,1
"581050210","NEUQUEN",34,0,10,18,2,30,0
"580350416","NEUQUEN",270,262,4,2,0,6,0.97037037037037
"580140110","NEUQUEN",341,264,24,48,0,72,0.774193548387097
"580140108","NEUQUEN",222,2,152,67,0,219,0.00900900900900901
"580350409","NEUQUEN",347,344,2,0,0,2,0.99135446685879
"580770102","NEUQUEN",154,2,69,50,17,136,0.012987012987013
"580350605","NEUQUEN",263,258,5,0,0,5,0.980988593155893
"580350504","NEUQUEN",195,195,0,0,0,0,1
"580351608","NEUQUEN",155,3,107,43,0,150,0.0193548387096774
"580350304","NEUQUEN",374,366,6,0,0,6,0.978609625668449
"580210111","NEUQUEN",17,0,10,7,0,17,0
"580910314","NEUQUEN",178,156,7,6,0,13,0.876404494382023
"580910313","NEUQUEN",176,165,7,2,0,9,0.9375
"580560511","NEUQUEN",226,224,0,0,0,0,0.991150442477876
"580350503","NEUQUEN",337,337,0,0,0,0,1
"260071002","CHUBUT",345,343,2,0,0,2,0.994202898550725
"580910311","NEUQUEN",286,10,84,180,2,266,0.034965034965035
"581120311","NEUQUEN",239,223,5,1,0,6,0.933054393305439
"581120309","NEUQUEN",294,275,5,5,0,10,0.935374149659864
"580840109","NEUQUEN",100,1,63,34,1,98,0.01
"580910327","NEUQUEN",232,127,33,68,1,102,0.547413793103448
"580700109","NEUQUEN",194,4,153,34,0,187,0.0206185567010309
"580700103","NEUQUEN",325,4,269,32,16,317,0.0123076923076923
"580560512","NEUQUEN",206,205,1,0,0,1,0.995145631067961
"580560409","NEUQUEN",197,182,11,1,1,13,0.923857868020305
"580560305","NEUQUEN",344,311,8,16,0,24,0.904069767441861
"580490407","NEUQUEN",462,418,5,10,1,16,0.904761904761905
"580490406","NEUQUEN",208,204,0,0,0,0,0.980769230769231
"580560303","NEUQUEN",283,274,0,1,0,1,0.968197879858657
"580351515","NEUQUEN",190,182,8,0,0,8,0.957894736842105
"580560302","NEUQUEN",292,192,50,19,1,70,0.657534246575342
"580352408","NEUQUEN",287,7,36,206,10,252,0.024390243902439
"580352402","NEUQUEN",237,231,4,1,0,5,0.974683544303797
"580352327","NEUQUEN",171,166,0,1,0,1,0.970760233918129
"580352320","NEUQUEN",199,196,2,0,0,2,0.984924623115578
"581120409","NEUQUEN",155,152,2,0,0,2,0.980645161290323
"581050211","NEUQUEN",213,1,183,25,0,208,0.00469483568075117
"580910308","NEUQUEN",197,171,11,13,0,24,0.868020304568528
"580351907","NEUQUEN",316,193,93,30,0,123,0.610759493670886
"580351105","NEUQUEN",246,243,1,2,0,3,0.98780487804878
"580770105","NEUQUEN",165,77,19,42,1,62,0.466666666666667
"580910304","RIO NEGRO",409,213,88,101,4,193,0.52078239608802
"580352312","NEUQUEN",295,286,3,2,0,5,0.969491525423729
"580351906","NEUQUEN",330,257,42,31,0,73,0.778787878787879
"580351816","NEUQUEN",253,188,50,13,0,63,0.743083003952569
"580351813","NEUQUEN",253,1,148,93,2,243,0.00395256916996047
"580351807","NEUQUEN",330,280,45,4,0,49,0.848484848484849
"580351703","NEUQUEN",157,152,5,0,0,5,0.968152866242038
"580351620","NEUQUEN",76,69,3,4,0,7,0.907894736842105
"580351610","NEUQUEN",212,78,12,105,5,122,0.367924528301887
"580840101","NEUQUEN",15,0,3,2,4,9,0
"580560401","NEUQUEN",215,2,191,17,1,209,0.00930232558139535
"580350404","NEUQUEN",470,410,11,32,8,51,0.872340425531915
"580350401","NEUQUEN",258,256,1,0,0,1,0.992248062015504
"580350215","NEUQUEN",203,117,10,64,6,80,0.576354679802956
"580350523","NEUQUEN",190,190,0,0,0,0,1
"580280108","NEUQUEN",103,49,18,34,0,52,0.475728155339806
"580350421","NEUQUEN",194,192,0,0,0,0,0.989690721649485
"580280117","NEUQUEN",258,225,23,10,0,33,0.872093023255814
"580351316","NEUQUEN",317,312,4,1,0,5,0.984227129337539
"580351307","NEUQUEN",293,279,1,7,0,8,0.95221843003413
"580351302","NEUQUEN",153,153,0,0,0,0,1
"580351207","NEUQUEN",205,199,2,4,0,6,0.970731707317073
"580351126","NEUQUEN",163,31,44,73,3,120,0.190184049079755
"580351005","NEUQUEN",396,383,3,5,0,8,0.967171717171717
"580351002","NEUQUEN",296,289,3,2,0,5,0.976351351351351
"580350910","NEUQUEN",303,302,0,0,0,0,0.996699669966997
"580350906","NEUQUEN",260,228,2,23,2,27,0.876923076923077
"580350903","NEUQUEN",338,330,2,6,0,8,0.976331360946746
"580350917","NEUQUEN",323,321,1,0,0,1,0.993808049535604
"580350824","NEUQUEN",182,3,30,123,4,157,0.0164835164835165
"580350918","NEUQUEN",285,259,1,17,1,19,0.908771929824561
"581120109","NEUQUEN",38,14,5,16,1,22,0.368421052631579
"580560516","NEUQUEN",208,207,1,0,0,1,0.995192307692308
"581120418","NEUQUEN",413,403,6,4,0,10,0.975786924939467
"580280110","NEUQUEN",116,96,16,4,0,20,0.827586206896552
"580352202","NEUQUEN",198,193,0,3,0,3,0.974747474747475
"581120413","NEUQUEN",358,342,3,8,0,11,0.955307262569832
"580420213","NEUQUEN",183,2,109,58,1,168,0.0109289617486339
"580352324","NEUQUEN",198,194,3,1,0,4,0.97979797979798
"580840110","NEUQUEN",18,0,2,10,1,13,0
"580700202","NEUQUEN",65,0,49,14,1,64,0
"580700201","NEUQUEN",34,0,20,9,0,29,0
"580210105","NEUQUEN",77,0,37,36,4,77,0
"581120201","NEUQUEN",77,0,15,36,8,59,0
"580351124","NEUQUEN",111,106,4,1,0,5,0.954954954954955
"581120203","NEUQUEN",39,0,2,18,15,35,0
"581120106","NEUQUEN",25,0,12,10,0,22,0
"581120408","NEUQUEN",371,351,7,5,0,12,0.946091644204852
"501120305","MENDOZA",280,0,181,91,2,274,0
"580352205","NEUQUEN",279,239,8,15,1,24,0.85663082437276
"581120402","NEUQUEN",246,129,22,62,4,88,0.524390243902439
"300844508","ENTRE RIOS",126,123,2,1,0,3,0.976190476190476
"580352101","NEUQUEN",112,5,20,68,2,90,0.0446428571428571
"580351613","NEUQUEN",193,1,34,103,17,154,0.00518134715025907
"580350418","NEUQUEN",299,280,1,0,0,1,0.936454849498328
"580280101","NEUQUEN",32,0,5,10,13,28,0
"580910105","NEUQUEN",12,0,0,2,2,4,0
"580840112","NEUQUEN",20,0,1,6,4,11,0
"580560205","NEUQUEN",11,0,9,2,0,11,0
"581050201","NEUQUEN",4,0,2,2,0,4,0
"580351820","NEUQUEN",197,130,41,21,0,62,0.65989847715736
"140840316","CORDOBA",157,0,128,21,5,154,0
"580420107","NEUQUEN",35,0,10,15,3,28,0
"580280115","NEUQUEN",37,1,6,26,2,34,0.027027027027027
"581120417","NEUQUEN",17,17,0,0,0,0,1
"580770103","NEUQUEN",190,26,91,40,4,135,0.136842105263158
"580352006","NEUQUEN",117,0,48,47,9,104,0
"260071003","CHUBUT",133,133,0,0,0,0,1
"580351112","NEUQUEN",353,101,93,134,12,239,0.286118980169972
"580840108","NEUQUEN",111,1,48,41,9,98,0.00900900900900901
"581120312","NEUQUEN",303,302,1,0,0,1,0.996699669966997
"580910326","NEUQUEN",160,74,46,37,2,85,0.4625
"581120316","NEUQUEN",228,212,8,2,0,10,0.929824561403509
"580560517","NEUQUEN",141,134,5,1,0,6,0.950354609929078
"860350702","SANTIAGO DEL ESTERO",121,0,7,50,29,86,0
"860351204","SANTIAGO DEL ESTERO",137,0,8,54,19,81,0
"580560506","NEUQUEN",298,264,4,5,0,9,0.885906040268456
"580910319","NEUQUEN",250,77,98,64,0,162,0.308
"580490411","NEUQUEN",215,160,6,11,2,19,0.744186046511628
"580490408","NEUQUEN",283,252,3,3,0,6,0.890459363957597
"580490404","NEUQUEN",314,300,5,5,0,10,0.955414012738854
"580420209","NEUQUEN",192,6,139,44,1,184,0.03125
"580352512","NEUQUEN",241,100,73,57,1,131,0.4149377593361
"580352314","NEUQUEN",267,266,0,0,0,0,0.99625468164794
"580352307","NEUQUEN",297,291,3,3,0,6,0.97979797979798
"580352302","NEUQUEN",277,272,1,3,0,4,0.981949458483754
"580352221","NEUQUEN",216,207,2,4,0,6,0.958333333333333
"580352210","NEUQUEN",262,254,1,5,0,6,0.969465648854962
"500070315","MENDOZA",209,208,0,0,0,0,0.995215311004785
"580350415","NEUQUEN",310,296,4,3,0,7,0.954838709677419
"580352203","NEUQUEN",35,1,17,16,0,33,0.0285714285714286
"581120306","NEUQUEN",252,240,6,2,0,8,0.952380952380952
"581050105","NEUQUEN",236,205,8,18,0,26,0.86864406779661
"580910303","RIO NEGRO",281,95,102,80,0,182,0.338078291814947
"580352218","NEUQUEN",121,120,1,0,0,1,0.991735537190083
"580352011","NEUQUEN",289,269,12,5,0,17,0.930795847750865
"580352003","NEUQUEN",52,0,32,20,0,52,0
"580351822","NEUQUEN",200,2,160,37,0,197,0.01
"580352002","NEUQUEN",206,199,0,0,0,0,0.966019417475728
"580351905","NEUQUEN",357,280,65,12,0,77,0.784313725490196
"580351904","NEUQUEN",321,249,45,25,0,70,0.775700934579439
"100490614","CATAMARCA",230,195,22,10,0,32,0.847826086956522
"580351709","NEUQUEN",366,357,5,2,0,7,0.975409836065574
"580351706","NEUQUEN",223,215,7,1,0,8,0.964125560538117
"580351705","NEUQUEN",103,47,16,39,0,55,0.456310679611651
"580351615","NEUQUEN",192,4,65,100,4,169,0.0208333333333333
"580351602","NEUQUEN",248,2,173,61,2,236,0.00806451612903226
"580351512","NEUQUEN",237,236,0,1,0,1,0.9957805907173
"580351404","NEUQUEN",298,283,10,2,0,12,0.949664429530201
"580350705","NEUQUEN",265,186,22,30,8,60,0.70188679245283
"580350315","NEUQUEN",176,9,21,122,5,148,0.0511363636363636
"580350313","NEUQUEN",268,23,208,37,0,245,0.0858208955223881
"580350301","NEUQUEN",250,220,4,25,0,29,0.88
"580350209","NEUQUEN",219,217,0,1,0,1,0.990867579908676
"580351122","NEUQUEN",255,247,7,1,0,8,0.968627450980392
"580351121","NEUQUEN",262,260,1,1,0,2,0.99236641221374
"740351306","SAN LUIS",242,242,0,0,0,0,1
"141050508","CORDOBA",301,4,283,10,1,294,0.0132890365448505
"580350202","NEUQUEN",147,0,71,66,1,138,0
"580351315","NEUQUEN",373,346,12,7,0,19,0.927613941018767
"580351314","NEUQUEN",270,254,12,1,0,13,0.940740740740741
"580351313","NEUQUEN",407,392,9,1,0,10,0.963144963144963
"580351309","NEUQUEN",323,309,5,2,0,7,0.956656346749226
"580351308","NEUQUEN",205,201,3,1,0,4,0.980487804878049
"580351306","NEUQUEN",289,287,2,0,0,2,0.993079584775087
"580351305","NEUQUEN",169,149,0,0,0,0,0.881656804733728
"580351208","NEUQUEN",262,253,3,3,0,6,0.965648854961832
"580351206","NEUQUEN",257,250,6,1,0,7,0.972762645914397
"580351205","NEUQUEN",433,380,23,21,1,45,0.877598152424942
"580351216","NEUQUEN",263,255,6,2,0,8,0.96958174904943
"581050202","NEUQUEN",14,0,6,6,0,12,0
"580351116","NEUQUEN",177,177,0,0,0,0,1
"580351102","NEUQUEN",258,256,1,1,0,2,0.992248062015504
"580351015","NEUQUEN",276,273,1,1,0,2,0.989130434782609
"580351011","NEUQUEN",265,164,84,16,0,100,0.618867924528302
"580351006","NEUQUEN",434,423,7,3,0,10,0.974654377880184
"580350905","NEUQUEN",200,199,1,0,0,1,0.995
"580350916","NEUQUEN",284,254,1,1,0,2,0.894366197183099
"580350914","NEUQUEN",321,317,1,1,0,2,0.987538940809969
"580350812","NEUQUEN",239,233,1,4,0,5,0.97489539748954
"580350811","NEUQUEN",348,346,2,0,0,2,0.994252873563218
"580350810","NEUQUEN",350,337,4,5,0,9,0.962857142857143
"580350806","NEUQUEN",327,321,3,0,0,3,0.981651376146789
"580350805","NEUQUEN",119,119,0,0,0,0,1
"580350521","NEUQUEN",192,192,0,0,0,0,1
"580980103","NEUQUEN",466,436,4,21,0,25,0.935622317596567
"580770106","NEUQUEN",237,222,11,1,0,12,0.936708860759494
"580352303","NEUQUEN",213,205,5,3,0,8,0.962441314553991
"581120421","NEUQUEN",342,339,1,0,0,1,0.991228070175439
"580351611","NEUQUEN",271,257,2,1,0,3,0.948339483394834
"580350611","NEUQUEN",233,232,1,0,0,1,0.995708154506438
"580350312","NEUQUEN",135,135,0,0,0,0,1
"580420217","NEUQUEN",292,52,172,66,0,238,0.178082191780822
"580770101","NEUQUEN",0,0,0,0,0,0,NA
"581050206","NEUQUEN",11,0,0,7,2,9,0
"580350107","NEUQUEN",26,2,4,12,1,17,0.0769230769230769
"581050204","NEUQUEN",58,57,1,0,0,1,0.982758620689655
"580352004","NEUQUEN",101,73,2,14,10,26,0.722772277227723
"580210101","NEUQUEN",33,0,4,8,12,24,0
"260070611","CHUBUT",136,103,5,26,0,31,0.757352941176471
"260070709","CHUBUT",324,266,7,45,0,52,0.820987654320988
"260070801","CHUBUT",260,250,4,1,0,5,0.961538461538462
"580910104","NEUQUEN",26,0,9,4,1,14,0
"580630106","NEUQUEN",11,0,2,3,3,8,0
"580560104","NEUQUEN",8,0,3,4,1,8,0
"580420103","NEUQUEN",75,0,12,35,16,63,0
"260070403","CHUBUT",268,245,4,18,0,22,0.914179104477612
"580560201","NEUQUEN",32,0,27,4,1,32,0
"260070101","CHUBUT",29,3,1,23,0,24,0.103448275862069
"260070201","CHUBUT",42,0,17,23,1,41,0
"260070404","CHUBUT",275,254,4,15,1,20,0.923636363636364
"260070202","CHUBUT",156,82,27,16,1,44,0.525641025641026
"260070301","CHUBUT",56,1,15,28,3,46,0.0178571428571429
"260070302","CHUBUT",11,0,0,11,0,11,0
"260070303","CHUBUT",27,0,19,5,2,26,0
"260070304","CHUBUT",203,1,136,64,1,201,0.00492610837438424
"260070401","CHUBUT",295,279,2,7,1,10,0.945762711864407
"260070402","CHUBUT",235,219,3,9,0,12,0.931914893617021
"260070711","CHUBUT",239,216,17,1,0,18,0.903765690376569
"260070405","CHUBUT",336,302,11,19,1,31,0.898809523809524
"260070406","CHUBUT",227,217,2,8,0,10,0.955947136563877
"260070407","CHUBUT",433,418,5,10,0,15,0.965357967667437
"260070408","CHUBUT",106,106,0,0,0,0,1
"260070409","CHUBUT",235,235,0,0,0,0,1
"260070410","CHUBUT",210,198,10,0,0,10,0.942857142857143
"260070411","CHUBUT",200,200,0,0,0,0,1
"260070412","CHUBUT",362,344,14,3,0,17,0.950276243093923
"260070413","CHUBUT",30,0,6,18,5,29,0
"260070414","CHUBUT",11,0,7,4,0,11,0
"260070501","CHUBUT",327,12,30,255,6,291,0.036697247706422
"260070502","CHUBUT",285,264,5,5,0,10,0.926315789473684
"260070503","CHUBUT",324,267,18,27,1,46,0.824074074074074
"260070712","CHUBUT",249,188,24,35,0,59,0.755020080321285
"260070504","CHUBUT",206,168,19,10,0,29,0.815533980582524
"260070505","CHUBUT",231,218,4,6,0,10,0.943722943722944
"260070506","CHUBUT",238,218,15,2,0,17,0.915966386554622
"260070507","CHUBUT",249,245,3,0,0,3,0.983935742971888
"260070508","CHUBUT",272,264,4,0,0,4,0.970588235294118
"260070509","CHUBUT",266,258,3,2,0,5,0.969924812030075
"260070510","CHUBUT",391,371,5,6,0,11,0.948849104859335
"260070511","CHUBUT",275,181,54,35,0,89,0.658181818181818
"260070610","CHUBUT",344,291,35,18,0,53,0.845930232558139
"900140707","TUCUMAN",35,0,9,19,6,34,0
"260070601","CHUBUT",356,343,2,2,0,4,0.963483146067416
"260070602","CHUBUT",229,225,3,0,0,3,0.982532751091703
"260070603","CHUBUT",285,284,0,0,0,0,0.996491228070175
"260070604","CHUBUT",377,376,0,0,0,0,0.997347480106101
"260070605","CHUBUT",397,394,0,1,0,1,0.992443324937028
"260070606","CHUBUT",225,222,0,0,0,0,0.986666666666667
"260070607","CHUBUT",306,292,4,6,0,10,0.954248366013072
"260070608","CHUBUT",340,147,58,134,0,192,0.432352941176471
"260070706","CHUBUT",193,3,24,120,22,166,0.0155440414507772
"260070609","CHUBUT",389,371,5,5,0,10,0.953727506426735
"900630502","TUCUMAN",213,211,1,0,0,1,0.990610328638498
"260070612","CHUBUT",403,384,6,7,0,13,0.952853598014888
"260070613","CHUBUT",185,164,19,1,0,20,0.886486486486487
"260070614","CHUBUT",307,303,1,0,0,1,0.986970684039088
"260070615","CHUBUT",364,339,22,2,0,24,0.931318681318681
"260070701","CHUBUT",75,73,2,0,0,2,0.973333333333333
"260070702","CHUBUT",232,205,6,15,0,21,0.883620689655172
"260070703","CHUBUT",255,253,1,0,0,1,0.992156862745098
"260070704","CHUBUT",348,342,0,1,0,1,0.982758620689655
"260070705","CHUBUT",287,170,21,75,5,101,0.592334494773519
"260070707","CHUBUT",354,91,47,193,3,243,0.257062146892655
"260070708","CHUBUT",343,272,15,48,0,63,0.793002915451895
"260070802","CHUBUT",455,445,5,3,0,8,0.978021978021978
"260070803","CHUBUT",250,150,57,39,0,96,0.6
"260070804","CHUBUT",330,263,24,38,0,62,0.796969696969697
"260070805","CHUBUT",294,288,3,1,0,4,0.979591836734694
"260070806","CHUBUT",457,440,8,8,0,16,0.962800875273523
"260070807","CHUBUT",206,162,33,8,0,41,0.786407766990291
"260070808","CHUBUT",218,208,5,0,0,5,0.954128440366973
"260070809","CHUBUT",210,119,48,43,0,91,0.566666666666667
"260070810","CHUBUT",217,27,145,44,0,189,0.124423963133641
"260070811","CHUBUT",422,382,24,12,1,37,0.90521327014218
"260070812","CHUBUT",339,326,5,6,0,11,0.96165191740413
"260070813","CHUBUT",271,249,12,8,0,20,0.918819188191882
"260070902","CHUBUT",319,310,6,1,0,7,0.971786833855799
"260070903","CHUBUT",445,439,4,1,0,5,0.986516853932584
"260071004","CHUBUT",182,180,1,0,0,1,0.989010989010989
"260071005","CHUBUT",253,252,1,0,0,1,0.99604743083004
"260071006","CHUBUT",249,219,2,0,0,2,0.879518072289157
"260071007","CHUBUT",283,282,0,0,1,1,0.996466431095406
"260071008","CHUBUT",211,211,0,0,0,0,1
"260071009","CHUBUT",231,223,6,2,0,8,0.965367965367965
"260071010","CHUBUT",376,367,6,3,0,9,0.976063829787234
"260071011","CHUBUT",233,226,6,1,0,7,0.969957081545064
"260071012","CHUBUT",182,171,7,4,0,11,0.93956043956044
"260140102","CHUBUT",37,0,20,6,0,26,0
"260071013","CHUBUT",140,48,48,44,0,92,0.342857142857143
"260140202","CHUBUT",22,0,15,2,5,22,0
"140145811","CORDOBA",302,299,2,1,0,3,0.990066225165563
"260140101","CHUBUT",47,2,36,1,2,39,0.0425531914893617
"260140106","CHUBUT",246,7,184,50,0,234,0.0284552845528455
"340142211","FORMOSA",323,114,143,17,0,160,0.352941176470588
"260140103","CHUBUT",74,1,42,25,4,71,0.0135135135135135
"260140104","CHUBUT",237,5,176,46,9,231,0.0210970464135021
"260211006","CHUBUT",190,188,0,0,0,0,0.989473684210526
"260140105","CHUBUT",286,7,225,50,2,277,0.0244755244755245
"260140107","CHUBUT",197,4,111,75,3,189,0.0203045685279188
"900840206","TUCUMAN",270,243,13,7,0,20,0.9
"260140108","CHUBUT",237,13,168,42,7,217,0.0548523206751055
"260140201","CHUBUT",3,0,0,1,2,3,0
"260211007","CHUBUT",177,173,0,0,2,2,0.977401129943503
"260140203","CHUBUT",7,0,1,3,3,7,0
"260140204","CHUBUT",6,0,0,0,6,6,0
"260140205","CHUBUT",3,0,3,0,0,3,0
"260140206","CHUBUT",1,0,0,1,0,1,0
"260140207","CHUBUT",10,0,6,3,1,10,0
"260140208","CHUBUT",4,0,2,2,0,4,0
"900630414","TUCUMAN",213,201,4,1,0,5,0.943661971830986
"260211208","CHUBUT",277,267,2,3,0,5,0.963898916967509
"260140209","CHUBUT",5,0,0,4,1,5,0
"260140301","CHUBUT",77,0,4,2,66,72,0
"260140302","CHUBUT",46,0,6,4,35,45,0
"260140303","CHUBUT",227,1,112,42,43,197,0.00440528634361234
"260140304","CHUBUT",26,0,5,0,10,15,0
"260210204","CHUBUT",375,367,3,1,0,4,0.978666666666667
"260211009","CHUBUT",170,169,0,1,0,1,0.994117647058824
"260210907","CHUBUT",203,200,2,0,0,2,0.985221674876847
"260140305","CHUBUT",55,0,3,9,27,39,0
"260210101","CHUBUT",32,0,4,28,0,32,0
"260210407","CHUBUT",347,344,2,1,0,3,0.99135446685879
"260211008","CHUBUT",206,206,0,0,0,0,1
"900840505","TUCUMAN",195,185,6,4,0,10,0.948717948717949
"260210406","CHUBUT",317,308,6,2,0,8,0.971608832807571
"260210413","CHUBUT",232,225,7,0,0,7,0.969827586206897
"260210908","CHUBUT",256,256,0,0,0,0,1
"260210909","CHUBUT",223,223,0,0,0,0,1
"260140306","CHUBUT",42,0,2,10,15,27,0
"260140307","CHUBUT",45,0,21,13,11,45,0
"260210409","CHUBUT",241,234,3,2,0,5,0.970954356846473
"260210410","CHUBUT",245,239,6,0,0,6,0.975510204081633
"260140401","CHUBUT",55,0,3,6,41,50,0
"260140501","CHUBUT",10,0,0,7,1,8,0
"260140703","CHUBUT",3,0,0,1,1,2,0
"300844509","ENTRE RIOS",60,54,3,3,0,6,0.9
"260140601","CHUBUT",18,0,4,4,8,16,0
"260140701","CHUBUT",21,0,0,4,17,21,0
"260210411","CHUBUT",196,193,2,0,0,2,0.98469387755102
"260210412","CHUBUT",193,188,2,3,0,5,0.974093264248705
"260140702","CHUBUT",50,0,5,10,28,43,0
"260140905","CHUBUT",236,22,190,21,0,211,0.0932203389830508
"260140704","CHUBUT",43,0,9,14,16,39,0
"260210203","CHUBUT",13,0,5,7,1,13,0
"260140705","CHUBUT",373,3,159,118,69,346,0.00804289544235925
"260140801","CHUBUT",189,7,108,53,4,165,0.037037037037037
"260140802","CHUBUT",28,0,15,13,0,28,0
"260140906","CHUBUT",255,5,193,37,11,241,0.0196078431372549
"260140803","CHUBUT",268,217,19,20,2,41,0.809701492537313
"260140804","CHUBUT",247,215,16,9,1,26,0.870445344129555
"260210301","CHUBUT",29,2,10,14,3,27,0.0689655172413793
"260140901","CHUBUT",945,18,713,117,38,868,0.019047619047619
"260210302","CHUBUT",9,0,4,4,1,9,0
"260210401","CHUBUT",2,0,2,0,0,2,0
"260210910","CHUBUT",147,147,0,0,0,0,1
"260140902","CHUBUT",27,0,13,4,5,22,0
"260140903","CHUBUT",230,7,170,35,7,212,0.0304347826086957
"260140904","CHUBUT",254,5,207,37,3,247,0.0196850393700787
"260211409","CHUBUT",235,234,1,0,0,1,0.995744680851064
"260141001","CHUBUT",65,0,35,16,5,56,0
"260141104","CHUBUT",179,13,113,40,0,153,0.0726256983240224
"260211508","CHUBUT",233,231,0,0,0,0,0.991416309012876
"260141002","CHUBUT",47,0,30,10,0,40,0
"260141003","CHUBUT",145,2,112,25,2,139,0.0137931034482759
"260141004","CHUBUT",327,13,236,56,4,296,0.0397553516819572
"260141101","CHUBUT",25,0,7,18,0,25,0
"260211807","CHUBUT",183,134,3,34,3,40,0.73224043715847
"260141102","CHUBUT",462,2,281,108,38,427,0.00432900432900433
"260141103","CHUBUT",272,96,145,24,4,173,0.352941176470588
"260210102","CHUBUT",22,22,0,0,0,0,1
"260210402","CHUBUT",67,20,42,5,0,47,0.298507462686567
"260210408","CHUBUT",220,202,12,3,0,15,0.918181818181818
"260210103","CHUBUT",27,0,4,18,3,25,0
"260210104","CHUBUT",13,0,13,0,0,13,0
"260210201","CHUBUT",26,25,1,0,0,1,0.961538461538462
"260210202","CHUBUT",50,0,20,16,12,48,0
"260211302","CHUBUT",410,376,6,7,0,13,0.917073170731707
"260210403","CHUBUT",82,81,0,0,0,0,0.98780487804878
"260210404","CHUBUT",281,277,1,2,0,3,0.98576512455516
"260210405","CHUBUT",274,260,10,3,0,13,0.948905109489051
"260211509","CHUBUT",225,225,0,0,0,0,1
"260210414","CHUBUT",215,209,4,2,0,6,0.972093023255814
"260210501","CHUBUT",12,1,1,8,2,11,0.0833333333333333
"260210502","CHUBUT",228,170,29,18,5,52,0.745614035087719
"260210503","CHUBUT",111,110,1,0,0,1,0.990990990990991
"260210504","CHUBUT",2,0,2,0,0,2,0
"901050910","TUCUMAN",147,142,3,1,0,4,0.965986394557823
"260210911","CHUBUT",287,286,0,0,0,0,0.996515679442509
"260210505","CHUBUT",312,286,8,9,0,17,0.916666666666667
"260210509","CHUBUT",207,205,2,0,0,2,0.990338164251208
"260210506","CHUBUT",288,278,7,3,0,10,0.965277777777778
"260210510","CHUBUT",248,242,1,1,0,2,0.975806451612903
"260211210","CHUBUT",170,161,3,3,0,6,0.947058823529412
"260210507","CHUBUT",245,243,0,1,0,1,0.991836734693878
"260210508","CHUBUT",133,129,3,0,0,3,0.969924812030075
"260211301","CHUBUT",325,291,3,6,0,9,0.895384615384615
"260210912","CHUBUT",154,154,0,0,0,0,1
"260210511","CHUBUT",276,239,9,18,0,27,0.865942028985507
"260210512","CHUBUT",320,303,7,1,0,8,0.946875
"260210513","CHUBUT",442,434,3,5,0,8,0.981900452488688
"260210606","CHUBUT",279,272,2,1,0,3,0.974910394265233
"260210913","CHUBUT",128,126,2,0,0,2,0.984375
"260210514","CHUBUT",473,388,9,65,0,74,0.820295983086681
"260210515","CHUBUT",407,385,3,15,0,18,0.945945945945946
"260210516","CHUBUT",237,237,0,0,0,0,1
"260210517","CHUBUT",242,239,0,0,0,0,0.987603305785124
"260211303","CHUBUT",236,213,2,2,0,4,0.902542372881356
"260210518","CHUBUT",293,213,4,56,2,62,0.726962457337884
"260210601","CHUBUT",108,80,1,3,24,28,0.740740740740741
"260210607","CHUBUT",334,330,3,0,0,3,0.988023952095808
"260210914","CHUBUT",185,182,1,0,0,1,0.983783783783784
"260211209","CHUBUT",319,310,0,3,0,3,0.971786833855799
"260211201","CHUBUT",323,244,11,35,0,46,0.755417956656347
"260210602","CHUBUT",194,1,59,105,3,167,0.00515463917525773
"260210603","CHUBUT",73,73,0,0,0,0,1
"260210604","CHUBUT",277,277,0,0,0,0,1
"260210614","CHUBUT",267,233,11,17,0,28,0.872659176029963
"260211114","CHUBUT",235,231,0,1,0,1,0.982978723404255
"260210605","CHUBUT",367,359,3,1,0,4,0.978201634877384
"260210610","CHUBUT",384,379,4,0,0,4,0.986979166666667
"140145810","CORDOBA",122,122,0,0,0,0,1
"260210608","CHUBUT",449,427,5,12,0,17,0.951002227171492
"260210611","CHUBUT",351,330,3,16,1,20,0.94017094017094
"260211115","CHUBUT",188,185,3,0,0,3,0.984042553191489
"260210808","CHUBUT",267,264,0,0,0,0,0.98876404494382
"260210612","CHUBUT",279,260,7,3,5,15,0.931899641577061
"260210609","CHUBUT",336,328,7,0,0,7,0.976190476190476
"260210613","CHUBUT",196,190,2,3,0,5,0.969387755102041
"260210615","CHUBUT",251,240,4,4,3,11,0.956175298804781
"260210701","CHUBUT",39,20,4,15,0,19,0.512820512820513
"260210707","CHUBUT",251,231,11,6,0,17,0.920318725099602
"260210708","CHUBUT",220,117,26,71,4,101,0.531818181818182
"260211116","CHUBUT",245,219,1,0,0,1,0.893877551020408
"260210709","CHUBUT",337,317,2,17,0,19,0.940652818991098
"260210809","CHUBUT",147,147,0,0,0,0,1
"300560301","ENTRE RIOS",76,76,0,0,0,0,1
"260210803","CHUBUT",48,43,1,2,0,3,0.895833333333333
"260210902","CHUBUT",212,212,0,0,0,0,1
"140145611","CORDOBA",279,279,0,0,0,0,1
"260210702","CHUBUT",241,4,90,136,3,229,0.016597510373444
"260210703","CHUBUT",83,81,2,0,0,2,0.975903614457831
"260210801","CHUBUT",30,30,0,0,0,0,1
"260210802","CHUBUT",442,394,7,16,0,23,0.891402714932127
"260210704","CHUBUT",440,419,4,7,5,16,0.952272727272727
"260210705","CHUBUT",106,98,3,3,0,6,0.924528301886792
"260210806","CHUBUT",207,205,2,0,0,2,0.990338164251208
"260210807","CHUBUT",372,369,3,0,0,3,0.991935483870968
"260210706","CHUBUT",230,210,7,13,0,20,0.91304347826087
"260211202","CHUBUT",231,210,2,12,0,14,0.909090909090909
"260210710","CHUBUT",278,224,4,33,0,37,0.805755395683453
"260210711","CHUBUT",178,163,7,3,0,10,0.915730337078652
"260211010","CHUBUT",215,204,2,0,1,3,0.948837209302326
"260210903","CHUBUT",215,215,0,0,0,0,1
"260210904","CHUBUT",126,125,0,0,0,0,0.992063492063492
"260210905","CHUBUT",186,186,0,0,0,0,1
"260210712","CHUBUT",271,261,5,1,0,6,0.96309963099631
"260210804","CHUBUT",141,141,0,0,0,0,1
"260210805","CHUBUT",225,222,2,0,0,2,0.986666666666667
"260210906","CHUBUT",152,151,1,0,0,1,0.993421052631579
"260211117","CHUBUT",219,216,2,0,0,2,0.986301369863014
"260210810","CHUBUT",301,285,5,10,0,15,0.946843853820598
"260210811","CHUBUT",53,53,0,0,0,0,1
"260210901","CHUBUT",307,235,6,29,2,37,0.765472312703583
"260211011","CHUBUT",105,105,0,0,0,0,1
"260210812","CHUBUT",321,258,8,52,0,60,0.803738317757009
"260210813","CHUBUT",114,114,0,0,0,0,1
"260210814","CHUBUT",390,373,4,12,1,17,0.956410256410256
"900770419","TUCUMAN",176,1,46,95,18,159,0.00568181818181818
"260210815","CHUBUT",402,367,13,21,0,34,0.912935323383085
"260211003","CHUBUT",326,322,2,0,0,2,0.987730061349693
"260211001","CHUBUT",336,336,0,0,0,0,1
"260211002","CHUBUT",272,271,0,1,0,1,0.996323529411765
"260211012","CHUBUT",476,475,1,0,0,1,0.997899159663866
"260211013","CHUBUT",316,308,6,0,0,6,0.974683544303797
"260211101","CHUBUT",140,128,2,4,0,6,0.914285714285714
"260211112","CHUBUT",181,180,0,0,0,0,0.994475138121547
"260211113","CHUBUT",322,318,0,1,0,1,0.987577639751553
"900910809","TUCUMAN",224,2,141,67,9,217,0.00892857142857143
"260211102","CHUBUT",264,226,5,10,0,15,0.856060606060606
"260211103","CHUBUT",138,130,1,0,0,1,0.942028985507246
"900840210","TUCUMAN",316,316,0,0,0,0,1
"260211104","CHUBUT",371,354,3,8,0,11,0.954177897574124
"260211105","CHUBUT",179,170,1,1,0,2,0.949720670391061
"260211106","CHUBUT",215,182,3,12,2,17,0.846511627906977
"260211304","CHUBUT",231,230,0,0,0,0,0.995670995670996
"260211107","CHUBUT",327,274,11,15,9,35,0.837920489296636
"260211108","CHUBUT",396,385,0,6,0,6,0.972222222222222
"260211109","CHUBUT",303,276,1,1,0,2,0.910891089108911
"260211110","CHUBUT",315,303,5,1,0,6,0.961904761904762
"260211111","CHUBUT",279,274,1,1,0,2,0.982078853046595
"260211203","CHUBUT",334,253,5,43,0,48,0.75748502994012
"260211204","CHUBUT",367,352,3,5,0,8,0.959128065395095
"260211205","CHUBUT",178,166,5,1,0,6,0.932584269662921
"260211206","CHUBUT",341,318,5,9,2,16,0.932551319648094
"260211406","CHUBUT",332,329,3,0,0,3,0.990963855421687
"260211207","CHUBUT",347,323,1,7,0,8,0.930835734870317
"260211305","CHUBUT",379,360,1,4,0,5,0.949868073878628
"260211306","CHUBUT",265,259,0,4,0,4,0.977358490566038
"260211307","CHUBUT",194,174,2,0,0,2,0.896907216494845
"260211308","CHUBUT",218,214,1,1,0,2,0.981651376146789
"260211309","CHUBUT",271,255,2,4,0,6,0.940959409594096
"260211310","CHUBUT",271,264,7,0,0,7,0.974169741697417
"260211311","CHUBUT",209,199,0,2,0,2,0.952153110047847
"260211312","CHUBUT",424,414,2,0,0,2,0.976415094339623
"260211401","CHUBUT",397,394,3,0,0,3,0.992443324937028
"260211402","CHUBUT",297,296,1,0,0,1,0.996632996632997
"260211403","CHUBUT",232,232,0,0,0,0,1
"260211404","CHUBUT",356,351,3,0,0,3,0.985955056179775
"260211405","CHUBUT",240,238,1,0,0,1,0.991666666666667
"860351604","SANTIAGO DEL ESTERO",401,332,44,24,0,68,0.827930174563591
"260211407","CHUBUT",419,403,1,0,0,1,0.9618138424821
"140145610","CORDOBA",89,88,1,0,0,1,0.98876404494382
"260211410","CHUBUT",178,178,0,0,0,0,1
"260211411","CHUBUT",255,254,1,0,0,1,0.996078431372549
"260211412","CHUBUT",298,297,1,0,0,1,0.996644295302013
"260211413","CHUBUT",339,288,8,11,26,45,0.849557522123894
"260211501","CHUBUT",234,216,4,2,0,6,0.923076923076923
"260211502","CHUBUT",321,311,5,0,0,5,0.968847352024922
"260211503","CHUBUT",331,329,0,0,0,0,0.993957703927492
"260211504","CHUBUT",306,306,0,0,0,0,1
"260211505","CHUBUT",236,233,1,0,0,1,0.98728813559322
"260211506","CHUBUT",284,276,0,1,0,1,0.971830985915493
"260211507","CHUBUT",239,239,0,0,0,0,1
"260211510","CHUBUT",287,285,0,0,0,0,0.993031358885017
"260211511","CHUBUT",340,332,5,1,0,6,0.976470588235294
"260211601","CHUBUT",352,191,23,96,4,123,0.542613636363636
"260211602","CHUBUT",111,100,2,1,1,4,0.900900900900901
"260211603","CHUBUT",198,182,7,1,0,8,0.919191919191919
"260211614","CHUBUT",190,174,3,4,0,7,0.91578947368421
"260211604","CHUBUT",203,178,4,10,0,14,0.876847290640394
"260211605","CHUBUT",335,311,5,4,1,10,0.928358208955224
"300701310","ENTRE RIOS",115,110,2,2,0,4,0.956521739130435
"260211606","CHUBUT",257,215,4,3,0,7,0.836575875486381
"260211607","CHUBUT",289,273,0,7,0,7,0.944636678200692
"260211608","CHUBUT",285,172,11,69,7,87,0.603508771929825
"260211609","CHUBUT",324,305,2,6,0,8,0.941358024691358
"260211610","CHUBUT",381,355,9,7,0,16,0.931758530183727
"260211611","CHUBUT",256,241,0,13,0,13,0.94140625
"260211612","CHUBUT",210,130,5,49,1,55,0.619047619047619
"260211613","CHUBUT",391,379,2,1,0,3,0.969309462915601
"260211615","CHUBUT",216,185,6,12,2,20,0.856481481481482
"260211712","CHUBUT",295,253,6,16,1,23,0.857627118644068
"260211702","CHUBUT",309,236,14,39,0,53,0.763754045307443
"260211703","CHUBUT",179,40,35,93,2,130,0.223463687150838
"260211704","CHUBUT",261,139,14,75,6,95,0.532567049808429
"260211705","CHUBUT",286,269,8,9,0,17,0.940559440559441
"260211706","CHUBUT",294,112,27,119,3,149,0.380952380952381
"260211707","CHUBUT",210,125,18,50,1,69,0.595238095238095
"260211708","CHUBUT",303,251,17,27,0,44,0.828382838283828
"260211709","CHUBUT",407,325,5,67,1,73,0.798525798525799
"900840509","TUCUMAN",163,132,12,13,1,26,0.809815950920245
"260211701","CHUBUT",77,0,25,51,1,77,0
"260211710","CHUBUT",264,197,9,47,1,57,0.746212121212121
"260211711","CHUBUT",420,104,32,246,3,281,0.247619047619048
"260211804","CHUBUT",280,278,0,0,0,0,0.992857142857143
"260211713","CHUBUT",157,141,0,11,0,11,0.898089171974522
"260211714","CHUBUT",327,323,0,3,0,3,0.987767584097859
"260211801","CHUBUT",188,8,50,119,2,171,0.0425531914893617
"900840119","TUCUMAN",193,190,3,0,0,3,0.984455958549223
"260211802","CHUBUT",219,13,40,141,2,183,0.0593607305936073
"260211803","CHUBUT",265,252,1,6,0,7,0.950943396226415
"661120403","SALTA",172,150,7,12,0,19,0.872093023255814
"260211808","CHUBUT",304,301,1,2,0,3,0.990131578947368
"260211809","CHUBUT",375,372,2,0,0,2,0.992
"260211810","CHUBUT",231,231,0,0,0,0,1
"260211811","CHUBUT",302,302,0,0,0,0,1
"260211812","CHUBUT",221,218,0,0,0,0,0.986425339366516
"260211813","CHUBUT",223,220,0,0,0,0,0.986547085201794
"260211901","CHUBUT",196,191,1,0,0,1,0.974489795918367
"260211902","CHUBUT",303,301,0,0,0,0,0.993399339933993
"260211911","CHUBUT",278,272,3,2,0,5,0.97841726618705
"260211903","CHUBUT",373,281,4,56,1,61,0.753351206434316
"260350304","CHUBUT",246,229,7,8,1,16,0.930894308943089
"260211904","CHUBUT",185,160,0,3,0,3,0.864864864864865
"260211905","CHUBUT",257,247,2,6,0,8,0.961089494163424
"260211906","CHUBUT",237,229,1,5,2,8,0.966244725738397
"260211907","CHUBUT",252,250,0,1,0,1,0.992063492063492
"260211908","CHUBUT",262,32,43,171,1,215,0.122137404580153
"260211909","CHUBUT",259,87,47,119,1,167,0.335907335907336
"260211910","CHUBUT",260,252,1,3,0,4,0.969230769230769
"260211912","CHUBUT",320,301,6,9,0,15,0.940625
"260211913","CHUBUT",301,61,70,161,0,231,0.20265780730897
"260211914","CHUBUT",170,49,24,88,3,115,0.288235294117647
"260350305","CHUBUT",249,236,4,6,1,11,0.947791164658635
"900141207","TUCUMAN",313,1,142,158,3,303,0.00319488817891374
"260211915","CHUBUT",268,118,29,98,3,130,0.440298507462687
"260211916","CHUBUT",227,178,10,28,1,39,0.784140969162996
"260280101","CHUBUT",25,0,11,12,0,23,0
"260280102","CHUBUT",4,0,1,3,0,4,0
"260280201","CHUBUT",33,0,8,18,2,28,0
"260280301","CHUBUT",13,0,2,9,0,11,0
"260280302","CHUBUT",24,0,12,9,0,21,0
"260350309","CHUBUT",311,310,0,1,0,1,0.996784565916399
"260280303","CHUBUT",380,0,305,70,2,377,0
"260350101","CHUBUT",51,1,33,17,0,50,0.0196078431372549
"260350306","CHUBUT",211,197,7,1,0,8,0.933649289099526
"260350310","CHUBUT",140,137,3,0,0,3,0.978571428571429
"260350311","CHUBUT",371,355,9,4,0,13,0.956873315363881
"260350613","CHUBUT",207,195,6,4,0,10,0.942028985507246
"260350614","CHUBUT",215,205,5,3,0,8,0.953488372093023
"260350615","CHUBUT",284,265,7,3,0,10,0.933098591549296
"260350102","CHUBUT",25,0,11,7,7,25,0
"260350201","CHUBUT",127,0,53,42,8,103,0
"260350202","CHUBUT",31,0,14,12,2,28,0
"260350307","CHUBUT",273,273,0,0,0,0,1
"260350308","CHUBUT",137,137,0,0,0,0,1
"260350610","CHUBUT",236,234,2,0,0,2,0.991525423728814
"260350301","CHUBUT",138,105,27,3,1,31,0.760869565217391
"260350302","CHUBUT",190,79,10,68,21,99,0.415789473684211
"260350303","CHUBUT",217,183,9,16,4,29,0.84331797235023
"260350312","CHUBUT",242,205,7,9,1,17,0.847107438016529
"260350503","CHUBUT",29,0,22,6,1,29,0
"260350515","CHUBUT",318,290,8,11,0,19,0.911949685534591
"260350607","CHUBUT",182,173,5,3,0,8,0.950549450549451
"260350608","CHUBUT",214,207,1,3,0,4,0.967289719626168
"260350606","CHUBUT",181,179,1,1,0,2,0.988950276243094
"260350611","CHUBUT",260,255,2,1,1,4,0.980769230769231
"260350612","CHUBUT",234,223,2,7,1,10,0.952991452991453
"300980313","ENTRE RIOS",133,133,0,0,0,0,1
"260350313","CHUBUT",216,173,13,10,2,25,0.800925925925926
"260350402","CHUBUT",32,0,18,8,6,32,0
"260350403","CHUBUT",88,2,49,18,11,78,0.0227272727272727
"260350401","CHUBUT",7,0,2,3,2,7,0
"260350404","CHUBUT",587,215,224,134,5,363,0.366269165247019
"260350512","CHUBUT",179,107,43,16,0,59,0.597765363128492
"260350513","CHUBUT",280,233,14,15,1,30,0.832142857142857
"260350609","CHUBUT",174,172,1,1,0,2,0.988505747126437
"260350405","CHUBUT",21,0,1,6,14,21,0
"260350501","CHUBUT",9,0,0,6,1,7,0
"260350502","CHUBUT",56,4,45,5,1,51,0.0714285714285714
"260350504","CHUBUT",32,0,18,6,4,28,0
"260350505","CHUBUT",187,3,59,53,13,125,0.0160427807486631
"260350506","CHUBUT",34,0,17,9,4,30,0
"260350507","CHUBUT",150,4,77,59,2,138,0.0266666666666667
"260350514","CHUBUT",291,255,8,9,1,18,0.876288659793814
"260350508","CHUBUT",83,1,59,15,5,79,0.0120481927710843
"260350509","CHUBUT",273,243,16,3,2,21,0.89010989010989
"260350510","CHUBUT",409,344,55,10,0,65,0.841075794621027
"260350511","CHUBUT",163,145,5,10,0,15,0.889570552147239
"540280821","MISIONES",266,3,41,155,26,222,0.0112781954887218
"260350601","CHUBUT",330,305,3,15,0,18,0.924242424242424
"260350602","CHUBUT",252,218,9,11,2,22,0.865079365079365
"260350603","CHUBUT",265,222,10,15,9,34,0.837735849056604
"260350604","CHUBUT",193,153,4,16,11,31,0.792746113989637
"260350605","CHUBUT",220,208,8,3,0,11,0.945454545454545
"900630420","TUCUMAN",212,139,14,45,2,61,0.655660377358491
"260350701","CHUBUT",300,269,5,14,5,24,0.896666666666667
"260350702","CHUBUT",293,231,1,13,2,16,0.78839590443686
"260350708","CHUBUT",331,326,1,2,0,3,0.984894259818731
"260771207","CHUBUT",356,355,0,0,0,0,0.997191011235955
"260350709","CHUBUT",317,308,2,1,0,3,0.971608832807571
"260350710","CHUBUT",349,341,2,1,0,3,0.977077363896848
"260350703","CHUBUT",366,288,5,33,13,51,0.786885245901639
"260350704","CHUBUT",247,213,8,18,4,30,0.862348178137652
"260350705","CHUBUT",348,337,3,6,1,10,0.968390804597701
"260350706","CHUBUT",244,240,4,0,0,4,0.983606557377049
"260350707","CHUBUT",386,360,8,7,1,16,0.932642487046632
"260350711","CHUBUT",173,157,9,5,0,14,0.907514450867052
"260350712","CHUBUT",363,351,8,3,0,11,0.966942148760331
"260350713","CHUBUT",173,167,4,2,0,6,0.965317919075145
"260770707","CHUBUT",350,321,14,1,0,15,0.917142857142857
"260420101","CHUBUT",14,0,1,12,1,14,0
"260420402","CHUBUT",5,0,4,0,0,4,0
"260770713","CHUBUT",306,288,9,6,0,15,0.941176470588235
"260420102","CHUBUT",26,0,7,14,5,26,0
"260420302","CHUBUT",17,0,3,8,3,14,0
"260420401","CHUBUT",1,0,1,0,0,1,0
"260420403","CHUBUT",110,1,90,12,2,104,0.00909090909090909
"260420103","CHUBUT",9,0,1,8,0,9,0
"260420201","CHUBUT",37,0,14,1,0,15,0
"260420301","CHUBUT",59,22,24,11,0,35,0.372881355932203
"300701311","ENTRE RIOS",175,162,1,6,0,7,0.925714285714286
"260420404","CHUBUT",33,0,25,7,1,33,0
"260420405","CHUBUT",37,0,24,10,2,36,0
"260420406","CHUBUT",46,0,26,12,4,42,0
"260420414","CHUBUT",397,154,188,50,0,238,0.387909319899244
"260770715","CHUBUT",198,190,2,1,0,3,0.95959595959596
"260420411","CHUBUT",153,0,75,43,9,127,0
"260420412","CHUBUT",68,0,14,38,9,61,0
"260420407","CHUBUT",57,1,25,27,1,53,0.0175438596491228
"260420408","CHUBUT",53,0,31,20,1,52,0
"260420409","CHUBUT",130,1,69,50,2,121,0.00769230769230769
"260420413","CHUBUT",528,122,240,135,9,384,0.231060606060606
"780140909","SANTA CRUZ",325,277,31,15,0,46,0.852307692307692
"380140607","JUJUY",307,266,8,28,0,36,0.866449511400652
"260770906","CHUBUT",355,337,8,8,0,16,0.949295774647887
"260420417","CHUBUT",336,5,230,92,4,326,0.0148809523809524
"260420410","CHUBUT",312,3,242,58,3,303,0.00961538461538462
"260770711","CHUBUT",188,180,0,6,0,6,0.957446808510638
"260771007","CHUBUT",189,187,2,0,0,2,0.989417989417989
"260420415","CHUBUT",392,6,261,104,10,375,0.0153061224489796
"260420416","CHUBUT",296,32,204,56,3,263,0.108108108108108
"260770705","CHUBUT",299,282,3,1,1,5,0.94314381270903
"540070102","MISIONES",245,1,100,88,42,230,0.00408163265306122
"260770708","CHUBUT",212,194,3,4,0,7,0.915094339622642
"260420418","CHUBUT",392,6,322,64,0,386,0.0153061224489796
"260490103","CHUBUT",49,0,4,27,9,40,0
"260770805","CHUBUT",255,245,9,0,0,9,0.96078431372549
"260490104","CHUBUT",37,0,4,15,18,37,0
"780141106","SANTA CRUZ",234,216,13,5,0,18,0.923076923076923
"260490101","CHUBUT",39,0,7,10,16,33,0
"260770801","CHUBUT",319,54,50,201,2,253,0.169278996865204
"260490102","CHUBUT",25,0,2,10,5,17,0
"260560107","CHUBUT",90,32,24,24,5,53,0.355555555555556
"260560108","CHUBUT",157,83,18,52,3,73,0.528662420382166
"660280811","SALTA",235,234,0,0,0,0,0.995744680851064
"260490105","CHUBUT",88,0,31,29,22,82,0
"260770806","CHUBUT",403,384,4,4,2,10,0.952853598014888
"260490106","CHUBUT",181,0,97,75,2,174,0
"260770315","CHUBUT",146,3,142,1,0,143,0.0205479452054795
"260560201","CHUBUT",18,0,4,6,8,18,0
"260560202","CHUBUT",49,0,2,9,35,46,0
"260560203","CHUBUT",5,0,2,0,3,5,0
"260770807","CHUBUT",160,156,1,2,0,3,0.975
"260490201","CHUBUT",5,0,2,0,3,5,0
"260770709","CHUBUT",403,377,1,3,1,5,0.935483870967742
"260490202","CHUBUT",28,0,2,12,14,28,0
"260490203","CHUBUT",60,0,15,27,17,59,0
"260770710","CHUBUT",317,287,14,5,0,19,0.905362776025237
"300980308","ENTRE RIOS",207,207,0,0,0,0,1
"260560101","CHUBUT",36,1,3,7,20,30,0.0277777777777778
"260560102","CHUBUT",18,0,8,1,2,11,0
"260770712","CHUBUT",346,329,3,3,0,6,0.950867052023121
"260560103","CHUBUT",20,0,7,7,6,20,0
"260560104","CHUBUT",101,38,10,26,22,58,0.376237623762376
"260560105","CHUBUT",28,0,1,8,17,26,0
"260560106","CHUBUT",33,0,7,5,14,26,0
"260560204","CHUBUT",12,0,0,9,0,9,0
"260630201","CHUBUT",26,0,4,17,1,22,0
"260770813","CHUBUT",322,306,6,6,0,12,0.950310559006211
"260700105","CHUBUT",29,0,2,16,8,26,0
"260770808","CHUBUT",363,346,2,6,1,9,0.953168044077135
"260560205","CHUBUT",14,0,11,1,0,12,0
"260560206","CHUBUT",392,289,40,21,5,66,0.737244897959184
"260560301","CHUBUT",100,14,41,25,7,73,0.14
"260630101","CHUBUT",8,0,6,2,0,8,0
"260630102","CHUBUT",13,0,1,11,1,13,0
"260630103","CHUBUT",21,0,15,4,0,19,0
"300701312","ENTRE RIOS",164,150,1,5,0,6,0.914634146341463
"260630202","CHUBUT",25,0,7,16,2,25,0
"260630203","CHUBUT",160,0,98,55,6,159,0
"260630301","CHUBUT",17,0,5,11,1,17,0
"260630401","CHUBUT",17,0,8,2,0,10,0
"260700101","CHUBUT",26,4,10,11,1,22,0.153846153846154
"260700102","CHUBUT",25,0,2,11,12,25,0
"260771011","CHUBUT",154,154,0,0,0,0,1
"260700103","CHUBUT",15,0,0,5,9,14,0
"260700104","CHUBUT",106,0,55,34,13,102,0
"260771012","CHUBUT",158,157,0,0,0,0,0.993670886075949
"260700106","CHUBUT",18,0,1,5,11,17,0
"260700107","CHUBUT",10,0,1,6,3,10,0
"260700108","CHUBUT",377,192,101,75,3,179,0.509283819628647
"260700201","CHUBUT",18,0,1,14,1,16,0
"260770302","CHUBUT",231,15,168,47,0,215,0.0649350649350649
"260770802","CHUBUT",307,300,3,3,0,6,0.977198697068404
"260700202","CHUBUT",25,0,2,18,2,22,0
"260770101","CHUBUT",3,0,0,3,0,3,0
"260770102","CHUBUT",13,2,0,11,0,11,0.153846153846154
"260770303","CHUBUT",171,2,151,18,0,169,0.0116959064327485
"260770305","CHUBUT",295,17,197,79,0,276,0.0576271186440678
"260770103","CHUBUT",10,1,6,3,0,9,0.1
"260770203","CHUBUT",51,19,5,23,0,28,0.372549019607843
"260770204","CHUBUT",58,2,24,25,1,50,0.0344827586206897
"260770104","CHUBUT",18,1,5,5,1,11,0.0555555555555556
"260770301","CHUBUT",115,5,103,7,0,110,0.0434782608695652
"780141122","SANTA CRUZ",242,240,0,0,0,0,0.991735537190083
"260770201","CHUBUT",22,2,9,10,1,20,0.0909090909090909
"260770304","CHUBUT",208,14,159,34,0,193,0.0673076923076923
"260770202","CHUBUT",2,1,1,0,0,1,0.5
"260770306","CHUBUT",215,9,184,21,0,205,0.0418604651162791
"260770307","CHUBUT",174,3,144,26,0,170,0.0172413793103448
"260770308","CHUBUT",106,3,92,11,0,103,0.0283018867924528
"260770309","CHUBUT",75,0,75,0,0,75,0
"260770310","CHUBUT",132,3,108,21,0,129,0.0227272727272727
"260770311","CHUBUT",108,8,96,4,0,100,0.0740740740740741
"260770312","CHUBUT",105,3,92,10,0,102,0.0285714285714286
"260770313","CHUBUT",123,3,97,23,0,120,0.024390243902439
"260770314","CHUBUT",109,9,87,13,0,100,0.0825688073394495
"260770316","CHUBUT",88,7,29,46,1,76,0.0795454545454545
"260770401","CHUBUT",113,8,62,36,0,98,0.0707964601769911
"260770402","CHUBUT",60,2,11,39,2,52,0.0333333333333333
"260770403","CHUBUT",167,2,62,69,3,134,0.0119760479041916
"300701401","ENTRE RIOS",12,0,7,5,0,12,0
"260770404","CHUBUT",211,1,113,84,2,199,0.004739336492891
"260770405","CHUBUT",83,0,37,33,7,77,0
"260770501","CHUBUT",3,3,0,0,0,0,1
"260770502","CHUBUT",285,267,8,1,0,9,0.936842105263158
"260770503","CHUBUT",202,194,1,0,0,1,0.96039603960396
"260770504","CHUBUT",219,216,2,0,0,2,0.986301369863014
"260770505","CHUBUT",252,238,10,1,0,11,0.944444444444444
"260770506","CHUBUT",250,233,10,2,0,12,0.932
"260770507","CHUBUT",229,227,1,0,0,1,0.991266375545852
"260770508","CHUBUT",171,151,18,1,0,19,0.883040935672515
"260770509","CHUBUT",214,211,1,0,0,1,0.985981308411215
"260770510","CHUBUT",321,312,4,3,0,7,0.97196261682243
"260770511","CHUBUT",214,204,8,0,0,8,0.953271028037383
"260770512","CHUBUT",199,177,16,3,0,19,0.889447236180904
"260770513","CHUBUT",183,167,5,7,0,12,0.912568306010929
"260770514","CHUBUT",228,227,1,0,0,1,0.995614035087719
"260770515","CHUBUT",232,232,0,0,0,0,1
"260770516","CHUBUT",213,212,0,0,0,0,0.995305164319249
"260770803","CHUBUT",393,392,0,0,0,0,0.997455470737914
"260770517","CHUBUT",201,199,1,0,0,1,0.990049751243781
"260770518","CHUBUT",239,163,27,40,0,67,0.682008368200837
"260770519","CHUBUT",184,106,55,23,0,78,0.576086956521739
"260770520","CHUBUT",116,3,88,19,2,109,0.0258620689655172
"260770601","CHUBUT",202,174,19,9,0,28,0.861386138613861
"260770602","CHUBUT",273,231,32,10,0,42,0.846153846153846
"260770603","CHUBUT",275,221,42,10,0,52,0.803636363636364
"260770714","CHUBUT",223,213,1,0,0,1,0.955156950672646
"260770604","CHUBUT",181,179,1,0,0,1,0.988950276243094
"260770605","CHUBUT",326,308,4,0,0,4,0.94478527607362
"260770610","CHUBUT",170,108,52,6,0,58,0.635294117647059
"260770611","CHUBUT",267,91,134,33,3,170,0.340823970037453
"260770606","CHUBUT",323,279,28,12,0,40,0.863777089783282
"260770608","CHUBUT",317,269,27,17,0,44,0.848580441640379
"260770609","CHUBUT",281,218,46,8,0,54,0.775800711743772
"260770804","CHUBUT",265,261,4,0,0,4,0.984905660377358
"260770607","CHUBUT",170,138,25,6,0,31,0.811764705882353
"260770706","CHUBUT",211,202,3,0,0,3,0.957345971563981
"260770612","CHUBUT",214,137,67,5,0,72,0.64018691588785
"260770701","CHUBUT",482,476,3,0,0,3,0.987551867219917
"260770702","CHUBUT",298,297,1,0,0,1,0.996644295302013
"260770703","CHUBUT",397,395,1,0,0,1,0.994962216624685
"260770704","CHUBUT",465,434,0,0,0,0,0.933333333333333
"260770809","CHUBUT",277,251,9,10,0,19,0.906137184115523
"260770810","CHUBUT",277,266,8,3,0,11,0.96028880866426
"260770811","CHUBUT",168,157,9,1,0,10,0.93452380952381
"260770812","CHUBUT",224,213,7,2,0,9,0.950892857142857
"260770814","CHUBUT",215,198,2,3,0,5,0.92093023255814
"260770815","CHUBUT",330,307,10,10,0,20,0.93030303030303
"260770901","CHUBUT",390,303,32,24,2,58,0.776923076923077
"260770902","CHUBUT",325,187,51,80,1,132,0.575384615384615
"260770903","CHUBUT",428,212,89,106,1,196,0.495327102803738
"260770904","CHUBUT",285,248,9,16,0,25,0.870175438596491
"260770905","CHUBUT",350,333,9,4,0,13,0.951428571428571
"260770907","CHUBUT",240,210,16,7,0,23,0.875
"260770908","CHUBUT",264,248,6,5,0,11,0.939393939393939
"260770909","CHUBUT",238,200,19,11,0,30,0.840336134453782
"900841803","TUCUMAN",167,163,1,3,0,4,0.976047904191617
"260770910","CHUBUT",344,330,5,4,0,9,0.959302325581395
"260770911","CHUBUT",360,276,43,30,0,73,0.766666666666667
"260770912","CHUBUT",435,263,49,101,0,150,0.604597701149425
"260771001","CHUBUT",245,231,6,4,1,11,0.942857142857143
"260771002","CHUBUT",246,229,4,5,0,9,0.930894308943089
"260771003","CHUBUT",158,129,3,11,0,14,0.816455696202532
"260771004","CHUBUT",237,231,3,0,0,3,0.974683544303797
"260771005","CHUBUT",306,302,1,3,0,4,0.986928104575163
"260771006","CHUBUT",140,130,9,0,0,9,0.928571428571429
"260771008","CHUBUT",188,186,2,0,0,2,0.98936170212766
"260771009","CHUBUT",205,203,2,0,0,2,0.990243902439024
"260771010","CHUBUT",213,213,0,0,0,0,1
"141400708","CORDOBA",178,156,19,2,0,21,0.876404494382023
"260771013","CHUBUT",315,312,2,0,0,2,0.990476190476191
"260771014","CHUBUT",328,325,0,0,0,0,0.990853658536585
"260771015","CHUBUT",312,307,4,1,0,5,0.983974358974359
"260771016","CHUBUT",488,474,9,2,0,11,0.971311475409836
"260771017","CHUBUT",375,363,8,2,0,10,0.968
"260771107","CHUBUT",366,328,12,8,0,20,0.896174863387978
"900841403","TUCUMAN",190,179,7,1,0,8,0.942105263157895
"260771018","CHUBUT",218,154,12,27,0,39,0.706422018348624
"260771101","CHUBUT",158,154,2,2,0,4,0.974683544303797
"260771102","CHUBUT",425,410,12,0,0,12,0.964705882352941
"260771103","CHUBUT",366,248,11,60,11,82,0.677595628415301
"260771104","CHUBUT",222,209,3,2,1,6,0.941441441441441
"260771105","CHUBUT",293,277,7,2,0,9,0.945392491467577
"260771106","CHUBUT",288,283,4,1,0,5,0.982638888888889
"260771108","CHUBUT",215,207,7,1,0,8,0.962790697674419
"260771109","CHUBUT",189,187,2,0,0,2,0.989417989417989
"260771110","CHUBUT",163,163,0,0,0,0,1
"260771111","CHUBUT",143,142,0,1,0,1,0.993006993006993
"260771112","CHUBUT",271,260,6,1,0,7,0.959409594095941
"260771113","CHUBUT",339,332,5,0,1,6,0.979351032448378
"260771114","CHUBUT",193,161,12,18,0,30,0.83419689119171
"260771201","CHUBUT",449,442,1,5,0,6,0.984409799554566
"780211411","SANTA CRUZ",239,228,2,2,0,4,0.95397489539749
"260771202","CHUBUT",283,271,3,7,0,10,0.957597173144876
"260771203","CHUBUT",392,387,1,0,0,1,0.987244897959184
"260771204","CHUBUT",285,283,2,0,0,2,0.992982456140351
"260771205","CHUBUT",336,333,3,0,0,3,0.991071428571429
"260771206","CHUBUT",319,319,0,0,0,0,1
"260771208","CHUBUT",323,321,2,0,0,2,0.993808049535604
"260771209","CHUBUT",207,206,1,0,0,1,0.995169082125604
"260771210","CHUBUT",320,319,1,0,0,1,0.996875
"260771211","CHUBUT",389,389,0,0,0,0,1
"260771212","CHUBUT",349,346,1,0,0,1,0.991404011461318
"260771213","CHUBUT",281,281,0,0,0,0,1
"260771214","CHUBUT",378,367,1,1,1,3,0.970899470899471
"900210205","TUCUMAN",489,6,241,210,1,452,0.0122699386503067
"260771215","CHUBUT",363,263,63,27,0,90,0.724517906336088
"260771305","CHUBUT",392,390,1,0,0,1,0.994897959183674
"260771306","CHUBUT",443,441,0,0,0,0,0.99548532731377
"260771307","CHUBUT",351,351,0,0,0,0,1
"260771301","CHUBUT",336,281,44,11,0,55,0.836309523809524
"260771302","CHUBUT",446,428,12,6,0,18,0.959641255605381
"260771303","CHUBUT",364,357,4,2,0,6,0.980769230769231
"260771304","CHUBUT",395,388,4,1,0,5,0.982278481012658
"900840905","TUCUMAN",252,245,3,2,0,5,0.972222222222222
"260771308","CHUBUT",378,376,1,0,0,1,0.994708994708995
"260771309","CHUBUT",449,446,2,1,0,3,0.993318485523385
"260771310","CHUBUT",241,236,3,0,0,3,0.979253112033195
"260771311","CHUBUT",293,293,0,0,0,0,1
"260771312","CHUBUT",268,261,5,2,0,7,0.973880597014925
"780211101","SANTA CRUZ",246,243,2,0,0,2,0.98780487804878
"900841402","TUCUMAN",267,248,5,10,0,15,0.928838951310861
"260771313","CHUBUT",212,199,9,4,0,13,0.938679245283019
"900420115","TUCUMAN",282,268,1,3,0,4,0.950354609929078
"260840101","CHUBUT",6,0,0,4,0,4,0
"780140804","SANTA CRUZ",410,202,171,30,2,203,0.492682926829268
"900840614","TUCUMAN",158,141,0,17,0,17,0.892405063291139
"260771314","CHUBUT",130,4,103,23,0,126,0.0307692307692308
"260840301","CHUBUT",12,0,0,10,0,10,0
"260840302","CHUBUT",9,0,3,4,2,9,0
"901120110","TUCUMAN",142,0,80,51,1,132,0
"260840102","CHUBUT",33,0,9,18,2,29,0
"260840201","CHUBUT",68,1,12,41,2,55,0.0147058823529412
"260840202","CHUBUT",62,1,41,16,1,58,0.0161290322580645
"260910102","CHUBUT",34,0,25,9,0,34,0
"260840303","CHUBUT",11,0,8,1,0,9,0
"780141105","SANTA CRUZ",170,163,5,1,0,6,0.958823529411765
"260840103","CHUBUT",42,0,23,5,3,31,0
"260840104","CHUBUT",4,0,3,0,1,4,0
"260840105","CHUBUT",5,0,0,3,1,4,0
"260840106","CHUBUT",43,0,22,18,2,42,0
"260840107","CHUBUT",218,70,83,42,8,133,0.321100917431193
"260840108","CHUBUT",281,104,105,60,4,169,0.370106761565836
"260840506","CHUBUT",53,0,49,2,1,52,0
"260910101","CHUBUT",25,0,13,6,6,25,0
"260840304","CHUBUT",39,0,8,11,18,37,0
"260840305","CHUBUT",466,38,291,108,8,407,0.0815450643776824
"260840306","CHUBUT",270,6,179,81,3,263,0.0222222222222222
"260840307","CHUBUT",103,69,32,2,0,34,0.669902912621359
"260910201","CHUBUT",27,0,12,10,2,24,0
"260910301","CHUBUT",7,0,3,3,1,7,0
"780141203","SANTA CRUZ",473,399,34,31,0,65,0.843551797040169
"900630416","TUCUMAN",67,2,33,31,0,64,0.0298507462686567
"260840505","CHUBUT",70,5,34,20,9,63,0.0714285714285714
"780140217","SANTA CRUZ",283,274,5,2,0,7,0.968197879858657
"780140211","SANTA CRUZ",478,453,9,6,0,15,0.947698744769874
"260840401","CHUBUT",21,1,5,11,1,17,0.0476190476190476
"260840402","CHUBUT",29,2,11,9,2,22,0.0689655172413793
"260840403","CHUBUT",65,0,60,2,2,64,0
"260910412","CHUBUT",221,191,17,10,0,27,0.864253393665158
"260910413","CHUBUT",232,209,8,11,1,20,0.900862068965517
"260910414","CHUBUT",228,202,14,8,0,22,0.885964912280702
"260840501","CHUBUT",10,0,4,3,2,9,0
"260840502","CHUBUT",18,0,2,13,0,15,0
"260840503","CHUBUT",22,0,15,6,0,21,0
"260840504","CHUBUT",24,0,9,6,3,18,0
"260910302","CHUBUT",9,0,1,4,4,9,0
"260910303","CHUBUT",36,0,23,10,2,35,0
"260910304","CHUBUT",102,2,60,32,3,95,0.0196078431372549
"260910305","CHUBUT",4,0,1,2,1,4,0
"260910306","CHUBUT",3,0,0,3,0,3,0
"260910401","CHUBUT",212,128,52,29,0,81,0.60377358490566
"260910402","CHUBUT",152,149,3,0,0,3,0.980263157894737
"780141121","SANTA CRUZ",287,281,5,0,0,5,0.979094076655052
"260910403","CHUBUT",114,43,49,20,0,69,0.37719298245614
"260910404","CHUBUT",283,223,8,14,1,23,0.787985865724382
"260910405","CHUBUT",321,280,29,6,0,35,0.872274143302181
"260910406","CHUBUT",153,83,40,17,1,58,0.542483660130719
"260910407","CHUBUT",180,152,18,3,0,21,0.844444444444444
"260910408","CHUBUT",176,147,20,4,0,24,0.835227272727273
"260910409","CHUBUT",294,259,23,10,0,33,0.880952380952381
"260910410","CHUBUT",273,243,17,10,1,28,0.89010989010989
"260980101","CHUBUT",15,0,1,10,3,14,0
"260980102","CHUBUT",27,1,7,12,7,26,0.037037037037037
"260980103","CHUBUT",234,3,158,58,13,229,0.0128205128205128
"260980306","CHUBUT",340,86,128,96,11,235,0.252941176470588
"260980104","CHUBUT",275,5,193,53,7,253,0.0181818181818182
"260980201","CHUBUT",20,0,5,6,1,12,0
"260980202","CHUBUT",24,0,8,12,1,21,0
"260980203","CHUBUT",19,0,12,5,0,17,0
"260980204","CHUBUT",0,0,0,0,0,0,NA
"780141116","SANTA CRUZ",282,266,13,2,0,15,0.943262411347518
"900841411","TUCUMAN",282,275,1,4,0,5,0.975177304964539
"260980205","CHUBUT",432,5,364,58,3,425,0.0115740740740741
"260980206","CHUBUT",317,2,219,75,9,303,0.00630914826498423
"260980301","CHUBUT",0,0,0,0,0,0,NA
"261050101","CHUBUT",28,0,14,14,0,28,0
"780211201","SANTA CRUZ",381,372,6,1,0,7,0.976377952755906
"780140903","SANTA CRUZ",277,223,19,16,0,35,0.805054151624549
"780211102","SANTA CRUZ",198,196,0,1,0,1,0.98989898989899
"260980302","CHUBUT",1,0,1,0,0,1,0
"260980303","CHUBUT",11,0,6,2,2,10,0
"261050102","CHUBUT",14,0,3,11,0,14,0
"260980304","CHUBUT",22,0,7,10,3,20,0
"260980305","CHUBUT",56,1,29,16,9,54,0.0178571428571429
"780211116","SANTA CRUZ",194,179,1,0,0,1,0.922680412371134
"261050103","CHUBUT",49,0,8,36,2,46,0
"261050104","CHUBUT",26,0,4,21,0,25,0
"261050105","CHUBUT",205,0,148,55,2,205,0
"780211205","SANTA CRUZ",437,430,3,2,0,5,0.983981693363844
"261050201","CHUBUT",27,0,0,19,5,24,0
"261050202","CHUBUT",10,0,1,5,2,8,0
"261050203","CHUBUT",8,0,0,6,2,8,0
"261050204","CHUBUT",53,0,13,34,6,53,0
"261050205","CHUBUT",212,0,112,97,0,209,0
"780490503","SANTA CRUZ",243,129,47,53,8,108,0.530864197530864
"780420301","SANTA CRUZ",307,253,16,21,0,37,0.824104234527687
"780280512","SANTA CRUZ",29,2,23,2,0,25,0.0689655172413793
"780280506","SANTA CRUZ",101,16,72,13,0,85,0.158415841584158
"780140218","SANTA CRUZ",382,335,35,8,0,43,0.87696335078534
"780140203","SANTA CRUZ",574,522,16,25,1,42,0.909407665505226
"780211412","SANTA CRUZ",221,218,0,2,0,2,0.986425339366516
"780211410","SANTA CRUZ",355,346,3,0,0,3,0.974647887323944
"780211320","SANTA CRUZ",581,289,28,235,4,267,0.497418244406196
"780211207","SANTA CRUZ",371,366,3,0,0,3,0.986522911051213
"780210805","SANTA CRUZ",327,324,2,1,0,3,0.990825688073395
"780210803","SANTA CRUZ",12,12,0,0,0,0,1
"780210706","SANTA CRUZ",65,46,4,13,0,17,0.707692307692308
"780211316","SANTA CRUZ",55,35,10,9,0,19,0.636363636363636
"780211315","SANTA CRUZ",446,445,1,0,0,1,0.997757847533632
"780211310","SANTA CRUZ",322,312,5,2,0,7,0.968944099378882
"780211220","SANTA CRUZ",386,381,3,0,0,3,0.987046632124352
"780211218","SANTA CRUZ",201,201,0,0,0,0,1
"780140505","SANTA CRUZ",606,342,140,87,2,229,0.564356435643564
"780140103","SANTA CRUZ",495,49,295,139,0,434,0.098989898989899
"780211406","SANTA CRUZ",364,346,11,2,0,13,0.950549450549451
"780070501","SANTA CRUZ",320,292,7,11,1,19,0.9125
"780350602","SANTA CRUZ",410,373,15,14,1,30,0.909756097560976
"780350404","SANTA CRUZ",379,315,19,38,1,58,0.831134564643799
"780420304","SANTA CRUZ",294,238,30,19,0,49,0.80952380952381
"780420303","SANTA CRUZ",126,94,15,17,0,32,0.746031746031746
"780141110","SANTA CRUZ",249,237,5,3,0,8,0.951807228915663
"780140805","SANTA CRUZ",370,267,70,24,2,96,0.721621621621622
"540420415","MISIONES",284,1,189,31,58,278,0.00352112676056338
"780420202","SANTA CRUZ",190,150,11,23,2,36,0.789473684210526
"780490301","SANTA CRUZ",20,0,6,11,0,17,0
"780490101","SANTA CRUZ",40,7,7,22,0,29,0.175
"780140302","SANTA CRUZ",22,0,3,9,1,13,0
"780140601","SANTA CRUZ",17,0,7,6,0,13,0
"780140101","SANTA CRUZ",30,1,4,16,0,20,0.0333333333333333
"780141202","SANTA CRUZ",341,329,5,4,0,9,0.964809384164223
"780140201","SANTA CRUZ",37,1,4,21,2,27,0.027027027027027
"780140913","SANTA CRUZ",374,246,57,67,1,125,0.657754010695187
"780210301","SANTA CRUZ",88,2,33,22,0,55,0.0227272727272727
"780211204","SANTA CRUZ",285,274,5,2,0,7,0.96140350877193
"780350603","SANTA CRUZ",404,380,16,6,0,22,0.940594059405941
"900842608","TUCUMAN",245,243,1,0,0,1,0.991836734693878
"780140208","SANTA CRUZ",463,335,27,65,8,100,0.72354211663067
"780211413","SANTA CRUZ",148,136,5,7,0,12,0.918918918918919
"780211408","SANTA CRUZ",339,334,3,1,0,4,0.985250737463127
"780211118","SANTA CRUZ",235,235,0,0,0,0,1
"780211117","SANTA CRUZ",172,172,0,0,0,0,1
"780211114","SANTA CRUZ",266,247,3,2,0,5,0.928571428571429
"780211112","SANTA CRUZ",292,287,1,1,0,2,0.982876712328767
"780211106","SANTA CRUZ",257,256,0,1,0,1,0.996108949416342
"780211104","SANTA CRUZ",157,154,3,0,0,3,0.980891719745223
"780211122","SANTA CRUZ",316,314,0,0,0,0,0.993670886075949
"780211014","SANTA CRUZ",333,326,4,0,0,4,0.978978978978979
"780211007","SANTA CRUZ",168,162,4,1,0,5,0.964285714285714
"780211005","SANTA CRUZ",182,182,0,0,0,0,1
"780280501","SANTA CRUZ",22,0,13,6,0,19,0
"780211219","SANTA CRUZ",216,212,3,1,0,4,0.981481481481482
"780210902","SANTA CRUZ",623,572,21,20,1,42,0.918138041733547
"780211121","SANTA CRUZ",219,218,0,1,0,1,0.995433789954338
"780210405","SANTA CRUZ",430,20,117,245,15,377,0.0465116279069767
"780210402","SANTA CRUZ",49,0,32,12,0,44,0
"780141124","SANTA CRUZ",206,199,3,1,0,4,0.966019417475728
"780140109","SANTA CRUZ",695,443,186,59,3,248,0.637410071942446
"780140106","SANTA CRUZ",626,221,220,164,7,391,0.353035143769968
"780490103","SANTA CRUZ",88,34,36,16,1,53,0.386363636363636
"780141109","SANTA CRUZ",288,259,21,5,0,26,0.899305555555556
"780350601","SANTA CRUZ",208,178,13,12,0,25,0.855769230769231
"780280701","SANTA CRUZ",198,193,4,1,0,5,0.974747474747475
"780210705","SANTA CRUZ",8,7,0,1,0,1,0.875
"780350101","SANTA CRUZ",15,0,0,8,4,12,0
"780210201","SANTA CRUZ",29,0,11,9,2,22,0
"780141201","SANTA CRUZ",303,243,35,16,0,51,0.801980198019802
"780140904","SANTA CRUZ",247,212,14,11,0,25,0.8582995951417
"780140216","SANTA CRUZ",454,438,8,7,0,15,0.964757709251101
"780280402","SANTA CRUZ",86,61,18,5,0,23,0.709302325581395
"780141208","SANTA CRUZ",351,290,40,7,0,47,0.826210826210826
"780210501","SANTA CRUZ",35,0,24,7,2,33,0
"780350402","SANTA CRUZ",250,65,95,65,6,166,0.26
"780070101","SANTA CRUZ",19,0,2,12,3,17,0
"780141107","SANTA CRUZ",219,214,4,0,0,4,0.977168949771689
"900141105","TUCUMAN",357,3,313,33,4,350,0.00840336134453781
"780490201","SANTA CRUZ",30,1,8,16,2,26,0.0333333333333333
"780490501","SANTA CRUZ",529,517,7,1,1,9,0.977315689981096
"780420306","SANTA CRUZ",538,457,53,21,2,76,0.849442379182156
"780140802","SANTA CRUZ",477,35,333,90,0,423,0.0733752620545073
"780140801","SANTA CRUZ",214,8,116,82,1,199,0.0373831775700935
"780140304","SANTA CRUZ",357,328,7,20,0,27,0.918767507002801
"780280507","SANTA CRUZ",4,0,2,2,0,4,0
"780141125","SANTA CRUZ",219,209,6,3,0,9,0.954337899543379
"780140204","SANTA CRUZ",419,411,8,0,0,8,0.98090692124105
"780211415","SANTA CRUZ",278,272,5,0,0,5,0.97841726618705
"780211404","SANTA CRUZ",236,226,1,1,0,2,0.957627118644068
"780211115","SANTA CRUZ",321,320,1,0,0,1,0.996884735202492
"780211109","SANTA CRUZ",298,293,2,3,0,5,0.983221476510067
"780211108","SANTA CRUZ",186,183,2,0,0,2,0.983870967741935
"780211403","SANTA CRUZ",269,266,3,0,0,3,0.988847583643123
"780420101","SANTA CRUZ",33,1,8,14,3,25,0.0303030303030303
"780211002","SANTA CRUZ",429,420,6,0,0,6,0.979020979020979
"780210901","SANTA CRUZ",513,493,13,4,0,17,0.961013645224172
"780210804","SANTA CRUZ",265,264,1,0,0,1,0.99622641509434
"780210703","SANTA CRUZ",7,0,2,5,0,7,0
"780211314","SANTA CRUZ",252,245,3,1,0,4,0.972222222222222
"780211312","SANTA CRUZ",583,556,5,5,0,10,0.95368782161235
"780211309","SANTA CRUZ",333,327,3,1,0,4,0.981981981981982
"780211303","SANTA CRUZ",176,170,3,0,0,3,0.965909090909091
"780140104","SANTA CRUZ",514,215,174,104,1,279,0.418287937743191
"780490102","SANTA CRUZ",13,12,0,0,0,0,0.923076923076923
"780211203","SANTA CRUZ",242,236,0,0,0,0,0.975206611570248
"780280502","SANTA CRUZ",14,0,0,7,4,11,0
"780280102","SANTA CRUZ",25,0,12,10,3,25,0
"780140401","SANTA CRUZ",28,0,4,19,2,25,0
"780141120","SANTA CRUZ",501,495,3,1,0,4,0.988023952095808
"780141104","SANTA CRUZ",291,264,5,22,0,27,0.907216494845361
"780140912","SANTA CRUZ",382,275,47,57,1,105,0.719895287958115
"780140908","SANTA CRUZ",485,402,30,39,0,69,0.828865979381443
"780140504","SANTA CRUZ",201,98,63,39,0,102,0.487562189054726
"780280103","SANTA CRUZ",481,381,37,40,1,78,0.792099792099792
"780140305","SANTA CRUZ",529,462,43,18,0,61,0.873345935727788
"780140221","SANTA CRUZ",455,431,15,7,0,22,0.947252747252747
"780140212","SANTA CRUZ",546,513,18,13,1,32,0.93956043956044
"780140206","SANTA CRUZ",408,393,9,3,0,12,0.963235294117647
"780211414","SANTA CRUZ",404,402,2,0,0,2,0.995049504950495
"780211319","SANTA CRUZ",159,158,0,0,0,0,0.993710691823899
"780211318","SANTA CRUZ",188,9,94,83,1,178,0.0478723404255319
"780211210","SANTA CRUZ",229,228,1,0,0,1,0.995633187772926
"780211209","SANTA CRUZ",325,317,4,3,0,7,0.975384615384615
"780211206","SANTA CRUZ",161,159,2,0,0,2,0.987577639751553
"900140905","TUCUMAN",143,0,24,94,2,120,0
"780211103","SANTA CRUZ",371,368,3,0,0,3,0.991913746630728
"780211016","SANTA CRUZ",233,225,3,0,0,3,0.965665236051502
"780211015","SANTA CRUZ",192,191,0,0,0,0,0.994791666666667
"780211012","SANTA CRUZ",331,326,3,2,0,5,0.984894259818731
"780211010","SANTA CRUZ",355,347,3,3,0,6,0.977464788732394
"780211008","SANTA CRUZ",328,321,5,2,0,7,0.978658536585366
"780211006","SANTA CRUZ",228,226,1,0,0,1,0.991228070175439
"780210807","SANTA CRUZ",483,479,0,0,0,0,0.991718426501035
"780210801","SANTA CRUZ",350,345,2,1,0,3,0.985714285714286
"780211307","SANTA CRUZ",486,468,8,4,0,12,0.962962962962963
"780210404","SANTA CRUZ",1,0,1,0,0,1,0
"780140207","SANTA CRUZ",326,312,6,6,0,12,0.957055214723926
"780070604","SANTA CRUZ",304,292,5,2,0,7,0.960526315789474
"780350403","SANTA CRUZ",425,382,20,14,4,38,0.898823529411765
"780280702","SANTA CRUZ",296,256,22,7,0,29,0.864864864864865
"780210102","SANTA CRUZ",22,0,13,3,3,19,0
"780140502","SANTA CRUZ",26,0,3,11,0,14,0
"900070408","TUCUMAN",349,2,175,144,4,323,0.00573065902578797
"860491312","SANTIAGO DEL ESTERO",212,209,2,1,0,3,0.985849056603774
"780280101","SANTA CRUZ",17,0,1,8,2,11,0
"780490401","SANTA CRUZ",8,0,2,3,0,5,0
"780210701","SANTA CRUZ",80,5,8,55,4,67,0.0625
"900840111","TUCUMAN",254,252,2,0,0,2,0.992125984251969
"861470915","SANTIAGO DEL ESTERO",199,182,7,4,2,13,0.914572864321608
"780280601","SANTA CRUZ",19,0,2,17,0,19,0
"780420305","SANTA CRUZ",422,336,60,13,0,73,0.796208530805687
"780350604","SANTA CRUZ",275,239,15,13,0,28,0.869090909090909
"780210704","SANTA CRUZ",143,137,5,0,0,5,0.958041958041958
"780141111","SANTA CRUZ",408,385,14,5,0,19,0.943627450980392
"860140801","SANTIAGO DEL ESTERO",65,0,1,11,40,52,0
"780141103","SANTA CRUZ",149,117,11,2,15,28,0.785234899328859
"780141204","SANTA CRUZ",276,226,23,15,1,39,0.818840579710145
"780141117","SANTA CRUZ",262,217,9,4,0,13,0.82824427480916
"780141114","SANTA CRUZ",360,337,9,2,0,11,0.936111111111111
"780141113","SANTA CRUZ",345,340,2,3,0,5,0.985507246376812
"780141112","SANTA CRUZ",385,358,18,2,0,20,0.92987012987013
"780140213","SANTA CRUZ",453,445,1,3,0,4,0.98233995584989
"861470706","SANTIAGO DEL ESTERO",164,0,21,105,20,146,0
"780141001","SANTA CRUZ",251,233,11,5,0,16,0.928286852589641
"780140914","SANTA CRUZ",324,280,20,18,0,38,0.864197530864197
"780140507","SANTA CRUZ",382,362,14,4,0,18,0.947643979057592
"780140403","SANTA CRUZ",107,8,64,34,0,98,0.0747663551401869
"780280514","SANTA CRUZ",424,131,135,156,0,291,0.308962264150943
"780280513","SANTA CRUZ",612,338,189,81,0,270,0.552287581699346
"780280511","SANTA CRUZ",15,1,12,2,0,14,0.0666666666666667
"900070509","TUCUMAN",113,3,73,25,1,99,0.0265486725663717
"780140220","SANTA CRUZ",359,320,23,13,0,36,0.891364902506964
"300840315","ENTRE RIOS",143,139,1,2,0,3,0.972027972027972
"780140210","SANTA CRUZ",376,359,13,3,0,16,0.954787234042553
"780140205","SANTA CRUZ",426,383,8,6,0,14,0.89906103286385
"780211405","SANTA CRUZ",225,224,0,0,0,0,0.995555555555556
"780211401","SANTA CRUZ",391,377,4,6,0,10,0.964194373401535
"780211214","SANTA CRUZ",257,252,1,1,0,2,0.980544747081712
"780211213","SANTA CRUZ",201,198,1,1,0,2,0.985074626865672
"780211110","SANTA CRUZ",179,176,1,0,0,1,0.983240223463687
"780211011","SANTA CRUZ",342,327,2,4,0,6,0.956140350877193
"780211001","SANTA CRUZ",244,241,0,0,0,0,0.987704918032787
"780211306","SANTA CRUZ",531,496,12,14,0,26,0.934086629001883
"780211322","SANTA CRUZ",360,357,0,3,0,3,0.991666666666667
"780211301","SANTA CRUZ",328,309,3,14,0,17,0.942073170731707
"780211217","SANTA CRUZ",222,217,4,0,0,4,0.977477477477477
"780210403","SANTA CRUZ",47,0,22,21,1,44,0
"780420203","SANTA CRUZ",145,131,0,14,0,14,0.903448275862069
"780350301","SANTA CRUZ",22,0,3,15,1,19,0
"780420201","SANTA CRUZ",15,0,7,6,2,15,0
"900842103","TUCUMAN",165,165,0,0,0,0,1
"780420307","SANTA CRUZ",335,286,30,17,0,47,0.853731343283582
"780211321","SANTA CRUZ",338,251,23,50,4,77,0.742603550295858
"780211105","SANTA CRUZ",401,388,9,1,0,10,0.967581047381546
"780140105","SANTA CRUZ",329,135,110,80,1,191,0.410334346504559
"780490502","SANTA CRUZ",458,443,5,3,3,11,0.967248908296943
"900841904","TUCUMAN",184,184,0,0,0,0,1
"780280706","SANTA CRUZ",280,262,15,3,0,18,0.935714285714286
"780280705","SANTA CRUZ",272,263,7,1,0,8,0.966911764705882
"780070302","SANTA CRUZ",14,0,3,4,1,8,0
"780140506","SANTA CRUZ",296,179,75,41,1,117,0.60472972972973
"780280509","SANTA CRUZ",40,2,25,12,1,38,0.05
"780350605","SANTA CRUZ",104,57,23,17,0,40,0.548076923076923
"780280504","SANTA CRUZ",763,369,237,137,1,375,0.483617300131062
"780211211","SANTA CRUZ",236,232,2,0,0,2,0.983050847457627
"780140303","SANTA CRUZ",74,0,32,24,2,58,0
"540140208","MISIONES",311,9,232,56,12,300,0.0289389067524116
"780140222","SANTA CRUZ",411,373,2,3,0,5,0.907542579075426
"780140209","SANTA CRUZ",216,8,63,110,4,177,0.037037037037037
"780211123","SANTA CRUZ",302,294,4,0,0,4,0.973509933774834
"780140202","SANTA CRUZ",337,325,7,4,0,11,0.964391691394659
"780141207","SANTA CRUZ",300,158,95,42,0,137,0.526666666666667
"780141205","SANTA CRUZ",240,194,29,13,0,42,0.808333333333333
"780141123","SANTA CRUZ",234,229,3,2,0,5,0.978632478632479
"780141119","SANTA CRUZ",226,203,13,4,0,17,0.898230088495575
"780141118","SANTA CRUZ",139,135,2,2,0,4,0.971223021582734
"780140907","SANTA CRUZ",262,232,23,5,2,30,0.885496183206107
"780140906","SANTA CRUZ",495,425,32,29,0,61,0.858585858585859
"780140902","SANTA CRUZ",490,358,68,57,1,126,0.730612244897959
"380211509","JUJUY",193,166,7,14,1,22,0.860103626943005
"780211313","SANTA CRUZ",189,16,85,78,1,164,0.0846560846560847
"780211304","SANTA CRUZ",443,442,1,0,0,1,0.997742663656885
"780211221","SANTA CRUZ",557,551,6,0,0,6,0.989228007181329
"900841611","TUCUMAN",352,344,6,0,0,6,0.977272727272727
"780210702","SANTA CRUZ",90,60,8,19,1,28,0.666666666666667
"780210406","SANTA CRUZ",44,1,10,28,1,39,0.0227272727272727
"780070602","SANTA CRUZ",528,518,6,2,0,8,0.981060606060606
"780141108","SANTA CRUZ",457,429,18,9,0,27,0.938730853391685
"780420302","SANTA CRUZ",402,321,47,25,0,72,0.798507462686567
"780070505","SANTA CRUZ",517,397,65,38,0,103,0.7678916827853
"780280401","SANTA CRUZ",24,0,12,8,1,21,0
"780280201","SANTA CRUZ",9,0,0,8,0,8,0
"780140910","SANTA CRUZ",383,299,42,36,0,78,0.780678851174935
"780140803","SANTA CRUZ",414,44,253,115,0,368,0.106280193236715
"540282212","MISIONES",229,41,167,10,6,183,0.179039301310044
"780210101","SANTA CRUZ",77,4,37,26,2,65,0.051948051948052
"780140701","SANTA CRUZ",16,0,3,11,1,15,0
"780350501","SANTA CRUZ",13,0,4,8,0,12,0
"540281911","MISIONES",354,300,41,13,0,54,0.847457627118644
"780070504","SANTA CRUZ",171,161,9,1,0,10,0.941520467836257
"780070502","SANTA CRUZ",488,396,69,23,0,92,0.811475409836066
"780140911","SANTA CRUZ",341,302,27,10,0,37,0.885630498533724
"900841908","TUCUMAN",193,173,1,1,0,2,0.896373056994819
"780280510","SANTA CRUZ",316,50,202,63,0,265,0.158227848101266
"780280508","SANTA CRUZ",16,0,14,1,1,16,0
"780070603","SANTA CRUZ",312,284,15,8,2,25,0.91025641025641
"141400707","CORDOBA",198,166,27,5,0,32,0.838383838383838
"780280503","SANTA CRUZ",473,210,192,69,0,261,0.443974630021142
"780141206","SANTA CRUZ",394,330,46,15,0,61,0.83756345177665
"780211402","SANTA CRUZ",340,327,4,7,0,11,0.961764705882353
"780211208","SANTA CRUZ",366,360,5,1,0,6,0.983606557377049
"780211120","SANTA CRUZ",285,280,1,0,0,1,0.982456140350877
"780211119","SANTA CRUZ",118,116,1,1,0,2,0.983050847457627
"780211113","SANTA CRUZ",261,261,0,0,0,0,1
"780211111","SANTA CRUZ",244,240,2,0,0,2,0.983606557377049
"780211004","SANTA CRUZ",238,236,1,1,0,2,0.991596638655462
"780210903","SANTA CRUZ",507,501,5,0,0,5,0.988165680473373
"780070601","SANTA CRUZ",249,230,12,7,0,19,0.923694779116466
"780280703","SANTA CRUZ",363,358,3,1,0,4,0.986225895316804
"140145809","CORDOBA",263,261,1,1,0,2,0.992395437262357
"780210806","SANTA CRUZ",397,391,4,0,1,5,0.984886649874055
"861610404","SANTIAGO DEL ESTERO",204,0,45,106,14,165,0
"780211317","SANTA CRUZ",497,474,12,6,0,18,0.953722334004024
"780211407","SANTA CRUZ",421,404,5,4,0,9,0.959619952494062
"780211311","SANTA CRUZ",270,269,1,0,0,1,0.996296296296296
"780211305","SANTA CRUZ",463,444,7,8,0,15,0.958963282937365
"780211302","SANTA CRUZ",213,151,32,22,0,54,0.708920187793427
"780211216","SANTA CRUZ",253,240,3,3,0,6,0.948616600790514
"780140108","SANTA CRUZ",492,205,184,90,5,279,0.416666666666667
"900841913","TUCUMAN",209,203,6,0,0,6,0.971291866028708
"780141102","SANTA CRUZ",324,320,1,1,0,2,0.987654320987654
"900841911","TUCUMAN",364,363,1,0,0,1,0.997252747252747
"780140301","SANTA CRUZ",25,0,7,12,0,19,0
"780140102","SANTA CRUZ",30,1,4,14,5,23,0.0333333333333333
"780210601","SANTA CRUZ",52,0,21,26,1,48,0
"780350401","SANTA CRUZ",31,0,22,9,0,31,0
"780350102","SANTA CRUZ",14,0,0,12,0,12,0
"780211202","SANTA CRUZ",206,172,1,0,0,1,0.83495145631068
"780070301","SANTA CRUZ",12,0,1,7,4,12,0
"780141115","SANTA CRUZ",441,423,12,6,0,18,0.959183673469388
"780141101","SANTA CRUZ",500,493,1,2,0,3,0.986
"780140905","SANTA CRUZ",375,289,44,16,0,60,0.770666666666667
"780140901","SANTA CRUZ",575,478,44,47,0,91,0.831304347826087
"780140503","SANTA CRUZ",24,4,7,10,3,20,0.166666666666667
"780140402","SANTA CRUZ",102,1,67,33,0,100,0.00980392156862745
"780280505","SANTA CRUZ",103,3,40,59,0,99,0.029126213592233
"780140219","SANTA CRUZ",466,422,10,12,0,22,0.905579399141631
"861190302","SANTIAGO DEL ESTERO",75,0,4,22,45,71,0
"861610303","SANTIAGO DEL ESTERO",45,0,3,14,14,31,0
"541050113","MISIONES",205,5,92,83,22,197,0.024390243902439
"860350301","SANTIAGO DEL ESTERO",40,0,0,10,13,23,0
"780140215","SANTA CRUZ",8,1,5,2,0,7,0.125
"780140214","SANTA CRUZ",295,268,12,6,0,18,0.908474576271186
"780211409","SANTA CRUZ",294,285,7,1,0,8,0.969387755102041
"780211215","SANTA CRUZ",226,225,1,0,0,1,0.995575221238938
"780211212","SANTA CRUZ",401,398,3,0,0,3,0.992518703241895
"780211107","SANTA CRUZ",232,231,1,0,0,1,0.995689655172414
"780211013","SANTA CRUZ",222,216,5,0,0,5,0.972972972972973
"780211009","SANTA CRUZ",163,152,2,1,0,3,0.932515337423313
"780211003","SANTA CRUZ",235,221,11,1,0,12,0.940425531914894
"940071304","TIERRA DEL FUEGO",318,313,2,2,0,4,0.984276729559748
"900841906","TUCUMAN",174,172,1,0,0,1,0.988505747126437
"780210802","SANTA CRUZ",631,624,3,1,0,4,0.988906497622821
"780211308","SANTA CRUZ",448,434,5,5,0,10,0.96875
"780140107","SANTA CRUZ",396,152,172,69,1,242,0.383838383838384
"780070503","SANTA CRUZ",455,338,77,22,0,99,0.742857142857143
"780280704","SANTA CRUZ",498,274,114,86,3,203,0.550200803212851
"780140501","SANTA CRUZ",29,0,4,8,4,16,0
"940140413","TIERRA DEL FUEGO",326,268,14,31,3,48,0.822085889570552
"860140203","SANTIAGO DEL ESTERO",43,0,1,6,21,28,0
"780280301","SANTA CRUZ",12,0,2,5,1,8,0
"780070401","SANTA CRUZ",61,0,37,17,4,58,0
"940140506","TIERRA DEL FUEGO",168,167,1,0,0,1,0.994047619047619
"940140606","TIERRA DEL FUEGO",284,269,6,7,0,13,0.947183098591549
"940140801","TIERRA DEL FUEGO",68,49,16,3,0,19,0.720588235294118
"940071007","TIERRA DEL FUEGO",337,335,0,0,0,0,0.99406528189911
"940071011","TIERRA DEL FUEGO",326,289,0,0,0,0,0.886503067484663
"860351302","SANTIAGO DEL ESTERO",339,4,155,140,18,313,0.0117994100294985
"780210401","SANTA CRUZ",117,7,65,28,1,94,0.0598290598290598
"860491616","SANTIAGO DEL ESTERO",238,1,34,169,4,207,0.00420168067226891
"780070201","SANTA CRUZ",31,0,10,12,0,22,0
"780350201","SANTA CRUZ",21,0,6,6,1,13,0
"940071312","TIERRA DEL FUEGO",293,289,2,0,0,2,0.986348122866894
"860280305","SANTIAGO DEL ESTERO",211,0,107,73,8,188,0
"940071101","TIERRA DEL FUEGO",308,305,3,0,0,3,0.99025974025974
"940071103","TIERRA DEL FUEGO",348,341,7,0,0,7,0.979885057471264
"940071203","TIERRA DEL FUEGO",197,193,1,0,0,1,0.979695431472081
"940071401","TIERRA DEL FUEGO",311,266,11,25,5,41,0.855305466237942
"940071412","TIERRA DEL FUEGO",358,14,61,243,10,314,0.0391061452513966
"940140409","TIERRA DEL FUEGO",319,277,41,1,0,42,0.86833855799373
"940140407","TIERRA DEL FUEGO",294,214,36,15,19,70,0.727891156462585
"940140504","TIERRA DEL FUEGO",103,103,0,0,0,0,1
"940140510","TIERRA DEL FUEGO",240,233,7,0,0,7,0.970833333333333
"940140605","TIERRA DEL FUEGO",373,357,12,2,1,15,0.957104557640751
"940140610","TIERRA DEL FUEGO",349,308,28,8,0,36,0.882521489971347
"940140808","TIERRA DEL FUEGO",368,293,43,27,5,75,0.796195652173913
"940071302","TIERRA DEL FUEGO",343,340,0,0,1,1,0.991253644314869
"900841610","TUCUMAN",217,215,2,0,0,2,0.990783410138249
"940140809","TIERRA DEL FUEGO",248,236,8,0,1,9,0.951612903225806
"940140813","TIERRA DEL FUEGO",319,314,4,0,0,4,0.984326018808777
"940140103","TIERRA DEL FUEGO",41,0,11,21,1,33,0
"940070801","TIERRA DEL FUEGO",14,1,13,0,0,13,0.0714285714285714
"940071402","TIERRA DEL FUEGO",376,331,14,26,3,43,0.88031914893617
"940071008","TIERRA DEL FUEGO",279,279,0,0,0,0,1
"940071210","TIERRA DEL FUEGO",321,315,4,0,0,4,0.981308411214953
"940071306","TIERRA DEL FUEGO",106,104,2,0,0,2,0.981132075471698
"940071410","TIERRA DEL FUEGO",288,285,1,0,0,1,0.989583333333333
"940071314","TIERRA DEL FUEGO",198,195,2,1,0,3,0.984848484848485
"940071408","TIERRA DEL FUEGO",312,304,4,1,1,6,0.974358974358974
"940140706","TIERRA DEL FUEGO",142,126,9,7,0,16,0.887323943661972
"900841804","TUCUMAN",144,143,1,0,0,1,0.993055555555556
"940140401","TIERRA DEL FUEGO",148,128,15,2,0,17,0.864864864864865
"940140410","TIERRA DEL FUEGO",228,223,5,0,0,5,0.978070175438597
"940140707","TIERRA DEL FUEGO",319,313,6,0,0,6,0.981191222570533
"940140609","TIERRA DEL FUEGO",333,313,18,2,0,20,0.93993993993994
"940140711","TIERRA DEL FUEGO",370,352,13,2,1,16,0.951351351351351
"940070601","TIERRA DEL FUEGO",31,0,16,14,0,30,0
"940140812","TIERRA DEL FUEGO",294,286,7,0,0,7,0.972789115646258
"940140102","TIERRA DEL FUEGO",53,6,35,6,5,46,0.113207547169811
"940071403","TIERRA DEL FUEGO",352,291,22,34,1,57,0.826704545454545
"860491703","SANTIAGO DEL ESTERO",259,0,171,84,1,256,0
"940070503","TIERRA DEL FUEGO",294,112,61,98,4,163,0.380952380952381
"940140202","TIERRA DEL FUEGO",5,1,1,3,0,4,0.2
"900842309","TUCUMAN",317,303,7,3,0,10,0.95583596214511
"940140502","TIERRA DEL FUEGO",287,282,5,0,0,5,0.982578397212544
"940140507","TIERRA DEL FUEGO",182,180,0,0,0,0,0.989010989010989
"860491709","SANTIAGO DEL ESTERO",354,9,183,141,8,332,0.0254237288135593
"940140703","TIERRA DEL FUEGO",320,300,11,8,0,19,0.9375
"940140709","TIERRA DEL FUEGO",130,97,1,0,0,1,0.746153846153846
"940140806","TIERRA DEL FUEGO",366,357,7,1,0,8,0.975409836065574
"940071202","TIERRA DEL FUEGO",274,268,6,0,0,6,0.978102189781022
"940071206","TIERRA DEL FUEGO",342,341,0,0,0,0,0.997076023391813
"940071211","TIERRA DEL FUEGO",232,231,0,0,0,0,0.995689655172414
"140840314","CORDOBA",225,8,164,52,1,217,0.0355555555555556
"940140811","TIERRA DEL FUEGO",309,252,5,30,8,43,0.815533980582524
"940140414","TIERRA DEL FUEGO",362,338,15,6,0,21,0.933701657458563
"940140406","TIERRA DEL FUEGO",222,209,12,1,0,13,0.941441441441441
"860140401","SANTIAGO DEL ESTERO",20,0,8,1,4,13,0
"940140511","TIERRA DEL FUEGO",214,213,0,1,0,1,0.995327102803738
"940140608","TIERRA DEL FUEGO",293,289,4,0,0,4,0.986348122866894
"940140713","TIERRA DEL FUEGO",307,264,7,32,1,40,0.859934853420195
"940140705","TIERRA DEL FUEGO",306,299,6,1,0,7,0.977124183006536
"940070502","TIERRA DEL FUEGO",150,143,3,4,0,7,0.953333333333333
"940071104","TIERRA DEL FUEGO",453,453,0,0,0,0,1
"940071311","TIERRA DEL FUEGO",311,310,0,0,0,0,0.996784565916399
"940071307","TIERRA DEL FUEGO",352,352,0,0,0,0,1
"940071308","TIERRA DEL FUEGO",245,245,0,0,0,0,1
"940071413","TIERRA DEL FUEGO",258,8,22,190,15,227,0.0310077519379845
"940140503","TIERRA DEL FUEGO",300,276,24,0,0,24,0.92
"940140509","TIERRA DEL FUEGO",398,386,11,0,0,11,0.969849246231156
"940140704","TIERRA DEL FUEGO",295,286,7,0,0,7,0.969491525423729
"940140101","TIERRA DEL FUEGO",5,0,4,0,1,5,0
"860491904","SANTIAGO DEL ESTERO",362,359,0,0,0,0,0.99171270718232
"940140702","TIERRA DEL FUEGO",272,261,8,0,0,8,0.959558823529412
"940071406","TIERRA DEL FUEGO",271,261,4,5,0,9,0.96309963099631
"940071414","TIERRA DEL FUEGO",285,14,18,227,9,254,0.0491228070175439
"940071416","TIERRA DEL FUEGO",96,19,5,61,3,69,0.197916666666667
"940140710","TIERRA DEL FUEGO",107,94,13,0,0,13,0.878504672897196
"940071205","TIERRA DEL FUEGO",336,333,1,0,0,1,0.991071428571429
"940071005","TIERRA DEL FUEGO",303,303,0,0,0,0,1
"940071313","TIERRA DEL FUEGO",320,318,1,0,0,1,0.99375
"900842407","TUCUMAN",166,156,4,5,0,9,0.939759036144578
"660281702","SALTA",232,226,4,0,0,4,0.974137931034483
"940140505","TIERRA DEL FUEGO",270,248,20,1,0,21,0.918518518518519
"940071310","TIERRA DEL FUEGO",195,177,11,4,0,15,0.907692307692308
"140145609","CORDOBA",138,138,0,0,0,0,1
"940071106","TIERRA DEL FUEGO",303,293,8,0,0,8,0.966996699669967
"940071111","TIERRA DEL FUEGO",313,311,2,0,0,2,0.993610223642173
"940071113","TIERRA DEL FUEGO",358,353,1,0,0,1,0.986033519553073
"940071201","TIERRA DEL FUEGO",249,249,0,0,0,0,1
"940071212","TIERRA DEL FUEGO",327,326,0,0,0,0,0.996941896024465
"940071303","TIERRA DEL FUEGO",338,338,0,0,0,0,1
"940071305","TIERRA DEL FUEGO",348,261,12,34,6,52,0.75
"540282404","MISIONES",405,391,1,1,0,2,0.965432098765432
"940140405","TIERRA DEL FUEGO",151,106,11,17,12,40,0.701986754966887
"861820203","SANTIAGO DEL ESTERO",76,0,2,25,17,44,0
"940071404","TIERRA DEL FUEGO",293,225,22,41,0,63,0.767918088737201
"940140411","TIERRA DEL FUEGO",255,247,3,1,0,4,0.968627450980392
"221330403","CHACO",43,0,3,16,4,23,0
"940140602","TIERRA DEL FUEGO",371,366,5,0,0,5,0.986522911051213
"940071409","TIERRA DEL FUEGO",338,328,2,1,2,5,0.970414201183432
"540280706","MISIONES",186,186,0,0,0,0,1
"940140708","TIERRA DEL FUEGO",248,243,3,1,0,4,0.979838709677419
"940140607","TIERRA DEL FUEGO",300,287,11,0,0,11,0.956666666666667
"860210208","SANTIAGO DEL ESTERO",269,0,161,102,2,265,0
"860490309","SANTIAGO DEL ESTERO",271,9,70,144,17,231,0.033210332103321
"940140404","TIERRA DEL FUEGO",102,9,24,44,14,82,0.0882352941176471
"900840305","TUCUMAN",272,237,18,16,0,34,0.871323529411765
"860351303","SANTIAGO DEL ESTERO",442,12,217,190,7,414,0.0271493212669683
"940070505","TIERRA DEL FUEGO",188,50,37,87,5,129,0.265957446808511
"940140408","TIERRA DEL FUEGO",136,121,11,4,0,15,0.889705882352941
"940070201","TIERRA DEL FUEGO",12,0,1,11,0,12,0
"940070901","TIERRA DEL FUEGO",0,0,0,0,0,0,NA
"940140416","TIERRA DEL FUEGO",318,317,1,0,0,1,0.99685534591195
"860351109","SANTIAGO DEL ESTERO",484,420,5,44,3,52,0.867768595041322
"860351403","SANTIAGO DEL ESTERO",441,152,96,131,35,262,0.344671201814059
"140145608","CORDOBA",122,122,0,0,0,0,1
"940070101","TIERRA DEL FUEGO",8,0,6,2,0,8,0
"940071411","TIERRA DEL FUEGO",291,269,7,11,0,18,0.924398625429553
"940071407","TIERRA DEL FUEGO",346,333,3,7,0,10,0.96242774566474
"540560402","MISIONES",3,0,1,0,0,1,0
"940071001","TIERRA DEL FUEGO",407,397,1,9,0,10,0.975429975429975
"940071112","TIERRA DEL FUEGO",329,326,3,0,0,3,0.990881458966565
"940071204","TIERRA DEL FUEGO",339,336,3,0,0,3,0.991150442477876
"940071209","TIERRA DEL FUEGO",336,336,0,0,0,0,1
"540140205","MISIONES",235,0,136,83,14,233,0
"940140412","TIERRA DEL FUEGO",274,248,18,1,1,20,0.905109489051095
"940140402","TIERRA DEL FUEGO",244,27,86,109,9,204,0.110655737704918
"940140415","TIERRA DEL FUEGO",296,270,26,0,0,26,0.912162162162162
"940140603","TIERRA DEL FUEGO",299,281,14,0,0,14,0.939799331103679
"900350214","TUCUMAN",187,0,94,79,3,176,0
"940140601","TIERRA DEL FUEGO",210,187,0,5,13,18,0.89047619047619
"940071309","TIERRA DEL FUEGO",267,267,0,0,0,0,1
"861540101","SANTIAGO DEL ESTERO",31,0,16,13,2,31,0
"940140805","TIERRA DEL FUEGO",273,264,4,0,0,4,0.967032967032967
"940071109","TIERRA DEL FUEGO",280,274,2,0,0,2,0.978571428571429
"940071002","TIERRA DEL FUEGO",119,94,10,3,0,13,0.789915966386555
"940070401","TIERRA DEL FUEGO",17,1,16,0,0,16,0.0588235294117647
"940070501","TIERRA DEL FUEGO",8,0,2,2,0,4,0
"940071006","TIERRA DEL FUEGO",336,332,2,0,0,2,0.988095238095238
"940071102","TIERRA DEL FUEGO",308,304,1,0,0,1,0.987012987012987
"940071105","TIERRA DEL FUEGO",298,296,2,0,0,2,0.993288590604027
"940071108","TIERRA DEL FUEGO",170,170,0,0,0,0,1
"940071208","TIERRA DEL FUEGO",307,304,1,0,0,1,0.990228013029316
"940071213","TIERRA DEL FUEGO",312,309,1,0,0,1,0.990384615384615
"940070701","TIERRA DEL FUEGO",28,0,18,9,0,27,0
"940071405","TIERRA DEL FUEGO",345,314,3,24,1,28,0.910144927536232
"940140611","TIERRA DEL FUEGO",347,133,9,47,147,203,0.38328530259366
"940140612","TIERRA DEL FUEGO",312,90,15,146,45,206,0.288461538461538
"940071415","TIERRA DEL FUEGO",227,221,3,1,0,4,0.973568281938326
"940071110","TIERRA DEL FUEGO",231,228,0,0,0,0,0.987012987012987
"940071107","TIERRA DEL FUEGO",210,206,3,1,0,4,0.980952380952381
"940070504","TIERRA DEL FUEGO",228,211,4,10,0,14,0.925438596491228
"940140701","TIERRA DEL FUEGO",172,161,9,1,1,11,0.936046511627907
"940140712","TIERRA DEL FUEGO",343,328,13,1,0,14,0.956268221574344
"940071003","TIERRA DEL FUEGO",355,352,1,0,0,1,0.991549295774648
"900840819","TUCUMAN",333,212,53,61,0,114,0.636636636636637
"940140803","TIERRA DEL FUEGO",89,89,0,0,0,0,1
"940140807","TIERRA DEL FUEGO",268,244,23,0,0,23,0.91044776119403
"940071010","TIERRA DEL FUEGO",287,286,1,0,0,1,0.996515679442509
"940071009","TIERRA DEL FUEGO",292,292,0,0,0,0,1
"940071012","TIERRA DEL FUEGO",279,270,3,3,0,6,0.967741935483871
"940071013","TIERRA DEL FUEGO",290,277,9,0,0,9,0.955172413793103
"940071207","TIERRA DEL FUEGO",296,291,0,1,0,1,0.983108108108108
"940140508","TIERRA DEL FUEGO",277,266,5,0,0,5,0.96028880866426
"940140301","TIERRA DEL FUEGO",1,0,0,0,0,0,0
"940071301","TIERRA DEL FUEGO",314,309,5,0,0,5,0.984076433121019
"940140403","TIERRA DEL FUEGO",137,7,49,60,16,125,0.0510948905109489
"940140714","TIERRA DEL FUEGO",391,361,8,18,0,26,0.923273657289003
"940140810","TIERRA DEL FUEGO",439,428,8,1,0,9,0.9749430523918
"860351218","SANTIAGO DEL ESTERO",181,4,172,5,0,177,0.0220994475138122
"860351307","SANTIAGO DEL ESTERO",425,6,278,89,19,386,0.0141176470588235
"860351312","SANTIAGO DEL ESTERO",293,17,268,8,0,276,0.0580204778156997
"860070206","SANTIAGO DEL ESTERO",307,0,174,116,3,293,0
"940140501","TIERRA DEL FUEGO",220,175,21,16,6,43,0.795454545454545
"940140604","TIERRA DEL FUEGO",282,277,5,0,0,5,0.982269503546099
"860351313","SANTIAGO DEL ESTERO",299,5,169,123,0,292,0.0167224080267559
"940140802","TIERRA DEL FUEGO",212,208,2,2,0,4,0.981132075471698
"940140804","TIERRA DEL FUEGO",220,196,7,0,0,7,0.890909090909091
"940070301","TIERRA DEL FUEGO",16,8,2,6,0,8,0.5
"860351517","SANTIAGO DEL ESTERO",255,2,85,138,17,240,0.00784313725490196
"940140201","TIERRA DEL FUEGO",0,0,0,0,0,0,NA
"940140302","TIERRA DEL FUEGO",14,0,3,11,0,14,0
"940071004","TIERRA DEL FUEGO",334,333,0,0,0,0,0.997005988023952
"860351512","SANTIAGO DEL ESTERO",216,11,89,86,10,185,0.0509259259259259
"860280206","SANTIAGO DEL ESTERO",184,0,50,111,17,178,0
"860351208","SANTIAGO DEL ESTERO",276,2,250,4,0,254,0.0072463768115942
"861470504","SANTIAGO DEL ESTERO",126,0,55,54,6,115,0
"861750307","SANTIAGO DEL ESTERO",227,0,105,76,7,188,0
"860770603","SANTIAGO DEL ESTERO",217,0,169,39,7,215,0
"860070107","SANTIAGO DEL ESTERO",361,0,215,117,14,346,0
"860490512","SANTIAGO DEL ESTERO",287,17,194,76,0,270,0.0592334494773519
"860420205","SANTIAGO DEL ESTERO",233,0,86,127,12,225,0
"860490310","SANTIAGO DEL ESTERO",234,12,41,140,17,198,0.0512820512820513
"860490508","SANTIAGO DEL ESTERO",314,196,76,30,0,106,0.624203821656051
"860491717","SANTIAGO DEL ESTERO",299,3,168,112,3,283,0.0100334448160535
"860491902","SANTIAGO DEL ESTERO",427,424,0,0,0,0,0.992974238875878
"860490514","SANTIAGO DEL ESTERO",406,312,56,37,1,94,0.768472906403941
"860490909","SANTIAGO DEL ESTERO",279,277,1,1,0,2,0.992831541218638
"860490913","SANTIAGO DEL ESTERO",209,206,3,0,0,3,0.985645933014354
"661540209","SALTA",277,243,8,24,0,32,0.877256317689531
"860491115","SANTIAGO DEL ESTERO",322,172,105,29,2,136,0.53416149068323
"860491202","SANTIAGO DEL ESTERO",244,174,63,5,0,68,0.713114754098361
"860491206","SANTIAGO DEL ESTERO",294,292,1,0,1,2,0.993197278911565
"860491502","SANTIAGO DEL ESTERO",229,6,105,107,0,212,0.0262008733624454
"860491707","SANTIAGO DEL ESTERO",303,1,94,145,18,257,0.0033003300330033
"860491504","SANTIAGO DEL ESTERO",266,70,177,17,1,195,0.263157894736842
"860490819","SANTIAGO DEL ESTERO",233,2,173,52,2,227,0.00858369098712446
"860560502","SANTIAGO DEL ESTERO",260,0,113,90,34,237,0
"860630813","SANTIAGO DEL ESTERO",304,109,120,61,8,189,0.358552631578947
"860770605","SANTIAGO DEL ESTERO",215,0,150,58,3,211,0
"860770502","SANTIAGO DEL ESTERO",327,0,230,75,13,318,0
"860630608","SANTIAGO DEL ESTERO",237,235,0,0,0,0,0.991561181434599
"860770504","SANTIAGO DEL ESTERO",194,0,113,66,5,184,0
"860770506","SANTIAGO DEL ESTERO",233,0,91,118,6,215,0
"860910410","SANTIAGO DEL ESTERO",336,0,163,131,5,299,0
"860980110","SANTIAGO DEL ESTERO",326,0,177,101,32,310,0
"860980109","SANTIAGO DEL ESTERO",476,0,204,272,0,476,0
"861190415","SANTIAGO DEL ESTERO",229,0,88,65,64,217,0
"861330504","SANTIAGO DEL ESTERO",114,0,18,78,3,99,0
"861400209","SANTIAGO DEL ESTERO",277,0,146,109,10,265,0
"861470815","SANTIAGO DEL ESTERO",121,116,2,1,0,3,0.958677685950413
"861470912","SANTIAGO DEL ESTERO",209,166,11,22,5,38,0.794258373205742
"861190502","SANTIAGO DEL ESTERO",380,0,6,68,259,333,0
"861540107","SANTIAGO DEL ESTERO",352,0,245,65,13,323,0
"861610410","SANTIAGO DEL ESTERO",320,2,179,124,6,309,0.00625
"861610107","SANTIAGO DEL ESTERO",234,0,123,96,8,227,0
"861610409","SANTIAGO DEL ESTERO",303,4,179,96,11,286,0.0132013201320132
"861190201","SANTIAGO DEL ESTERO",108,0,13,25,61,99,0
"860560203","SANTIAGO DEL ESTERO",179,0,0,30,74,104,0
"860630201","SANTIAGO DEL ESTERO",123,1,17,43,45,105,0.00813008130081301
"861890202","SANTIAGO DEL ESTERO",161,0,12,49,62,123,0
"861890201","SANTIAGO DEL ESTERO",258,0,39,120,49,208,0
"860910106","SANTIAGO DEL ESTERO",192,0,16,114,21,151,0
"221330404","CHACO",60,0,5,44,7,56,0
"860070102","SANTIAGO DEL ESTERO",85,0,39,18,22,79,0
"860350601","SANTIAGO DEL ESTERO",304,0,19,127,108,254,0
"860350705","SANTIAGO DEL ESTERO",72,0,2,44,6,52,0
"860210103","SANTIAGO DEL ESTERO",147,0,15,93,6,114,0
"860630301","SANTIAGO DEL ESTERO",103,0,7,22,58,87,0
"860700401","SANTIAGO DEL ESTERO",656,0,81,205,214,500,0
"860491005","SANTIAGO DEL ESTERO",286,248,27,11,0,38,0.867132867132867
"861260201","SANTIAGO DEL ESTERO",183,0,22,93,21,136,0
"861470702","SANTIAGO DEL ESTERO",78,0,9,42,19,70,0
"861470705","SANTIAGO DEL ESTERO",111,28,3,66,2,71,0.252252252252252
"861540203","SANTIAGO DEL ESTERO",150,0,101,25,22,148,0
"861750301","SANTIAGO DEL ESTERO",190,0,15,117,29,161,0
"860491908","SANTIAGO DEL ESTERO",379,369,8,2,0,10,0.973614775725594
"860350802","SANTIAGO DEL ESTERO",73,0,3,26,18,47,0
"860490521","SANTIAGO DEL ESTERO",187,159,17,6,0,23,0.850267379679144
"860140202","SANTIAGO DEL ESTERO",161,0,5,51,74,130,0
"860140302","SANTIAGO DEL ESTERO",10,0,1,2,5,8,0
"861470101","SANTIAGO DEL ESTERO",143,0,16,96,15,127,0
"861680204","SANTIAGO DEL ESTERO",133,0,10,55,42,107,0
"860140101","SANTIAGO DEL ESTERO",252,0,5,35,104,144,0
"860140701","SANTIAGO DEL ESTERO",3,0,0,0,1,1,0
"860210205","SANTIAGO DEL ESTERO",77,0,0,25,41,66,0
"860280503","SANTIAGO DEL ESTERO",100,0,4,34,23,61,0
"860351103","SANTIAGO DEL ESTERO",59,0,14,23,3,40,0
"860350902","SANTIAGO DEL ESTERO",91,0,18,33,7,58,0
"860490103","SANTIAGO DEL ESTERO",66,0,0,21,38,59,0
"860490302","SANTIAGO DEL ESTERO",12,3,2,6,0,8,0.25
"860490601","SANTIAGO DEL ESTERO",95,0,0,23,29,52,0
"860630502","SANTIAGO DEL ESTERO",34,0,2,19,9,30,0
"140145607","CORDOBA",130,130,0,0,0,0,1
"861400104","SANTIAGO DEL ESTERO",69,0,0,31,31,62,0
"860700501","SANTIAGO DEL ESTERO",128,0,1,30,61,92,0
"860770404","SANTIAGO DEL ESTERO",46,0,5,22,19,46,0
"860840404","SANTIAGO DEL ESTERO",23,0,3,12,1,16,0
"861610408","SANTIAGO DEL ESTERO",48,0,5,14,4,23,0
"860840304","SANTIAGO DEL ESTERO",82,0,9,51,16,76,0
"860490402","SANTIAGO DEL ESTERO",135,0,1,30,84,115,0
"860980701","SANTIAGO DEL ESTERO",33,0,3,9,0,12,0
"861050301","SANTIAGO DEL ESTERO",335,0,18,152,102,272,0
"140145606","CORDOBA",149,149,0,0,0,0,1
"861260102","SANTIAGO DEL ESTERO",7,0,0,2,4,6,0
"861260304","SANTIAGO DEL ESTERO",32,0,2,13,11,26,0
"861260306","SANTIAGO DEL ESTERO",30,0,8,11,4,23,0
"861260401","SANTIAGO DEL ESTERO",87,0,20,31,9,60,0
"861330402","SANTIAGO DEL ESTERO",44,0,0,18,9,27,0
"861330406","SANTIAGO DEL ESTERO",157,0,19,85,37,141,0
"860700103","SANTIAGO DEL ESTERO",160,0,5,12,77,94,0
"860490510","SANTIAGO DEL ESTERO",117,114,1,1,0,2,0.974358974358974
"861400301","SANTIAGO DEL ESTERO",148,0,13,27,66,106,0
"861470501","SANTIAGO DEL ESTERO",184,0,5,149,5,159,0
"861330101","SANTIAGO DEL ESTERO",68,0,3,41,8,52,0
"540980504","MISIONES",236,3,180,40,8,228,0.0127118644067797
"861890101","SANTIAGO DEL ESTERO",309,0,58,144,61,263,0
"380140605","JUJUY",319,312,5,1,0,6,0.978056426332288
"861680102","SANTIAGO DEL ESTERO",109,0,2,33,48,83,0
"861680203","SANTIAGO DEL ESTERO",142,0,19,68,35,122,0
"861750302","SANTIAGO DEL ESTERO",54,0,2,30,12,44,0
"900560705","TUCUMAN",87,0,28,49,2,79,0
"861890102","SANTIAGO DEL ESTERO",117,0,11,65,10,86,0
"860491403","SANTIAGO DEL ESTERO",336,116,146,68,3,217,0.345238095238095
"860351314","SANTIAGO DEL ESTERO",305,8,201,79,3,283,0.0262295081967213
"860630611","SANTIAGO DEL ESTERO",270,110,74,62,7,143,0.407407407407407
"860491408","SANTIAGO DEL ESTERO",194,1,115,57,0,172,0.00515463917525773
"860980502","SANTIAGO DEL ESTERO",202,0,0,47,133,180,0
"861190403","SANTIAGO DEL ESTERO",43,0,3,5,10,18,0
"860491215","SANTIAGO DEL ESTERO",258,147,67,33,1,101,0.569767441860465
"860491711","SANTIAGO DEL ESTERO",304,4,146,129,5,280,0.0131578947368421
"860350808","SANTIAGO DEL ESTERO",269,0,202,60,1,263,0
"860351502","SANTIAGO DEL ESTERO",285,166,78,36,0,114,0.582456140350877
"860351505","SANTIAGO DEL ESTERO",257,98,71,75,4,150,0.381322957198444
"860351507","SANTIAGO DEL ESTERO",287,241,20,23,0,43,0.839721254355401
"860491211","SANTIAGO DEL ESTERO",179,177,2,0,0,2,0.988826815642458
"860491515","SANTIAGO DEL ESTERO",208,1,113,68,12,193,0.00480769230769231
"861470403","SANTIAGO DEL ESTERO",177,0,21,131,5,157,0
"860980108","SANTIAGO DEL ESTERO",373,0,140,179,24,343,0
"861050210","SANTIAGO DEL ESTERO",347,0,248,69,18,335,0
"861610109","SANTIAGO DEL ESTERO",334,1,269,50,5,324,0.0029940119760479
"861610411","SANTIAGO DEL ESTERO",201,16,119,39,1,159,0.0796019900497512
"861750204","SANTIAGO DEL ESTERO",266,0,104,115,29,248,0
"861890303","SANTIAGO DEL ESTERO",266,0,61,130,21,212,0
"860490511","SANTIAGO DEL ESTERO",230,5,201,24,0,225,0.0217391304347826
"860770601","SANTIAGO DEL ESTERO",177,0,97,55,9,161,0
"860210207","SANTIAGO DEL ESTERO",249,0,91,104,24,219,0
"860140504","SANTIAGO DEL ESTERO",249,0,96,102,33,231,0
"860140706","SANTIAGO DEL ESTERO",350,0,174,131,30,335,0
"900841606","TUCUMAN",211,208,3,0,0,3,0.985781990521327
"861470911","SANTIAGO DEL ESTERO",82,81,1,0,0,1,0.98780487804878
"860280409","SANTIAGO DEL ESTERO",378,0,284,84,1,369,0
"860351111","SANTIAGO DEL ESTERO",96,96,0,0,0,0,1
"860351514","SANTIAGO DEL ESTERO",284,8,93,139,2,234,0.028169014084507
"860351515","SANTIAGO DEL ESTERO",320,34,233,39,2,274,0.10625
"860420206","SANTIAGO DEL ESTERO",439,0,273,73,24,370,0
"860420208","SANTIAGO DEL ESTERO",342,0,232,85,19,336,0
"860490305","SANTIAGO DEL ESTERO",348,26,301,17,2,320,0.0747126436781609
"860490313","SANTIAGO DEL ESTERO",148,113,14,16,0,30,0.763513513513513
"860490504","SANTIAGO DEL ESTERO",315,12,204,70,8,282,0.0380952380952381
"860491815","SANTIAGO DEL ESTERO",301,9,278,11,0,289,0.0299003322259136
"860490506","SANTIAGO DEL ESTERO",316,6,196,93,5,294,0.0189873417721519
"860490519","SANTIAGO DEL ESTERO",372,366,3,3,0,6,0.983870967741935
"860490922","SANTIAGO DEL ESTERO",169,168,0,1,0,1,0.994082840236686
"860491015","SANTIAGO DEL ESTERO",268,259,6,1,1,8,0.966417910447761
"860490911","SANTIAGO DEL ESTERO",141,141,0,0,0,0,1
"860490918","SANTIAGO DEL ESTERO",302,233,42,22,1,65,0.771523178807947
"860491020","SANTIAGO DEL ESTERO",276,150,55,59,7,121,0.543478260869565
"860491503","SANTIAGO DEL ESTERO",349,5,297,46,0,343,0.0143266475644699
"860491708","SANTIAGO DEL ESTERO",228,4,100,80,16,196,0.0175438596491228
"860491802","SANTIAGO DEL ESTERO",369,88,64,189,14,267,0.238482384823848
"860491803","SANTIAGO DEL ESTERO",295,3,75,178,8,261,0.0101694915254237
"860630106","SANTIAGO DEL ESTERO",202,0,102,82,13,197,0
"861400205","SANTIAGO DEL ESTERO",200,0,161,25,11,197,0
"861470104","SANTIAGO DEL ESTERO",159,2,7,112,21,140,0.0125786163522013
"860630802","SANTIAGO DEL ESTERO",253,105,103,13,0,116,0.41501976284585
"860630810","SANTIAGO DEL ESTERO",313,170,117,22,0,139,0.543130990415335
"860630815","SANTIAGO DEL ESTERO",331,6,183,86,23,292,0.0181268882175227
"860770611","SANTIAGO DEL ESTERO",233,0,154,52,5,211,0
"861050211","SANTIAGO DEL ESTERO",265,0,135,102,9,246,0
"861050205","SANTIAGO DEL ESTERO",296,0,186,85,19,290,0
"861190103","SANTIAGO DEL ESTERO",340,0,137,113,62,312,0
"861190413","SANTIAGO DEL ESTERO",496,0,195,165,70,430,0
"861330410","SANTIAGO DEL ESTERO",513,0,163,262,24,449,0
"861470803","SANTIAGO DEL ESTERO",297,275,12,9,0,21,0.925925925925926
"861470909","SANTIAGO DEL ESTERO",236,218,2,9,3,14,0.923728813559322
"861470910","SANTIAGO DEL ESTERO",155,153,1,1,0,2,0.987096774193548
"861540106","SANTIAGO DEL ESTERO",297,0,254,37,4,295,0
"861610204","SANTIAGO DEL ESTERO",218,1,142,26,10,178,0.00458715596330275
"861610413","SANTIAGO DEL ESTERO",188,1,96,70,11,177,0.00531914893617021
"860560305","SANTIAGO DEL ESTERO",72,0,2,6,46,54,0
"860070104","SANTIAGO DEL ESTERO",107,0,0,29,47,76,0
"860070205","SANTIAGO DEL ESTERO",7,0,3,3,1,7,0
"861330203","SANTIAGO DEL ESTERO",248,0,29,131,27,187,0
"860770609","SANTIAGO DEL ESTERO",214,0,157,28,1,186,0
"900141216","TUCUMAN",232,1,144,74,4,222,0.00431034482758621
"860070203","SANTIAGO DEL ESTERO",45,0,6,24,5,35,0
"860560501","SANTIAGO DEL ESTERO",406,0,35,249,50,334,0
"100070103","CATAMARCA",26,0,17,9,0,26,0
"861190102","SANTIAGO DEL ESTERO",459,0,68,195,99,362,0
"861330103","SANTIAGO DEL ESTERO",163,0,30,82,37,149,0
"860351603","SANTIAGO DEL ESTERO",291,265,22,3,0,25,0.910652920962199
"860351612","SANTIAGO DEL ESTERO",435,5,174,194,18,386,0.0114942528735632
"860351607","SANTIAGO DEL ESTERO",335,193,106,32,3,141,0.576119402985075
"861610312","SANTIAGO DEL ESTERO",264,3,203,15,0,218,0.0113636363636364
"860490513","SANTIAGO DEL ESTERO",249,2,199,48,0,247,0.00803212851405622
"860490522","SANTIAGO DEL ESTERO",322,305,15,1,0,16,0.947204968944099
"860490811","SANTIAGO DEL ESTERO",189,2,178,8,0,186,0.0105820105820106
"860350805","SANTIAGO DEL ESTERO",389,5,257,65,21,343,0.012853470437018
"860491218","SANTIAGO DEL ESTERO",220,194,14,10,1,25,0.881818181818182
"900560904","TUCUMAN",149,0,10,122,2,134,0
"860070302","SANTIAGO DEL ESTERO",23,0,2,14,1,17,0
"860070304","SANTIAGO DEL ESTERO",36,0,3,19,0,22,0
"860140602","SANTIAGO DEL ESTERO",59,0,17,14,25,56,0
"900841401","TUCUMAN",337,306,15,5,0,20,0.908011869436202
"860280101","SANTIAGO DEL ESTERO",95,0,1,46,19,66,0
"860351202","SANTIAGO DEL ESTERO",167,1,37,60,33,130,0.00598802395209581
"860560403","SANTIAGO DEL ESTERO",84,0,3,15,55,73,0
"860350901","SANTIAGO DEL ESTERO",154,1,17,46,40,103,0.00649350649350649
"860560205","SANTIAGO DEL ESTERO",113,0,4,6,68,78,0
"860630202","SANTIAGO DEL ESTERO",62,0,1,18,34,53,0
"861050202","SANTIAGO DEL ESTERO",44,0,0,16,26,42,0
"860630402","SANTIAGO DEL ESTERO",43,0,4,13,15,32,0
"861260303","SANTIAGO DEL ESTERO",93,0,11,50,18,79,0
"860700102","SANTIAGO DEL ESTERO",137,0,1,24,61,86,0
"860770303","SANTIAGO DEL ESTERO",59,0,27,24,3,54,0
"860491301","SANTIAGO DEL ESTERO",288,285,2,0,0,2,0.989583333333333
"860351404","SANTIAGO DEL ESTERO",312,37,171,94,6,271,0.118589743589744
"860700602","SANTIAGO DEL ESTERO",86,0,0,16,44,60,0
"860910408","SANTIAGO DEL ESTERO",46,0,0,6,15,21,0
"861610103","SANTIAGO DEL ESTERO",144,0,23,46,27,96,0
"540280116","MISIONES",5,3,2,0,0,2,0.6
"860980204","SANTIAGO DEL ESTERO",40,0,4,14,18,36,0
"860491401","SANTIAGO DEL ESTERO",187,174,10,3,0,13,0.93048128342246
"860910301","SANTIAGO DEL ESTERO",43,0,0,8,9,17,0
"860910405","SANTIAGO DEL ESTERO",202,0,22,131,15,168,0
"860980105","SANTIAGO DEL ESTERO",33,0,2,6,18,26,0
"861610401","SANTIAGO DEL ESTERO",73,0,8,42,7,57,0
"860351605","SANTIAGO DEL ESTERO",265,209,43,12,1,56,0.788679245283019
"861120104","SANTIAGO DEL ESTERO",36,0,0,1,26,27,0
"861260403","SANTIAGO DEL ESTERO",126,0,19,53,30,102,0
"861120105","SANTIAGO DEL ESTERO",47,0,2,14,17,33,0
"861120202","SANTIAGO DEL ESTERO",25,0,1,13,3,17,0
"860210206","SANTIAGO DEL ESTERO",155,0,51,61,25,137,0
"861120301","SANTIAGO DEL ESTERO",0,0,0,0,0,0,NA
"860140902","SANTIAGO DEL ESTERO",89,0,1,25,47,73,0
"860491310","SANTIAGO DEL ESTERO",288,277,4,5,0,9,0.961805555555556
"860560206","SANTIAGO DEL ESTERO",60,0,1,2,33,36,0
"861540201","SANTIAGO DEL ESTERO",29,0,19,6,2,27,0
"861330102","SANTIAGO DEL ESTERO",93,0,4,13,38,55,0
"861400105","SANTIAGO DEL ESTERO",144,0,15,67,26,108,0
"861330501","SANTIAGO DEL ESTERO",16,0,11,3,1,15,0
"861400102","SANTIAGO DEL ESTERO",47,0,6,33,7,46,0
"861470601","SANTIAGO DEL ESTERO",148,0,23,84,29,136,0
"860980106","SANTIAGO DEL ESTERO",30,0,0,24,6,30,0
"861680104","SANTIAGO DEL ESTERO",87,0,5,34,33,72,0
"860630602","SANTIAGO DEL ESTERO",288,228,36,5,14,55,0.791666666666667
"860351211","SANTIAGO DEL ESTERO",274,273,0,0,0,0,0.996350364963504
"861680201","SANTIAGO DEL ESTERO",165,0,10,51,62,123,0
"861750305","SANTIAGO DEL ESTERO",161,0,6,37,60,103,0
"860491912","SANTIAGO DEL ESTERO",327,314,5,6,0,11,0.960244648318043
"900841609","TUCUMAN",263,253,5,4,0,9,0.961977186311787
"861890302","SANTIAGO DEL ESTERO",278,0,56,91,98,245,0
"860630610","SANTIAGO DEL ESTERO",306,149,116,38,1,155,0.486928104575163
"860491217","SANTIAGO DEL ESTERO",265,251,5,1,1,7,0.947169811320755
"860491308","SANTIAGO DEL ESTERO",227,195,18,10,0,28,0.859030837004405
"860491407","SANTIAGO DEL ESTERO",212,83,76,48,0,124,0.391509433962264
"860770512","SANTIAGO DEL ESTERO",218,0,163,53,0,216,0
"860491511","SANTIAGO DEL ESTERO",246,4,108,95,10,213,0.016260162601626
"860350806","SANTIAGO DEL ESTERO",272,2,184,65,6,255,0.00735294117647059
"860351504","SANTIAGO DEL ESTERO",389,191,106,84,4,194,0.491002570694087
"860351108","SANTIAGO DEL ESTERO",476,474,1,0,0,1,0.995798319327731
"860491012","SANTIAGO DEL ESTERO",304,304,0,0,0,0,1
"860560404","SANTIAGO DEL ESTERO",160,0,41,69,19,129,0
"861050209","SANTIAGO DEL ESTERO",339,0,191,128,8,327,0
"861680105","SANTIAGO DEL ESTERO",149,0,47,75,18,140,0
"860351509","SANTIAGO DEL ESTERO",262,246,11,5,0,16,0.938931297709924
"860140503","SANTIAGO DEL ESTERO",246,0,119,77,33,229,0
"860140705","SANTIAGO DEL ESTERO",308,0,155,95,39,289,0
"860280207","SANTIAGO DEL ESTERO",304,0,119,147,28,294,0
"860280504","SANTIAGO DEL ESTERO",340,0,105,195,20,320,0
"860351220","SANTIAGO DEL ESTERO",277,218,19,31,5,55,0.787003610108303
"860490308","SANTIAGO DEL ESTERO",252,6,41,171,18,230,0.0238095238095238
"860351609","SANTIAGO DEL ESTERO",422,288,81,43,2,126,0.682464454976303
"860490303","SANTIAGO DEL ESTERO",397,271,91,29,0,120,0.682619647355164
"860490306","SANTIAGO DEL ESTERO",352,24,268,55,0,323,0.0681818181818182
"860490312","SANTIAGO DEL ESTERO",209,116,40,47,2,89,0.555023923444976
"860490505","SANTIAGO DEL ESTERO",195,4,124,51,2,177,0.0205128205128205
"860491002","SANTIAGO DEL ESTERO",256,13,25,176,17,218,0.05078125
"860490517","SANTIAGO DEL ESTERO",223,136,56,27,0,83,0.609865470852018
"860490518","SANTIAGO DEL ESTERO",310,247,34,20,1,55,0.796774193548387
"860490802","SANTIAGO DEL ESTERO",235,7,97,108,12,217,0.0297872340425532
"860490807","SANTIAGO DEL ESTERO",197,148,31,16,1,48,0.751269035532995
"860490903","SANTIAGO DEL ESTERO",233,207,16,8,0,24,0.888412017167382
"860491011","SANTIAGO DEL ESTERO",218,218,0,0,0,0,1
"860491016","SANTIAGO DEL ESTERO",291,287,2,1,0,3,0.986254295532646
"860491106","SANTIAGO DEL ESTERO",354,5,203,101,19,323,0.0141242937853107
"860491205","SANTIAGO DEL ESTERO",212,5,166,34,0,200,0.0235849056603774
"860491210","SANTIAGO DEL ESTERO",319,315,3,1,0,4,0.987460815047022
"860491411","SANTIAGO DEL ESTERO",257,3,213,38,0,251,0.0116731517509728
"860491514","SANTIAGO DEL ESTERO",390,8,145,211,13,369,0.0205128205128205
"860491601","SANTIAGO DEL ESTERO",369,18,198,122,14,334,0.0487804878048781
"860491606","SANTIAGO DEL ESTERO",269,216,40,7,3,50,0.802973977695167
"540280501","MISIONES",304,134,150,13,3,166,0.440789473684211
"860491610","SANTIAGO DEL ESTERO",308,11,120,155,13,288,0.0357142857142857
"860491715","SANTIAGO DEL ESTERO",313,8,241,46,2,289,0.0255591054313099
"860491812","SANTIAGO DEL ESTERO",83,1,35,40,4,79,0.0120481927710843
"860491814","SANTIAGO DEL ESTERO",214,21,163,30,0,193,0.0981308411214953
"861470806","SANTIAGO DEL ESTERO",267,236,5,16,1,22,0.883895131086142
"380210805","JUJUY",292,282,7,0,0,7,0.965753424657534
"860491916","SANTIAGO DEL ESTERO",307,1,165,101,6,272,0.00325732899022801
"860560309","SANTIAGO DEL ESTERO",230,0,43,93,66,202,0
"860630403","SANTIAGO DEL ESTERO",162,0,66,77,10,153,0
"860630809","SANTIAGO DEL ESTERO",157,79,49,25,1,75,0.503184713375796
"860700603","SANTIAGO DEL ESTERO",406,0,194,134,30,358,0
"860840408","SANTIAGO DEL ESTERO",223,0,138,71,2,211,0
"140145409","CORDOBA",252,251,1,0,0,1,0.996031746031746
"860910109","SANTIAGO DEL ESTERO",351,0,96,203,4,303,0
"860980205","SANTIAGO DEL ESTERO",252,0,89,104,40,233,0
"861190104","SANTIAGO DEL ESTERO",450,0,269,99,34,402,0
"861260313","SANTIAGO DEL ESTERO",284,0,248,28,2,278,0
"540070620","MISIONES",103,0,25,32,44,101,0
"861400208","SANTIAGO DEL ESTERO",206,0,180,19,3,202,0
"861470917","SANTIAGO DEL ESTERO",212,195,9,4,0,13,0.919811320754717
"861470808","SANTIAGO DEL ESTERO",338,240,22,48,4,74,0.710059171597633
"861470809","SANTIAGO DEL ESTERO",253,179,9,41,3,53,0.707509881422925
"861470814","SANTIAGO DEL ESTERO",311,157,75,77,2,154,0.504823151125402
"861470906","SANTIAGO DEL ESTERO",190,183,6,0,0,6,0.963157894736842
"140145408","CORDOBA",194,194,0,0,0,0,1
"861470913","SANTIAGO DEL ESTERO",172,145,6,20,0,26,0.843023255813954
"860910401","SANTIAGO DEL ESTERO",40,0,12,23,2,37,0
"860560402","SANTIAGO DEL ESTERO",121,0,14,24,31,69,0
"860910406","SANTIAGO DEL ESTERO",400,0,86,245,24,355,0
"860980401","SANTIAGO DEL ESTERO",221,0,48,25,105,178,0
"380210804","JUJUY",209,208,1,0,0,1,0.995215311004785
"860140702","SANTIAGO DEL ESTERO",290,0,12,108,78,198,0
"860070303","SANTIAGO DEL ESTERO",33,0,8,23,0,31,0
"860351203","SANTIAGO DEL ESTERO",204,0,53,81,33,167,0
"861610314","SANTIAGO DEL ESTERO",229,6,191,29,1,221,0.0262008733624454
"861610313","SANTIAGO DEL ESTERO",193,0,168,20,0,188,0
"860490501","SANTIAGO DEL ESTERO",661,16,206,252,67,525,0.0242057488653555
"860700403","SANTIAGO DEL ESTERO",191,0,4,53,64,121,0
"140145406","CORDOBA",280,279,1,0,0,1,0.996428571428571
"861190301","SANTIAGO DEL ESTERO",141,0,29,48,33,110,0
"860491214","SANTIAGO DEL ESTERO",241,12,158,68,1,227,0.0497925311203319
"860350803","SANTIAGO DEL ESTERO",215,0,11,95,50,156,0
"860490813","SANTIAGO DEL ESTERO",270,11,198,54,5,257,0.0407407407407407
"860490602","SANTIAGO DEL ESTERO",64,0,3,16,37,56,0
"860560103","SANTIAGO DEL ESTERO",235,0,8,74,42,124,0
"860630104","SANTIAGO DEL ESTERO",104,0,11,41,49,101,0
"860630203","SANTIAGO DEL ESTERO",76,0,1,31,39,71,0
"140145407","CORDOBA",157,157,0,0,0,0,1
"900841608","TUCUMAN",338,331,0,7,0,7,0.979289940828402
"860630702","SANTIAGO DEL ESTERO",0,0,0,0,0,0,NA
"860770402","SANTIAGO DEL ESTERO",150,0,4,39,93,136,0
"861400103","SANTIAGO DEL ESTERO",194,0,11,60,104,175,0
"861470401","SANTIAGO DEL ESTERO",567,2,16,371,81,468,0.00352733686067019
"860070301","SANTIAGO DEL ESTERO",8,0,5,3,0,8,0
"860280203","SANTIAGO DEL ESTERO",104,0,1,35,61,97,0
"860280401","SANTIAGO DEL ESTERO",97,0,9,41,22,72,0
"860350303","SANTIAGO DEL ESTERO",49,0,1,7,8,16,0
"860351102","SANTIAGO DEL ESTERO",198,1,26,82,34,142,0.00505050505050505
"860630204","SANTIAGO DEL ESTERO",27,0,0,5,21,26,0
"860140103","SANTIAGO DEL ESTERO",104,0,1,21,48,70,0
"860280405","SANTIAGO DEL ESTERO",116,0,11,41,21,73,0
"860350602","SANTIAGO DEL ESTERO",198,1,8,113,30,151,0.00505050505050505
"860280202","SANTIAGO DEL ESTERO",34,0,2,25,3,30,0
"860420203","SANTIAGO DEL ESTERO",15,0,7,7,1,15,0
"540420503","MISIONES",248,3,206,39,0,245,0.0120967741935484
"860700601","SANTIAGO DEL ESTERO",89,0,2,23,10,35,0
"860840302","SANTIAGO DEL ESTERO",50,0,0,12,28,40,0
"860910101","SANTIAGO DEL ESTERO",131,0,6,83,15,104,0
"860910202","SANTIAGO DEL ESTERO",20,0,0,11,0,11,0
"860980402","SANTIAGO DEL ESTERO",144,0,14,22,80,116,0
"860980702","SANTIAGO DEL ESTERO",18,0,1,16,0,17,0
"900841802","TUCUMAN",287,279,4,3,0,7,0.97212543554007
"861050303","SANTIAGO DEL ESTERO",94,0,1,9,40,50,0
"860491307","SANTIAGO DEL ESTERO",253,214,23,13,2,38,0.845849802371542
"861120102","SANTIAGO DEL ESTERO",69,0,4,12,37,53,0
"861190304","SANTIAGO DEL ESTERO",36,0,2,2,30,34,0
"540210705","MISIONES",252,7,112,79,44,235,0.0277777777777778
"861260402","SANTIAGO DEL ESTERO",82,0,15,45,10,70,0
"861330502","SANTIAGO DEL ESTERO",23,0,10,7,3,20,0
"861330503","SANTIAGO DEL ESTERO",41,0,3,21,6,30,0
"861330603","SANTIAGO DEL ESTERO",73,0,2,41,18,61,0
"860840303","SANTIAGO DEL ESTERO",87,0,1,38,37,76,0
"861540302","SANTIAGO DEL ESTERO",54,0,30,19,5,54,0
"860210304","SANTIAGO DEL ESTERO",43,0,0,9,21,30,0
"860491811","SANTIAGO DEL ESTERO",212,4,135,54,11,200,0.0188679245283019
"860491313","SANTIAGO DEL ESTERO",135,134,1,0,0,1,0.992592592592593
"861610104","SANTIAGO DEL ESTERO",119,0,23,50,19,92,0
"861610106","SANTIAGO DEL ESTERO",222,1,42,102,16,160,0.0045045045045045
"860351005","SANTIAGO DEL ESTERO",119,0,4,48,39,91,0
"861610201","SANTIAGO DEL ESTERO",87,0,4,21,34,59,0
"861610304","SANTIAGO DEL ESTERO",82,0,15,12,22,49,0
"861610406","SANTIAGO DEL ESTERO",127,0,10,59,18,87,0
"861680101","SANTIAGO DEL ESTERO",112,0,4,18,73,95,0
"860351210","SANTIAGO DEL ESTERO",279,279,0,0,0,0,1
"860770509","SANTIAGO DEL ESTERO",187,0,147,36,1,184,0
"861610310","SANTIAGO DEL ESTERO",243,4,203,32,1,236,0.0164609053497942
"860491006","SANTIAGO DEL ESTERO",389,4,77,203,42,322,0.0102827763496144
"860491007","SANTIAGO DEL ESTERO",340,105,140,71,2,213,0.308823529411765
"860980112","SANTIAGO DEL ESTERO",188,0,88,49,25,162,0
"861680103","SANTIAGO DEL ESTERO",152,0,9,58,48,115,0
"861750103","SANTIAGO DEL ESTERO",120,0,3,49,39,91,0
"861680302","SANTIAGO DEL ESTERO",180,0,3,46,79,128,0
"861750203","SANTIAGO DEL ESTERO",126,0,1,3,56,60,0
"100210114","CATAMARCA",90,1,85,2,0,87,0.0111111111111111
"861610317","SANTIAGO DEL ESTERO",222,3,141,50,16,207,0.0135135135135135
"860491614","SANTIAGO DEL ESTERO",227,0,24,136,44,204,0
"860491909","SANTIAGO DEL ESTERO",292,277,8,6,0,14,0.948630136986301
"860491914","SANTIAGO DEL ESTERO",335,320,9,6,0,15,0.955223880597015
"860491915","SANTIAGO DEL ESTERO",196,185,9,1,1,11,0.943877551020408
"860350809","SANTIAGO DEL ESTERO",297,5,152,94,31,277,0.0168350168350168
"860351410","SANTIAGO DEL ESTERO",259,227,12,19,1,32,0.876447876447876
"860770405","SANTIAGO DEL ESTERO",224,0,15,84,122,221,0
"860351513","SANTIAGO DEL ESTERO",300,66,116,96,18,230,0.22
"860351508","SANTIAGO DEL ESTERO",160,154,3,3,0,6,0.9625
"860630601","SANTIAGO DEL ESTERO",192,74,50,52,1,103,0.385416666666667
"860491816","SANTIAGO DEL ESTERO",298,5,263,24,0,287,0.0167785234899329
"860070106","SANTIAGO DEL ESTERO",371,0,221,141,3,365,0
"860351216","SANTIAGO DEL ESTERO",216,9,162,44,0,206,0.0416666666666667
"860351217","SANTIAGO DEL ESTERO",259,31,201,26,1,228,0.11969111969112
"860351219","SANTIAGO DEL ESTERO",473,29,146,229,34,409,0.0613107822410148
"860420209","SANTIAGO DEL ESTERO",346,0,197,120,6,323,0
"860490906","SANTIAGO DEL ESTERO",236,232,3,1,0,4,0.983050847457627
"860560306","SANTIAGO DEL ESTERO",393,0,101,141,64,306,0
"540630917","MISIONES",197,1,120,36,18,174,0.0050761421319797
"860490503","SANTIAGO DEL ESTERO",281,5,119,111,26,256,0.0177935943060498
"860490515","SANTIAGO DEL ESTERO",303,255,36,12,0,48,0.841584158415842
"860490523","SANTIAGO DEL ESTERO",120,100,14,4,0,18,0.833333333333333
"860490804","SANTIAGO DEL ESTERO",181,68,81,14,0,95,0.375690607734807
"860490905","SANTIAGO DEL ESTERO",227,217,7,3,0,10,0.955947136563877
"860490916","SANTIAGO DEL ESTERO",240,233,4,2,1,7,0.970833333333333
"860490917","SANTIAGO DEL ESTERO",265,146,94,20,2,116,0.550943396226415
"860420301","SANTIAGO DEL ESTERO",114,0,73,33,6,112,0
"860491008","SANTIAGO DEL ESTERO",283,13,53,146,35,234,0.0459363957597173
"860491009","SANTIAGO DEL ESTERO",291,250,37,3,0,40,0.859106529209622
"860491018","SANTIAGO DEL ESTERO",312,146,60,87,4,151,0.467948717948718
"860491019","SANTIAGO DEL ESTERO",314,22,145,132,6,283,0.0700636942675159
"860491108","SANTIAGO DEL ESTERO",317,316,1,0,0,1,0.996845425867508
"860491112","SANTIAGO DEL ESTERO",377,63,259,54,0,313,0.16710875331565
"860491203","SANTIAGO DEL ESTERO",262,15,206,41,0,247,0.0572519083969466
"860491207","SANTIAGO DEL ESTERO",232,232,0,0,0,0,1
"860491608","SANTIAGO DEL ESTERO",280,279,0,1,0,1,0.996428571428571
"860491716","SANTIAGO DEL ESTERO",274,5,170,79,3,252,0.0182481751824818
"860491801","SANTIAGO DEL ESTERO",293,0,46,160,54,260,0
"860491805","SANTIAGO DEL ESTERO",348,14,294,39,0,333,0.0402298850574713
"860560307","SANTIAGO DEL ESTERO",365,0,216,95,33,344,0
"860560503","SANTIAGO DEL ESTERO",255,0,88,81,53,222,0
"860630205","SANTIAGO DEL ESTERO",295,4,66,102,78,246,0.0135593220338983
"860630615","SANTIAGO DEL ESTERO",225,97,100,19,4,123,0.431111111111111
"860630803","SANTIAGO DEL ESTERO",175,70,64,24,1,89,0.4
"860630805","SANTIAGO DEL ESTERO",207,119,74,13,0,87,0.57487922705314
"860630808","SANTIAGO DEL ESTERO",216,66,74,47,17,138,0.305555555555556
"860840407","SANTIAGO DEL ESTERO",254,0,148,82,14,244,0
"861050206","SANTIAGO DEL ESTERO",283,0,189,74,4,267,0
"861190405","SANTIAGO DEL ESTERO",130,0,7,27,84,118,0
"861260307","SANTIAGO DEL ESTERO",307,0,154,107,3,264,0
"861330407","SANTIAGO DEL ESTERO",195,0,99,53,3,155,0
"540980905","MISIONES",127,0,33,17,52,102,0
"861400206","SANTIAGO DEL ESTERO",339,0,268,58,11,337,0
"861400207","SANTIAGO DEL ESTERO",234,0,177,48,2,227,0
"861470807","SANTIAGO DEL ESTERO",360,217,46,59,6,111,0.602777777777778
"861470801","SANTIAGO DEL ESTERO",343,167,94,71,0,165,0.486880466472303
"861470802","SANTIAGO DEL ESTERO",313,217,16,60,0,76,0.693290734824281
"861470901","SANTIAGO DEL ESTERO",230,170,12,38,1,51,0.739130434782609
"861680207","SANTIAGO DEL ESTERO",305,0,122,163,3,288,0
"861400202","SANTIAGO DEL ESTERO",78,0,13,23,28,64,0
"861470103","SANTIAGO DEL ESTERO",365,0,43,218,54,315,0
"860140901","SANTIAGO DEL ESTERO",168,0,14,55,59,128,0
"860490502","SANTIAGO DEL ESTERO",537,4,208,212,65,485,0.0074487895716946
"860700201","SANTIAGO DEL ESTERO",269,0,23,140,43,206,0
"861470502","SANTIAGO DEL ESTERO",281,1,18,179,32,229,0.00355871886120996
"860490814","SANTIAGO DEL ESTERO",206,6,157,42,0,199,0.029126213592233
"860490816","SANTIAGO DEL ESTERO",213,1,133,63,0,196,0.00469483568075117
"860140201","SANTIAGO DEL ESTERO",63,0,0,15,26,41,0
"540700805","MISIONES",228,0,176,27,23,226,0
"861890301","SANTIAGO DEL ESTERO",164,0,2,54,64,120,0
"860351114","SANTIAGO DEL ESTERO",324,175,30,77,13,120,0.540123456790123
"861470903","SANTIAGO DEL ESTERO",237,192,17,19,0,36,0.810126582278481
"860350804","SANTIAGO DEL ESTERO",296,5,185,90,5,280,0.0168918918918919
"861610102","SANTIAGO DEL ESTERO",230,0,20,66,61,147,0
"860490301","SANTIAGO DEL ESTERO",11,1,2,3,4,9,0.0909090909090909
"861610307","SANTIAGO DEL ESTERO",42,0,8,20,7,35,0
"860351613","SANTIAGO DEL ESTERO",280,45,126,89,8,223,0.160714285714286
"860280502","SANTIAGO DEL ESTERO",136,0,9,36,57,102,0
"860140903","SANTIAGO DEL ESTERO",64,0,0,1,33,34,0
"860210101","SANTIAGO DEL ESTERO",31,0,0,2,0,2,0
"860140601","SANTIAGO DEL ESTERO",22,0,0,13,1,14,0
"860210104","SANTIAGO DEL ESTERO",126,0,2,61,54,117,0
"860210301","SANTIAGO DEL ESTERO",52,0,2,10,31,43,0
"861190202","SANTIAGO DEL ESTERO",33,0,4,5,12,21,0
"820842613","SANTA FE",357,356,1,0,0,1,0.997198879551821
"860210306","SANTIAGO DEL ESTERO",26,0,0,17,8,25,0
"860280103","SANTIAGO DEL ESTERO",70,0,3,2,61,66,0
"860280303","SANTIAGO DEL ESTERO",88,0,1,21,23,45,0
"860280404","SANTIAGO DEL ESTERO",126,0,13,70,28,111,0
"860350402","SANTIAGO DEL ESTERO",128,0,14,23,45,82,0
"860351104","SANTIAGO DEL ESTERO",70,0,2,40,9,51,0
"860351105","SANTIAGO DEL ESTERO",39,0,2,20,4,26,0
"861260202","SANTIAGO DEL ESTERO",39,0,4,23,4,31,0
"860351511","SANTIAGO DEL ESTERO",350,132,104,105,7,216,0.377142857142857
"860210209","SANTIAGO DEL ESTERO",256,0,86,94,50,230,0
"860351201","SANTIAGO DEL ESTERO",96,0,25,50,10,85,0
"860420102","SANTIAGO DEL ESTERO",16,0,3,3,0,6,0
"860490101","SANTIAGO DEL ESTERO",198,11,1,45,124,170,0.0555555555555556
"860490404","SANTIAGO DEL ESTERO",36,0,2,22,1,25,0
"860630401","SANTIAGO DEL ESTERO",29,0,0,3,22,25,0
"860840305","SANTIAGO DEL ESTERO",89,0,10,40,24,74,0
"860840402","SANTIAGO DEL ESTERO",22,0,0,1,5,6,0
"860840403","SANTIAGO DEL ESTERO",27,0,3,3,4,10,0
"860910204","SANTIAGO DEL ESTERO",7,0,5,0,2,7,0
"860980301","SANTIAGO DEL ESTERO",67,0,9,34,18,61,0
"860491305","SANTIAGO DEL ESTERO",318,267,27,23,1,51,0.839622641509434
"861260203","SANTIAGO DEL ESTERO",121,0,26,59,9,94,0
"861260301","SANTIAGO DEL ESTERO",209,0,29,95,46,170,0
"861260305","SANTIAGO DEL ESTERO",58,0,10,23,9,42,0
"861260404","SANTIAGO DEL ESTERO",29,0,9,8,6,23,0
"860491219","SANTIAGO DEL ESTERO",227,205,10,12,0,22,0.903083700440529
"860491309","SANTIAGO DEL ESTERO",383,243,111,20,1,132,0.634464751958224
"860491508","SANTIAGO DEL ESTERO",457,6,236,175,15,426,0.0131291028446389
"540280708","MISIONES",255,254,1,0,0,1,0.996078431372549
"861330201","SANTIAGO DEL ESTERO",150,0,8,36,57,101,0
"860491612","SANTIAGO DEL ESTERO",295,295,0,0,0,0,1
"860491613","SANTIAGO DEL ESTERO",336,336,0,0,0,0,1
"860491910","SANTIAGO DEL ESTERO",75,62,7,4,1,12,0.826666666666667
"860350810","SANTIAGO DEL ESTERO",453,3,387,58,1,446,0.00662251655629139
"861400302","SANTIAGO DEL ESTERO",71,0,8,15,35,58,0
"861470301","SANTIAGO DEL ESTERO",851,8,124,486,121,731,0.00940070505287897
"860351411","SANTIAGO DEL ESTERO",242,240,1,1,0,2,0.991735537190083
"861470302","SANTIAGO DEL ESTERO",164,4,40,87,21,148,0.024390243902439
"861540104","SANTIAGO DEL ESTERO",45,0,25,12,8,45,0
"861820204","SANTIAGO DEL ESTERO",41,0,3,19,6,28,0
"860560102","SANTIAGO DEL ESTERO",403,0,5,75,108,188,0
"861610402","SANTIAGO DEL ESTERO",97,0,7,64,2,73,0
"861750303","SANTIAGO DEL ESTERO",166,0,2,54,49,105,0
"861750202","SANTIAGO DEL ESTERO",73,0,1,19,11,31,0
"861820101","SANTIAGO DEL ESTERO",14,0,0,2,4,6,0
"861820201","SANTIAGO DEL ESTERO",57,0,7,20,17,44,0
"860491314","SANTIAGO DEL ESTERO",186,182,1,3,0,4,0.978494623655914
"860630603","SANTIAGO DEL ESTERO",155,7,122,24,0,146,0.0451612903225806
"860630604","SANTIAGO DEL ESTERO",203,115,38,40,7,85,0.566502463054187
"860351209","SANTIAGO DEL ESTERO",278,278,0,0,0,0,1
"860630606","SANTIAGO DEL ESTERO",231,82,118,14,6,138,0.354978354978355
"860980602","SANTIAGO DEL ESTERO",53,0,0,39,8,47,0
"860491907","SANTIAGO DEL ESTERO",300,296,3,1,0,4,0.986666666666667
"860351506","SANTIAGO DEL ESTERO",370,6,178,153,4,335,0.0162162162162162
"860630804","SANTIAGO DEL ESTERO",225,102,94,25,0,119,0.453333333333333
"860491303","SANTIAGO DEL ESTERO",248,213,4,0,0,4,0.858870967741935
"860350203","SANTIAGO DEL ESTERO",152,2,14,43,47,104,0.0131578947368421
"860351106","SANTIAGO DEL ESTERO",176,127,7,34,2,43,0.721590909090909
"860351206","SANTIAGO DEL ESTERO",232,4,121,85,9,215,0.0172413793103448
"860351301","SANTIAGO DEL ESTERO",377,347,22,4,0,26,0.920424403183024
"860351304","SANTIAGO DEL ESTERO",225,6,146,66,0,212,0.0266666666666667
"860351306","SANTIAGO DEL ESTERO",239,28,178,26,2,206,0.117154811715481
"860491105","SANTIAGO DEL ESTERO",241,6,186,47,1,234,0.024896265560166
"860351310","SANTIAGO DEL ESTERO",258,1,99,114,8,221,0.00387596899224806
"860490307","SANTIAGO DEL ESTERO",296,19,135,105,21,261,0.0641891891891892
"860351317","SANTIAGO DEL ESTERO",240,4,159,71,0,230,0.0166666666666667
"860351606","SANTIAGO DEL ESTERO",191,38,96,54,3,153,0.198952879581152
"860490304","SANTIAGO DEL ESTERO",283,28,235,17,1,253,0.0989399293286219
"860490507","SANTIAGO DEL ESTERO",227,72,144,11,0,155,0.317180616740088
"860490806","SANTIAGO DEL ESTERO",151,149,1,1,0,2,0.986754966887417
"860490904","SANTIAGO DEL ESTERO",272,221,10,6,0,16,0.8125
"860490915","SANTIAGO DEL ESTERO",262,260,2,0,0,2,0.99236641221374
"860491010","SANTIAGO DEL ESTERO",214,214,0,0,0,0,1
"860770207","SANTIAGO DEL ESTERO",227,0,108,95,17,220,0
"860491113","SANTIAGO DEL ESTERO",372,12,260,85,4,349,0.032258064516129
"860491208","SANTIAGO DEL ESTERO",303,303,0,0,0,0,1
"860491209","SANTIAGO DEL ESTERO",232,231,1,0,0,1,0.995689655172414
"860491213","SANTIAGO DEL ESTERO",258,258,0,0,0,0,1
"860491413","SANTIAGO DEL ESTERO",266,193,46,21,3,70,0.725563909774436
"860491415","SANTIAGO DEL ESTERO",293,157,74,58,0,132,0.535836177474403
"860491505","SANTIAGO DEL ESTERO",199,64,124,11,0,135,0.321608040201005
"860491607","SANTIAGO DEL ESTERO",328,4,102,189,23,314,0.0121951219512195
"860491705","SANTIAGO DEL ESTERO",279,6,187,80,0,267,0.021505376344086
"860491808","SANTIAGO DEL ESTERO",277,6,265,3,2,270,0.0216606498194946
"100490617","CATAMARCA",192,178,7,6,0,13,0.927083333333333
"860770205","SANTIAGO DEL ESTERO",374,0,158,154,38,350,0
"861330802","SANTIAGO DEL ESTERO",239,0,6,100,97,203,0
"860491817","SANTIAGO DEL ESTERO",289,1,263,24,0,287,0.00346020761245675
"860560311","SANTIAGO DEL ESTERO",254,0,96,73,27,196,0
"860560312","SANTIAGO DEL ESTERO",491,0,273,119,48,440,0
"860560505","SANTIAGO DEL ESTERO",282,0,159,82,16,257,0
"860630613","SANTIAGO DEL ESTERO",252,12,133,81,10,224,0.0476190476190476
"861470817","SANTIAGO DEL ESTERO",168,138,6,19,0,25,0.821428571428571
"820631612","SANTA FE",256,241,5,10,0,15,0.94140625
"860630614","SANTIAGO DEL ESTERO",279,100,121,40,6,167,0.3584229390681
"860770604","SANTIAGO DEL ESTERO",214,0,173,25,1,199,0
"860350501","SANTIAGO DEL ESTERO",156,0,2,24,84,110,0
"860770507","SANTIAGO DEL ESTERO",182,0,106,58,4,168,0
"860770612","SANTIAGO DEL ESTERO",235,0,131,70,2,203,0
"860910108","SANTIAGO DEL ESTERO",13,0,3,5,0,8,0
"860980305","SANTIAGO DEL ESTERO",392,0,33,110,198,341,0
"861190406","SANTIAGO DEL ESTERO",489,0,240,164,42,446,0
"861190411","SANTIAGO DEL ESTERO",261,0,172,43,35,250,0
"861260308","SANTIAGO DEL ESTERO",327,0,152,113,16,281,0
"861260309","SANTIAGO DEL ESTERO",419,0,357,39,6,402,0
"861470811","SANTIAGO DEL ESTERO",306,144,35,106,2,143,0.470588235294118
"540280406","MISIONES",303,184,111,8,0,119,0.607260726072607
"861470914","SANTIAGO DEL ESTERO",228,109,12,90,2,104,0.478070175438596
"861470918","SANTIAGO DEL ESTERO",159,109,8,16,0,24,0.685534591194969
"861540108","SANTIAGO DEL ESTERO",230,0,187,18,5,210,0
"861610206","SANTIAGO DEL ESTERO",222,2,118,78,12,208,0.00900900900900901
"861890103","SANTIAGO DEL ESTERO",257,0,138,86,17,241,0
"861680206","SANTIAGO DEL ESTERO",376,0,224,129,12,365,0
"860980503","SANTIAGO DEL ESTERO",278,0,13,97,69,179,0
"860490202","SANTIAGO DEL ESTERO",509,92,37,226,90,353,0.180746561886051
"860910103","SANTIAGO DEL ESTERO",131,0,18,73,22,113,0
"860140402","SANTIAGO DEL ESTERO",57,0,13,31,7,51,0
"860491905","SANTIAGO DEL ESTERO",366,365,1,0,0,1,0.997267759562842
"860420202","SANTIAGO DEL ESTERO",257,0,199,51,3,253,0
"860560303","SANTIAGO DEL ESTERO",141,0,7,42,52,101,0
"860770103","SANTIAGO DEL ESTERO",247,0,88,56,61,205,0
"860770202","SANTIAGO DEL ESTERO",490,0,40,292,104,436,0
"860910102","SANTIAGO DEL ESTERO",42,0,3,32,3,38,0
"861050201","SANTIAGO DEL ESTERO",324,0,199,95,19,313,0
"861190401","SANTIAGO DEL ESTERO",129,0,20,47,35,102,0
"181191518","CORRIENTES",174,170,4,0,0,4,0.977011494252874
"861470703","SANTIAGO DEL ESTERO",232,0,15,158,39,212,0
"861750101","SANTIAGO DEL ESTERO",323,0,34,106,88,228,0
"860770610","SANTIAGO DEL ESTERO",246,0,165,43,22,230,0
"860910411","SANTIAGO DEL ESTERO",315,0,111,146,20,277,0
"901050622","TUCUMAN",123,3,110,10,0,120,0.024390243902439
"860351101","SANTIAGO DEL ESTERO",328,195,89,22,3,114,0.594512195121951
"860491004","SANTIAGO DEL ESTERO",280,0,39,183,15,237,0
"860491003","SANTIAGO DEL ESTERO",511,3,118,275,86,479,0.00587084148727984
"861610305","SANTIAGO DEL ESTERO",262,1,19,109,82,210,0.00381679389312977
"860350703","SANTIAGO DEL ESTERO",106,0,5,40,21,66,0
"860070201","SANTIAGO DEL ESTERO",9,0,2,4,2,8,0
"860420103","SANTIAGO DEL ESTERO",21,0,1,18,1,20,0
"860280104","SANTIAGO DEL ESTERO",74,0,4,8,54,66,0
"860280201","SANTIAGO DEL ESTERO",53,0,0,22,26,48,0
"860280302","SANTIAGO DEL ESTERO",144,0,10,91,12,113,0
"860350101","SANTIAGO DEL ESTERO",67,0,0,4,53,57,0
"860420303","SANTIAGO DEL ESTERO",28,0,17,5,2,24,0
"860491114","SANTIAGO DEL ESTERO",351,8,290,48,0,338,0.0227920227920228
"860491906","SANTIAGO DEL ESTERO",415,411,4,0,0,4,0.990361445783133
"860560101","SANTIAGO DEL ESTERO",183,0,6,14,43,63,0
"860560304","SANTIAGO DEL ESTERO",117,0,2,32,47,81,0
"860630102","SANTIAGO DEL ESTERO",150,0,6,66,42,114,0
"860630103","SANTIAGO DEL ESTERO",182,1,14,62,82,158,0.00549450549450549
"900841604","TUCUMAN",445,436,6,3,0,9,0.979775280898876
"860630703","SANTIAGO DEL ESTERO",0,0,0,0,0,0,NA
"860700104","SANTIAGO DEL ESTERO",162,0,0,35,84,119,0
"540280311","MISIONES",425,138,247,37,0,284,0.324705882352941
"860420304","SANTIAGO DEL ESTERO",17,0,5,8,1,14,0
"860490102","SANTIAGO DEL ESTERO",165,1,4,77,47,128,0.00606060606060606
"860560302","SANTIAGO DEL ESTERO",64,0,4,15,9,28,0
"860630501","SANTIAGO DEL ESTERO",70,0,1,6,38,45,0
"860491710","SANTIAGO DEL ESTERO",327,4,126,165,14,305,0.0122324159021407
"140147903","CORDOBA",223,202,15,6,0,21,0.905829596412556
"860770101","SANTIAGO DEL ESTERO",318,0,15,109,96,220,0
"860840101","SANTIAGO DEL ESTERO",26,0,2,21,0,23,0
"860840102","SANTIAGO DEL ESTERO",128,0,7,64,49,120,0
"860910201","SANTIAGO DEL ESTERO",64,0,5,31,17,53,0
"860910302","SANTIAGO DEL ESTERO",27,0,0,15,0,15,0
"860491512","SANTIAGO DEL ESTERO",304,6,186,66,2,254,0.0197368421052632
"100840107","CATAMARCA",7,0,6,1,0,7,0
"860980703","SANTIAGO DEL ESTERO",8,0,4,2,2,8,0
"860280102","SANTIAGO DEL ESTERO",108,0,0,28,53,81,0
"861680303","SANTIAGO DEL ESTERO",65,0,1,27,18,46,0
"820841901","SANTA FE",285,285,0,0,0,0,1
"861610407","SANTIAGO DEL ESTERO",54,0,4,27,1,32,0
"860350807","SANTIAGO DEL ESTERO",454,4,191,186,27,404,0.00881057268722467
"860351412","SANTIAGO DEL ESTERO",322,235,37,43,3,83,0.729813664596273
"860980201","SANTIAGO DEL ESTERO",126,0,6,29,68,103,0
"860980107","SANTIAGO DEL ESTERO",11,0,3,6,2,11,0
"860351107","SANTIAGO DEL ESTERO",518,21,149,222,57,428,0.0405405405405405
"900841007","TUCUMAN",173,123,15,20,0,35,0.710982658959538
"861050203","SANTIAGO DEL ESTERO",389,0,13,138,178,329,0
"861120103","SANTIAGO DEL ESTERO",44,0,1,20,18,39,0
"860140102","SANTIAGO DEL ESTERO",74,0,0,6,15,21,0
"860210302","SANTIAGO DEL ESTERO",55,0,2,35,5,42,0
"861610301","SANTIAGO DEL ESTERO",371,0,28,94,82,204,0
"900841019","TUCUMAN",157,155,1,1,0,2,0.987261146496815
"861120302","SANTIAGO DEL ESTERO",42,0,1,8,33,42,0
"860491311","SANTIAGO DEL ESTERO",274,262,2,8,0,10,0.956204379562044
"861400203","SANTIAGO DEL ESTERO",67,0,6,18,33,57,0
"861330301","SANTIAGO DEL ESTERO",154,0,7,51,22,80,0
"861330602","SANTIAGO DEL ESTERO",56,0,3,12,25,40,0
"861470602","SANTIAGO DEL ESTERO",127,0,0,52,66,118,0
"861470603","SANTIAGO DEL ESTERO",134,0,8,83,23,114,0
"861540303","SANTIAGO DEL ESTERO",63,0,43,15,4,62,0
"861540301","SANTIAGO DEL ESTERO",26,0,5,1,12,18,0
"861680301","SANTIAGO DEL ESTERO",224,0,3,47,97,147,0
"861820103","SANTIAGO DEL ESTERO",85,0,5,26,32,63,0
"860491405","SANTIAGO DEL ESTERO",275,106,163,6,0,169,0.385454545454545
"860630605","SANTIAGO DEL ESTERO",335,196,121,18,0,139,0.585074626865672
"860630609","SANTIAGO DEL ESTERO",280,155,68,47,2,117,0.553571428571429
"860630612","SANTIAGO DEL ESTERO",264,122,92,47,1,140,0.462121212121212
"860491409","SANTIAGO DEL ESTERO",168,124,18,22,0,40,0.738095238095238
"860980501","SANTIAGO DEL ESTERO",63,0,1,13,30,44,0
"860491507","SANTIAGO DEL ESTERO",231,1,130,90,2,222,0.00432900432900433
"860351414","SANTIAGO DEL ESTERO",420,25,210,130,23,363,0.0595238095238095
"860140603","SANTIAGO DEL ESTERO",129,0,11,82,18,111,0
"860630814","SANTIAGO DEL ESTERO",197,21,79,80,2,161,0.106598984771574
"861330505","SANTIAGO DEL ESTERO",318,0,116,137,42,295,0
"861470805","SANTIAGO DEL ESTERO",203,186,7,5,0,12,0.916256157635468
"861610412","SANTIAGO DEL ESTERO",308,1,105,150,26,281,0.00324675324675325
"860070105","SANTIAGO DEL ESTERO",196,0,146,40,4,190,0
"860140704","SANTIAGO DEL ESTERO",372,0,102,183,51,336,0
"860351608","SANTIAGO DEL ESTERO",259,81,133,37,4,174,0.312741312741313
"860280304","SANTIAGO DEL ESTERO",261,0,128,111,7,246,0
"860280407","SANTIAGO DEL ESTERO",245,0,131,75,11,217,0
"860351110","SANTIAGO DEL ESTERO",1,0,0,0,0,0,0
"860490815","SANTIAGO DEL ESTERO",238,5,175,50,3,228,0.0210084033613445
"860351315","SANTIAGO DEL ESTERO",337,1,114,187,7,308,0.0029673590504451
"860351316","SANTIAGO DEL ESTERO",349,1,61,196,45,302,0.00286532951289398
"860351318","SANTIAGO DEL ESTERO",296,4,73,178,9,260,0.0135135135135135
"860351319","SANTIAGO DEL ESTERO",386,348,14,2,1,17,0.901554404145078
"860351402","SANTIAGO DEL ESTERO",284,0,66,149,51,266,0
"860351601","SANTIAGO DEL ESTERO",189,162,20,7,0,27,0.857142857142857
"860490311","SANTIAGO DEL ESTERO",300,15,45,158,59,262,0.05
"860490314","SANTIAGO DEL ESTERO",402,314,47,28,8,83,0.781094527363184
"860490516","SANTIAGO DEL ESTERO",374,344,26,4,0,30,0.919786096256685
"860490520","SANTIAGO DEL ESTERO",273,5,119,115,8,242,0.0183150183150183
"860490803","SANTIAGO DEL ESTERO",182,37,76,58,7,141,0.203296703296703
"860490901","SANTIAGO DEL ESTERO",285,68,62,149,1,212,0.23859649122807
"860490919","SANTIAGO DEL ESTERO",259,259,0,0,0,0,1
"860491013","SANTIAGO DEL ESTERO",176,136,35,4,0,39,0.772727272727273
"860491111","SANTIAGO DEL ESTERO",337,285,38,14,0,52,0.845697329376855
"860491412","SANTIAGO DEL ESTERO",339,6,168,152,1,321,0.0176991150442478
"540280506","MISIONES",417,154,220,43,0,263,0.369304556354916
"860491605","SANTIAGO DEL ESTERO",343,9,161,134,9,304,0.0262390670553936
"860491702","SANTIAGO DEL ESTERO",213,2,108,83,2,193,0.00938967136150235
"860491804","SANTIAGO DEL ESTERO",342,3,170,155,7,332,0.0087719298245614
"860630303","SANTIAGO DEL ESTERO",273,0,128,79,30,237,0
"860630811","SANTIAGO DEL ESTERO",285,67,116,65,10,191,0.235087719298246
"860630806","SANTIAGO DEL ESTERO",261,125,111,21,0,132,0.478927203065134
"860770606","SANTIAGO DEL ESTERO",175,0,141,28,1,170,0
"860770501","SANTIAGO DEL ESTERO",218,0,61,102,31,194,0
"860910409","SANTIAGO DEL ESTERO",32,0,11,10,4,25,0
"860980111","SANTIAGO DEL ESTERO",267,0,120,102,23,245,0
"861050208","SANTIAGO DEL ESTERO",294,0,203,77,3,283,0
"861050207","SANTIAGO DEL ESTERO",342,0,190,113,17,320,0
"861190408","SANTIAGO DEL ESTERO",398,0,253,82,12,347,0
"861190409","SANTIAGO DEL ESTERO",406,0,250,130,16,396,0
"861190414","SANTIAGO DEL ESTERO",379,0,222,88,54,364,0
"861330408","SANTIAGO DEL ESTERO",215,0,96,91,2,189,0
"861470810","SANTIAGO DEL ESTERO",191,130,19,36,3,58,0.680628272251309
"861470905","SANTIAGO DEL ESTERO",259,116,44,82,7,133,0.447876447876448
"861470916","SANTIAGO DEL ESTERO",234,12,42,152,4,198,0.0512820512820513
"860491509","SANTIAGO DEL ESTERO",307,8,256,40,2,298,0.0260586319218241
"861610108","SANTIAGO DEL ESTERO",277,1,156,100,16,272,0.0036101083032491
"861610205","SANTIAGO DEL ESTERO",163,2,62,72,18,152,0.0122699386503067
"861610319","SANTIAGO DEL ESTERO",235,0,148,54,14,216,0
"861680205","SANTIAGO DEL ESTERO",195,0,64,96,14,174,0
"860070103","SANTIAGO DEL ESTERO",146,0,26,60,22,108,0
"860140502","SANTIAGO DEL ESTERO",306,0,59,125,50,234,0
"860350102","SANTIAGO DEL ESTERO",78,0,1,3,63,67,0
"860350201","SANTIAGO DEL ESTERO",53,0,2,11,34,47,0
"860350701","SANTIAGO DEL ESTERO",99,0,7,49,26,82,0
"861750201","SANTIAGO DEL ESTERO",81,0,16,26,12,54,0
"860490201","SANTIAGO DEL ESTERO",346,93,16,63,115,194,0.26878612716763
"861610112","SANTIAGO DEL ESTERO",284,16,121,106,18,245,0.0563380281690141
"860491911","SANTIAGO DEL ESTERO",303,293,3,7,0,10,0.966996699669967
"540280412","MISIONES",353,281,11,39,9,59,0.796033994334278
"860560104","SANTIAGO DEL ESTERO",402,0,35,176,31,242,0
"860560202","SANTIAGO DEL ESTERO",147,0,27,82,9,118,0
"860770301","SANTIAGO DEL ESTERO",238,0,46,88,55,189,0
"860700503","SANTIAGO DEL ESTERO",236,0,1,65,114,180,0
"860770403","SANTIAGO DEL ESTERO",152,0,7,81,25,113,0
"860490817","SANTIAGO DEL ESTERO",389,42,265,67,4,336,0.107969151670951
"860350704","SANTIAGO DEL ESTERO",297,0,26,164,34,224,0
"860700505","SANTIAGO DEL ESTERO",141,0,5,26,68,99,0
"860910407","SANTIAGO DEL ESTERO",184,0,31,126,7,164,0
"860840401","SANTIAGO DEL ESTERO",56,0,10,23,17,50,0
"860910403","SANTIAGO DEL ESTERO",146,0,74,47,9,130,0
"861190101","SANTIAGO DEL ESTERO",395,0,20,46,241,307,0
"861330403","SANTIAGO DEL ESTERO",348,0,65,204,13,282,0
"861330205","SANTIAGO DEL ESTERO",355,0,195,129,12,336,0
"860210105","SANTIAGO DEL ESTERO",37,0,0,20,11,31,0
"860210203","SANTIAGO DEL ESTERO",38,0,0,15,14,29,0
"860210204","SANTIAGO DEL ESTERO",185,0,3,37,105,145,0
"860210303","SANTIAGO DEL ESTERO",18,0,1,1,15,17,0
"860491302","SANTIAGO DEL ESTERO",213,205,7,0,0,7,0.962441314553991
"860280205","SANTIAGO DEL ESTERO",82,0,1,39,23,63,0
"860210305","SANTIAGO DEL ESTERO",10,0,1,1,7,9,0
"860420201","SANTIAGO DEL ESTERO",11,0,6,2,3,11,0
"860351001","SANTIAGO DEL ESTERO",401,2,41,159,78,278,0.00498753117206983
"860490401","SANTIAGO DEL ESTERO",83,0,0,69,12,81,0
"860560301","SANTIAGO DEL ESTERO",70,0,0,4,34,38,0
"860630701","SANTIAGO DEL ESTERO",0,0,0,0,0,0,NA
"860700504","SANTIAGO DEL ESTERO",39,0,0,1,33,34,0
"861540105","SANTIAGO DEL ESTERO",31,0,15,13,3,31,0
"860351213","SANTIAGO DEL ESTERO",315,4,92,185,7,284,0.0126984126984127
"860770401","SANTIAGO DEL ESTERO",42,0,2,12,24,38,0
"860770203","SANTIAGO DEL ESTERO",211,0,18,92,54,164,0
"860351214","SANTIAGO DEL ESTERO",382,5,292,85,0,377,0.0130890052356021
"860770204","SANTIAGO DEL ESTERO",102,0,3,27,35,65,0
"860840103","SANTIAGO DEL ESTERO",26,0,0,14,0,14,0
"860840301","SANTIAGO DEL ESTERO",200,0,22,114,24,160,0
"860910203","SANTIAGO DEL ESTERO",77,0,2,45,24,71,0
"860980403","SANTIAGO DEL ESTERO",165,0,58,13,65,136,0
"861050102","SANTIAGO DEL ESTERO",58,0,1,22,27,50,0
"861260101","SANTIAGO DEL ESTERO",46,0,2,16,11,29,0
"861330404","SANTIAGO DEL ESTERO",319,0,32,191,40,263,0
"861330601","SANTIAGO DEL ESTERO",76,0,6,36,15,57,0
"861400201","SANTIAGO DEL ESTERO",113,0,19,43,34,96,0
"860910107","SANTIAGO DEL ESTERO",109,0,15,71,12,98,0
"861050101","SANTIAGO DEL ESTERO",521,0,64,204,123,391,0
"860351215","SANTIAGO DEL ESTERO",273,9,207,42,7,256,0.032967032967033
"860351611","SANTIAGO DEL ESTERO",265,45,128,76,5,209,0.169811320754717
"860980601","SANTIAGO DEL ESTERO",28,0,0,6,19,25,0
"860980202","SANTIAGO DEL ESTERO",12,0,0,3,9,12,0
"861610315","SANTIAGO DEL ESTERO",242,5,116,79,22,217,0.0206611570247934
"860491713","SANTIAGO DEL ESTERO",294,2,242,34,0,276,0.00680272108843537
"861400101","SANTIAGO DEL ESTERO",109,0,9,58,28,95,0
"861400303","SANTIAGO DEL ESTERO",143,0,5,50,58,113,0
"861470202","SANTIAGO DEL ESTERO",383,4,20,294,23,337,0.010443864229765
"900840914","TUCUMAN",263,260,3,0,0,3,0.988593155893536
"861680304","SANTIAGO DEL ESTERO",119,0,1,21,54,76,0
"861750102","SANTIAGO DEL ESTERO",63,0,0,14,33,47,0
"861820202","SANTIAGO DEL ESTERO",8,0,3,0,3,6,0
"860491404","SANTIAGO DEL ESTERO",248,9,153,78,3,234,0.0362903225806452
"860630607","SANTIAGO DEL ESTERO",209,192,2,15,0,17,0.91866028708134
"860491809","SANTIAGO DEL ESTERO",334,10,259,61,2,322,0.029940119760479
"860351407","SANTIAGO DEL ESTERO",232,3,37,133,3,173,0.0129310344827586
"860351415","SANTIAGO DEL ESTERO",265,48,111,79,16,206,0.181132075471698
"860351510","SANTIAGO DEL ESTERO",364,23,189,134,11,334,0.0631868131868132
"860491014","SANTIAGO DEL ESTERO",204,200,4,0,0,4,0.980392156862745
"860351112","SANTIAGO DEL ESTERO",320,298,0,0,1,1,0.93125
"860491304","SANTIAGO DEL ESTERO",309,256,37,16,0,53,0.828478964401295
"860070108","SANTIAGO DEL ESTERO",281,0,189,71,9,269,0
"860351113","SANTIAGO DEL ESTERO",401,399,2,0,0,2,0.99501246882793
"860140703","SANTIAGO DEL ESTERO",335,0,177,83,51,311,0
"860491102","SANTIAGO DEL ESTERO",291,29,174,80,3,257,0.0996563573883162
"860351221","SANTIAGO DEL ESTERO",36,2,16,15,1,32,0.0555555555555556
"860351309","SANTIAGO DEL ESTERO",257,12,158,76,1,235,0.0466926070038911
"860351311","SANTIAGO DEL ESTERO",282,257,25,0,0,25,0.911347517730496
"861190410","SANTIAGO DEL ESTERO",413,0,183,134,67,384,0
"860351401","SANTIAGO DEL ESTERO",494,4,143,211,40,394,0.00809716599190283
"860351516","SANTIAGO DEL ESTERO",331,59,113,131,6,250,0.178247734138973
"860490509","SANTIAGO DEL ESTERO",349,17,245,86,0,331,0.0487106017191977
"861330409","SANTIAGO DEL ESTERO",208,0,163,36,2,201,0
"861470908","SANTIAGO DEL ESTERO",154,151,2,1,0,3,0.980519480519481
"860490809","SANTIAGO DEL ESTERO",256,80,87,88,1,176,0.3125
"860491001","SANTIAGO DEL ESTERO",386,171,86,109,10,205,0.44300518134715
"860490920","SANTIAGO DEL ESTERO",145,144,1,0,0,1,0.993103448275862
"860490908","SANTIAGO DEL ESTERO",205,205,0,0,0,0,1
"860491101","SANTIAGO DEL ESTERO",366,9,178,161,4,343,0.0245901639344262
"860350302","SANTIAGO DEL ESTERO",23,0,0,3,5,8,0
"860491107","SANTIAGO DEL ESTERO",245,104,121,18,1,140,0.424489795918367
"860491109","SANTIAGO DEL ESTERO",363,306,45,12,0,57,0.84297520661157
"860491212","SANTIAGO DEL ESTERO",177,173,4,0,0,4,0.977401129943503
"860491410","SANTIAGO DEL ESTERO",281,3,216,57,1,274,0.0106761565836299
"860491602","SANTIAGO DEL ESTERO",363,12,133,152,35,320,0.0330578512396694
"860491609","SANTIAGO DEL ESTERO",268,268,0,0,0,0,1
"860491714","SANTIAGO DEL ESTERO",302,2,173,76,1,250,0.00662251655629139
"860491704","SANTIAGO DEL ESTERO",306,8,202,88,1,291,0.0261437908496732
"860491718","SANTIAGO DEL ESTERO",284,3,138,119,5,262,0.0105633802816901
"860491807","SANTIAGO DEL ESTERO",302,7,191,70,0,261,0.0231788079470199
"860491901","SANTIAGO DEL ESTERO",254,251,1,1,0,2,0.988188976377953
"860560310","SANTIAGO DEL ESTERO",213,0,111,57,20,188,0
"860560313","SANTIAGO DEL ESTERO",199,0,135,51,5,191,0
"860770602","SANTIAGO DEL ESTERO",210,0,180,24,0,204,0
"860630807","SANTIAGO DEL ESTERO",273,8,226,39,0,265,0.0293040293040293
"860630812","SANTIAGO DEL ESTERO",178,40,34,64,17,115,0.224719101123595
"860630801","SANTIAGO DEL ESTERO",337,68,132,107,18,257,0.201780415430267
"860770206","SANTIAGO DEL ESTERO",248,0,63,123,48,234,0
"860770503","SANTIAGO DEL ESTERO",193,0,80,50,25,155,0
"860840406","SANTIAGO DEL ESTERO",198,0,138,36,3,177,0
"861050212","SANTIAGO DEL ESTERO",282,0,199,75,6,280,0
"861260311","SANTIAGO DEL ESTERO",304,0,264,29,3,296,0
"861260312","SANTIAGO DEL ESTERO",327,0,275,42,3,320,0
"861470902","SANTIAGO DEL ESTERO",359,209,40,75,2,117,0.582172701949861
"861470813","SANTIAGO DEL ESTERO",229,86,32,96,4,132,0.375545851528384
"860210102","SANTIAGO DEL ESTERO",58,0,1,29,20,50,0
"861470919","SANTIAGO DEL ESTERO",202,66,28,97,1,126,0.326732673267327
"861610110","SANTIAGO DEL ESTERO",345,1,177,121,10,308,0.00289855072463768
"861610111","SANTIAGO DEL ESTERO",283,11,116,118,11,245,0.03886925795053
"861610318","SANTIAGO DEL ESTERO",323,3,274,37,7,318,0.00928792569659443
"861750306","SANTIAGO DEL ESTERO",176,0,96,59,7,162,0
"861820205","SANTIAGO DEL ESTERO",263,0,114,125,6,245,0
"860350502","SANTIAGO DEL ESTERO",123,0,3,68,31,102,0
"220211302","CHACO",45,0,9,23,5,37,0
"861470201","SANTIAGO DEL ESTERO",194,0,6,131,39,176,0
"860700402","SANTIAGO DEL ESTERO",291,0,6,91,108,205,0
"860280204","SANTIAGO DEL ESTERO",60,0,1,5,40,46,0
"860280403","SANTIAGO DEL ESTERO",190,0,10,100,25,135,0
"860630105","SANTIAGO DEL ESTERO",40,0,2,21,8,31,0
"860700202","SANTIAGO DEL ESTERO",447,0,10,170,136,316,0
"861540102","SANTIAGO DEL ESTERO",76,0,32,23,20,75,0
"861750304","SANTIAGO DEL ESTERO",235,0,14,109,46,169,0
"861190412","SANTIAGO DEL ESTERO",360,0,230,89,15,334,0
"861470904","SANTIAGO DEL ESTERO",209,63,23,104,4,131,0.301435406698565
"860491220","SANTIAGO DEL ESTERO",216,3,90,99,8,197,0.0138888888888889
"860350801","SANTIAGO DEL ESTERO",95,0,4,57,15,76,0
"861610309","SANTIAGO DEL ESTERO",255,4,172,63,2,237,0.0156862745098039
"860140802","SANTIAGO DEL ESTERO",43,0,3,18,12,33,0
"860350401","SANTIAGO DEL ESTERO",144,0,5,55,27,87,0
"861610308","SANTIAGO DEL ESTERO",469,3,298,90,18,406,0.00639658848614072
"860491306","SANTIAGO DEL ESTERO",313,285,11,16,0,27,0.910543130990415
"460140506","LA RIOJA",206,203,1,0,0,1,0.985436893203884
"860070202","SANTIAGO DEL ESTERO",28,0,0,12,10,22,0
"900840910","TUCUMAN",200,199,1,0,0,1,0.995
"860210202","SANTIAGO DEL ESTERO",311,0,2,130,87,219,0
"860210201","SANTIAGO DEL ESTERO",377,0,8,164,104,276,0
"860700302","SANTIAGO DEL ESTERO",152,0,1,36,88,125,0
"860491402","SANTIAGO DEL ESTERO",285,254,25,6,0,31,0.891228070175439
"540280314","MISIONES",260,167,68,5,0,73,0.642307692307692
"860420101","SANTIAGO DEL ESTERO",83,0,9,27,24,60,0
"860420302","SANTIAGO DEL ESTERO",14,0,5,7,1,13,0
"860420204","SANTIAGO DEL ESTERO",11,0,1,1,4,6,0
"860490403","SANTIAGO DEL ESTERO",40,0,5,29,3,37,0
"860630101","SANTIAGO DEL ESTERO",12,0,1,6,4,11,0
"860630302","SANTIAGO DEL ESTERO",40,0,0,21,4,25,0
"860770102","SANTIAGO DEL ESTERO",206,0,6,56,115,177,0
"860770201","SANTIAGO DEL ESTERO",115,0,7,21,60,88,0
"860840201","SANTIAGO DEL ESTERO",120,0,4,51,45,100,0
"860910105","SANTIAGO DEL ESTERO",345,0,58,220,27,305,0
"860910404","SANTIAGO DEL ESTERO",180,0,37,110,10,157,0
"860980101","SANTIAGO DEL ESTERO",71,0,1,19,17,37,0
"860980104","SANTIAGO DEL ESTERO",34,0,0,9,14,23,0
"860980302","SANTIAGO DEL ESTERO",44,0,9,9,13,31,0
"220211401","CHACO",35,1,11,22,1,34,0.0285714285714286
"861610316","SANTIAGO DEL ESTERO",329,0,197,79,31,307,0
"860491513","SANTIAGO DEL ESTERO",186,4,128,54,0,182,0.021505376344086
"540981007","MISIONES",229,0,146,45,21,212,0
"861120101","SANTIAGO DEL ESTERO",36,0,0,10,20,30,0
"861190501","SANTIAGO DEL ESTERO",316,0,22,43,138,203,0
"861260302","SANTIAGO DEL ESTERO",89,0,8,38,10,56,0
"861470503","SANTIAGO DEL ESTERO",120,1,9,79,14,102,0.00833333333333333
"860770607","SANTIAGO DEL ESTERO",162,0,78,77,4,159,0
"860980603","SANTIAGO DEL ESTERO",15,0,0,13,0,13,0
"861330202","SANTIAGO DEL ESTERO",68,0,7,28,14,49,0
"861330701","SANTIAGO DEL ESTERO",231,0,9,118,42,169,0
"861330204","SANTIAGO DEL ESTERO",192,0,13,84,48,145,0
"861610105","SANTIAGO DEL ESTERO",314,1,56,167,22,245,0.00318471337579618
"861610403","SANTIAGO DEL ESTERO",119,1,12,61,13,86,0.00840336134453781
"861610405","SANTIAGO DEL ESTERO",120,0,7,73,14,94,0
"860491216","SANTIAGO DEL ESTERO",286,277,4,2,0,6,0.968531468531469
"861330302","SANTIAGO DEL ESTERO",85,0,3,13,23,39,0
"861820301","SANTIAGO DEL ESTERO",73,0,2,19,28,49,0
"861890203","SANTIAGO DEL ESTERO",9,0,0,4,5,9,0
"860351002","SANTIAGO DEL ESTERO",194,0,18,38,76,132,0
"220211402","CHACO",34,1,16,12,0,28,0.0294117647058824
"861330702","SANTIAGO DEL ESTERO",139,0,2,58,48,108,0
"861540103","SANTIAGO DEL ESTERO",14,0,8,5,1,14,0
"861610101","SANTIAGO DEL ESTERO",154,0,26,57,15,98,0
"861190503","SANTIAGO DEL ESTERO",159,0,2,32,112,146,0
"860491406","SANTIAGO DEL ESTERO",281,149,62,65,0,127,0.530249110320285
"860491810","SANTIAGO DEL ESTERO",294,2,238,54,0,292,0.00680272108843537
"860491913","SANTIAGO DEL ESTERO",186,174,11,1,0,12,0.935483870967742
"860560315","SANTIAGO DEL ESTERO",272,0,68,139,36,243,0
"860351406","SANTIAGO DEL ESTERO",273,150,43,66,0,109,0.549450549450549
"860351503","SANTIAGO DEL ESTERO",250,19,138,85,7,230,0.076
"860490805","SANTIAGO DEL ESTERO",203,202,1,0,0,1,0.995073891625616
"860490818","SANTIAGO DEL ESTERO",205,4,120,75,2,197,0.0195121951219512
"860491201","SANTIAGO DEL ESTERO",220,208,9,2,0,11,0.945454545454545
"860491603","SANTIAGO DEL ESTERO",297,68,125,87,6,218,0.228956228956229
"860700203","SANTIAGO DEL ESTERO",194,0,83,85,18,186,0
"861120203","SANTIAGO DEL ESTERO",164,0,70,65,12,147,0
"860350707","SANTIAGO DEL ESTERO",255,12,123,101,5,229,0.0470588235294118
"860280410","SANTIAGO DEL ESTERO",249,0,121,96,3,220,0
"900840903","TUCUMAN",217,214,0,1,0,1,0.986175115207373
"860280408","SANTIAGO DEL ESTERO",419,0,191,174,13,378,0
"860351205","SANTIAGO DEL ESTERO",416,2,173,134,20,327,0.00480769230769231
"860351207","SANTIAGO DEL ESTERO",424,4,279,114,15,408,0.00943396226415094
"860351305","SANTIAGO DEL ESTERO",184,105,65,11,0,76,0.570652173913043
"860351308","SANTIAGO DEL ESTERO",453,4,228,187,20,435,0.00883002207505519
"860351602","SANTIAGO DEL ESTERO",232,226,3,2,0,5,0.974137931034483
"860351610","SANTIAGO DEL ESTERO",400,279,54,47,1,102,0.6975
"860420207","SANTIAGO DEL ESTERO",391,0,179,177,18,374,0
"860491510","SANTIAGO DEL ESTERO",272,0,197,68,3,268,0
"860491204","SANTIAGO DEL ESTERO",256,29,126,98,1,225,0.11328125
"540282018","MISIONES",231,2,188,41,0,229,0.00865800865800866
"860490801","SANTIAGO DEL ESTERO",321,5,219,80,7,306,0.0155763239875389
"860490808","SANTIAGO DEL ESTERO",183,136,38,7,2,47,0.743169398907104
"860490902","SANTIAGO DEL ESTERO",218,130,76,9,0,85,0.596330275229358
"860490921","SANTIAGO DEL ESTERO",189,182,5,2,0,7,0.962962962962963
"860490907","SANTIAGO DEL ESTERO",172,170,0,1,0,1,0.988372093023256
"860490910","SANTIAGO DEL ESTERO",117,117,0,0,0,0,1
"860490912","SANTIAGO DEL ESTERO",165,164,1,0,0,1,0.993939393939394
"860490914","SANTIAGO DEL ESTERO",210,209,1,0,0,1,0.995238095238095
"860491017","SANTIAGO DEL ESTERO",385,195,81,88,10,179,0.506493506493506
"860491103","SANTIAGO DEL ESTERO",367,80,139,112,11,262,0.217983651226158
"860491104","SANTIAGO DEL ESTERO",218,23,151,43,1,195,0.105504587155963
"860491110","SANTIAGO DEL ESTERO",271,261,5,5,0,10,0.96309963099631
"860491706","SANTIAGO DEL ESTERO",282,1,145,111,3,259,0.00354609929078014
"860560314","SANTIAGO DEL ESTERO",217,0,40,94,50,184,0
"860491414","SANTIAGO DEL ESTERO",198,18,116,48,2,166,0.0909090909090909
"860491501","SANTIAGO DEL ESTERO",287,14,202,60,3,265,0.0487804878048781
"860491506","SANTIAGO DEL ESTERO",348,1,164,159,2,325,0.0028735632183908
"860491604","SANTIAGO DEL ESTERO",349,62,187,87,3,277,0.177650429799427
"860491615","SANTIAGO DEL ESTERO",330,110,37,151,22,210,0.333333333333333
"860491701","SANTIAGO DEL ESTERO",177,3,68,64,28,160,0.0169491525423729
"860491813","SANTIAGO DEL ESTERO",233,135,56,23,9,88,0.579399141630901
"860491903","SANTIAGO DEL ESTERO",433,408,0,0,0,0,0.942263279445728
"660280620","SALTA",252,248,4,0,0,4,0.984126984126984
"900841020","TUCUMAN",303,293,2,8,0,10,0.966996699669967
"860560308","SANTIAGO DEL ESTERO",305,0,161,90,18,269,0
"860560504","SANTIAGO DEL ESTERO",267,0,97,82,59,238,0
"860770510","SANTIAGO DEL ESTERO",173,0,116,43,1,160,0
"860770511","SANTIAGO DEL ESTERO",205,0,153,48,2,203,0
"860770505","SANTIAGO DEL ESTERO",317,0,161,113,12,286,0
"860770508","SANTIAGO DEL ESTERO",323,0,239,74,2,315,0
"860840409","SANTIAGO DEL ESTERO",203,0,123,62,5,190,0
"861190407","SANTIAGO DEL ESTERO",296,0,235,47,7,289,0
"861260310","SANTIAGO DEL ESTERO",494,0,377,86,10,473,0
"861400210","SANTIAGO DEL ESTERO",241,0,195,42,3,240,0
"861470804","SANTIAGO DEL ESTERO",194,191,1,1,0,2,0.984536082474227
"861470812","SANTIAGO DEL ESTERO",260,204,8,34,6,48,0.784615384615385
"861470816","SANTIAGO DEL ESTERO",206,180,16,7,0,23,0.87378640776699
"861470907","SANTIAGO DEL ESTERO",64,62,2,0,0,2,0.96875
"861610203","SANTIAGO DEL ESTERO",304,9,134,90,13,237,0.0296052631578947
"861820206","SANTIAGO DEL ESTERO",343,0,113,155,44,312,0
"860560204","SANTIAGO DEL ESTERO",97,0,0,15,57,72,0
"860770302","SANTIAGO DEL ESTERO",205,0,74,105,19,198,0
"860840405","SANTIAGO DEL ESTERO",89,0,31,49,2,82,0
"861190303","SANTIAGO DEL ESTERO",115,0,12,25,35,72,0
"861190404","SANTIAGO DEL ESTERO",329,0,41,104,115,260,0
"540210513","MISIONES",200,6,148,22,18,188,0.03
"861330303","SANTIAGO DEL ESTERO",138,0,5,49,32,86,0
"861470102","SANTIAGO DEL ESTERO",307,1,51,191,46,288,0.00325732899022801
"861470402","SANTIAGO DEL ESTERO",123,0,48,57,8,113,0
"861470701","SANTIAGO DEL ESTERO",42,0,1,20,19,40,0
"861470704","SANTIAGO DEL ESTERO",237,0,13,148,46,207,0
"861610202","SANTIAGO DEL ESTERO",42,1,12,5,14,31,0.0238095238095238
"860351004","SANTIAGO DEL ESTERO",189,0,21,59,53,133,0
"861610311","SANTIAGO DEL ESTERO",206,8,144,41,9,194,0.0388349514563107
"860490810","SANTIAGO DEL ESTERO",322,14,235,73,0,308,0.0434782608695652
"860490812","SANTIAGO DEL ESTERO",405,8,301,91,1,393,0.0197530864197531
"860770608","SANTIAGO DEL ESTERO",351,0,148,163,11,322,0
"860070101","SANTIAGO DEL ESTERO",38,0,4,17,17,38,0
"860140301","SANTIAGO DEL ESTERO",59,0,6,23,4,33,0
"860280501","SANTIAGO DEL ESTERO",146,0,11,64,58,133,0
"860350202","SANTIAGO DEL ESTERO",28,0,1,4,9,14,0
"860280301","SANTIAGO DEL ESTERO",181,0,0,67,61,128,0
"860280402","SANTIAGO DEL ESTERO",58,0,3,26,6,35,0
"860280406","SANTIAGO DEL ESTERO",244,0,9,85,55,149,0
"860350503","SANTIAGO DEL ESTERO",67,0,0,26,18,44,0
"860700101","SANTIAGO DEL ESTERO",118,0,3,26,25,54,0
"860700301","SANTIAGO DEL ESTERO",43,0,0,6,26,32,0
"860700502","SANTIAGO DEL ESTERO",139,0,0,44,74,118,0
"860840202","SANTIAGO DEL ESTERO",47,0,0,19,22,41,0
"860910402","SANTIAGO DEL ESTERO",69,0,2,19,25,46,0
"860980102","SANTIAGO DEL ESTERO",17,0,0,3,6,9,0
"860980103","SANTIAGO DEL ESTERO",122,0,4,38,67,109,0
"860980303","SANTIAGO DEL ESTERO",12,0,2,6,0,8,0
"860980304","SANTIAGO DEL ESTERO",19,0,0,2,16,18,0
"860980203","SANTIAGO DEL ESTERO",40,0,0,6,27,33,0
"861050302","SANTIAGO DEL ESTERO",162,0,8,62,52,122,0
"861120201","SANTIAGO DEL ESTERO",73,0,3,42,15,60,0
"861260204","SANTIAGO DEL ESTERO",91,0,15,33,30,78,0
"900840902","TUCUMAN",290,284,4,1,1,6,0.979310344827586
"861050204","SANTIAGO DEL ESTERO",407,0,20,146,151,317,0
"860070204","SANTIAGO DEL ESTERO",6,0,5,1,0,6,0
"861190402","SANTIAGO DEL ESTERO",22,0,5,7,10,22,0
"861330401","SANTIAGO DEL ESTERO",58,0,2,15,23,40,0
"861330405","SANTIAGO DEL ESTERO",53,0,5,24,8,37,0
"861330801","SANTIAGO DEL ESTERO",70,0,3,30,11,44,0
"860910104","SANTIAGO DEL ESTERO",84,0,6,55,12,73,0
"861400204","SANTIAGO DEL ESTERO",127,0,6,16,82,104,0
"861540202","SANTIAGO DEL ESTERO",60,0,27,24,8,59,0
"860140501","SANTIAGO DEL ESTERO",39,0,10,7,12,29,0
"861610302","SANTIAGO DEL ESTERO",307,1,22,100,105,227,0.00325732899022801
"860491611","SANTIAGO DEL ESTERO",245,245,0,0,0,0,1
"860560405","SANTIAGO DEL ESTERO",347,0,147,77,56,280,0
"861680202","SANTIAGO DEL ESTERO",205,0,6,85,97,188,0
"861820102","SANTIAGO DEL ESTERO",34,0,4,8,19,31,0
"861820302","SANTIAGO DEL ESTERO",63,0,3,17,33,53,0
"860351003","SANTIAGO DEL ESTERO",52,0,1,25,12,38,0
"860350706","SANTIAGO DEL ESTERO",96,0,20,50,9,79,0
"860491806","SANTIAGO DEL ESTERO",238,9,152,42,0,194,0.0378151260504202
"540210511","MISIONES",237,9,167,45,12,224,0.0379746835443038
"860491712","SANTIAGO DEL ESTERO",449,13,256,152,2,410,0.0289532293986637
"860351405","SANTIAGO DEL ESTERO",366,7,211,113,6,330,0.0191256830601093
"860351408","SANTIAGO DEL ESTERO",305,8,234,48,3,285,0.0262295081967213
"860351409","SANTIAGO DEL ESTERO",289,262,14,11,2,27,0.906574394463668
"860351413","SANTIAGO DEL ESTERO",260,193,41,17,1,59,0.742307692307692
"860351501","SANTIAGO DEL ESTERO",258,232,16,7,0,23,0.89922480620155
"860351416","SANTIAGO DEL ESTERO",237,94,33,89,1,123,0.39662447257384
"100070104","CATAMARCA",92,0,84,8,0,92,0
"100070404","CATAMARCA",106,0,73,33,0,106,0
"660282010","SALTA",215,205,4,3,0,7,0.953488372093023
"100140401","CATAMARCA",27,0,8,16,2,26,0
"100070101","CATAMARCA",15,0,11,2,0,13,0
"100070102","CATAMARCA",51,0,31,20,0,51,0
"100070105","CATAMARCA",120,0,95,25,0,120,0
"100070201","CATAMARCA",160,0,118,39,2,159,0
"100070202","CATAMARCA",83,0,53,30,0,83,0
"100070203","CATAMARCA",34,0,13,18,0,31,0
"100070204","CATAMARCA",89,0,41,31,2,74,0
"100140103","CATAMARCA",24,0,4,9,3,16,0
"100070301","CATAMARCA",113,0,54,42,1,97,0
"100070302","CATAMARCA",36,0,9,17,0,26,0
"100070401","CATAMARCA",23,0,2,16,0,18,0
"100070402","CATAMARCA",31,0,18,8,0,26,0
"100140402","CATAMARCA",27,0,15,7,3,25,0
"100070403","CATAMARCA",3,0,1,2,0,3,0
"100070405","CATAMARCA",13,0,2,9,0,11,0
"100070406","CATAMARCA",84,0,61,22,0,83,0
"100070407","CATAMARCA",83,0,48,35,0,83,0
"100070408","CATAMARCA",82,0,45,37,0,82,0
"100070409","CATAMARCA",50,0,28,21,0,49,0
"100140101","CATAMARCA",97,0,60,30,7,97,0
"100140102","CATAMARCA",23,0,2,16,2,20,0
"100350401","CATAMARCA",110,1,33,55,14,102,0.00909090909090909
"100140104","CATAMARCA",19,0,1,2,0,3,0
"100140201","CATAMARCA",92,0,53,23,2,78,0
"100140202","CATAMARCA",32,0,9,19,1,29,0
"100140301","CATAMARCA",34,0,0,25,1,26,0
"100140302","CATAMARCA",10,0,5,3,1,9,0
"100140303","CATAMARCA",9,0,0,1,0,1,0
"100490109","CATAMARCA",197,134,6,15,0,21,0.680203045685279
"100140501","CATAMARCA",24,0,11,11,0,22,0
"100140502","CATAMARCA",39,0,8,16,5,29,0
"100140503","CATAMARCA",46,0,15,12,1,28,0
"100140601","CATAMARCA",29,0,15,11,0,26,0
"100140602","CATAMARCA",25,0,2,21,1,24,0
"100140701","CATAMARCA",59,0,36,12,4,52,0
"100140702","CATAMARCA",19,0,1,10,1,12,0
"100350402","CATAMARCA",43,0,6,17,3,26,0
"100140801","CATAMARCA",32,0,12,9,2,23,0
"100140802","CATAMARCA",31,0,16,7,0,23,0
"100140803","CATAMARCA",29,0,18,4,0,22,0
"100140901","CATAMARCA",29,0,15,11,0,26,0
"900841806","TUCUMAN",357,340,6,10,0,16,0.952380952380952
"900140706","TUCUMAN",151,8,55,77,1,133,0.0529801324503311
"100140902","CATAMARCA",30,0,6,6,2,14,0
"100210101","CATAMARCA",95,1,52,35,0,87,0.0105263157894737
"100210104","CATAMARCA",321,105,163,46,1,210,0.327102803738318
"100210105","CATAMARCA",313,16,229,64,0,293,0.0511182108626198
"100210106","CATAMARCA",268,47,149,71,0,220,0.175373134328358
"901050506","TUCUMAN",297,12,250,31,1,282,0.0404040404040404
"100490111","CATAMARCA",462,59,134,158,41,333,0.127705627705628
"100210102","CATAMARCA",4,0,0,0,0,0,0
"100490115","CATAMARCA",299,294,2,3,0,5,0.983277591973244
"100210103","CATAMARCA",436,7,331,69,0,400,0.0160550458715596
"100490112","CATAMARCA",393,325,29,4,0,33,0.826972010178117
"100210107","CATAMARCA",330,0,222,88,0,310,0
"100210108","CATAMARCA",253,19,170,58,3,231,0.075098814229249
"100210109","CATAMARCA",241,15,186,39,0,225,0.0622406639004149
"100210110","CATAMARCA",317,196,85,33,0,118,0.618296529968454
"100490219","CATAMARCA",302,262,20,5,1,26,0.867549668874172
"100210111","CATAMARCA",325,9,210,90,2,302,0.0276923076923077
"100350501","CATAMARCA",117,0,27,80,1,108,0
"100210112","CATAMARCA",236,2,175,53,0,228,0.00847457627118644
"100210113","CATAMARCA",217,1,162,36,4,202,0.00460829493087558
"100210501","CATAMARCA",27,0,4,7,4,15,0
"100490213","CATAMARCA",183,180,0,0,0,0,0.983606557377049
"100210201","CATAMARCA",6,0,2,1,1,4,0
"100211005","CATAMARCA",99,0,63,32,3,98,0
"100210202","CATAMARCA",273,91,77,88,3,168,0.333333333333333
"100210301","CATAMARCA",71,0,34,24,0,58,0
"100210401","CATAMARCA",103,0,43,48,2,93,0
"100350502","CATAMARCA",143,0,76,37,9,122,0
"100210601","CATAMARCA",16,0,0,7,4,11,0
"100211006","CATAMARCA",72,0,49,23,0,72,0
"100490307","CATAMARCA",227,207,7,7,0,14,0.911894273127753
"900841501","TUCUMAN",265,245,10,4,0,14,0.924528301886792
"100210701","CATAMARCA",48,0,28,17,1,46,0
"100210801","CATAMARCA",51,0,18,21,3,42,0
"100210901","CATAMARCA",25,0,3,12,5,20,0
"100210902","CATAMARCA",53,0,7,33,4,44,0
"100350108","CATAMARCA",265,210,24,16,1,41,0.792452830188679
"100420105","CATAMARCA",228,0,149,61,0,210,0
"100490514","CATAMARCA",176,159,9,7,0,16,0.903409090909091
"100211001","CATAMARCA",153,1,65,68,2,135,0.0065359477124183
"100211002","CATAMARCA",73,0,9,50,2,61,0
"100211003","CATAMARCA",90,0,40,47,0,87,0
"100211004","CATAMARCA",91,0,52,35,0,87,0
"100350109","CATAMARCA",218,174,17,24,1,42,0.798165137614679
"100280101","CATAMARCA",75,1,27,34,4,65,0.0133333333333333
"100350115","CATAMARCA",242,160,13,45,0,58,0.661157024793388
"100490317","CATAMARCA",374,361,11,2,0,13,0.96524064171123
"900842101","TUCUMAN",169,169,0,0,0,0,1
"100280201","CATAMARCA",49,0,3,17,10,30,0
"100280202","CATAMARCA",199,96,24,54,16,94,0.482412060301508
"100280301","CATAMARCA",18,0,1,9,1,11,0
"100350110","CATAMARCA",240,185,35,16,2,53,0.770833333333333
"100350508","CATAMARCA",284,4,106,121,16,243,0.0140845070422535
"100280302","CATAMARCA",24,0,3,6,14,23,0
"100350101","CATAMARCA",275,26,92,118,6,216,0.0945454545454545
"100350102","CATAMARCA",20,1,0,2,3,5,0.05
"100350202","CATAMARCA",29,1,3,8,10,21,0.0344827586206897
"100490214","CATAMARCA",219,219,0,0,0,0,1
"100350103","CATAMARCA",281,223,23,22,1,46,0.793594306049822
"100350104","CATAMARCA",203,189,4,7,1,12,0.931034482758621
"100350105","CATAMARCA",357,340,10,4,0,14,0.952380952380952
"100350106","CATAMARCA",314,268,16,15,0,31,0.853503184713376
"100350107","CATAMARCA",196,156,6,10,1,17,0.795918367346939
"100350304","CATAMARCA",55,1,9,38,5,52,0.0181818181818182
"100350111","CATAMARCA",204,71,32,47,1,80,0.348039215686274
"100350112","CATAMARCA",329,293,20,12,1,33,0.890577507598784
"100350113","CATAMARCA",276,240,10,9,0,19,0.869565217391304
"100350114","CATAMARCA",201,178,7,11,4,22,0.885572139303483
"100350305","CATAMARCA",70,1,21,44,1,66,0.0142857142857143
"100350201","CATAMARCA",82,1,27,42,3,72,0.0121951219512195
"100350306","CATAMARCA",160,6,64,56,10,130,0.0375
"300210714","ENTRE RIOS",248,247,1,0,0,1,0.995967741935484
"100490113","CATAMARCA",442,356,58,18,0,76,0.805429864253394
"100350203","CATAMARCA",27,0,3,16,2,21,0
"100350204","CATAMARCA",303,60,102,123,9,234,0.198019801980198
"100350205","CATAMARCA",177,75,45,36,0,81,0.423728813559322
"100350206","CATAMARCA",173,87,28,52,1,81,0.502890173410405
"100350301","CATAMARCA",73,0,38,29,1,68,0
"100350302","CATAMARCA",34,0,27,5,1,33,0
"100350303","CATAMARCA",75,0,27,37,6,70,0
"100350503","CATAMARCA",190,0,107,32,11,150,0
"100350504","CATAMARCA",13,0,0,3,4,7,0
"100350604","CATAMARCA",59,0,6,14,8,28,0
"100350605","CATAMARCA",108,0,21,38,1,60,0
"100350505","CATAMARCA",43,0,0,4,11,15,0
"100350506","CATAMARCA",58,0,3,1,16,20,0
"100350507","CATAMARCA",13,0,0,3,1,4,0
"100490215","CATAMARCA",203,203,0,0,0,0,1
"100350601","CATAMARCA",63,36,6,14,1,21,0.571428571428571
"100350602","CATAMARCA",49,0,8,35,2,45,0
"100350603","CATAMARCA",58,1,25,14,2,41,0.0172413793103448
"100490110","CATAMARCA",397,184,108,88,5,201,0.463476070528967
"100350606","CATAMARCA",138,1,65,45,5,115,0.0072463768115942
"100350607","CATAMARCA",119,0,11,10,21,42,0
"100350608","CATAMARCA",248,0,143,64,9,216,0
"100420101","CATAMARCA",25,0,13,7,2,22,0
"100420103","CATAMARCA",178,0,129,36,4,169,0
"100490314","CATAMARCA",266,249,11,6,0,17,0.93609022556391
"100420102","CATAMARCA",58,0,32,14,3,49,0
"100420104","CATAMARCA",193,0,156,36,0,192,0
"100490315","CATAMARCA",274,258,13,3,0,16,0.941605839416058
"100420106","CATAMARCA",254,0,177,53,8,238,0
"100420107","CATAMARCA",233,0,172,58,1,231,0
"100420201","CATAMARCA",44,0,25,16,0,41,0
"100420202","CATAMARCA",165,0,84,62,2,148,0
"100420501","CATAMARCA",21,0,16,5,0,21,0
"100490114","CATAMARCA",370,331,17,20,0,37,0.894594594594595
"100420203","CATAMARCA",16,0,9,5,1,15,0
"100420204","CATAMARCA",85,0,42,24,4,70,0
"100420205","CATAMARCA",78,0,46,27,2,75,0
"100420206","CATAMARCA",217,0,186,22,1,209,0
"100420502","CATAMARCA",85,0,49,32,0,81,0
"100490316","CATAMARCA",187,181,3,3,0,6,0.967914438502674
"100420207","CATAMARCA",358,0,258,75,5,338,0
"100420301","CATAMARCA",172,0,121,42,2,165,0
"100420302","CATAMARCA",194,0,142,28,4,174,0
"100420303","CATAMARCA",323,0,247,71,1,319,0
"100420304","CATAMARCA",51,0,18,18,0,36,0
"100420305","CATAMARCA",225,0,167,43,2,212,0
"100420306","CATAMARCA",254,0,182,51,3,236,0
"100420601","CATAMARCA",12,0,4,7,1,12,0
"100420307","CATAMARCA",28,0,26,2,0,28,0
"100420401","CATAMARCA",100,0,36,56,0,92,0
"100420402","CATAMARCA",110,0,65,42,0,107,0
"100490107","CATAMARCA",222,214,8,0,0,8,0.963963963963964
"100490108","CATAMARCA",243,208,32,1,0,33,0.8559670781893
"100420602","CATAMARCA",118,0,86,25,1,112,0
"100420603","CATAMARCA",39,0,24,9,2,35,0
"100420604","CATAMARCA",63,0,25,20,4,49,0
"100490101","CATAMARCA",65,30,1,10,0,11,0.461538461538462
"100490102","CATAMARCA",462,10,323,94,0,417,0.0216450216450216
"100490103","CATAMARCA",298,232,20,16,0,36,0.778523489932886
"100490104","CATAMARCA",172,166,1,0,0,1,0.965116279069767
"100490105","CATAMARCA",328,323,2,0,0,2,0.984756097560976
"100490106","CATAMARCA",274,265,8,1,0,9,0.967153284671533
"900840612","TUCUMAN",129,89,9,31,0,40,0.689922480620155
"100490201","CATAMARCA",282,50,152,36,1,189,0.177304964539007
"100490202","CATAMARCA",262,204,40,15,1,56,0.778625954198473
"100490203","CATAMARCA",304,199,27,65,2,94,0.654605263157895
"100490204","CATAMARCA",273,254,16,2,0,18,0.93040293040293
"100490318","CATAMARCA",197,186,9,2,0,11,0.944162436548223
"100490205","CATAMARCA",269,203,19,44,0,63,0.754646840148699
"100490206","CATAMARCA",198,184,14,0,0,14,0.929292929292929
"100490207","CATAMARCA",384,330,15,10,0,25,0.859375
"100490208","CATAMARCA",371,353,7,0,0,7,0.951482479784367
"100490209","CATAMARCA",292,290,1,0,0,1,0.993150684931507
"100490210","CATAMARCA",229,227,2,0,0,2,0.991266375545852
"100490211","CATAMARCA",187,169,10,3,0,13,0.903743315508021
"100490212","CATAMARCA",210,210,0,0,0,0,1
"100490216","CATAMARCA",391,385,3,2,0,5,0.9846547314578
"100490217","CATAMARCA",290,283,7,0,0,7,0.975862068965517
"100490218","CATAMARCA",224,214,8,2,0,10,0.955357142857143
"900141611","TUCUMAN",236,182,28,22,0,50,0.771186440677966
"100490220","CATAMARCA",147,117,11,19,0,30,0.795918367346939
"100490221","CATAMARCA",182,167,11,4,0,15,0.917582417582418
"100490301","CATAMARCA",356,346,5,5,0,10,0.971910112359551
"100490302","CATAMARCA",265,225,5,0,0,5,0.849056603773585
"100490303","CATAMARCA",306,258,36,9,0,45,0.843137254901961
"100490304","CATAMARCA",277,220,43,13,0,56,0.794223826714801
"100490319","CATAMARCA",292,285,6,1,0,7,0.976027397260274
"740560709","SAN LUIS",298,292,6,0,0,6,0.979865771812081
"100490305","CATAMARCA",258,229,10,18,0,28,0.887596899224806
"100490306","CATAMARCA",255,188,42,22,0,64,0.737254901960784
"100490710","CATAMARCA",287,251,13,17,1,31,0.874564459930314
"100490308","CATAMARCA",317,308,1,2,1,4,0.971608832807571
"100490309","CATAMARCA",425,346,19,49,3,71,0.814117647058824
"100490310","CATAMARCA",209,194,8,6,0,14,0.92822966507177
"100490311","CATAMARCA",385,364,8,9,0,17,0.945454545454545
"100490312","CATAMARCA",252,247,3,2,0,5,0.98015873015873
"100490313","CATAMARCA",204,196,5,1,0,6,0.96078431372549
"380211311","JUJUY",319,247,43,2,0,45,0.774294670846395
"100490320","CATAMARCA",320,301,5,4,0,9,0.940625
"100490321","CATAMARCA",175,167,8,0,0,8,0.954285714285714
"100490322","CATAMARCA",136,136,0,0,0,0,1
"100490323","CATAMARCA",176,176,0,0,0,0,1
"100490324","CATAMARCA",232,223,8,1,0,9,0.961206896551724
"100490401","CATAMARCA",216,214,1,0,0,1,0.990740740740741
"100490402","CATAMARCA",204,203,1,0,0,1,0.995098039215686
"100490403","CATAMARCA",242,238,3,1,0,4,0.983471074380165
"100490404","CATAMARCA",355,265,43,14,0,57,0.746478873239437
"100490405","CATAMARCA",302,219,52,27,0,79,0.725165562913907
"100490406","CATAMARCA",324,240,42,33,0,75,0.740740740740741
"100490510","CATAMARCA",344,276,40,10,1,51,0.802325581395349
"100490407","CATAMARCA",378,252,54,40,0,94,0.666666666666667
"100490711","CATAMARCA",311,284,19,3,0,22,0.913183279742765
"100490408","CATAMARCA",235,216,11,1,0,12,0.919148936170213
"100490409","CATAMARCA",384,339,33,7,0,40,0.8828125
"100490410","CATAMARCA",274,198,58,17,0,75,0.722627737226277
"100490411","CATAMARCA",289,170,64,30,0,94,0.588235294117647
"100490511","CATAMARCA",217,204,9,3,0,12,0.940092165898618
"100490513","CATAMARCA",439,271,51,102,3,156,0.617312072892939
"100490412","CATAMARCA",261,178,50,33,0,83,0.681992337164751
"100490413","CATAMARCA",245,197,28,16,3,47,0.804081632653061
"100490414","CATAMARCA",246,105,107,32,0,139,0.426829268292683
"100490415","CATAMARCA",286,203,52,25,1,78,0.70979020979021
"100490416","CATAMARCA",372,338,17,5,0,22,0.908602150537634
"100490417","CATAMARCA",216,214,2,0,0,2,0.990740740740741
"100490512","CATAMARCA",398,315,18,50,1,69,0.791457286432161
"100490515","CATAMARCA",422,311,39,60,1,100,0.73696682464455
"100490418","CATAMARCA",289,278,8,2,1,11,0.961937716262976
"100490419","CATAMARCA",329,281,22,20,0,42,0.854103343465046
"100490501","CATAMARCA",244,227,1,3,0,4,0.930327868852459
"100490502","CATAMARCA",207,178,1,0,0,1,0.859903381642512
"100490503","CATAMARCA",209,183,11,14,0,25,0.875598086124402
"100490504","CATAMARCA",208,180,15,11,1,27,0.865384615384615
"100490505","CATAMARCA",262,200,35,21,1,57,0.763358778625954
"100490506","CATAMARCA",212,168,18,20,0,38,0.792452830188679
"100490507","CATAMARCA",211,199,5,5,0,10,0.943127962085308
"100490508","CATAMARCA",296,292,1,3,0,4,0.986486486486487
"100490509","CATAMARCA",236,230,2,3,0,5,0.974576271186441
"100490516","CATAMARCA",403,125,90,148,9,247,0.310173697270471
"100490517","CATAMARCA",167,71,38,44,1,83,0.425149700598802
"100490601","CATAMARCA",293,279,8,5,0,13,0.95221843003413
"100490602","CATAMARCA",204,198,2,4,0,6,0.970588235294118
"100490603","CATAMARCA",211,208,3,0,0,3,0.985781990521327
"100490604","CATAMARCA",177,171,5,0,0,5,0.966101694915254
"100490605","CATAMARCA",207,202,5,0,0,5,0.975845410628019
"100490606","CATAMARCA",264,243,14,7,0,21,0.920454545454545
"100490607","CATAMARCA",321,287,23,10,0,33,0.894080996884735
"100490608","CATAMARCA",153,148,4,0,0,4,0.967320261437909
"100490609","CATAMARCA",284,266,15,3,0,18,0.936619718309859
"100490610","CATAMARCA",239,209,18,7,0,25,0.874476987447699
"100490615","CATAMARCA",369,322,23,14,0,37,0.872628726287263
"100490616","CATAMARCA",289,246,12,30,0,42,0.85121107266436
"100490618","CATAMARCA",292,277,10,3,0,13,0.948630136986301
"100490619","CATAMARCA",225,220,3,1,0,4,0.977777777777778
"100490701","CATAMARCA",290,176,70,38,0,108,0.606896551724138
"100490702","CATAMARCA",204,120,56,28,0,84,0.588235294117647
"100490703","CATAMARCA",251,203,28,19,1,48,0.808764940239044
"100490704","CATAMARCA",241,214,13,12,0,25,0.887966804979253
"100490705","CATAMARCA",187,151,6,3,1,10,0.807486631016043
"100490706","CATAMARCA",378,322,25,27,0,52,0.851851851851852
"100490707","CATAMARCA",437,376,25,28,1,54,0.860411899313501
"900840806","TUCUMAN",273,236,13,15,1,29,0.864468864468865
"100490708","CATAMARCA",277,266,4,5,0,9,0.96028880866426
"100490709","CATAMARCA",279,257,6,13,0,19,0.921146953405018
"100490712","CATAMARCA",387,255,88,36,0,124,0.65891472868217
"100490801","CATAMARCA",168,168,0,0,0,0,1
"100490802","CATAMARCA",260,252,0,0,0,0,0.969230769230769
"100490803","CATAMARCA",347,345,1,0,0,1,0.994236311239193
"100490804","CATAMARCA",233,232,1,0,0,1,0.995708154506438
"100490805","CATAMARCA",288,238,16,27,0,43,0.826388888888889
"100490806","CATAMARCA",219,212,6,0,0,6,0.968036529680365
"900840410","TUCUMAN",247,56,75,113,0,188,0.226720647773279
"100490807","CATAMARCA",284,216,55,12,0,67,0.76056338028169
"100490808","CATAMARCA",420,249,123,34,1,158,0.592857142857143
"100490809","CATAMARCA",249,199,27,16,0,43,0.799196787148594
"100490810","CATAMARCA",350,278,46,23,0,69,0.794285714285714
"100490811","CATAMARCA",268,240,17,11,0,28,0.895522388059702
"100490812","CATAMARCA",191,152,24,12,0,36,0.795811518324607
"100490813","CATAMARCA",438,364,54,19,0,73,0.831050228310502
"100490907","CATAMARCA",282,158,43,69,4,116,0.560283687943262
"100490908","CATAMARCA",235,72,54,105,3,162,0.306382978723404
"100700404","CATAMARCA",278,1,118,138,5,261,0.00359712230215827
"100490909","CATAMARCA",325,152,82,76,5,163,0.467692307692308
"100490901","CATAMARCA",91,2,29,40,8,77,0.021978021978022
"100490902","CATAMARCA",114,4,42,32,10,84,0.0350877192982456
"100490903","CATAMARCA",230,226,2,2,0,4,0.982608695652174
"100490904","CATAMARCA",256,255,1,0,0,1,0.99609375
"100490905","CATAMARCA",148,148,0,0,0,0,1
"100490906","CATAMARCA",423,381,34,8,0,42,0.900709219858156
"900840406","TUCUMAN",286,242,9,28,1,38,0.846153846153846
"100490910","CATAMARCA",253,89,26,113,1,140,0.351778656126482
"100490911","CATAMARCA",219,203,3,0,0,3,0.926940639269406
"100490912","CATAMARCA",303,299,3,1,0,4,0.986798679867987
"100490913","CATAMARCA",269,217,9,13,1,23,0.806691449814126
"100490914","CATAMARCA",306,276,9,10,0,19,0.901960784313726
"100560101","CATAMARCA",10,0,4,0,0,4,0
"100560504","CATAMARCA",56,0,8,23,15,46,0
"100700205","CATAMARCA",114,0,56,43,6,105,0
"900070409","TUCUMAN",300,14,105,151,4,260,0.0466666666666667
"100560102","CATAMARCA",115,0,72,41,0,113,0
"100560103","CATAMARCA",38,0,25,9,0,34,0
"100560104","CATAMARCA",11,0,4,6,0,10,0
"100560201","CATAMARCA",21,0,6,7,3,16,0
"100560202","CATAMARCA",18,0,4,11,0,15,0
"100560601","CATAMARCA",35,0,7,24,1,32,0
"100560203","CATAMARCA",24,0,10,9,1,20,0
"100560204","CATAMARCA",11,0,3,7,1,11,0
"100560205","CATAMARCA",212,0,156,52,0,208,0
"100560301","CATAMARCA",20,0,4,7,2,13,0
"100560302","CATAMARCA",53,0,9,28,5,42,0
"901050911","TUCUMAN",186,180,4,2,0,6,0.967741935483871
"100560303","CATAMARCA",46,0,19,16,1,36,0
"100560304","CATAMARCA",31,0,7,19,0,26,0
"100560401","CATAMARCA",39,0,12,15,0,27,0
"100560502","CATAMARCA",92,0,36,45,3,84,0
"100560503","CATAMARCA",74,0,27,35,2,64,0
"100560602","CATAMARCA",6,0,0,0,3,3,0
"100560402","CATAMARCA",15,0,3,5,2,10,0
"100560403","CATAMARCA",41,0,25,13,1,39,0
"100560501","CATAMARCA",14,0,1,9,2,12,0
"100700109","CATAMARCA",243,54,125,53,3,181,0.222222222222222
"100560603","CATAMARCA",22,0,2,11,7,20,0
"100560701","CATAMARCA",38,0,11,21,3,35,0
"100630101","CATAMARCA",185,158,11,7,0,18,0.854054054054054
"100630102","CATAMARCA",64,2,41,17,0,58,0.03125
"100630103","CATAMARCA",73,0,35,30,1,66,0
"100630201","CATAMARCA",98,0,79,18,0,97,0
"100630202","CATAMARCA",203,3,170,29,0,199,0.0147783251231527
"100630203","CATAMARCA",163,3,108,51,0,159,0.0184049079754601
"900842510","TUCUMAN",264,238,5,10,5,20,0.901515151515151
"100630204","CATAMARCA",228,12,180,20,0,200,0.0526315789473684
"100630205","CATAMARCA",267,3,242,20,0,262,0.0112359550561798
"100630206","CATAMARCA",189,3,175,9,1,185,0.0158730158730159
"100630207","CATAMARCA",197,3,190,4,0,194,0.0152284263959391
"100630208","CATAMARCA",204,0,165,35,0,200,0
"100630209","CATAMARCA",220,11,175,27,0,202,0.05
"100630210","CATAMARCA",202,2,164,20,1,185,0.0099009900990099
"100770201","CATAMARCA",45,1,12,22,1,35,0.0222222222222222
"100630211","CATAMARCA",193,3,171,15,1,187,0.0155440414507772
"100630212","CATAMARCA",223,1,198,18,0,216,0.00448430493273543
"100630213","CATAMARCA",305,2,238,47,3,288,0.00655737704918033
"100630214","CATAMARCA",5,0,3,1,0,4,0
"100630215","CATAMARCA",0,0,0,0,0,0,NA
"100630216","CATAMARCA",0,0,0,0,0,0,NA
"100630217","CATAMARCA",0,0,0,0,0,0,NA
"100630218","CATAMARCA",0,0,0,0,0,0,NA
"100700101","CATAMARCA",36,0,8,10,6,24,0
"100700108","CATAMARCA",285,159,68,24,4,96,0.557894736842105
"900700101","TUCUMAN",109,4,39,56,2,97,0.036697247706422
"100840103","CATAMARCA",200,0,156,37,0,193,0
"100700102","CATAMARCA",42,0,0,16,17,33,0
"100700103","CATAMARCA",378,19,226,108,4,338,0.0502645502645503
"100700104","CATAMARCA",291,46,161,57,2,220,0.15807560137457
"100700105","CATAMARCA",275,128,119,21,3,143,0.465454545454545
"100700106","CATAMARCA",233,36,139,46,2,187,0.15450643776824
"900842306","TUCUMAN",391,341,7,25,0,32,0.872122762148338
"100700107","CATAMARCA",307,187,66,49,0,115,0.609120521172638
"300560111","ENTRE RIOS",344,336,7,1,0,8,0.976744186046512
"100700110","CATAMARCA",387,147,134,78,7,219,0.37984496124031
"100700111","CATAMARCA",296,68,130,83,6,219,0.22972972972973
"100700112","CATAMARCA",290,115,107,51,4,162,0.396551724137931
"100700113","CATAMARCA",191,11,112,62,3,177,0.0575916230366492
"100700201","CATAMARCA",132,0,25,59,3,87,0
"100700202","CATAMARCA",90,0,29,40,7,76,0
"100700203","CATAMARCA",273,2,155,62,0,217,0.00732600732600733
"900842908","TUCUMAN",437,124,95,199,4,298,0.283752860411899
"100700204","CATAMARCA",210,0,63,72,32,167,0
"540281910","MISIONES",262,198,39,24,1,64,0.755725190839695
"100700301","CATAMARCA",266,2,163,78,5,246,0.0075187969924812
"100700302","CATAMARCA",72,0,45,20,0,65,0
"100700303","CATAMARCA",132,0,35,70,2,107,0
"100700307","CATAMARCA",269,8,168,74,10,252,0.0297397769516729
"100700308","CATAMARCA",204,2,143,52,3,198,0.00980392156862745
"100700304","CATAMARCA",24,0,8,3,7,18,0
"100700402","CATAMARCA",50,0,9,29,3,41,0
"100700305","CATAMARCA",278,0,221,47,3,271,0
"100700306","CATAMARCA",262,2,206,48,0,254,0.00763358778625954
"100700309","CATAMARCA",53,0,3,12,25,40,0
"100700401","CATAMARCA",60,0,22,12,17,51,0
"100700403","CATAMARCA",72,0,5,33,16,54,0
"100770101","CATAMARCA",15,0,10,4,1,15,0
"100770102","CATAMARCA",74,1,67,6,0,73,0.0135135135135135
"100770103","CATAMARCA",52,4,30,15,0,45,0.0769230769230769
"100770104","CATAMARCA",194,171,10,8,0,18,0.881443298969072
"100770105","CATAMARCA",215,200,9,5,0,14,0.930232558139535
"100770202","CATAMARCA",75,2,52,15,0,67,0.0266666666666667
"100770203","CATAMARCA",25,0,15,6,0,21,0
"100770301","CATAMARCA",58,0,35,14,0,49,0
"100770603","CATAMARCA",75,0,52,22,1,75,0
"100770401","CATAMARCA",61,1,40,19,1,60,0.0163934426229508
"100770402","CATAMARCA",29,0,16,12,0,28,0
"100770501","CATAMARCA",22,0,3,17,0,20,0
"100770502","CATAMARCA",73,2,32,29,4,65,0.0273972602739726
"100770601","CATAMARCA",96,0,42,53,0,95,0
"100770602","CATAMARCA",43,0,14,27,1,42,0
"100840104","CATAMARCA",190,0,158,30,1,189,0
"100840105","CATAMARCA",185,0,132,42,1,175,0
"100840101","CATAMARCA",174,0,103,59,3,165,0
"100840106","CATAMARCA",190,0,146,25,0,171,0
"900842102","TUCUMAN",329,327,2,0,0,2,0.993920972644377
"100840204","CATAMARCA",137,0,85,50,0,135,0
"100910107","CATAMARCA",275,185,45,21,1,67,0.672727272727273
"100840201","CATAMARCA",24,0,16,4,1,21,0
"100840303","CATAMARCA",139,0,77,53,0,130,0
"100910111","CATAMARCA",293,159,89,41,1,131,0.542662116040956
"900841215","TUCUMAN",172,168,0,0,0,0,0.976744186046512
"100840102","CATAMARCA",12,0,4,7,0,11,0
"100840202","CATAMARCA",138,0,78,53,0,131,0
"100840203","CATAMARCA",155,0,101,51,1,153,0
"100840301","CATAMARCA",12,0,5,6,1,12,0
"100840302","CATAMARCA",30,0,5,0,11,16,0
"100840304","CATAMARCA",287,0,166,95,10,271,0
"100840305","CATAMARCA",127,0,102,12,4,118,0
"100840403","CATAMARCA",95,0,73,19,0,92,0
"100840306","CATAMARCA",204,0,160,36,1,197,0
"100840307","CATAMARCA",246,0,195,41,1,237,0
"100910109","CATAMARCA",317,204,62,40,4,106,0.643533123028391
"100910110","CATAMARCA",273,263,5,5,0,10,0.963369963369963
"100910405","CATAMARCA",11,0,0,2,4,6,0
"100840401","CATAMARCA",176,0,113,46,7,166,0
"100840402","CATAMARCA",18,0,14,4,0,18,0
"100910101","CATAMARCA",5,0,1,1,0,2,0
"100980101","CATAMARCA",102,0,40,52,8,100,0
"100910102","CATAMARCA",81,52,10,8,6,24,0.641975308641975
"100910103","CATAMARCA",236,76,85,50,4,139,0.322033898305085
"100910104","CATAMARCA",263,187,40,27,4,71,0.711026615969582
"100910105","CATAMARCA",273,212,37,10,0,47,0.776556776556777
"100910106","CATAMARCA",201,135,41,24,0,65,0.671641791044776
"300560302","ENTRE RIOS",119,119,0,0,0,0,1
"100910108","CATAMARCA",386,114,123,126,14,263,0.295336787564767
"540980604","MISIONES",25,0,4,10,11,25,0
"100910112","CATAMARCA",203,19,64,82,7,153,0.0935960591133005
"100910113","CATAMARCA",208,119,41,26,6,73,0.572115384615385
"100910114","CATAMARCA",216,3,119,56,22,197,0.0138888888888889
"100910115","CATAMARCA",136,98,19,15,1,35,0.720588235294118
"100910201","CATAMARCA",125,4,57,52,7,116,0.032
"100910202","CATAMARCA",53,0,32,14,3,49,0
"100910301","CATAMARCA",1,0,0,0,0,0,0
"100910302","CATAMARCA",215,5,82,73,33,188,0.0232558139534884
"100910303","CATAMARCA",219,3,135,51,28,214,0.0136986301369863
"100910401","CATAMARCA",7,0,0,3,2,5,0
"100910402","CATAMARCA",0,0,0,0,0,0,NA
"100910504","CATAMARCA",172,2,94,55,3,152,0.0116279069767442
"100910403","CATAMARCA",379,1,235,109,24,368,0.00263852242744063
"100910404","CATAMARCA",117,0,46,59,5,110,0
"900842907","TUCUMAN",256,83,97,70,0,167,0.32421875
"100910501","CATAMARCA",161,1,44,62,43,149,0.0062111801242236
"100910502","CATAMARCA",182,0,68,56,38,162,0
"100910503","CATAMARCA",162,2,94,38,13,145,0.0123456790123457
"100910505","CATAMARCA",257,0,87,134,17,238,0
"100910506","CATAMARCA",33,0,9,0,13,22,0
"100980102","CATAMARCA",210,0,110,94,2,206,0
"100910507","CATAMARCA",111,0,20,47,23,90,0
"100910508","CATAMARCA",76,0,13,35,20,68,0
"100910509","CATAMARCA",69,0,38,11,6,55,0
"100910510","CATAMARCA",19,0,4,4,9,17,0
"100980103","CATAMARCA",8,0,3,5,0,8,0
"900842301","TUCUMAN",220,201,7,8,0,15,0.913636363636364
"100910511","CATAMARCA",1,0,0,0,1,1,0
"100980204","CATAMARCA",51,0,23,19,3,45,0
"901190420","TUCUMAN",270,46,109,98,8,215,0.17037037037037
"100910703","CATAMARCA",23,0,0,4,16,20,0
"540420306","MISIONES",287,44,234,7,2,243,0.153310104529617
"100910601","CATAMARCA",55,1,2,13,24,39,0.0181818181818182
"100910602","CATAMARCA",26,0,0,2,17,19,0
"100980205","CATAMARCA",165,0,133,28,1,162,0
"100910603","CATAMARCA",44,0,0,9,24,33,0
"100910604","CATAMARCA",21,0,0,4,2,6,0
"100910701","CATAMARCA",15,0,0,0,13,13,0
"100910702","CATAMARCA",62,0,6,1,34,41,0
"100980404","CATAMARCA",390,0,343,43,2,388,0
"100980104","CATAMARCA",68,0,5,34,10,49,0
"100980201","CATAMARCA",34,0,9,21,2,32,0
"100980202","CATAMARCA",27,0,4,18,2,24,0
"100980203","CATAMARCA",200,0,117,72,3,192,0
"100980206","CATAMARCA",152,0,92,53,3,148,0
"100980207","CATAMARCA",70,0,18,40,4,62,0
"101050114","CATAMARCA",306,166,97,37,3,137,0.542483660130719
"100980208","CATAMARCA",44,0,14,23,0,37,0
"100980301","CATAMARCA",49,0,18,25,2,45,0
"100980302","CATAMARCA",31,0,13,10,0,23,0
"100980405","CATAMARCA",309,0,189,81,7,277,0
"101050113","CATAMARCA",153,0,72,44,6,122,0
"100980303","CATAMARCA",123,0,54,48,1,103,0
"100980401","CATAMARCA",74,0,30,36,3,69,0
"100980402","CATAMARCA",225,0,178,40,3,221,0
"100980403","CATAMARCA",191,0,137,39,2,178,0
"100980406","CATAMARCA",19,0,10,8,0,18,0
"900842915","TUCUMAN",293,2,72,201,2,275,0.0068259385665529
"100980407","CATAMARCA",169,0,113,41,1,155,0
"100980408","CATAMARCA",194,0,145,42,0,187,0
"100980409","CATAMARCA",177,0,152,23,1,176,0
"100980410","CATAMARCA",14,0,4,9,0,13,0
"101050112","CATAMARCA",272,198,44,28,2,74,0.727941176470588
"540420513","MISIONES",309,6,266,32,1,299,0.0194174757281553
"101050115","CATAMARCA",288,4,212,62,3,277,0.0138888888888889
"901050916","TUCUMAN",229,211,7,7,0,14,0.921397379912664
"101050101","CATAMARCA",38,0,5,17,7,29,0
"101050102","CATAMARCA",195,0,120,58,9,187,0
"900070403","TUCUMAN",126,7,37,63,10,110,0.0555555555555556
"101050103","CATAMARCA",147,57,55,21,8,84,0.387755102040816
"101050104","CATAMARCA",300,17,203,65,8,276,0.0566666666666667
"101050105","CATAMARCA",267,86,105,59,2,166,0.322097378277154
"101050106","CATAMARCA",179,78,31,61,2,94,0.435754189944134
"101050107","CATAMARCA",256,87,88,79,1,168,0.33984375
"101050108","CATAMARCA",179,173,6,0,0,6,0.966480446927374
"101050109","CATAMARCA",263,87,119,53,1,173,0.330798479087452
"101050110","CATAMARCA",157,12,102,42,0,144,0.0764331210191083
"101050111","CATAMARCA",260,68,120,71,1,192,0.261538461538462
"101050201","CATAMARCA",63,0,24,35,1,60,0
"101050202","CATAMARCA",195,0,93,78,7,178,0
"101050301","CATAMARCA",8,0,1,2,1,4,0
"540280215","MISIONES",196,187,8,1,0,9,0.954081632653061
"101050302","CATAMARCA",215,0,132,78,2,212,0
"901190417","TUCUMAN",298,128,123,47,0,170,0.429530201342282
"900841202","TUCUMAN",269,269,0,0,0,0,1
"101050303","CATAMARCA",243,0,170,65,4,239,0
"101050304","CATAMARCA",265,17,168,50,3,221,0.0641509433962264
"101050305","CATAMARCA",177,0,139,31,3,173,0
"101050306","CATAMARCA",181,1,139,39,1,179,0.00552486187845304
"101050307","CATAMARCA",140,1,103,30,1,134,0.00714285714285714
"101050401","CATAMARCA",120,1,80,29,4,113,0.00833333333333333
"101050402","CATAMARCA",58,0,42,10,4,56,0
"101050602","CATAMARCA",167,1,94,51,5,150,0.00598802395209581
"340142106","FORMOSA",201,186,5,1,0,6,0.925373134328358
"101050501","CATAMARCA",66,0,24,33,1,58,0
"101050502","CATAMARCA",18,0,1,1,1,3,0
"101050601","CATAMARCA",2,0,0,1,0,1,0
"101050701","CATAMARCA",87,0,33,26,6,65,0
"101050702","CATAMARCA",241,0,107,96,2,205,0
"900842220","TUCUMAN",326,77,50,180,3,233,0.236196319018405
"900840203","TUCUMAN",275,103,12,138,9,159,0.374545454545455
"901190415","TUCUMAN",135,32,93,10,0,103,0.237037037037037
"901050604","TUCUMAN",325,7,294,17,0,311,0.0215384615384615
"101050703","CATAMARCA",52,1,12,10,0,22,0.0192307692307692
"101050704","CATAMARCA",25,0,5,0,0,5,0
"900842107","TUCUMAN",366,362,4,0,0,4,0.989071038251366
"540980602","MISIONES",60,0,10,16,33,59,0
"101050705","CATAMARCA",44,0,9,11,0,20,0
"101050707","CATAMARCA",82,0,24,29,6,59,0
"900842414","TUCUMAN",283,173,40,58,0,98,0.6113074204947
"101050706","CATAMARCA",42,0,14,10,8,32,0
"101050708","CATAMARCA",133,2,77,47,1,125,0.0150375939849624
"101050709","CATAMARCA",139,2,100,23,1,124,0.0143884892086331
"101050801","CATAMARCA",34,0,14,20,0,34,0
"101050802","CATAMARCA",9,0,0,9,0,9,0
"101120101","CATAMARCA",118,0,87,28,2,117,0
"101120201","CATAMARCA",42,0,20,13,0,33,0
"101120202","CATAMARCA",63,0,28,30,0,58,0
"101120301","CATAMARCA",30,0,14,12,0,26,0
"101120302","CATAMARCA",99,0,66,24,0,90,0
"101120303","CATAMARCA",49,0,42,3,1,46,0
"101120401","CATAMARCA",26,0,19,5,0,24,0
"101120402","CATAMARCA",199,0,180,14,0,194,0
"101120403","CATAMARCA",389,0,335,29,1,365,0
"101120404","CATAMARCA",339,0,239,88,2,329,0
"101120405","CATAMARCA",342,0,309,24,1,334,0
"101120406","CATAMARCA",337,0,296,25,0,321,0
"101120407","CATAMARCA",236,0,228,8,0,236,0
"101120408","CATAMARCA",335,0,296,35,0,331,0
"101120505","CATAMARCA",233,0,175,56,0,231,0
"101120506","CATAMARCA",285,0,217,54,1,272,0
"900842412","TUCUMAN",298,245,3,7,1,11,0.822147651006711
"101120409","CATAMARCA",318,0,271,37,0,308,0
"101120410","CATAMARCA",239,0,222,13,0,235,0
"101120411","CATAMARCA",196,0,168,25,1,194,0
"101120507","CATAMARCA",252,0,207,37,2,246,0
"101120508","CATAMARCA",214,0,203,7,2,212,0
"901190508","TUCUMAN",369,289,48,28,0,76,0.78319783197832
"101120501","CATAMARCA",17,0,8,5,0,13,0
"101120502","CATAMARCA",223,0,197,20,0,217,0
"101120503","CATAMARCA",282,0,249,11,1,261,0
"101120504","CATAMARCA",240,0,190,42,0,232,0
"901190506","TUCUMAN",176,130,25,21,0,46,0.738636363636364
"101120509","CATAMARCA",307,0,283,23,0,306,0
"101120510","CATAMARCA",285,0,189,87,2,278,0
"101120511","CATAMARCA",255,0,227,23,2,252,0
"101120512","CATAMARCA",220,0,152,46,11,209,0
"101120513","CATAMARCA",293,0,226,54,3,283,0
"101120514","CATAMARCA",196,0,137,50,2,189,0
"101120515","CATAMARCA",223,0,149,62,1,212,0
"900770404","TUCUMAN",286,14,176,75,3,254,0.048951048951049
"900770202","TUCUMAN",287,90,56,109,12,177,0.313588850174216
"900630412","TUCUMAN",136,0,58,61,5,124,0
"340142107","FORMOSA",246,174,71,0,0,71,0.707317073170732
"901050504","TUCUMAN",457,11,156,253,13,422,0.0240700218818381
"901050702","TUCUMAN",252,7,80,152,5,237,0.0277777777777778
"901050701","TUCUMAN",511,16,237,216,10,463,0.0313111545988258
"900842408","TUCUMAN",394,290,27,62,1,90,0.736040609137056
"900842406","TUCUMAN",344,321,8,11,1,20,0.933139534883721
"901190318","TUCUMAN",186,40,51,85,6,142,0.21505376344086
"901190317","TUCUMAN",443,18,258,156,0,414,0.0406320541760722
"901190316","TUCUMAN",238,47,55,119,1,175,0.197478991596639
"901190204","TUCUMAN",323,9,211,103,0,314,0.0278637770897833
"901190213","TUCUMAN",241,7,171,60,0,231,0.029045643153527
"901120216","TUCUMAN",257,0,239,18,0,257,0
"901190212","TUCUMAN",157,5,104,46,0,150,0.0318471337579618
"901051017","TUCUMAN",430,7,228,186,2,416,0.0162790697674419
"901051016","TUCUMAN",270,3,164,94,0,258,0.0111111111111111
"901051012","TUCUMAN",245,10,92,137,1,230,0.0408163265306122
"900560703","TUCUMAN",36,0,10,19,0,29,0
"901051010","TUCUMAN",324,5,136,134,5,275,0.0154320987654321
"901051007","TUCUMAN",290,4,188,97,0,285,0.0137931034482759
"901050912","TUCUMAN",347,195,59,87,0,146,0.561959654178674
"901050811","TUCUMAN",333,112,191,28,0,219,0.336336336336336
"901050805","TUCUMAN",363,267,27,35,0,62,0.735537190082645
"901050704","TUCUMAN",278,5,96,164,1,261,0.0179856115107914
"901050620","TUCUMAN",310,2,177,116,1,294,0.00645161290322581
"901050618","TUCUMAN",240,3,132,97,0,229,0.0125
"901050808","TUCUMAN",477,297,77,89,2,168,0.622641509433962
"901050617","TUCUMAN",212,1,94,115,0,209,0.00471698113207547
"900980412","TUCUMAN",151,0,77,59,1,137,0
"901050714","TUCUMAN",254,246,2,3,0,5,0.968503937007874
"900843006","TUCUMAN",205,165,4,0,0,4,0.804878048780488
"900842903","TUCUMAN",276,197,54,22,0,76,0.713768115942029
"900842823","TUCUMAN",308,16,148,131,0,279,0.051948051948052
"900842822","TUCUMAN",337,193,56,87,0,143,0.572700296735905
"900842807","TUCUMAN",275,2,83,171,8,262,0.00727272727272727
"900842804","TUCUMAN",269,6,58,164,0,222,0.0223048327137546
"900842712","TUCUMAN",216,207,3,4,1,8,0.958333333333333
"900842403","TUCUMAN",385,361,6,14,0,20,0.937662337662338
"900842303","TUCUMAN",159,139,1,19,0,20,0.874213836477987
"900840202","TUCUMAN",304,116,37,115,25,177,0.381578947368421
"900842222","TUCUMAN",133,1,69,60,0,129,0.0075187969924812
"900842215","TUCUMAN",427,127,125,134,7,266,0.297423887587822
"900842207","TUCUMAN",481,364,17,41,19,77,0.756756756756757
"900842509","TUCUMAN",258,239,16,2,0,18,0.926356589147287
"900842201","TUCUMAN",402,338,24,19,1,44,0.840796019900497
"900842116","TUCUMAN",166,157,2,4,0,6,0.94578313253012
"900841801","TUCUMAN",447,416,3,3,0,6,0.930648769574944
"900841710","TUCUMAN",128,122,2,2,0,4,0.953125
"900841404","TUCUMAN",371,365,5,0,0,5,0.983827493261456
"900840606","TUCUMAN",257,235,3,12,0,15,0.914396887159533
"900841306","TUCUMAN",331,331,0,0,0,0,1
"900840315","TUCUMAN",168,162,5,1,0,6,0.964285714285714
"900840310","TUCUMAN",340,315,7,4,0,11,0.926470588235294
"900840304","TUCUMAN",358,308,7,24,0,31,0.860335195530726
"900840208","TUCUMAN",380,361,7,10,2,19,0.95
"900840207","TUCUMAN",183,179,2,0,0,2,0.978142076502732
"900070611","TUCUMAN",258,6,100,129,11,240,0.0232558139534884
"900840126","TUCUMAN",376,286,50,34,0,84,0.76063829787234
"901050816","TUCUMAN",241,144,22,59,1,82,0.597510373443983
"900141205","TUCUMAN",338,157,38,126,5,169,0.464497041420118
"901050813","TUCUMAN",361,273,25,57,0,82,0.756232686980609
"900840113","TUCUMAN",379,342,1,0,0,1,0.902374670184697
"900840104","TUCUMAN",343,343,0,0,0,0,1
"900840110","TUCUMAN",271,263,8,0,0,8,0.970479704797048
"900840112","TUCUMAN",342,339,2,0,0,2,0.991228070175439
"900840506","TUCUMAN",310,277,22,5,0,27,0.893548387096774
"900701410","TUCUMAN",312,141,76,88,0,164,0.451923076923077
"900770211","TUCUMAN",252,250,0,1,0,1,0.992063492063492
"900700306","TUCUMAN",201,5,110,62,2,174,0.0248756218905473
"900701415","TUCUMAN",357,289,19,15,0,34,0.80952380952381
"900841312","TUCUMAN",339,339,0,0,0,0,1
"900630508","TUCUMAN",271,173,32,42,7,81,0.638376383763838
"900630507","TUCUMAN",381,318,32,20,2,54,0.834645669291339
"900630504","TUCUMAN",288,227,18,23,0,41,0.788194444444444
"900770213","TUCUMAN",270,231,15,19,0,34,0.855555555555556
"900630219","TUCUMAN",283,1,109,157,2,268,0.00353356890459364
"900630111","TUCUMAN",404,342,24,30,0,54,0.846534653465347
"900841221","TUCUMAN",294,294,0,0,0,0,1
"900841220","TUCUMAN",299,296,3,0,0,3,0.989966555183946
"900560308","TUCUMAN",318,117,111,85,1,197,0.367924528301887
"900141610","TUCUMAN",202,87,17,96,1,114,0.430693069306931
"900141607","TUCUMAN",253,135,98,15,0,113,0.533596837944664
"900141405","TUCUMAN",285,3,115,142,9,266,0.0105263157894737
"900141206","TUCUMAN",251,163,54,21,1,76,0.649402390438247
"900140711","TUCUMAN",293,0,146,128,1,275,0
"900840802","TUCUMAN",194,128,14,35,11,60,0.65979381443299
"900840711","TUCUMAN",224,212,9,1,1,11,0.946428571428571
"900140612","TUCUMAN",302,2,110,140,26,276,0.00662251655629139
"900140124","TUCUMAN",287,23,152,107,1,260,0.0801393728222996
"900140122","TUCUMAN",442,0,210,204,5,419,0
"900140110","TUCUMAN",376,24,182,158,2,342,0.0638297872340425
"900140115","TUCUMAN",432,20,211,180,3,394,0.0462962962962963
"900140114","TUCUMAN",477,9,263,189,1,453,0.0188679245283019
"900070410","TUCUMAN",331,3,60,212,6,278,0.00906344410876133
"900141309","TUCUMAN",249,159,36,47,0,83,0.63855421686747
"900140128","TUCUMAN",262,4,166,83,0,249,0.0152671755725191
"900140119","TUCUMAN",262,4,169,81,2,252,0.0152671755725191
"900842012","TUCUMAN",268,249,19,0,0,19,0.92910447761194
"900840218","TUCUMAN",228,195,5,24,0,29,0.855263157894737
"900420112","TUCUMAN",217,188,12,9,4,25,0.866359447004608
"900350213","TUCUMAN",359,0,205,109,8,322,0
"900420114","TUCUMAN",302,296,0,1,0,1,0.980132450331126
"900841208","TUCUMAN",357,351,4,0,0,4,0.983193277310924
"900280102","TUCUMAN",350,142,103,91,3,197,0.405714285714286
"900420103","TUCUMAN",184,163,5,5,2,12,0.885869565217391
"900842019","TUCUMAN",303,283,0,0,0,0,0.933993399339934
"900210619","TUCUMAN",208,176,3,15,4,22,0.846153846153846
"900210606","TUCUMAN",335,291,2,2,0,4,0.86865671641791
"900210507","TUCUMAN",349,3,134,163,23,320,0.00859598853868195
"900210506","TUCUMAN",210,2,98,88,3,189,0.00952380952380952
"900210708","TUCUMAN",185,185,0,0,0,0,1
"900210407","TUCUMAN",283,0,118,100,9,227,0
"900141615","TUCUMAN",352,6,152,162,19,333,0.0170454545454545
"900842004","TUCUMAN",136,135,1,0,0,1,0.992647058823529
"900630213","TUCUMAN",268,11,127,128,0,255,0.041044776119403
"900701406","TUCUMAN",340,207,50,69,3,122,0.608823529411765
"900841907","TUCUMAN",296,295,1,0,0,1,0.996621621621622
"900841905","TUCUMAN",185,184,1,0,0,1,0.994594594594595
"900841807","TUCUMAN",332,316,11,5,0,16,0.951807228915663
"900841613","TUCUMAN",186,172,2,3,0,5,0.924731182795699
"900841605","TUCUMAN",337,300,9,24,0,33,0.890207715133531
"900841502","TUCUMAN",351,315,1,2,0,3,0.897435897435897
"900840808","TUCUMAN",329,260,21,40,1,62,0.790273556231003
"900841022","TUCUMAN",257,250,4,3,0,7,0.972762645914397
"900840815","TUCUMAN",228,126,41,49,2,92,0.552631578947368
"900840807","TUCUMAN",259,224,13,17,0,30,0.864864864864865
"900140121","TUCUMAN",415,8,255,141,1,397,0.0192771084337349
"900840409","TUCUMAN",244,105,48,80,0,128,0.430327868852459
"900840413","TUCUMAN",248,184,14,29,0,43,0.741935483870968
"900840408","TUCUMAN",101,8,40,45,0,85,0.0792079207920792
"900840404","TUCUMAN",334,317,7,4,0,11,0.949101796407186
"900840403","TUCUMAN",305,288,7,1,0,8,0.944262295081967
"900840223","TUCUMAN",205,190,5,6,0,11,0.926829268292683
"900770119","TUCUMAN",262,200,26,27,0,53,0.763358778625954
"900770116","TUCUMAN",321,287,4,20,1,25,0.894080996884735
"900420109","TUCUMAN",155,143,2,2,2,6,0.92258064516129
"900420108","TUCUMAN",350,332,5,5,3,13,0.948571428571429
"900842803","TUCUMAN",466,321,12,101,14,127,0.688841201716738
"900842802","TUCUMAN",309,278,5,20,3,28,0.899676375404531
"900842418","TUCUMAN",298,230,18,45,0,63,0.771812080536913
"900140712","TUCUMAN",278,7,170,85,3,258,0.0251798561151079
"900070305","TUCUMAN",32,0,12,9,9,30,0
"900140304","TUCUMAN",66,0,13,33,8,54,0
"900980413","TUCUMAN",95,0,33,53,4,90,0
"900980303","TUCUMAN",12,0,5,6,0,11,0
"900842106","TUCUMAN",299,291,4,3,1,8,0.973244147157191
"901190101","TUCUMAN",15,1,1,10,1,12,0.0666666666666667
"900841113","TUCUMAN",243,227,1,3,0,4,0.934156378600823
"901120211","TUCUMAN",5,0,2,1,0,3,0
"900980102","TUCUMAN",57,0,14,22,10,46,0
"540980601","MISIONES",69,0,22,11,33,66,0
"900910605","TUCUMAN",25,0,0,12,8,20,0
"900490401","TUCUMAN",121,0,28,73,9,110,0
"901050625","TUCUMAN",220,84,79,50,1,130,0.381818181818182
"901120208","TUCUMAN",20,0,3,8,3,14,0
"901120207","TUCUMAN",34,0,6,21,2,29,0
"901120202","TUCUMAN",19,0,6,8,4,18,0
"901050103","TUCUMAN",32,0,0,20,4,24,0
"900911202","TUCUMAN",55,0,3,17,23,43,0
"900911201","TUCUMAN",102,0,6,65,20,91,0
"900911103","TUCUMAN",54,1,1,33,18,52,0.0185185185185185
"900980103","TUCUMAN",23,0,1,9,6,16,0
"900140603","TUCUMAN",6,0,0,6,0,6,0
"900910307","TUCUMAN",106,0,8,69,16,93,0
"900910208","TUCUMAN",152,1,33,78,21,132,0.00657894736842105
"900770602","TUCUMAN",200,1,62,112,15,189,0.005
"900630204","TUCUMAN",29,0,18,9,0,27,0
"900770208","TUCUMAN",5,0,0,5,0,5,0
"901190311","TUCUMAN",179,2,73,102,0,175,0.0111731843575419
"900701303","TUCUMAN",217,28,57,100,5,162,0.129032258064516
"900701202","TUCUMAN",66,0,4,26,17,47,0
"900140402","TUCUMAN",57,1,20,27,2,49,0.0175438596491228
"141400212","CORDOBA",234,1,215,6,6,227,0.00427350427350427
"900840502","TUCUMAN",208,197,6,4,0,10,0.947115384615385
"900141201","TUCUMAN",262,3,104,139,1,244,0.0114503816793893
"900842313","TUCUMAN",201,191,1,5,0,6,0.950248756218905
"900701203","TUCUMAN",114,0,41,59,5,105,0
"900700901","TUCUMAN",0,0,0,0,0,0,NA
"900140205","TUCUMAN",184,1,56,112,3,171,0.00543478260869565
"900700404","TUCUMAN",182,0,31,108,17,156,0
"900700401","TUCUMAN",66,0,6,42,10,58,0
"900700304","TUCUMAN",31,0,9,16,4,29,0
"900070605","TUCUMAN",73,3,15,48,0,63,0.0410958904109589
"900070501","TUCUMAN",73,0,5,47,5,57,0
"900700302","TUCUMAN",35,0,0,15,8,23,0
"900630405","TUCUMAN",53,1,18,30,0,48,0.0188679245283019
"901190402","TUCUMAN",298,9,92,161,14,267,0.0302013422818792
"900561401","TUCUMAN",72,0,40,27,2,69,0
"900561202","TUCUMAN",95,0,10,67,9,86,0
"900561103","TUCUMAN",33,0,7,18,7,32,0
"900560603","TUCUMAN",193,15,48,109,6,163,0.077720207253886
"900560801","TUCUMAN",59,0,11,39,1,51,0
"900210402","TUCUMAN",51,0,16,19,7,42,0
"900210207","TUCUMAN",172,2,55,76,12,143,0.0116279069767442
"900840507","TUCUMAN",228,213,5,4,0,9,0.934210526315789
"900280205","TUCUMAN",114,18,21,70,0,91,0.157894736842105
"900210404","TUCUMAN",67,0,42,15,7,64,0
"900141401","TUCUMAN",7,0,3,3,1,7,0
"900070402","TUCUMAN",62,0,4,54,1,59,0
"901050301","TUCUMAN",12,0,5,6,0,11,0
"900210208","TUCUMAN",130,1,59,37,8,104,0.00769230769230769
"900141002","TUCUMAN",114,2,49,52,5,106,0.0175438596491228
"900140904","TUCUMAN",75,0,26,42,0,68,0
"900140903","TUCUMAN",152,0,41,98,2,141,0
"900140709","TUCUMAN",64,0,6,42,3,51,0
"900210101","TUCUMAN",2,0,1,0,0,1,0
"900141505","TUCUMAN",79,0,38,36,3,77,0
"900840314","TUCUMAN",160,146,0,6,0,6,0.9125
"900490302","TUCUMAN",79,0,34,37,3,74,0
"900350307","TUCUMAN",50,0,3,21,23,47,0
"900070707","TUCUMAN",59,0,11,43,1,55,0
"900630207","TUCUMAN",123,0,62,38,7,107,0
"900560607","TUCUMAN",64,1,17,36,3,56,0.015625
"900560605","TUCUMAN",45,0,12,30,2,44,0
"900420304","TUCUMAN",69,1,20,36,8,64,0.0144927536231884
"900420205","TUCUMAN",61,5,15,35,0,50,0.0819672131147541
"901190419","TUCUMAN",332,58,242,32,0,274,0.174698795180723
"900840313","TUCUMAN",266,264,1,0,0,1,0.992481203007519
"900210106","TUCUMAN",130,1,38,56,25,119,0.00769230769230769
"900770405","TUCUMAN",207,9,24,135,24,183,0.0434782608695652
"900630404","TUCUMAN",348,3,112,187,8,307,0.00862068965517241
"900070405","TUCUMAN",235,63,50,98,14,162,0.268085106382979
"901190414","TUCUMAN",211,56,88,67,0,155,0.265402843601896
"901190404","TUCUMAN",353,3,111,225,3,339,0.0084985835694051
"300840316","ENTRE RIOS",194,193,0,1,0,1,0.994845360824742
"901050913","TUCUMAN",356,119,72,142,0,214,0.334269662921348
"901050817","TUCUMAN",252,164,19,49,0,68,0.650793650793651
"901051001","TUCUMAN",340,4,197,130,0,327,0.0117647058823529
"901050708","TUCUMAN",255,2,102,143,0,245,0.00784313725490196
"901050601","TUCUMAN",188,4,108,57,4,169,0.0212765957446809
"900980409","TUCUMAN",112,0,38,54,1,93,0
"900841915","TUCUMAN",164,162,2,0,0,2,0.98780487804878
"900842411","TUCUMAN",217,208,4,5,0,9,0.95852534562212
"901190503","TUCUMAN",266,126,57,77,0,134,0.473684210526316
"900840303","TUCUMAN",362,314,10,32,0,42,0.867403314917127
"901050607","TUCUMAN",166,11,74,76,0,150,0.0662650602409639
"900980420","TUCUMAN",137,0,56,67,3,126,0
"901050614","TUCUMAN",118,3,78,36,0,114,0.0254237288135593
"900843010","TUCUMAN",271,68,95,99,0,194,0.250922509225092
"900843008","TUCUMAN",266,1,35,211,0,246,0.0037593984962406
"900842914","TUCUMAN",626,36,131,359,8,498,0.0575079872204473
"900842812","TUCUMAN",369,4,121,225,6,352,0.010840108401084
"900842809","TUCUMAN",242,214,6,20,0,26,0.884297520661157
"900840212","TUCUMAN",403,385,9,4,0,13,0.955334987593052
"900842801","TUCUMAN",416,1,104,298,5,407,0.00240384615384615
"900842701","TUCUMAN",255,202,11,36,3,50,0.792156862745098
"900842517","TUCUMAN",275,52,34,167,2,203,0.189090909090909
"900842401","TUCUMAN",255,220,11,16,0,27,0.862745098039216
"900842217","TUCUMAN",389,116,115,140,3,258,0.298200514138817
"900842212","TUCUMAN",194,167,5,14,0,19,0.860824742268041
"900842210","TUCUMAN",292,242,16,25,2,43,0.828767123287671
"900842218","TUCUMAN",164,31,77,47,0,124,0.189024390243902
"900842118","TUCUMAN",217,209,2,0,0,2,0.963133640552995
"900841704","TUCUMAN",315,303,4,5,0,9,0.961904761904762
"900841409","TUCUMAN",215,210,2,3,0,5,0.976744186046512
"900840613","TUCUMAN",160,150,1,7,1,9,0.9375
"900840609","TUCUMAN",210,137,3,41,4,48,0.652380952380952
"900840602","TUCUMAN",391,379,2,6,1,9,0.969309462915601
"900840108","TUCUMAN",321,318,3,0,0,3,0.990654205607477
"900840204","TUCUMAN",191,167,13,10,1,24,0.87434554973822
"900770417","TUCUMAN",301,6,154,130,3,287,0.0199335548172757
"900840510","TUCUMAN",177,173,0,4,0,4,0.977401129943503
"900840124","TUCUMAN",346,323,15,8,0,23,0.933526011560694
"900770121","TUCUMAN",307,238,12,28,3,43,0.775244299674267
"900701419","TUCUMAN",346,333,7,3,0,10,0.96242774566474
"900701417","TUCUMAN",413,293,43,53,8,104,0.709443099273608
"900701404","TUCUMAN",222,174,25,14,0,39,0.783783783783784
"900630505","TUCUMAN",336,317,8,8,0,16,0.943452380952381
"900630417","TUCUMAN",216,146,33,34,2,69,0.675925925925926
"900701401","TUCUMAN",186,144,19,20,1,40,0.774193548387097
"900840220","TUCUMAN",211,210,0,1,0,1,0.995260663507109
"900630110","TUCUMAN",387,341,17,22,1,40,0.881136950904393
"900561403","TUCUMAN",154,1,74,72,2,148,0.00649350649350649
"900701414","TUCUMAN",226,211,7,5,0,12,0.933628318584071
"900701412","TUCUMAN",232,154,36,34,3,73,0.663793103448276
"900700807","TUCUMAN",440,7,290,103,16,409,0.0159090909090909
"900700206","TUCUMAN",316,6,128,163,9,300,0.0189873417721519
"900630513","TUCUMAN",336,289,6,8,0,14,0.860119047619048
"900630511","TUCUMAN",299,198,32,55,1,88,0.662207357859532
"900630114","TUCUMAN",335,257,36,37,2,75,0.767164179104478
"900630112","TUCUMAN",284,251,17,9,0,26,0.883802816901408
"900561108","TUCUMAN",293,1,151,121,0,272,0.00341296928327645
"900841218","TUCUMAN",203,182,1,0,0,1,0.896551724137931
"900560307","TUCUMAN",215,13,143,55,0,198,0.0604651162790698
"900841108","TUCUMAN",297,17,57,193,3,253,0.0572390572390572
"900841104","TUCUMAN",198,190,8,0,0,8,0.95959595959596
"900841016","TUCUMAN",264,257,2,4,1,7,0.973484848484849
"900141219","TUCUMAN",328,0,199,109,8,316,0
"900840820","TUCUMAN",274,2,126,136,3,265,0.0072992700729927
"900840709","TUCUMAN",304,297,1,2,1,4,0.976973684210526
"900140611","TUCUMAN",267,4,87,142,16,245,0.0149812734082397
"900560306","TUCUMAN",355,202,49,91,1,141,0.569014084507042
"900560305","TUCUMAN",367,75,123,152,2,277,0.204359673024523
"900141612","TUCUMAN",213,31,71,110,0,181,0.145539906103286
"900141506","TUCUMAN",386,15,318,44,0,362,0.038860103626943
"900141410","TUCUMAN",267,4,49,152,8,209,0.0149812734082397
"900141617","TUCUMAN",258,1,178,76,0,254,0.00387596899224806
"900141224","TUCUMAN",202,6,191,5,0,196,0.0297029702970297
"900841602","TUCUMAN",248,242,4,1,0,5,0.975806451612903
"900140207","TUCUMAN",353,1,199,134,4,337,0.0028328611898017
"900140113","TUCUMAN",420,4,183,220,5,408,0.00952380952380952
"900840707","TUCUMAN",304,291,3,7,0,10,0.957236842105263
"900140120","TUCUMAN",237,0,136,95,1,232,0
"900140117","TUCUMAN",212,11,171,27,0,198,0.0518867924528302
"900700605","TUCUMAN",197,0,151,35,0,186,0
"900841023","TUCUMAN",402,391,5,6,0,11,0.972636815920398
"900840814","TUCUMAN",518,88,180,222,0,402,0.16988416988417
"900841307","TUCUMAN",120,119,1,0,0,1,0.991666666666667
"900280108","TUCUMAN",334,165,93,60,4,157,0.494011976047904
"900280106","TUCUMAN",231,208,6,16,0,22,0.9004329004329
"900280101","TUCUMAN",375,93,153,95,15,263,0.248
"900210613","TUCUMAN",218,207,5,2,0,7,0.94954128440367
"900210608","TUCUMAN",394,365,9,13,1,23,0.926395939086294
"900210605","TUCUMAN",351,329,9,3,0,12,0.937321937321937
"900841207","TUCUMAN",257,257,0,0,0,0,1
"900141614","TUCUMAN",301,3,136,156,3,295,0.00996677740863787
"900140211","TUCUMAN",254,3,93,133,3,229,0.0118110236220472
"900840512","TUCUMAN",218,185,6,6,0,12,0.848623853211009
"900841211","TUCUMAN",266,266,0,0,0,0,1
"900842616","TUCUMAN",356,105,61,175,11,247,0.294943820224719
"900701003","TUCUMAN",82,1,39,41,0,80,0.0121951219512195
"900840810","TUCUMAN",254,231,9,14,0,23,0.909448818897638
"900840412","TUCUMAN",219,205,5,5,0,10,0.936073059360731
"900840407","TUCUMAN",276,229,5,28,0,33,0.829710144927536
"900770117","TUCUMAN",278,252,7,11,0,18,0.906474820143885
"900420107","TUCUMAN",331,272,7,7,0,14,0.821752265861027
"900420105","TUCUMAN",242,223,2,8,2,12,0.921487603305785
"900141311","TUCUMAN",377,184,46,124,3,173,0.488063660477454
"900842815","TUCUMAN",334,239,45,36,7,88,0.715568862275449
"900842605","TUCUMAN",325,107,54,149,1,204,0.329230769230769
"900141218","TUCUMAN",273,3,174,82,0,256,0.010989010989011
"900842602","TUCUMAN",224,14,62,135,1,198,0.0625
"900842601","TUCUMAN",412,56,175,161,1,337,0.135922330097087
"900980101","TUCUMAN",131,0,31,36,40,107,0
"900420110","TUCUMAN",192,158,11,7,1,19,0.822916666666667
"901120403","TUCUMAN",88,0,29,40,6,75,0
"901190102","TUCUMAN",4,0,3,0,1,4,0
"900980104","TUCUMAN",76,0,18,35,9,62,0
"901120305","TUCUMAN",38,0,7,22,3,32,0
"901120212","TUCUMAN",23,0,2,20,0,22,0
"900980407","TUCUMAN",80,0,18,46,8,72,0
"900980309","TUCUMAN",109,0,56,41,4,101,0
"900980304","TUCUMAN",90,0,56,24,2,82,0
"900560706","TUCUMAN",103,0,21,62,6,89,0
"900911203","TUCUMAN",13,0,0,7,3,10,0
"900911102","TUCUMAN",26,0,1,22,3,26,0
"900701408","TUCUMAN",168,155,7,6,0,13,0.922619047619048
"900210303","TUCUMAN",146,1,51,78,9,138,0.00684931506849315
"900911101","TUCUMAN",56,0,3,29,21,53,0
"900910801","TUCUMAN",34,0,4,9,10,23,0
"900910701","TUCUMAN",195,0,9,80,71,160,0
"900210405","TUCUMAN",24,2,9,10,3,22,0.0833333333333333
"901190209","TUCUMAN",269,2,126,121,5,252,0.00743494423791822
"900910602","TUCUMAN",132,0,35,62,14,111,0
"900910205","TUCUMAN",112,0,49,49,10,108,0
"900770601","TUCUMAN",202,3,47,129,15,191,0.0148514851485149
"900770201","TUCUMAN",62,0,20,21,18,59,0
"900701302","TUCUMAN",127,56,18,47,0,65,0.440944881889764
"900700902","TUCUMAN",64,0,12,34,6,52,0
"900561303","TUCUMAN",41,0,13,16,10,39,0
"900700703","TUCUMAN",3,0,0,0,3,3,0
"900700501","TUCUMAN",142,0,71,61,6,138,0
"900700407","TUCUMAN",67,0,0,21,26,47,0
"900700201","TUCUMAN",22,0,0,14,5,19,0
"900561301","TUCUMAN",140,0,36,87,3,126,0
"900560907","TUCUMAN",110,0,46,53,3,102,0
"900350201","TUCUMAN",24,0,3,10,6,19,0
"900350110","TUCUMAN",64,0,8,38,14,60,0
"900350102","TUCUMAN",33,0,0,17,10,27,0
"900210304","TUCUMAN",121,0,64,41,14,119,0
"901050505","TUCUMAN",173,0,88,62,6,156,0
"900280310","TUCUMAN",95,0,41,40,9,90,0
"900280308","TUCUMAN",8,0,3,4,1,8,0
"540420518","MISIONES",274,3,182,68,17,267,0.0109489051094891
"901120104","TUCUMAN",24,0,1,15,3,19,0
"901120102","TUCUMAN",41,0,4,18,4,26,0
"901051021","TUCUMAN",330,7,146,173,1,320,0.0212121212121212
"900701413","TUCUMAN",157,151,6,0,0,6,0.961783439490446
"900700607","TUCUMAN",254,6,179,62,0,241,0.0236220472440945
"900841503","TUCUMAN",227,190,8,3,0,11,0.837004405286344
"140145808","CORDOBA",301,297,4,0,0,4,0.98671096345515
"901050503","TUCUMAN",223,8,59,128,4,191,0.0358744394618834
"901050206","TUCUMAN",81,0,14,55,0,69,0
"900141503","TUCUMAN",29,0,2,21,5,28,0
"900141104","TUCUMAN",168,0,36,119,1,156,0
"900140901","TUCUMAN",231,0,71,135,9,215,0
"900140804","TUCUMAN",53,0,11,23,9,43,0
"900140705","TUCUMAN",56,0,31,16,0,47,0
"900140605","TUCUMAN",6,0,1,5,0,6,0
"900140201","TUCUMAN",61,0,10,38,5,53,0
"900140102","TUCUMAN",273,1,44,192,13,249,0.00366300366300366
"901190510","TUCUMAN",252,181,52,18,0,70,0.718253968253968
"900701101","TUCUMAN",76,5,34,36,0,70,0.0657894736842105
"900071005","TUCUMAN",217,1,101,79,10,190,0.00460829493087558
"900071004","TUCUMAN",50,0,20,21,1,42,0
"900070808","TUCUMAN",183,0,55,109,11,175,0
"900070807","TUCUMAN",295,4,105,159,15,279,0.0135593220338983
"901190505","TUCUMAN",214,157,40,16,0,56,0.733644859813084
"901190406","TUCUMAN",366,77,256,32,0,288,0.210382513661202
"900070804","TUCUMAN",37,0,11,24,0,35,0
"900070801","TUCUMAN",107,0,26,64,3,93,0
"900070204","TUCUMAN",133,9,19,58,11,88,0.0676691729323308
"900070102","TUCUMAN",19,0,1,12,3,16,0
"900560406","TUCUMAN",83,0,27,39,10,76,0
"900490203","TUCUMAN",303,0,80,135,20,235,0
"900350208","TUCUMAN",49,0,5,25,14,44,0
"901190405","TUCUMAN",320,22,132,143,10,285,0.06875
"900840909","TUCUMAN",170,166,2,2,0,4,0.976470588235294
"900490102","TUCUMAN",229,0,52,122,36,210,0
"900420213","TUCUMAN",108,1,4,63,28,95,0.00925925925925926
"901190403","TUCUMAN",333,8,94,197,6,297,0.024024024024024
"901190208","TUCUMAN",249,6,102,125,0,227,0.0240963855421687
"900842005","TUCUMAN",198,198,0,0,0,0,1
"900420201","TUCUMAN",142,0,14,97,16,127,0
"900350311","TUCUMAN",47,0,2,37,0,39,0
"900350310","TUCUMAN",97,0,7,47,30,84,0
"900350303","TUCUMAN",31,0,1,20,9,30,0
"901190205","TUCUMAN",223,7,110,98,1,209,0.031390134529148
"901120214","TUCUMAN",299,0,271,23,0,294,0
"901120115","TUCUMAN",143,0,43,84,5,132,0
"901120113","TUCUMAN",93,0,43,44,1,88,0
"900842213","TUCUMAN",310,274,9,10,0,19,0.883870967741936
"901120401","TUCUMAN",24,0,1,17,4,22,0
"900070608","TUCUMAN",74,0,28,40,3,71,0
"900561102","TUCUMAN",9,0,4,5,0,9,0
"900420302","TUCUMAN",199,5,75,78,26,179,0.0251256281407035
"900840714","TUCUMAN",217,208,2,6,0,8,0.95852534562212
"900770407","TUCUMAN",278,1,125,121,10,256,0.00359712230215827
"900210209","TUCUMAN",148,0,13,103,16,132,0
"900141504","TUCUMAN",445,7,270,129,10,409,0.0157303370786517
"901190401","TUCUMAN",206,14,107,71,2,180,0.0679611650485437
"900700702","TUCUMAN",46,2,9,35,0,44,0.0434782608695652
"900560903","TUCUMAN",132,0,88,41,0,129,0
"900490502","TUCUMAN",124,0,49,63,6,118,0
"900842404","TUCUMAN",391,361,23,4,0,27,0.923273657289003
"900841508","TUCUMAN",154,153,1,0,0,1,0.993506493506494
"901051008","TUCUMAN",110,1,65,40,0,105,0.00909090909090909
"901050706","TUCUMAN",286,236,10,30,0,40,0.825174825174825
"901050703","TUCUMAN",155,1,76,75,0,151,0.00645161290322581
"901050712","TUCUMAN",407,402,4,0,0,4,0.987714987714988
"901050624","TUCUMAN",111,1,59,41,1,101,0.00900900900900901
"901050717","TUCUMAN",3,2,1,0,0,1,0.666666666666667
"900980106","TUCUMAN",178,0,93,75,3,171,0
"900980419","TUCUMAN",24,0,20,4,0,24,0
"900910104","TUCUMAN",385,181,111,84,5,200,0.47012987012987
"900910103","TUCUMAN",377,43,242,81,7,330,0.114058355437666
"900842119","TUCUMAN",393,350,10,5,18,33,0.89058524173028
"900843016","TUCUMAN",349,97,76,135,16,227,0.277936962750716
"900910106","TUCUMAN",249,179,38,28,2,68,0.718875502008032
"900843011","TUCUMAN",362,199,75,79,3,157,0.549723756906077
"900843002","TUCUMAN",309,222,34,44,0,78,0.718446601941748
"900842906","TUCUMAN",254,65,52,134,1,187,0.255905511811024
"900842904","TUCUMAN",278,99,103,63,1,167,0.356115107913669
"900842902","TUCUMAN",397,148,74,165,0,239,0.3727959697733
"900842819","TUCUMAN",273,268,0,0,0,0,0.981684981684982
"900842818","TUCUMAN",278,276,1,0,0,1,0.992805755395683
"900842810","TUCUMAN",271,247,12,8,0,20,0.911439114391144
"900842123","TUCUMAN",0,0,0,0,0,0,NA
"900841705","TUCUMAN",283,280,1,2,0,3,0.989399293286219
"900842808","TUCUMAN",275,0,30,178,3,211,0
"900842711","TUCUMAN",286,240,10,27,0,37,0.839160839160839
"900842710","TUCUMAN",382,328,5,45,0,50,0.858638743455497
"900842709","TUCUMAN",369,322,17,21,0,38,0.872628726287263
"900842518","TUCUMAN",288,83,69,127,0,196,0.288194444444444
"900842507","TUCUMAN",407,288,23,90,1,114,0.707616707616708
"900842506","TUCUMAN",180,81,14,56,24,94,0.45
"900842314","TUCUMAN",228,200,4,12,4,20,0.87719298245614
"900842214","TUCUMAN",391,309,27,14,0,41,0.790281329923274
"900841615","TUCUMAN",374,323,16,26,1,43,0.863636363636364
"900841408","TUCUMAN",267,259,6,2,0,8,0.970037453183521
"900841406","TUCUMAN",287,279,3,4,0,7,0.97212543554007
"900840302","TUCUMAN",409,195,63,106,4,173,0.476772616136919
"901050815","TUCUMAN",219,119,11,80,3,94,0.54337899543379
"900840114","TUCUMAN",297,294,1,0,0,1,0.98989898989899
"900840103","TUCUMAN",350,321,0,25,2,27,0.917142857142857
"900770416","TUCUMAN",129,1,92,35,1,128,0.00775193798449612
"900770414","TUCUMAN",371,9,227,104,17,348,0.0242587601078167
"900840216","TUCUMAN",199,197,2,0,0,2,0.989949748743719
"900770123","TUCUMAN",222,202,9,7,0,16,0.90990990990991
"900770122","TUCUMAN",232,212,7,7,2,16,0.913793103448276
"900770108","TUCUMAN",243,235,4,2,0,6,0.967078189300412
"900841021","TUCUMAN",94,92,1,1,0,2,0.978723404255319
"900701420","TUCUMAN",291,194,28,39,2,69,0.666666666666667
"900701411","TUCUMAN",219,209,5,5,0,10,0.954337899543379
"900700604","TUCUMAN",264,0,176,74,2,252,0
"900700603","TUCUMAN",212,8,163,37,2,202,0.0377358490566038
"900700207","TUCUMAN",183,49,123,11,0,134,0.26775956284153
"900700204","TUCUMAN",225,3,157,61,4,222,0.0133333333333333
"900770214","TUCUMAN",159,0,56,95,0,151,0
"900840219","TUCUMAN",281,277,2,1,0,3,0.98576512455516
"900841302","TUCUMAN",237,228,1,0,0,1,0.962025316455696
"900841301","TUCUMAN",216,215,1,0,0,1,0.99537037037037
"900141213","TUCUMAN",333,2,184,130,3,317,0.00600600600600601
"900842016","TUCUMAN",233,232,1,0,0,1,0.995708154506438
"900841102","TUCUMAN",282,282,0,0,0,0,1
"900841011","TUCUMAN",350,209,22,97,12,131,0.597142857142857
"900841005","TUCUMAN",363,238,38,69,2,109,0.65564738292011
"900840701","TUCUMAN",320,200,19,89,2,110,0.625
"900140404","TUCUMAN",247,3,144,90,3,237,0.0121457489878543
"900140209","TUCUMAN",228,0,121,85,2,208,0
"900842015","TUCUMAN",291,291,0,0,0,0,1
"900140129","TUCUMAN",314,2,119,149,12,280,0.00636942675159236
"900140126","TUCUMAN",549,8,270,249,3,522,0.0145719489981785
"900140111","TUCUMAN",169,1,32,83,2,117,0.00591715976331361
"900840811","TUCUMAN",298,284,9,4,0,13,0.953020134228188
"900842011","TUCUMAN",178,165,1,0,0,1,0.926966292134832
"900841217","TUCUMAN",235,234,0,1,0,1,0.995744680851064
"900560103","TUCUMAN",274,4,183,83,0,266,0.0145985401459854
"900490512","TUCUMAN",207,0,111,83,5,199,0
"900350312","TUCUMAN",358,0,141,155,40,336,0
"900280320","TUCUMAN",196,193,0,3,0,3,0.98469387755102
"900280103","TUCUMAN",382,290,27,40,2,69,0.759162303664921
"900210720","TUCUMAN",288,245,16,20,2,38,0.850694444444444
"900210716","TUCUMAN",272,225,16,28,0,44,0.827205882352941
"900490510","TUCUMAN",310,0,182,115,9,306,0
"900210604","TUCUMAN",378,283,51,34,2,87,0.748677248677249
"900210411","TUCUMAN",272,23,155,59,17,231,0.0845588235294118
"900210409","TUCUMAN",328,112,114,82,5,201,0.341463414634146
"900210408","TUCUMAN",210,5,127,68,8,203,0.0238095238095238
"900210110","TUCUMAN",169,7,85,63,4,152,0.0414201183431953
"901120112","TUCUMAN",82,0,48,29,4,81,0
"901120111","TUCUMAN",152,0,76,69,0,145,0
"900630305","TUCUMAN",499,5,101,330,5,436,0.0100200400801603
"900420214","TUCUMAN",239,198,5,28,4,37,0.828451882845188
"900280318","TUCUMAN",370,98,169,86,3,258,0.264864864864865
"900280111","TUCUMAN",341,303,16,9,4,29,0.888563049853372
"900210111","TUCUMAN",118,0,25,76,11,112,0
"900141605","TUCUMAN",291,38,171,71,0,242,0.130584192439863
"900841701","TUCUMAN",292,275,4,12,0,16,0.941780821917808
"900841225","TUCUMAN",290,266,0,0,0,0,0.917241379310345
"900071007","TUCUMAN",315,1,168,121,6,295,0.00317460317460317
"900070712","TUCUMAN",417,3,188,181,4,373,0.00719424460431655
"900841512","TUCUMAN",167,148,0,8,0,8,0.88622754491018
"900841314","TUCUMAN",231,225,6,0,0,6,0.974025974025974
"900841313","TUCUMAN",105,103,2,0,0,2,0.980952380952381
"900841910","TUCUMAN",263,263,0,0,0,0,1
"900841909","TUCUMAN",356,354,2,0,0,2,0.99438202247191
"900841812","TUCUMAN",273,271,1,1,0,2,0.992673992673993
"900841607","TUCUMAN",388,353,15,16,1,32,0.90979381443299
"900841805","TUCUMAN",334,308,7,6,0,13,0.922155688622755
"900841612","TUCUMAN",213,204,1,5,0,6,0.957746478873239
"900841513","TUCUMAN",192,189,2,1,0,3,0.984375
"900770120","TUCUMAN",299,238,10,33,7,50,0.795986622073579
"900420106","TUCUMAN",253,234,7,8,3,18,0.924901185770751
"900141314","TUCUMAN",203,68,15,88,17,120,0.334975369458128
"900141313","TUCUMAN",259,161,54,33,2,89,0.621621621621622
"901051004","TUCUMAN",412,3,141,252,2,395,0.00728155339805825
"900842913","TUCUMAN",360,40,137,160,1,298,0.111111111111111
"900842613","TUCUMAN",198,181,6,1,7,14,0.914141414141414
"900842603","TUCUMAN",209,43,48,116,2,166,0.205741626794258
"900842501","TUCUMAN",427,100,100,206,11,317,0.234192037470726
"900842420","TUCUMAN",261,239,10,6,0,16,0.915708812260536
"901120402","TUCUMAN",45,0,4,35,3,42,0
"900910403","TUCUMAN",118,1,33,55,16,104,0.00847457627118644
"901120303","TUCUMAN",123,0,36,60,15,111,0
"900911004","TUCUMAN",37,0,5,17,14,36,0
"901120206","TUCUMAN",57,0,16,33,3,52,0
"901120205","TUCUMAN",247,0,114,100,13,227,0
"901120204","TUCUMAN",68,0,10,35,7,52,0
"900842105","TUCUMAN",159,157,0,0,0,0,0.987421383647799
"900841918","TUCUMAN",173,173,0,0,0,0,1
"900842413","TUCUMAN",270,247,4,8,2,14,0.914814814814815
"901050204","TUCUMAN",150,3,43,87,1,131,0.02
"900980403","TUCUMAN",10,0,0,8,0,8,0
"900980202","TUCUMAN",4,0,0,1,0,1,0
"901190408","TUCUMAN",336,15,178,137,1,316,0.0446428571428571
"900911001","TUCUMAN",67,0,15,36,9,60,0
"900910503","TUCUMAN",122,0,46,63,8,117,0
"900910502","TUCUMAN",112,2,14,56,21,91,0.0178571428571429
"900910404","TUCUMAN",87,0,26,56,4,86,0
"901190516","TUCUMAN",316,7,218,90,0,308,0.0221518987341772
"900910305","TUCUMAN",152,0,35,76,35,146,0
"900770603","TUCUMAN",56,0,19,35,0,54,0
"900770412","TUCUMAN",74,0,21,35,12,68,0
"900630101","TUCUMAN",253,4,90,131,3,224,0.0158102766798419
"900561209","TUCUMAN",89,0,4,67,4,75,0
"900770409","TUCUMAN",142,1,48,56,8,112,0.00704225352112676
"900770302","TUCUMAN",145,3,77,53,10,140,0.0206896551724138
"900701001","TUCUMAN",3,0,1,1,1,3,0
"900140502","TUCUMAN",101,0,20,61,11,92,0
"900140204","TUCUMAN",147,0,24,91,9,124,0
"900700903","TUCUMAN",298,0,80,184,15,279,0
"900700403","TUCUMAN",305,3,124,96,52,272,0.00983606557377049
"901190513","TUCUMAN",402,141,158,86,3,247,0.350746268656716
"900700303","TUCUMAN",33,0,7,14,12,33,0
"900630402","TUCUMAN",20,0,1,15,0,16,0
"900630211","TUCUMAN",38,0,16,15,1,32,0
"901190504","TUCUMAN",222,114,59,16,0,75,0.513513513513513
"340142108","FORMOSA",229,156,72,1,0,73,0.681222707423581
"900561201","TUCUMAN",86,0,23,59,0,82,0
"900561001","TUCUMAN",145,0,28,88,12,128,0
"900560906","TUCUMAN",63,0,4,52,4,60,0
"900560606","TUCUMAN",100,0,24,65,2,91,0
"900560503","TUCUMAN",118,1,40,49,5,94,0.00847457627118644
"900350107","TUCUMAN",23,0,1,10,11,22,0
"900071006","TUCUMAN",45,0,0,40,2,42,0
"901190421","TUCUMAN",181,6,155,16,0,171,0.0331491712707182
"900841110","TUCUMAN",228,210,3,13,0,16,0.921052631578947
"901050711","TUCUMAN",385,244,109,29,0,138,0.633766233766234
"900280307","TUCUMAN",270,23,78,136,8,222,0.0851851851851852
"900280305","TUCUMAN",243,46,62,114,7,183,0.189300411522634
"900070902","TUCUMAN",84,0,12,61,5,78,0
"900070803","TUCUMAN",86,0,22,47,6,75,0
"900280304","TUCUMAN",113,3,24,70,7,101,0.0265486725663717
"900210206","TUCUMAN",188,1,67,105,6,178,0.00531914893617021
"901050801","TUCUMAN",72,8,11,44,2,57,0.111111111111111
"901050401","TUCUMAN",102,10,42,36,0,78,0.0980392156862745
"901190418","TUCUMAN",195,51,128,15,1,144,0.261538461538462
"901190413","TUCUMAN",210,39,108,63,0,171,0.185714285714286
"901190411","TUCUMAN",257,19,173,52,0,225,0.0739299610894942
"300980309","ENTRE RIOS",202,202,0,0,0,0,1
"901050205","TUCUMAN",178,1,24,114,15,153,0.00561797752808989
"900141502","TUCUMAN",247,9,84,109,16,209,0.0364372469635627
"900141102","TUCUMAN",286,1,131,145,0,276,0.0034965034965035
"900140906","TUCUMAN",130,1,37,76,3,116,0.00769230769230769
"900140902","TUCUMAN",135,5,58,61,3,122,0.037037037037037
"900140708","TUCUMAN",223,6,73,123,5,201,0.0269058295964126
"900140701","TUCUMAN",118,0,49,52,3,104,0
"900140504","TUCUMAN",73,0,4,51,3,58,0
"900070802","TUCUMAN",29,0,4,4,16,24,0
"900070603","TUCUMAN",41,0,23,13,1,37,0
"900070303","TUCUMAN",18,0,2,10,1,13,0
"900841614","TUCUMAN",253,250,2,1,0,3,0.988142292490119
"900420203","TUCUMAN",47,2,8,27,9,44,0.0425531914893617
"901190215","TUCUMAN",259,6,200,52,0,252,0.0231660231660232
"901051024","TUCUMAN",321,2,48,244,2,294,0.00623052959501558
"901051022","TUCUMAN",273,11,129,126,1,256,0.0402930402930403
"900070101","TUCUMAN",14,0,2,11,0,13,0
"900070404","TUCUMAN",78,1,16,54,1,71,0.0128205128205128
"900490403","TUCUMAN",141,0,38,75,10,123,0
"900070104","TUCUMAN",85,2,48,26,0,74,0.0235294117647059
"900070503","TUCUMAN",88,0,6,45,30,81,0
"900070407","TUCUMAN",93,1,21,56,4,81,0.010752688172043
"900560402","TUCUMAN",227,4,85,101,15,201,0.0176211453744493
"900560401","TUCUMAN",99,1,34,45,8,87,0.0101010101010101
"900490601","TUCUMAN",2,0,0,1,0,1,0
"900841620","TUCUMAN",317,312,1,2,0,3,0.984227129337539
"900350209","TUCUMAN",37,0,25,5,1,31,0
"900350308","TUCUMAN",12,0,0,10,2,12,0
"900770118","TUCUMAN",188,173,3,6,0,9,0.920212765957447
"901120301","TUCUMAN",62,0,4,24,18,46,0
"900420301","TUCUMAN",49,1,8,28,6,42,0.0204081632653061
"900350211","TUCUMAN",6,0,0,5,1,6,0
"900350206","TUCUMAN",97,0,7,63,12,82,0
"900490505","TUCUMAN",8,0,7,0,0,7,0
"900070103","TUCUMAN",40,0,6,10,23,39,0
"900841510","TUCUMAN",305,294,2,4,0,6,0.963934426229508
"900490205","TUCUMAN",70,0,5,38,14,57,0
"901190207","TUCUMAN",167,12,120,32,0,152,0.0718562874251497
"900210502","TUCUMAN",293,2,117,120,26,263,0.0068259385665529
"900490501","TUCUMAN",284,0,173,85,3,261,0
"900140103","TUCUMAN",419,1,121,218,11,350,0.00238663484486874
"900770203","TUCUMAN",222,22,43,129,2,174,0.0990990990990991
"901190202","TUCUMAN",200,167,13,16,0,29,0.835
"900630411","TUCUMAN",128,0,35,79,2,116,0
"900630103","TUCUMAN",248,29,61,145,4,210,0.116935483870968
"900140301","TUCUMAN",229,15,128,80,1,209,0.0655021834061135
"901190319","TUCUMAN",271,70,170,28,0,198,0.25830258302583
"901190314","TUCUMAN",254,8,154,84,3,241,0.031496062992126
"901190305","TUCUMAN",193,1,124,66,0,190,0.00518134715025907
"901051013","TUCUMAN",262,111,94,56,0,150,0.423664122137405
"901051006","TUCUMAN",320,11,213,92,2,307,0.034375
"901050907","TUCUMAN",306,289,1,13,0,14,0.944444444444444
"901050705","TUCUMAN",215,194,8,8,1,17,0.902325581395349
"901050623","TUCUMAN",426,67,262,96,0,358,0.157276995305164
"901050605","TUCUMAN",317,4,126,134,4,264,0.0126182965299685
"901050713","TUCUMAN",243,241,2,0,0,2,0.991769547325103
"901050611","TUCUMAN",299,3,184,104,1,289,0.0100334448160535
"901050616","TUCUMAN",205,1,152,48,0,200,0.0048780487804878
"900980415","TUCUMAN",265,0,108,148,4,260,0
"901051003","TUCUMAN",297,16,126,142,0,268,0.0538720538720539
"900843009","TUCUMAN",299,10,135,143,2,280,0.0334448160535117
"900843001","TUCUMAN",320,66,47,182,2,231,0.20625
"900842901","TUCUMAN",412,56,104,222,4,330,0.135922330097087
"900842813","TUCUMAN",271,90,63,107,0,170,0.33210332103321
"900841903","TUCUMAN",292,292,0,0,0,0,1
"900842811","TUCUMAN",314,7,189,109,2,300,0.0222929936305732
"900842705","TUCUMAN",348,293,7,30,0,37,0.841954022988506
"900842704","TUCUMAN",323,311,4,4,0,8,0.962848297213622
"900842516","TUCUMAN",207,68,77,57,1,135,0.328502415458937
"900842515","TUCUMAN",262,178,17,64,0,81,0.679389312977099
"900842512","TUCUMAN",387,281,39,42,6,87,0.72609819121447
"900842209","TUCUMAN",260,220,2,6,0,8,0.846153846153846
"900842208","TUCUMAN",266,191,15,37,5,57,0.718045112781955
"900842112","TUCUMAN",235,231,4,0,0,4,0.982978723404255
"900840605","TUCUMAN",352,334,9,7,0,16,0.948863636363636
"900840415","TUCUMAN",448,294,22,115,2,139,0.65625
"900840306","TUCUMAN",350,303,23,16,0,39,0.865714285714286
"900141608","TUCUMAN",272,49,164,54,0,218,0.180147058823529
"900840301","TUCUMAN",455,262,35,105,24,164,0.575824175824176
"900840221","TUCUMAN",406,367,16,9,0,25,0.903940886699507
"900840214","TUCUMAN",258,245,8,2,0,10,0.949612403100775
"901050812","TUCUMAN",374,373,1,0,0,1,0.997326203208556
"900840122","TUCUMAN",207,206,0,1,0,1,0.995169082125604
"900840117","TUCUMAN",196,178,6,4,0,10,0.908163265306122
"900840116","TUCUMAN",257,239,7,9,0,16,0.929961089494163
"900840106","TUCUMAN",392,169,37,179,1,217,0.431122448979592
"900840105","TUCUMAN",309,308,1,0,0,1,0.996763754045307
"900770418","TUCUMAN",150,2,55,72,10,137,0.0133333333333333
"900770210","TUCUMAN",372,229,41,83,3,127,0.615591397849462
"900770115","TUCUMAN",355,307,10,36,0,46,0.864788732394366
"900770114","TUCUMAN",156,153,1,1,0,2,0.980769230769231
"900842017","TUCUMAN",231,231,0,0,0,0,1
"900841901","TUCUMAN",233,232,0,1,0,1,0.995708154506438
"900700806","TUCUMAN",223,3,194,20,3,217,0.0134529147982063
"900630503","TUCUMAN",389,315,31,28,1,60,0.809768637532134
"900630108","TUCUMAN",387,203,50,89,1,140,0.524547803617571
"900630107","TUCUMAN",161,104,28,23,0,51,0.645962732919255
"900630104","TUCUMAN",334,60,92,161,2,255,0.179640718562874
"900561203","TUCUMAN",185,1,133,49,1,183,0.00540540540540541
"900841222","TUCUMAN",170,169,1,0,0,1,0.994117647058824
"900841219","TUCUMAN",373,372,1,0,0,1,0.997319034852547
"900560303","TUCUMAN",223,0,88,123,2,213,0
"300210408","ENTRE RIOS",21,0,2,17,0,19,0
"900141409","TUCUMAN",393,2,161,193,10,364,0.00508905852417303
"900141407","TUCUMAN",328,5,134,161,0,295,0.0152439024390244
"900141301","TUCUMAN",346,299,5,41,0,46,0.864161849710983
"900141223","TUCUMAN",322,7,165,126,1,292,0.0217391304347826
"900141209","TUCUMAN",337,10,200,110,3,313,0.029673590504451
"900141106","TUCUMAN",391,0,228,136,4,368,0
"900841203","TUCUMAN",305,305,0,0,0,0,1
"900841109","TUCUMAN",321,5,41,233,27,301,0.0155763239875389
"900841413","TUCUMAN",270,250,11,5,0,16,0.925925925925926
"900841025","TUCUMAN",86,6,30,33,2,65,0.0697674418604651
"900841308","TUCUMAN",240,239,1,0,0,1,0.995833333333333
"900210707","TUCUMAN",301,266,1,2,0,3,0.883720930232558
"900841012","TUCUMAN",231,223,4,1,0,5,0.965367965367965
"900841003","TUCUMAN",240,44,120,74,0,194,0.183333333333333
"900840911","TUCUMAN",292,288,2,1,0,3,0.986301369863014
"900840908","TUCUMAN",200,192,3,5,0,8,0.96
"900843004","TUCUMAN",231,228,3,0,0,3,0.987012987012987
"900840805","TUCUMAN",488,94,171,199,4,374,0.192622950819672
"900840803","TUCUMAN",340,74,89,162,2,253,0.217647058823529
"900140208","TUCUMAN",363,6,128,205,1,334,0.0165289256198347
"900840812","TUCUMAN",351,302,17,27,1,45,0.86039886039886
"900140127","TUCUMAN",434,12,185,200,4,389,0.0276497695852535
"900140123","TUCUMAN",332,19,167,140,0,307,0.0572289156626506
"900842014","TUCUMAN",187,187,0,0,0,0,1
"900842104","TUCUMAN",224,222,1,0,0,1,0.991071428571429
"900140116","TUCUMAN",466,15,270,157,9,436,0.0321888412017167
"900842006","TUCUMAN",191,191,0,0,0,0,1
"900490508","TUCUMAN",232,0,179,38,1,218,0
"900420217","TUCUMAN",154,131,2,18,3,23,0.850649350649351
"901190304","TUCUMAN",243,0,110,118,13,241,0
"901120308","TUCUMAN",116,0,72,41,2,115,0
"900280319","TUCUMAN",316,126,85,89,3,177,0.39873417721519
"900700412","TUCUMAN",270,2,164,80,14,258,0.00740740740740741
"900210724","TUCUMAN",284,278,2,3,0,5,0.97887323943662
"900210612","TUCUMAN",298,294,1,3,0,4,0.986577181208054
"900210611","TUCUMAN",317,304,5,6,0,11,0.958990536277603
"900210610","TUCUMAN",400,365,7,22,0,29,0.9125
"900210603","TUCUMAN",369,189,80,77,2,159,0.51219512195122
"900210705","TUCUMAN",212,137,21,35,4,60,0.64622641509434
"900141616","TUCUMAN",524,8,208,262,10,480,0.0152671755725191
"900842003","TUCUMAN",185,184,1,0,0,1,0.994594594594595
"901190512","TUCUMAN",375,204,82,79,1,162,0.544
"140840315","CORDOBA",175,0,93,78,3,174,0
"900560309","TUCUMAN",288,37,159,67,1,227,0.128472222222222
"900350113","TUCUMAN",324,0,222,84,2,308,0
"900280208","TUCUMAN",206,6,73,119,4,196,0.029126213592233
"900280107","TUCUMAN",266,201,30,18,3,51,0.755639097744361
"900210706","TUCUMAN",381,377,2,1,1,4,0.989501312335958
"900141604","TUCUMAN",206,42,69,63,0,132,0.203883495145631
"900701403","TUCUMAN",174,159,4,5,0,9,0.913793103448276
"900140118","TUCUMAN",296,3,218,71,1,290,0.0101351351351351
"900841024","TUCUMAN",352,325,8,10,1,19,0.923295454545455
"900841018","TUCUMAN",265,255,4,4,0,8,0.962264150943396
"900840813","TUCUMAN",271,255,9,6,0,15,0.940959409594096
"900841506","TUCUMAN",328,314,5,3,1,9,0.957317073170732
"900840816","TUCUMAN",329,302,8,15,0,23,0.917933130699088
"900840414","TUCUMAN",205,90,25,57,2,84,0.439024390243902
"900840809","TUCUMAN",226,179,17,26,0,43,0.792035398230089
"900840411","TUCUMAN",200,177,7,10,2,19,0.885
"900840405","TUCUMAN",288,270,3,4,1,8,0.9375
"900840511","TUCUMAN",164,146,0,5,0,5,0.890243902439024
"900840222","TUCUMAN",324,295,9,11,3,23,0.910493827160494
"900842912","TUCUMAN",200,6,64,108,2,174,0.03
"900842614","TUCUMAN",320,253,17,32,4,53,0.790625
"900842609","TUCUMAN",214,162,22,21,6,49,0.757009345794392
"900842610","TUCUMAN",241,90,11,126,7,144,0.37344398340249
"900842417","TUCUMAN",215,156,24,20,0,44,0.725581395348837
"900842416","TUCUMAN",485,297,62,112,0,174,0.612371134020619
"901120404","TUCUMAN",195,0,58,109,4,171,0
"900910105","TUCUMAN",293,210,39,40,1,80,0.716723549488055
"901120201","TUCUMAN",27,0,2,13,3,18,0
"900980406","TUCUMAN",171,0,54,90,7,151,0
"900841017","TUCUMAN",221,215,4,2,0,6,0.972850678733032
"901050104","TUCUMAN",13,0,0,8,2,10,0
"901190310","TUCUMAN",210,15,79,107,2,188,0.0714285714285714
"900980405","TUCUMAN",142,0,18,84,3,105,0
"901050612","TUCUMAN",275,11,138,124,0,262,0.04
"900910807","TUCUMAN",17,0,6,1,1,8,0
"901190216","TUCUMAN",223,6,179,38,0,217,0.0269058295964126
"900980402","TUCUMAN",245,0,65,146,11,222,0
"900980108","TUCUMAN",0,0,0,0,0,0,NA
"900980203","TUCUMAN",14,0,6,6,1,13,0
"900841008","TUCUMAN",379,279,28,31,14,73,0.736147757255937
"900910808","TUCUMAN",132,0,52,47,6,105,0
"900910805","TUCUMAN",56,0,15,15,11,41,0
"901120215","TUCUMAN",162,0,117,41,0,158,0
"900910702","TUCUMAN",186,6,16,125,18,159,0.032258064516129
"900910402","TUCUMAN",97,1,12,49,6,67,0.0103092783505155
"900842805","TUCUMAN",295,4,45,229,3,277,0.0135593220338983
"900842714","TUCUMAN",396,384,4,2,3,9,0.96969696969697
"900910606","TUCUMAN",30,0,4,12,10,26,0
"900910604","TUCUMAN",42,0,7,25,8,40,0
"901190211","TUCUMAN",309,2,186,104,1,291,0.00647249190938511
"901051020","TUCUMAN",167,6,76,59,0,135,0.0359281437125748
"900910601","TUCUMAN",26,0,4,20,0,24,0
"900070502","TUCUMAN",52,1,0,47,2,49,0.0192307692307692
"900910301","TUCUMAN",76,0,3,47,12,62,0
"900910207","TUCUMAN",168,0,43,80,24,147,0
"900070702","TUCUMAN",104,0,45,54,1,100,0
"900770406","TUCUMAN",144,1,57,72,11,140,0.00694444444444444
"900842702","TUCUMAN",455,394,14,23,1,38,0.865934065934066
"541050204","MISIONES",72,0,27,6,29,62,0
"900910202","TUCUMAN",87,1,29,49,4,82,0.0114942528735632
"900910201","TUCUMAN",161,2,51,94,6,151,0.0124223602484472
"900770605","TUCUMAN",180,0,32,135,3,170,0
"900070609","TUCUMAN",131,0,54,62,3,119,0
"900700601","TUCUMAN",3,0,2,1,0,3,0
"900700408","TUCUMAN",48,0,20,14,13,47,0
"900070401","TUCUMAN",70,1,23,39,2,64,0.0142857142857143
"900140505","TUCUMAN",70,0,10,44,9,63,0
"900630205","TUCUMAN",18,0,3,13,1,17,0
"900560910","TUCUMAN",35,0,11,20,0,31,0
"900630203","TUCUMAN",18,0,7,9,1,17,0
"900561205","TUCUMAN",125,0,32,81,0,113,0
"900561107","TUCUMAN",211,0,73,121,5,199,0
"900843018","TUCUMAN",473,196,91,178,2,271,0.414376321353066
"900561005","TUCUMAN",109,0,25,80,3,108,0
"900560901","TUCUMAN",71,1,20,41,0,61,0.0140845070422535
"900560604","TUCUMAN",35,0,4,22,4,30,0
"900350108","TUCUMAN",11,0,4,5,0,9,0
"901051014","TUCUMAN",4,0,0,4,0,4,0
"901050207","TUCUMAN",48,0,23,20,2,45,0
"900842511","TUCUMAN",480,173,149,140,1,290,0.360416666666667
"900350106","TUCUMAN",39,0,3,17,13,33,0
"900350103","TUCUMAN",32,0,4,19,6,29,0
"900280306","TUCUMAN",212,5,106,78,14,198,0.0235849056603774
"900280302","TUCUMAN",76,0,14,54,5,73,0
"901051011","TUCUMAN",253,3,141,100,5,246,0.0118577075098814
"221330405","CHACO",77,0,2,32,36,70,0
"900280207","TUCUMAN",251,45,67,125,1,193,0.179282868525896
"900210718","TUCUMAN",226,0,90,106,16,212,0
"900210302","TUCUMAN",132,0,23,98,3,124,0
"900842905","TUCUMAN",235,78,40,112,1,153,0.331914893617021
"900210109","TUCUMAN",234,0,72,128,10,210,0
"900141202","TUCUMAN",184,0,63,103,2,168,0
"900141001","TUCUMAN",158,1,72,73,0,145,0.00632911392405063
"900140802","TUCUMAN",62,5,26,26,0,52,0.0806451612903226
"900071003","TUCUMAN",65,0,23,30,5,58,0
"900842820","TUCUMAN",232,214,5,10,0,15,0.922413793103448
"900842806","TUCUMAN",294,3,82,195,3,280,0.0102040816326531
"900842504","TUCUMAN",276,262,4,8,1,13,0.949275362318841
"900842307","TUCUMAN",243,235,2,4,0,6,0.967078189300412
"900210102","TUCUMAN",104,1,11,58,18,87,0.00961538461538462
"900071002","TUCUMAN",54,1,7,39,0,46,0.0185185185185185
"900560405","TUCUMAN",27,2,7,10,4,21,0.0740740740740741
"900560704","TUCUMAN",141,2,47,81,5,133,0.0141843971631206
"900560101","TUCUMAN",29,0,18,8,2,28,0
"900490701","TUCUMAN",1,0,1,0,0,1,0
"900490402","TUCUMAN",166,0,76,70,3,149,0
"900420402","TUCUMAN",99,3,26,46,2,74,0.0303030303030303
"900560505","TUCUMAN",80,1,32,38,3,73,0.0125
"900420207","TUCUMAN",57,0,3,22,28,53,0
"900420206","TUCUMAN",47,4,1,39,0,40,0.0851063829787234
"901050909","TUCUMAN",276,261,7,7,0,14,0.945652173913043
"900841811","TUCUMAN",321,298,1,1,0,2,0.928348909657321
"900350301","TUCUMAN",80,0,23,37,5,65,0
"900350202","TUCUMAN",20,0,3,6,0,9,0
"900280206","TUCUMAN",524,170,141,170,14,325,0.324427480916031
"901050102","TUCUMAN",18,0,2,1,3,6,0
"900420305","TUCUMAN",96,2,10,56,14,80,0.0208333333333333
"900210406","TUCUMAN",180,7,104,51,5,160,0.0388888888888889
"900842204","TUCUMAN",200,151,14,34,0,48,0.755
"900842108","TUCUMAN",223,223,0,0,0,0,1
"900841914","TUCUMAN",193,193,0,0,0,0,1
"900842415","TUCUMAN",482,124,139,212,1,352,0.257261410788382
"901190502","TUCUMAN",235,95,68,36,0,104,0.404255319148936
"901190313","TUCUMAN",355,134,166,48,0,214,0.377464788732394
"900700301","TUCUMAN",375,5,156,153,22,331,0.0133333333333333
"900140606","TUCUMAN",135,2,104,21,3,128,0.0148148148148148
"900070904","TUCUMAN",202,22,48,106,11,165,0.108910891089109
"900070607","TUCUMAN",184,5,73,87,5,165,0.0271739130434783
"901050905","TUCUMAN",323,159,65,85,0,150,0.492260061919505
"901050903","TUCUMAN",477,167,66,228,4,298,0.350104821802935
"901050710","TUCUMAN",207,11,107,87,0,194,0.0531400966183575
"901050709","TUCUMAN",273,4,74,155,12,241,0.0146520146520147
"901050707","TUCUMAN",144,2,81,58,1,140,0.0138888888888889
"901050621","TUCUMAN",427,11,202,160,30,392,0.0257611241217799
"901050606","TUCUMAN",230,8,143,79,0,222,0.0347826086956522
"901050613","TUCUMAN",226,1,191,30,0,221,0.00442477876106195
"900980311","TUCUMAN",179,0,128,43,3,174,0
"901050715","TUCUMAN",153,115,9,29,0,38,0.751633986928105
"900630418","TUCUMAN",262,212,25,22,0,47,0.809160305343511
"900842223","TUCUMAN",222,2,24,156,19,199,0.00900900900900901
"900841712","TUCUMAN",297,249,2,0,1,3,0.838383838383838
"900841706","TUCUMAN",280,223,6,5,0,11,0.796428571428571
"900841702","TUCUMAN",348,342,1,3,0,4,0.982758620689655
"900841622","TUCUMAN",165,113,13,37,0,50,0.684848484848485
"900842018","TUCUMAN",375,374,1,0,0,1,0.997333333333333
"900840611","TUCUMAN",206,198,6,1,0,7,0.961165048543689
"900840501","TUCUMAN",333,306,10,9,3,22,0.918918918918919
"900840401","TUCUMAN",397,278,21,79,7,107,0.700251889168766
"900840312","TUCUMAN",201,175,5,11,0,16,0.870646766169154
"900840213","TUCUMAN",221,189,5,4,0,9,0.855203619909502
"900840211","TUCUMAN",186,186,0,0,0,0,1
"900840125","TUCUMAN",268,233,21,11,0,32,0.869402985074627
"900840121","TUCUMAN",215,215,0,0,0,0,1
"900840107","TUCUMAN",357,138,87,108,2,197,0.38655462184874
"900770607","TUCUMAN",393,4,300,78,1,379,0.0101781170483461
"900840101","TUCUMAN",187,34,6,116,9,131,0.181818181818182
"900770109","TUCUMAN",253,216,2,2,0,4,0.853754940711462
"900770104","TUCUMAN",423,255,26,79,10,115,0.602836879432624
"900770103","TUCUMAN",328,282,7,8,0,15,0.859756097560976
"900701421","TUCUMAN",206,93,54,57,0,111,0.451456310679612
"900701402","TUCUMAN",230,138,41,34,9,84,0.6
"900770212","TUCUMAN",122,114,0,0,1,1,0.934426229508197
"900700208","TUCUMAN",239,11,69,140,5,214,0.0460251046025105
"900841304","TUCUMAN",220,220,0,0,0,0,1
"900841006","TUCUMAN",298,174,16,68,2,86,0.583892617449664
"900770101","TUCUMAN",331,14,111,171,9,291,0.0422960725075529
"900630501","TUCUMAN",318,207,27,50,16,93,0.650943396226415
"900630419","TUCUMAN",356,217,74,63,0,137,0.609550561797753
"900630216","TUCUMAN",267,10,162,88,1,251,0.0374531835205993
"900630218","TUCUMAN",296,1,175,102,1,278,0.00337837837837838
"900561305","TUCUMAN",289,134,53,90,3,146,0.463667820069204
"220210606","CHACO",165,4,24,104,7,135,0.0242424242424242
"900141613","TUCUMAN",390,31,202,150,0,352,0.0794871794871795
"900141303","TUCUMAN",400,41,226,103,11,340,0.1025
"900141308","TUCUMAN",243,35,96,86,0,182,0.1440329218107
"900141215","TUCUMAN",212,6,137,60,1,198,0.0283018867924528
"900840703","TUCUMAN",285,280,3,0,1,4,0.982456140350877
"900140710","TUCUMAN",356,3,216,122,3,341,0.00842696629213483
"900140609","TUCUMAN",289,5,253,27,1,281,0.0173010380622837
"900140403","TUCUMAN",214,3,103,96,1,200,0.014018691588785
"900840706","TUCUMAN",357,341,5,8,0,13,0.955182072829132
"900420116","TUCUMAN",225,177,18,26,1,45,0.786666666666667
"900842010","TUCUMAN",249,249,0,0,0,0,1
"900560310","TUCUMAN",305,56,121,119,2,242,0.183606557377049
"900420216","TUCUMAN",148,129,0,0,0,0,0.871621621621622
"900841212","TUCUMAN",349,349,0,0,0,0,1
"900841209","TUCUMAN",357,356,1,0,0,1,0.997198879551821
"900210726","TUCUMAN",280,276,2,0,0,2,0.985714285714286
"900210725","TUCUMAN",417,1,76,245,26,347,0.00239808153477218
"900210722","TUCUMAN",286,254,6,2,2,10,0.888111888111888
"900210717","TUCUMAN",306,237,37,19,1,57,0.774509803921569
"900210710","TUCUMAN",346,266,18,28,0,46,0.76878612716763
"900210704","TUCUMAN",191,120,13,19,1,33,0.628272251308901
"900210618","TUCUMAN",268,208,24,16,3,43,0.776119402985075
"900841603","TUCUMAN",310,286,18,2,1,21,0.92258064516129
"900840817","TUCUMAN",213,205,4,1,0,5,0.962441314553991
"900841004","TUCUMAN",362,178,78,101,3,182,0.49171270718232
"900210602","TUCUMAN",510,276,68,129,6,203,0.541176470588235
"900210410","TUCUMAN",238,2,128,101,2,231,0.00840336134453781
"900841206","TUCUMAN",169,168,1,0,0,1,0.994082840236686
"900842009","TUCUMAN",246,246,0,0,0,0,1
"900840513","TUCUMAN",285,276,2,2,0,4,0.968421052631579
"900842121","TUCUMAN",209,207,1,1,0,2,0.990430622009569
"901050402","TUCUMAN",207,2,117,67,8,192,0.00966183574879227
"900630106","TUCUMAN",275,226,18,27,0,45,0.821818181818182
"900490404","TUCUMAN",29,0,10,19,0,29,0
"900840402","TUCUMAN",349,316,0,17,10,27,0.905444126074499
"901050810","TUCUMAN",292,254,18,19,0,37,0.86986301369863
"901050809","TUCUMAN",306,160,60,71,0,131,0.522875816993464
"900842008","TUCUMAN",207,206,1,0,0,1,0.995169082125604
"900842612","TUCUMAN",248,107,50,82,4,136,0.431451612903226
"900141217","TUCUMAN",354,8,160,168,0,328,0.0225988700564972
"901120209","TUCUMAN",58,0,33,18,4,55,0
"900980410","TUCUMAN",91,0,56,29,1,86,0
"901120307","TUCUMAN",147,0,35,51,24,110,0
"900980307","TUCUMAN",5,0,1,2,0,3,0
"900910902","TUCUMAN",76,0,31,33,7,71,0
"900842505","TUCUMAN",352,338,3,9,1,13,0.960227272727273
"901120107","TUCUMAN",16,0,0,5,0,5,0
"901050302","TUCUMAN",125,0,17,89,2,108,0
"900980201","TUCUMAN",12,0,0,5,6,11,0
"900561210","TUCUMAN",33,0,4,21,2,27,0
"900910804","TUCUMAN",95,0,8,64,16,88,0
"900910901","TUCUMAN",60,0,32,20,5,57,0
"900910603","TUCUMAN",75,2,18,43,9,70,0.0266666666666667
"900910401","TUCUMAN",40,0,6,30,0,36,0
"900910306","TUCUMAN",159,0,41,66,36,143,0
"900842402","TUCUMAN",338,309,6,10,1,17,0.914201183431953
"900910501","TUCUMAN",154,0,61,53,24,138,0
"900910203","TUCUMAN",144,0,80,49,11,140,0
"900070905","TUCUMAN",55,0,11,40,1,52,0
"900770301","TUCUMAN",103,1,65,26,9,100,0.00970873786407767
"900701201","TUCUMAN",3,0,0,1,2,3,0
"900700803","TUCUMAN",87,1,22,54,6,82,0.0114942528735632
"900700409","TUCUMAN",211,0,43,129,18,190,0
"900700802","TUCUMAN",11,0,7,2,2,11,0
"900700405","TUCUMAN",121,3,18,78,6,102,0.0247933884297521
"900700305","TUCUMAN",48,0,7,29,8,44,0
"900561002","TUCUMAN",16,0,3,10,0,13,0
"900630303","TUCUMAN",151,10,75,45,4,124,0.0662251655629139
"900630210","TUCUMAN",26,0,2,21,0,23,0
"900350306","TUCUMAN",12,0,3,7,1,11,0
"900842304","TUCUMAN",328,312,5,7,1,13,0.951219512195122
"900420306","TUCUMAN",291,0,175,95,8,278,0
"900630202","TUCUMAN",91,0,3,50,17,70,0
"900630208","TUCUMAN",5,0,3,2,0,5,0
"900630302","TUCUMAN",495,18,153,279,8,440,0.0363636363636364
"900630206","TUCUMAN",201,6,26,134,1,161,0.0298507462686567
"900561302","TUCUMAN",89,0,19,59,8,86,0
"900560909","TUCUMAN",48,0,6,39,1,46,0
"900560908","TUCUMAN",107,0,6,59,21,86,0
"900560701","TUCUMAN",102,1,34,59,2,95,0.00980392156862745
"900210505","TUCUMAN",21,0,6,9,5,20,0
"900842115","TUCUMAN",234,167,16,41,3,60,0.713675213675214
"900842206","TUCUMAN",333,248,42,38,3,83,0.744744744744745
"900350112","TUCUMAN",154,0,61,54,23,138,0
"900350101","TUCUMAN",230,0,84,101,24,209,0
"900210504","TUCUMAN",146,0,51,65,13,129,0
"901120106","TUCUMAN",21,0,0,10,3,13,0
"900280204","TUCUMAN",43,0,5,30,5,40,0
"900140101","TUCUMAN",122,2,17,89,0,106,0.0163934426229508
"900420113","TUCUMAN",280,272,0,0,0,0,0.971428571428571
"901120103","TUCUMAN",41,0,13,20,3,36,0
"901050901","TUCUMAN",15,0,5,4,0,9,0
"900141601","TUCUMAN",183,39,16,105,3,124,0.213114754098361
"900140801","TUCUMAN",77,0,18,48,2,68,0
"900140604","TUCUMAN",22,0,2,15,5,22,0
"900140503","TUCUMAN",134,1,16,92,10,118,0.00746268656716418
"900140501","TUCUMAN",32,0,0,20,0,20,0
"900140206","TUCUMAN",41,0,4,24,8,36,0
"900140202","TUCUMAN",132,1,12,102,8,122,0.00757575757575758
"900841210","TUCUMAN",293,292,1,0,0,1,0.996587030716723
"900070809","TUCUMAN",64,0,7,50,2,59,0
"900070610","TUCUMAN",110,1,35,64,5,104,0.00909090909090909
"900140506","TUCUMAN",91,0,6,63,9,78,0
"900070304","TUCUMAN",18,0,6,7,1,14,0
"900070202","TUCUMAN",26,0,1,20,1,22,0
"900140401","TUCUMAN",36,0,6,26,1,33,0
"900070705","TUCUMAN",57,0,5,40,2,47,0
"900560403","TUCUMAN",115,3,36,49,13,98,0.0260869565217391
"900560805","TUCUMAN",221,0,51,140,12,203,0
"900701407","TUCUMAN",187,141,20,25,1,46,0.754010695187166
"900560102","TUCUMAN",34,2,18,13,0,31,0.0588235294117647
"900490602","TUCUMAN",149,0,67,65,3,135,0
"900490504","TUCUMAN",30,0,1,20,6,27,0
"900490503","TUCUMAN",12,0,6,4,1,11,0
"900490202","TUCUMAN",17,0,2,14,0,16,0
"900770113","TUCUMAN",237,204,9,17,0,26,0.860759493670886
"900420401","TUCUMAN",21,0,2,8,3,13,0
"900420208","TUCUMAN",170,0,37,70,33,140,0
"900350304","TUCUMAN",40,0,1,14,19,34,0
"900070903","TUCUMAN",150,1,49,79,4,132,0.00666666666666667
"900350203","TUCUMAN",10,0,0,5,2,7,0
"900070504","TUCUMAN",67,0,4,53,0,57,0
"900980305","TUCUMAN",30,0,8,17,3,28,0
"900910504","TUCUMAN",37,0,2,22,10,34,0
"900070805","TUCUMAN",186,2,61,98,10,169,0.010752688172043
"900842405","TUCUMAN",251,239,6,5,0,11,0.952191235059761
"900842122","TUCUMAN",196,194,2,0,0,2,0.989795918367347
"900350111","TUCUMAN",154,0,19,93,28,140,0
"900701002","TUCUMAN",86,0,65,17,3,85,0
"900842202","TUCUMAN",369,336,2,25,2,29,0.910569105691057
"900700602","TUCUMAN",285,2,170,64,30,264,0.00701754385964912
"900700203","TUCUMAN",111,1,42,44,5,91,0.00900900900900901
"900141501","TUCUMAN",263,2,83,157,3,243,0.00760456273764259
"900841919","TUCUMAN",380,375,1,0,0,1,0.986842105263158
"901190412","TUCUMAN",198,42,86,68,0,154,0.212121212121212
"900770107","TUCUMAN",244,224,11,8,0,19,0.918032786885246
"901190201","TUCUMAN",292,116,50,120,0,170,0.397260273972603
"900210104","TUCUMAN",311,12,142,101,27,270,0.0385852090032154
"900842410","TUCUMAN",325,321,0,2,0,2,0.987692307692308
"901190409","TUCUMAN",440,58,139,201,1,341,0.131818181818182
"901190315","TUCUMAN",239,28,66,136,4,206,0.117154811715481
"901190309","TUCUMAN",239,15,144,77,1,222,0.0627615062761506
"901190307","TUCUMAN",262,5,256,1,0,257,0.0190839694656489
"901190306","TUCUMAN",280,5,167,102,1,270,0.0178571428571429
"901120213","TUCUMAN",416,0,278,105,11,394,0
"901120116","TUCUMAN",85,0,66,17,1,84,0
"901051023","TUCUMAN",302,0,110,148,3,261,0
"901051015","TUCUMAN",320,5,68,232,1,301,0.015625
"901050806","TUCUMAN",244,156,18,30,0,48,0.639344262295082
"901050804","TUCUMAN",348,277,34,24,0,58,0.795977011494253
"901050718","TUCUMAN",25,25,0,0,0,0,1
"900980414","TUCUMAN",155,0,47,92,0,139,0
"900910101","TUCUMAN",447,33,177,162,3,342,0.0738255033557047
"900843015","TUCUMAN",435,326,16,52,1,69,0.749425287356322
"900842909","TUCUMAN",335,180,45,99,0,144,0.537313432835821
"900842821","TUCUMAN",221,154,11,52,0,63,0.69683257918552
"900842817","TUCUMAN",285,32,76,163,4,243,0.112280701754386
"900842703","TUCUMAN",283,266,6,8,0,14,0.939929328621908
"900842615","TUCUMAN",388,172,26,109,44,179,0.443298969072165
"900842513","TUCUMAN",403,384,8,8,1,17,0.952853598014888
"900840309","TUCUMAN",217,200,2,7,0,9,0.921658986175115
"900842111","TUCUMAN",177,75,31,59,4,94,0.423728813559322
"900841621","TUCUMAN",268,212,33,19,1,53,0.791044776119403
"900841618","TUCUMAN",323,284,8,3,0,11,0.879256965944272
"900840608","TUCUMAN",301,200,19,38,0,57,0.664451827242525
"900840215","TUCUMAN",197,176,1,0,0,1,0.893401015228426
"900840209","TUCUMAN",278,275,1,0,0,1,0.989208633093525
"900840205","TUCUMAN",497,439,13,18,0,31,0.883299798792757
"900840120","TUCUMAN",221,217,2,0,0,2,0.981900452488688
"900840109","TUCUMAN",247,234,6,6,0,12,0.947368421052632
"900840217","TUCUMAN",229,202,26,1,0,27,0.882096069868996
"900770124","TUCUMAN",237,225,8,4,0,12,0.949367088607595
"900701304","TUCUMAN",336,307,13,12,0,25,0.913690476190476
"900630509","TUCUMAN",441,291,71,60,1,132,0.659863945578231
"900770112","TUCUMAN",231,188,14,6,0,20,0.813852813852814
"900770111","TUCUMAN",246,228,0,0,0,0,0.926829268292683
"900630215","TUCUMAN",332,6,179,139,2,320,0.0180722891566265
"900630214","TUCUMAN",169,4,132,29,0,161,0.0236686390532544
"900630217","TUCUMAN",275,7,177,77,1,255,0.0254545454545455
"900630113","TUCUMAN",307,284,13,8,0,21,0.925081433224756
"900630109","TUCUMAN",292,230,26,34,0,60,0.787671232876712
"900841226","TUCUMAN",309,309,0,0,0,0,1
"900561213","TUCUMAN",285,37,121,115,3,239,0.129824561403509
"900841224","TUCUMAN",105,105,0,0,0,0,1
"900841223","TUCUMAN",235,235,0,0,0,0,1
"900841315","TUCUMAN",176,176,0,0,0,0,1
"900141603","TUCUMAN",241,45,105,86,1,192,0.186721991701245
"900141602","TUCUMAN",395,226,79,83,1,163,0.572151898734177
"900490509","TUCUMAN",390,0,295,82,2,379,0
"900141305","TUCUMAN",239,129,26,76,0,102,0.539748953974895
"900141225","TUCUMAN",205,7,126,59,0,185,0.0341463414634146
"900141211","TUCUMAN",299,11,96,177,4,277,0.0367892976588629
"900141210","TUCUMAN",437,2,243,167,3,413,0.0045766590389016
"900841318","TUCUMAN",313,297,7,8,0,15,0.94888178913738
"900841414","TUCUMAN",267,251,5,5,1,11,0.940074906367041
"900841107","TUCUMAN",319,18,20,234,6,260,0.0564263322884013
"900841310","TUCUMAN",258,258,0,0,0,0,1
"900841101","TUCUMAN",229,223,2,2,0,4,0.973799126637555
"900841002","TUCUMAN",502,209,89,169,10,268,0.416334661354582
"900840913","TUCUMAN",158,154,2,2,0,4,0.974683544303797
"900840904","TUCUMAN",210,204,4,1,0,5,0.971428571428571
"900840708","TUCUMAN",387,372,7,2,0,9,0.961240310077519
"900140131","TUCUMAN",434,227,77,106,3,186,0.523041474654378
"900140112","TUCUMAN",625,7,379,218,1,598,0.0112
"900140108","TUCUMAN",219,4,80,128,1,209,0.0182648401826484
"900140107","TUCUMAN",273,0,63,189,3,255,0
"900140106","TUCUMAN",161,4,93,64,0,157,0.0248447204968944
"900140105","TUCUMAN",202,11,62,116,4,182,0.0544554455445545
"900700606","TUCUMAN",240,3,162,52,20,234,0.0125
"900490511","TUCUMAN",357,0,217,115,5,337,0
"900210723","TUCUMAN",225,5,125,85,0,210,0.0222222222222222
"900210702","TUCUMAN",361,223,41,66,6,113,0.617728531855956
"900210620","TUCUMAN",166,152,12,1,0,13,0.91566265060241
"900210709","TUCUMAN",298,245,21,19,4,44,0.822147651006711
"900210617","TUCUMAN",183,139,10,1,0,11,0.759562841530055
"900210711","TUCUMAN",158,149,0,0,0,0,0.943037974683544
"901190511","TUCUMAN",178,165,6,7,0,13,0.926966292134832
"900980411","TUCUMAN",74,0,60,12,0,72,0
"900910704","TUCUMAN",80,0,44,34,0,78,0
"900700414","TUCUMAN",226,6,147,66,2,215,0.0265486725663717
"900560311","TUCUMAN",429,249,87,86,2,175,0.58041958041958
"900350212","TUCUMAN",233,0,140,76,5,221,0
"900210715","TUCUMAN",273,271,0,0,0,0,0.992673992673993
"900210714","TUCUMAN",267,257,4,4,0,8,0.962546816479401
"900843013","TUCUMAN",402,71,149,174,0,323,0.176616915422886
"900842816","TUCUMAN",289,203,23,56,0,79,0.70242214532872
"900842607","TUCUMAN",280,227,29,24,0,53,0.810714285714286
"900842604","TUCUMAN",340,92,74,157,1,232,0.270588235294118
"900840915","TUCUMAN",306,292,5,5,0,10,0.954248366013072
"901190501","TUCUMAN",7,0,5,2,0,7,0
"901120304","TUCUMAN",28,0,1,14,6,21,0
"901120302","TUCUMAN",228,0,87,76,37,200,0
"901120210","TUCUMAN",326,0,80,190,21,291,0
"901051005","TUCUMAN",440,1,177,227,2,406,0.00227272727272727
"901120203","TUCUMAN",92,0,15,60,11,86,0
"900980404","TUCUMAN",5,0,1,0,1,2,0
"900980306","TUCUMAN",0,0,0,0,0,0,NA
"900910803","TUCUMAN",71,0,8,45,17,70,0
"901050917","TUCUMAN",166,13,62,75,1,138,0.0783132530120482
"900910302","TUCUMAN",170,0,29,83,52,164,0
"900980302","TUCUMAN",7,0,1,3,1,5,0
"900910209","TUCUMAN",126,0,18,67,25,110,0
"900980301","TUCUMAN",11,0,1,4,3,8,0
"900700502","TUCUMAN",161,0,48,75,30,153,0
"900700410","TUCUMAN",46,0,4,26,16,46,0
"901050915","TUCUMAN",277,271,2,4,0,6,0.978339350180505
"900770207","TUCUMAN",61,0,28,17,3,48,0
"900770206","TUCUMAN",51,0,22,20,4,46,0
"900770204","TUCUMAN",69,0,6,50,2,58,0
"900700801","TUCUMAN",37,0,6,14,13,33,0
"900840123","TUCUMAN",425,369,6,15,0,21,0.868235294117647
"900630403","TUCUMAN",143,0,71,63,1,135,0
"900630409","TUCUMAN",1,0,1,0,0,1,0
"900630408","TUCUMAN",145,46,30,48,0,78,0.317241379310345
"900630304","TUCUMAN",37,1,7,25,1,33,0.027027027027027
"900350104","TUCUMAN",8,0,1,2,5,8,0
"900280312","TUCUMAN",106,0,39,56,2,97,0
"900561306","TUCUMAN",36,0,12,19,1,32,0
"900210301","TUCUMAN",118,1,34,68,8,110,0.00847457627118644
"900770415","TUCUMAN",247,89,103,51,1,155,0.360323886639676
"900561304","TUCUMAN",202,26,63,97,6,166,0.128712871287129
"900561212","TUCUMAN",96,0,16,72,5,93,0
"900561211","TUCUMAN",117,2,33,71,2,106,0.0170940170940171
"900561207","TUCUMAN",153,0,49,93,6,148,0
"900561206","TUCUMAN",126,0,42,52,25,119,0
"900840508","TUCUMAN",184,157,3,7,0,10,0.853260869565217
"900561003","TUCUMAN",182,0,41,128,7,176,0
"900561106","TUCUMAN",67,0,8,44,11,63,0
"900560501","TUCUMAN",74,0,25,43,4,72,0
"901050914","TUCUMAN",339,238,43,46,1,90,0.702064896755162
"900280303","TUCUMAN",33,12,2,19,0,21,0.363636363636364
"900141101","TUCUMAN",68,0,40,24,0,64,0
"900140805","TUCUMAN",169,0,106,52,5,163,0
"900140803","TUCUMAN",98,0,8,80,2,90,0
"900070701","TUCUMAN",112,1,45,58,2,105,0.00892857142857143
"900070602","TUCUMAN",91,1,29,53,0,82,0.010989010989011
"900280301","TUCUMAN",5,0,0,4,0,4,0
"900280201","TUCUMAN",10,0,0,5,2,7,0
"900560803","TUCUMAN",117,1,9,75,19,103,0.00854700854700855
"900210501","TUCUMAN",149,0,32,91,10,133,0
"900070507","TUCUMAN",71,0,3,49,9,61,0
"900840311","TUCUMAN",196,186,3,7,0,10,0.948979591836735
"900210202","TUCUMAN",80,2,20,36,7,63,0.025
"900210103","TUCUMAN",0,0,0,0,0,0,NA
"900141404","TUCUMAN",47,0,6,32,4,42,0
"900141103","TUCUMAN",46,0,15,27,0,42,0
"900140601","TUCUMAN",131,0,25,77,10,112,0
"900560404","TUCUMAN",35,0,1,33,0,34,0
"900560202","TUCUMAN",1,0,0,0,0,0,0
"900560201","TUCUMAN",50,0,22,19,5,46,0
"900560804","TUCUMAN",101,0,16,68,7,91,0
"900350305","TUCUMAN",52,0,0,9,25,34,0
"900350302","TUCUMAN",39,0,1,33,3,37,0
"900350210","TUCUMAN",5,0,1,0,1,2,0
"901190210","TUCUMAN",199,4,173,22,0,195,0.0201005025125628
"901051019","TUCUMAN",195,1,92,97,1,190,0.00512820512820513
"900350207","TUCUMAN",71,0,5,38,7,50,0
"900140303","TUCUMAN",29,0,1,21,5,27,0
"900070709","TUCUMAN",63,1,18,38,0,56,0.0158730158730159
"900700904","TUCUMAN",70,0,30,26,2,58,0
"900561402","TUCUMAN",85,1,42,40,1,83,0.0117647058823529
"900140602","TUCUMAN",14,0,2,11,1,14,0
"901190217","TUCUMAN",266,4,88,170,0,258,0.0150375939849624
"901051009","TUCUMAN",416,10,302,98,1,401,0.0240384615384615
"900770411","TUCUMAN",144,0,49,69,14,132,0
"900561404","TUCUMAN",351,130,110,100,3,213,0.37037037037037
"900420212","TUCUMAN",506,121,87,224,41,352,0.239130434782609
"900210701","TUCUMAN",429,204,89,114,13,216,0.475524475524476
"900140104","TUCUMAN",180,3,70,83,0,153,0.0166666666666667
"901190302","TUCUMAN",190,31,97,52,0,149,0.163157894736842
"900842219","TUCUMAN",341,2,71,259,1,331,0.00586510263929619
"900842203","TUCUMAN",229,188,7,11,1,19,0.820960698689956
"900842002","TUCUMAN",207,207,0,0,0,0,1
"900841916","TUCUMAN",296,293,2,0,0,2,0.989864864864865
"901190514","TUCUMAN",322,82,152,79,3,234,0.254658385093168
"901190312","TUCUMAN",173,7,135,31,0,166,0.0404624277456647
"901190206","TUCUMAN",369,6,209,135,1,345,0.016260162601626
"901190214","TUCUMAN",188,10,132,46,0,178,0.0531914893617021
"901050807","TUCUMAN",313,240,28,40,1,69,0.766773162939297
"901050803","TUCUMAN",340,262,40,27,1,68,0.770588235294118
"901050603","TUCUMAN",379,3,336,37,2,375,0.0079155672823219
"901050608","TUCUMAN",132,0,79,49,0,128,0
"901050615","TUCUMAN",236,4,143,87,1,231,0.0169491525423729
"900910607","TUCUMAN",117,4,53,48,3,104,0.0341880341880342
"900843019","TUCUMAN",117,110,5,2,0,7,0.94017094017094
"900843014","TUCUMAN",329,204,43,75,2,120,0.620060790273556
"900843012","TUCUMAN",375,44,112,206,2,320,0.117333333333333
"900843005","TUCUMAN",252,247,0,4,0,4,0.98015873015873
"900842916","TUCUMAN",202,1,84,102,0,186,0.00495049504950495
"900842910","TUCUMAN",249,6,95,140,0,235,0.0240963855421687
"900842824","TUCUMAN",417,340,17,53,2,72,0.815347721822542
"900840308","TUCUMAN",293,271,13,5,0,18,0.924914675767918
"900842706","TUCUMAN",383,326,6,31,0,37,0.851174934725849
"900842514","TUCUMAN",329,285,17,24,0,41,0.866261398176292
"900842502","TUCUMAN",163,8,31,112,6,149,0.049079754601227
"900842312","TUCUMAN",264,261,1,0,0,1,0.988636363636364
"900842310","TUCUMAN",336,317,11,4,0,15,0.943452380952381
"900842305","TUCUMAN",306,289,9,7,0,16,0.944444444444444
"900842211","TUCUMAN",228,199,1,8,0,9,0.87280701754386
"900842114","TUCUMAN",450,366,15,44,0,59,0.813333333333333
"900842113","TUCUMAN",384,370,4,1,0,5,0.963541666666667
"900841708","TUCUMAN",371,364,3,2,0,5,0.981132075471698
"900841707","TUCUMAN",187,149,6,0,0,6,0.796791443850267
"900841703","TUCUMAN",311,293,9,5,0,14,0.942122186495177
"900841407","TUCUMAN",311,303,1,6,0,7,0.97427652733119
"900840607","TUCUMAN",255,246,5,4,0,9,0.964705882352941
"900840604","TUCUMAN",294,283,7,2,0,9,0.962585034013605
"900141304","TUCUMAN",181,181,0,0,0,0,1
"900840601","TUCUMAN",155,100,4,47,1,52,0.645161290322581
"900840416","TUCUMAN",383,179,52,137,4,193,0.467362924281984
"900770209","TUCUMAN",308,48,119,136,1,256,0.155844155844156
"900770105","TUCUMAN",412,333,18,42,2,62,0.808252427184466
"900770102","TUCUMAN",328,15,103,185,6,294,0.0457317073170732
"900701416","TUCUMAN",252,176,39,33,1,73,0.698412698412698
"900841305","TUCUMAN",292,292,0,0,0,0,1
"900700205","TUCUMAN",352,4,186,140,8,334,0.0113636363636364
"900770106","TUCUMAN",332,272,15,12,0,27,0.819277108433735
"900630510","TUCUMAN",360,18,61,230,5,296,0.05
"900141212","TUCUMAN",265,0,153,108,0,261,0
"900630506","TUCUMAN",341,299,10,6,0,16,0.87683284457478
"900630105","TUCUMAN",383,121,87,139,6,232,0.315926892950392
"900561407","TUCUMAN",301,61,152,85,1,238,0.20265780730897
"900560408","TUCUMAN",153,151,1,1,0,2,0.986928104575163
"900560302","TUCUMAN",308,16,154,126,5,285,0.051948051948052
"900141208","TUCUMAN",251,4,133,105,3,241,0.0159362549800797
"900140713","TUCUMAN",439,6,212,171,22,405,0.0136674259681093
"900841204","TUCUMAN",255,238,0,0,0,0,0.933333333333333
"900841201","TUCUMAN",268,268,0,0,0,0,1
"900841111","TUCUMAN",318,276,10,27,0,37,0.867924528301887
"900841106","TUCUMAN",325,5,50,229,33,312,0.0153846153846154
"900841309","TUCUMAN",310,310,0,0,0,0,1
"900560301","TUCUMAN",248,11,157,74,2,233,0.0443548387096774
"900141609","TUCUMAN",261,29,134,86,1,221,0.111111111111111
"900210712","TUCUMAN",237,207,5,4,0,9,0.873417721518987
"900841810","TUCUMAN",217,170,12,24,0,36,0.783410138248848
"900141618","TUCUMAN",330,0,95,216,1,312,0
"900141307","TUCUMAN",297,127,71,86,3,160,0.427609427609428
"900141306","TUCUMAN",459,297,69,66,4,139,0.647058823529412
"900841014","TUCUMAN",207,153,13,35,0,48,0.739130434782609
"900840901","TUCUMAN",193,189,3,1,0,4,0.979274611398964
"900841808","TUCUMAN",424,400,9,12,0,21,0.943396226415094
"900840801","TUCUMAN",208,142,30,29,3,62,0.682692307692308
"900840710","TUCUMAN",188,184,1,3,0,4,0.978723404255319
"900140610","TUCUMAN",367,15,186,139,5,330,0.0408719346049046
"900140608","TUCUMAN",174,6,83,75,2,160,0.0344827586206897
"900140125","TUCUMAN",274,4,89,113,38,240,0.0145985401459854
"900840705","TUCUMAN",253,243,9,0,0,9,0.960474308300395
"900700808","TUCUMAN",173,0,84,80,4,168,0
"900420101","TUCUMAN",317,280,6,5,6,17,0.883280757097792
"900280317","TUCUMAN",287,96,100,63,4,167,0.334494773519164
"900280316","TUCUMAN",239,5,122,96,1,219,0.0209205020920502
"900700413","TUCUMAN",329,25,136,121,18,275,0.0759878419452888
"900280113","TUCUMAN",265,204,30,27,0,57,0.769811320754717
"900840704","TUCUMAN",364,327,10,5,0,15,0.898351648351648
"140840111","CORDOBA",296,0,223,63,7,293,0
"900280112","TUCUMAN",435,369,19,34,8,61,0.848275862068966
"900280105","TUCUMAN",310,218,44,31,0,75,0.703225806451613
"900210703","TUCUMAN",228,178,6,24,13,43,0.780701754385965
"900210615","TUCUMAN",247,222,12,7,4,23,0.898785425101215
"900841617","TUCUMAN",277,18,92,152,2,246,0.0649819494584837
"900911104","TUCUMAN",55,4,10,25,7,42,0.0727272727272727
"900843017","TUCUMAN",198,190,6,2,0,8,0.95959595959596
"900420215","TUCUMAN",140,9,37,70,5,112,0.0642857142857143
"900280315","TUCUMAN",3,1,2,0,0,2,0.333333333333333
"900842120","TUCUMAN",247,245,1,1,0,2,0.991902834008097
"900841917","TUCUMAN",160,154,0,0,0,0,0.9625
"900841601","TUCUMAN",297,295,1,0,0,1,0.993265993265993
"900841505","TUCUMAN",311,301,6,4,0,10,0.967845659163987
"900840818","TUCUMAN",179,166,4,7,0,11,0.927374301675978
"900141312","TUCUMAN",408,136,140,117,1,258,0.333333333333333
"900842911","TUCUMAN",378,103,126,140,1,267,0.272486772486772
"900842814","TUCUMAN",200,144,11,44,0,55,0.72
"900141310","TUCUMAN",483,231,80,140,4,224,0.478260869565217
"900842519","TUCUMAN",251,237,7,6,1,14,0.944223107569721
"900280313","TUCUMAN",2,0,0,2,0,2,0
"900700804","TUCUMAN",152,1,69,65,7,141,0.00657894736842105
"901190103","TUCUMAN",46,8,23,6,1,30,0.173913043478261
"900070606","TUCUMAN",122,1,43,56,2,101,0.00819672131147541
"901050202","TUCUMAN",11,0,0,2,1,3,0
"901120114","TUCUMAN",112,0,36,67,3,106,0
"900350205","TUCUMAN",81,0,8,38,18,64,0
"901050904","TUCUMAN",367,239,33,86,0,119,0.651226158038147
"901051002","TUCUMAN",218,9,146,56,0,202,0.0412844036697248
"900841103","TUCUMAN",212,212,0,0,0,0,1
"901050201","TUCUMAN",31,0,1,23,1,25,0
"900980105","TUCUMAN",68,0,21,36,0,57,0
"900701204","TUCUMAN",183,1,74,87,5,166,0.00546448087431694
"900843007","TUCUMAN",346,70,146,116,3,265,0.202312138728324
"901190507","TUCUMAN",378,288,61,26,0,87,0.761904761904762
"900911003","TUCUMAN",116,0,32,63,11,106,0
"900910802","TUCUMAN",23,0,8,9,5,22,0
"900350105","TUCUMAN",21,0,5,11,4,20,0
"900070604","TUCUMAN",136,0,24,99,5,128,0
"900770408","TUCUMAN",72,0,25,38,3,66,0
"900700406","TUCUMAN",173,0,23,83,52,158,0
"900630406","TUCUMAN",81,1,22,48,3,73,0.0123456790123457
"901190308","TUCUMAN",194,27,150,16,0,166,0.139175257731959
"900770402","TUCUMAN",8,0,2,3,2,7,0
"900770401","TUCUMAN",2,0,0,2,0,2,0
"900770205","TUCUMAN",11,0,3,7,0,10,0
"900560601","TUCUMAN",43,0,5,36,1,42,0
"900630201","TUCUMAN",42,0,8,10,11,29,0
"900561101","TUCUMAN",5,0,2,2,1,5,0
"900560911","TUCUMAN",42,0,3,27,5,35,0
"900560602","TUCUMAN",142,1,80,48,2,130,0.00704225352112676
"900280309","TUCUMAN",72,0,30,32,8,70,0
"901120105","TUCUMAN",59,0,1,14,5,20,0
"901190203","TUCUMAN",211,11,78,120,0,198,0.0521327014218009
"900350204","TUCUMAN",40,0,5,30,0,35,0
"900140302","TUCUMAN",53,0,15,35,1,51,0
"900280202","TUCUMAN",44,0,9,24,3,36,0
"901050208","TUCUMAN",181,2,44,106,1,151,0.0110497237569061
"900280203","TUCUMAN",59,0,59,0,0,59,0
"900560802","TUCUMAN",33,0,11,16,2,29,0
"900210107","TUCUMAN",62,0,1,40,6,47,0
"900841616","TUCUMAN",265,250,4,11,0,15,0.943396226415094
"900210601","TUCUMAN",26,1,1,16,5,22,0.0384615384615385
"900210403","TUCUMAN",136,3,42,69,12,123,0.0220588235294118
"900210204","TUCUMAN",192,4,84,89,8,181,0.0208333333333333
"900841412","TUCUMAN",315,312,1,2,0,3,0.990476190476191
"901120101","TUCUMAN",11,0,2,6,2,10,0
"900071001","TUCUMAN",166,0,28,103,9,140,0
"900841619","TUCUMAN",276,251,2,10,0,12,0.909420289855073
"901050602","TUCUMAN",248,0,98,127,3,228,0
"901050502","TUCUMAN",27,2,9,11,0,20,0.0740740740740741
"901050501","TUCUMAN",146,2,33,104,2,139,0.0136986301369863
"900070703","TUCUMAN",137,0,42,80,4,126,0
"900210105","TUCUMAN",146,1,62,60,11,133,0.00684931506849315
"900141220","TUCUMAN",27,0,12,10,2,24,0
"900141203","TUCUMAN",67,12,20,21,1,42,0.17910447761194
"900141003","TUCUMAN",174,3,120,42,2,164,0.0172413793103448
"900140806","TUCUMAN",67,0,18,47,0,65,0
"900140704","TUCUMAN",209,0,68,119,5,192,0
"900140703","TUCUMAN",214,3,53,134,3,190,0.014018691588785
"900140203","TUCUMAN",33,0,15,12,5,32,0
"900070901","TUCUMAN",23,0,8,6,0,14,0
"900070806","TUCUMAN",70,0,17,49,1,67,0
"900070302","TUCUMAN",17,0,2,5,3,10,0
"900070206","TUCUMAN",78,0,26,35,5,66,0
"900490507","TUCUMAN",41,0,8,12,0,20,0
"900350309","TUCUMAN",23,0,1,20,0,21,0
"901190416","TUCUMAN",119,54,47,17,0,64,0.453781512605042
"901050814","TUCUMAN",325,234,32,47,0,79,0.72
"900070203","TUCUMAN",21,0,2,10,3,15,0
"900070406","TUCUMAN",13,0,5,4,0,9,0
"900070505","TUCUMAN",97,0,17,43,16,76,0
"900560407","TUCUMAN",25,0,10,13,0,23,0
"900070710","TUCUMAN",360,1,171,171,7,349,0.00277777777777778
"900280311","TUCUMAN",61,0,23,20,12,55,0
"900770403","TUCUMAN",208,4,56,93,15,164,0.0192307692307692
"900842110","TUCUMAN",323,315,6,0,0,6,0.975232198142415
"900842109","TUCUMAN",253,253,0,0,0,0,1
"900842001","TUCUMAN",184,172,0,0,0,0,0.934782608695652
"901120109","TUCUMAN",124,0,41,56,7,104,0
"900701301","TUCUMAN",359,153,39,132,3,174,0.426183844011142
"900701102","TUCUMAN",108,3,68,33,0,101,0.0277777777777778
"900140613","TUCUMAN",326,2,122,152,18,292,0.00613496932515337
"901190515","TUCUMAN",281,10,233,35,0,268,0.0355871886120996
"900840115","TUCUMAN",276,270,0,3,0,3,0.978260869565217
"900700102","TUCUMAN",109,0,56,39,2,97,0
"900630413","TUCUMAN",422,153,54,196,5,255,0.362559241706161
"901190410","TUCUMAN",259,26,126,107,0,233,0.1003861003861
"900841711","TUCUMAN",225,212,2,3,0,5,0.942222222222222
"900070105","TUCUMAN",83,11,42,25,1,68,0.132530120481928
"900070704","TUCUMAN",147,5,65,67,6,138,0.0340136054421769
"901190303","TUCUMAN",149,115,24,9,0,33,0.771812080536913
"901190407","TUCUMAN",423,15,209,185,2,396,0.0354609929078014
"900841709","TUCUMAN",360,333,15,6,1,22,0.925
"901050902","TUCUMAN",303,138,55,65,3,123,0.455445544554455
"900980401","TUCUMAN",181,0,29,136,6,171,0
"900842409","TUCUMAN",350,330,5,10,0,15,0.942857142857143
"900842221","TUCUMAN",313,7,79,211,4,294,0.0223642172523962
"901051018","TUCUMAN",408,3,246,149,1,396,0.00735294117647059
"901050908","TUCUMAN",280,245,11,22,0,33,0.875
"901050906","TUCUMAN",394,313,33,41,0,74,0.794416243654822
"900840102","TUCUMAN",219,163,5,36,1,42,0.744292237442922
"901050802","TUCUMAN",414,292,44,62,4,110,0.705314009661836
"901050610","TUCUMAN",230,2,124,99,1,224,0.00869565217391304
"901050609","TUCUMAN",261,0,165,77,1,243,0
"901050716","TUCUMAN",0,0,0,0,0,0,NA
"900980418","TUCUMAN",109,0,44,52,2,98,0
"900980417","TUCUMAN",94,0,37,55,0,92,0
"900910102","TUCUMAN",386,63,229,83,2,314,0.163212435233161
"900843003","TUCUMAN",357,164,67,112,2,181,0.459383753501401
"900842713","TUCUMAN",248,246,2,0,0,2,0.991935483870968
"900842708","TUCUMAN",340,317,7,7,0,14,0.932352941176471
"900842707","TUCUMAN",364,290,38,24,1,63,0.796703296703297
"900842508","TUCUMAN",387,170,124,78,2,204,0.439276485788114
"900770606","TUCUMAN",340,4,188,116,12,316,0.0117647058823529
"900842503","TUCUMAN",333,322,3,6,0,9,0.966966966966967
"900842311","TUCUMAN",360,348,7,1,0,8,0.966666666666667
"900842308","TUCUMAN",242,232,6,2,0,8,0.958677685950413
"900842302","TUCUMAN",220,206,2,9,0,11,0.936363636363636
"900842216","TUCUMAN",329,224,36,56,2,94,0.680851063829787
"900842205","TUCUMAN",220,8,9,133,33,175,0.0363636363636364
"900842117","TUCUMAN",169,160,1,3,0,4,0.946745562130177
"900841410","TUCUMAN",234,228,4,1,0,5,0.974358974358974
"900840610","TUCUMAN",207,199,6,1,0,7,0.961352657004831
"900840603","TUCUMAN",251,241,4,1,0,5,0.960159362549801
"900840307","TUCUMAN",334,320,5,2,0,7,0.958083832335329
"900840201","TUCUMAN",165,71,21,58,4,83,0.43030303030303
"900701418","TUCUMAN",362,32,122,178,3,303,0.0883977900552486
"900701405","TUCUMAN",333,159,74,89,3,166,0.477477477477477
"900701409","TUCUMAN",424,246,49,96,1,146,0.580188679245283
"900700805","TUCUMAN",174,6,127,33,3,163,0.0344827586206897
"900630512","TUCUMAN",321,297,9,13,0,22,0.925233644859813
"900770110","TUCUMAN",322,321,1,0,0,1,0.996894409937888
"900630212","TUCUMAN",345,8,88,193,4,285,0.0231884057971014
"900561408","TUCUMAN",256,50,100,80,16,196,0.1953125
"900560702","TUCUMAN",322,4,198,113,4,315,0.0124223602484472
"900841013","TUCUMAN",276,233,18,22,0,40,0.844202898550725
"900560312","TUCUMAN",368,141,101,102,9,212,0.383152173913043
"900560304","TUCUMAN",162,0,65,79,0,144,0
"900141507","TUCUMAN",464,4,376,64,1,441,0.00862068965517241
"900141408","TUCUMAN",506,11,172,249,5,426,0.0217391304347826
"140840110","CORDOBA",283,2,194,80,3,277,0.00706713780918728
"900141406","TUCUMAN",267,13,137,96,12,245,0.048689138576779
"900141302","TUCUMAN",280,78,84,97,14,195,0.278571428571429
"900141222","TUCUMAN",432,1,190,198,13,401,0.00231481481481481
"900141214","TUCUMAN",338,4,144,167,7,318,0.0118343195266272
"900140714","TUCUMAN",295,1,161,102,10,273,0.00338983050847458
"900841112","TUCUMAN",248,232,3,12,0,15,0.935483870967742
"900841105","TUCUMAN",277,240,14,16,0,30,0.866425992779783
"900841311","TUCUMAN",146,146,0,0,0,0,1
"900841010","TUCUMAN",438,159,151,88,9,248,0.363013698630137
"900841009","TUCUMAN",285,222,16,37,2,55,0.778947368421053
"900841001","TUCUMAN",299,144,134,18,1,153,0.481605351170569
"900840907","TUCUMAN",201,134,17,38,0,55,0.666666666666667
"900840906","TUCUMAN",178,142,3,28,1,32,0.797752808988764
"900840804","TUCUMAN",241,4,35,188,4,227,0.016597510373444
"900840713","TUCUMAN",186,178,5,0,0,5,0.956989247311828
"900840712","TUCUMAN",280,278,2,0,0,2,0.992857142857143
"900840702","TUCUMAN",155,142,5,3,0,8,0.916129032258065
"900140614","TUCUMAN",246,14,76,141,3,220,0.0569105691056911
"900140130","TUCUMAN",514,20,137,315,10,462,0.0389105058365759
"900140109","TUCUMAN",487,1,268,186,9,463,0.00205338809034908
"900842013","TUCUMAN",205,187,6,1,0,7,0.91219512195122
"900420102","TUCUMAN",352,272,11,17,9,37,0.772727272727273
"900420104","TUCUMAN",182,174,2,2,0,4,0.956043956043956
"900842611","TUCUMAN",282,229,3,31,0,34,0.812056737588652
"900842419","TUCUMAN",199,187,5,5,0,10,0.939698492462312
"900280104","TUCUMAN",317,215,41,55,0,96,0.678233438485804
"900210721","TUCUMAN",222,211,0,8,0,8,0.95045045045045
"900210719","TUCUMAN",439,339,18,54,1,73,0.772209567198178
"900210614","TUCUMAN",360,353,4,2,0,6,0.980555555555556
"900210609","TUCUMAN",171,160,3,7,0,10,0.935672514619883
"900210607","TUCUMAN",308,140,52,76,16,144,0.454545454545455
"900210616","TUCUMAN",266,262,1,1,1,3,0.984962406015038
"900140210","TUCUMAN",249,3,69,148,17,234,0.0120481927710843
"900980416","TUCUMAN",203,0,87,101,5,193,0
"900980310","TUCUMAN",187,0,139,33,0,172,0
"900910406","TUCUMAN",48,0,28,17,0,45,0
"900280110","TUCUMAN",214,180,14,13,0,27,0.841121495327103
"900141606","TUCUMAN",229,46,70,95,1,166,0.200873362445415
"900840504","TUCUMAN",185,181,1,3,0,4,0.978378378378378
"900840503","TUCUMAN",286,274,4,8,0,12,0.958041958041958
"900841316","TUCUMAN",202,202,0,0,0,0,1
"901050619","TUCUMAN",221,9,124,83,1,208,0.0407239819004525
"900841809","TUCUMAN",318,312,2,1,0,3,0.981132075471698
"900841509","TUCUMAN",373,368,3,2,0,5,0.986595174262735
"900841507","TUCUMAN",133,127,1,1,0,2,0.954887218045113
"900841504","TUCUMAN",360,352,3,1,0,4,0.977777777777778
"900420111","TUCUMAN",154,66,9,58,2,69,0.428571428571429
"340141711","FORMOSA",247,85,139,3,16,158,0.34412955465587
"900280109","TUCUMAN",221,185,6,20,2,28,0.83710407239819
"900210713","TUCUMAN",184,174,2,4,0,6,0.945652173913043
"901190509","TUCUMAN",318,252,41,24,0,65,0.792452830188679
"900842606","TUCUMAN",263,181,31,46,1,78,0.688212927756654
"140840109","CORDOBA",298,0,233,62,1,296,0
"901190301","TUCUMAN",1,0,0,1,0,1,0
"901050203","TUCUMAN",58,0,4,21,8,33,0
"340141801","FORMOSA",9,0,2,6,0,8,0
"901120306","TUCUMAN",36,0,1,14,20,35,0
"901120108","TUCUMAN",55,0,3,36,1,40,0
"460140416","LA RIOJA",280,278,1,1,0,2,0.992857142857143
"460910201","LA RIOJA",375,0,308,45,1,354,0
"900910904","TUCUMAN",26,0,7,11,0,18,0
"900910903","TUCUMAN",76,0,25,37,9,71,0
"900911002","TUCUMAN",45,0,5,29,11,45,0
"460140901","LA RIOJA",330,196,43,82,3,128,0.593939393939394
"661260705","SALTA",209,186,6,5,1,12,0.889952153110048
"901050101","TUCUMAN",22,0,0,4,0,4,0
"900980107","TUCUMAN",12,0,0,3,3,6,0
"900910806","TUCUMAN",49,0,0,24,21,45,0
"900910703","TUCUMAN",58,0,1,29,9,39,0
"900700402","TUCUMAN",84,3,19,47,8,74,0.0357142857142857
"900910405","TUCUMAN",120,1,45,56,4,105,0.00833333333333333
"661120311","SALTA",214,193,8,8,0,16,0.901869158878505
"460140402","LA RIOJA",275,270,5,0,0,5,0.981818181818182
"900910308","TUCUMAN",46,0,9,31,5,45,0
"900910304","TUCUMAN",167,0,17,96,44,157,0
"900700202","TUCUMAN",70,0,7,47,8,62,0
"460141009","LA RIOJA",228,226,1,0,0,1,0.991228070175439
"540420517","MISIONES",225,0,129,54,37,220,0
"900910303","TUCUMAN",142,1,14,87,24,125,0.00704225352112676
"900910206","TUCUMAN",88,0,16,52,16,84,0
"900700411","TUCUMAN",76,0,11,52,10,73,0
"900630401","TUCUMAN",8,0,1,5,1,7,0
"900561204","TUCUMAN",165,7,44,95,7,146,0.0424242424242424
"900561105","TUCUMAN",88,0,11,48,17,76,0
"900070508","TUCUMAN",87,0,21,55,7,83,0
"140142706","CORDOBA",238,227,8,1,0,9,0.953781512605042
"900910204","TUCUMAN",216,40,85,67,1,153,0.185185185185185
"900980308","TUCUMAN",225,0,125,78,6,209,0
"900770604","TUCUMAN",55,0,27,18,6,51,0
"900561208","TUCUMAN",33,0,11,20,1,32,0
"900770501","TUCUMAN",169,2,107,49,1,157,0.0118343195266272
"900770410","TUCUMAN",97,4,38,35,17,90,0.0412371134020619
"900630410","TUCUMAN",57,0,12,36,4,52,0
"900630102","TUCUMAN",314,45,148,106,0,254,0.143312101910828
"900561406","TUCUMAN",227,3,60,145,9,214,0.013215859030837
"900561405","TUCUMAN",109,13,16,67,9,92,0.119266055045872
"900630301","TUCUMAN",578,219,74,233,6,313,0.378892733564014
"900561104","TUCUMAN",96,0,15,68,1,84,0
"900561004","TUCUMAN",117,0,37,63,2,102,0
"900630209","TUCUMAN",15,0,7,4,2,13,0
"900560502","TUCUMAN",241,0,120,98,5,223,0
"900350109","TUCUMAN",43,0,3,28,8,39,0
"900210203","TUCUMAN",108,2,13,56,26,95,0.0185185185185185
"460141016","LA RIOJA",334,327,6,1,0,7,0.979041916167665
"900280314","TUCUMAN",20,0,0,1,1,2,0
"900210503","TUCUMAN",189,1,57,72,19,148,0.00529100529100529
"900210401","TUCUMAN",110,3,36,61,4,101,0.0272727272727273
"900210201","TUCUMAN",62,0,13,44,4,61,0
"900210108","TUCUMAN",177,4,43,79,36,158,0.0225988700564972
"900141403","TUCUMAN",31,0,6,23,1,30,0
"900141402","TUCUMAN",8,0,4,3,0,7,0
"900141204","TUCUMAN",452,8,133,262,8,403,0.0176991150442478
"900140702","TUCUMAN",10,0,0,5,1,6,0
"900140607","TUCUMAN",49,0,3,42,4,49,0
"900070601","TUCUMAN",126,0,27,87,1,115,0
"661260708","SALTA",337,162,10,97,31,138,0.480712166172107
"900070301","TUCUMAN",29,1,2,20,0,22,0.0344827586206897
"900560203","TUCUMAN",178,7,67,91,5,163,0.0393258426966292
"460141007","LA RIOJA",242,242,0,0,0,0,1
"460140908","LA RIOJA",408,406,2,0,0,2,0.995098039215686
"661260416","SALTA",357,350,1,3,0,4,0.980392156862745
"900070201","TUCUMAN",31,0,12,10,9,31,0
"900070706","TUCUMAN",16,0,4,10,0,14,0
"900560504","TUCUMAN",195,0,76,109,4,189,0
"460840201","LA RIOJA",256,0,208,26,2,236,0
"660490415","SALTA",240,168,34,29,2,65,0.7
"900490703","TUCUMAN",162,0,102,43,4,149,0
"900490702","TUCUMAN",130,0,82,32,5,119,0
"460140806","LA RIOJA",445,421,9,11,0,20,0.946067415730337
"460840202","LA RIOJA",210,0,149,50,0,199,0
"460280107","LA RIOJA",185,0,160,6,1,167,0
"900490603","TUCUMAN",54,0,24,27,1,52,0
"900490506","TUCUMAN",85,0,37,37,5,79,0
"900490201","TUCUMAN",149,0,63,60,20,143,0
"660560625","SALTA",156,116,22,11,2,35,0.743589743589744
"900490301","TUCUMAN",217,0,75,94,18,187,0
"900490101","TUCUMAN",140,0,38,89,6,133,0
"900490204","TUCUMAN",368,0,62,211,62,335,0
"900420303","TUCUMAN",73,0,3,52,15,70,0
"900420211","TUCUMAN",302,4,43,159,68,270,0.0132450331125828
"900560902","TUCUMAN",4,0,2,2,0,4,0
"900420210","TUCUMAN",134,0,23,70,29,122,0
"900420209","TUCUMAN",276,1,45,135,60,240,0.0036231884057971
"900420204","TUCUMAN",48,4,2,22,16,40,0.0833333333333333
"460350202","LA RIOJA",181,19,69,43,10,122,0.104972375690608
"460140716","LA RIOJA",258,31,171,56,0,227,0.12015503875969
"660281205","SALTA",154,153,1,0,0,1,0.993506493506494
"900420202","TUCUMAN",60,0,10,45,0,55,0
"900070708","TUCUMAN",69,0,13,49,1,63,0
"900980408","TUCUMAN",198,0,23,127,15,165,0
"900070711","TUCUMAN",131,1,37,77,5,119,0.00763358778625954
"900070205","TUCUMAN",150,2,37,94,3,134,0.0133333333333333
"900630407","TUCUMAN",27,0,9,17,1,27,0
"900560905","TUCUMAN",23,0,4,12,6,22,0
"460140103","LA RIOJA",487,62,71,284,5,360,0.127310061601643
"460420203","LA RIOJA",216,106,43,57,5,105,0.490740740740741
"460420121","LA RIOJA",360,321,10,10,1,21,0.891666666666667
"460420118","LA RIOJA",339,336,1,0,0,1,0.991150442477876
"460420114","LA RIOJA",380,334,33,4,1,38,0.878947368421053
"460420110","LA RIOJA",467,413,18,19,1,38,0.884368308351178
"460420109","LA RIOJA",401,367,16,9,0,25,0.915211970074813
"460420101","LA RIOJA",534,281,136,79,0,215,0.526217228464419
"460141113","LA RIOJA",370,332,25,11,0,36,0.897297297297297
"460141107","LA RIOJA",308,261,14,13,1,28,0.847402597402597
"460140709","LA RIOJA",275,10,164,92,1,257,0.0363636363636364
"460140803","LA RIOJA",421,405,8,8,0,16,0.961995249406176
"460140611","LA RIOJA",282,272,6,4,0,10,0.964539007092199
"460140601","LA RIOJA",387,378,6,2,0,8,0.976744186046512
"460140418","LA RIOJA",230,191,4,5,0,9,0.830434782608696
"460140409","LA RIOJA",278,264,7,6,0,13,0.949640287769784
"461190102","LA RIOJA",307,0,235,64,1,300,0
"461120109","LA RIOJA",339,0,314,22,3,339,0
"460630101","LA RIOJA",304,0,276,18,2,296,0
"460490203","LA RIOJA",58,0,46,9,2,57,0
"460490102","LA RIOJA",303,0,246,48,5,299,0
"460140707","LA RIOJA",268,205,39,22,0,61,0.764925373134328
"460140106","LA RIOJA",363,2,173,175,0,348,0.00550964187327824
"460280103","LA RIOJA",287,0,245,35,2,282,0
"460140812","LA RIOJA",302,289,8,1,0,9,0.956953642384106
"461120302","LA RIOJA",131,0,41,43,7,91,0
"461120301","LA RIOJA",182,0,36,61,17,114,0
"460840204","LA RIOJA",69,0,28,31,2,61,0
"460350203","LA RIOJA",48,0,14,16,4,34,0
"460350201","LA RIOJA",365,1,239,80,8,327,0.00273972602739726
"460980105","LA RIOJA",15,0,6,3,2,11,0
"460980103","LA RIOJA",11,0,0,0,0,0,0
"540420511","MISIONES",293,7,285,1,0,286,0.0238907849829352
"460070203","LA RIOJA",16,5,4,5,0,9,0.3125
"660280711","SALTA",470,429,28,4,0,32,0.912765957446809
"460420403","LA RIOJA",127,1,84,27,3,114,0.0078740157480315
"460840102","LA RIOJA",198,0,57,93,3,153,0
"460280202","LA RIOJA",338,0,261,42,10,313,0
"540420506","MISIONES",271,240,31,0,0,31,0.885608856088561
"460420401","LA RIOJA",366,2,212,119,8,339,0.00546448087431694
"460420201","LA RIOJA",392,0,295,73,5,373,0
"460420119","LA RIOJA",236,194,36,5,1,42,0.822033898305085
"460490201","LA RIOJA",244,0,207,32,1,240,0
"460350107","LA RIOJA",378,41,277,55,3,335,0.108465608465608
"460140801","LA RIOJA",373,350,9,11,0,20,0.938337801608579
"460280201","LA RIOJA",110,0,90,16,2,108,0
"460141013","LA RIOJA",410,379,16,8,0,24,0.924390243902439
"460140920","LA RIOJA",357,249,29,68,1,98,0.697478991596639
"460140917","LA RIOJA",444,435,7,0,0,7,0.97972972972973
"460140909","LA RIOJA",355,260,41,51,0,92,0.732394366197183
"460140904","LA RIOJA",234,198,25,10,0,35,0.846153846153846
"460140902","LA RIOJA",320,303,14,2,0,16,0.946875
"221401821","CHACO",193,9,82,86,4,172,0.0466321243523316
"460140706","LA RIOJA",273,95,78,90,0,168,0.347985347985348
"460140702","LA RIOJA",487,7,264,185,3,452,0.0143737166324435
"460140515","LA RIOJA",363,265,45,44,2,91,0.730027548209366
"460140507","LA RIOJA",397,392,0,0,0,0,0.987405541561713
"460840104","LA RIOJA",227,0,159,46,3,208,0
"660281406","SALTA",419,413,0,0,0,0,0.985680190930788
"460420123","LA RIOJA",366,344,1,0,0,1,0.939890710382514
"460140504","LA RIOJA",431,286,61,70,2,133,0.663573085846868
"460140414","LA RIOJA",221,184,22,14,0,36,0.832579185520362
"460140413","LA RIOJA",341,268,52,12,1,65,0.785923753665689
"460140412","LA RIOJA",286,249,6,9,0,15,0.870629370629371
"460140111","LA RIOJA",369,314,34,15,0,49,0.850948509485095
"460700103","LA RIOJA",103,0,11,44,2,57,0
"461260101","LA RIOJA",294,0,230,61,0,291,0
"461190101","LA RIOJA",177,0,131,40,2,173,0
"461050102","LA RIOJA",207,0,117,68,2,187,0
"460630103","LA RIOJA",324,0,296,21,1,318,0
"460070109","LA RIOJA",222,0,165,51,2,218,0
"460420303","LA RIOJA",247,0,209,26,0,235,0
"460140906","LA RIOJA",431,198,83,120,4,207,0.459396751740139
"460070108","LA RIOJA",345,4,249,71,5,325,0.0115942028985507
"460910101","LA RIOJA",68,0,21,22,5,48,0
"460560103","LA RIOJA",96,0,54,23,1,78,0
"460140201","LA RIOJA",28,0,6,14,4,24,0
"460420301","LA RIOJA",562,3,434,74,7,515,0.00533807829181495
"460420105","LA RIOJA",224,197,21,4,0,25,0.879464285714286
"460420102","LA RIOJA",217,183,15,17,0,32,0.84331797235023
"460490204","LA RIOJA",154,0,105,29,3,137,0
"460350109","LA RIOJA",379,13,335,28,1,364,0.0343007915567282
"460140202","LA RIOJA",103,0,64,33,0,97,0
"460350108","LA RIOJA",429,3,301,101,2,404,0.00699300699300699
"460280204","LA RIOJA",193,0,146,25,4,175,0
"460141106","LA RIOJA",384,368,1,10,0,11,0.958333333333333
"460141101","LA RIOJA",390,40,114,215,3,332,0.102564102564103
"460141005","LA RIOJA",444,336,57,43,1,101,0.756756756756757
"460141006","LA RIOJA",394,365,15,7,0,22,0.926395939086294
"460140408","LA RIOJA",373,279,17,6,0,23,0.74798927613941
"460140905","LA RIOJA",220,139,31,43,0,74,0.631818181818182
"460140809","LA RIOJA",376,354,7,9,0,16,0.941489361702128
"460140711","LA RIOJA",280,239,30,10,0,40,0.853571428571429
"460140605","LA RIOJA",308,306,2,0,0,2,0.993506493506494
"460140514","LA RIOJA",354,329,8,10,2,20,0.929378531073446
"460140513","LA RIOJA",302,292,2,6,1,9,0.966887417218543
"460140503","LA RIOJA",259,206,20,28,1,49,0.795366795366795
"460140501","LA RIOJA",239,221,5,12,1,18,0.924686192468619
"460630202","LA RIOJA",26,0,8,8,1,17,0
"460140415","LA RIOJA",235,213,3,17,0,20,0.906382978723404
"461260103","LA RIOJA",299,0,197,72,1,270,0
"461120105","LA RIOJA",277,0,227,43,1,271,0
"460980104","LA RIOJA",78,0,39,34,1,74,0
"460140105","LA RIOJA",239,203,6,19,1,26,0.849372384937239
"460280108","LA RIOJA",200,0,162,17,1,180,0
"460140302","LA RIOJA",83,1,8,43,7,58,0.0120481927710843
"461120203","LA RIOJA",45,0,15,10,6,31,0
"460140913","LA RIOJA",278,253,6,13,0,19,0.910071942446043
"460070201","LA RIOJA",317,2,243,59,1,303,0.00630914826498423
"460070106","LA RIOJA",97,0,54,26,3,83,0
"461120103","LA RIOJA",292,0,219,57,4,280,0
"460141010","LA RIOJA",276,248,12,15,0,27,0.898550724637681
"460141115","LA RIOJA",482,414,45,19,2,66,0.858921161825726
"460141110","LA RIOJA",477,452,12,4,0,16,0.947589098532495
"460770103","LA RIOJA",13,0,3,1,8,12,0
"460770102","LA RIOJA",5,0,3,1,1,5,0
"460141108","LA RIOJA",403,397,1,2,0,3,0.985111662531017
"460140807","LA RIOJA",380,371,6,1,0,7,0.976315789473684
"460140102","LA RIOJA",28,1,13,12,2,27,0.0357142857142857
"460280105","LA RIOJA",254,0,208,34,1,243,0
"460141015","LA RIOJA",241,234,3,0,0,3,0.970954356846473
"460140512","LA RIOJA",278,263,6,2,0,8,0.946043165467626
"460700102","LA RIOJA",283,0,62,184,3,249,0
"460420305","LA RIOJA",205,1,75,78,7,160,0.0048780487804878
"460280106","LA RIOJA",144,0,73,24,4,101,0
"460420202","LA RIOJA",439,2,325,88,9,422,0.00455580865603645
"460420117","LA RIOJA",283,239,24,14,1,39,0.84452296819788
"461120108","LA RIOJA",374,0,249,96,6,351,0
"460350104","LA RIOJA",529,124,329,54,5,388,0.234404536862004
"460141111","LA RIOJA",428,385,14,21,1,36,0.899532710280374
"460140916","LA RIOJA",352,345,3,2,0,5,0.980113636363636
"460140907","LA RIOJA",374,309,53,10,0,63,0.82620320855615
"460140814","LA RIOJA",444,407,18,7,0,25,0.916666666666667
"460140802","LA RIOJA",314,293,3,4,0,7,0.93312101910828
"460140610","LA RIOJA",327,314,8,2,0,10,0.960244648318043
"460140609","LA RIOJA",241,231,6,4,0,10,0.95850622406639
"460140608","LA RIOJA",239,232,4,2,0,6,0.97071129707113
"460140604","LA RIOJA",272,265,2,3,0,5,0.974264705882353
"460140603","LA RIOJA",209,205,3,1,0,4,0.980861244019139
"140631216","CORDOBA",292,206,31,49,0,80,0.705479452054795
"460140517","LA RIOJA",423,391,11,18,0,29,0.92434988179669
"460140516","LA RIOJA",361,268,25,34,0,59,0.742382271468144
"460140511","LA RIOJA",271,260,1,1,7,9,0.959409594095941
"460140509","LA RIOJA",417,382,8,19,1,28,0.916067146282974
"460140505","LA RIOJA",332,320,3,0,0,3,0.963855421686747
"460140502","LA RIOJA",255,234,3,11,0,14,0.917647058823529
"460140403","LA RIOJA",247,232,8,5,0,13,0.939271255060729
"461120104","LA RIOJA",402,0,322,62,0,384,0
"460770101","LA RIOJA",214,0,184,19,4,207,0
"460420108","LA RIOJA",301,280,8,11,0,19,0.930232558139535
"460700101","LA RIOJA",359,0,198,133,0,331,0
"460350101","LA RIOJA",374,7,281,83,0,364,0.018716577540107
"501050503","MENDOZA",186,152,26,8,0,34,0.817204301075269
"460140108","LA RIOJA",237,111,43,67,1,111,0.468354430379747
"460070107","LA RIOJA",259,2,186,53,3,242,0.00772200772200772
"460070105","LA RIOJA",317,2,277,33,1,311,0.00630914826498423
"461120107","LA RIOJA",314,0,237,67,2,306,0
"460770104","LA RIOJA",252,0,219,20,2,241,0
"460980102","LA RIOJA",283,0,244,33,0,277,0
"460420302","LA RIOJA",582,13,404,136,1,541,0.0223367697594502
"501050502","MENDOZA",117,113,4,0,0,4,0.965811965811966
"460141114","LA RIOJA",422,383,24,8,0,32,0.907582938388626
"460910202","LA RIOJA",168,0,63,59,3,125,0
"460141105","LA RIOJA",496,284,47,136,4,187,0.57258064516129
"460560104","LA RIOJA",185,0,139,36,2,177,0
"460420205","LA RIOJA",193,10,105,61,13,179,0.0518134715025907
"460210105","LA RIOJA",131,0,98,24,1,123,0
"460140804","LA RIOJA",436,431,4,1,0,5,0.988532110091743
"460140708","LA RIOJA",333,209,66,51,1,118,0.627627627627628
"460350102","LA RIOJA",293,76,187,28,0,215,0.25938566552901
"460140705","LA RIOJA",432,260,43,98,3,144,0.601851851851852
"461260102","LA RIOJA",29,0,8,18,2,28,0
"460140407","LA RIOJA",250,235,6,4,0,10,0.94
"460490104","LA RIOJA",38,0,21,13,3,37,0
"460070104","LA RIOJA",306,0,222,55,6,283,0
"460070101","LA RIOJA",315,6,205,80,3,288,0.019047619047619
"460420112","LA RIOJA",326,289,2,0,0,2,0.886503067484663
"460140915","LA RIOJA",424,418,5,0,0,5,0.985849056603774
"460140914","LA RIOJA",430,419,7,2,0,9,0.974418604651163
"460420111","LA RIOJA",296,245,36,15,0,51,0.827702702702703
"460420104","LA RIOJA",266,215,31,18,0,49,0.808270676691729
"460210106","LA RIOJA",126,0,107,19,0,126,0
"460141004","LA RIOJA",208,175,19,7,1,27,0.841346153846154
"460141003","LA RIOJA",285,249,8,22,0,30,0.873684210526316
"460140922","LA RIOJA",345,286,29,27,1,57,0.828985507246377
"460140701","LA RIOJA",99,6,43,50,0,93,0.0606060606060606
"460140417","LA RIOJA",231,211,12,5,0,17,0.913419913419913
"460140401","LA RIOJA",287,202,15,28,6,49,0.70383275261324
"460560101","LA RIOJA",326,87,158,70,0,228,0.266871165644172
"461120202","LA RIOJA",299,0,92,85,6,183,0
"660281411","SALTA",481,418,7,5,0,12,0.869022869022869
"461190104","LA RIOJA",121,0,101,17,0,118,0
"461120106","LA RIOJA",356,0,263,72,2,337,0
"460140606","LA RIOJA",269,267,1,1,0,2,0.992565055762082
"460140109","LA RIOJA",510,216,51,185,8,244,0.423529411764706
"460420107","LA RIOJA",287,228,43,13,0,56,0.794425087108014
"460140411","LA RIOJA",434,410,6,8,1,15,0.944700460829493
"540280416","MISIONES",254,187,54,13,0,67,0.736220472440945
"660560622","SALTA",311,302,6,2,0,8,0.971061093247588
"460980101","LA RIOJA",379,0,304,67,4,375,0
"460910204","LA RIOJA",431,0,336,83,1,420,0
"460630102","LA RIOJA",423,0,393,20,4,417,0
"660281524","SALTA",444,431,6,3,0,9,0.970720720720721
"460840101","LA RIOJA",253,0,193,42,1,236,0
"461050103","LA RIOJA",132,0,32,51,22,105,0
"460700203","LA RIOJA",86,0,18,40,1,59,0
"460070204","LA RIOJA",183,0,68,58,24,150,0
"460280102","LA RIOJA",298,0,269,28,1,298,0
"461120201","LA RIOJA",200,0,139,46,2,187,0
"460490205","LA RIOJA",77,0,53,23,1,77,0
"460280203","LA RIOJA",165,0,71,36,16,123,0
"460210202","LA RIOJA",141,0,105,21,2,128,0
"460420304","LA RIOJA",249,0,156,82,0,238,0
"460420204","LA RIOJA",370,9,288,68,0,356,0.0243243243243243
"460420116","LA RIOJA",357,315,19,21,0,40,0.882352941176471
"460280101","LA RIOJA",155,0,121,29,1,151,0
"460140810","LA RIOJA",453,427,9,14,0,23,0.942604856512141
"540280702","MISIONES",293,9,156,112,11,279,0.0307167235494881
"460210101","LA RIOJA",223,0,192,29,0,221,0
"460141011","LA RIOJA",251,230,8,5,3,16,0.916334661354582
"460140911","LA RIOJA",55,0,7,29,0,36,0
"460140910","LA RIOJA",553,491,20,14,0,34,0.887884267631103
"460140718","LA RIOJA",177,11,113,49,0,162,0.0621468926553672
"460140717","LA RIOJA",113,1,98,12,0,110,0.00884955752212389
"460140703","LA RIOJA",471,132,90,223,4,317,0.280254777070064
"460140518","LA RIOJA",389,357,15,11,1,27,0.917737789203085
"460141112","LA RIOJA",371,350,5,16,0,21,0.943396226415094
"460141109","LA RIOJA",415,405,2,4,0,6,0.975903614457831
"461120101","LA RIOJA",423,0,324,83,1,408,0
"460700201","LA RIOJA",265,0,179,69,2,250,0
"460630201","LA RIOJA",258,0,223,25,1,249,0
"460630105","LA RIOJA",196,0,168,17,4,189,0
"460140704","LA RIOJA",389,206,70,104,3,177,0.529562982005141
"460630104","LA RIOJA",270,0,259,5,2,266,0
"460140104","LA RIOJA",209,58,81,62,2,145,0.277511961722488
"460140107","LA RIOJA",348,325,10,10,0,20,0.933908045977011
"460070111","LA RIOJA",363,1,257,97,1,355,0.00275482093663912
"460140811","LA RIOJA",417,355,13,39,0,52,0.851318944844125
"460140607","LA RIOJA",276,275,1,0,0,1,0.996376811594203
"460910203","LA RIOJA",132,0,68,26,8,102,0
"460700202","LA RIOJA",27,0,7,8,4,19,0
"460141103","LA RIOJA",218,186,1,0,0,1,0.853211009174312
"460141018","LA RIOJA",295,194,49,47,0,96,0.657627118644068
"460140519","LA RIOJA",316,300,11,4,0,15,0.949367088607595
"460560102","LA RIOJA",260,1,121,88,2,211,0.00384615384615385
"460070102","LA RIOJA",258,2,204,51,0,255,0.00775193798449612
"460420122","LA RIOJA",276,275,0,1,0,1,0.996376811594203
"460350106","LA RIOJA",322,90,185,35,2,222,0.279503105590062
"460350103","LA RIOJA",528,10,450,49,2,501,0.0189393939393939
"460141017","LA RIOJA",606,487,24,51,0,75,0.803630363036304
"460141001","LA RIOJA",327,323,2,0,0,2,0.987767584097859
"460140918","LA RIOJA",338,334,4,0,0,4,0.988165680473373
"460140903","LA RIOJA",218,190,18,9,0,27,0.871559633027523
"460140813","LA RIOJA",334,326,3,5,0,8,0.976047904191617
"460140808","LA RIOJA",262,242,8,9,0,17,0.923664122137405
"460140715","LA RIOJA",283,216,28,34,0,62,0.763250883392226
"460420103","LA RIOJA",277,217,20,25,0,45,0.783393501805054
"460140508","LA RIOJA",427,389,18,17,0,35,0.911007025761124
"460840206","LA RIOJA",338,0,280,48,4,332,0
"460840205","LA RIOJA",233,0,197,30,4,231,0
"460490101","LA RIOJA",393,0,310,75,5,390,0
"460140406","LA RIOJA",300,281,9,10,0,19,0.936666666666667
"540280414","MISIONES",249,95,127,27,0,154,0.381526104417671
"461050101","LA RIOJA",248,0,171,51,7,229,0
"460420306","LA RIOJA",553,6,337,168,17,522,0.0108499095840868
"460280109","LA RIOJA",134,0,110,15,2,127,0
"460280104","LA RIOJA",154,0,120,21,5,146,0
"460210104","LA RIOJA",161,0,151,9,1,161,0
"660282302","SALTA",267,264,1,0,0,1,0.98876404494382
"460140713","LA RIOJA",362,260,34,56,4,94,0.718232044198895
"460140712","LA RIOJA",329,197,48,66,1,115,0.598784194528875
"460140410","LA RIOJA",258,256,2,0,0,2,0.992248062015504
"460070112","LA RIOJA",424,202,187,25,4,216,0.476415094339623
"460840103","LA RIOJA",245,0,89,96,10,195,0
"460630203","LA RIOJA",90,0,26,18,21,65,0
"460420113","LA RIOJA",655,627,4,2,0,6,0.957251908396947
"460420106","LA RIOJA",457,419,29,9,0,38,0.916849015317287
"460350105","LA RIOJA",232,17,179,34,0,213,0.0732758620689655
"460210201","LA RIOJA",128,0,111,16,0,127,0
"460141104","LA RIOJA",353,187,58,97,4,159,0.529745042492918
"460140805","LA RIOJA",340,332,2,4,0,6,0.976470588235294
"460630106","LA RIOJA",258,0,78,69,13,160,0
"460910102","LA RIOJA",123,0,25,44,6,75,0
"461190201","LA RIOJA",134,0,85,41,0,126,0
"460490103","LA RIOJA",189,0,144,32,4,180,0
"460070103","LA RIOJA",386,5,277,93,5,375,0.0129533678756477
"460420402","LA RIOJA",382,1,295,64,2,361,0.00261780104712042
"540280408","MISIONES",430,215,153,57,5,215,0.5
"460420206","LA RIOJA",197,3,127,52,3,182,0.0152284263959391
"460420120","LA RIOJA",600,517,55,21,0,76,0.861666666666667
"460420115","LA RIOJA",315,277,22,16,0,38,0.879365079365079
"460140101","LA RIOJA",180,23,49,70,11,130,0.127777777777778
"540280405","MISIONES",309,201,107,1,0,108,0.650485436893204
"460141102","LA RIOJA",388,184,110,87,0,197,0.474226804123711
"460141014","LA RIOJA",394,382,7,1,0,8,0.969543147208122
"460141012","LA RIOJA",603,528,28,35,1,64,0.875621890547264
"460141008","LA RIOJA",387,379,3,1,0,4,0.979328165374677
"460141002","LA RIOJA",168,161,2,3,0,5,0.958333333333333
"460140921","LA RIOJA",326,3,90,167,16,273,0.00920245398773006
"460140919","LA RIOJA",421,108,41,236,21,298,0.256532066508314
"460140912","LA RIOJA",412,372,18,16,0,34,0.902912621359223
"460140714","LA RIOJA",425,284,42,89,1,132,0.668235294117647
"460140710","LA RIOJA",352,250,58,40,0,98,0.710227272727273
"460140602","LA RIOJA",286,271,11,3,0,14,0.947552447552448
"460140510","LA RIOJA",346,332,5,7,0,12,0.959537572254335
"460140405","LA RIOJA",257,246,8,2,0,10,0.957198443579767
"460140404","LA RIOJA",394,375,7,10,1,18,0.951776649746193
"461120102","LA RIOJA",290,0,198,67,8,273,0
"460210103","LA RIOJA",95,0,87,6,0,93,0
"460210102","LA RIOJA",323,0,261,61,0,322,0
"661260616","SALTA",281,54,41,136,20,197,0.192170818505338
"661260615","SALTA",304,263,10,15,2,27,0.865131578947368
"660840205","SALTA",160,40,86,30,0,116,0.25
"461190103","LA RIOJA",348,0,256,73,0,329,0
"460490202","LA RIOJA",255,0,206,40,0,246,0
"460140110","LA RIOJA",522,285,72,141,5,218,0.545977011494253
"460070202","LA RIOJA",111,0,38,58,3,99,0
"460070110","LA RIOJA",190,1,135,42,4,181,0.00526315789473684
"540280401","MISIONES",354,56,207,82,5,294,0.15819209039548
"461050104","LA RIOJA",56,0,19,20,3,42,0
"460840203","LA RIOJA",67,0,13,37,4,54,0
"460140301","LA RIOJA",45,0,9,17,11,37,0
"661470502","SALTA",226,85,105,33,1,139,0.376106194690265
"661470314","SALTA",144,6,109,28,1,138,0.0416666666666667
"661260812","SALTA",379,42,32,253,36,321,0.110817941952507
"661260803","SALTA",154,146,2,1,0,3,0.948051948051948
"661470307","SALTA",564,6,303,202,16,521,0.0106382978723404
"661470407","SALTA",455,3,166,236,8,410,0.00659340659340659
"661470514","SALTA",294,221,26,30,0,56,0.751700680272109
"661330216","SALTA",243,0,35,57,86,178,0
"661330101","SALTA",662,0,133,144,146,423,0
"660980101","SALTA",178,45,39,55,19,113,0.252808988764045
"661400414","SALTA",343,252,47,38,0,85,0.73469387755102
"661260205","SALTA",246,107,24,70,3,97,0.434959349593496
"660560603","SALTA",156,0,28,43,49,120,0
"660560402","SALTA",222,34,88,74,15,177,0.153153153153153
"661400413","SALTA",243,232,6,1,1,8,0.954732510288066
"661120201","SALTA",114,2,41,37,7,85,0.0175438596491228
"661610105","SALTA",142,0,2,40,83,125,0
"661330210","SALTA",98,0,12,36,24,72,0
"660420105","SALTA",138,9,36,65,10,111,0.0652173913043478
"661050202","SALTA",100,0,12,57,26,95,0
"660980205","SALTA",113,0,36,21,21,78,0
"660350202","SALTA",222,3,74,110,13,197,0.0135135135135135
"660070419","SALTA",298,244,19,26,2,47,0.818791946308725
"661260415","SALTA",317,301,6,7,1,14,0.949526813880126
"661260215","SALTA",329,16,31,190,47,268,0.0486322188449848
"661260210","SALTA",291,124,31,95,5,131,0.426116838487972
"661260707","SALTA",317,282,3,9,4,16,0.889589905362776
"661260706","SALTA",290,184,17,17,0,34,0.63448275862069
"661260624","SALTA",276,204,18,32,6,56,0.739130434782609
"661260621","SALTA",200,149,3,8,0,11,0.745
"660630110","SALTA",226,194,8,17,0,25,0.858407079646018
"660560925","SALTA",302,196,10,56,22,88,0.649006622516556
"660560919","SALTA",266,50,25,96,67,188,0.18796992481203
"660560918","SALTA",253,144,6,57,21,84,0.569169960474308
"660350122","SALTA",322,45,74,148,9,231,0.139751552795031
"660560627","SALTA",218,11,22,79,61,162,0.0504587155963303
"660560626","SALTA",285,149,18,75,25,118,0.52280701754386
"540280303","MISIONES",280,36,164,67,11,242,0.128571428571429
"660490305","SALTA",372,1,280,82,2,364,0.00268817204301075
"660490107","SALTA",329,4,233,77,4,314,0.0121580547112462
"660420209","SALTA",250,2,187,53,0,240,0.008
"660420207","SALTA",336,55,201,52,2,255,0.163690476190476
"660490405","SALTA",320,188,83,46,0,129,0.5875
"660282814","SALTA",252,239,4,6,0,10,0.948412698412698
"660282801","SALTA",209,205,4,0,0,4,0.980861244019139
"660282614","SALTA",460,332,16,68,3,87,0.721739130434783
"660282613","SALTA",435,265,49,69,3,121,0.609195402298851
"660282512","SALTA",276,275,1,0,0,1,0.996376811594203
"660281902","SALTA",317,103,88,105,2,195,0.324921135646688
"540280212","MISIONES",120,118,1,1,0,2,0.983333333333333
"660560105","SALTA",292,156,25,66,11,102,0.534246575342466
"660560616","SALTA",409,4,65,220,91,376,0.0097799511002445
"660490422","SALTA",209,189,8,12,0,20,0.904306220095694
"660282504","SALTA",279,202,54,18,0,72,0.724014336917563
"660282404","SALTA",369,347,1,8,1,10,0.940379403794038
"660560614","SALTA",350,225,15,73,32,120,0.642857142857143
"660560216","SALTA",210,85,42,49,17,108,0.404761904761905
"660281814","SALTA",342,317,0,6,0,6,0.926900584795322
"660282120","SALTA",341,334,3,1,0,4,0.979472140762463
"660282115","SALTA",368,364,1,0,0,1,0.989130434782609
"660282111","SALTA",232,212,8,3,0,11,0.913793103448276
"660282019","SALTA",263,30,25,107,4,136,0.114068441064639
"660281813","SALTA",298,266,1,1,0,2,0.89261744966443
"660281811","SALTA",386,381,1,1,0,2,0.987046632124352
"660282007","SALTA",398,360,19,14,1,34,0.904522613065327
"660281907","SALTA",326,314,3,5,0,8,0.96319018404908
"661260710","SALTA",219,200,4,9,4,17,0.91324200913242
"660282004","SALTA",295,287,5,2,0,7,0.972881355932203
"660281607","SALTA",306,292,4,6,0,10,0.954248366013072
"660281605","SALTA",411,390,13,1,0,14,0.948905109489051
"660282318","SALTA",324,242,17,32,1,50,0.746913580246914
"660282311","SALTA",383,382,1,0,0,1,0.997389033942559
"660282303","SALTA",431,422,2,2,0,4,0.979118329466357
"660281807","SALTA",249,244,0,0,0,0,0.979919678714859
"660281803","SALTA",262,256,2,0,0,2,0.977099236641221
"540280210","MISIONES",267,266,0,1,0,1,0.99625468164794
"660281716","SALTA",330,304,4,9,1,14,0.921212121212121
"660281712","SALTA",388,374,10,0,0,10,0.963917525773196
"540911207","MISIONES",89,1,14,25,32,71,0.0112359550561798
"660282212","SALTA",386,385,0,0,0,0,0.99740932642487
"660281601","SALTA",402,367,9,13,0,22,0.912935323383085
"660281515","SALTA",427,400,3,2,1,6,0.936768149882904
"660281504","SALTA",389,263,36,44,1,81,0.676092544987147
"660281409","SALTA",387,316,9,1,0,10,0.816537467700258
"660281307","SALTA",386,383,3,0,0,3,0.992227979274611
"660281215","SALTA",262,198,15,40,3,58,0.755725190839695
"660281210","SALTA",253,246,1,1,1,3,0.972332015810277
"660281708","SALTA",361,347,11,0,0,11,0.961218836565097
"660281619","SALTA",472,340,56,48,1,105,0.720338983050847
"660281617","SALTA",437,235,41,114,2,157,0.537757437070938
"660280609","SALTA",197,197,0,0,0,0,1
"660280519","SALTA",182,178,4,0,0,4,0.978021978021978
"660280514","SALTA",232,220,4,0,0,4,0.948275862068966
"660280501","SALTA",394,391,3,0,0,3,0.99238578680203
"660280420","SALTA",209,174,12,20,0,32,0.832535885167464
"660280419","SALTA",294,133,47,95,0,142,0.452380952380952
"660280414","SALTA",270,246,1,0,0,1,0.911111111111111
"660280409","SALTA",332,332,0,0,0,0,1
"660280405","SALTA",424,31,94,280,4,378,0.0731132075471698
"660281113","SALTA",189,188,1,0,0,1,0.994708994708995
"660281110","SALTA",221,220,1,0,0,1,0.995475113122172
"660281005","SALTA",327,323,3,0,0,3,0.987767584097859
"660281003","SALTA",358,351,2,3,0,5,0.980446927374302
"660281002","SALTA",330,323,2,3,0,5,0.978787878787879
"660280910","SALTA",198,193,0,0,0,0,0.974747474747475
"661610205","SALTA",262,0,187,46,22,255,0
"660070424","SALTA",397,11,182,153,40,375,0.0277078085642317
"660282620","SALTA",334,3,64,215,5,284,0.00898203592814371
"660280112","SALTA",401,22,320,55,0,375,0.0548628428927681
"661400115","SALTA",49,0,33,13,0,46,0
"660840108","SALTA",196,5,144,36,2,182,0.0255102040816327
"660280618","SALTA",195,194,1,0,0,1,0.994871794871795
"660560811","SALTA",152,148,4,0,0,4,0.973684210526316
"660560611","SALTA",175,0,15,19,49,83,0
"660560209","SALTA",101,0,2,50,37,89,0
"660070413","SALTA",39,0,19,15,2,36,0
"660490304","SALTA",213,1,72,97,3,172,0.00469483568075117
"660350208","SALTA",163,3,102,52,2,156,0.0184049079754601
"660280903","SALTA",254,246,4,2,0,6,0.968503937007874
"660280108","SALTA",160,11,111,35,1,147,0.06875
"660210112","SALTA",291,275,4,8,0,12,0.945017182130584
"660070426","SALTA",226,0,52,126,33,211,0
"661540203","SALTA",49,0,9,19,10,38,0
"661540202","SALTA",22,0,3,15,1,19,0
"661260614","SALTA",317,213,16,42,34,92,0.67192429022082
"661260609","SALTA",355,3,46,178,81,305,0.00845070422535211
"660282312","SALTA",291,286,2,0,0,2,0.982817869415808
"660282806","SALTA",420,417,0,1,0,1,0.992857142857143
"661540103","SALTA",27,0,9,11,5,25,0
"661470405","SALTA",62,0,6,18,34,58,0
"661470303","SALTA",12,0,0,5,1,6,0
"661470301","SALTA",21,0,0,1,13,14,0
"661260504","SALTA",276,246,29,1,0,30,0.891304347826087
"661260218","SALTA",224,124,10,82,4,96,0.553571428571429
"661260105","SALTA",262,138,26,64,9,99,0.526717557251908
"540210611","MISIONES",61,0,29,13,16,58,0
"661260503","SALTA",5,0,0,2,1,3,0
"661260204","SALTA",35,17,6,11,0,17,0.485714285714286
"660070308","SALTA",20,0,0,16,4,20,0
"661260101","SALTA",35,1,7,15,1,23,0.0285714285714286
"660560502","SALTA",39,1,20,6,3,29,0.0256410256410256
"661120308","SALTA",179,176,1,2,0,3,0.983240223463687
"661260703","SALTA",258,190,9,49,0,58,0.736434108527132
"660560501","SALTA",18,0,0,6,5,11,0
"660560202","SALTA",119,0,11,34,53,98,0
"661120215","SALTA",282,238,30,7,1,38,0.843971631205674
"540280205","MISIONES",181,171,7,3,0,10,0.94475138121547
"660490201","SALTA",94,0,7,48,10,65,0
"660490101","SALTA",24,0,3,16,2,21,0
"660420101","SALTA",98,2,11,34,4,49,0.0204081632653061
"661470102","SALTA",34,0,0,15,7,22,0
"661330305","SALTA",168,0,4,14,107,125,0
"661330303","SALTA",34,0,0,2,7,9,0
"660560915","SALTA",416,380,21,9,0,30,0.913461538461538
"661330302","SALTA",111,0,7,12,43,62,0
"661330211","SALTA",70,0,4,4,17,25,0
"661330209","SALTA",56,0,0,8,41,49,0
"660560904","SALTA",269,244,13,11,1,25,0.907063197026022
"660350106","SALTA",359,11,168,134,0,302,0.0306406685236769
"660070306","SALTA",11,0,5,6,0,11,0
"660350103","SALTA",223,4,128,72,4,204,0.0179372197309417
"661610203","SALTA",75,0,14,28,8,50,0
"661050103","SALTA",3,0,0,0,0,0,0
"660910104","SALTA",38,0,0,1,20,21,0
"660770205","SALTA",291,0,223,53,1,277,0
"660770303","SALTA",105,0,70,18,4,92,0
"660770201","SALTA",20,0,1,2,1,4,0
"660770103","SALTA",69,0,32,25,0,57,0
"661470510","SALTA",335,280,11,25,1,37,0.835820895522388
"660561009","SALTA",190,3,113,48,8,169,0.0157894736842105
"660560916","SALTA",327,250,31,11,6,48,0.764525993883792
"660700502","SALTA",5,0,1,2,0,3,0
"660700105","SALTA",46,0,3,38,1,42,0
"660280204","SALTA",13,0,7,4,0,11,0
"660490412","SALTA",262,173,37,44,6,87,0.66030534351145
"660490215","SALTA",221,1,74,138,2,214,0.00452488687782805
"660561014","SALTA",159,71,50,32,1,83,0.446540880503145
"140210914","CORDOBA",325,277,33,15,0,48,0.852307692307692
"661610103","SALTA",243,0,14,80,83,177,0
"660490411","SALTA",268,159,38,63,2,103,0.593283582089552
"660490414","SALTA",208,162,19,21,1,41,0.778846153846154
"660630109","SALTA",23,0,1,12,0,13,0
"660070503","SALTA",35,0,0,21,8,29,0
"660210202","SALTA",16,0,1,3,2,6,0
"661120207","SALTA",30,0,2,1,0,3,0
"660420109","SALTA",277,221,27,26,2,55,0.797833935018051
"660210102","SALTA",31,0,13,10,1,24,0
"660140205","SALTA",10,0,3,1,0,4,0
"660561013","SALTA",289,63,32,112,47,191,0.217993079584775
"660561012","SALTA",227,146,14,27,15,56,0.643171806167401
"540070614","MISIONES",200,6,158,34,1,193,0.03
"660070501","SALTA",52,0,18,5,9,32,0
"660350107","SALTA",33,0,3,26,0,29,0
"661120411","SALTA",299,261,3,28,4,35,0.872909698996655
"660282802","SALTA",198,196,2,0,0,2,0.98989898989899
"661400113","SALTA",74,1,34,26,0,60,0.0135135135135135
"660420103","SALTA",252,1,132,85,18,235,0.00396825396825397
"661470504","SALTA",317,266,16,15,2,33,0.839116719242902
"661400411","SALTA",287,276,5,2,0,7,0.961672473867596
"660560808","SALTA",182,174,2,0,2,4,0.956043956043956
"660560701","SALTA",508,2,66,269,75,410,0.00393700787401575
"660560630","SALTA",124,0,11,21,73,105,0
"660560624","SALTA",515,0,17,248,143,408,0
"660280104","SALTA",359,11,179,135,3,317,0.0306406685236769
"660560609","SALTA",44,4,29,5,5,39,0.0909090909090909
"661400405","SALTA",274,150,14,77,14,105,0.547445255474453
"660560205","SALTA",118,6,27,49,5,81,0.0508474576271186
"660560103","SALTA",214,5,16,93,42,151,0.0233644859813084
"661260805","SALTA",200,187,9,3,0,12,0.935
"660560102","SALTA",311,85,10,109,47,166,0.273311897106109
"660420107","SALTA",71,5,27,25,8,60,0.0704225352112676
"661260722","SALTA",218,218,0,0,0,0,1
"661260719","SALTA",166,157,1,6,2,9,0.94578313253012
"660282714","SALTA",316,302,6,5,0,11,0.955696202531646
"660282604","SALTA",241,211,8,15,0,23,0.87551867219917
"660282009","SALTA",355,307,11,32,0,43,0.864788732394366
"661050213","SALTA",238,52,5,98,35,138,0.218487394957983
"660350116","SALTA",313,237,42,22,3,67,0.757188498402556
"660350114","SALTA",282,222,20,33,2,55,0.787234042553192
"660350109","SALTA",459,365,40,31,2,73,0.79520697167756
"660282811","SALTA",343,316,10,17,0,27,0.921282798833819
"540070601","MISIONES",28,17,10,1,0,11,0.607142857142857
"660282410","SALTA",445,313,3,57,1,61,0.703370786516854
"660560408","SALTA",228,136,27,59,4,90,0.596491228070175
"660560218","SALTA",319,248,21,38,1,60,0.777429467084639
"660560212","SALTA",223,112,41,31,21,93,0.502242152466368
"660560409","SALTA",160,0,9,43,57,109,0
"660282003","SALTA",246,246,0,0,0,0,1
"660281915","SALTA",298,108,58,100,2,160,0.36241610738255
"660282316","SALTA",302,255,16,18,2,36,0.844370860927152
"660560118","SALTA",272,74,23,78,35,136,0.272058823529412
"660560116","SALTA",122,70,2,22,22,46,0.573770491803279
"660560110","SALTA",254,215,6,13,4,23,0.846456692913386
"660490402","SALTA",246,106,40,94,1,135,0.430894308943089
"660490401","SALTA",318,311,5,2,0,7,0.977987421383648
"660490309","SALTA",210,1,161,40,1,202,0.00476190476190476
"660282309","SALTA",389,379,8,0,0,8,0.974293059125964
"660282211","SALTA",275,275,0,0,0,0,1
"660281703","SALTA",262,259,2,0,0,2,0.988549618320611
"660282605","SALTA",266,255,5,4,0,9,0.958646616541353
"660282214","SALTA",396,395,1,0,0,1,0.997474747474748
"660281525","SALTA",354,345,2,1,0,3,0.974576271186441
"660281518","SALTA",326,321,2,0,0,2,0.984662576687117
"660281517","SALTA",224,224,0,0,0,0,1
"660281516","SALTA",295,292,2,0,0,2,0.989830508474576
"660281414","SALTA",248,246,1,0,0,1,0.991935483870968
"660281305","SALTA",392,388,1,0,0,1,0.989795918367347
"660281405","SALTA",283,281,1,1,0,2,0.992932862190813
"660281401","SALTA",321,317,2,0,0,2,0.987538940809969
"660280617","SALTA",220,220,0,0,0,0,1
"660281905","SALTA",371,245,34,78,0,112,0.660377358490566
"660281805","SALTA",265,262,1,1,0,2,0.988679245283019
"660280116","SALTA",126,0,36,61,3,100,0
"660070510","SALTA",193,0,13,18,101,132,0
"660281613","SALTA",244,213,11,18,0,29,0.872950819672131
"660281610","SALTA",354,333,4,2,0,6,0.940677966101695
"661260712","SALTA",213,200,1,6,5,12,0.938967136150235
"660280601","SALTA",331,327,1,0,0,1,0.987915407854985
"660280502","SALTA",202,199,1,0,0,1,0.985148514851485
"660280415","SALTA",302,96,141,63,0,204,0.317880794701987
"660281114","SALTA",233,233,0,0,0,0,1
"660281108","SALTA",181,181,0,0,0,0,1
"660281012","SALTA",242,241,0,0,0,0,0.995867768595041
"660070106","SALTA",194,5,35,74,40,149,0.0257731958762887
"660280908","SALTA",313,114,82,110,0,192,0.364217252396166
"660070108","SALTA",233,5,67,84,44,195,0.0214592274678112
"660280907","SALTA",266,169,63,33,0,96,0.635338345864662
"660280901","SALTA",388,382,5,1,0,6,0.984536082474227
"660280802","SALTA",227,216,0,0,0,0,0.951541850220264
"660280801","SALTA",0,0,0,0,0,0,NA
"660280713","SALTA",312,303,3,2,0,5,0.971153846153846
"660280207","SALTA",399,395,1,0,0,1,0.989974937343358
"660280410","SALTA",272,244,16,12,0,28,0.897058823529412
"660280118","SALTA",376,1,93,191,3,287,0.00265957446808511
"661540208","SALTA",104,0,36,55,9,100,0
"660070321","SALTA",358,201,14,94,15,123,0.56145251396648
"660282002","SALTA",316,314,0,2,0,2,0.993670886075949
"660140207","SALTA",186,143,19,16,1,36,0.768817204301075
"660070620","SALTA",199,0,163,13,0,176,0
"660560307","SALTA",248,0,30,124,35,189,0
"660420208","SALTA",371,120,177,65,2,244,0.323450134770889
"660281115","SALTA",129,126,2,0,0,2,0.976744186046512
"661330219","SALTA",128,0,18,34,23,75,0
"660282015","SALTA",327,279,2,8,0,10,0.853211009174312
"660210110","SALTA",303,296,4,1,0,5,0.976897689768977
"661120110","SALTA",103,2,27,63,9,99,0.0194174757281553
"661120109","SALTA",308,3,152,114,10,276,0.00974025974025974
"660070320","SALTA",262,211,16,12,3,31,0.805343511450382
"660282116","SALTA",409,405,0,0,0,0,0.990220048899755
"660281519","SALTA",244,241,0,0,0,0,0.987704918032787
"660070214","SALTA",204,130,24,28,8,60,0.637254901960784
"660070207","SALTA",249,2,143,54,24,221,0.00803212851405622
"660281103","SALTA",325,323,1,0,0,1,0.993846153846154
"661540205","SALTA",11,0,0,7,0,7,0
"140210913","CORDOBA",306,230,59,10,0,69,0.751633986928105
"661260211","SALTA",291,11,38,155,24,217,0.0378006872852234
"661470302","SALTA",47,0,4,5,5,14,0
"661260606","SALTA",27,0,9,9,1,19,0
"661470505","SALTA",225,198,17,8,0,25,0.88
"740560602","SAN LUIS",62,62,0,0,0,0,1
"661190202","SALTA",48,0,2,25,6,33,0
"660490204","SALTA",46,0,3,27,4,34,0
"660420202","SALTA",182,1,76,84,19,179,0.00549450549450549
"540630109","MISIONES",369,21,149,113,55,317,0.0569105691056911
"660560607","SALTA",41,0,2,7,16,25,0
"661260714","SALTA",295,237,8,44,0,52,0.803389830508475
"660560403","SALTA",158,0,27,20,61,108,0
"660560401","SALTA",148,0,7,46,76,129,0
"540630108","MISIONES",212,5,99,77,19,195,0.0235849056603774
"660420102","SALTA",51,0,4,31,3,38,0
"661260617","SALTA",238,190,3,18,2,23,0.798319327731092
"660280702","SALTA",358,354,1,0,0,1,0.988826815642458
"661400308","SALTA",15,0,1,5,8,14,0
"661400304","SALTA",96,0,7,62,14,83,0
"661260418","SALTA",229,229,0,0,0,0,1
"661400302","SALTA",20,1,5,7,1,13,0.05
"660560620","SALTA",226,168,18,33,2,53,0.743362831858407
"661260209","SALTA",439,299,21,64,18,103,0.681093394077449
"661120412","SALTA",345,279,21,37,1,59,0.808695652173913
"660560903","SALTA",244,232,5,5,0,10,0.950819672131147
"661330307","SALTA",49,0,26,3,2,31,0
"661330217","SALTA",35,0,0,11,20,31,0
"661260611","SALTA",386,90,14,165,44,223,0.233160621761658
"661260506","SALTA",225,211,0,6,4,10,0.937777777777778
"660280701","SALTA",335,318,5,4,0,9,0.949253731343284
"660560907","SALTA",320,36,22,162,56,240,0.1125
"660560906","SALTA",282,216,2,25,0,27,0.765957446808511
"661330204","SALTA",33,0,1,21,5,27,0
"661330106","SALTA",251,0,24,38,69,131,0
"660770301","SALTA",14,0,5,4,2,11,0
"661260505","SALTA",253,203,3,3,4,10,0.802371541501976
"661610204","SALTA",50,0,1,8,24,33,0
"661120104","SALTA",51,0,7,37,7,51,0
"661610109","SALTA",90,0,1,31,54,86,0
"660840204","SALTA",21,0,2,11,0,13,0
"660840203","SALTA",50,0,25,12,2,39,0
"660700506","SALTA",18,0,0,2,10,12,0
"660700504","SALTA",81,0,3,34,31,68,0
"660700406","SALTA",6,0,0,2,0,2,0
"660070401","SALTA",26,0,6,7,0,13,0
"660070613","SALTA",9,0,1,3,4,8,0
"660070304","SALTA",41,0,6,13,6,25,0
"660070101","SALTA",185,0,2,60,37,99,0
"660560809","SALTA",190,186,1,1,1,3,0.978947368421053
"660070206","SALTA",15,0,0,2,6,8,0
"660070611","SALTA",86,0,5,21,38,64,0
"661330208","SALTA",173,0,46,39,43,128,0
"661260403","SALTA",27,8,3,13,0,16,0.296296296296296
"660280201","SALTA",268,140,101,19,0,120,0.522388059701492
"660070103","SALTA",83,1,26,26,12,64,0.0120481927710843
"660140201","SALTA",3,0,0,0,0,0,0
"660280705","SALTA",254,249,0,2,0,2,0.980314960629921
"660070410","SALTA",47,0,1,36,5,42,0
"661330301","SALTA",188,0,7,55,85,147,0
"660630107","SALTA",92,2,37,28,3,68,0.0217391304347826
"660281102","SALTA",170,168,1,0,0,1,0.988235294117647
"660210103","SALTA",200,0,94,83,3,180,0
"660070607","SALTA",63,0,15,24,22,61,0
"660980104","SALTA",31,1,13,12,1,26,0.032258064516129
"660560905","SALTA",299,265,7,19,4,30,0.88628762541806
"661470409","SALTA",277,0,157,97,2,256,0
"661470408","SALTA",371,5,159,177,11,347,0.0134770889487871
"661470315","SALTA",417,3,335,72,0,407,0.00719424460431655
"661610306","SALTA",231,194,5,22,3,30,0.83982683982684
"661400121","SALTA",493,469,18,2,0,20,0.95131845841785
"661330308","SALTA",84,0,30,4,28,62,0
"661400401","SALTA",314,286,11,15,0,26,0.910828025477707
"661400312","SALTA",145,7,81,48,3,132,0.0482758620689655
"661260823","SALTA",291,230,8,31,0,39,0.790378006872852
"661260806","SALTA",207,202,3,1,0,4,0.975845410628019
"661260801","SALTA",360,287,6,49,9,64,0.797222222222222
"661260718","SALTA",282,268,3,4,4,11,0.950354609929078
"661050211","SALTA",156,133,5,8,9,22,0.852564102564103
"660980105","SALTA",381,108,138,85,13,236,0.283464566929134
"661120408","SALTA",199,193,3,2,0,5,0.969849246231156
"661120406","SALTA",248,216,14,17,0,31,0.870967741935484
"661120304","SALTA",202,156,14,25,0,39,0.772277227722772
"661470508","SALTA",199,190,1,6,0,7,0.954773869346734
"660561010","SALTA",322,11,114,122,50,286,0.0341614906832298
"660560411","SALTA",180,0,24,94,48,166,0
"660560909","SALTA",506,284,42,86,74,202,0.561264822134387
"661120302","SALTA",254,229,8,16,0,24,0.901574803149606
"660560715","SALTA",376,110,18,175,44,237,0.292553191489362
"660560708","SALTA",409,0,37,251,89,377,0
"660560803","SALTA",254,216,15,16,3,34,0.850393700787402
"660560706","SALTA",349,347,0,0,0,0,0.994269340974212
"740350910","SAN LUIS",330,323,5,1,0,6,0.978787878787879
"660560704","SALTA",232,187,0,16,15,31,0.806034482758621
"660282810","SALTA",403,330,19,31,0,50,0.818858560794045
"660282710","SALTA",255,220,0,4,0,4,0.862745098039216
"660282704","SALTA",354,344,3,2,2,7,0.971751412429379
"540282017","MISIONES",229,6,42,124,43,209,0.0262008733624454
"660560629","SALTA",181,0,47,68,50,165,0
"660420210","SALTA",246,1,123,101,5,229,0.0040650406504065
"140210912","CORDOBA",204,161,31,11,0,42,0.78921568627451
"660420111","SALTA",263,224,6,22,7,35,0.85171102661597
"660282107","SALTA",290,290,0,0,0,0,1
"660282510","SALTA",380,376,2,0,0,2,0.989473684210526
"660282507","SALTA",277,5,227,40,1,268,0.0180505415162455
"660282506","SALTA",242,3,194,22,0,216,0.012396694214876
"660282501","SALTA",444,425,10,0,0,10,0.957207207207207
"660282406","SALTA",298,215,16,47,1,64,0.721476510067114
"660560407","SALTA",88,58,8,16,5,29,0.659090909090909
"660560117","SALTA",248,192,2,31,12,45,0.774193548387097
"660560108","SALTA",203,186,7,5,4,16,0.916256157635468
"660282117","SALTA",381,377,2,0,0,2,0.989501312335958
"660282112","SALTA",229,229,0,0,0,0,1
"660282105","SALTA",452,442,3,5,0,8,0.97787610619469
"660282608","SALTA",447,99,97,207,4,308,0.221476510067114
"660282103","SALTA",139,136,2,1,0,3,0.97841726618705
"660282017","SALTA",312,232,12,43,0,55,0.743589743589744
"660282306","SALTA",365,357,5,0,0,5,0.978082191780822
"660282204","SALTA",390,384,0,2,0,2,0.984615384615385
"660282203","SALTA",312,308,1,0,0,1,0.987179487179487
"660282202","SALTA",219,219,0,0,0,0,1
"660281510","SALTA",269,268,0,0,0,0,0.996282527881041
"660281408","SALTA",386,383,1,0,0,1,0.992227979274611
"660281306","SALTA",294,291,2,0,0,2,0.989795918367347
"660281214","SALTA",268,179,32,46,0,78,0.667910447761194
"660281404","SALTA",254,237,6,0,0,6,0.933070866141732
"660281403","SALTA",334,333,0,0,0,0,0.997005988023952
"660280703","SALTA",288,281,2,0,0,2,0.975694444444444
"140210716","CORDOBA",156,0,104,38,3,145,0
"660281909","SALTA",256,57,65,99,4,168,0.22265625
"660281809","SALTA",275,265,5,0,0,5,0.963636363636364
"660281713","SALTA",333,227,38,51,2,91,0.681681681681682
"660281711","SALTA",230,225,0,3,0,3,0.978260869565217
"660281615","SALTA",262,217,3,0,0,3,0.82824427480916
"660281612","SALTA",271,265,0,0,0,0,0.977859778597786
"660210115","SALTA",290,281,4,2,1,7,0.968965517241379
"660281608","SALTA",285,268,6,6,0,12,0.940350877192982
"660280518","SALTA",222,220,2,0,0,2,0.990990990990991
"660280406","SALTA",433,16,178,223,1,402,0.0369515011547344
"660281107","SALTA",211,209,2,0,0,2,0.990521327014218
"660281105","SALTA",276,276,0,0,0,0,1
"660281104","SALTA",234,232,1,0,0,1,0.991452991452991
"660281013","SALTA",206,205,1,0,0,1,0.995145631067961
"660281010","SALTA",305,304,0,0,0,0,0.99672131147541
"660281007","SALTA",256,254,2,0,0,2,0.9921875
"660281001","SALTA",255,251,3,0,0,3,0.984313725490196
"660280916","SALTA",221,201,3,0,0,3,0.909502262443439
"660280809","SALTA",468,451,5,4,0,9,0.963675213675214
"660280803","SALTA",234,198,3,3,0,6,0.846153846153846
"660280206","SALTA",282,1,58,201,0,259,0.00354609929078014
"660280402","SALTA",336,45,103,174,1,278,0.133928571428571
"660282110","SALTA",178,176,2,0,0,2,0.98876404494382
"660280113","SALTA",200,14,168,14,0,182,0.07
"660840106","SALTA",224,2,158,51,3,212,0.00892857142857143
"660140104","SALTA",127,2,94,27,0,121,0.015748031496063
"660560305","SALTA",232,0,5,106,95,206,0
"660560214","SALTA",193,178,6,7,1,14,0.922279792746114
"660070415","SALTA",164,2,98,51,8,157,0.0121951219512195
"660420108","SALTA",229,205,13,5,0,18,0.895196506550218
"660280107","SALTA",209,7,178,22,1,201,0.0334928229665072
"661260408","SALTA",189,12,14,95,18,127,0.0634920634920635
"661050104","SALTA",51,12,25,12,1,38,0.235294117647059
"660280105","SALTA",359,356,3,0,0,3,0.991643454038997
"660070322","SALTA",249,173,15,25,9,49,0.694779116465863
"660282101","SALTA",252,247,5,0,0,5,0.98015873015873
"660280604","SALTA",318,310,7,0,0,7,0.974842767295597
"660280912","SALTA",215,215,0,0,0,0,1
"660070315","SALTA",189,4,54,75,41,170,0.0211640211640212
"660070425","SALTA",230,6,114,90,14,218,0.0260869565217391
"661260623","SALTA",136,0,2,44,47,93,0
"300560112","ENTRE RIOS",155,155,0,0,0,0,1
"661540207","SALTA",54,0,2,24,14,40,0
"661260723","SALTA",289,199,40,5,9,54,0.688581314878893
"660070210","SALTA",193,169,4,11,4,19,0.875647668393782
"661610107","SALTA",67,0,0,36,24,60,0
"661540104","SALTA",1,0,0,0,1,1,0
"660630101","SALTA",22,0,4,6,1,11,0
"661610110","SALTA",298,169,20,80,12,112,0.567114093959732
"661540102","SALTA",69,0,12,22,20,54,0
"661470404","SALTA",122,1,24,39,35,98,0.00819672131147541
"661190203","SALTA",130,0,21,46,2,69,0
"660560610","SALTA",34,0,0,25,6,31,0
"660560606","SALTA",57,0,4,2,36,42,0
"660560104","SALTA",23,0,0,0,1,1,0
"661260412","SALTA",380,133,18,139,54,211,0.35
"340140707","FORMOSA",223,98,111,4,1,116,0.439461883408072
"661120413","SALTA",360,262,29,61,2,92,0.727777777777778
"660910205","SALTA",147,0,82,56,3,141,0
"660420204","SALTA",4,0,0,1,2,3,0
"661400303","SALTA",11,0,1,4,1,6,0
"661400102","SALTA",35,1,15,13,2,30,0.0285714285714286
"661120213","SALTA",347,318,2,15,6,23,0.9164265129683
"661330218","SALTA",55,0,4,8,27,39,0
"660350203","SALTA",210,1,54,123,2,179,0.00476190476190476
"660350105","SALTA",144,1,37,66,4,107,0.00694444444444444
"661610301","SALTA",78,0,4,27,36,67,0
"340140708","FORMOSA",270,29,238,0,0,238,0.107407407407407
"661050208","SALTA",7,0,0,5,0,5,0
"660910204","SALTA",58,0,0,45,5,50,0
"660840104","SALTA",16,0,7,5,1,13,0
"661120212","SALTA",277,198,5,15,20,40,0.714801444043321
"340140408","FORMOSA",285,270,14,0,0,14,0.947368421052632
"660770203","SALTA",16,0,4,6,1,11,0
"660700501","SALTA",9,0,1,0,0,1,0
"660700404","SALTA",21,0,3,6,6,15,0
"660700401","SALTA",24,0,0,18,6,24,0
"660700102","SALTA",106,10,12,26,41,79,0.0943396226415094
"661120211","SALTA",49,0,6,20,19,45,0
"660630106","SALTA",7,0,0,3,0,3,0
"660070404","SALTA",15,0,2,1,7,10,0
"660070311","SALTA",23,0,4,10,7,21,0
"660070313","SALTA",24,0,8,14,2,24,0
"660560503","SALTA",86,0,6,18,32,56,0
"660070412","SALTA",34,0,8,18,1,27,0
"661610101","SALTA",63,0,4,35,10,49,0
"661610104","SALTA",56,0,0,25,27,52,0
"660070105","SALTA",86,0,7,21,9,37,0
"661260406","SALTA",108,32,10,40,11,61,0.296296296296296
"660070102","SALTA",19,1,10,5,0,15,0.0526315789473684
"661400104","SALTA",9,0,0,6,0,6,0
"660700302","SALTA",11,0,0,3,0,3,0
"660070610","SALTA",30,0,0,4,24,28,0
"660070604","SALTA",20,0,0,4,5,9,0
"661540204","SALTA",26,0,2,5,7,14,0
"660840102","SALTA",138,0,62,56,7,125,0
"661260701","SALTA",371,158,24,160,12,196,0.425876010781671
"660280202","SALTA",202,170,8,4,0,12,0.841584158415842
"660070606","SALTA",47,0,25,14,5,44,0
"300840317","ENTRE RIOS",233,231,1,1,0,2,0.991416309012876
"660420203","SALTA",363,9,257,67,18,342,0.0247933884297521
"661400311","SALTA",133,1,70,39,3,112,0.0075187969924812
"660280716","SALTA",332,325,2,3,0,5,0.978915662650602
"661400117","SALTA",370,53,64,159,20,243,0.143243243243243
"661400116","SALTA",266,19,27,200,4,231,0.0714285714285714
"661330310","SALTA",251,0,39,52,90,181,0
"661400415","SALTA",325,273,19,22,3,44,0.84
"661330222","SALTA",139,0,59,35,37,131,0
"661400402","SALTA",301,212,36,39,2,77,0.704318936877076
"660770107","SALTA",188,0,128,49,3,180,0
"660700508","SALTA",179,1,49,100,14,163,0.00558659217877095
"660560911","SALTA",408,75,21,127,117,265,0.183823529411765
"660560813","SALTA",246,217,9,10,2,21,0.882113821138211
"660560812","SALTA",297,276,10,8,0,18,0.929292929292929
"660560807","SALTA",128,126,1,1,0,2,0.984375
"660560806","SALTA",191,186,5,0,0,5,0.973821989528796
"660560713","SALTA",312,301,3,5,0,8,0.96474358974359
"660560628","SALTA",219,127,13,22,41,76,0.579908675799087
"660560623","SALTA",190,174,6,7,0,13,0.91578947368421
"660490306","SALTA",200,1,102,73,1,176,0.005
"141611114","CORDOBA",244,229,5,8,0,13,0.938524590163934
"660490214","SALTA",225,224,0,0,0,0,0.995555555555556
"660420206","SALTA",406,118,196,77,4,277,0.29064039408867
"660350212","SALTA",360,4,259,83,3,345,0.0111111111111111
"660350117","SALTA",406,233,62,96,3,161,0.573891625615764
"660350113","SALTA",283,222,27,26,3,56,0.784452296819788
"660350112","SALTA",294,269,15,7,1,23,0.914965986394558
"660350110","SALTA",285,257,16,4,0,20,0.901754385964912
"660282713","SALTA",395,367,11,9,0,20,0.929113924050633
"660282602","SALTA",311,308,0,0,0,0,0.990353697749196
"660282514","SALTA",314,310,4,0,0,4,0.987261146496815
"660282513","SALTA",223,222,1,0,0,1,0.995515695067265
"660282508","SALTA",393,12,270,95,3,368,0.0305343511450382
"660282503","SALTA",237,175,37,22,0,59,0.738396624472574
"660560119","SALTA",338,127,34,96,38,168,0.375739644970414
"660560112","SALTA",493,247,45,125,61,231,0.501014198782961
"660490419","SALTA",208,174,10,20,0,30,0.836538461538462
"660560612","SALTA",253,5,33,77,44,154,0.0197628458498024
"660560306","SALTA",330,7,9,113,119,241,0.0212121212121212
"660560215","SALTA",195,73,34,61,11,106,0.374358974358974
"660560211","SALTA",236,196,13,22,0,35,0.830508474576271
"660560410","SALTA",283,2,39,138,60,237,0.00706713780918728
"660281801","SALTA",336,330,5,0,0,5,0.982142857142857
"660490403","SALTA",360,85,124,141,4,269,0.236111111111111
"660282502","SALTA",243,239,0,2,1,3,0.983539094650206
"660282118","SALTA",327,324,0,0,0,0,0.990825688073395
"660282113","SALTA",240,224,6,4,0,10,0.933333333333333
"660282611","SALTA",394,255,38,62,0,100,0.647208121827411
"660282014","SALTA",321,295,14,3,0,17,0.919003115264797
"660282001","SALTA",223,217,2,0,0,2,0.973094170403587
"660280416","SALTA",278,136,92,43,0,135,0.489208633093525
"660281604","SALTA",305,296,1,1,0,2,0.970491803278689
"660282317","SALTA",327,264,19,25,1,45,0.807339449541284
"660280421","SALTA",240,240,0,0,0,0,1
"660282314","SALTA",367,332,14,18,0,32,0.904632152588556
"660282207","SALTA",239,235,3,0,0,3,0.98326359832636
"660282206","SALTA",253,253,0,0,0,0,1
"660281506","SALTA",326,154,49,99,0,148,0.47239263803681
"660281412","SALTA",420,410,2,2,0,4,0.976190476190476
"660281410","SALTA",342,310,5,0,0,5,0.906432748538012
"660280615","SALTA",226,225,1,0,0,1,0.995575221238938
"660281911","SALTA",327,314,5,5,0,10,0.960244648318043
"660281817","SALTA",297,282,6,4,0,10,0.94949494949495
"660281806","SALTA",295,289,2,0,0,2,0.979661016949153
"660280403","SALTA",305,118,71,106,0,177,0.386885245901639
"660070208","SALTA",214,182,6,11,4,21,0.850467289719626
"540980603","MISIONES",39,0,1,12,20,33,0
"660281707","SALTA",385,371,12,0,0,12,0.963636363636364
"660281611","SALTA",366,358,0,0,0,0,0.978142076502732
"660281715","SALTA",297,282,7,2,0,9,0.94949494949495
"660280602","SALTA",335,330,1,0,0,1,0.985074626865672
"660280516","SALTA",400,386,4,4,0,8,0.965
"660280513","SALTA",247,247,0,0,0,0,1
"660280508","SALTA",318,317,0,0,0,0,0.99685534591195
"660280507","SALTA",346,291,6,2,15,23,0.841040462427746
"660280505","SALTA",264,223,8,25,0,33,0.84469696969697
"660281208","SALTA",159,157,1,0,0,1,0.987421383647799
"660281116","SALTA",98,98,0,0,0,0,1
"660280913","SALTA",281,273,4,2,0,6,0.97153024911032
"660280904","SALTA",250,227,6,13,0,19,0.908
"660280815","SALTA",226,221,4,0,0,4,0.97787610619469
"660280813","SALTA",289,275,2,0,0,2,0.951557093425606
"660280807","SALTA",252,248,1,0,0,1,0.984126984126984
"660280710","SALTA",363,354,4,2,0,6,0.975206611570248
"660280709","SALTA",401,391,3,2,1,6,0.975062344139651
"660281207","SALTA",177,175,2,0,0,2,0.988700564971751
"660280205","SALTA",231,218,11,2,0,13,0.943722943722944
"660070319","SALTA",258,231,11,14,0,25,0.895348837209302
"660070317","SALTA",264,212,7,12,5,24,0.803030303030303
"660281204","SALTA",216,214,2,0,0,2,0.990740740740741
"660280411","SALTA",228,228,0,0,0,0,1
"661540106","SALTA",186,119,16,31,4,51,0.639784946236559
"660980208","SALTA",211,0,125,65,8,198,0
"660910105","SALTA",39,0,10,16,7,33,0
"660070621","SALTA",291,5,170,64,30,264,0.0171821305841924
"660070619","SALTA",245,0,122,78,16,216,0
"660070615","SALTA",189,1,107,48,15,170,0.00529100529100529
"660070418","SALTA",307,171,51,75,3,129,0.55700325732899
"660560208","SALTA",122,0,27,44,29,100,0
"660281413","SALTA",423,421,0,1,0,1,0.995271867612293
"660281008","SALTA",169,169,0,0,0,0,1
"661260213","SALTA",342,262,5,57,11,73,0.766081871345029
"661540210","SALTA",300,252,6,24,6,36,0.84
"661470402","SALTA",180,2,71,92,0,163,0.0111111111111111
"661470104","SALTA",46,0,2,26,15,43,0
"661190201","SALTA",18,0,0,12,0,12,0
"660490303","SALTA",31,0,2,18,0,20,0
"660840109","SALTA",225,5,159,50,3,212,0.0222222222222222
"661400403","SALTA",273,255,7,9,2,18,0.934065934065934
"661260604","SALTA",42,0,15,17,6,38,0
"661190104","SALTA",63,0,25,24,4,53,0
"661120206","SALTA",68,0,13,22,12,47,0
"661260602","SALTA",70,1,23,11,26,60,0.0142857142857143
"661120203","SALTA",9,0,3,3,0,6,0
"660070618","SALTA",193,1,138,45,6,189,0.00518134715025907
"661260202","SALTA",76,0,3,27,14,44,0
"661190204","SALTA",71,0,6,24,12,42,0
"660630104","SALTA",27,0,1,8,0,9,0
"660630103","SALTA",8,0,0,0,0,0,0
"660560207","SALTA",41,0,4,22,13,39,0
"660560605","SALTA",68,0,1,2,41,44,0
"661260402","SALTA",160,2,12,105,27,144,0.0125
"660560301","SALTA",237,3,28,88,64,180,0.0126582278481013
"660700101","SALTA",17,2,1,11,3,15,0.117647058823529
"660490206","SALTA",44,0,2,26,3,31,0
"660490203","SALTA",10,0,0,2,1,3,0
"660350204","SALTA",15,0,6,0,0,6,0
"660070507","SALTA",10,0,7,3,0,10,0
"661400305","SALTA",12,0,4,5,0,9,0
"661400301","SALTA",33,0,5,19,3,27,0
"661400205","SALTA",58,0,3,21,9,33,0
"660070506","SALTA",45,0,6,9,14,29,0
"661260816","SALTA",327,272,0,0,1,1,0.831804281345566
"661400105","SALTA",34,0,12,9,2,23,0
"661400101","SALTA",21,0,2,15,2,19,0
"661050207","SALTA",3,0,0,1,2,3,0
"300840318","ENTRE RIOS",426,424,1,0,0,1,0.995305164319249
"661330212","SALTA",72,0,0,2,63,65,0
"661330201","SALTA",33,0,10,11,8,29,0
"661050203","SALTA",54,0,0,17,19,36,0
"660070504","SALTA",29,0,1,6,5,12,0
"380140703","JUJUY",57,0,9,48,0,57,0
"661610202","SALTA",97,2,31,22,29,82,0.0206185567010309
"661610201","SALTA",93,0,23,37,9,69,0
"661610106","SALTA",48,0,1,39,4,44,0
"540700403","MISIONES",69,0,11,10,34,55,0
"661120407","SALTA",187,116,15,44,2,61,0.620320855614973
"661050206","SALTA",5,0,0,1,3,4,0
"660980201","SALTA",18,0,2,7,3,12,0
"661050205","SALTA",14,0,12,0,2,14,0
"660980203","SALTA",71,0,20,37,1,58,0
"660840201","SALTA",29,2,8,9,3,20,0.0689655172413793
"660070403","SALTA",23,1,2,18,0,20,0.0434782608695652
"661260815","SALTA",316,306,6,4,0,10,0.968354430379747
"660770304","SALTA",37,0,20,9,1,30,0
"661260814","SALTA",390,321,11,25,11,47,0.823076923076923
"660700407","SALTA",27,0,2,13,12,27,0
"660700303","SALTA",17,0,1,7,5,13,0
"660700301","SALTA",34,0,0,3,19,22,0
"660280301","SALTA",7,0,3,1,0,4,0
"661260720","SALTA",287,238,9,30,3,42,0.829268292682927
"660070314","SALTA",14,0,0,12,0,12,0
"660070307","SALTA",13,0,0,7,1,8,0
"660070612","SALTA",49,0,2,2,11,15,0
"660700507","SALTA",140,0,18,100,16,134,0
"660070406","SALTA",22,0,11,4,4,19,0
"660070310","SALTA",3,0,0,3,0,3,0
"661400404","SALTA",218,190,6,21,0,27,0.871559633027523
"660140102","SALTA",37,0,1,22,10,33,0
"661260717","SALTA",296,282,2,5,2,9,0.952702702702703
"661260601","SALTA",239,29,51,110,13,174,0.121338912133891
"661260613","SALTA",302,268,7,15,0,22,0.887417218543046
"661190102","SALTA",306,0,80,162,25,267,0
"661330224","SALTA",238,0,55,83,77,215,0
"661330223","SALTA",211,0,100,26,52,178,0
"660070601","SALTA",432,1,208,87,69,364,0.00231481481481481
"661260610","SALTA",351,222,4,49,32,85,0.632478632478632
"661260212","SALTA",253,44,7,143,18,168,0.173913043478261
"660070407","SALTA",69,0,14,38,12,64,0
"660560608","SALTA",266,10,10,159,53,222,0.037593984962406
"660560203","SALTA",319,7,30,143,91,264,0.0219435736677116
"661120309","SALTA",223,221,2,0,0,2,0.991031390134529
"661120210","SALTA",144,1,52,62,3,117,0.00694444444444444
"661260702","SALTA",311,92,4,164,30,198,0.295819935691318
"661120405","SALTA",336,281,17,29,5,51,0.836309523809524
"661120404","SALTA",248,236,3,1,0,4,0.951612903225806
"661120301","SALTA",309,194,30,48,3,81,0.627831715210356
"660490205","SALTA",86,74,1,9,0,10,0.86046511627907
"661400412","SALTA",271,237,12,10,5,27,0.874538745387454
"661400408","SALTA",236,228,1,4,0,5,0.966101694915254
"661330312","SALTA",282,0,34,27,84,145,0
"661330309","SALTA",231,0,90,64,57,211,0
"661470312","SALTA",325,1,266,53,1,320,0.00307692307692308
"660490413","SALTA",297,263,5,3,0,8,0.885521885521885
"661050210","SALTA",173,113,5,45,5,55,0.653179190751445
"660840107","SALTA",244,5,164,59,1,224,0.0204918032786885
"660770204","SALTA",252,0,218,16,2,236,0
"660490217","SALTA",326,142,46,122,0,168,0.43558282208589
"660490211","SALTA",223,209,8,5,0,13,0.937219730941704
"660770108","SALTA",240,0,205,27,0,232,0
"660561011","SALTA",300,214,52,28,3,83,0.713333333333333
"660561008","SALTA",236,10,99,79,29,207,0.0423728813559322
"340142212","FORMOSA",376,200,129,34,0,163,0.531914893617021
"660560917","SALTA",448,73,13,156,122,291,0.162946428571429
"660560910","SALTA",216,17,7,112,62,181,0.0787037037037037
"660560801","SALTA",292,66,32,99,82,213,0.226027397260274
"660560714","SALTA",272,195,13,26,4,43,0.716911764705882
"660560712","SALTA",207,188,7,2,1,10,0.908212560386473
"660490409","SALTA",307,203,23,75,2,100,0.661237785016287
"660282612","SALTA",489,350,41,66,4,111,0.715746421267894
"660282515","SALTA",366,366,0,0,0,0,1
"661260819","SALTA",325,269,15,18,1,34,0.827692307692308
"660490105","SALTA",374,2,182,146,7,335,0.0053475935828877
"660350120","SALTA",287,119,50,99,4,153,0.414634146341463
"660350111","SALTA",277,235,27,9,3,39,0.848375451263538
"660282805","SALTA",330,329,0,1,0,1,0.996969696969697
"660281816","SALTA",296,275,4,0,0,4,0.929054054054054
"660282709","SALTA",289,144,70,62,3,135,0.498269896193772
"660282706","SALTA",244,197,16,24,0,40,0.807377049180328
"660282701","SALTA",253,232,10,4,2,16,0.91699604743083
"660282619","SALTA",368,14,62,256,5,323,0.0380434782608696
"660282412","SALTA",428,386,17,18,0,35,0.901869158878505
"660282407","SALTA",212,210,0,0,0,0,0.990566037735849
"660560618","SALTA",427,46,107,192,61,360,0.107728337236534
"660560217","SALTA",190,162,15,11,2,28,0.852631578947368
"660560617","SALTA",294,83,42,124,32,198,0.282312925170068
"660560213","SALTA",397,222,36,100,24,160,0.55919395465995
"660281710","SALTA",211,207,0,3,0,3,0.981042654028436
"660560115","SALTA",222,116,16,35,9,60,0.522522522522523
"660560114","SALTA",276,211,14,16,8,38,0.764492753623188
"660490418","SALTA",277,248,13,9,0,22,0.895306859205776
"661260711","SALTA",212,202,4,5,0,9,0.952830188679245
"661190105","SALTA",78,73,3,1,1,5,0.935897435897436
"660490308","SALTA",231,44,144,40,0,184,0.19047619047619
"660282210","SALTA",332,332,0,0,0,0,1
"660282109","SALTA",238,237,1,0,0,1,0.995798319327731
"660282104","SALTA",367,363,2,0,0,2,0.989100817438692
"660282607","SALTA",463,0,89,304,7,400,0
"660282606","SALTA",319,80,91,137,0,228,0.250783699059561
"660282008","SALTA",318,300,4,11,0,15,0.943396226415094
"660282006","SALTA",207,207,0,0,0,0,1
"660282307","SALTA",354,349,0,2,0,2,0.985875706214689
"660282209","SALTA",310,310,0,0,0,0,1
"661260709","SALTA",455,265,17,144,10,171,0.582417582417582
"660282121","SALTA",398,385,5,2,0,7,0.967336683417085
"660281508","SALTA",268,259,0,3,1,4,0.966417910447761
"660281507","SALTA",358,270,15,49,1,65,0.754189944134078
"660281704","SALTA",238,229,7,0,0,7,0.96218487394958
"660281501","SALTA",227,194,17,11,0,28,0.854625550660793
"660281308","SALTA",220,217,3,0,0,3,0.986363636363636
"660280704","SALTA",289,281,0,4,0,4,0.972318339100346
"660280616","SALTA",348,347,1,0,0,1,0.997126436781609
"660280614","SALTA",223,220,3,0,0,3,0.986547085201794
"660282016","SALTA",318,302,3,2,0,5,0.949685534591195
"660281908","SALTA",279,214,18,32,2,52,0.767025089605735
"660281906","SALTA",323,276,7,26,3,36,0.854489164086687
"660281818","SALTA",261,180,42,22,0,64,0.689655172413793
"660281714","SALTA",436,351,49,21,2,72,0.805045871559633
"660280906","SALTA",405,393,5,1,0,6,0.97037037037037
"660280208","SALTA",277,3,16,94,4,114,0.0108303249097473
"660280119","SALTA",329,0,38,163,11,212,0
"660281618","SALTA",412,366,8,23,0,31,0.888349514563107
"660281609","SALTA",317,286,3,22,0,25,0.902208201892745
"660280610","SALTA",298,295,1,0,0,1,0.98993288590604
"660280606","SALTA",235,230,2,0,0,2,0.978723404255319
"660280715","SALTA",314,277,4,2,0,6,0.882165605095541
"660280515","SALTA",256,256,0,0,0,0,1
"660280510","SALTA",416,395,0,0,0,0,0.949519230769231
"660280408","SALTA",365,90,137,127,0,264,0.246575342465753
"660281112","SALTA",212,212,0,0,0,0,1
"660281009","SALTA",291,290,0,0,0,0,0.996563573883162
"300840319","ENTRE RIOS",116,116,0,0,0,0,1
"660280902","SALTA",436,411,15,8,0,23,0.942660550458716
"660280814","SALTA",193,191,1,0,0,1,0.989637305699482
"660280812","SALTA",230,223,1,0,0,1,0.969565217391304
"660280804","SALTA",284,272,6,2,0,8,0.957746478873239
"660280714","SALTA",315,292,0,1,0,1,0.926984126984127
"660280708","SALTA",368,362,1,0,0,1,0.983695652173913
"660281206","SALTA",150,150,0,0,0,0,1
"660280401","SALTA",285,208,12,64,0,76,0.729824561403509
"660280619","SALTA",318,305,8,3,0,11,0.959119496855346
"140210706","CORDOBA",305,1,219,71,6,296,0.00327868852459016
"660280117","SALTA",367,1,154,150,7,311,0.00272479564032698
"661470507","SALTA",258,242,4,10,0,14,0.937984496124031
"661470313","SALTA",185,1,121,63,0,184,0.00540540540540541
"661400407","SALTA",204,198,2,3,0,5,0.970588235294118
"660280111","SALTA",235,8,168,47,0,215,0.0340425531914894
"660070616","SALTA",183,6,100,45,15,160,0.0327868852459016
"660561002","SALTA",364,2,111,138,87,336,0.00549450549450549
"660560619","SALTA",229,187,13,20,2,35,0.816593886462882
"660070416","SALTA",399,239,102,55,0,157,0.598997493734336
"660280909","SALTA",405,395,6,0,0,6,0.975308641975309
"661330220","SALTA",251,0,52,106,52,210,0
"661120410","SALTA",182,144,2,25,0,27,0.791208791208791
"660280120","SALTA",168,1,108,46,1,155,0.00595238095238095
"660282123","SALTA",254,248,3,0,0,3,0.976377952755906
"660282102","SALTA",225,225,0,0,0,0,1
"660281309","SALTA",159,156,3,0,0,3,0.981132075471698
"660070213","SALTA",210,171,6,23,3,32,0.814285714285714
"660070212","SALTA",265,99,15,93,28,136,0.373584905660377
"661260811","SALTA",231,133,11,32,17,60,0.575757575757576
"661260410","SALTA",460,375,14,53,5,72,0.815217391304348
"661540201","SALTA",61,0,18,19,3,40,0
"661610102","SALTA",213,0,10,119,43,172,0
"661470310","SALTA",7,0,0,2,1,3,0
"661470304","SALTA",9,0,0,5,2,7,0
"661470203","SALTA",20,0,2,1,12,15,0
"661470103","SALTA",34,0,0,5,23,28,0
"661260603","SALTA",222,0,38,49,88,175,0
"661260607","SALTA",24,0,3,8,8,19,0
"661260820","SALTA",152,148,4,0,0,4,0.973684210526316
"661330205","SALTA",28,0,0,9,13,22,0
"661260203","SALTA",199,0,11,121,39,171,0
"661120204","SALTA",39,0,4,22,8,34,0
"661260818","SALTA",521,149,31,190,62,283,0.285988483685221
"141611021","CORDOBA",245,235,6,3,0,9,0.959183673469388
"661120107","SALTA",65,0,15,35,2,52,0
"660700104","SALTA",12,0,1,0,11,12,0
"660490103","SALTA",143,2,19,82,6,107,0.013986013986014
"661260401","SALTA",224,2,38,102,7,147,0.00892857142857143
"660560601","SALTA",26,0,8,8,4,20,0
"660560404","SALTA",6,0,0,2,2,4,0
"661610108","SALTA",52,0,5,44,1,50,0
"820842503","SANTA FE",191,191,0,0,0,0,1
"660490210","SALTA",13,0,3,5,0,8,0
"660490207","SALTA",18,0,13,4,0,17,0
"660910203","SALTA",16,0,0,7,7,14,0
"661400309","SALTA",17,0,2,4,2,8,0
"661400203","SALTA",41,0,8,7,18,33,0
"661400202","SALTA",19,0,4,11,1,16,0
"661400201","SALTA",16,0,1,11,4,16,0
"660910102","SALTA",33,0,0,30,0,30,0
"661330203","SALTA",101,0,0,36,8,44,0
"660350108","SALTA",173,12,85,62,3,150,0.069364161849711
"660070204","SALTA",94,0,10,32,32,74,0
"661260810","SALTA",206,151,5,22,22,49,0.733009708737864
"660910101","SALTA",15,0,0,12,0,12,0
"300980310","ENTRE RIOS",194,193,1,0,0,1,0.994845360824742
"661470513","SALTA",274,243,18,10,1,29,0.886861313868613
"660840202","SALTA",35,0,18,8,0,26,0
"660840105","SALTA",16,0,7,4,4,15,0
"660070508","SALTA",65,0,4,13,48,65,0
"661260804","SALTA",182,168,3,9,1,13,0.923076923076923
"661260802","SALTA",278,267,3,4,1,8,0.960431654676259
"661610302","SALTA",112,15,6,41,11,58,0.133928571428571
"660840103","SALTA",12,0,3,1,3,7,0
"660700204","SALTA",109,3,11,60,19,90,0.0275229357798165
"660700107","SALTA",61,0,17,15,28,60,0
"660700103","SALTA",19,0,1,2,13,16,0
"661400107","SALTA",42,20,5,14,0,19,0.476190476190476
"660630203","SALTA",34,0,3,4,0,7,0
"660280302","SALTA",30,0,2,5,4,11,0
"660280203","SALTA",25,0,6,7,4,17,0
"660070202","SALTA",67,3,5,14,9,28,0.0447761194029851
"660070309","SALTA",13,0,0,3,0,3,0
"660280103","SALTA",43,0,6,15,0,21,0
"660140103","SALTA",110,1,4,67,3,74,0.00909090909090909
"660140101","SALTA",129,0,43,77,1,121,0
"660980106","SALTA",440,173,126,122,6,254,0.393181818181818
"660560303","SALTA",132,0,1,27,33,61,0
"661400108","SALTA",102,1,7,68,6,81,0.00980392156862745
"661260619","SALTA",358,232,17,57,16,90,0.64804469273743
"661330304","SALTA",220,0,5,40,87,132,0
"661260502","SALTA",266,36,17,126,26,169,0.135338345864662
"340140407","FORMOSA",222,212,8,0,1,9,0.954954954954955
"660280102","SALTA",64,0,50,5,0,55,0
"660070303","SALTA",158,115,7,8,6,21,0.727848101265823
"660700201","SALTA",68,2,9,28,17,54,0.0294117647058824
"661260414","SALTA",266,125,15,58,22,95,0.469924812030075
"661260411","SALTA",331,238,10,57,15,82,0.719033232628399
"661260409","SALTA",180,17,33,84,19,136,0.0944444444444444
"660280121","SALTA",132,73,21,10,1,32,0.553030303030303
"660420104","SALTA",442,3,205,192,7,404,0.00678733031674208
"661260612","SALTA",238,168,8,38,9,55,0.705882352941177
"660350102","SALTA",202,76,37,68,8,113,0.376237623762376
"660070205","SALTA",209,79,11,44,28,83,0.37799043062201
"660070414","SALTA",104,1,40,42,4,86,0.00961538461538462
"661470503","SALTA",219,204,3,3,0,6,0.931506849315068
"661470511","SALTA",354,133,61,149,2,212,0.375706214689266
"661400118","SALTA",232,216,0,0,0,0,0.931034482758621
"661400409","SALTA",354,190,32,107,9,148,0.536723163841808
"661260304","SALTA",193,102,5,46,29,80,0.528497409326425
"661120305","SALTA",280,148,18,52,39,109,0.528571428571429
"661120303","SALTA",204,149,24,26,1,51,0.730392156862745
"661120401","SALTA",355,254,15,65,7,87,0.715492957746479
"661120214","SALTA",404,349,16,10,2,28,0.863861386138614
"661120409","SALTA",424,386,6,17,1,24,0.910377358490566
"660561007","SALTA",237,236,0,1,0,1,0.9957805907173
"660561004","SALTA",260,14,165,76,4,245,0.0538461538461538
"660561001","SALTA",234,182,15,9,5,29,0.777777777777778
"660560922","SALTA",274,229,11,14,0,25,0.835766423357664
"660560914","SALTA",252,237,4,8,0,12,0.94047619047619
"660560810","SALTA",234,219,8,7,0,15,0.935897435897436
"660560805","SALTA",215,211,1,0,1,2,0.981395348837209
"660560711","SALTA",287,257,2,14,3,19,0.895470383275261
"660560710","SALTA",398,297,24,61,3,88,0.746231155778894
"660560705","SALTA",275,205,7,45,3,55,0.745454545454545
"660560802","SALTA",301,36,63,166,25,254,0.119601328903654
"660490212","SALTA",214,188,6,18,0,24,0.878504672897196
"661260620","SALTA",353,326,5,4,15,24,0.923512747875354
"660490410","SALTA",445,123,92,197,3,292,0.276404494382022
"660490408","SALTA",271,241,14,13,1,28,0.88929889298893
"660560405","SALTA",290,153,36,49,43,128,0.527586206896552
"660490106","SALTA",287,3,226,48,1,275,0.0104529616724739
"660420205","SALTA",451,103,200,125,5,330,0.228381374722838
"660350210","SALTA",345,2,218,90,1,309,0.00579710144927536
"660350209","SALTA",296,27,186,67,4,257,0.0912162162162162
"660350119","SALTA",174,89,11,38,10,59,0.511494252873563
"660350118","SALTA",222,103,16,71,2,89,0.463963963963964
"660560615","SALTA",347,62,27,174,65,266,0.178674351585014
"660350115","SALTA",212,157,31,19,3,53,0.740566037735849
"300980311","ENTRE RIOS",56,56,0,0,0,0,1
"660282617","SALTA",449,368,22,41,1,64,0.819599109131403
"660282511","SALTA",384,372,5,2,0,7,0.96875
"660282509","SALTA",257,233,6,16,2,24,0.906614785992218
"660282505","SALTA",162,3,131,28,0,159,0.0185185185185185
"660282411","SALTA",376,312,14,41,1,56,0.829787234042553
"660282405","SALTA",339,319,10,5,0,15,0.941002949852507
"660560621","SALTA",290,85,29,101,39,169,0.293103448275862
"660280509","SALTA",300,296,0,0,0,0,0.986666666666667
"300980312","ENTRE RIOS",183,183,0,0,0,0,1
"660560120","SALTA",168,53,31,36,28,95,0.31547619047619
"660490421","SALTA",212,130,37,27,2,66,0.613207547169811
"660282119","SALTA",355,354,0,0,0,0,0.997183098591549
"660282114","SALTA",237,232,3,0,0,3,0.978902953586498
"660282106","SALTA",414,414,0,0,0,0,1
"660282603","SALTA",328,327,1,0,0,1,0.996951219512195
"660282012","SALTA",333,264,11,33,1,45,0.792792792792793
"661260618","SALTA",232,220,0,1,0,1,0.948275862068966
"660281513","SALTA",276,166,36,64,0,100,0.601449275362319
"660282011","SALTA",361,342,7,5,0,12,0.947368421052632
"660281912","SALTA",220,214,5,0,0,5,0.972727272727273
"660282310","SALTA",344,344,0,0,0,0,1
"660282308","SALTA",354,184,34,100,1,135,0.519774011299435
"660282305","SALTA",380,356,3,4,0,7,0.936842105263158
"660282205","SALTA",252,252,0,0,0,0,1
"660282201","SALTA",337,335,2,0,0,2,0.99406528189911
"660281521","SALTA",237,234,0,0,0,0,0.987341772151899
"660281509","SALTA",276,268,1,6,0,7,0.971014492753623
"660281522","SALTA",344,339,1,0,0,1,0.98546511627907
"660281211","SALTA",325,314,2,0,0,2,0.966153846153846
"660280621","SALTA",435,414,6,3,0,9,0.951724137931034
"660280613","SALTA",226,226,0,0,0,0,1
"660281901","SALTA",364,159,90,72,0,162,0.436813186813187
"660281812","SALTA",286,283,0,0,0,0,0.989510489510489
"660281808","SALTA",249,239,2,0,0,2,0.959839357429719
"660281804","SALTA",225,222,1,0,0,1,0.986666666666667
"660281614","SALTA",325,325,0,0,0,0,1
"660280611","SALTA",382,380,0,0,0,0,0.994764397905759
"660280608","SALTA",294,290,2,0,0,2,0.986394557823129
"660280607","SALTA",262,257,4,1,0,5,0.980916030534351
"660280605","SALTA",357,354,2,0,0,2,0.991596638655462
"660280511","SALTA",252,249,3,0,0,3,0.988095238095238
"660280503","SALTA",241,203,26,10,0,36,0.842323651452282
"660280423","SALTA",460,443,0,1,0,1,0.96304347826087
"660280407","SALTA",323,43,107,154,0,261,0.13312693498452
"660280404","SALTA",415,1,84,302,1,387,0.00240963855421687
"660281209","SALTA",174,174,0,0,0,0,1
"660281203","SALTA",204,203,1,0,0,1,0.995098039215686
"660281202","SALTA",225,223,0,1,0,1,0.991111111111111
"660281111","SALTA",193,192,1,0,0,1,0.994818652849741
"660281106","SALTA",225,225,0,0,0,0,1
"660281006","SALTA",390,347,11,0,0,11,0.88974358974359
"660280905","SALTA",443,427,10,2,0,12,0.963882618510158
"660280808","SALTA",253,240,8,4,0,12,0.948616600790514
"660280712","SALTA",209,205,0,1,0,1,0.980861244019139
"660280706","SALTA",250,249,1,0,0,1,0.996
"660281310","SALTA",201,195,6,0,0,6,0.970149253731343
"661470509","SALTA",285,250,16,14,0,30,0.87719298245614
"661470506","SALTA",245,178,17,38,1,56,0.726530612244898
"661470311","SALTA",316,0,200,107,0,307,0
"661400406","SALTA",211,196,3,7,1,11,0.928909952606635
"660140206","SALTA",295,225,30,33,2,65,0.76271186440678
"660560111","SALTA",223,170,26,17,1,44,0.762331838565022
"660490104","SALTA",391,7,229,141,2,372,0.0179028132992327
"660282809","SALTA",505,487,3,0,0,3,0.964356435643564
"660281303","SALTA",260,259,1,0,0,1,0.996153846153846
"660280109","SALTA",222,1,155,50,2,207,0.0045045045045045
"661330108","SALTA",429,0,137,186,69,392,0
"661260104","SALTA",193,118,7,48,4,59,0.61139896373057
"660210108","SALTA",289,281,1,2,0,3,0.972318339100346
"660070107","SALTA",203,4,74,67,25,166,0.0197044334975369
"660281815","SALTA",249,247,2,0,0,2,0.991967871485944
"660281523","SALTA",274,271,0,1,0,1,0.989051094890511
"660070211","SALTA",248,175,19,38,12,69,0.705645161290323
"660070422","SALTA",246,208,14,19,0,33,0.845528455284553
"661540211","SALTA",228,164,15,24,4,43,0.719298245614035
"661470406","SALTA",5,0,0,0,0,0,0
"661470403","SALTA",97,0,21,67,5,93,0
"661470401","SALTA",301,1,158,110,3,271,0.00332225913621262
"661470305","SALTA",32,0,1,23,0,24,0
"661470202","SALTA",48,0,10,21,13,44,0
"661330102","SALTA",447,0,5,58,88,151,0
"661260405","SALTA",23,2,8,6,1,15,0.0869565217391304
"661120208","SALTA",159,0,22,82,14,118,0
"660560201","SALTA",57,0,3,19,14,36,0
"661470512","SALTA",173,151,9,1,1,11,0.872832369942196
"660561005","SALTA",277,11,151,106,4,261,0.0397111913357401
"660490301","SALTA",184,1,44,128,3,175,0.00543478260869565
"660490209","SALTA",27,0,2,18,0,20,0
"661400306","SALTA",10,0,2,2,3,7,0
"661260721","SALTA",302,253,0,0,0,0,0.837748344370861
"661260511","SALTA",296,206,25,8,15,48,0.695945945945946
"661260413","SALTA",292,146,10,98,19,127,0.5
"661400114","SALTA",53,0,14,33,2,49,0
"661400111","SALTA",36,1,16,9,0,25,0.0277777777777778
"660630201","SALTA",35,0,6,0,11,17,0
"661400416","SALTA",187,122,13,17,5,35,0.6524064171123
"661400307","SALTA",27,0,7,10,5,22,0
"661260208","SALTA",289,289,0,0,0,0,1
"661260217","SALTA",469,78,92,214,8,314,0.166311300639659
"661400106","SALTA",27,0,1,15,0,16,0
"661120307","SALTA",181,174,3,2,0,5,0.961325966850829
"661260625","SALTA",176,16,34,100,11,145,0.0909090909090909
"300701402","ENTRE RIOS",18,0,9,6,0,15,0
"660770202","SALTA",15,0,2,2,1,5,0
"660700202","SALTA",24,0,2,4,15,21,0
"661260824","SALTA",415,328,11,41,8,60,0.790361445783132
"661330306","SALTA",235,0,14,42,66,122,0
"660910202","SALTA",26,0,1,13,1,15,0
"661330213","SALTA",40,0,0,1,14,15,0
"660980204","SALTA",22,0,3,7,4,14,0
"660070402","SALTA",25,0,5,10,2,17,0
"661050204","SALTA",18,0,0,8,3,11,0
"660980103","SALTA",57,1,34,17,0,51,0.0175438596491228
"661050102","SALTA",0,0,0,0,0,0,NA
"661120313","SALTA",267,210,13,17,2,32,0.786516853932584
"180210117","CORRIENTES",405,405,0,0,0,0,1
"660070405","SALTA",100,0,59,17,6,82,0
"660070203","SALTA",11,0,2,5,0,7,0
"660770104","SALTA",173,0,135,24,6,165,0
"660070312","SALTA",6,0,0,2,2,4,0
"661330202","SALTA",28,0,0,0,25,25,0
"660280101","SALTA",136,49,73,12,0,85,0.360294117647059
"660210105","SALTA",19,0,6,6,0,12,0
"660210101","SALTA",85,0,7,23,5,35,0
"660980206","SALTA",4,0,0,0,0,0,0
"660070609","SALTA",50,0,15,10,10,35,0
"660070305","SALTA",28,0,6,16,1,23,0
"661260713","SALTA",320,184,6,107,19,132,0.575
"660070505","SALTA",53,0,3,8,37,48,0
"661190103","SALTA",162,0,71,53,11,135,0
"660210106","SALTA",89,1,52,12,5,69,0.0112359550561798
"661260821","SALTA",362,304,24,27,3,54,0.839779005524862
"661260817","SALTA",358,298,23,15,0,38,0.832402234636871
"661260813","SALTA",358,215,29,53,5,87,0.600558659217877
"661260807","SALTA",193,144,5,5,0,10,0.746113989637306
"661260715","SALTA",199,194,3,1,0,4,0.974874371859296
"660560604","SALTA",56,0,5,2,32,39,0
"660070411","SALTA",17,0,1,10,3,14,0
"141611020","CORDOBA",253,234,8,8,1,17,0.924901185770751
"661120105","SALTA",253,97,33,100,6,139,0.383399209486166
"661470515","SALTA",237,173,12,37,4,53,0.729957805907173
"661400410","SALTA",343,268,28,39,0,67,0.78134110787172
"660561003","SALTA",309,4,136,108,28,272,0.0129449838187702
"660140203","SALTA",210,59,39,87,10,136,0.280952380952381
"661400119","SALTA",298,286,4,3,0,7,0.959731543624161
"661120312","SALTA",346,141,21,149,2,172,0.407514450867052
"660560304","SALTA",171,6,10,22,49,81,0.0350877192982456
"660980102","SALTA",86,0,8,43,1,52,0
"660700203","SALTA",122,34,8,52,11,71,0.278688524590164
"660560204","SALTA",289,7,23,141,79,243,0.0242214532871972
"141401716","CORDOBA",210,5,197,7,0,204,0.0238095238095238
"661330311","SALTA",256,0,103,73,45,221,0
"660560923","SALTA",290,249,1,31,4,36,0.858620689655172
"660560920","SALTA",308,274,6,12,1,19,0.88961038961039
"660630111","SALTA",223,205,3,5,1,9,0.919282511210762
"660560908","SALTA",344,102,59,80,68,207,0.296511627906977
"660560815","SALTA",324,1,43,177,83,303,0.00308641975308642
"660560707","SALTA",46,1,6,22,12,40,0.0217391304347826
"660490216","SALTA",187,0,54,120,1,175,0
"660490407","SALTA",215,54,78,69,1,148,0.251162790697674
"660350211","SALTA",270,0,223,39,1,263,0
"660280612","SALTA",240,239,1,0,0,1,0.995833333333333
"660350121","SALTA",189,105,24,54,0,78,0.555555555555556
"660282812","SALTA",296,285,2,0,0,2,0.962837837837838
"660282804","SALTA",248,246,0,0,0,0,0.991935483870968
"660282712","SALTA",321,297,4,4,0,8,0.925233644859813
"660282708","SALTA",259,167,28,54,1,83,0.644787644787645
"660282618","SALTA",342,3,77,169,18,264,0.0087719298245614
"660282616","SALTA",316,223,30,55,0,85,0.705696202531646
"660560113","SALTA",148,4,22,100,4,126,0.027027027027027
"660560106","SALTA",387,206,18,108,37,163,0.532299741602067
"660281810","SALTA",263,262,1,0,0,1,0.996197718631179
"660490420","SALTA",194,168,9,12,0,21,0.865979381443299
"660490417","SALTA",248,243,3,2,0,5,0.979838709677419
"660490416","SALTA",293,232,20,33,0,53,0.791808873720137
"660282108","SALTA",216,206,8,0,0,8,0.953703703703704
"660282610","SALTA",463,342,28,78,2,108,0.73866090712743
"660282013","SALTA",230,192,10,11,0,21,0.834782608695652
"660282005","SALTA",220,213,7,0,0,7,0.968181818181818
"660281914","SALTA",300,61,70,137,1,208,0.203333333333333
"660281606","SALTA",375,369,2,1,0,3,0.984
"660281514","SALTA",291,290,0,0,0,0,0.996563573883162
"660281505","SALTA",349,182,34,81,0,115,0.521489971346705
"660281709","SALTA",337,334,2,1,0,3,0.991097922848665
"660282401","SALTA",112,83,11,8,0,19,0.741071428571429
"660282315","SALTA",363,359,3,0,0,3,0.988980716253444
"660282313","SALTA",340,338,2,0,0,2,0.994117647058824
"660282301","SALTA",335,314,9,8,0,17,0.937313432835821
"660282208","SALTA",294,294,0,0,0,0,1
"660282122","SALTA",340,338,1,0,0,1,0.994117647058824
"661050209","SALTA",239,66,5,111,20,136,0.276150627615063
"660281602","SALTA",569,506,25,28,0,53,0.889279437609842
"660281520","SALTA",273,267,2,1,2,5,0.978021978021978
"660281706","SALTA",221,217,1,0,0,1,0.981900452488688
"660280517","SALTA",354,353,0,0,0,0,0.997175141242938
"660280506","SALTA",302,289,4,6,1,11,0.956953642384106
"660280413","SALTA",444,435,3,0,0,3,0.97972972972973
"660280412","SALTA",432,422,7,0,0,7,0.976851851851852
"660281201","SALTA",272,272,0,0,0,0,1
"660281011","SALTA",168,160,0,0,0,0,0.952380952380952
"660281004","SALTA",327,318,4,1,0,5,0.972477064220184
"660280914","SALTA",299,293,4,0,0,4,0.979933110367893
"660280810","SALTA",273,263,2,0,0,2,0.963369963369963
"661120310","SALTA",346,297,14,20,5,39,0.858381502890173
"660280805","SALTA",261,249,6,1,0,7,0.954022988505747
"660280707","SALTA",411,390,3,2,1,6,0.948905109489051
"141401412","CORDOBA",315,312,2,0,0,2,0.990476190476191
"660280115","SALTA",190,113,73,4,0,77,0.594736842105263
"660070614","SALTA",313,1,122,66,91,279,0.00319488817891374
"660560703","SALTA",291,168,9,63,43,115,0.577319587628866
"660560613","SALTA",296,1,12,127,60,199,0.00337837837837838
"661260510","SALTA",283,264,11,4,2,17,0.932862190812721
"660210114","SALTA",326,304,2,2,0,4,0.932515337423313
"660210109","SALTA",283,280,1,0,0,1,0.989399293286219
"660210107","SALTA",252,177,27,40,0,67,0.702380952380952
"380630610","JUJUY",97,7,12,64,0,76,0.0721649484536082
"660210113","SALTA",267,233,8,11,0,19,0.872659176029963
"660070421","SALTA",195,157,14,16,0,30,0.805128205128205
"380211306","JUJUY",237,212,13,10,0,23,0.894514767932489
"660282408","SALTA",387,371,3,11,0,14,0.958656330749354
"660281701","SALTA",266,266,0,0,0,0,1
"660070209","SALTA",196,168,8,12,0,20,0.857142857142857
"661540105","SALTA",163,1,1,39,82,122,0.00613496932515337
"660282707","SALTA",237,101,53,61,1,115,0.426160337552743
"660281503","SALTA",407,396,5,0,0,5,0.972972972972973
"661540101","SALTA",35,0,5,13,11,29,0
"661470205","SALTA",38,0,10,21,6,37,0
"661330104","SALTA",116,0,0,22,14,36,0
"661260501","SALTA",14,0,2,2,0,4,0
"661400103","SALTA",43,0,18,22,0,40,0
"661260201","SALTA",79,1,3,54,4,61,0.0126582278481013
"380700107","JUJUY",119,7,46,50,9,105,0.0588235294117647
"661190101","SALTA",54,0,10,34,1,45,0
"661120209","SALTA",205,0,19,60,50,129,0
"661330107","SALTA",385,0,38,188,59,285,0
"660490208","SALTA",33,0,4,20,1,25,0
"661400112","SALTA",36,0,3,11,5,19,0
"380630203","JUJUY",156,95,15,36,3,54,0.608974358974359
"661260206","SALTA",402,80,17,206,46,269,0.199004975124378
"661190205","SALTA",261,162,36,40,5,81,0.620689655172414
"660490202","SALTA",25,0,2,15,3,20,0
"660420201","SALTA",125,1,36,64,8,108,0.008
"660350205","SALTA",45,0,2,11,2,15,0
"660070603","SALTA",20,0,1,9,1,11,0
"661400110","SALTA",72,0,7,30,12,49,0
"661400109","SALTA",6,0,1,2,0,3,0
"660070602","SALTA",13,0,5,1,4,10,0
"660070509","SALTA",21,0,0,5,10,15,0
"141401410","CORDOBA",178,147,20,7,0,27,0.825842696629214
"661400204","SALTA",45,0,1,16,21,38,0
"661610303","SALTA",41,0,2,8,28,38,0
"660070409","SALTA",51,2,25,8,15,48,0.0392156862745098
"661330215","SALTA",28,0,1,5,17,23,0
"661330206","SALTA",38,0,0,0,22,22,0
"661330105","SALTA",64,0,0,33,1,34,0
"141401409","CORDOBA",179,164,13,1,0,14,0.916201117318436
"661330214","SALTA",163,0,4,14,121,139,0
"661330207","SALTA",26,0,1,5,17,23,0
"660350207","SALTA",91,0,14,38,11,63,0
"661260508","SALTA",315,273,5,4,1,10,0.866666666666667
"141401408","CORDOBA",150,145,1,4,0,5,0.966666666666667
"660350104","SALTA",17,0,2,12,0,14,0
"660350101","SALTA",63,1,9,38,3,50,0.0158730158730159
"661050201","SALTA",36,0,9,14,4,27,0
"661610304","SALTA",182,45,30,64,22,116,0.247252747252747
"661120101","SALTA",65,0,22,22,5,49,0
"661260507","SALTA",359,340,0,0,0,0,0.947075208913649
"661050101","SALTA",0,0,0,0,0,0,NA
"660910103","SALTA",32,0,4,19,5,28,0
"660700505","SALTA",3,0,0,0,0,0,0
"661260417","SALTA",146,146,0,0,0,0,1
"660700503","SALTA",12,0,2,7,1,10,0
"660700405","SALTA",7,0,0,0,3,3,0
"660700106","SALTA",21,0,3,17,0,20,0
"660630108","SALTA",70,0,53,11,0,64,0
"660630105","SALTA",20,0,1,4,2,7,0
"660280303","SALTA",15,0,0,2,0,2,0
"660070302","SALTA",22,0,9,2,2,13,0
"660140204","SALTA",83,0,35,27,4,66,0
"660282803","SALTA",238,238,0,0,0,0,1
"660280304","SALTA",25,0,2,11,0,13,0
"660070608","SALTA",38,0,2,8,8,18,0
"660281502","SALTA",390,270,54,48,3,105,0.692307692307692
"661120106","SALTA",105,0,38,49,11,98,0
"660282705","SALTA",298,243,17,36,1,54,0.815436241610738
"660560602","SALTA",79,1,8,18,39,65,0.0126582278481013
"661120306","SALTA",283,193,18,59,0,77,0.681978798586572
"660210104","SALTA",263,135,36,33,3,72,0.513307984790874
"660140202","SALTA",621,39,193,265,23,481,0.0628019323671498
"660070408","SALTA",276,124,71,64,6,141,0.449275362318841
"660560302","SALTA",233,1,26,91,58,175,0.00429184549356223
"661470316","SALTA",336,7,295,32,1,328,0.0208333333333333
"661400310","SALTA",132,22,18,65,8,91,0.166666666666667
"660281407","SALTA",396,391,5,0,0,5,0.987373737373737
"661400120","SALTA",291,287,0,1,0,1,0.986254295532646
"661330221","SALTA",273,0,145,31,73,249,0
"661260808","SALTA",210,152,13,20,18,51,0.723809523809524
"661260704","SALTA",272,261,4,4,0,8,0.959558823529412
"661260622","SALTA",196,54,17,98,13,128,0.275510204081633
"661120402","SALTA",179,154,13,8,0,21,0.860335195530726
"660490302","SALTA",228,0,105,88,10,203,0
"660350206","SALTA",246,1,202,35,3,240,0.0040650406504065
"660350201","SALTA",333,0,117,162,25,304,0
"660070420","SALTA",299,209,63,19,0,82,0.698996655518395
"661470501","SALTA",221,106,31,75,6,112,0.479638009049774
"661260822","SALTA",358,290,28,26,2,56,0.810055865921788
"661260809","SALTA",419,276,27,75,9,111,0.658711217183771
"661470317","SALTA",335,1,149,148,6,303,0.00298507462686567
"661260716","SALTA",191,177,10,2,0,12,0.926701570680628
"661260303","SALTA",285,158,10,30,22,62,0.554385964912281
"661260302","SALTA",170,88,14,32,12,58,0.517647058823529
"661260216","SALTA",285,62,4,116,36,156,0.217543859649123
"661260214","SALTA",282,8,10,165,55,230,0.0283687943262411
"661260207","SALTA",236,235,0,0,0,0,0.995762711864407
"660770109","SALTA",183,0,140,36,0,176,0
"660770106","SALTA",196,0,152,40,0,192,0
"180351912","CORRIENTES",269,249,5,13,2,20,0.925650557620818
"660561006","SALTA",246,19,142,73,3,218,0.0772357723577236
"660560924","SALTA",284,216,1,24,25,50,0.76056338028169
"660560921","SALTA",213,195,3,9,4,16,0.915492957746479
"660560913","SALTA",324,244,10,21,27,58,0.753086419753086
"660560912","SALTA",265,241,1,10,1,12,0.909433962264151
"660770105","SALTA",215,0,182,28,1,211,0
"660980209","SALTA",227,0,179,38,3,220,0
"660282703","SALTA",335,176,85,57,1,143,0.525373134328358
"660560902","SALTA",259,238,9,8,1,18,0.918918918918919
"660560901","SALTA",57,55,2,0,0,2,0.964912280701754
"660560814","SALTA",303,8,31,185,70,286,0.0264026402640264
"660560804","SALTA",265,187,24,48,0,72,0.705660377358491
"660560709","SALTA",248,187,11,36,8,55,0.754032258064516
"660560702","SALTA",290,100,25,88,64,177,0.344827586206897
"660490307","SALTA",218,15,182,21,0,203,0.0688073394495413
"660490213","SALTA",343,287,25,20,0,45,0.836734693877551
"660490406","SALTA",216,157,27,28,0,55,0.726851851851852
"660281304","SALTA",173,172,1,0,0,1,0.994219653179191
"660420110","SALTA",204,115,39,40,3,82,0.563725490196078
"660350124","SALTA",347,330,0,0,0,0,0.951008645533141
"660282715","SALTA",348,183,56,84,0,140,0.525862068965517
"660282711","SALTA",309,229,25,32,1,58,0.741100323624595
"181120204","CORRIENTES",32,0,18,10,2,30,0
"660282807","SALTA",332,276,29,21,0,50,0.831325301204819
"660281302","SALTA",132,131,1,0,0,1,0.992424242424242
"660281301","SALTA",239,219,0,0,0,0,0.916317991631799
"661050212","SALTA",153,92,5,27,18,50,0.601307189542484
"660350123","SALTA",343,343,0,0,0,0,1
"660282815","SALTA",228,221,1,3,0,4,0.969298245614035
"660282813","SALTA",443,398,18,25,0,43,0.898419864559819
"660282808","SALTA",298,296,0,0,0,0,0.993288590604027
"660282702","SALTA",254,41,69,100,7,176,0.161417322834646
"660282615","SALTA",333,230,17,71,0,88,0.690690690690691
"660282601","SALTA",300,157,57,55,1,113,0.523333333333333
"660560505","SALTA",233,3,66,28,40,134,0.0128755364806867
"660560406","SALTA",63,54,2,4,2,8,0.857142857142857
"660560210","SALTA",320,192,47,63,6,116,0.6
"660560109","SALTA",259,190,20,24,3,47,0.733590733590734
"660560107","SALTA",240,160,23,41,4,68,0.666666666666667
"660490404","SALTA",320,193,82,38,0,120,0.603125
"660282403","SALTA",301,281,7,2,0,9,0.933554817275748
"660282402","SALTA",201,200,0,1,0,1,0.995024875621891
"660282609","SALTA",458,227,58,132,2,192,0.495633187772926
"660282018","SALTA",467,359,23,60,5,88,0.768736616702355
"660281913","SALTA",338,329,0,0,0,0,0.973372781065089
"660282304","SALTA",346,320,16,2,0,18,0.92485549132948
"660282213","SALTA",332,331,0,0,0,0,0.996987951807229
"660282124","SALTA",253,248,1,0,0,1,0.980237154150198
"660281603","SALTA",233,229,0,0,0,0,0.982832618025751
"141401407","CORDOBA",233,227,4,2,0,6,0.974248927038627
"660281512","SALTA",377,284,29,43,3,75,0.753315649867374
"660281511","SALTA",386,314,32,20,0,52,0.813471502590674
"660281213","SALTA",480,418,22,25,1,48,0.870833333333333
"660281904","SALTA",266,226,12,8,0,20,0.849624060150376
"660281903","SALTA",253,209,21,8,0,29,0.826086956521739
"660281802","SALTA",434,426,3,0,0,3,0.981566820276498
"660281705","SALTA",280,250,25,0,0,25,0.892857142857143
"660281616","SALTA",332,292,6,19,0,25,0.879518072289157
"660280603","SALTA",374,369,1,0,0,1,0.986631016042781
"660280520","SALTA",214,214,0,0,0,0,1
"660280512","SALTA",249,248,0,1,0,1,0.995983935742972
"660280504","SALTA",233,187,15,23,0,38,0.802575107296137
"660280422","SALTA",416,404,0,0,0,0,0.971153846153846
"660281212","SALTA",462,385,38,27,1,66,0.833333333333333
"660281402","SALTA",363,360,3,0,0,3,0.991735537190083
"660280622","SALTA",435,432,3,0,0,3,0.993103448275862
"660281910","SALTA",427,113,61,211,1,273,0.26463700234192
"660280418","SALTA",293,218,23,42,1,66,0.744027303754266
"660280417","SALTA",498,123,232,135,1,368,0.246987951807229
"660281109","SALTA",185,184,1,0,0,1,0.994594594594595
"660281101","SALTA",264,241,21,2,0,23,0.912878787878788
"660280915","SALTA",200,199,0,0,0,0,0.995
"660280911","SALTA",194,189,3,0,0,3,0.974226804123711
"660280806","SALTA",284,278,2,0,0,2,0.97887323943662
"660280717","SALTA",317,305,4,3,0,7,0.962145110410095
"660280114","SALTA",247,233,8,2,0,10,0.94331983805668
"660980207","SALTA",28,0,3,22,1,26,0
"660700205","SALTA",277,153,41,70,9,120,0.552346570397112
"660070617","SALTA",253,2,151,85,9,245,0.00790513833992095
"660561015","SALTA",198,101,88,8,0,96,0.51010101010101
"660210116","SALTA",317,296,8,1,0,9,0.933753943217666
"660560504","SALTA",234,3,60,70,70,200,0.0128205128205128
"660070427","SALTA",263,1,45,94,86,225,0.00380228136882129
"660070417","SALTA",326,109,106,91,9,206,0.334355828220859
"220211501","CHACO",214,197,13,1,0,14,0.920560747663551
"660280110","SALTA",265,5,163,84,2,249,0.0188679245283019
"660280106","SALTA",274,274,0,0,0,0,1
"661260509","SALTA",378,336,13,24,0,37,0.888888888888889
"660210111","SALTA",229,227,1,1,0,2,0.991266375545852
"661120108","SALTA",82,0,56,20,1,77,0
"660282409","SALTA",346,276,6,41,0,47,0.797687861271676
"660070318","SALTA",364,286,29,28,5,62,0.785714285714286
"660070316","SALTA",309,225,18,25,6,49,0.728155339805825
"660070423","SALTA",269,173,60,31,1,92,0.643122676579926
"661540206","SALTA",39,0,7,30,0,37,0
"380210802","JUJUY",317,283,2,0,0,2,0.892744479495268
"661470309","SALTA",13,0,2,2,5,9,0
"661470308","SALTA",7,0,0,1,0,1,0
"661470201","SALTA",31,0,0,6,16,22,0
"380630515","JUJUY",315,237,30,43,0,73,0.752380952380952
"661470306","SALTA",134,0,59,59,0,118,0
"661470204","SALTA",12,0,1,1,8,10,0
"660070502","SALTA",18,0,0,1,0,1,0
"380211208","JUJUY",209,208,1,0,0,1,0.995215311004785
"661470105","SALTA",41,0,3,24,7,34,0
"661330103","SALTA",131,0,1,31,33,65,0
"661260608","SALTA",8,0,0,0,1,1,0
"661260605","SALTA",67,1,11,23,7,41,0.0149253731343284
"661260407","SALTA",36,0,10,15,3,28,0
"661260404","SALTA",51,7,9,32,0,41,0.137254901960784
"380070107","JUJUY",259,170,23,31,10,64,0.656370656370656
"660910201","SALTA",19,0,1,8,8,17,0
"380350606","JUJUY",361,328,2,0,0,2,0.908587257617729
"661260301","SALTA",59,1,5,26,17,48,0.0169491525423729
"380490105","JUJUY",50,0,0,19,21,40,0
"661260103","SALTA",153,1,4,54,9,67,0.0065359477124183
"660630102","SALTA",7,0,1,5,0,6,0
"380211212","JUJUY",279,222,33,15,2,50,0.795698924731183
"661260102","SALTA",397,1,36,234,37,307,0.00251889168765743
"661120205","SALTA",85,0,10,29,31,70,0
"660560206","SALTA",52,0,5,17,26,48,0
"660560101","SALTA",32,0,0,2,9,11,0
"660490102","SALTA",58,0,10,40,0,50,0
"660980202","SALTA",2,0,0,1,0,1,0
"380350217","JUJUY",272,5,144,76,30,250,0.0183823529411765
"380070405","JUJUY",42,0,12,7,23,42,0
"660420106","SALTA",190,2,45,116,15,176,0.0105263157894737
"661470101","SALTA",28,0,0,2,19,21,0
"661610305","SALTA",52,0,4,33,11,48,0
"661120102","SALTA",9,0,0,0,6,6,0
"660770102","SALTA",46,0,23,11,2,36,0
"660840101","SALTA",103,0,12,47,34,93,0
"660770302","SALTA",9,0,5,1,0,6,0
"380070105","JUJUY",239,13,96,80,44,220,0.0543933054393305
"540700602","MISIONES",209,0,85,34,81,200,0
"380630407","JUJUY",358,305,19,23,6,48,0.85195530726257
"660770101","SALTA",19,0,0,0,0,0,0
"660700403","SALTA",15,0,0,1,0,1,0
"660700402","SALTA",13,0,1,1,11,13,0
"660210201","SALTA",5,0,0,4,1,5,0
"380280412","JUJUY",146,12,51,67,6,124,0.0821917808219178
"380770101","JUJUY",76,0,4,20,45,69,0
"660630202","SALTA",112,6,51,18,5,74,0.0535714285714286
"661120202","SALTA",31,0,1,14,3,18,0
"380280101","JUJUY",87,0,2,27,41,70,0
"380210406","JUJUY",217,56,81,69,5,155,0.258064516129032
"380140303","JUJUY",142,2,27,76,13,116,0.0140845070422535
"660070301","SALTA",5,0,0,0,2,2,0
"661120103","SALTA",22,0,4,17,0,21,0
"660070605","SALTA",19,0,7,0,2,9,0
"380210705","JUJUY",376,296,40,30,0,70,0.787234042553192
"660070201","SALTA",96,2,1,52,14,67,0.0208333333333333
"660070104","SALTA",50,0,21,12,13,46,0
"141401406","CORDOBA",194,192,2,0,0,2,0.989690721649485
"381120402","JUJUY",49,0,7,26,1,34,0
"381050402","JUJUY",62,0,10,27,15,52,0
"380840401","JUJUY",42,0,0,17,20,37,0
"141401405","CORDOBA",283,238,21,4,0,25,0.840989399293286
"381050102","JUJUY",77,0,7,35,13,55,0
"380980101","JUJUY",65,0,15,27,18,60,0
"380700105","JUJUY",315,293,5,0,0,5,0.93015873015873
"380630519","JUJUY",236,228,8,0,0,8,0.966101694915254
"380350616","JUJUY",355,237,56,56,0,112,0.667605633802817
"380210620","JUJUY",178,149,12,17,0,29,0.837078651685393
"300770510","ENTRE RIOS",32,0,18,12,1,31,0
"380980501","JUJUY",64,15,6,20,22,48,0.234375
"380420612","JUJUY",210,206,3,0,0,3,0.980952380952381
"380420501","JUJUY",350,236,34,72,1,107,0.674285714285714
"380630616","JUJUY",294,291,3,0,0,3,0.989795918367347
"380420409","JUJUY",263,255,4,2,0,6,0.96958174904943
"141401404","CORDOBA",267,264,3,0,0,3,0.98876404494382
"380940102","JUJUY",193,0,17,110,26,153,0
"380350613","JUJUY",331,236,23,47,0,70,0.712990936555891
"380350610","JUJUY",351,256,24,49,8,81,0.729344729344729
"380350511","JUJUY",196,192,4,0,0,4,0.979591836734694
"380770202","JUJUY",82,0,1,61,14,76,0
"380840102","JUJUY",52,0,7,31,6,44,0
"380350604","JUJUY",381,358,14,0,0,14,0.939632545931758
"380211519","JUJUY",185,179,6,0,0,6,0.967567567567568
"380560103","JUJUY",65,0,17,46,1,64,0
"380211303","JUJUY",43,1,24,14,0,38,0.0232558139534884
"380140506","JUJUY",142,7,48,62,4,114,0.0492957746478873
"380070504","JUJUY",79,0,10,25,28,63,0
"380070303","JUJUY",92,0,15,35,36,86,0
"380211517","JUJUY",185,174,10,0,0,10,0.940540540540541
"380211502","JUJUY",182,0,25,66,3,94,0
"380211419","JUJUY",285,219,16,45,2,63,0.768421052631579
"380210617","JUJUY",240,202,0,1,0,1,0.841666666666667
"380070402","JUJUY",73,0,4,9,47,60,0
"381120103","JUJUY",260,192,39,29,0,68,0.738461538461539
"380940602","JUJUY",20,0,0,4,1,5,0
"380560201","JUJUY",144,3,70,59,3,132,0.0208333333333333
"381120111","JUJUY",264,135,31,76,7,114,0.511363636363636
"380700205","JUJUY",182,59,45,49,23,117,0.324175824175824
"380211418","JUJUY",315,60,14,214,17,245,0.19047619047619
"380211414","JUJUY",415,375,7,19,2,28,0.903614457831325
"380211411","JUJUY",240,53,10,152,0,162,0.220833333333333
"381120109","JUJUY",281,145,34,74,15,123,0.516014234875445
"380350506","JUJUY",232,204,22,0,0,22,0.879310344827586
"380350501","JUJUY",385,369,11,0,0,11,0.958441558441558
"380350414","JUJUY",298,132,19,90,35,144,0.442953020134228
"381120108","JUJUY",268,193,4,37,0,41,0.720149253731343
"380980204","JUJUY",143,116,14,9,1,24,0.811188811188811
"380140508","JUJUY",426,310,70,44,0,114,0.727699530516432
"380350111","JUJUY",248,87,41,77,12,130,0.350806451612903
"380211408","JUJUY",404,329,12,45,0,57,0.814356435643564
"380211211","JUJUY",275,222,28,21,0,49,0.807272727272727
"380211204","JUJUY",294,41,68,184,0,252,0.139455782312925
"380211115","JUJUY",232,214,13,5,0,18,0.922413793103448
"380211107","JUJUY",261,257,4,0,0,4,0.984674329501916
"380211102","JUJUY",284,230,21,33,0,54,0.809859154929577
"380210902","JUJUY",219,210,8,0,0,8,0.958904109589041
"380210811","JUJUY",254,243,8,1,0,9,0.956692913385827
"380210707","JUJUY",347,345,2,0,0,2,0.994236311239193
"380210706","JUJUY",176,176,0,0,0,0,1
"380210720","JUJUY",245,175,11,54,2,67,0.714285714285714
"380210613","JUJUY",208,179,1,0,0,1,0.860576923076923
"380350211","JUJUY",378,3,234,105,26,365,0.00793650793650794
"380070108","JUJUY",325,0,80,121,92,293,0
"380560303","JUJUY",24,0,8,13,0,21,0
"380350401","JUJUY",128,1,15,36,47,98,0.0078125
"380210526","JUJUY",169,0,23,131,9,163,0
"380210904","JUJUY",140,139,0,1,0,1,0.992857142857143
"380140305","JUJUY",368,2,256,100,7,363,0.00543478260869565
"380210606","JUJUY",66,66,0,0,0,0,1
"380350405","JUJUY",0,0,0,0,0,0,NA
"380350507","JUJUY",363,344,17,1,0,18,0.947658402203857
"380210516","JUJUY",291,52,189,42,1,232,0.178694158075601
"380210515","JUJUY",247,18,45,167,2,214,0.0728744939271255
"380210514","JUJUY",414,116,111,172,0,283,0.280193236714976
"380210504","JUJUY",445,341,35,42,1,78,0.766292134831461
"380211511","JUJUY",383,357,6,17,2,25,0.932114882506527
"380210415","JUJUY",288,17,115,102,5,222,0.0590277777777778
"380210906","JUJUY",311,300,2,3,0,5,0.964630225080386
"380210813","JUJUY",229,220,4,3,0,7,0.960698689956332
"380140714","JUJUY",216,199,11,2,0,13,0.921296296296296
"380140707","JUJUY",261,148,98,14,0,112,0.567049808429119
"380140601","JUJUY",305,293,7,4,1,12,0.960655737704918
"381120503","JUJUY",51,0,11,33,2,46,0
"381050205","JUJUY",179,0,42,107,23,172,0
"380700505","JUJUY",44,2,25,14,0,39,0.0454545454545455
"380630109","JUJUY",169,3,58,51,20,129,0.0177514792899408
"380630106","JUJUY",265,0,5,26,90,121,0
"380420607","JUJUY",373,369,0,0,0,0,0.989276139410188
"380630513","JUJUY",198,187,9,2,0,11,0.944444444444444
"380210608","JUJUY",243,49,60,103,0,163,0.201646090534979
"380350201","JUJUY",2,0,0,1,1,2,0
"380210107","JUJUY",179,2,113,60,0,173,0.0111731843575419
"380140704","JUJUY",59,0,27,28,0,55,0
"380280401","JUJUY",153,0,11,76,40,127,0
"380350303","JUJUY",16,15,0,0,0,0,0.9375
"380350301","JUJUY",41,0,1,16,12,29,0
"380280402","JUJUY",89,2,7,49,10,66,0.0224719101123595
"380140104","JUJUY",127,4,24,75,5,104,0.031496062992126
"380210823","JUJUY",251,238,2,1,0,3,0.948207171314741
"380280408","JUJUY",173,111,14,39,2,55,0.641618497109827
"380980202","JUJUY",15,0,1,7,0,8,0
"380940603","JUJUY",16,0,1,3,9,13,0
"380940601","JUJUY",18,0,0,0,2,2,0
"380560102","JUJUY",153,49,30,56,1,87,0.320261437908497
"380560101","JUJUY",15,0,2,7,0,9,0
"380211510","JUJUY",312,1,54,187,10,251,0.00320512820512821
"380490102","JUJUY",58,0,1,22,33,56,0
"380420302","JUJUY",39,1,2,23,0,25,0.0256410256410256
"380770102","JUJUY",52,0,0,22,20,42,0
"380700401","JUJUY",23,2,5,8,1,14,0.0869565217391304
"380140502","JUJUY",190,2,43,81,3,127,0.0105263157894737
"380940103","JUJUY",206,2,15,153,20,188,0.00970873786407767
"380840101","JUJUY",82,0,33,21,15,69,0
"380770201","JUJUY",54,0,1,22,17,40,0
"380840301","JUJUY",44,0,4,12,11,27,0
"380420204","JUJUY",73,8,15,38,2,55,0.10958904109589
"380140105","JUJUY",328,2,59,174,9,242,0.00609756097560976
"380940405","JUJUY",315,38,150,92,6,248,0.120634920634921
"380630606","JUJUY",97,0,2,41,15,58,0
"380630605","JUJUY",171,0,3,61,16,80,0
"380210821","JUJUY",261,251,6,4,0,10,0.961685823754789
"380070401","JUJUY",22,0,1,0,5,6,0
"380140401","JUJUY",427,8,136,170,28,334,0.0187353629976581
"380630518","JUJUY",211,206,4,1,0,5,0.976303317535545
"380140603","JUJUY",295,244,18,19,1,38,0.827118644067797
"380140106","JUJUY",83,0,27,29,5,61,0
"380630507","JUJUY",275,271,3,1,0,4,0.985454545454545
"380211503","JUJUY",82,26,47,9,0,56,0.317073170731707
"380940505","JUJUY",160,70,40,47,0,87,0.4375
"380630614","JUJUY",279,279,0,0,0,0,1
"380630611","JUJUY",228,0,22,187,4,213,0
"381120304","JUJUY",54,0,14,38,0,52,0
"380070503","JUJUY",129,0,0,7,107,114,0
"380350608","JUJUY",246,221,4,14,0,18,0.898373983739837
"380630501","JUJUY",316,313,2,0,0,2,0.990506329113924
"380420603","JUJUY",273,68,113,88,2,203,0.249084249084249
"380630617","JUJUY",244,233,0,0,0,0,0.954918032786885
"380420408","JUJUY",344,199,26,63,2,91,0.578488372093023
"380350614","JUJUY",348,215,31,87,3,121,0.617816091954023
"380211501","JUJUY",387,277,42,53,4,99,0.715762273901809
"380211417","JUJUY",461,358,26,54,3,83,0.776572668112798
"380211404","JUJUY",315,293,14,5,0,19,0.93015873015873
"380211322","JUJUY",276,243,5,1,0,6,0.880434782608696
"380211315","JUJUY",321,315,6,0,0,6,0.981308411214953
"380211313","JUJUY",383,371,10,2,0,12,0.968668407310705
"380211219","JUJUY",349,311,24,14,0,38,0.891117478510029
"380211216","JUJUY",208,207,1,0,0,1,0.995192307692308
"380211213","JUJUY",213,150,32,24,1,57,0.704225352112676
"380211201","JUJUY",283,223,38,21,0,59,0.787985865724382
"380211008","JUJUY",324,301,10,12,0,22,0.929012345679012
"380211001","JUJUY",350,313,28,6,0,34,0.894285714285714
"380700403","JUJUY",265,246,2,9,0,11,0.928301886792453
"380630204","JUJUY",106,100,3,0,1,4,0.943396226415094
"380630107","JUJUY",168,152,11,5,0,16,0.904761904761905
"380210901","JUJUY",405,405,0,0,0,0,1
"380210810","JUJUY",234,234,0,0,0,0,1
"380210615","JUJUY",252,251,0,0,0,0,0.996031746031746
"380210610","JUJUY",257,247,10,0,0,10,0.961089494163424
"380210721","JUJUY",190,174,14,0,0,14,0.91578947368421
"380210712","JUJUY",273,258,8,6,0,14,0.945054945054945
"380210711","JUJUY",262,17,134,109,0,243,0.0648854961832061
"380210704","JUJUY",267,17,46,192,3,241,0.0636704119850187
"380210818","JUJUY",308,290,8,7,0,15,0.941558441558442
"380210602","JUJUY",219,169,16,30,0,46,0.771689497716895
"380210523","JUJUY",286,6,79,185,5,269,0.020979020979021
"380210603","JUJUY",386,96,31,212,0,243,0.248704663212435
"380420503","JUJUY",296,202,25,58,0,83,0.682432432432432
"380140411","JUJUY",342,6,239,84,9,332,0.0175438596491228
"380140410","JUJUY",307,0,190,115,2,307,0
"380140513","JUJUY",281,164,52,60,2,114,0.583629893238434
"380350517","JUJUY",212,206,2,0,0,2,0.971698113207547
"380350412","JUJUY",362,302,19,17,1,37,0.834254143646409
"380070111","JUJUY",183,142,12,20,0,32,0.775956284153005
"380210419","JUJUY",91,57,23,7,0,30,0.626373626373626
"381120206","JUJUY",51,0,6,36,6,48,0
"380211402","JUJUY",326,317,8,0,0,8,0.97239263803681
"380210517","JUJUY",276,156,88,31,0,119,0.565217391304348
"380210501","JUJUY",282,90,148,41,2,191,0.319148936170213
"380210410","JUJUY",246,115,22,100,0,122,0.467479674796748
"380210513","JUJUY",374,186,66,79,2,147,0.497326203208556
"380210709","JUJUY",235,234,0,0,0,0,0.995744680851064
"380210110","JUJUY",166,0,64,85,3,152,0
"380140710","JUJUY",377,370,2,0,0,2,0.981432360742706
"380211301","JUJUY",385,2,100,216,9,325,0.00519480519480519
"380210619","JUJUY",259,44,38,162,1,201,0.16988416988417
"380210616","JUJUY",253,253,0,0,0,0,1
"380210601","JUJUY",275,215,41,19,0,60,0.781818181818182
"380140406","JUJUY",396,15,302,59,0,361,0.0378787878787879
"380280505","JUJUY",188,187,1,0,0,1,0.99468085106383
"380350104","JUJUY",10,0,0,3,0,3,0
"380210302","JUJUY",18,0,1,13,2,16,0
"380210301","JUJUY",14,0,0,8,0,8,0
"380630612","JUJUY",210,16,10,106,18,134,0.0761904761904762
"380420513","JUJUY",253,183,21,39,4,64,0.723320158102767
"380630520","JUJUY",206,32,47,86,13,146,0.155339805825243
"380140501","JUJUY",214,4,88,103,3,194,0.0186915887850467
"380070301","JUJUY",60,5,1,9,35,45,0.0833333333333333
"380420601","JUJUY",236,225,2,7,0,9,0.953389830508475
"380940101","JUJUY",10,0,0,1,8,9,0
"380560304","JUJUY",12,0,2,1,0,3,0
"380210708","JUJUY",186,174,11,0,0,11,0.935483870967742
"381050203","JUJUY",12,0,0,4,1,5,0
"380840403","JUJUY",44,0,3,13,16,32,0
"380840302","JUJUY",137,0,25,34,38,97,0
"380420508","JUJUY",239,125,38,71,0,109,0.523012552301255
"380980201","JUJUY",11,0,0,11,0,11,0
"380980102","JUJUY",39,0,0,16,20,36,0
"380940302","JUJUY",41,0,0,15,10,25,0
"380420403","JUJUY",325,280,20,20,0,40,0.861538461538462
"380420202","JUJUY",45,2,13,23,0,36,0.0444444444444444
"381120302","JUJUY",147,0,24,53,58,135,0
"380420103","JUJUY",14,0,0,8,1,9,0
"380940406","JUJUY",227,37,98,87,5,190,0.162995594713656
"380840501","JUJUY",14,0,7,1,5,13,0
"380700602","JUJUY",22,0,1,3,11,15,0
"380350203","JUJUY",0,0,0,0,0,0,NA
"380350102","JUJUY",66,0,5,49,2,56,0
"380700106","JUJUY",367,281,20,36,1,57,0.76566757493188
"540981203","MISIONES",156,2,67,54,23,144,0.0128205128205128
"380280203","JUJUY",117,10,4,55,15,74,0.0854700854700855
"380070403","JUJUY",152,0,35,42,36,113,0
"380420407","JUJUY",386,303,52,30,0,82,0.784974093264249
"380070101","JUJUY",165,74,2,42,30,74,0.448484848484848
"380700207","JUJUY",122,0,33,36,45,114,0
"380420406","JUJUY",236,201,12,22,0,34,0.851694915254237
"380940408","JUJUY",175,1,50,76,19,145,0.00571428571428571
"380211412","JUJUY",316,233,14,65,0,79,0.737341772151899
"380630411","JUJUY",225,211,4,10,0,14,0.937777777777778
"380630402","JUJUY",243,236,5,0,0,5,0.97119341563786
"380630409","JUJUY",290,214,22,49,1,72,0.737931034482759
"380420606","JUJUY",234,227,7,0,0,7,0.97008547008547
"380280406","JUJUY",213,182,11,16,3,30,0.854460093896714
"381120114","JUJUY",221,209,2,10,0,12,0.945701357466063
"381120110","JUJUY",316,113,52,126,2,180,0.357594936708861
"380980404","JUJUY",126,1,74,44,1,119,0.00793650793650794
"380211403","JUJUY",324,321,2,0,0,2,0.990740740740741
"380211320","JUJUY",225,211,12,0,0,12,0.937777777777778
"380211215","JUJUY",293,218,52,20,2,74,0.744027303754266
"380211209","JUJUY",311,302,7,1,0,8,0.971061093247588
"380211205","JUJUY",247,80,111,51,1,163,0.323886639676113
"380211117","JUJUY",297,296,0,1,0,1,0.996632996632997
"380211012","JUJUY",270,251,12,2,0,14,0.92962962962963
"380211004","JUJUY",243,196,21,22,0,43,0.806584362139918
"140980208","CORDOBA",260,15,239,5,0,244,0.0576923076923077
"380210108","JUJUY",327,2,181,126,3,310,0.00611620795107034
"380211002","JUJUY",348,319,16,12,0,28,0.916666666666667
"380210919","JUJUY",164,164,0,0,0,0,1
"380210916","JUJUY",408,363,8,19,0,27,0.889705882352941
"380210912","JUJUY",421,356,29,33,1,63,0.845605700712589
"380210910","JUJUY",387,368,12,3,0,15,0.950904392764858
"380210717","JUJUY",365,332,5,23,3,31,0.90958904109589
"380210701","JUJUY",330,154,88,77,4,169,0.466666666666667
"380140516","JUJUY",241,209,19,12,0,31,0.867219917012448
"380140412","JUJUY",162,1,101,48,7,156,0.00617283950617284
"380140701","JUJUY",180,83,20,60,1,81,0.461111111111111
"340142109","FORMOSA",223,212,11,0,0,11,0.95067264573991
"380350515","JUJUY",387,351,12,2,0,14,0.906976744186046
"380350210","JUJUY",266,1,122,103,25,250,0.0037593984962406
"380350204","JUJUY",205,196,9,0,0,9,0.95609756097561
"380350107","JUJUY",269,250,0,0,0,0,0.929368029739777
"380350212","JUJUY",237,5,169,46,2,217,0.0210970464135021
"380350114","JUJUY",191,45,59,46,28,133,0.235602094240838
"380210816","JUJUY",416,369,14,18,1,33,0.887019230769231
"380140705","JUJUY",193,3,75,106,2,183,0.0155440414507772
"381120112","JUJUY",261,161,10,83,2,95,0.616858237547893
"380210109","JUJUY",72,4,46,17,0,63,0.0555555555555556
"380140712","JUJUY",448,122,73,222,3,298,0.272321428571429
"380210518","JUJUY",212,131,25,49,0,74,0.617924528301887
"380630112","JUJUY",24,4,13,2,0,15,0.166666666666667
"380560104","JUJUY",203,124,42,27,1,70,0.610837438423645
"380210510","JUJUY",439,40,89,294,0,383,0.0911161731207289
"380210506","JUJUY",195,150,32,9,0,41,0.769230769230769
"380210814","JUJUY",304,292,5,2,0,7,0.960526315789474
"380140711","JUJUY",459,211,58,168,6,232,0.459694989106754
"380140708","JUJUY",322,303,2,0,0,2,0.940993788819876
"380140706","JUJUY",205,41,112,40,1,153,0.2
"380350618","JUJUY",345,325,13,1,0,14,0.942028985507246
"380210815","JUJUY",217,208,2,5,0,7,0.95852534562212
"380280602","JUJUY",116,76,13,18,5,36,0.655172413793103
"380211305","JUJUY",305,253,22,29,0,51,0.829508196721311
"540981008","MISIONES",262,1,220,24,11,255,0.00381679389312977
"380070204","JUJUY",274,17,105,60,64,229,0.062043795620438
"380140616","JUJUY",288,281,2,2,0,4,0.975694444444444
"380280502","JUJUY",103,0,4,27,51,82,0
"380280301","JUJUY",151,1,11,74,41,126,0.00662251655629139
"380700601","JUJUY",35,1,16,7,7,30,0.0285714285714286
"380350305","JUJUY",14,0,0,6,1,7,0
"380420512","JUJUY",374,318,33,18,0,51,0.850267379679144
"380420411","JUJUY",314,314,0,0,0,0,1
"380940507","JUJUY",162,4,85,54,5,144,0.0246913580246914
"380940104","JUJUY",154,5,33,89,13,135,0.0324675324675325
"380840502","JUJUY",79,0,29,30,14,73,0
"380350207","JUJUY",56,29,14,11,2,27,0.517857142857143
"380980401","JUJUY",30,0,6,12,5,23,0
"380280102","JUJUY",69,0,0,25,32,57,0
"380980303","JUJUY",31,0,4,16,1,21,0
"380630421","JUJUY",264,256,4,4,0,8,0.96969696969697
"380630124","JUJUY",449,3,19,196,22,237,0.0066815144766147
"380210306","JUJUY",12,0,6,2,0,8,0
"380070102","JUJUY",39,0,0,15,21,36,0
"381120301","JUJUY",40,0,2,15,15,32,0
"380940502","JUJUY",42,0,7,33,1,41,0
"380630403","JUJUY",268,258,4,4,0,8,0.962686567164179
"380630401","JUJUY",339,319,14,6,0,20,0.941002949852507
"380630208","JUJUY",236,233,1,0,0,1,0.98728813559322
"380700203","JUJUY",164,0,36,95,13,144,0
"380211105","JUJUY",349,342,3,1,0,4,0.979942693409742
"380490202","JUJUY",46,0,2,30,13,45,0
"380350302","JUJUY",18,15,1,0,0,1,0.833333333333333
"380630206","JUJUY",365,344,1,16,1,18,0.942465753424658
"340142110","FORMOSA",204,186,17,0,0,17,0.911764705882353
"380630509","JUJUY",251,21,24,137,50,211,0.0836653386454183
"381120205","JUJUY",259,252,5,1,1,7,0.972972972972973
"380770303","JUJUY",80,0,9,32,28,69,0
"380420205","JUJUY",238,99,73,55,1,129,0.415966386554622
"380350615","JUJUY",294,190,29,62,1,92,0.646258503401361
"380280404","JUJUY",195,182,3,6,0,9,0.933333333333333
"380211514","JUJUY",285,280,4,1,0,5,0.982456140350877
"380211512","JUJUY",289,265,6,18,0,24,0.916955017301038
"380211504","JUJUY",136,110,10,10,1,21,0.808823529411765
"380140611","JUJUY",311,301,1,2,0,3,0.967845659163987
"380490301","JUJUY",66,0,13,14,35,62,0
"380490101","JUJUY",19,0,2,7,1,10,0
"380280205","JUJUY",39,0,6,24,6,36,0
"381120204","JUJUY",52,0,3,15,32,50,0
"380420104","JUJUY",162,3,42,79,0,121,0.0185185185185185
"380280201","JUJUY",75,6,3,27,10,40,0.08
"380210405","JUJUY",253,1,44,144,21,209,0.00395256916996047
"380210404","JUJUY",73,1,27,39,3,69,0.0136986301369863
"380140503","JUJUY",340,3,177,138,7,322,0.00882352941176471
"380210411","JUJUY",282,124,95,57,0,152,0.439716312056738
"380140202","JUJUY",19,15,2,1,0,3,0.789473684210526
"381050301","JUJUY",65,0,15,37,7,59,0
"380280303","JUJUY",134,3,31,61,33,125,0.0223880597014925
"380630602","JUJUY",304,3,13,237,34,284,0.00986842105263158
"380630517","JUJUY",209,200,5,4,0,9,0.956937799043062
"380211410","JUJUY",215,90,24,89,0,113,0.418604651162791
"380210911","JUJUY",482,450,16,15,0,31,0.933609958506224
"380350106","JUJUY",369,299,18,33,8,59,0.81029810298103
"380211314","JUJUY",232,39,33,153,0,186,0.168103448275862
"380211220","JUJUY",341,6,46,267,7,320,0.0175953079178886
"380140609","JUJUY",457,455,0,0,0,0,0.99562363238512
"380211407","JUJUY",430,332,11,62,2,75,0.772093023255814
"380211319","JUJUY",283,281,2,0,0,2,0.992932862190813
"380211309","JUJUY",310,300,2,0,0,2,0.967741935483871
"380140606","JUJUY",312,278,22,11,0,33,0.891025641025641
"380211118","JUJUY",140,9,32,79,0,111,0.0642857142857143
"380211110","JUJUY",392,339,14,4,0,18,0.864795918367347
"380211109","JUJUY",155,1,20,124,3,147,0.00645161290322581
"380211104","JUJUY",273,194,46,25,0,71,0.710622710622711
"380211013","JUJUY",292,276,1,10,0,11,0.945205479452055
"380140615","JUJUY",397,336,23,33,0,56,0.846347607052897
"380210903","JUJUY",198,196,2,0,0,2,0.98989898989899
"380210824","JUJUY",238,150,6,6,0,12,0.630252100840336
"380210806","JUJUY",364,357,4,0,0,4,0.980769230769231
"380210803","JUJUY",169,122,13,26,0,39,0.72189349112426
"380210819","JUJUY",293,268,8,16,0,24,0.914675767918089
"380210621","JUJUY",243,206,7,22,0,29,0.847736625514403
"380210604","JUJUY",330,303,9,17,0,26,0.918181818181818
"380140614","JUJUY",260,212,14,32,2,48,0.815384615384615
"380140206","JUJUY",93,0,49,28,1,78,0
"380350509","JUJUY",173,158,1,0,0,1,0.913294797687861
"380350406","JUJUY",0,0,0,0,0,0,NA
"380350110","JUJUY",214,30,62,92,13,167,0.14018691588785
"380350105","JUJUY",315,140,69,81,8,158,0.444444444444444
"380280410","JUJUY",278,150,14,73,7,94,0.539568345323741
"380140618","JUJUY",273,270,0,0,0,0,0.989010989010989
"380140617","JUJUY",241,240,0,1,0,1,0.995850622406639
"380210408","JUJUY",92,1,29,49,1,79,0.0108695652173913
"380630514","JUJUY",285,244,15,13,0,28,0.856140350877193
"380140716","JUJUY",358,80,89,185,1,275,0.223463687150838
"380140715","JUJUY",211,183,25,1,1,27,0.867298578199052
"380140709","JUJUY",308,306,0,0,0,0,0.993506493506494
"380210509","JUJUY",254,12,83,144,13,240,0.047244094488189
"380210412","JUJUY",307,119,71,111,1,183,0.387622149837134
"380630417","JUJUY",241,232,3,5,0,8,0.962655601659751
"381120116","JUJUY",228,199,9,11,4,24,0.87280701754386
"381120115","JUJUY",231,184,15,20,0,35,0.796536796536797
"380770103","JUJUY",81,0,15,47,11,73,0
"380630111","JUJUY",211,185,15,10,0,25,0.876777251184834
"380420208","JUJUY",334,197,30,89,0,119,0.589820359281437
"820630711","SANTA FE",285,274,6,5,0,11,0.96140350877193
"380420207","JUJUY",124,104,7,8,1,16,0.838709677419355
"380350619","JUJUY",210,209,1,0,0,1,0.995238095238095
"380350617","JUJUY",413,173,36,98,0,134,0.418886198547215
"380210913","JUJUY",357,354,3,0,0,3,0.991596638655462
"380210618","JUJUY",273,41,42,184,0,226,0.15018315018315
"380140407","JUJUY",377,14,290,59,1,350,0.0371352785145889
"380140115","JUJUY",12,0,5,6,0,11,0
"380350115","JUJUY",115,0,35,33,33,101,0
"380280503","JUJUY",173,158,1,0,0,1,0.913294797687861
"381120501","JUJUY",68,0,1,49,14,64,0
"381120203","JUJUY",48,0,0,26,10,36,0
"381050302","JUJUY",24,0,0,6,8,14,0
"300980314","ENTRE RIOS",201,200,0,0,0,0,0.995024875621891
"380980302","JUJUY",31,0,0,10,5,15,0
"380140102","JUJUY",81,0,1,66,3,70,0
"380350601","JUJUY",342,305,9,18,0,27,0.891812865497076
"380280204","JUJUY",40,4,2,24,2,28,0.1
"380070203","JUJUY",44,0,2,8,9,19,0
"381120602","JUJUY",51,0,1,31,3,35,0
"380980403","JUJUY",66,0,12,40,8,60,0
"380630416","JUJUY",232,216,7,3,0,10,0.931034482758621
"380350112","JUJUY",196,160,8,19,1,28,0.816326530612245
"380211518","JUJUY",429,417,10,2,0,12,0.972027972027972
"380211507","JUJUY",257,145,103,4,0,107,0.56420233463035
"380420201","JUJUY",66,5,36,19,0,55,0.0757575757575758
"380420101","JUJUY",63,0,7,28,9,44,0
"381120101","JUJUY",92,0,3,66,16,85,0
"380980502","JUJUY",32,0,0,4,24,28,0
"380210102","JUJUY",32,0,1,5,20,26,0
"381120202","JUJUY",133,24,18,62,13,93,0.180451127819549
"380940402","JUJUY",255,0,82,140,15,237,0
"380420507","JUJUY",265,211,33,13,0,46,0.79622641509434
"381120113","JUJUY",265,89,28,131,8,167,0.335849056603774
"820842822","SANTA FE",205,204,1,0,0,1,0.995121951219512
"381050101","JUJUY",13,0,2,2,0,4,0
"380700201","JUJUY",45,0,8,15,10,33,0
"380940403","JUJUY",117,0,33,57,13,103,0
"380350607","JUJUY",278,277,1,0,0,1,0.996402877697842
"380940202","JUJUY",24,0,0,5,15,20,0
"140982909","CORDOBA",183,0,110,73,0,183,0
"380700503","JUJUY",18,0,1,3,10,14,0
"380140201","JUJUY",253,5,77,130,12,219,0.0197628458498024
"380700303","JUJUY",13,0,1,3,2,6,0
"380700102","JUJUY",13,0,8,2,0,10,0
"380560301","JUJUY",7,0,0,0,7,7,0
"380490303","JUJUY",55,0,12,31,8,51,0
"380940407","JUJUY",178,21,108,46,2,156,0.117977528089888
"380630613","JUJUY",368,295,0,0,0,0,0.801630434782609
"380630603","JUJUY",0,0,0,0,0,0,NA
"380210203","JUJUY",4,0,0,1,1,2,0
"141190911","CORDOBA",295,48,227,19,1,247,0.16271186440678
"380630404","JUJUY",357,278,14,25,6,45,0.778711484593838
"380350612","JUJUY",282,250,20,2,0,22,0.886524822695035
"380840201","JUJUY",80,0,11,30,13,54,0
"380630103","JUJUY",288,1,39,126,62,227,0.00347222222222222
"380630101","JUJUY",23,0,3,15,0,18,0
"380560202","JUJUY",216,0,37,97,15,149,0
"380280202","JUJUY",58,1,4,34,12,50,0.0172413793103448
"380211406","JUJUY",360,332,10,15,1,26,0.922222222222222
"380630410","JUJUY",263,192,13,17,5,35,0.730038022813688
"380211317","JUJUY",294,289,4,1,0,5,0.982993197278912
"380420414","JUJUY",374,222,36,84,2,122,0.593582887700535
"380420402","JUJUY",346,287,18,40,0,58,0.829479768786127
"540980908","MISIONES",314,2,197,20,81,298,0.00636942675159236
"380420412","JUJUY",142,121,9,8,0,17,0.852112676056338
"380420206","JUJUY",127,68,13,45,0,58,0.535433070866142
"380420405","JUJUY",243,172,21,44,3,68,0.707818930041152
"380350609","JUJUY",209,206,3,0,0,3,0.985645933014354
"380211221","JUJUY",348,225,34,83,1,118,0.646551724137931
"380211218","JUJUY",240,3,76,149,1,226,0.0125
"180210118","CORRIENTES",333,332,0,0,0,0,0.996996996996997
"380211108","JUJUY",434,404,15,11,0,26,0.930875576036866
"380211106","JUJUY",239,237,0,0,0,0,0.99163179916318
"380211101","JUJUY",320,309,2,1,0,3,0.965625
"380211014","JUJUY",347,332,3,9,0,12,0.956772334293948
"380211010","JUJUY",312,305,4,1,0,5,0.977564102564103
"380211005","JUJUY",359,290,41,22,0,63,0.807799442896936
"380211003","JUJUY",287,242,25,17,0,42,0.843205574912892
"380210921","JUJUY",216,215,1,0,0,1,0.99537037037037
"380350415","JUJUY",202,163,7,26,0,33,0.806930693069307
"380210609","JUJUY",183,182,1,0,0,1,0.994535519125683
"380350611","JUJUY",267,252,11,0,0,11,0.943820224719101
"380210920","JUJUY",286,268,0,0,0,0,0.937062937062937
"380210827","JUJUY",233,229,4,0,0,4,0.982832618025751
"380210825","JUJUY",236,226,7,1,0,8,0.957627118644068
"380210702","JUJUY",204,161,22,19,1,42,0.78921568627451
"380350508","JUJUY",205,203,2,0,0,2,0.990243902439024
"380350209","JUJUY",85,77,6,0,0,6,0.905882352941176
"380210524","JUJUY",398,267,52,53,2,107,0.670854271356784
"380210521","JUJUY",337,88,140,89,11,240,0.261127596439169
"380140205","JUJUY",266,219,30,12,0,42,0.823308270676692
"540630111","MISIONES",319,0,20,94,147,261,0
"380210520","JUJUY",354,235,82,36,0,118,0.663841807909605
"380140515","JUJUY",335,221,46,55,3,104,0.659701492537313
"380140511","JUJUY",351,235,62,45,0,107,0.66951566951567
"380210605","JUJUY",166,165,0,0,0,0,0.993975903614458
"380350408","JUJUY",394,306,32,52,3,87,0.776649746192893
"380210511","JUJUY",248,64,98,81,1,180,0.258064516129032
"380140613","JUJUY",251,246,2,1,0,3,0.9800796812749
"380210502","JUJUY",299,229,48,15,1,64,0.765886287625418
"380140608","JUJUY",288,267,7,14,0,21,0.927083333333333
"380140510","JUJUY",274,228,19,23,0,42,0.832116788321168
"380840303","JUJUY",205,0,74,107,15,196,0
"380840202","JUJUY",66,0,30,29,5,64,0
"380700504","JUJUY",136,1,42,75,9,126,0.00735294117647059
"380700206","JUJUY",177,1,73,73,19,165,0.00564971751412429
"380210407","JUJUY",45,42,3,0,0,3,0.933333333333333
"380140702","JUJUY",77,1,36,40,0,76,0.012987012987013
"380210503","JUJUY",390,316,42,26,2,70,0.81025641025641
"380210416","JUJUY",140,0,59,68,2,129,0
"380140408","JUJUY",311,5,237,69,0,306,0.0160771704180064
"380350208","JUJUY",58,50,7,0,0,7,0.862068965517241
"380350206","JUJUY",56,43,5,3,2,10,0.767857142857143
"380211505","JUJUY",193,159,4,22,0,26,0.823834196891192
"380070106","JUJUY",196,90,28,46,19,93,0.459183673469388
"380070104","JUJUY",57,1,16,30,10,56,0.0175438596491228
"380140717","JUJUY",169,0,43,115,4,162,0
"381120502","JUJUY",114,0,9,63,16,88,0
"380420605","JUJUY",233,233,0,0,0,0,1
"380280501","JUJUY",33,1,0,11,16,27,0.0303030303030303
"380210403","JUJUY",12,2,4,3,0,7,0.166666666666667
"380210401","JUJUY",4,0,0,0,1,1,0
"380140402","JUJUY",258,11,102,133,2,237,0.0426356589147287
"380211111","JUJUY",294,293,0,1,0,1,0.996598639455782
"380140301","JUJUY",132,7,49,68,0,117,0.053030303030303
"380070502","JUJUY",36,0,2,11,19,32,0
"380940503","JUJUY",162,117,14,23,0,37,0.722222222222222
"380700508","JUJUY",152,100,14,30,6,50,0.657894736842105
"380211202","JUJUY",359,356,3,0,0,3,0.991643454038997
"380140103","JUJUY",143,1,24,95,6,125,0.00699300699300699
"381120303","JUJUY",116,0,3,48,36,87,0
"380490302","JUJUY",91,0,6,16,33,55,0
"380210103","JUJUY",131,0,50,59,7,116,0
"381120603","JUJUY",27,0,0,16,10,26,0
"381120601","JUJUY",41,0,1,19,12,32,0
"381120401","JUJUY",19,0,0,4,14,18,0
"381050303","JUJUY",20,0,0,2,11,13,0
"381050201","JUJUY",30,0,3,9,8,20,0
"380980203","JUJUY",148,3,43,68,15,126,0.0202702702702703
"380140405","JUJUY",303,3,158,80,5,243,0.0099009900990099
"380770301","JUJUY",142,0,6,61,23,90,0
"380350101","JUJUY",283,38,59,123,28,210,0.134275618374558
"381120604","JUJUY",61,0,4,36,10,50,0
"380350416","JUJUY",354,2,60,239,20,319,0.00564971751412429
"380770304","JUJUY",64,0,22,21,16,59,0
"380940506","JUJUY",180,2,73,64,16,153,0.0111111111111111
"540911308","MISIONES",272,225,35,8,2,45,0.827205882352941
"380700204","JUJUY",411,189,107,81,16,204,0.45985401459854
"380630608","JUJUY",0,0,0,0,0,0,NA
"380630607","JUJUY",335,1,14,224,56,294,0.00298507462686567
"380630604","JUJUY",25,0,16,2,0,18,0
"380630516","JUJUY",313,259,20,31,1,52,0.827476038338658
"380630512","JUJUY",251,251,0,0,0,0,1
"380630508","JUJUY",300,298,2,0,0,2,0.993333333333333
"380630412","JUJUY",233,194,8,20,0,28,0.832618025751073
"180210218","CORRIENTES",154,154,0,0,0,0,1
"380630502","JUJUY",349,132,34,156,14,204,0.378223495702006
"380630413","JUJUY",376,277,15,82,0,97,0.736702127659574
"380630418","JUJUY",279,192,17,64,0,81,0.688172043010753
"380630209","JUJUY",96,84,0,0,0,0,0.875
"380420413","JUJUY",235,78,50,96,1,147,0.331914893617021
"380350603","JUJUY",337,315,8,0,0,8,0.934718100890208
"380280403","JUJUY",221,169,12,25,6,43,0.764705882352941
"380211515","JUJUY",236,186,39,11,0,50,0.788135593220339
"380211416","JUJUY",255,239,7,5,0,12,0.937254901960784
"380350510","JUJUY",352,289,35,24,0,59,0.821022727272727
"380980405","JUJUY",303,237,18,37,3,58,0.782178217821782
"381120105","JUJUY",218,207,6,5,0,11,0.94954128440367
"380980205","JUJUY",62,0,26,30,0,56,0
"380350605","JUJUY",272,256,13,0,0,13,0.941176470588235
"380211405","JUJUY",347,158,58,119,2,179,0.455331412103746
"380211312","JUJUY",323,292,1,0,0,1,0.904024767801858
"380211006","JUJUY",284,244,14,24,0,38,0.859154929577465
"380210915","JUJUY",320,320,0,0,0,0,1
"380210914","JUJUY",271,265,1,1,0,2,0.977859778597786
"380211307","JUJUY",408,250,59,96,0,155,0.612745098039216
"380211210","JUJUY",310,295,7,8,0,15,0.951612903225806
"380211203","JUJUY",403,148,41,209,1,251,0.367245657568238
"380210808","JUJUY",431,369,24,34,0,58,0.85614849187935
"380210801","JUJUY",219,183,3,4,0,7,0.835616438356164
"380210713","JUJUY",220,193,1,0,0,1,0.877272727272727
"380210703","JUJUY",67,41,9,11,0,20,0.611940298507463
"380140514","JUJUY",320,195,70,52,1,123,0.609375
"380140512","JUJUY",269,121,77,66,0,143,0.449814126394052
"380210607","JUJUY",256,253,3,0,0,3,0.98828125
"380350504","JUJUY",332,330,0,0,0,0,0.993975903614458
"380350503","JUJUY",296,283,5,0,5,10,0.956081081081081
"380350513","JUJUY",254,242,6,0,0,6,0.952755905511811
"380350413","JUJUY",295,261,15,9,1,25,0.884745762711864
"380350409","JUJUY",338,186,36,52,23,111,0.550295857988166
"380350214","JUJUY",198,3,138,45,7,190,0.0151515151515152
"380280409","JUJUY",157,140,6,4,3,13,0.89171974522293
"380210812","JUJUY",397,360,5,2,0,7,0.906801007556675
"380070109","JUJUY",284,121,56,50,46,152,0.426056338028169
"380140602","JUJUY",312,220,24,51,1,76,0.705128205128205
"380140507","JUJUY",349,213,66,46,1,113,0.610315186246418
"381050103","JUJUY",115,0,16,56,11,83,0
"380490106","JUJUY",90,0,43,25,3,71,0
"380280103","JUJUY",80,0,7,60,8,75,0
"380420609","JUJUY",404,401,3,0,0,3,0.992574257425743
"380210512","JUJUY",326,273,28,21,0,49,0.837423312883436
"380420105","JUJUY",110,76,23,1,0,24,0.690909090909091
"380350404","JUJUY",243,211,21,2,0,23,0.868312757201646
"380210922","JUJUY",285,256,8,17,0,25,0.898245614035088
"380210612","JUJUY",160,160,0,0,0,0,1
"380140116","JUJUY",153,0,84,64,1,149,0
"380280411","JUJUY",290,195,13,37,12,62,0.672413793103448
"380211520","JUJUY",40,1,0,3,0,3,0.025
"220211707","CHACO",293,5,174,86,24,284,0.0170648464163823
"380210417","JUJUY",292,90,88,90,0,178,0.308219178082192
"380700404","JUJUY",307,249,7,19,12,38,0.811074918566775
"141190910","CORDOBA",178,123,51,4,0,55,0.691011235955056
"380210304","JUJUY",25,0,2,21,1,24,0
"380630609","JUJUY",151,0,46,32,1,79,0
"380630601","JUJUY",287,1,50,209,14,273,0.00348432055749129
"540560907","MISIONES",220,0,96,80,43,219,0
"380630510","JUJUY",270,266,1,3,0,4,0.985185185185185
"380140604","JUJUY",394,352,19,20,0,39,0.893401015228426
"380140404","JUJUY",369,6,66,223,11,300,0.016260162601626
"380140101","JUJUY",53,0,6,26,2,34,0
"380940203","JUJUY",11,0,0,1,7,8,0
"380770203","JUJUY",65,0,0,29,23,52,0
"380700402","JUJUY",38,0,9,17,2,28,0
"380700301","JUJUY",27,0,3,11,9,23,0
"380940301","JUJUY",25,0,0,5,10,15,0
"380420502","JUJUY",287,196,33,57,1,91,0.682926829268293
"380420410","JUJUY",261,258,2,0,0,2,0.988505747126437
"380140505","JUJUY",32,0,10,15,2,27,0
"380630506","JUJUY",167,153,6,4,0,10,0.916167664670659
"380490104","JUJUY",27,0,3,2,12,17,0
"380350103","JUJUY",3,1,1,0,0,1,0.333333333333333
"380210305","JUJUY",39,2,16,15,1,32,0.0512820512820513
"380630419","JUJUY",264,209,9,43,2,54,0.791666666666667
"820841813","SANTA FE",393,377,1,0,0,1,0.959287531806616
"380211513","JUJUY",215,155,10,46,0,56,0.720930232558139
"380420604","JUJUY",311,300,1,0,0,1,0.964630225080386
"380420511","JUJUY",230,183,25,20,0,45,0.795652173913043
"380420509","JUJUY",354,268,49,28,0,77,0.757062146892655
"380420505","JUJUY",263,159,33,65,3,101,0.604562737642586
"381050202","JUJUY",79,0,36,19,11,66,0
"380980402","JUJUY",69,12,7,36,8,51,0.173913043478261
"380630104","JUJUY",292,9,72,134,25,231,0.0308219178082192
"380630408","JUJUY",196,169,6,19,1,26,0.862244897959184
"380420504","JUJUY",271,222,16,29,1,46,0.819188191881919
"380420404","JUJUY",354,252,31,59,2,92,0.711864406779661
"380070404","JUJUY",62,1,1,23,26,50,0.0161290322580645
"380560105","JUJUY",183,101,27,40,4,71,0.551912568306011
"380070202","JUJUY",41,0,1,7,24,32,0
"380140204","JUJUY",221,46,46,82,5,133,0.208144796380091
"380420611","JUJUY",231,226,4,0,0,4,0.978354978354978
"380211506","JUJUY",226,178,11,19,1,31,0.787610619469027
"380140203","JUJUY",324,3,55,159,29,243,0.00925925925925926
"380770302","JUJUY",72,0,6,19,30,55,0
"380630303","JUJUY",174,0,21,94,38,153,0
"380630301","JUJUY",126,1,53,42,16,111,0.00793650793650794
"380350403","JUJUY",91,26,6,38,2,46,0.285714285714286
"380770204","JUJUY",78,0,29,35,9,73,0
"380140517","JUJUY",117,59,16,41,1,58,0.504273504273504
"380211413","JUJUY",220,192,3,21,1,25,0.872727272727273
"381120107","JUJUY",239,209,0,27,0,27,0.874476987447699
"381120106","JUJUY",242,174,7,56,2,65,0.71900826446281
"380211316","JUJUY",283,277,6,0,0,6,0.978798586572438
"380211207","JUJUY",367,360,5,0,0,5,0.980926430517711
"380211116","JUJUY",289,249,29,9,1,39,0.86159169550173
"380211114","JUJUY",272,248,9,15,0,24,0.911764705882353
"380211112","JUJUY",237,228,6,2,0,8,0.962025316455696
"381120102","JUJUY",238,188,12,34,0,46,0.789915966386555
"380211401","JUJUY",285,254,11,13,0,24,0.891228070175439
"380211321","JUJUY",196,189,6,0,0,6,0.964285714285714
"380211214","JUJUY",418,397,9,10,0,19,0.949760765550239
"380211308","JUJUY",366,341,24,0,0,24,0.931693989071038
"380210923","JUJUY",127,99,19,6,0,25,0.779527559055118
"380211113","JUJUY",294,274,12,7,0,19,0.931972789115646
"380210907","JUJUY",342,326,9,5,0,14,0.953216374269006
"380210822","JUJUY",285,238,15,19,0,34,0.835087719298246
"380210809","JUJUY",297,256,8,29,0,37,0.861952861952862
"380210714","JUJUY",300,295,3,0,0,3,0.983333333333333
"380211310","JUJUY",279,50,61,154,2,217,0.17921146953405
"380211304","JUJUY",224,162,6,1,0,7,0.723214285714286
"380210614","JUJUY",254,30,57,146,7,210,0.118110236220472
"180210302","CORRIENTES",288,276,3,2,0,5,0.958333333333333
"380210527","JUJUY",200,104,63,31,0,94,0.52
"380210525","JUJUY",215,126,48,9,1,58,0.586046511627907
"380140304","JUJUY",547,9,316,182,21,519,0.0164533820840951
"380350215","JUJUY",206,169,14,1,0,15,0.820388349514563
"380350109","JUJUY",279,150,17,41,32,90,0.537634408602151
"380350213","JUJUY",183,170,13,0,0,13,0.92896174863388
"380280415","JUJUY",215,159,20,29,0,49,0.73953488372093
"380700302","JUJUY",13,0,1,4,3,8,0
"380350304","JUJUY",14,0,0,6,3,9,0
"380280414","JUJUY",145,1,32,58,14,104,0.00689655172413793
"381120104","JUJUY",310,180,27,90,2,119,0.580645161290323
"381050204","JUJUY",84,0,45,31,5,81,0
"380210507","JUJUY",305,195,51,47,1,99,0.639344262295082
"380700506","JUJUY",357,30,198,99,13,310,0.0840336134453782
"380630119","JUJUY",336,106,177,39,5,221,0.31547619047619
"380210409","JUJUY",424,361,30,29,0,59,0.851415094339623
"380210905","JUJUY",375,347,11,11,1,23,0.925333333333333
"380630504","JUJUY",250,241,6,2,0,8,0.964
"380630110","JUJUY",253,175,50,5,0,55,0.691699604743083
"380560203","JUJUY",55,0,25,30,0,55,0
"380420608","JUJUY",267,260,6,0,0,6,0.973782771535581
"380210715","JUJUY",399,392,4,1,0,5,0.982456140350877
"380210519","JUJUY",229,9,67,150,1,218,0.0393013100436681
"380140117","JUJUY",189,1,83,88,11,182,0.00529100529100529
"380350205","JUJUY",219,196,23,0,0,23,0.894977168949772
"380350306","JUJUY",193,160,1,20,2,23,0.829015544041451
"380210505","JUJUY",276,180,5,89,1,95,0.652173913043478
"380140713","JUJUY",381,193,66,114,1,181,0.506561679790026
"380140610","JUJUY",221,197,0,0,0,0,0.891402714932127
"540911301","MISIONES",324,0,6,28,280,314,0
"380210418","JUJUY",128,2,54,68,2,124,0.015625
"380210718","JUJUY",215,178,9,27,1,37,0.827906976744186
"380210307","JUJUY",295,2,41,205,3,249,0.00677966101694915
"540911211","MISIONES",125,0,77,41,5,123,0
"380210402","JUJUY",100,10,28,35,9,72,0.1
"380211302","JUJUY",14,2,6,2,0,8,0.142857142857143
"380210303","JUJUY",64,0,6,9,42,57,0
"380210104","JUJUY",9,0,0,0,5,5,0
"380210101","JUJUY",21,0,1,15,1,17,0
"380700507","JUJUY",282,23,166,81,6,253,0.0815602836879433
"380140108","JUJUY",101,2,19,74,0,93,0.0198019801980198
"380700101","JUJUY",239,7,44,89,32,165,0.0292887029288703
"380940401","JUJUY",81,0,20,44,15,79,0
"380700502","JUJUY",96,0,27,49,8,84,0
"380630202","JUJUY",100,3,16,50,10,76,0.03
"380630102","JUJUY",105,1,5,52,0,57,0.00952380952380952
"380210105","JUJUY",135,3,44,63,4,111,0.0222222222222222
"380210201","JUJUY",47,0,1,26,17,44,0
"380140403","JUJUY",301,12,89,142,9,240,0.0398671096345515
"381050401","JUJUY",17,0,1,7,4,12,0
"380840402","JUJUY",9,0,0,0,4,4,0
"540281505","MISIONES",409,14,380,13,2,395,0.0342298288508557
"380420203","JUJUY",3,0,1,1,1,3,0
"380420102","JUJUY",10,0,1,1,2,4,0
"380560302","JUJUY",6,0,0,1,0,1,0
"380280302","JUJUY",100,0,4,24,6,34,0
"540911210","MISIONES",240,0,116,96,25,237,0
"380140302","JUJUY",275,12,79,125,10,214,0.0436363636363636
"380420301","JUJUY",100,2,43,39,4,86,0.02
"540911209","MISIONES",251,1,89,63,56,208,0.00398406374501992
"380630615","JUJUY",318,315,1,0,0,1,0.990566037735849
"380630511","JUJUY",400,62,55,235,25,315,0.155
"380630505","JUJUY",267,260,7,0,0,7,0.973782771535581
"380630503","JUJUY",262,23,48,176,1,225,0.0877862595419847
"380630414","JUJUY",327,244,21,43,7,71,0.746177370030581
"380630205","JUJUY",43,0,10,32,0,42,0
"380630406","JUJUY",316,223,8,37,3,48,0.705696202531646
"380420602","JUJUY",322,288,15,8,0,23,0.894409937888199
"380420510","JUJUY",266,208,32,25,0,57,0.781954887218045
"380630405","JUJUY",371,310,14,21,1,36,0.835579514824798
"380350108","JUJUY",262,90,33,60,41,134,0.343511450381679
"380420506","JUJUY",315,193,53,66,0,119,0.612698412698413
"380420401","JUJUY",388,281,33,60,1,94,0.724226804123711
"380350602","JUJUY",354,333,21,0,0,21,0.940677966101695
"380280407","JUJUY",246,179,19,38,5,62,0.727642276422764
"540910102","MISIONES",272,246,21,2,3,26,0.904411764705882
"380630207","JUJUY",359,345,2,7,0,9,0.96100278551532
"380630420","JUJUY",315,252,8,50,1,59,0.8
"380420613","JUJUY",296,277,5,7,1,13,0.935810810810811
"380420610","JUJUY",353,352,0,0,0,0,0.997167138810198
"380630618","JUJUY",226,181,0,0,0,0,0.800884955752212
"380350113","JUJUY",211,192,7,12,0,19,0.909952606635071
"380280405","JUJUY",190,141,9,35,2,46,0.742105263157895
"380211516","JUJUY",90,88,2,0,0,2,0.977777777777778
"380211508","JUJUY",284,199,66,14,0,80,0.700704225352113
"540281925","MISIONES",382,279,55,47,1,103,0.730366492146597
"380211415","JUJUY",375,332,16,18,1,35,0.885333333333333
"540070605","MISIONES",238,1,162,73,2,237,0.00420168067226891
"380210918","JUJUY",417,411,4,2,0,6,0.985611510791367
"380210917","JUJUY",328,310,13,5,0,18,0.945121951219512
"380210909","JUJUY",245,206,4,5,0,9,0.840816326530612
"381120117","JUJUY",252,45,24,124,19,167,0.178571428571429
"380211009","JUJUY",402,385,11,4,0,15,0.95771144278607
"380211007","JUJUY",352,305,15,25,0,40,0.866477272727273
"380210908","JUJUY",303,276,9,7,0,16,0.910891089108911
"380210826","JUJUY",261,256,3,1,0,4,0.980842911877395
"380210820","JUJUY",143,48,14,76,0,90,0.335664335664336
"380210807","JUJUY",394,381,6,2,0,8,0.967005076142132
"380211409","JUJUY",377,315,11,28,0,39,0.835543766578249
"380211318","JUJUY",204,172,1,0,0,1,0.843137254901961
"380211217","JUJUY",254,187,39,25,0,64,0.736220472440945
"380211206","JUJUY",354,192,132,25,0,157,0.542372881355932
"380211103","JUJUY",316,151,89,71,0,160,0.477848101265823
"380211011","JUJUY",223,198,6,2,0,8,0.887892376681614
"380350512","JUJUY",171,148,19,1,0,20,0.865497076023392
"380210716","JUJUY",439,431,5,2,0,7,0.981776765375854
"380210611","JUJUY",256,136,29,74,0,103,0.53125
"380210817","JUJUY",283,242,19,21,0,40,0.855123674911661
"540070603","MISIONES",278,9,124,97,39,260,0.0323741007194245
"380140409","JUJUY",431,2,235,159,4,398,0.00464037122969838
"380140414","JUJUY",264,8,154,64,6,224,0.0303030303030303
"380140413","JUJUY",321,6,209,93,3,305,0.0186915887850467
"380350516","JUJUY",449,445,4,0,0,4,0.99109131403118
"380350514","JUJUY",314,307,6,0,0,6,0.977707006369427
"380350407","JUJUY",266,163,27,68,2,97,0.612781954887218
"380350505","JUJUY",253,250,1,0,0,1,0.988142292490119
"380350502","JUJUY",293,273,4,2,0,6,0.931740614334471
"380350411","JUJUY",254,193,27,25,3,55,0.759842519685039
"380350410","JUJUY",362,261,61,33,2,96,0.720994475138122
"380350216","JUJUY",165,10,138,12,0,150,0.0606060606060606
"380280413","JUJUY",252,3,97,123,17,237,0.0119047619047619
"380140619","JUJUY",266,164,34,51,1,86,0.616541353383459
"380070110","JUJUY",173,18,55,62,38,155,0.104046242774566
"380210719","JUJUY",294,229,43,21,0,64,0.77891156462585
"380210710","JUJUY",250,225,0,0,0,0,0.9
"380210414","JUJUY",222,112,47,56,1,104,0.504504504504504
"540840606","MISIONES",177,1,68,52,38,158,0.00564971751412429
"380210413","JUJUY",300,102,73,116,5,194,0.34
"380140718","JUJUY",105,5,38,51,0,89,0.0476190476190476
"380140612","JUJUY",276,241,15,1,0,16,0.873188405797101
"380140509","JUJUY",315,69,69,157,0,226,0.219047619047619
"540560612","MISIONES",375,0,47,76,231,354,0
"380630415","JUJUY",402,168,49,112,34,195,0.417910447761194
"380630108","JUJUY",49,31,1,8,2,11,0.63265306122449
"380560204","JUJUY",156,2,101,50,0,151,0.0128205128205128
"380940504","JUJUY",210,40,75,90,2,167,0.19047619047619
"380940404","JUJUY",187,35,103,27,15,145,0.18716577540107
"540981006","MISIONES",266,3,189,61,11,261,0.0112781954887218
"540490309","MISIONES",328,1,132,68,109,309,0.00304878048780488
"380210522","JUJUY",276,79,79,106,0,185,0.286231884057971
"380210508","JUJUY",250,17,83,140,5,228,0.068
"380280504","JUJUY",176,156,1,0,0,1,0.886363636363636
"540840605","MISIONES",100,0,71,10,16,97,0
"380070205","JUJUY",137,25,15,26,64,105,0.182481751824818
"380070103","JUJUY",19,0,1,3,13,17,0
"380210106","JUJUY",180,4,109,56,0,165,0.0222222222222222
"380350202","JUJUY",2,0,1,1,0,2,0
"380280601","JUJUY",40,0,0,16,15,31,0
"380210204","JUJUY",5,0,0,4,1,5,0
"540910718","MISIONES",328,9,229,79,9,317,0.0274390243902439
"380140107","JUJUY",230,16,41,156,5,202,0.0695652173913043
"380070501","JUJUY",79,0,2,3,67,72,0
"541050302","MISIONES",265,0,121,32,90,243,0
"380210202","JUJUY",54,0,16,22,8,46,0
"380490103","JUJUY",13,0,0,10,3,13,0
"380940501","JUJUY",198,5,40,121,23,184,0.0252525252525253
"380700202","JUJUY",169,9,38,74,12,124,0.0532544378698225
"380140504","JUJUY",78,0,13,42,4,59,0
"380140109","JUJUY",182,4,69,87,8,164,0.021978021978022
"540910710","MISIONES",144,4,113,15,10,138,0.0277777777777778
"540840602","MISIONES",109,0,56,21,25,102,0
"540770306","MISIONES",72,0,19,20,28,67,0
"540280413","MISIONES",295,141,21,91,33,145,0.477966101694915
"540280309","MISIONES",245,166,71,6,0,77,0.677551020408163
"540700105","MISIONES",95,0,24,19,40,83,0
"540210602","MISIONES",204,2,80,46,68,194,0.00980392156862745
"380070201","JUJUY",64,2,3,22,22,47,0.03125
"381120201","JUJUY",58,0,0,35,13,48,0
"380980301","JUJUY",49,1,7,30,4,41,0.0204081632653061
"380940201","JUJUY",30,0,1,15,10,26,0
"380630302","JUJUY",59,0,23,18,3,44,0
"380490201","JUJUY",38,0,0,22,15,37,0
"540280404","MISIONES",199,96,91,11,1,103,0.482412060301508
"540840405","MISIONES",217,1,112,43,60,215,0.00460829493087558
"540770603","MISIONES",165,0,94,29,41,164,0
"540770305","MISIONES",107,0,4,9,90,103,0
"540840402","MISIONES",87,0,46,26,12,84,0
"540840104","MISIONES",192,2,23,42,105,170,0.0104166666666667
"540490103","MISIONES",249,1,64,48,106,218,0.00401606425702811
"540420801","MISIONES",148,0,46,35,47,128,0
"540420705","MISIONES",29,0,3,10,16,29,0
"540910213","MISIONES",513,10,196,150,146,492,0.0194931773879142
"540280403","MISIONES",211,136,55,15,3,73,0.644549763033175
"540420603","MISIONES",193,1,29,41,94,164,0.00518134715025907
"540350103","MISIONES",140,0,26,46,47,119,0
"540210603","MISIONES",131,0,93,23,2,118,0
"540910515","MISIONES",328,2,150,104,67,321,0.00609756097560976
"540140906","MISIONES",183,0,26,58,79,163,0
"540070506","MISIONES",100,0,23,36,35,94,0
"540910514","MISIONES",227,9,182,24,5,211,0.039647577092511
"540910511","MISIONES",114,0,109,4,0,113,0
"540280304","MISIONES",226,124,93,9,0,102,0.548672566371681
"540280209","MISIONES",154,148,6,0,0,6,0.961038961038961
"540910114","MISIONES",137,1,54,77,4,135,0.0072992700729927
"540910103","MISIONES",224,207,13,3,1,17,0.924107142857143
"540070503","MISIONES",91,0,27,26,26,79,0
"540070105","MISIONES",140,4,30,54,24,108,0.0285714285714286
"540911012","MISIONES",23,0,4,6,6,16,0
"540281204","MISIONES",73,2,23,36,3,62,0.0273972602739726
"541120511","MISIONES",294,0,161,70,46,277,0
"541050223","MISIONES",181,9,134,25,9,168,0.0497237569060773
"541050222","MISIONES",202,1,156,35,10,201,0.00495049504950495
"540981212","MISIONES",200,0,124,41,21,186,0
"540840908","MISIONES",249,105,120,16,1,137,0.421686746987952
"540560611","MISIONES",352,0,18,79,204,301,0
"540840108","MISIONES",275,3,192,45,31,268,0.0109090909090909
"540770802","MISIONES",115,42,54,19,0,73,0.365217391304348
"540770801","MISIONES",284,153,92,22,1,115,0.538732394366197
"540770407","MISIONES",265,6,199,59,1,259,0.0226415094339623
"540280202","MISIONES",230,225,5,0,0,5,0.978260869565217
"540770110","MISIONES",370,1,293,48,26,367,0.0027027027027027
"540770108","MISIONES",386,125,116,112,24,252,0.323834196891192
"540700801","MISIONES",230,2,158,47,8,213,0.00869565217391304
"540700709","MISIONES",185,0,151,20,10,181,0
"540700504","MISIONES",214,1,117,53,29,199,0.00467289719626168
"540700309","MISIONES",397,4,118,88,140,346,0.0100755667506297
"540700307","MISIONES",289,4,177,52,9,238,0.013840830449827
"540631112","MISIONES",278,211,17,18,0,35,0.758992805755396
"540631109","MISIONES",227,1,130,73,7,210,0.00440528634361234
"540631104","MISIONES",394,90,222,68,5,295,0.228426395939086
"540631014","MISIONES",387,20,230,85,31,346,0.0516795865633075
"540420602","MISIONES",262,22,156,48,31,235,0.083969465648855
"540630912","MISIONES",214,0,102,81,29,212,0
"540630910","MISIONES",204,0,67,66,50,183,0
"540630906","MISIONES",254,2,174,64,11,249,0.0078740157480315
"540630801","MISIONES",181,0,73,42,63,178,0
"540630408","MISIONES",257,1,201,37,17,255,0.00389105058365759
"540630406","MISIONES",342,10,97,100,69,266,0.0292397660818713
"540560210","MISIONES",285,1,85,112,76,273,0.00350877192982456
"540490207","MISIONES",189,1,101,69,16,186,0.00529100529100529
"540490108","MISIONES",331,3,101,102,98,301,0.00906344410876133
"540490105","MISIONES",559,2,138,143,223,504,0.0035778175313059
"540420710","MISIONES",183,18,99,24,34,157,0.0983606557377049
"540420519","MISIONES",211,2,158,30,8,196,0.00947867298578199
"540420403","MISIONES",316,2,207,80,18,305,0.00632911392405063
"540420107","MISIONES",298,7,149,76,45,270,0.023489932885906
"540281013","MISIONES",225,155,51,1,0,52,0.688888888888889
"540281007","MISIONES",195,140,49,6,0,55,0.717948717948718
"540281002","MISIONES",202,180,18,4,0,22,0.891089108910891
"540280822","MISIONES",167,10,121,34,0,155,0.0598802395209581
"540281316","MISIONES",287,17,249,4,0,253,0.0592334494773519
"540280812","MISIONES",448,9,353,58,8,419,0.0200892857142857
"540280810","MISIONES",364,10,196,103,40,339,0.0274725274725275
"540280806","MISIONES",274,201,58,8,1,67,0.733576642335766
"540280720","MISIONES",275,6,151,74,32,257,0.0218181818181818
"540280718","MISIONES",227,104,77,34,1,112,0.458149779735683
"540280714","MISIONES",353,7,201,105,3,309,0.0198300283286119
"540280616","MISIONES",215,33,55,78,34,167,0.153488372093023
"540280611","MISIONES",300,5,237,50,5,292,0.0166666666666667
"540280419","MISIONES",373,269,74,16,1,91,0.721179624664879
"540280418","MISIONES",250,138,52,33,21,106,0.552
"540280307","MISIONES",436,202,178,54,1,233,0.463302752293578
"540280216","MISIONES",128,118,6,4,0,10,0.921875
"540210704","MISIONES",261,2,150,47,53,250,0.00766283524904215
"540420413","MISIONES",256,0,185,56,15,256,0
"540282417","MISIONES",55,44,9,2,0,11,0.8
"540282413","MISIONES",215,194,5,1,0,6,0.902325581395349
"540282405","MISIONES",267,254,0,1,0,1,0.951310861423221
"540282308","MISIONES",230,62,119,44,0,163,0.269565217391304
"540282306","MISIONES",322,21,140,140,11,291,0.0652173913043478
"540282208","MISIONES",247,36,195,15,0,210,0.145748987854251
"540282016","MISIONES",340,100,160,66,10,236,0.294117647058824
"540282013","MISIONES",237,5,125,55,11,191,0.0210970464135021
"540281923","MISIONES",525,205,245,63,8,316,0.39047619047619
"540281912","MISIONES",412,110,216,83,2,301,0.266990291262136
"540281811","MISIONES",312,4,204,62,15,281,0.0128205128205128
"540281808","MISIONES",187,14,118,50,2,170,0.0748663101604278
"540281321","MISIONES",176,2,151,23,0,174,0.0113636363636364
"540210515","MISIONES",257,23,183,35,1,219,0.0894941634241245
"540210510","MISIONES",247,17,145,68,12,225,0.0688259109311741
"540210509","MISIONES",284,10,187,65,15,267,0.0352112676056338
"540210508","MISIONES",266,6,238,12,9,259,0.0225563909774436
"540140210","MISIONES",312,7,174,69,37,280,0.0224358974358974
"540140209","MISIONES",306,0,118,97,81,296,0
"540140206","MISIONES",158,0,126,31,0,157,0
"540140204","MISIONES",199,1,80,46,66,192,0.0050251256281407
"540070618","MISIONES",262,10,219,33,0,252,0.0381679389312977
"540070610","MISIONES",226,1,186,37,2,225,0.00442477876106195
"540070107","MISIONES",206,0,84,46,61,191,0
"540281908","MISIONES",381,376,4,1,0,5,0.986876640419947
"540141006","MISIONES",136,1,66,48,14,128,0.00735294117647059
"540070606","MISIONES",282,31,162,66,18,246,0.109929078014184
"540280803","MISIONES",325,10,183,71,43,297,0.0307692307692308
"540560501","MISIONES",299,0,28,53,144,225,0
"540420418","MISIONES",298,0,189,31,43,263,0
"541190101","MISIONES",219,0,35,52,108,195,0
"541120702","MISIONES",370,0,8,144,161,313,0
"540420317","MISIONES",285,5,158,52,41,251,0.0175438596491228
"540980201","MISIONES",27,0,4,9,14,27,0
"541190304","MISIONES",130,0,13,61,50,124,0
"540980204","MISIONES",43,0,10,9,23,42,0
"541120102","MISIONES",791,0,62,317,286,665,0
"541050403","MISIONES",128,0,9,27,76,112,0
"541050208","MISIONES",87,1,20,19,40,79,0.0114942528735632
"541050207","MISIONES",131,2,31,27,57,115,0.0152671755725191
"540980904","MISIONES",234,0,52,50,118,220,0
"540980301","MISIONES",61,0,21,9,23,53,0
"540420405","MISIONES",416,4,291,44,44,379,0.00961538461538462
"540910505","MISIONES",80,0,12,17,43,72,0
"540910504","MISIONES",82,0,10,11,51,72,0
"540560205","MISIONES",289,1,9,19,210,238,0.00346020761245675
"540490112","MISIONES",202,0,24,67,76,167,0
"540420312","MISIONES",162,0,142,12,7,161,0
"540420904","MISIONES",24,0,3,6,6,15,0
"540490201","MISIONES",113,0,14,39,56,109,0
"540281303","MISIONES",68,2,35,27,3,65,0.0294117647058824
"540282416","MISIONES",356,348,3,0,0,3,0.97752808988764
"540420604","MISIONES",40,2,12,7,16,35,0.05
"540420102","MISIONES",105,0,22,26,45,93,0
"540350402","MISIONES",43,0,8,10,21,39,0
"540281203","MISIONES",44,2,6,24,10,40,0.0454545454545455
"540210301","MISIONES",41,0,4,12,3,19,0
"540911206","MISIONES",84,0,15,26,28,69,0
"540210701","MISIONES",63,0,10,9,29,48,0
"540350206","MISIONES",11,0,1,3,6,10,0
"540350106","MISIONES",12,0,2,8,0,10,0
"540282103","MISIONES",24,0,4,14,2,20,0
"540282101","MISIONES",6,0,2,2,1,5,0
"540281401","MISIONES",312,2,143,113,34,290,0.00641025641025641
"540840204","MISIONES",1,0,0,0,1,1,0
"540141002","MISIONES",149,2,62,40,25,127,0.0134228187919463
"540140802","MISIONES",110,1,26,49,23,98,0.00909090909090909
"540070501","MISIONES",25,0,9,11,3,23,0
"540070404","MISIONES",28,0,0,13,5,18,0
"540700306","MISIONES",266,1,32,109,62,203,0.0037593984962406
"540700301","MISIONES",131,0,32,42,37,111,0
"540280310","MISIONES",288,251,26,8,2,36,0.871527777777778
"540420308","MISIONES",141,0,25,25,68,118,0
"540281208","MISIONES",319,3,143,135,25,303,0.00940438871473354
"540070307","MISIONES",46,0,14,7,9,30,0
"540070305","MISIONES",59,0,10,26,16,52,0
"540070302","MISIONES",115,7,28,35,37,100,0.0608695652173913
"540700103","MISIONES",21,0,2,1,16,19,0
"540630903","MISIONES",12,0,3,1,8,12,0
"540700204","MISIONES",58,0,5,15,33,53,0
"540420408","MISIONES",178,1,107,26,34,167,0.00561797752808989
"540070301","MISIONES",34,0,5,20,6,31,0
"540070202","MISIONES",25,0,6,1,13,20,0
"540630104","MISIONES",2,2,0,0,0,0,1
"540630103","MISIONES",2,0,1,0,0,1,0
"540280409","MISIONES",277,165,76,32,2,110,0.595667870036101
"540840701","MISIONES",37,0,1,10,18,29,0
"540840603","MISIONES",79,0,26,18,29,73,0
"540560802","MISIONES",509,1,61,84,325,470,0.00196463654223969
"540210401","MISIONES",106,31,13,36,18,67,0.292452830188679
"540770205","MISIONES",131,0,41,42,40,123,0
"540560603","MISIONES",471,1,56,147,238,441,0.00212314225053079
"540910403","MISIONES",220,0,45,107,47,199,0
"540770204","MISIONES",11,0,4,5,1,10,0
"540700501","MISIONES",113,0,13,23,59,95,0
"540630704","MISIONES",53,0,4,34,8,46,0
"540910508","MISIONES",108,0,28,27,52,107,0
"541120701","MISIONES",18,0,0,2,12,14,0
"540420706","MISIONES",24,0,4,1,18,23,0
"540350307","MISIONES",16,0,0,10,5,15,0
"540282305","MISIONES",430,206,155,56,7,218,0.47906976744186
"540630302","MISIONES",80,0,14,31,29,74,0
"541120703","MISIONES",659,0,132,153,300,585,0
"540981004","MISIONES",223,2,106,30,48,184,0.00896860986547085
"540911011","MISIONES",47,2,21,15,9,45,0.0425531914893617
"540770403","MISIONES",65,0,34,7,6,47,0
"540560902","MISIONES",631,19,317,215,67,599,0.0301109350237718
"540282303","MISIONES",343,116,208,13,1,222,0.338192419825073
"540770101","MISIONES",296,112,59,72,43,174,0.378378378378378
"540490203","MISIONES",614,0,60,114,340,514,0
"540560801","MISIONES",527,2,63,153,248,464,0.00379506641366224
"540490202","MISIONES",478,0,63,115,275,453,0
"540420704","MISIONES",129,0,49,17,55,121,0
"540350301","MISIONES",98,0,64,13,14,91,0
"540980207","MISIONES",327,6,209,58,47,314,0.018348623853211
"540911311","MISIONES",365,128,92,66,76,234,0.350684931506849
"540911306","MISIONES",252,6,175,58,9,242,0.0238095238095238
"540210202","MISIONES",250,2,67,62,97,226,0.008
"540281601","MISIONES",475,0,53,167,195,415,0
"540910707","MISIONES",250,2,81,76,56,213,0.008
"540140510","MISIONES",121,0,101,4,0,105,0
"541050214","MISIONES",255,5,185,36,20,241,0.0196078431372549
"540980515","MISIONES",180,1,151,23,3,177,0.00555555555555556
"540281301","MISIONES",110,3,38,18,24,80,0.0272727272727273
"540631008","MISIONES",346,34,194,99,7,300,0.0982658959537572
"540911008","MISIONES",154,0,60,41,47,148,0
"540910715","MISIONES",373,256,62,47,5,114,0.686327077747989
"540910714","MISIONES",269,87,10,70,81,161,0.323420074349442
"540910512","MISIONES",265,3,224,30,7,261,0.0113207547169811
"540910201","MISIONES",466,3,178,164,112,454,0.00643776824034335
"540910117","MISIONES",350,35,122,127,57,306,0.1
"540910110","MISIONES",203,176,20,6,1,27,0.866995073891626
"540840906","MISIONES",267,17,181,38,23,242,0.0636704119850187
"540840909","MISIONES",340,54,109,86,77,272,0.158823529411765
"540840409","MISIONES",220,2,92,69,54,215,0.00909090909090909
"540560911","MISIONES",214,1,104,72,18,194,0.00467289719626168
"540840102","MISIONES",285,1,172,57,44,273,0.00350877192982456
"540770808","MISIONES",114,73,40,1,0,41,0.640350877192982
"540700705","MISIONES",231,48,156,22,5,183,0.207792207792208
"540700704","MISIONES",280,7,179,60,11,250,0.025
"540700316","MISIONES",238,3,213,20,2,235,0.0126050420168067
"540700315","MISIONES",202,9,118,38,29,185,0.0445544554455446
"540700308","MISIONES",401,0,97,91,195,383,0
"540631107","MISIONES",376,11,192,139,3,334,0.0292553191489362
"540631003","MISIONES",429,146,103,136,11,250,0.34032634032634
"540630909","MISIONES",238,1,131,53,49,233,0.00420168067226891
"540490308","MISIONES",227,100,63,62,0,125,0.440528634361233
"540420614","MISIONES",317,10,220,40,47,307,0.0315457413249211
"540420611","MISIONES",142,0,47,27,58,132,0
"540420520","MISIONES",230,114,110,3,2,115,0.495652173913044
"540280815","MISIONES",226,0,69,113,40,222,0
"540280811","MISIONES",269,27,157,79,5,241,0.100371747211896
"540280716","MISIONES",340,14,208,106,1,315,0.0411764705882353
"540280610","MISIONES",172,6,153,12,0,165,0.0348837209302326
"540280609","MISIONES",299,131,135,24,6,165,0.438127090301003
"540280511","MISIONES",287,79,125,80,1,206,0.275261324041812
"540280510","MISIONES",109,11,76,20,0,96,0.100917431192661
"540280504","MISIONES",169,11,108,33,16,157,0.0650887573964497
"540280415","MISIONES",252,104,110,34,0,144,0.412698412698413
"540281909","MISIONES",349,345,2,1,0,3,0.988538681948424
"540281904","MISIONES",314,16,105,157,25,287,0.0509554140127389
"540070611","MISIONES",260,3,225,31,1,257,0.0115384615384615
"540070602","MISIONES",296,6,197,68,10,275,0.0202702702702703
"540281902","MISIONES",173,15,118,39,0,157,0.0867052023121387
"540281818","MISIONES",251,3,184,60,4,248,0.0119521912350598
"540281812","MISIONES",233,37,116,47,7,170,0.158798283261803
"540281805","MISIONES",209,83,73,41,7,121,0.397129186602871
"540281312","MISIONES",342,10,217,86,21,324,0.0292397660818713
"540281307","MISIONES",146,7,45,75,14,134,0.0479452054794521
"540210518","MISIONES",124,0,29,21,66,116,0
"540280106","MISIONES",105,4,78,20,1,99,0.0380952380952381
"540140807","MISIONES",181,2,153,26,0,179,0.0110497237569061
"540140508","MISIONES",294,1,156,95,25,276,0.00340136054421769
"540140506","MISIONES",227,1,117,56,45,218,0.00440528634361234
"540140202","MISIONES",230,4,132,70,21,223,0.0173913043478261
"540140111","MISIONES",335,3,72,53,183,308,0.00895522388059702
"540770602","MISIONES",362,0,259,61,34,354,0
"540700312","MISIONES",198,13,167,18,0,185,0.0656565656565657
"540700208","MISIONES",251,24,76,86,52,214,0.0956175298804781
"540560613","MISIONES",398,1,72,153,155,380,0.00251256281407035
"541120704","MISIONES",136,0,35,42,47,124,0
"541120106","MISIONES",89,0,28,22,32,82,0
"540981208","MISIONES",338,0,132,117,63,312,0
"540490114","MISIONES",295,2,63,109,105,277,0.00677966101694915
"540421007","MISIONES",108,0,63,33,4,100,0
"540140512","MISIONES",190,16,119,38,5,162,0.0842105263157895
"540070316","MISIONES",308,5,268,14,0,282,0.0162337662337662
"540070311","MISIONES",260,225,32,3,0,35,0.865384615384615
"540070110","MISIONES",145,0,13,63,61,137,0
"541190603","MISIONES",113,0,19,14,73,106,0
"541190402","MISIONES",267,0,29,66,156,251,0
"540420313","MISIONES",182,21,126,14,15,155,0.115384615384615
"541190305","MISIONES",165,1,26,63,69,158,0.00606060606060606
"540980508","MISIONES",30,0,6,13,11,30,0
"540911105","MISIONES",78,0,14,30,27,71,0
"540911102","MISIONES",82,0,3,16,57,76,0
"540910214","MISIONES",242,5,37,95,66,198,0.0206611570247934
"540910212","MISIONES",264,2,115,96,41,252,0.00757575757575758
"180210312","CORRIENTES",293,272,11,7,0,18,0.928327645051195
"540630815","MISIONES",386,0,264,90,25,379,0
"540281309","MISIONES",155,1,94,38,7,139,0.00645161290322581
"540210507","MISIONES",264,6,176,55,12,243,0.0227272727272727
"541190303","MISIONES",267,0,24,89,142,255,0
"541120601","MISIONES",230,0,28,34,159,221,0
"540910208","MISIONES",302,8,180,91,16,287,0.0264900662251656
"540070317","MISIONES",161,0,59,61,27,147,0
"541120505","MISIONES",340,0,42,91,171,304,0
"541050402","MISIONES",186,0,17,74,85,176,0
"541050301","MISIONES",44,0,6,2,30,38,0
"540910207","MISIONES",389,252,114,22,1,137,0.647814910025707
"540910116","MISIONES",507,184,157,106,54,317,0.362919132149901
"541050212","MISIONES",56,0,4,14,30,48,0
"540980906","MISIONES",82,0,4,14,48,66,0
"540911013","MISIONES",86,0,2,6,69,77,0
"540911002","MISIONES",124,0,4,42,51,97,0
"540911107","MISIONES",65,0,7,16,25,48,0
"540910808","MISIONES",126,0,18,33,68,119,0
"540560204","MISIONES",142,0,16,34,77,127,0
"540560503","MISIONES",1,0,1,0,0,1,0
"540350101","MISIONES",67,0,13,21,29,63,0
"540840607","MISIONES",227,17,34,40,111,185,0.0748898678414097
"540840314","MISIONES",200,56,115,26,3,144,0.28
"540560909","MISIONES",285,8,54,132,75,261,0.0280701754385965
"540560301","MISIONES",435,1,11,61,249,321,0.00229885057471264
"540910302","MISIONES",81,0,13,14,38,65,0
"540282408","MISIONES",366,351,8,0,0,8,0.959016393442623
"540420707","MISIONES",11,0,2,1,5,8,0
"540420606","MISIONES",81,0,17,31,32,80,0
"540420304","MISIONES",76,0,45,9,17,71,0
"540840502","MISIONES",49,0,0,6,15,21,0
"540840501","MISIONES",34,0,6,10,12,28,0
"540282309","MISIONES",281,10,201,45,2,248,0.0355871886120996
"540420202","MISIONES",0,0,0,0,0,0,NA
"540840308","MISIONES",25,0,6,0,17,23,0
"540282307","MISIONES",273,92,160,19,0,179,0.336996336996337
"540420201","MISIONES",1,0,0,0,1,1,0
"540420105","MISIONES",22,0,3,8,11,22,0
"540420103","MISIONES",61,0,2,17,38,57,0
"540350204","MISIONES",26,0,0,2,16,18,0
"540770303","MISIONES",44,0,14,6,23,43,0
"540281502","MISIONES",55,0,23,25,6,54,0
"540281403","MISIONES",1,0,0,1,0,1,0
"540210604","MISIONES",37,0,11,6,13,30,0
"540210203","MISIONES",37,0,2,3,32,37,0
"540141004","MISIONES",111,0,13,35,61,109,0
"540140905","MISIONES",83,0,10,7,60,77,0
"540210302","MISIONES",47,0,4,15,22,41,0
"540140803","MISIONES",52,0,2,22,26,50,0
"540282211","MISIONES",234,129,93,12,0,105,0.551282051282051
"540140304","MISIONES",168,0,23,43,96,162,0
"540070306","MISIONES",46,0,12,20,13,45,0
"540070101","MISIONES",39,0,9,18,9,36,0
"540140403","MISIONES",97,1,10,47,35,92,0.0103092783505155
"540840201","MISIONES",57,0,7,13,34,54,0
"540770501","MISIONES",125,0,4,26,19,49,0
"540980403","MISIONES",49,0,11,8,28,47,0
"540282015","MISIONES",282,2,83,114,51,248,0.00709219858156028
"540770302","MISIONES",170,0,24,9,104,137,0
"540770106","MISIONES",44,0,9,12,21,42,0
"540700404","MISIONES",93,0,6,8,71,85,0
"540700303","MISIONES",87,0,30,23,33,86,0
"540700205","MISIONES",227,0,32,78,104,214,0
"540700203","MISIONES",68,0,8,22,32,62,0
"540630807","MISIONES",43,0,14,9,17,40,0
"540560610","MISIONES",355,1,115,85,144,344,0.0028169014084507
"540630705","MISIONES",25,0,0,6,19,25,0
"540630701","MISIONES",7,0,0,0,7,7,0
"540282014","MISIONES",213,0,176,34,1,211,0
"540630502","MISIONES",22,0,3,2,7,12,0
"540630301","MISIONES",59,0,0,0,51,51,0
"540630105","MISIONES",191,0,2,63,109,174,0
"540840907","MISIONES",364,57,194,60,23,277,0.156593406593407
"540840304","MISIONES",356,74,177,46,43,266,0.207865168539326
"540630911","MISIONES",215,2,120,38,28,186,0.00930232558139535
"540560607","MISIONES",236,2,10,56,153,219,0.00847457627118644
"540560604","MISIONES",585,0,89,193,263,545,0
"540910402","MISIONES",140,0,30,31,66,127,0
"541190302","MISIONES",407,0,26,180,132,338,0
"540560308","MISIONES",235,0,18,58,123,199,0
"540560202","MISIONES",176,0,24,62,80,166,0
"540840101","MISIONES",89,1,67,11,8,86,0.0112359550561798
"540770809","MISIONES",219,101,97,19,1,117,0.461187214611872
"541050209","MISIONES",386,5,103,140,81,324,0.0129533678756477
"540911001","MISIONES",260,0,21,78,131,230,0
"540770807","MISIONES",239,149,61,6,2,69,0.623430962343096
"540840910","MISIONES",192,109,61,6,0,67,0.567708333333333
"540282011","MISIONES",472,161,124,142,15,281,0.341101694915254
"540910902","MISIONES",215,0,17,103,91,211,0
"540910709","MISIONES",113,58,6,33,10,49,0.513274336283186
"540910705","MISIONES",133,0,39,49,41,129,0
"540910601","MISIONES",167,1,56,38,70,164,0.00598802395209581
"540770405","MISIONES",245,1,203,38,0,241,0.00408163265306122
"540770703","MISIONES",314,1,97,62,60,219,0.00318471337579618
"540770105","MISIONES",407,4,190,148,49,387,0.00982800982800983
"540280101","MISIONES",181,145,3,27,3,33,0.801104972375691
"540421001","MISIONES",275,2,32,19,178,229,0.00727272727272727
"540840305","MISIONES",193,77,91,18,1,110,0.398963730569948
"540700806","MISIONES",322,6,263,24,3,290,0.0186335403726708
"540700314","MISIONES",203,1,116,44,28,188,0.00492610837438424
"540700311","MISIONES",314,1,182,51,44,277,0.00318471337579618
"540281501","MISIONES",78,0,67,11,0,78,0
"540281305","MISIONES",95,0,51,27,8,86,0
"540210503","MISIONES",39,0,20,6,7,33,0
"540630918","MISIONES",167,4,128,22,10,160,0.0239520958083832
"540281102","MISIONES",110,4,60,33,5,98,0.0363636363636364
"540911304","MISIONES",265,3,59,132,57,248,0.0113207547169811
"540210501","MISIONES",111,1,64,30,7,101,0.00900900900900901
"540210102","MISIONES",124,2,78,20,20,118,0.0161290322580645
"540910713","MISIONES",273,3,73,72,111,256,0.010989010989011
"540910516","MISIONES",164,1,38,46,67,151,0.00609756097560976
"540910510","MISIONES",71,1,13,15,37,65,0.0140845070422535
"540630404","MISIONES",64,0,4,6,43,53,0
"541120504","MISIONES",253,0,88,75,74,237,0
"541050216","MISIONES",222,3,152,38,19,209,0.0135135135135135
"540981213","MISIONES",171,1,158,10,0,168,0.00584795321637427
"540981207","MISIONES",230,2,137,26,30,193,0.00869565217391304
"540981206","MISIONES",251,12,173,13,14,200,0.047808764940239
"540981205","MISIONES",367,2,61,93,191,345,0.00544959128065395
"540981201","MISIONES",148,2,141,4,1,146,0.0135135135135135
"540981005","MISIONES",235,4,174,36,6,216,0.0170212765957447
"540980518","MISIONES",225,4,209,4,0,213,0.0177777777777778
"540980517","MISIONES",115,0,12,32,56,100,0
"540980507","MISIONES",212,1,54,75,72,201,0.00471698113207547
"540630812","MISIONES",264,0,90,102,60,252,0
"540630804","MISIONES",164,0,90,42,30,162,0
"540630802","MISIONES",442,5,233,92,31,356,0.0113122171945701
"540631010","MISIONES",175,24,69,59,3,131,0.137142857142857
"540490107","MISIONES",334,13,280,34,7,321,0.0389221556886228
"540420613","MISIONES",507,39,239,75,140,454,0.0769230769230769
"540631011","MISIONES",227,5,55,113,27,195,0.0220264317180617
"540420401","MISIONES",222,1,135,61,23,219,0.0045045045045045
"540420307","MISIONES",341,193,87,9,15,111,0.565982404692082
"540281211","MISIONES",424,385,23,0,0,23,0.908018867924528
"540281201","MISIONES",440,262,70,61,11,142,0.595454545454545
"540281004","MISIONES",396,210,162,23,0,185,0.53030303030303
"540280813","MISIONES",231,0,130,94,0,224,0
"540280805","MISIONES",228,8,174,41,4,219,0.0350877192982456
"540280608","MISIONES",235,143,78,12,0,90,0.608510638297872
"540280505","MISIONES",255,17,189,46,1,236,0.0666666666666667
"540280302","MISIONES",298,149,97,47,2,146,0.5
"540280208","MISIONES",232,232,0,0,0,0,1
"540280118","MISIONES",147,126,13,7,0,20,0.857142857142857
"540280117","MISIONES",206,186,15,5,0,20,0.902912621359223
"540280102","MISIONES",234,19,59,115,19,193,0.0811965811965812
"540281822","MISIONES",203,2,181,16,4,201,0.00985221674876847
"540281807","MISIONES",360,6,187,125,34,346,0.0166666666666667
"540281319","MISIONES",479,16,448,15,0,463,0.0334029227557411
"540282006","MISIONES",312,8,239,51,1,291,0.0256410256410256
"540280108","MISIONES",212,28,169,15,0,184,0.132075471698113
"540140308","MISIONES",124,4,51,36,33,120,0.032258064516129
"540140211","MISIONES",321,6,85,122,98,305,0.0186915887850467
"540070613","MISIONES",331,1,207,100,22,329,0.00302114803625378
"540070612","MISIONES",223,2,153,37,26,216,0.00896860986547085
"540070313","MISIONES",301,6,290,5,0,295,0.0199335548172757
"540281216","MISIONES",381,198,58,83,23,164,0.519685039370079
"540840313","MISIONES",158,0,21,57,73,151,0
"540840109","MISIONES",311,6,167,67,57,291,0.0192926045016077
"541120513","MISIONES",214,0,161,38,13,212,0
"541120509","MISIONES",248,0,66,68,91,225,0
"540560209","MISIONES",186,0,76,54,52,182,0
"540490311","MISIONES",248,1,74,127,37,238,0.00403225806451613
"540490310","MISIONES",210,5,21,60,88,169,0.0238095238095238
"540350414","MISIONES",243,0,104,76,53,233,0
"540282201","MISIONES",205,11,143,47,0,190,0.0536585365853659
"540630405","MISIONES",218,8,111,45,50,206,0.036697247706422
"540140103","MISIONES",299,3,128,63,58,249,0.0100334448160535
"540281209","MISIONES",376,14,117,171,40,328,0.0372340425531915
"540281206","MISIONES",317,155,103,45,3,151,0.488958990536278
"540981101","MISIONES",56,0,16,4,7,27,0
"540911312","MISIONES",330,103,102,48,59,209,0.312121212121212
"540280407","MISIONES",290,156,116,12,4,132,0.537931034482759
"540910603","MISIONES",85,0,26,32,26,84,0
"540420407","MISIONES",353,1,174,99,60,333,0.0028328611898017
"541190602","MISIONES",188,1,34,85,41,160,0.00531914893617021
"541190506","MISIONES",118,0,21,25,60,106,0
"540910805","MISIONES",148,2,16,56,59,131,0.0135135135135135
"540280206","MISIONES",246,206,36,4,0,40,0.83739837398374
"541190204","MISIONES",137,0,18,38,78,134,0
"540420410","MISIONES",319,3,124,49,107,280,0.00940438871473354
"541120401","MISIONES",1,0,0,0,0,0,0
"541120201","MISIONES",5,0,0,0,1,1,0
"541050203","MISIONES",92,0,18,33,27,78,0
"540280705","MISIONES",286,136,130,18,1,149,0.475524475524476
"541050103","MISIONES",185,0,24,32,108,164,0
"541050101","MISIONES",77,0,17,7,45,69,0
"540281815","MISIONES",314,298,6,0,0,6,0.949044585987261
"540980803","MISIONES",118,0,29,39,38,106,0
"540980605","MISIONES",13,0,7,0,3,10,0
"540980303","MISIONES",99,0,24,16,56,96,0
"540980205","MISIONES",31,0,6,1,24,31,0
"540911204","MISIONES",15,0,2,5,6,13,0
"540911004","MISIONES",37,0,6,8,21,35,0
"540560302","MISIONES",224,0,13,50,127,190,0
"540560203","MISIONES",99,0,23,41,24,88,0
"540210403","MISIONES",18,1,4,7,3,14,0.0555555555555556
"540070304","MISIONES",104,1,24,35,27,86,0.00961538461538462
"540560103","MISIONES",230,0,18,45,131,194,0
"540490401","MISIONES",423,0,0,81,271,352,0
"540281814","MISIONES",341,263,23,3,0,26,0.771260997067449
"540490110","MISIONES",135,0,41,33,50,124,0
"540421004","MISIONES",21,0,1,5,13,19,0
"540350308","MISIONES",26,0,0,13,13,26,0
"540281320","MISIONES",181,6,164,10,0,174,0.0331491712707182
"540420902","MISIONES",9,0,1,0,6,7,0
"540350304","MISIONES",49,0,2,14,19,35,0
"540350302","MISIONES",6,0,4,2,0,6,0
"540281304","MISIONES",7,1,6,0,0,6,0.142857142857143
"540070308","MISIONES",29,0,6,9,10,25,0
"540420806","MISIONES",6,0,0,0,6,6,0
"540350407","MISIONES",11,0,0,8,1,9,0
"540210304","MISIONES",37,0,6,13,12,31,0
"540210201","MISIONES",39,0,6,7,23,36,0
"540140805","MISIONES",67,0,5,12,40,57,0
"540910717","MISIONES",272,0,104,89,77,270,0
"540910217","MISIONES",206,193,10,3,0,13,0.936893203883495
"540281317","MISIONES",167,0,90,47,23,160,0
"540140602","MISIONES",267,0,22,25,175,222,0
"540140402","MISIONES",71,0,18,26,27,71,0
"540140401","MISIONES",136,0,25,45,40,110,0
"540070505","MISIONES",6,0,0,4,2,6,0
"540070402","MISIONES",87,0,17,30,34,81,0
"540280203","MISIONES",304,280,13,6,0,19,0.921052631578947
"540840406","MISIONES",11,0,2,1,7,10,0
"540910203","MISIONES",270,49,119,76,26,221,0.181481481481481
"540910109","MISIONES",254,228,16,10,0,26,0.897637795275591
"540910107","MISIONES",314,11,81,161,37,279,0.035031847133758
"540630107","MISIONES",274,0,95,145,23,263,0
"540560614","MISIONES",239,0,26,79,124,229,0
"820842808","SANTA FE",214,213,0,1,0,1,0.995327102803738
"540420406","MISIONES",414,7,275,86,26,387,0.0169082125603865
"540420404","MISIONES",276,5,211,52,6,269,0.0181159420289855
"540840404","MISIONES",38,0,5,10,18,33,0
"540630504","MISIONES",42,0,3,3,17,23,0
"540630819","MISIONES",311,1,86,90,83,259,0.00321543408360129
"540770404","MISIONES",310,3,234,66,6,306,0.00967741935483871
"540770206","MISIONES",24,0,2,13,7,22,0
"540700401","MISIONES",79,0,5,35,33,73,0
"540700202","MISIONES",152,0,19,107,20,146,0
"540700102","MISIONES",62,0,5,10,33,48,0
"540630810","MISIONES",67,1,10,18,37,65,0.0149253731343284
"541050306","MISIONES",61,0,4,9,39,52,0
"540630202","MISIONES",1,0,1,0,0,1,0
"540140605","MISIONES",112,0,14,16,66,96,0
"540140603","MISIONES",84,1,10,13,57,80,0.0119047619047619
"540070201","MISIONES",40,0,3,15,22,40,0
"540910806","MISIONES",32,0,10,7,14,31,0
"541190403","MISIONES",417,0,87,151,135,373,0
"540980701","MISIONES",155,0,46,42,44,132,0
"540770109","MISIONES",232,79,83,60,6,149,0.34051724137931
"540560709","MISIONES",265,0,21,49,139,209,0
"540560706","MISIONES",68,0,11,16,31,58,0
"540560703","MISIONES",53,0,8,15,27,50,0
"540281302","MISIONES",70,0,34,16,19,69,0
"540560606","MISIONES",134,0,7,8,109,124,0
"540560704","MISIONES",59,0,17,12,25,54,0
"541190501","MISIONES",96,0,11,19,58,88,0
"540980511","MISIONES",154,1,37,69,38,144,0.00649350649350649
"540980202","MISIONES",352,8,166,76,62,304,0.0227272727272727
"540911203","MISIONES",111,2,42,60,6,108,0.018018018018018
"540911005","MISIONES",159,0,26,43,53,122,0
"540700802","MISIONES",285,3,182,69,13,264,0.0105263157894737
"540490306","MISIONES",159,0,32,60,51,143,0
"540490305","MISIONES",252,9,45,89,88,222,0.0357142857142857
"540070403","MISIONES",163,3,26,70,39,135,0.0184049079754601
"540980104","MISIONES",301,2,145,65,65,275,0.00664451827242525
"540490102","MISIONES",531,15,81,101,285,467,0.0282485875706215
"540490101","MISIONES",369,0,56,126,154,336,0
"540282401","MISIONES",315,4,248,55,6,309,0.0126984126984127
"540282312","MISIONES",342,75,114,119,24,257,0.219298245614035
"540420702","MISIONES",130,1,35,18,69,122,0.00769230769230769
"540420701","MISIONES",265,0,76,36,126,238,0
"540420605","MISIONES",109,1,29,9,44,82,0.00917431192660551
"541120515","MISIONES",241,0,55,42,134,231,0
"540210502","MISIONES",57,1,7,36,13,56,0.0175438596491228
"540140801","MISIONES",151,2,55,70,16,141,0.0132450331125828
"541120503","MISIONES",224,0,118,43,55,216,0
"541050215","MISIONES",168,3,78,51,25,154,0.0178571428571429
"541050112","MISIONES",87,0,57,11,12,80,0
"540981211","MISIONES",231,2,201,24,4,229,0.00865800865800866
"540981011","MISIONES",298,7,210,21,38,269,0.023489932885906
"540980903","MISIONES",234,9,183,27,13,223,0.0384615384615385
"540980512","MISIONES",89,1,31,23,28,82,0.0112359550561798
"540631108","MISIONES",275,27,159,68,1,228,0.0981818181818182
"540140201","MISIONES",119,0,19,41,25,85,0
"540631012","MISIONES",252,4,114,90,5,209,0.0158730158730159
"540631102","MISIONES",384,10,163,128,51,342,0.0260416666666667
"540631013","MISIONES",348,7,156,140,24,320,0.0201149425287356
"540631007","MISIONES",187,3,96,46,27,169,0.0160427807486631
"540631002","MISIONES",402,225,100,60,1,161,0.559701492537313
"540630814","MISIONES",443,4,283,108,37,428,0.0090293453724605
"540631009","MISIONES",199,4,66,74,10,150,0.0201005025125628
"540490304","MISIONES",253,5,152,64,13,229,0.0197628458498024
"540490106","MISIONES",232,0,102,52,74,228,0
"540420402","MISIONES",333,4,174,80,64,318,0.012012012012012
"540420305","MISIONES",474,4,317,114,19,450,0.00843881856540084
"540281202","MISIONES",166,135,11,18,0,29,0.813253012048193
"540281213","MISIONES",458,426,12,2,4,18,0.930131004366812
"540281015","MISIONES",191,86,76,26,2,104,0.450261780104712
"540280911","MISIONES",177,126,32,18,0,50,0.711864406779661
"540280902","MISIONES",227,160,39,26,0,65,0.704845814977974
"540280910","MISIONES",202,202,0,0,0,0,1
"540280909","MISIONES",170,155,11,4,0,15,0.911764705882353
"540280814","MISIONES",246,4,145,79,15,239,0.016260162601626
"540280804","MISIONES",268,9,216,34,8,258,0.0335820895522388
"540280721","MISIONES",262,129,105,25,2,132,0.49236641221374
"540280715","MISIONES",261,3,117,73,6,196,0.0114942528735632
"540280709","MISIONES",216,177,0,0,0,0,0.819444444444444
"540280613","MISIONES",335,15,207,100,3,310,0.0447761194029851
"540280605","MISIONES",217,92,55,55,4,114,0.423963133640553
"540280502","MISIONES",269,67,185,12,0,197,0.24907063197026
"540280308","MISIONES",441,24,314,70,4,388,0.054421768707483
"540280218","MISIONES",135,132,2,1,0,3,0.977777777777778
"540280207","MISIONES",256,251,4,0,0,4,0.98046875
"540280201","MISIONES",206,191,14,1,0,15,0.927184466019418
"540280113","MISIONES",179,129,45,5,0,50,0.720670391061452
"540280112","MISIONES",366,296,63,7,0,70,0.808743169398907
"540280104","MISIONES",202,8,154,37,0,191,0.0396039603960396
"540350404","MISIONES",250,0,135,74,36,245,0
"540282207","MISIONES",352,178,140,16,0,156,0.505681818181818
"540282008","MISIONES",144,5,122,13,0,135,0.0347222222222222
"540281922","MISIONES",366,300,60,6,0,66,0.819672131147541
"540281920","MISIONES",365,306,18,0,0,18,0.838356164383562
"540281918","MISIONES",340,287,43,10,0,53,0.844117647058824
"540281913","MISIONES",402,22,231,125,9,365,0.054726368159204
"540281903","MISIONES",407,404,3,0,0,3,0.992628992628993
"540281314","MISIONES",444,11,127,220,66,413,0.0247747747747748
"540281311","MISIONES",258,8,247,2,1,250,0.0310077519379845
"540210517","MISIONES",162,11,102,24,9,135,0.0679012345679012
"540280107","MISIONES",295,105,154,33,1,188,0.355932203389831
"540140203","MISIONES",200,2,122,48,22,192,0.01
"540140104","MISIONES",275,1,141,91,36,268,0.00363636363636364
"540070504","MISIONES",246,1,120,71,47,238,0.0040650406504065
"540070509","MISIONES",192,1,65,42,65,172,0.00520833333333333
"540070508","MISIONES",335,6,120,105,78,303,0.017910447761194
"540070312","MISIONES",433,2,387,37,5,429,0.0046189376443418
"540070310","MISIONES",192,3,61,63,43,167,0.015625
"540700708","MISIONES",336,4,209,88,14,311,0.0119047619047619
"540700707","MISIONES",301,4,253,35,9,297,0.0132890365448505
"540981210","MISIONES",192,4,153,22,13,188,0.0208333333333333
"540560201","MISIONES",348,16,92,111,103,306,0.0459770114942529
"540421006","MISIONES",150,0,15,9,120,144,0
"540421005","MISIONES",246,1,113,59,49,221,0.0040650406504065
"540420610","MISIONES",255,2,144,47,45,236,0.00784313725490196
"540282403","MISIONES",353,249,46,35,2,83,0.705382436260623
"540281504","MISIONES",424,36,378,10,0,388,0.0849056603773585
"540281322","MISIONES",327,0,102,125,61,288,0
"540210609","MISIONES",247,11,170,32,26,228,0.0445344129554656
"540210608","MISIONES",230,0,98,64,56,218,0
"540070608","MISIONES",173,9,128,28,1,157,0.0520231213872832
"541190202","MISIONES",271,0,14,52,184,250,0
"540911103","MISIONES",22,0,0,2,8,10,0
"541190503","MISIONES",239,1,39,52,80,171,0.00418410041841004
"541120301","MISIONES",6,0,0,0,0,0,0
"541050201","MISIONES",107,0,36,23,46,105,0
"541050111","MISIONES",9,0,2,7,0,9,0
"540981009","MISIONES",190,3,167,19,1,187,0.0157894736842105
"541190401","MISIONES",134,3,24,52,39,115,0.0223880597014925
"541050110","MISIONES",15,0,2,7,4,13,0
"541050107","MISIONES",50,0,1,17,15,33,0
"540910204","MISIONES",237,6,73,73,47,193,0.0253164556962025
"541050106","MISIONES",5,0,2,0,3,5,0
"540910904","MISIONES",96,0,2,21,54,77,0
"540911106","MISIONES",135,0,13,83,31,127,0
"540910809","MISIONES",126,0,21,16,77,114,0
"540910702","MISIONES",73,0,11,46,12,69,0
"540910506","MISIONES",99,0,32,11,35,78,0
"540560309","MISIONES",159,0,59,45,22,126,0
"540560307","MISIONES",97,0,5,17,63,85,0
"540281219","MISIONES",402,364,28,8,0,36,0.90547263681592
"540281602","MISIONES",7,0,3,2,1,6,0
"540560207","MISIONES",131,0,10,44,73,127,0
"540560106","MISIONES",98,1,3,22,60,85,0.0102040816326531
"540350102","MISIONES",23,0,1,17,2,20,0
"540280711","MISIONES",213,83,101,27,1,129,0.389671361502347
"540560102","MISIONES",248,0,16,58,135,209,0
"540350409","MISIONES",26,0,2,3,6,11,0
"540350406","MISIONES",22,0,2,6,7,15,0
"540350203","MISIONES",11,0,3,7,1,11,0
"540350105","MISIONES",1,0,0,0,0,0,0
"541120502","MISIONES",289,0,236,39,13,288,0
"540210404","MISIONES",4,0,2,0,2,4,0
"540141005","MISIONES",99,1,18,33,40,91,0.0101010101010101
"540981214","MISIONES",290,5,106,89,32,227,0.0172413793103448
"540980907","MISIONES",299,2,211,44,35,290,0.00668896321070234
"540980704","MISIONES",146,0,85,37,23,145,0
"540980513","MISIONES",209,1,101,57,43,201,0.00478468899521531
"540280707","MISIONES",175,173,2,0,0,2,0.988571428571429
"820842707","SANTA FE",262,262,0,0,0,0,1
"540910119","MISIONES",399,150,146,99,2,247,0.37593984962406
"540140902","MISIONES",104,0,7,30,54,91,0
"540140704","MISIONES",183,0,26,50,73,149,0
"540980506","MISIONES",172,3,154,12,3,169,0.0174418604651163
"540980106","MISIONES",316,2,172,68,46,286,0.00632911392405063
"540911313","MISIONES",261,242,14,5,0,19,0.9272030651341
"540910905","MISIONES",266,3,109,88,40,237,0.0112781954887218
"540140703","MISIONES",177,0,24,50,86,160,0
"540140608","MISIONES",308,0,8,49,189,246,0
"540140601","MISIONES",99,0,14,30,55,99,0
"540140404","MISIONES",259,2,33,91,91,215,0.00772200772200772
"540910811","MISIONES",170,0,22,51,80,153,0
"540910719","MISIONES",263,9,147,91,13,251,0.0342205323193916
"540910513","MISIONES",266,1,132,85,16,233,0.0037593984962406
"540910509","MISIONES",440,0,101,165,131,397,0
"540140305","MISIONES",77,1,10,27,29,66,0.012987012987013
"540140302","MISIONES",91,1,28,34,13,75,0.010989010989011
"540070106","MISIONES",6,0,4,1,1,6,0
"540910219","MISIONES",250,3,112,104,20,236,0.012
"540910218","MISIONES",270,0,131,49,53,233,0
"540770503","MISIONES",9,0,1,4,1,6,0
"540770604","MISIONES",110,1,53,23,31,107,0.00909090909090909
"540630806","MISIONES",26,0,9,3,14,26,0
"540630203","MISIONES",0,0,0,0,0,0,NA
"540910216","MISIONES",215,102,68,29,5,102,0.474418604651163
"540630102","MISIONES",85,1,21,9,13,43,0.0117647058823529
"540910501","MISIONES",63,0,5,29,22,56,0
"540420104","MISIONES",9,0,0,5,3,8,0
"540140105","MISIONES",39,0,9,24,5,38,0
"541050109","MISIONES",6,0,3,1,1,5,0
"540911201","MISIONES",106,0,12,42,51,105,0
"540280703","MISIONES",329,108,189,26,1,216,0.328267477203647
"540840311","MISIONES",71,1,31,10,15,56,0.0140845070422535
"540700305","MISIONES",243,0,57,35,139,231,0
"540700104","MISIONES",120,0,45,38,26,109,0
"540700101","MISIONES",206,11,57,38,97,192,0.0533980582524272
"540630811","MISIONES",114,1,13,17,70,100,0.0087719298245614
"540490111","MISIONES",167,0,25,72,49,146,0
"540840202","MISIONES",85,0,9,18,48,75,0
"540770104","MISIONES",271,3,137,89,35,261,0.011070110701107
"540280110","MISIONES",179,163,13,3,0,16,0.910614525139665
"540282314","MISIONES",195,84,99,10,0,109,0.430769230769231
"540420315","MISIONES",208,9,131,26,38,195,0.0432692307692308
"541190508","MISIONES",363,4,210,84,59,353,0.0110192837465565
"540910118","MISIONES",360,300,39,15,3,57,0.833333333333333
"540910113","MISIONES",225,185,21,18,1,40,0.822222222222222
"540910111","MISIONES",256,214,35,7,0,42,0.8359375
"540910105","MISIONES",368,278,43,27,3,73,0.755434782608696
"540840903","MISIONES",193,53,117,15,4,136,0.274611398963731
"540910101","MISIONES",269,105,86,51,12,149,0.390334572490706
"540840312","MISIONES",256,121,110,14,8,132,0.47265625
"540560910","MISIONES",229,3,164,47,12,223,0.0131004366812227
"540560906","MISIONES",221,0,158,45,16,219,0
"540560905","MISIONES",298,4,140,124,23,287,0.0134228187919463
"540840301","MISIONES",376,4,219,99,37,355,0.0106382978723404
"540770806","MISIONES",298,231,49,15,2,66,0.775167785234899
"220211502","CHACO",185,154,11,3,0,14,0.832432432432432
"540280601","MISIONES",377,171,176,30,0,206,0.453580901856764
"540770805","MISIONES",346,6,174,84,49,307,0.0173410404624277
"540770803","MISIONES",277,178,64,25,9,98,0.642599277978339
"540770309","MISIONES",354,3,166,74,86,326,0.00847457627118644
"540700808","MISIONES",237,5,206,14,12,232,0.0210970464135021
"540631111","MISIONES",188,141,26,15,4,45,0.75
"540631005","MISIONES",245,6,175,53,3,231,0.0244897959183673
"540630915","MISIONES",260,0,82,106,58,246,0
"540630908","MISIONES",334,1,125,104,63,292,0.0029940119760479
"540630907","MISIONES",232,2,220,9,0,229,0.00862068965517241
"540630816","MISIONES",314,3,106,71,113,290,0.00955414012738853
"540630409","MISIONES",182,0,96,13,72,181,0
"540560206","MISIONES",301,0,141,109,35,285,0
"540490303","MISIONES",346,76,185,75,3,263,0.219653179190751
"540490113","MISIONES",220,0,41,84,81,206,0
"540421009","MISIONES",169,0,11,30,124,165,0
"540420515","MISIONES",274,3,220,46,3,269,0.0109489051094891
"540420512","MISIONES",268,3,222,39,1,262,0.0111940298507463
"540420509","MISIONES",231,3,218,9,1,228,0.012987012987013
"540420504","MISIONES",302,3,245,31,5,281,0.00993377483443709
"540420501","MISIONES",220,2,103,70,35,208,0.00909090909090909
"540420417","MISIONES",238,7,163,52,9,224,0.0294117647058824
"540420409","MISIONES",290,2,171,66,42,279,0.00689655172413793
"540420318","MISIONES",138,3,61,42,25,128,0.0217391304347826
"540420309","MISIONES",404,12,322,48,15,385,0.0297029702970297
"540280907","MISIONES",351,318,28,1,2,31,0.905982905982906
"540280901","MISIONES",244,152,81,8,3,92,0.622950819672131
"540280816","MISIONES",289,17,186,81,4,271,0.0588235294117647
"540280114","MISIONES",174,87,64,16,4,84,0.5
"540280103","MISIONES",372,20,127,195,15,337,0.0537634408602151
"540350411","MISIONES",186,0,91,61,21,173,0
"540282411","MISIONES",314,305,9,0,0,9,0.971337579617834
"540282410","MISIONES",287,273,13,0,0,13,0.951219512195122
"540282409","MISIONES",269,238,29,2,0,31,0.884758364312268
"540282213","MISIONES",210,139,63,7,0,70,0.661904761904762
"540282206","MISIONES",383,226,122,11,0,133,0.590078328981723
"540282204","MISIONES",292,77,97,77,13,187,0.263698630136986
"540282203","MISIONES",220,64,143,10,1,154,0.290909090909091
"540282019","MISIONES",381,113,135,92,14,241,0.296587926509186
"540282012","MISIONES",190,8,164,15,3,182,0.0421052631578947
"540281916","MISIONES",383,377,6,0,0,6,0.984334203655353
"540281821","MISIONES",232,1,136,74,17,227,0.00431034482758621
"540281820","MISIONES",198,1,129,56,10,195,0.00505050505050505
"540281817","MISIONES",221,5,136,60,12,208,0.0226244343891403
"540281809","MISIONES",231,3,102,80,21,203,0.012987012987013
"540281318","MISIONES",133,4,111,0,0,111,0.0300751879699248
"540281310","MISIONES",239,4,111,81,27,219,0.0167364016736402
"540281806","MISIONES",169,3,79,48,33,160,0.0177514792899408
"541050219","MISIONES",257,8,212,36,1,249,0.0311284046692607
"540210505","MISIONES",249,11,92,111,18,221,0.0441767068273092
"540140309","MISIONES",169,1,42,68,40,150,0.00591715976331361
"540140212","MISIONES",245,3,160,38,39,237,0.0122448979591837
"540070315","MISIONES",270,2,254,14,0,268,0.00740740740740741
"540070109","MISIONES",262,0,73,113,54,240,0
"540420414","MISIONES",341,18,226,76,15,317,0.0527859237536657
"540281928","MISIONES",288,274,14,0,0,14,0.951388888888889
"540282313","MISIONES",275,5,111,122,23,256,0.0181818181818182
"540070604","MISIONES",231,0,169,43,17,229,0
"540910210","MISIONES",321,177,78,46,14,138,0.551401869158878
"540910115","MISIONES",234,234,0,0,0,0,1
"540840110","MISIONES",223,0,57,48,76,181,0
"540840106","MISIONES",248,0,181,46,11,238,0
"540770704","MISIONES",148,2,80,30,31,141,0.0135135135135135
"540630112","MISIONES",309,1,49,173,34,256,0.00323624595469256
"340142111","FORMOSA",228,193,34,1,0,35,0.846491228070175
"541190507","MISIONES",134,1,83,25,21,129,0.00746268656716418
"541190601","MISIONES",36,0,1,6,27,34,0
"541190505","MISIONES",50,0,15,1,29,45,0
"540980401","MISIONES",124,1,27,35,52,114,0.00806451612903226
"541190306","MISIONES",74,0,2,29,21,52,0
"540911303","MISIONES",289,177,51,32,20,103,0.612456747404844
"541120402","MISIONES",1,0,0,0,0,0,0
"541050202","MISIONES",91,0,16,30,36,82,0
"541050102","MISIONES",43,0,12,19,12,43,0
"541190301","MISIONES",63,0,2,29,31,62,0
"540910108","MISIONES",493,439,31,20,3,54,0.890466531440162
"540911010","MISIONES",107,0,5,58,30,93,0
"540911202","MISIONES",29,0,9,6,8,23,0
"540911003","MISIONES",55,0,3,27,24,54,0
"540910903","MISIONES",184,0,19,30,110,159,0
"540910801","MISIONES",39,0,7,9,17,33,0
"540910602","MISIONES",128,0,26,19,73,118,0
"540350408","MISIONES",0,0,0,0,0,0,NA
"340142112","FORMOSA",164,158,6,0,0,6,0.963414634146341
"540140101","MISIONES",46,0,3,6,19,28,0
"540280119","MISIONES",198,147,30,5,0,35,0.742424242424242
"540560502","MISIONES",1,0,0,0,0,0,0
"540560903","MISIONES",455,3,191,150,79,420,0.00659340659340659
"540350405","MISIONES",47,0,4,15,23,42,0
"140145807","CORDOBA",200,199,0,1,0,1,0.995
"540490402","MISIONES",34,0,0,30,2,32,0
"540350306","MISIONES",7,0,1,3,1,5,0
"540840601","MISIONES",39,0,9,6,18,33,0
"540421003","MISIONES",77,0,5,16,51,72,0
"340140706","FORMOSA",301,105,160,8,6,174,0.348837209302326
"540141001","MISIONES",118,0,36,26,50,112,0
"540140301","MISIONES",96,0,36,26,33,95,0
"820842705","SANTA FE",180,180,0,0,0,0,1
"540282102","MISIONES",112,0,67,25,18,110,0
"540281702","MISIONES",20,0,6,11,2,19,0
"540210303","MISIONES",24,0,7,1,13,21,0
"541120501","MISIONES",335,0,105,82,124,311,0
"540210103","MISIONES",36,0,9,14,2,25,0
"540840306","MISIONES",26,0,2,13,11,26,0
"540840103","MISIONES",31,0,9,2,18,29,0
"540770304","MISIONES",140,0,20,69,31,120,0
"540700207","MISIONES",363,0,64,99,149,312,0
"540630410","MISIONES",195,2,76,40,56,172,0.0102564102564103
"540770203","MISIONES",15,1,1,5,5,11,0.0666666666666667
"540630809","MISIONES",4,0,0,1,2,3,0
"540630901","MISIONES",164,0,29,38,77,144,0
"540840203","MISIONES",21,0,0,0,15,15,0
"540700603","MISIONES",89,0,22,18,36,76,0
"540700502","MISIONES",138,0,20,45,52,117,0
"540630201","MISIONES",5,1,2,2,0,4,0.2
"540560803","MISIONES",218,0,9,43,115,167,0
"540560705","MISIONES",107,0,15,40,44,99,0
"541120507","MISIONES",169,0,19,41,91,151,0
"340142113","FORMOSA",212,185,23,3,0,26,0.872641509433962
"540560609","MISIONES",228,0,30,33,148,211,0
"540560608","MISIONES",465,0,21,104,292,417,0
"540981002","MISIONES",507,1,143,77,245,465,0.0019723865877712
"540280111","MISIONES",270,227,33,10,0,43,0.840740740740741
"540210610","MISIONES",109,0,19,12,66,97,0
"540910405","MISIONES",94,0,8,17,60,85,0
"540910304","MISIONES",51,0,11,31,7,49,0
"541190203","MISIONES",262,0,17,35,168,220,0
"540980101","MISIONES",160,0,78,25,45,148,0
"540910215","MISIONES",313,45,99,88,50,237,0.143769968051118
"541120101","MISIONES",478,0,24,62,320,406,0
"540281701","MISIONES",50,0,24,11,13,48,0
"540980203","MISIONES",128,0,29,35,56,120,0
"540840702","MISIONES",7,0,0,0,6,6,0
"540560101","MISIONES",179,0,33,61,58,152,0
"540910112","MISIONES",339,91,164,74,4,242,0.268436578171091
"540910901","MISIONES",282,0,76,79,77,232,0
"540840303","MISIONES",191,64,67,47,11,125,0.335078534031414
"540770406","MISIONES",76,0,11,33,24,68,0
"540770601","MISIONES",152,0,67,39,18,124,0
"540700302","MISIONES",173,4,40,27,81,148,0.023121387283237
"540770301","MISIONES",249,4,151,45,43,239,0.0160642570281124
"540420416","MISIONES",267,11,195,54,2,251,0.0411985018726592
"540770202","MISIONES",110,2,23,28,27,78,0.0181818181818182
"540700503","MISIONES",455,8,174,77,162,413,0.0175824175824176
"540490104","MISIONES",510,0,64,165,186,415,0
"540911014","MISIONES",194,5,40,32,99,171,0.0257731958762887
"540420607","MISIONES",220,2,70,56,72,198,0.00909090909090909
"540560601","MISIONES",549,0,69,121,318,508,0
"540420803","MISIONES",149,0,43,28,69,140,0
"540420601","MISIONES",285,1,17,82,168,267,0.00350877192982456
"540350303","MISIONES",17,0,4,6,7,17,0
"540350201","MISIONES",66,0,12,33,16,61,0
"541190107","MISIONES",525,21,180,196,103,479,0.04
"541050221","MISIONES",230,13,151,50,11,212,0.0565217391304348
"540840904","MISIONES",307,82,141,49,30,220,0.267100977198697
"540840408","MISIONES",187,1,31,29,120,180,0.0053475935828877
"540140607","MISIONES",414,1,68,100,229,397,0.00241545893719807
"540140504","MISIONES",198,3,89,48,45,182,0.0151515151515152
"540981003","MISIONES",221,0,17,35,108,160,0
"540281005","MISIONES",271,190,70,11,0,81,0.701107011070111
"540420310","MISIONES",159,1,156,2,0,158,0.00628930817610063
"540281217","MISIONES",334,282,15,2,4,21,0.844311377245509
"540770209","MISIONES",290,3,113,66,91,270,0.0103448275862069
"540770107","MISIONES",265,48,120,48,26,194,0.181132075471698
"540350410","MISIONES",248,0,132,94,17,243,0
"540770102","MISIONES",379,11,199,106,42,347,0.029023746701847
"540700804","MISIONES",238,20,190,21,5,216,0.0840336134453782
"540700706","MISIONES",273,2,221,29,2,252,0.00732600732600733
"540700702","MISIONES",189,1,160,23,5,188,0.00529100529100529
"540700507","MISIONES",209,2,166,30,8,204,0.00956937799043062
"540631001","MISIONES",273,50,165,35,1,201,0.183150183150183
"540630914","MISIONES",366,7,200,77,37,314,0.0191256830601093
"540630913","MISIONES",121,0,20,20,69,109,0
"540490307","MISIONES",205,21,97,58,13,168,0.102439024390244
"540421008","MISIONES",231,0,115,35,55,205,0
"540281103","MISIONES",134,5,36,27,33,96,0.0373134328358209
"540281012","MISIONES",273,144,86,21,1,108,0.527472527472527
"540281011","MISIONES",299,198,85,15,0,100,0.662207357859532
"540282412","MISIONES",391,341,40,5,0,45,0.872122762148338
"540282304","MISIONES",352,253,48,47,0,95,0.71875
"540280906","MISIONES",203,88,85,29,0,114,0.433497536945813
"540280818","MISIONES",362,83,160,59,22,241,0.229281767955801
"540280719","MISIONES",246,66,136,36,2,174,0.268292682926829
"540280713","MISIONES",428,40,322,49,3,374,0.0934579439252336
"540280704","MISIONES",269,126,111,14,0,125,0.468401486988848
"540280614","MISIONES",244,12,87,131,7,225,0.0491803278688525
"540280612","MISIONES",389,9,308,61,11,380,0.0231362467866324
"540280603","MISIONES",434,202,189,41,0,230,0.465437788018433
"540280507","MISIONES",262,131,96,17,0,113,0.5
"540280306","MISIONES",241,133,66,37,3,106,0.551867219917012
"540280305","MISIONES",311,150,78,65,11,154,0.482315112540193
"540280214","MISIONES",126,122,3,1,0,4,0.968253968253968
"540282001","MISIONES",418,313,87,14,4,105,0.748803827751196
"540281921","MISIONES",394,190,121,75,5,201,0.482233502538071
"540281919","MISIONES",407,10,252,129,6,387,0.0245700245700246
"540281914","MISIONES",345,9,196,131,4,331,0.0260869565217391
"540281907","MISIONES",375,366,5,4,0,9,0.976
"540281905","MISIONES",414,403,10,1,0,11,0.973429951690821
"540281901","MISIONES",417,202,117,87,6,210,0.484412470023981
"540281816","MISIONES",215,18,86,56,34,176,0.0837209302325581
"540281810","MISIONES",322,4,241,64,11,316,0.0124223602484472
"540281804","MISIONES",345,9,205,90,35,330,0.0260869565217391
"540140207","MISIONES",134,0,12,42,70,124,0
"540281315","MISIONES",432,2,163,157,81,401,0.00462962962962963
"540281313","MISIONES",333,25,145,114,43,302,0.0750750750750751
"540070318","MISIONES",300,77,218,5,0,223,0.256666666666667
"540281306","MISIONES",332,15,182,78,36,296,0.0451807228915663
"540210514","MISIONES",263,5,189,38,14,241,0.0190114068441065
"540210512","MISIONES",307,14,140,53,63,256,0.0456026058631922
"540280109","MISIONES",180,122,39,19,0,58,0.677777777777778
"540210601","MISIONES",287,2,146,60,70,276,0.00696864111498258
"540140505","MISIONES",250,0,154,71,21,246,0
"540140808","MISIONES",261,4,87,117,44,248,0.0153256704980843
"540140509","MISIONES",189,2,150,19,11,180,0.0105820105820106
"540140303","MISIONES",324,1,146,111,52,309,0.00308641975308642
"540140109","MISIONES",299,1,120,118,55,293,0.00334448160535117
"540070619","MISIONES",277,16,143,91,17,251,0.0577617328519856
"540070319","MISIONES",245,5,68,59,63,190,0.0204081632653061
"540070108","MISIONES",330,19,244,59,5,308,0.0575757575757576
"540631103","MISIONES",230,212,10,7,0,17,0.921739130434783
"540630813","MISIONES",411,5,349,43,2,394,0.0121654501216545
"540490312","MISIONES",220,3,150,40,21,211,0.0136363636363636
"540350413","MISIONES",104,0,65,12,21,98,0
"540210607","MISIONES",314,2,180,75,36,291,0.00636942675159236
"541120302","MISIONES",27,0,2,0,4,6,0
"541120506","MISIONES",256,0,20,56,152,228,0
"340142210","FORMOSA",375,94,248,27,0,275,0.250666666666667
"541050308","MISIONES",42,0,4,2,31,37,0
"340140305","FORMOSA",252,215,1,0,0,1,0.853174603174603
"541120105","MISIONES",39,0,6,12,9,27,0
"540350205","MISIONES",3,0,0,1,2,3,0
"541050307","MISIONES",87,0,5,9,59,73,0
"541050305","MISIONES",56,0,5,19,24,48,0
"220211503","CHACO",174,169,3,2,0,5,0.971264367816092
"541050303","MISIONES",40,0,13,5,18,36,0
"540560304","MISIONES",131,0,6,34,85,125,0
"541050404","MISIONES",72,0,4,17,33,54,0
"541120508","MISIONES",337,0,36,122,100,258,0
"540910205","MISIONES",329,14,141,75,87,303,0.0425531914893617
"541050210","MISIONES",33,0,0,6,17,23,0
"540980703","MISIONES",53,0,10,12,26,48,0
"540980102","MISIONES",97,0,38,32,26,96,0
"540980802","MISIONES",121,0,8,18,53,79,0
"540910202","MISIONES",431,94,90,80,161,331,0.218097447795824
"540910804","MISIONES",71,0,5,7,55,67,0
"540910507","MISIONES",186,0,20,75,80,175,0
"540350305","MISIONES",3,0,0,1,2,3,0
"540210606","MISIONES",23,0,2,11,10,23,0
"540350207","MISIONES",27,0,2,17,6,25,0
"540490302","MISIONES",165,1,6,68,24,98,0.00606060606060606
"540420901","MISIONES",35,0,1,1,28,30,0
"540630808","MISIONES",10,0,6,1,2,9,0
"540420609","MISIONES",17,0,2,2,12,16,0
"540420106","MISIONES",17,0,0,4,10,14,0
"540910503","MISIONES",101,0,22,21,51,94,0
"540210703","MISIONES",38,0,4,5,25,34,0
"540210101","MISIONES",63,0,14,3,36,53,0
"540140904","MISIONES",36,0,0,5,29,34,0
"540630106","MISIONES",268,3,79,125,37,241,0.0111940298507463
"540140507","MISIONES",140,0,17,61,46,124,0
"540140306","MISIONES",32,0,5,11,14,30,0
"540140102","MISIONES",128,0,12,46,54,112,0
"540910301","MISIONES",54,0,3,7,39,49,0
"540840604","MISIONES",35,0,2,14,18,34,0
"540840310","MISIONES",34,12,6,2,14,22,0.352941176470588
"540560908","MISIONES",301,5,273,19,3,295,0.0166112956810631
"540560710","MISIONES",266,1,131,74,43,248,0.0037593984962406
"540070502","MISIONES",70,0,17,20,23,60,0
"540070406","MISIONES",18,0,3,7,7,17,0
"540910104","MISIONES",404,339,36,21,6,63,0.839108910891089
"540770605","MISIONES",189,0,39,26,76,141,0
"540700506","MISIONES",84,2,14,27,37,78,0.0238095238095238
"340140306","FORMOSA",248,244,3,0,0,3,0.983870967741935
"540420903","MISIONES",3,0,0,1,2,3,0
"540560711","MISIONES",284,17,244,14,0,258,0.0598591549295775
"540630703","MISIONES",17,0,2,7,6,15,0
"540630702","MISIONES",3,0,0,0,2,2,0
"540630505","MISIONES",56,2,2,39,5,46,0.0357142857142857
"540630503","MISIONES",33,0,10,10,12,32,0
"540910305","MISIONES",122,1,27,30,53,110,0.00819672131147541
"540840905","MISIONES",169,0,129,25,4,158,0
"540281220","MISIONES",273,255,16,2,0,18,0.934065934065934
"540630401","MISIONES",23,0,0,17,6,23,0
"540630501","MISIONES",168,0,17,27,66,110,0
"540630101","MISIONES",126,0,9,53,54,116,0
"540281212","MISIONES",378,328,47,0,0,47,0.867724867724868
"540070405","MISIONES",10,0,4,2,4,10,0
"540980801","MISIONES",103,0,9,8,77,94,0
"540840407","MISIONES",45,0,9,11,17,37,0
"540770701","MISIONES",42,1,4,24,5,33,0.0238095238095238
"540281014","MISIONES",223,132,83,8,0,91,0.591928251121076
"540281009","MISIONES",422,245,136,35,0,171,0.580568720379147
"540911305","MISIONES",216,196,12,3,4,19,0.907407407407407
"540840901","MISIONES",287,22,122,48,44,214,0.0766550522648084
"541190105","MISIONES",583,1,125,233,189,547,0.00171526586620926
"540770207","MISIONES",117,4,27,47,32,106,0.0341880341880342
"540281006","MISIONES",238,157,59,21,0,80,0.659663865546218
"541190502","MISIONES",493,4,167,116,175,458,0.00811359026369168
"540980510","MISIONES",84,1,25,22,26,73,0.0119047619047619
"540980402","MISIONES",65,0,15,17,30,62,0
"540700206","MISIONES",176,12,43,47,60,150,0.0681818181818182
"540280301","MISIONES",436,241,107,78,9,194,0.552752293577982
"541190103","MISIONES",390,0,27,129,188,344,0
"540140107","MISIONES",135,0,19,47,64,130,0
"540280217","MISIONES",216,212,4,0,0,4,0.981481481481482
"541050108","MISIONES",89,0,20,35,29,84,0
"540980302","MISIONES",148,2,75,24,26,125,0.0135135135135135
"540911101","MISIONES",250,0,49,75,71,195,0
"540980516","MISIONES",337,0,100,83,95,278,0
"540981103","MISIONES",142,0,22,26,75,123,0
"540980902","MISIONES",353,1,89,99,140,328,0.0028328611898017
"540980514","MISIONES",210,1,103,73,25,201,0.00476190476190476
"540980505","MISIONES",232,5,173,33,15,221,0.021551724137931
"540980502","MISIONES",309,1,300,8,0,308,0.00323624595469256
"540980206","MISIONES",317,5,262,38,8,308,0.0157728706624606
"540911310","MISIONES",459,445,6,5,0,11,0.969498910675381
"540911006","MISIONES",83,0,10,31,17,58,0
"540910708","MISIONES",125,0,14,59,41,114,0
"540910706","MISIONES",164,7,41,59,43,143,0.0426829268292683
"540910703","MISIONES",120,0,6,32,62,100,0
"540911307","MISIONES",204,2,91,68,42,201,0.00980392156862745
"540280211","MISIONES",195,189,6,0,0,6,0.969230769230769
"540910404","MISIONES",237,0,37,65,107,209,0
"540840309","MISIONES",151,7,85,27,30,142,0.0463576158940397
"540911302","MISIONES",250,0,7,76,127,210,0
"540280213","MISIONES",214,203,8,3,0,11,0.948598130841122
"540840403","MISIONES",316,1,137,84,71,292,0.00316455696202532
"540840307","MISIONES",182,0,73,55,22,150,0
"540910712","MISIONES",258,16,153,46,39,238,0.062015503875969
"540910209","MISIONES",336,45,201,67,21,289,0.133928571428571
"540700313","MISIONES",201,5,169,2,0,171,0.0248756218905473
"540420302","MISIONES",141,0,54,47,28,129,0
"540420101","MISIONES",114,4,24,18,51,93,0.0350877192982456
"540140604","MISIONES",209,0,19,43,135,197,0
"540140502","MISIONES",204,0,47,78,71,196,0
"540070303","MISIONES",318,21,38,95,132,265,0.0660377358490566
"540070104","MISIONES",95,16,34,28,12,74,0.168421052631579
"541050401","MISIONES",210,0,35,63,90,188,0
"540630115","MISIONES",254,0,53,96,78,227,0
"540420316","MISIONES",228,7,180,13,1,194,0.0307017543859649
"541120514","MISIONES",123,0,37,48,32,117,0
"541120512","MISIONES",245,0,122,59,59,240,0
"540981209","MISIONES",231,7,157,58,3,218,0.0303030303030303
"540981204","MISIONES",305,0,65,50,185,300,0
"540981202","MISIONES",209,0,120,50,36,206,0
"540840302","MISIONES",291,143,97,9,42,148,0.491408934707904
"540840105","MISIONES",256,10,180,50,6,236,0.0390625
"540770811","MISIONES",190,155,23,12,0,35,0.815789473684211
"540770810","MISIONES",255,187,52,15,0,67,0.733333333333333
"540770408","MISIONES",233,15,133,77,4,214,0.0643776824034335
"540280204","MISIONES",215,192,22,0,0,22,0.893023255813953
"540770308","MISIONES",195,1,46,41,104,191,0.00512820512820513
"540770213","MISIONES",269,2,174,52,26,252,0.00743494423791822
"540280808","MISIONES",385,287,84,2,2,88,0.745454545454545
"540770212","MISIONES",205,2,84,54,47,185,0.00975609756097561
"540770210","MISIONES",207,0,124,64,3,191,0
"540770208","MISIONES",372,5,169,134,62,365,0.0134408602150538
"540700803","MISIONES",399,1,263,88,27,378,0.0025062656641604
"540700703","MISIONES",257,3,194,30,12,236,0.0116731517509728
"540700701","MISIONES",272,4,228,30,4,262,0.0147058823529412
"540700508","MISIONES",328,1,202,66,27,295,0.00304878048780488
"540700310","MISIONES",233,2,192,23,13,228,0.00858369098712446
"540631101","MISIONES",238,74,136,19,1,156,0.310924369747899
"540630904","MISIONES",177,0,135,37,3,175,0
"540630114","MISIONES",210,9,145,27,21,193,0.0428571428571429
"540490109","MISIONES",320,7,125,90,89,304,0.021875
"540630818","MISIONES",194,3,145,40,3,188,0.0154639175257732
"540280820","MISIONES",421,3,214,92,56,362,0.00712589073634204
"540280819","MISIONES",326,18,240,28,19,287,0.0552147239263804
"540280817","MISIONES",163,10,75,51,5,131,0.0613496932515337
"540280809","MISIONES",381,12,191,89,27,307,0.031496062992126
"540280908","MISIONES",279,262,16,1,0,17,0.939068100358423
"540280618","MISIONES",497,73,269,118,18,405,0.146881287726358
"540280606","MISIONES",210,111,88,7,0,95,0.528571428571429
"540280604","MISIONES",165,24,47,42,39,128,0.145454545454545
"540280417","MISIONES",327,272,7,37,0,44,0.831804281345566
"540280411","MISIONES",255,227,27,0,0,27,0.890196078431372
"540280402","MISIONES",372,324,32,4,0,36,0.870967741935484
"540280313","MISIONES",269,32,167,67,0,234,0.118959107806691
"540280312","MISIONES",299,88,185,16,3,204,0.294314381270903
"540280701","MISIONES",271,1,188,72,3,263,0.003690036900369
"540280105","MISIONES",67,18,32,16,0,48,0.26865671641791
"540282415","MISIONES",416,340,49,0,0,49,0.817307692307692
"540282407","MISIONES",380,314,2,0,0,2,0.826315789473684
"540282406","MISIONES",202,200,0,0,0,0,0.99009900990099
"540282310","MISIONES",248,123,111,13,0,124,0.495967741935484
"540282209","MISIONES",410,223,148,36,2,186,0.54390243902439
"540282205","MISIONES",238,131,105,2,0,107,0.550420168067227
"540420311","MISIONES",112,2,81,14,12,107,0.0178571428571429
"540281917","MISIONES",396,12,76,200,55,331,0.0303030303030303
"540281819","MISIONES",189,6,69,71,27,167,0.0317460317460317
"540281803","MISIONES",228,4,73,106,37,216,0.0175438596491228
"540210516","MISIONES",269,9,250,7,0,257,0.033457249070632
"540210506","MISIONES",210,2,108,55,39,202,0.00952380952380952
"540140511","MISIONES",369,3,38,67,229,334,0.00813008130081301
"540140307","MISIONES",303,0,54,74,111,239,0
"540070617","MISIONES",209,5,150,53,1,204,0.0239234449760766
"540070615","MISIONES",337,13,122,134,38,294,0.0385756676557863
"540070103","MISIONES",340,14,141,84,83,308,0.0411764705882353
"540560904","MISIONES",294,1,144,105,29,278,0.00340136054421769
"541190106","MISIONES",287,2,152,71,60,283,0.00696864111498258
"541050220","MISIONES",187,12,102,16,44,162,0.0641711229946524
"540560208","MISIONES",336,11,230,44,30,304,0.0327380952380952
"540490206","MISIONES",558,4,155,130,237,522,0.00716845878136201
"540770812","MISIONES",190,103,36,33,16,85,0.542105263157895
"540490116","MISIONES",264,0,72,64,104,240,0
"540490115","MISIONES",212,1,126,28,42,196,0.00471698113207547
"540140806","MISIONES",284,0,92,71,100,263,0
"540630407","MISIONES",236,1,116,52,11,179,0.00423728813559322
"540281207","MISIONES",269,159,34,72,2,108,0.591078066914498
"540281205","MISIONES",264,252,10,2,0,12,0.954545454545455
"541190201","MISIONES",142,1,11,14,101,126,0.00704225352112676
"540910106","MISIONES",389,163,98,96,27,221,0.419023136246787
"541190504","MISIONES",158,0,18,49,85,152,0
"540770804","MISIONES",279,159,59,38,19,116,0.56989247311828
"540981102","MISIONES",111,0,5,40,58,103,0
"540911007","MISIONES",34,0,5,23,2,30,0
"540910807","MISIONES",97,0,38,34,22,94,0
"540910802","MISIONES",168,0,18,46,97,161,0
"540910704","MISIONES",66,0,16,23,26,65,0
"540560901","MISIONES",372,6,258,60,23,341,0.0161290322580645
"540630817","MISIONES",246,11,42,84,61,187,0.0447154471544715
"541190102","MISIONES",190,0,25,71,64,160,0
"541050206","MISIONES",6,0,0,5,1,6,0
"540980105","MISIONES",56,0,24,15,16,55,0
"540980103","MISIONES",78,0,17,17,39,73,0
"541120602","MISIONES",509,0,35,107,320,462,0
"541050304","MISIONES",10,0,0,2,8,10,0
"541050205","MISIONES",6,0,0,4,1,5,0
"541050105","MISIONES",81,0,8,25,31,64,0
"540911208","MISIONES",56,0,8,15,14,37,0
"540560105","MISIONES",105,0,8,37,53,98,0
"540420703","MISIONES",92,1,56,12,19,87,0.0108695652173913
"540281503","MISIONES",59,1,36,19,2,57,0.0169491525423729
"540420612","MISIONES",328,1,99,68,125,292,0.00304878048780488
"540560305","MISIONES",314,0,28,47,111,186,0
"540421002","MISIONES",34,0,1,14,17,32,0
"540490403","MISIONES",24,0,0,2,18,20,0
"540350104","MISIONES",21,0,0,13,2,15,0
"540282202","MISIONES",459,128,288,40,1,329,0.278867102396514
"540420708","MISIONES",20,0,1,7,12,20,0
"540420301","MISIONES",192,3,84,30,66,180,0.015625
"540350202","MISIONES",13,0,4,5,4,13,0
"540210402","MISIONES",41,0,7,16,11,34,0
"540141003","MISIONES",68,0,12,33,18,63,0
"540210305","MISIONES",47,0,6,3,31,40,0
"540140106","MISIONES",73,0,21,11,40,72,0
"541050211","MISIONES",20,0,3,0,12,15,0
"540980503","MISIONES",247,0,199,42,5,246,0
"540980501","MISIONES",315,9,190,36,51,277,0.0285714285714286
"340141519","FORMOSA",212,185,26,0,0,26,0.872641509433962
"540840107","MISIONES",328,4,255,37,25,317,0.0121951219512195
"540282010","MISIONES",225,32,142,37,3,182,0.142222222222222
"540140903","MISIONES",87,0,1,23,54,78,0
"540140901","MISIONES",85,0,9,22,40,71,0
"540140705","MISIONES",142,2,13,52,71,136,0.0140845070422535
"540140702","MISIONES",86,0,16,21,41,78,0
"140142705","CORDOBA",195,181,14,0,0,14,0.928205128205128
"540140606","MISIONES",172,0,24,44,89,157,0
"540070401","MISIONES",55,0,23,11,16,50,0
"540070309","MISIONES",25,0,19,3,2,24,0
"540700505","MISIONES",154,0,35,33,64,132,0
"540630602","MISIONES",22,0,0,4,16,20,0
"540560702","MISIONES",269,1,65,83,100,248,0.00371747211895911
"540560701","MISIONES",90,0,7,21,52,80,0
"540560605","MISIONES",234,0,14,79,119,212,0
"540560401","MISIONES",1,0,0,0,0,0,0
"540910502","MISIONES",98,0,24,43,21,88,0
"540630402","MISIONES",20,0,2,14,3,19,0
"540560306","MISIONES",144,0,9,14,68,91,0
"540911309","MISIONES",445,318,36,16,71,123,0.714606741573034
"540910303","MISIONES",52,0,12,15,20,47,0
"540770502","MISIONES",7,0,0,0,3,3,0
"540770201","MISIONES",170,0,38,60,51,149,0
"540911009","MISIONES",166,0,40,58,47,145,0
"541120103","MISIONES",331,0,102,83,93,278,0
"540980702","MISIONES",265,0,84,61,103,248,0
"540770402","MISIONES",200,0,105,57,36,198,0
"540770401","MISIONES",342,0,73,97,125,295,0
"540910810","MISIONES",298,3,128,101,57,286,0.0100671140939597
"540840902","MISIONES",393,182,82,27,56,165,0.463104325699746
"540770103","MISIONES",254,2,55,41,135,231,0.0078740157480315
"540700402","MISIONES",309,8,58,70,134,262,0.0258899676375405
"540630902","MISIONES",82,1,33,15,28,76,0.0121951219512195
"540630805","MISIONES",399,0,234,88,61,383,0
"540910716","MISIONES",244,0,110,83,34,227,0
"540630403","MISIONES",84,0,33,40,8,81,0
"540490301","MISIONES",542,7,75,181,214,470,0.0129151291512915
"540630110","MISIONES",376,13,127,124,64,315,0.0345744680851064
"540420303","MISIONES",239,0,126,25,73,224,0
"540281101","MISIONES",120,62,12,17,4,33,0.516666666666667
"540140501","MISIONES",152,0,30,51,70,151,0
"540910211","MISIONES",265,8,215,36,5,256,0.030188679245283
"540910206","MISIONES",222,90,101,27,4,132,0.405405405405405
"540070507","MISIONES",53,0,13,25,4,42,0
"541190104","MISIONES",352,16,131,77,105,313,0.0454545454545455
"541120510","MISIONES",346,0,118,97,124,339,0
"541050218","MISIONES",323,131,144,22,23,189,0.405572755417957
"541050217","MISIONES",256,2,176,48,26,250,0.0078125
"541050213","MISIONES",221,0,110,39,60,209,0
"540981010","MISIONES",193,2,129,47,12,188,0.0103626943005181
"540770211","MISIONES",297,4,73,90,100,263,0.0134680134680135
"540700807","MISIONES",399,1,240,94,47,381,0.0025062656641604
"540631113","MISIONES",338,224,53,46,7,106,0.662721893491124
"540631110","MISIONES",283,58,112,105,3,220,0.204946996466431
"540631106","MISIONES",412,100,172,100,18,290,0.242718446601942
"540631105","MISIONES",441,233,175,26,0,201,0.528344671201814
"540631006","MISIONES",205,28,100,60,6,166,0.136585365853659
"540631004","MISIONES",389,172,139,59,0,198,0.442159383033419
"540630803","MISIONES",169,2,161,6,0,167,0.0118343195266272
"541190307","MISIONES",259,2,117,116,19,252,0.00772200772200772
"540420516","MISIONES",271,10,236,18,4,258,0.03690036900369
"540420508","MISIONES",279,7,249,22,0,271,0.025089605734767
"540420507","MISIONES",245,3,214,27,1,242,0.0122448979591837
"540420505","MISIONES",335,3,280,44,4,328,0.00895522388059702
"540420502","MISIONES",369,17,270,60,13,343,0.046070460704607
"540420420","MISIONES",284,6,196,37,30,263,0.0211267605633803
"540420419","MISIONES",231,0,141,59,26,226,0
"540420412","MISIONES",230,4,187,25,12,224,0.0173913043478261
"540280602","MISIONES",321,177,95,45,1,141,0.551401869158878
"540420411","MISIONES",405,5,211,87,93,391,0.0123456790123457
"540281215","MISIONES",274,193,24,45,9,78,0.704379562043796
"540281010","MISIONES",327,198,109,16,1,126,0.605504587155963
"540281008","MISIONES",443,319,106,16,2,124,0.720090293453725
"540281003","MISIONES",298,184,101,12,0,113,0.61744966442953
"540281001","MISIONES",223,188,19,10,0,29,0.84304932735426
"340140409","FORMOSA",350,292,8,0,0,8,0.834285714285714
"540280903","MISIONES",130,69,59,1,0,60,0.530769230769231
"540281218","MISIONES",474,4,63,233,131,427,0.00843881856540084
"540280807","MISIONES",481,408,25,13,8,46,0.848232848232848
"540280717","MISIONES",243,10,143,66,2,211,0.0411522633744856
"540280712","MISIONES",293,62,158,39,16,213,0.21160409556314
"540280710","MISIONES",322,305,16,1,0,17,0.947204968944099
"540280617","MISIONES",246,75,109,47,8,164,0.304878048780488
"540280615","MISIONES",60,1,47,7,0,54,0.0166666666666667
"540280607","MISIONES",310,176,111,15,0,126,0.567741935483871
"540280509","MISIONES",242,30,176,31,3,210,0.12396694214876
"540350412","MISIONES",346,0,241,51,45,337,0
"540350403","MISIONES",261,0,131,96,28,255,0
"540282414","MISIONES",308,248,19,3,0,22,0.805194805194805
"540282311","MISIONES",441,127,171,105,14,290,0.287981859410431
"540282301","MISIONES",436,167,202,47,6,255,0.38302752293578
"540282004","MISIONES",499,48,281,104,13,398,0.0961923847695391
"540281927","MISIONES",242,144,27,49,9,85,0.59504132231405
"540281915","MISIONES",284,281,1,0,0,1,0.98943661971831
"540281813","MISIONES",374,350,10,5,0,15,0.935828877005348
"540281802","MISIONES",242,2,99,59,61,219,0.00826446280991736
"540281801","MISIONES",351,306,8,1,1,10,0.871794871794872
"540210504","MISIONES",322,4,142,95,33,270,0.0124223602484472
"540210306","MISIONES",193,13,45,42,72,159,0.0673575129533679
"540140112","MISIONES",87,0,5,35,46,86,0
"540140110","MISIONES",261,0,122,85,41,248,0
"540140108","MISIONES",222,7,199,10,3,212,0.0315315315315315
"540070616","MISIONES",359,0,107,143,89,339,0
"540070314","MISIONES",135,0,23,46,58,127,0
"540070609","MISIONES",156,2,110,25,0,135,0.0128205128205128
"540910306","MISIONES",238,11,162,24,33,219,0.046218487394958
"540630916","MISIONES",200,0,4,43,140,187,0
"540630905","MISIONES",246,1,109,40,76,225,0.0040650406504065
"540630113","MISIONES",255,0,98,77,26,201,0
"540490204","MISIONES",219,8,140,40,28,208,0.0365296803652968
"540420709","MISIONES",91,1,37,7,35,79,0.010989010989011
"540420514","MISIONES",281,2,259,13,5,277,0.00711743772241993
"540282402","MISIONES",315,256,57,2,0,59,0.812698412698413
"540281323","MISIONES",175,10,89,58,15,162,0.0571428571428571
"540281308","MISIONES",269,1,109,98,56,263,0.00371747211895911
"540140609","MISIONES",157,0,20,58,76,154,0
"540070607","MISIONES",354,10,190,120,23,333,0.0282485875706215
"541120202","MISIONES",20,0,0,0,1,1,0
"340140120","FORMOSA",364,351,11,0,0,11,0.964285714285714
"340140121","FORMOSA",170,166,2,0,0,2,0.976470588235294
"540981001","MISIONES",12,0,3,3,5,11,0
"540980901","MISIONES",169,0,46,20,92,158,0
"541120104","MISIONES",41,0,15,3,16,34,0
"541050104","MISIONES",72,0,13,26,28,67,0
"820842607","SANTA FE",282,281,1,0,0,1,0.99645390070922
"540980509","MISIONES",154,0,42,72,35,149,0
"540911205","MISIONES",90,1,18,24,41,83,0.0111111111111111
"540911104","MISIONES",33,0,2,3,21,26,0
"540911108","MISIONES",126,0,32,30,53,115,0
"540560707","MISIONES",113,0,28,36,40,104,0
"540560602","MISIONES",466,1,28,72,321,421,0.00214592274678112
"540560303","MISIONES",567,0,12,84,303,399,0
"540910803","MISIONES",191,0,19,48,93,160,0
"540910711","MISIONES",19,0,6,4,7,17,0
"540910701","MISIONES",61,0,19,16,16,51,0
"340140122","FORMOSA",235,18,198,13,1,212,0.0765957446808511
"340140123","FORMOSA",246,232,14,0,0,14,0.943089430894309
"340140712","FORMOSA",5,2,3,0,0,3,0.4
"540420203","MISIONES",35,2,0,5,24,29,0.0571428571428571
"540350401","MISIONES",154,0,6,28,86,120,0
"340140217","FORMOSA",215,208,7,0,0,7,0.967441860465116
"540210702","MISIONES",37,0,4,21,12,37,0
"540560104","MISIONES",199,0,24,41,120,185,0
"540281704","MISIONES",11,0,4,2,0,6,0
"340140124","FORMOSA",218,204,12,0,0,12,0.935779816513762
"340140125","FORMOSA",203,93,105,0,1,106,0.458128078817734
"540490205","MISIONES",305,0,44,115,120,279,0
"540281402","MISIONES",0,0,0,0,0,0,NA
"540420805","MISIONES",48,0,4,11,33,48,0
"540840802","MISIONES",70,0,4,4,37,45,0
"340140410","FORMOSA",258,251,3,3,1,7,0.972868217054264
"540420804","MISIONES",6,0,0,1,4,5,0
"340140218","FORMOSA",212,210,2,0,0,2,0.990566037735849
"540420802","MISIONES",164,0,44,20,85,149,0
"540420608","MISIONES",39,0,14,15,4,33,0
"540840401","MISIONES",37,0,4,6,22,32,0
"540210605","MISIONES",30,0,6,13,3,22,0
"540770702","MISIONES",127,0,58,20,32,110,0
"540910401","MISIONES",124,1,25,30,64,119,0.00806451612903226
"540140804","MISIONES",63,0,5,21,24,50,0
"221330408","CHACO",57,2,10,19,21,50,0.0350877192982456
"540140701","MISIONES",138,0,25,42,62,129,0
"540140503","MISIONES",161,0,14,68,63,145,0
"540770307","MISIONES",6,0,1,3,2,6,0
"540700601","MISIONES",124,0,30,27,48,105,0
"540700304","MISIONES",279,0,56,56,151,263,0
"540630601","MISIONES",1,0,0,1,0,1,0
"540560708","MISIONES",338,0,41,112,160,313,0
"340140411","FORMOSA",212,199,9,3,1,13,0.938679245283019
"340070102","FORMOSA",307,0,11,70,32,113,0
"540560403","MISIONES",53,0,3,14,11,28,0
"540700201","MISIONES",80,0,19,19,37,75,0
"340070101","FORMOSA",83,0,0,5,20,25,0
"340070201","FORMOSA",203,0,16,52,96,164,0
"340140126","FORMOSA",176,19,154,3,0,157,0.107954545454545
"340070202","FORMOSA",33,0,0,1,6,7,0
"340140304","FORMOSA",281,270,11,0,0,11,0.96085409252669
"421050101","LA PAMPA",116,0,96,20,0,116,0
"340070203","FORMOSA",192,0,14,37,114,165,0
"340070504","FORMOSA",50,0,2,16,18,36,0
"340070204","FORMOSA",168,0,32,49,27,108,0
"221400203","CHACO",294,171,88,32,1,121,0.581632653061224
"340070301","FORMOSA",60,0,2,19,4,25,0
"340070401","FORMOSA",59,0,2,27,7,36,0
"340140211","FORMOSA",262,245,8,0,0,8,0.935114503816794
"340070402","FORMOSA",151,0,6,71,23,100,0
"340070403","FORMOSA",171,0,18,46,76,140,0
"340070404","FORMOSA",138,0,70,59,1,130,0
"340070405","FORMOSA",241,0,68,136,20,224,0
"340070406","FORMOSA",206,0,90,80,16,186,0
"340070407","FORMOSA",135,0,57,65,2,124,0
"340070408","FORMOSA",136,0,35,73,15,123,0
"340070409","FORMOSA",120,0,25,69,18,112,0
"340070505","FORMOSA",156,0,41,66,31,138,0
"340140105","FORMOSA",238,232,6,0,0,6,0.974789915966387
"340140220","FORMOSA",370,181,181,5,0,186,0.489189189189189
"340140710","FORMOSA",262,126,133,2,0,135,0.480916030534351
"340070501","FORMOSA",197,0,38,45,83,166,0
"340070502","FORMOSA",52,0,1,11,35,47,0
"340070503","FORMOSA",186,0,10,92,41,143,0
"340070601","FORMOSA",30,0,0,0,23,23,0
"340070603","FORMOSA",17,0,0,7,8,15,0
"340140212","FORMOSA",254,234,18,0,0,18,0.921259842519685
"340070602","FORMOSA",97,0,4,12,49,65,0
"340140106","FORMOSA",256,251,4,1,0,5,0.98046875
"340140107","FORMOSA",202,162,40,0,0,40,0.801980198019802
"340140108","FORMOSA",405,399,6,0,0,6,0.985185185185185
"340140109","FORMOSA",301,262,35,0,0,35,0.870431893687708
"340140110","FORMOSA",356,217,127,4,0,131,0.609550561797753
"340140111","FORMOSA",215,214,1,0,0,1,0.995348837209302
"340140112","FORMOSA",251,229,4,0,0,4,0.912350597609562
"340140113","FORMOSA",300,280,19,1,0,20,0.933333333333333
"340070701","FORMOSA",27,0,0,6,7,13,0
"340140114","FORMOSA",292,279,11,0,2,13,0.955479452054795
"340140115","FORMOSA",175,159,16,0,0,16,0.908571428571429
"340140116","FORMOSA",284,270,11,3,0,14,0.950704225352113
"340140117","FORMOSA",247,225,1,1,0,2,0.910931174089069
"340140118","FORMOSA",176,176,0,0,0,0,1
"340070702","FORMOSA",145,0,6,48,32,86,0
"340070703","FORMOSA",94,0,29,35,16,80,0
"340140119","FORMOSA",167,157,10,0,0,10,0.940119760479042
"421050307","LA PAMPA",155,150,4,1,0,5,0.967741935483871
"340070801","FORMOSA",94,0,1,36,17,54,0
"340140101","FORMOSA",342,121,151,19,3,173,0.353801169590643
"340140102","FORMOSA",248,87,109,1,16,126,0.350806451612903
"340140103","FORMOSA",95,93,2,0,0,2,0.978947368421053
"340140104","FORMOSA",255,253,1,1,0,2,0.992156862745098
"340140219","FORMOSA",185,65,108,2,3,113,0.351351351351351
"820842102","SANTA FE",303,298,0,0,0,0,0.983498349834984
"340140201","FORMOSA",361,161,109,68,6,183,0.445983379501385
"340140202","FORMOSA",298,119,142,29,2,173,0.399328859060403
"340140203","FORMOSA",330,319,11,0,0,11,0.966666666666667
"340140204","FORMOSA",186,161,25,0,0,25,0.865591397849462
"340140205","FORMOSA",345,145,152,15,22,189,0.420289855072464
"340140206","FORMOSA",299,104,138,30,0,168,0.347826086956522
"340140213","FORMOSA",188,188,0,0,0,0,1
"340140214","FORMOSA",311,304,6,0,0,6,0.977491961414791
"340140215","FORMOSA",258,256,2,0,0,2,0.992248062015504
"340140216","FORMOSA",227,214,13,0,0,13,0.94273127753304
"340140207","FORMOSA",244,38,72,43,28,143,0.155737704918033
"340140208","FORMOSA",258,138,112,3,0,115,0.534883720930233
"340140209","FORMOSA",359,320,27,3,0,30,0.891364902506964
"340140210","FORMOSA",238,232,6,0,0,6,0.974789915966387
"340140221","FORMOSA",193,55,98,16,0,114,0.284974093264249
"340140222","FORMOSA",200,82,103,11,0,114,0.41
"340140223","FORMOSA",240,119,89,15,3,107,0.495833333333333
"340140301","FORMOSA",274,267,6,1,0,7,0.974452554744526
"340140302","FORMOSA",322,305,15,1,0,16,0.947204968944099
"340140303","FORMOSA",264,243,17,1,0,18,0.920454545454545
"340140709","FORMOSA",338,211,93,4,0,97,0.624260355029586
"340140711","FORMOSA",337,131,196,6,1,203,0.388724035608309
"340140307","FORMOSA",339,175,149,5,3,157,0.51622418879056
"340140308","FORMOSA",319,131,179,3,2,184,0.410658307210031
"340140309","FORMOSA",176,62,98,12,0,110,0.352272727272727
"340140412","FORMOSA",262,243,10,7,1,18,0.927480916030534
"340140413","FORMOSA",306,144,105,29,1,135,0.470588235294118
"340140414","FORMOSA",243,217,10,6,2,18,0.893004115226337
"340140415","FORMOSA",366,257,76,9,7,92,0.702185792349727
"340140310","FORMOSA",353,94,213,31,8,252,0.26628895184136
"340140311","FORMOSA",282,106,153,21,2,176,0.375886524822695
"340140416","FORMOSA",290,150,106,17,0,123,0.517241379310345
"340140417","FORMOSA",290,134,115,25,8,148,0.462068965517241
"340140418","FORMOSA",245,184,38,6,14,58,0.751020408163265
"340140312","FORMOSA",250,22,141,58,6,205,0.088
"340140419","FORMOSA",259,162,55,34,0,89,0.625482625482625
"340140501","FORMOSA",17,0,1,12,1,14,0
"340140502","FORMOSA",351,8,97,176,34,307,0.0227920227920228
"340140503","FORMOSA",14,0,2,3,9,14,0
"340140313","FORMOSA",281,57,202,11,1,214,0.202846975088968
"340140401","FORMOSA",221,162,6,5,0,11,0.733031674208145
"340140402","FORMOSA",189,176,4,1,2,7,0.931216931216931
"340140403","FORMOSA",382,336,37,5,0,42,0.879581151832461
"340140404","FORMOSA",367,337,21,6,0,27,0.918256130790191
"340140405","FORMOSA",223,181,37,4,1,42,0.811659192825112
"340140406","FORMOSA",376,367,8,1,0,9,0.976063829787234
"340140504","FORMOSA",127,1,67,56,1,124,0.0078740157480315
"340140505","FORMOSA",93,3,54,26,2,82,0.032258064516129
"340140506","FORMOSA",167,4,72,75,7,154,0.0239520958083832
"340140601","FORMOSA",6,0,1,5,0,6,0
"340140602","FORMOSA",141,0,55,56,16,127,0
"340140603","FORMOSA",115,1,48,55,2,105,0.00869565217391304
"340140604","FORMOSA",25,0,0,21,4,25,0
"340140605","FORMOSA",67,1,35,18,5,58,0.0149253731343284
"340140606","FORMOSA",64,2,29,27,2,58,0.03125
"340140607","FORMOSA",94,4,34,47,2,83,0.0425531914893617
"340140608","FORMOSA",3,1,1,1,0,2,0.333333333333333
"340140609","FORMOSA",0,0,0,0,0,0,NA
"340140705","FORMOSA",319,239,58,8,5,71,0.749216300940439
"340140701","FORMOSA",203,7,23,105,40,168,0.0344827586206897
"340140702","FORMOSA",221,42,112,40,14,166,0.190045248868778
"340140703","FORMOSA",196,63,125,3,2,130,0.321428571428571
"340140704","FORMOSA",196,11,175,5,4,184,0.0561224489795918
"340140713","FORMOSA",248,64,181,1,1,183,0.258064516129032
"340140714","FORMOSA",275,175,98,2,0,100,0.636363636363636
"340140715","FORMOSA",323,148,135,27,1,163,0.458204334365325
"340140716","FORMOSA",126,0,20,83,17,120,0
"340140717","FORMOSA",190,0,68,108,5,181,0
"340140801","FORMOSA",33,0,9,16,7,32,0
"340140802","FORMOSA",16,0,9,6,1,16,0
"340140803","FORMOSA",46,6,13,19,1,33,0.130434782608696
"221330406","CHACO",38,0,4,8,22,34,0
"340140804","FORMOSA",54,5,21,12,5,38,0.0925925925925926
"340140901","FORMOSA",115,0,41,43,18,102,0
"340140902","FORMOSA",32,0,13,8,2,23,0
"340141001","FORMOSA",64,0,20,36,6,62,0
"340141002","FORMOSA",7,0,3,4,0,7,0
"340141003","FORMOSA",5,0,1,0,0,1,0
"340141004","FORMOSA",112,12,67,10,12,89,0.107142857142857
"340141005","FORMOSA",156,22,101,21,8,130,0.141025641025641
"340141101","FORMOSA",39,16,2,13,0,15,0.41025641025641
"340141102","FORMOSA",13,0,5,7,1,13,0
"340141503","FORMOSA",214,207,5,2,0,7,0.967289719626168
"340141103","FORMOSA",59,5,35,17,0,52,0.0847457627118644
"340141104","FORMOSA",109,20,59,23,1,83,0.18348623853211
"340141201","FORMOSA",55,0,14,28,10,52,0
"340141301","FORMOSA",48,1,29,15,1,45,0.0208333333333333
"340141302","FORMOSA",7,1,2,3,0,5,0.142857142857143
"340141401","FORMOSA",36,0,1,13,11,25,0
"340141402","FORMOSA",52,0,5,16,26,47,0
"340141403","FORMOSA",162,10,49,57,22,128,0.0617283950617284
"340141404","FORMOSA",99,1,18,32,30,80,0.0101010101010101
"340141501","FORMOSA",381,201,172,6,1,179,0.52755905511811
"340141502","FORMOSA",228,221,6,0,0,6,0.969298245614035
"340141504","FORMOSA",389,389,0,0,0,0,1
"340141505","FORMOSA",264,260,1,1,0,2,0.984848484848485
"340141506","FORMOSA",286,263,23,0,0,23,0.91958041958042
"340141507","FORMOSA",421,368,42,3,0,45,0.874109263657957
"340141508","FORMOSA",376,273,68,9,0,77,0.726063829787234
"340141509","FORMOSA",298,222,17,7,0,24,0.74496644295302
"340141510","FORMOSA",212,185,20,6,0,26,0.872641509433962
"340141511","FORMOSA",129,126,1,0,1,2,0.976744186046512
"340141512","FORMOSA",342,324,10,4,0,14,0.947368421052632
"340141513","FORMOSA",317,297,18,1,0,19,0.936908517350158
"340141514","FORMOSA",443,409,23,1,0,24,0.923250564334086
"340141515","FORMOSA",179,151,28,0,0,28,0.843575418994413
"340141516","FORMOSA",270,141,113,11,3,127,0.522222222222222
"340141517","FORMOSA",352,311,10,0,0,10,0.883522727272727
"340141518","FORMOSA",283,268,15,0,0,15,0.946996466431095
"221330407","CHACO",5,0,0,5,0,5,0
"340141520","FORMOSA",165,122,41,2,0,43,0.739393939393939
"340141521","FORMOSA",215,212,3,0,0,3,0.986046511627907
"340141522","FORMOSA",213,213,0,0,0,0,1
"340141523","FORMOSA",234,228,3,1,0,4,0.974358974358974
"340141524","FORMOSA",213,189,22,0,0,22,0.887323943661972
"340141525","FORMOSA",284,239,9,1,0,10,0.841549295774648
"340141526","FORMOSA",189,186,2,1,0,3,0.984126984126984
"340141527","FORMOSA",207,200,7,0,0,7,0.966183574879227
"340141528","FORMOSA",266,252,11,0,0,11,0.947368421052632
"340141601","FORMOSA",205,9,121,57,10,188,0.0439024390243902
"340141609","FORMOSA",292,271,14,0,0,14,0.928082191780822
"340141610","FORMOSA",303,269,31,2,0,33,0.887788778877888
"340141611","FORMOSA",253,244,8,1,0,9,0.964426877470356
"340141612","FORMOSA",228,204,23,0,1,24,0.894736842105263
"340141613","FORMOSA",239,206,32,0,0,32,0.861924686192469
"340141602","FORMOSA",370,92,127,60,20,207,0.248648648648649
"340141603","FORMOSA",189,179,6,2,0,8,0.947089947089947
"340141604","FORMOSA",220,212,6,2,0,8,0.963636363636364
"340141605","FORMOSA",336,242,80,10,2,92,0.720238095238095
"340141606","FORMOSA",352,292,37,11,0,48,0.829545454545455
"340141607","FORMOSA",235,195,33,2,0,35,0.829787234042553
"340141608","FORMOSA",369,309,19,4,5,28,0.83739837398374
"340141614","FORMOSA",195,194,1,0,0,1,0.994871794871795
"340141615","FORMOSA",236,232,4,0,0,4,0.983050847457627
"340141616","FORMOSA",303,302,1,0,0,1,0.996699669966997
"340141617","FORMOSA",271,262,6,0,0,6,0.966789667896679
"340141618","FORMOSA",176,176,0,0,0,0,1
"340141619","FORMOSA",215,211,4,0,0,4,0.981395348837209
"340141620","FORMOSA",251,139,100,2,1,103,0.553784860557769
"340141621","FORMOSA",330,240,72,5,1,78,0.727272727272727
"340141622","FORMOSA",352,49,249,36,1,286,0.139204545454545
"340141701","FORMOSA",179,17,108,8,2,118,0.0949720670391061
"340141702","FORMOSA",204,75,104,13,3,120,0.367647058823529
"340141703","FORMOSA",240,124,106,5,1,112,0.516666666666667
"340141704","FORMOSA",248,118,117,7,1,125,0.475806451612903
"340141623","FORMOSA",276,188,42,35,5,82,0.681159420289855
"340141624","FORMOSA",213,210,3,0,0,3,0.985915492957746
"340141625","FORMOSA",212,171,32,4,0,36,0.806603773584906
"340141626","FORMOSA",226,187,29,0,0,29,0.827433628318584
"340141627","FORMOSA",202,41,141,16,1,158,0.202970297029703
"340141628","FORMOSA",206,192,10,2,0,12,0.932038834951456
"300560213","ENTRE RIOS",214,210,3,1,0,4,0.981308411214953
"340141705","FORMOSA",379,149,185,28,1,214,0.393139841688654
"340141707","FORMOSA",147,52,46,24,10,80,0.353741496598639
"340141708","FORMOSA",259,142,93,0,0,93,0.548262548262548
"340141709","FORMOSA",230,118,108,0,0,108,0.51304347826087
"340141710","FORMOSA",206,17,157,0,31,188,0.0825242718446602
"340141712","FORMOSA",257,46,200,7,2,209,0.178988326848249
"340141713","FORMOSA",111,3,87,12,2,101,0.027027027027027
"340141714","FORMOSA",264,241,21,0,0,21,0.912878787878788
"340141715","FORMOSA",189,180,9,0,0,9,0.952380952380952
"340142023","FORMOSA",322,49,142,80,14,236,0.152173913043478
"340142024","FORMOSA",245,8,121,82,6,209,0.0326530612244898
"340141716","FORMOSA",328,132,97,42,7,146,0.402439024390244
"340142206","FORMOSA",377,158,161,16,0,177,0.419098143236074
"340141802","FORMOSA",6,0,1,3,2,6,0
"340141901","FORMOSA",32,0,14,8,0,22,0
"340141902","FORMOSA",4,0,3,0,0,3,0
"340142025","FORMOSA",309,62,216,2,1,219,0.200647249190939
"340142026","FORMOSA",260,27,198,17,2,217,0.103846153846154
"340142213","FORMOSA",352,211,121,5,0,126,0.599431818181818
"340561102","FORMOSA",249,6,124,88,19,231,0.0240963855421687
"340141717","FORMOSA",252,20,133,81,2,216,0.0793650793650794
"340142001","FORMOSA",37,0,6,21,5,32,0
"340142002","FORMOSA",242,34,51,79,34,164,0.140495867768595
"340142003","FORMOSA",18,0,9,4,0,13,0
"340142004","FORMOSA",260,2,79,91,11,181,0.00769230769230769
"340142005","FORMOSA",24,0,8,8,4,20,0
"340142006","FORMOSA",327,20,177,78,28,283,0.0611620795107034
"340142007","FORMOSA",46,2,5,22,13,40,0.0434782608695652
"340142207","FORMOSA",358,103,174,23,6,203,0.287709497206704
"340142103","FORMOSA",274,47,224,1,1,226,0.171532846715328
"340142104","FORMOSA",332,83,217,4,0,221,0.25
"340142105","FORMOSA",157,150,3,2,0,5,0.955414012738854
"340142009","FORMOSA",17,0,7,8,0,15,0
"340142020","FORMOSA",182,7,32,68,38,138,0.0384615384615385
"340142021","FORMOSA",0,0,0,0,0,0,NA
"340142008","FORMOSA",5,0,0,0,2,2,0
"340350806","FORMOSA",176,2,85,68,6,159,0.0113636363636364
"340142010","FORMOSA",2,0,1,1,0,2,0
"340142011","FORMOSA",27,0,0,13,11,24,0
"340142012","FORMOSA",121,63,50,1,0,51,0.520661157024793
"340142013","FORMOSA",278,15,244,12,2,258,0.0539568345323741
"340142014","FORMOSA",218,24,172,12,3,187,0.110091743119266
"340142018","FORMOSA",184,4,105,58,4,167,0.0217391304347826
"340142019","FORMOSA",213,25,93,55,25,173,0.117370892018779
"340142022","FORMOSA",1,0,1,0,0,1,0
"340142015","FORMOSA",330,98,159,32,1,192,0.296969696969697
"340142016","FORMOSA",253,31,173,25,4,202,0.122529644268775
"340142017","FORMOSA",225,22,80,98,9,187,0.0977777777777778
"340142027","FORMOSA",318,34,169,75,8,252,0.106918238993711
"340142114","FORMOSA",243,168,67,7,0,74,0.691358024691358
"340142208","FORMOSA",369,124,193,16,1,210,0.336043360433604
"340142209","FORMOSA",348,165,144,24,1,169,0.474137931034483
"340142101","FORMOSA",184,74,80,13,2,95,0.402173913043478
"340142102","FORMOSA",216,59,147,7,0,154,0.273148148148148
"340142115","FORMOSA",406,199,137,50,14,201,0.490147783251232
"340142116","FORMOSA",391,128,249,9,2,260,0.327365728900256
"340142117","FORMOSA",289,127,152,6,3,161,0.439446366782007
"340142118","FORMOSA",225,185,28,5,0,33,0.822222222222222
"340142205","FORMOSA",380,203,147,0,0,147,0.534210526315789
"340142119","FORMOSA",268,58,132,35,2,169,0.216417910447761
"340142201","FORMOSA",219,176,39,0,1,40,0.80365296803653
"340142202","FORMOSA",300,257,42,1,0,43,0.856666666666667
"340142203","FORMOSA",177,110,67,0,0,67,0.621468926553672
"340142204","FORMOSA",330,188,142,0,0,142,0.56969696969697
"340142214","FORMOSA",363,172,177,8,0,185,0.473829201101928
"340142215","FORMOSA",221,68,145,5,0,150,0.307692307692308
"340142216","FORMOSA",319,168,138,9,1,148,0.526645768025078
"340142217","FORMOSA",265,67,176,14,2,192,0.252830188679245
"340142218","FORMOSA",262,175,67,19,0,86,0.66793893129771
"340142219","FORMOSA",353,110,174,23,30,227,0.311614730878187
"340142220","FORMOSA",200,66,110,15,1,126,0.33
"340142221","FORMOSA",182,25,92,6,2,100,0.137362637362637
"340210208","FORMOSA",80,2,17,26,17,60,0.025
"340210209","FORMOSA",34,0,21,11,1,33,0
"340210210","FORMOSA",47,0,19,21,7,47,0
"340210211","FORMOSA",188,86,74,14,1,89,0.457446808510638
"340142222","FORMOSA",30,0,2,13,1,16,0
"340210101","FORMOSA",7,0,5,1,1,7,0
"340210102","FORMOSA",26,0,25,0,0,25,0
"340210201","FORMOSA",137,0,18,83,24,125,0
"340210202","FORMOSA",47,0,6,16,2,24,0
"340210203","FORMOSA",9,0,3,4,1,8,0
"340210204","FORMOSA",6,0,1,3,2,6,0
"340210205","FORMOSA",5,0,2,2,1,5,0
"340210206","FORMOSA",50,0,20,10,16,46,0
"421050308","LA PAMPA",215,211,3,1,0,4,0.981395348837209
"340210207","FORMOSA",10,0,2,7,0,9,0
"340210212","FORMOSA",203,3,97,61,34,192,0.0147783251231527
"340210213","FORMOSA",280,22,94,144,13,251,0.0785714285714286
"340210214","FORMOSA",302,13,172,92,14,278,0.043046357615894
"340210215","FORMOSA",151,3,93,33,1,127,0.0198675496688742
"340210301","FORMOSA",72,0,14,32,14,60,0
"340210501","FORMOSA",5,0,2,3,0,5,0
"340280105","FORMOSA",277,0,169,93,0,262,0
"340210302","FORMOSA",129,10,35,60,18,113,0.0775193798449612
"340210303","FORMOSA",67,0,24,32,6,62,0
"340210304","FORMOSA",185,1,88,92,2,182,0.00540540540540541
"340210305","FORMOSA",164,3,39,105,1,145,0.0182926829268293
"340350901","FORMOSA",168,9,86,47,20,153,0.0535714285714286
"340210306","FORMOSA",76,0,37,36,1,74,0
"340210307","FORMOSA",196,3,81,90,9,180,0.0153061224489796
"340210401","FORMOSA",11,0,2,9,0,11,0
"340210402","FORMOSA",73,0,32,19,18,69,0
"340280114","FORMOSA",191,0,99,77,6,182,0
"340491107","FORMOSA",162,27,88,32,4,124,0.166666666666667
"340210403","FORMOSA",258,6,87,120,21,228,0.0232558139534884
"300560303","ENTRE RIOS",255,255,0,0,0,0,1
"340210502","FORMOSA",127,0,61,39,18,118,0
"340210601","FORMOSA",50,0,6,19,18,43,0
"340280107","FORMOSA",205,0,51,111,17,179,0
"340210602","FORMOSA",134,0,58,48,21,127,0
"340280106","FORMOSA",212,0,137,56,7,200,0
"340350105","FORMOSA",47,0,13,21,1,35,0
"340280108","FORMOSA",163,0,94,42,3,139,0
"340280109","FORMOSA",264,0,47,128,41,216,0
"340280110","FORMOSA",140,0,8,76,14,98,0
"340280111","FORMOSA",118,0,10,50,25,85,0
"340280112","FORMOSA",169,0,81,54,25,160,0
"340280113","FORMOSA",248,0,115,99,8,222,0
"300560214","ENTRE RIOS",234,229,4,1,0,5,0.978632478632479
"340210603","FORMOSA",205,0,59,108,12,179,0
"340210604","FORMOSA",247,7,119,101,6,226,0.0283400809716599
"340210704","FORMOSA",28,0,4,10,11,25,0
"340210701","FORMOSA",18,0,9,6,1,16,0
"340210705","FORMOSA",7,0,4,3,0,7,0
"340210706","FORMOSA",327,17,214,67,6,287,0.0519877675840979
"340210702","FORMOSA",14,0,3,3,5,11,0
"340210707","FORMOSA",236,21,135,63,5,203,0.0889830508474576
"340210708","FORMOSA",176,4,112,42,13,167,0.0227272727272727
"340210709","FORMOSA",102,1,23,24,47,94,0.00980392156862745
"340280101","FORMOSA",167,0,1,32,37,70,0
"340210703","FORMOSA",49,0,3,23,23,49,0
"340280102","FORMOSA",154,0,76,68,2,146,0
"340280103","FORMOSA",271,0,121,122,13,256,0
"340280104","FORMOSA",243,0,113,105,11,229,0
"340350902","FORMOSA",200,2,111,42,14,167,0.01
"340280115","FORMOSA",180,0,30,83,41,154,0
"340350203","FORMOSA",157,0,13,53,51,117,0
"300560304","ENTRE RIOS",181,181,0,0,0,0,1
"340280201","FORMOSA",233,0,64,39,31,134,0
"340350106","FORMOSA",157,0,3,30,40,73,0
"340350107","FORMOSA",6,0,0,6,0,6,0
"340280302","FORMOSA",29,0,2,2,3,7,0
"340350101","FORMOSA",247,2,50,77,74,201,0.00809716599190283
"340350108","FORMOSA",200,0,2,35,90,127,0
"340280301","FORMOSA",99,0,1,17,43,61,0
"340350102","FORMOSA",59,0,8,44,2,54,0
"340350103","FORMOSA",154,2,72,40,20,132,0.012987012987013
"340350104","FORMOSA",29,0,2,2,23,27,0
"340350201","FORMOSA",179,0,7,34,60,101,0
"340350202","FORMOSA",71,0,8,25,19,52,0
"340350204","FORMOSA",91,0,4,63,13,80,0
"340350205","FORMOSA",24,0,0,13,2,15,0
"340350206","FORMOSA",94,0,8,33,38,79,0
"340350207","FORMOSA",5,0,2,2,0,4,0
"340350301","FORMOSA",206,1,13,59,46,118,0.00485436893203883
"340350607","FORMOSA",198,0,85,67,35,187,0
"340350302","FORMOSA",25,0,4,5,8,17,0
"340351006","FORMOSA",197,0,80,72,32,184,0
"340350403","FORMOSA",64,0,11,15,16,42,0
"340350404","FORMOSA",26,0,10,11,0,21,0
"340350405","FORMOSA",185,0,84,76,16,176,0
"340350406","FORMOSA",116,0,28,50,24,102,0
"340350605","FORMOSA",143,0,71,51,12,134,0
"340350303","FORMOSA",110,0,7,25,63,95,0
"340350304","FORMOSA",11,0,0,5,1,6,0
"340350401","FORMOSA",14,0,2,5,6,13,0
"340350402","FORMOSA",269,0,14,52,133,199,0
"340350705","FORMOSA",236,0,72,123,36,231,0
"300560305","ENTRE RIOS",128,128,0,0,0,0,1
"340350501","FORMOSA",455,0,143,133,120,396,0
"340350502","FORMOSA",29,0,11,10,2,23,0
"340350503","FORMOSA",2,0,0,1,0,1,0
"340350604","FORMOSA",180,1,20,95,49,164,0.00555555555555556
"340350608","FORMOSA",171,12,90,56,0,146,0.0701754385964912
"340350601","FORMOSA",106,0,15,44,34,93,0
"340350602","FORMOSA",166,0,29,58,67,154,0
"340350706","FORMOSA",155,1,22,88,22,132,0.00645161290322581
"340351007","FORMOSA",156,2,97,43,14,154,0.0128205128205128
"340350606","FORMOSA",165,1,81,51,24,156,0.00606060606060606
"340350910","FORMOSA",155,1,24,70,15,109,0.00645161290322581
"340350603","FORMOSA",155,0,18,39,89,146,0
"340350707","FORMOSA",220,4,69,46,70,185,0.0181818181818182
"340350801","FORMOSA",123,5,51,48,0,99,0.040650406504065
"340350609","FORMOSA",142,0,13,56,67,136,0
"340350802","FORMOSA",231,0,125,71,22,218,0
"340351201","FORMOSA",309,5,153,106,8,267,0.0161812297734628
"340350610","FORMOSA",119,1,22,59,23,104,0.00840336134453781
"340350611","FORMOSA",293,8,188,78,7,273,0.0273037542662116
"340350612","FORMOSA",301,1,76,141,33,250,0.00332225913621262
"340350613","FORMOSA",217,1,108,91,12,211,0.00460829493087558
"340350614","FORMOSA",125,0,45,70,8,123,0
"340350615","FORMOSA",142,1,42,48,47,137,0.00704225352112676
"340350911","FORMOSA",180,0,40,80,39,159,0
"340350803","FORMOSA",210,22,64,91,12,167,0.104761904761905
"340350804","FORMOSA",246,4,76,112,24,212,0.016260162601626
"340350805","FORMOSA",281,2,69,148,26,243,0.00711743772241993
"340350701","FORMOSA",111,0,13,46,47,106,0
"340350702","FORMOSA",157,0,28,51,55,134,0
"340350703","FORMOSA",173,0,12,79,60,151,0
"340350704","FORMOSA",316,0,118,139,34,291,0
"221330409","CHACO",5,0,3,1,0,4,0
"340350903","FORMOSA",272,0,139,62,24,225,0
"340350904","FORMOSA",234,5,123,75,6,204,0.0213675213675214
"340350905","FORMOSA",169,0,98,33,6,137,0
"340350906","FORMOSA",310,1,92,118,18,228,0.0032258064516129
"340350907","FORMOSA",206,5,93,67,12,172,0.0242718446601942
"340350908","FORMOSA",250,4,129,75,24,228,0.016
"340350909","FORMOSA",293,13,73,110,26,209,0.0443686006825939
"340351001","FORMOSA",174,2,59,51,35,145,0.0114942528735632
"340351002","FORMOSA",295,5,181,67,15,263,0.0169491525423729
"340351003","FORMOSA",215,0,104,62,20,186,0
"340351004","FORMOSA",323,5,153,91,32,276,0.0154798761609907
"340351005","FORMOSA",203,4,119,52,2,173,0.0197044334975369
"340351101","FORMOSA",72,0,1,27,41,69,0
"340351102","FORMOSA",29,0,1,5,18,24,0
"340351207","FORMOSA",284,1,91,117,6,214,0.00352112676056338
"340351103","FORMOSA",223,0,25,49,112,186,0
"340351104","FORMOSA",184,0,60,82,24,166,0
"340351105","FORMOSA",166,0,86,61,13,160,0
"340491013","FORMOSA",264,78,102,67,2,171,0.295454545454545
"340351202","FORMOSA",323,8,197,88,8,293,0.0247678018575851
"340351203","FORMOSA",265,13,217,33,0,250,0.0490566037735849
"340351204","FORMOSA",178,4,115,58,0,173,0.0224719101123595
"340351205","FORMOSA",278,9,124,103,13,240,0.0323741007194245
"340351206","FORMOSA",200,6,146,31,5,182,0.03
"300560215","ENTRE RIOS",227,221,3,3,0,6,0.973568281938326
"340351208","FORMOSA",166,0,95,44,22,161,0
"340351209","FORMOSA",153,1,49,72,7,128,0.0065359477124183
"340351210","FORMOSA",97,0,20,36,16,72,0
"340491007","FORMOSA",263,248,9,1,0,10,0.942965779467681
"340351301","FORMOSA",43,0,1,1,12,14,0
"340351403","FORMOSA",33,0,5,5,17,27,0
"340351502","FORMOSA",83,2,5,33,15,53,0.0240963855421687
"340351302","FORMOSA",26,0,2,16,6,24,0
"340351402","FORMOSA",46,0,1,19,2,22,0
"340351503","FORMOSA",104,0,0,19,17,36,0
"340560109","FORMOSA",252,16,172,52,4,228,0.0634920634920635
"340351303","FORMOSA",24,0,4,15,5,24,0
"340351401","FORMOSA",56,0,1,39,6,46,0
"340491014","FORMOSA",261,114,87,46,6,139,0.436781609195402
"340351501","FORMOSA",2,0,0,2,0,2,0
"340351701","FORMOSA",36,0,6,11,0,17,0
"300770209","ENTRE RIOS",188,182,0,2,0,2,0.968085106382979
"340351702","FORMOSA",19,0,4,5,1,10,0
"300844601","ENTRE RIOS",17,0,1,3,0,4,0
"340351703","FORMOSA",8,0,0,5,2,7,0
"340351802","FORMOSA",121,0,1,22,18,41,0
"340351803","FORMOSA",49,0,2,10,4,16,0
"300770210","ENTRE RIOS",249,233,0,7,0,7,0.93574297188755
"340491008","FORMOSA",240,231,7,2,0,9,0.9625
"340351812","FORMOSA",95,0,8,63,12,83,0
"340351901","FORMOSA",42,0,3,2,33,38,0
"340490611","FORMOSA",164,2,114,41,5,160,0.0121951219512195
"340351601","FORMOSA",88,0,14,15,32,61,0
"340351704","FORMOSA",18,0,1,7,7,15,0
"340351801","FORMOSA",134,0,10,50,16,76,0
"221330410","CHACO",7,1,0,5,0,5,0.142857142857143
"340351804","FORMOSA",49,0,3,18,16,37,0
"340351805","FORMOSA",129,2,41,50,7,98,0.0155038759689922
"340351806","FORMOSA",175,1,71,74,12,157,0.00571428571428571
"340351807","FORMOSA",155,9,44,86,9,139,0.0580645161290323
"340351808","FORMOSA",222,10,44,117,22,183,0.045045045045045
"340351809","FORMOSA",133,0,1,95,6,102,0
"340351810","FORMOSA",134,0,46,67,5,118,0
"340351811","FORMOSA",123,1,24,52,8,84,0.00813008130081301
"340351902","FORMOSA",43,0,4,34,5,43,0
"340351903","FORMOSA",109,0,5,16,42,63,0
"340351904","FORMOSA",179,0,21,81,6,108,0
"340351905","FORMOSA",221,7,68,107,9,184,0.0316742081447964
"340351906","FORMOSA",244,1,81,112,17,210,0.00409836065573771
"340351907","FORMOSA",121,0,6,17,18,41,0
"340351908","FORMOSA",202,0,94,78,14,186,0
"340351909","FORMOSA",49,0,9,14,10,33,0
"340352003","FORMOSA",48,0,1,14,33,48,0
"340491106","FORMOSA",301,17,166,93,14,273,0.0564784053156146
"340561123","FORMOSA",123,0,29,57,6,92,0
"340352001","FORMOSA",64,0,10,21,23,54,0
"340352002","FORMOSA",105,0,6,41,48,95,0
"340352101","FORMOSA",35,0,2,1,29,32,0
"340352103","FORMOSA",61,0,8,14,39,61,0
"220700503","CHACO",14,0,4,6,2,12,0
"300844510","ENTRE RIOS",120,112,4,2,0,6,0.933333333333333
"500070213","MENDOZA",311,309,0,1,0,1,0.993569131832797
"340352102","FORMOSA",11,0,4,5,1,10,0
"340420101","FORMOSA",39,0,6,20,11,37,0
"300840604","ENTRE RIOS",309,308,0,1,0,1,0.996763754045307
"340420102","FORMOSA",168,0,21,42,59,122,0
"340420103","FORMOSA",64,0,14,21,28,63,0
"340420104","FORMOSA",157,0,23,56,65,144,0
"340420105","FORMOSA",191,0,15,69,85,169,0
"340490104","FORMOSA",224,78,129,10,5,144,0.348214285714286
"300840605","ENTRE RIOS",211,211,0,0,0,0,1
"340420106","FORMOSA",110,0,12,34,56,102,0
"340420107","FORMOSA",125,0,18,70,35,123,0
"340420108","FORMOSA",143,0,98,35,6,139,0
"340420109","FORMOSA",330,0,98,166,52,316,0
"340420110","FORMOSA",265,0,126,97,28,251,0
"340420111","FORMOSA",330,0,198,114,9,321,0
"340420112","FORMOSA",97,0,28,31,9,68,0
"340420201","FORMOSA",14,0,6,2,6,14,0
"220700504","CHACO",9,0,0,4,3,7,0
"340420202","FORMOSA",80,0,36,6,36,78,0
"340420203","FORMOSA",37,0,5,19,9,33,0
"340420204","FORMOSA",275,0,52,112,106,270,0
"340420205","FORMOSA",241,0,144,64,29,237,0
"340420301","FORMOSA",92,0,14,27,32,73,0
"340420302","FORMOSA",13,0,7,3,3,13,0
"340490306","FORMOSA",65,0,0,1,39,40,0
"340491015","FORMOSA",237,44,103,49,2,154,0.185654008438819
"340420303","FORMOSA",165,0,32,69,45,146,0
"340420304","FORMOSA",25,0,5,3,16,24,0
"340420305","FORMOSA",332,0,63,118,140,321,0
"340420306","FORMOSA",262,0,210,31,16,257,0
"340420307","FORMOSA",150,0,35,50,58,143,0
"340420401","FORMOSA",144,0,14,42,66,122,0
"340420402","FORMOSA",16,0,1,3,10,14,0
"340420403","FORMOSA",13,0,1,5,6,12,0
"340490609","FORMOSA",92,0,16,16,52,84,0
"340420501","FORMOSA",167,0,9,55,69,133,0
"340420502","FORMOSA",24,0,8,7,8,23,0
"340420503","FORMOSA",10,0,5,2,3,10,0
"340490610","FORMOSA",303,2,128,91,44,263,0.0066006600660066
"300840606","ENTRE RIOS",191,188,3,0,0,3,0.984293193717278
"340420504","FORMOSA",245,0,111,82,44,237,0
"340420505","FORMOSA",253,0,86,102,51,239,0
"340420506","FORMOSA",217,0,118,74,21,213,0
"340490101","FORMOSA",245,36,105,64,20,189,0.146938775510204
"340490102","FORMOSA",374,120,138,49,6,193,0.320855614973262
"340490103","FORMOSA",276,54,166,45,4,215,0.195652173913043
"300844511","ENTRE RIOS",33,0,12,21,0,33,0
"340490105","FORMOSA",180,18,106,33,19,158,0.1
"340490106","FORMOSA",304,72,191,30,1,222,0.236842105263158
"340490107","FORMOSA",229,95,118,14,0,132,0.414847161572052
"340490108","FORMOSA",257,46,187,18,4,209,0.178988326848249
"340490109","FORMOSA",390,264,98,12,3,113,0.676923076923077
"340490110","FORMOSA",262,130,105,16,11,132,0.49618320610687
"340490111","FORMOSA",255,236,17,1,0,18,0.925490196078431
"340490112","FORMOSA",199,186,6,6,0,12,0.934673366834171
"340490113","FORMOSA",235,171,31,26,3,60,0.727659574468085
"301130202","ENTRE RIOS",111,111,0,0,0,0,1
"340490114","FORMOSA",404,138,137,89,10,236,0.341584158415842
"340490115","FORMOSA",326,49,185,74,7,266,0.150306748466258
"340490116","FORMOSA",249,144,54,17,12,83,0.578313253012048
"340490117","FORMOSA",262,87,152,20,2,174,0.33206106870229
"340490118","FORMOSA",220,62,118,33,2,153,0.281818181818182
"340490119","FORMOSA",328,122,172,29,2,203,0.371951219512195
"340490120","FORMOSA",275,72,146,39,6,191,0.261818181818182
"340490612","FORMOSA",254,5,152,77,17,246,0.0196850393700787
"340490613","FORMOSA",188,1,102,47,28,177,0.00531914893617021
"340491009","FORMOSA",258,251,3,2,1,6,0.972868217054264
"340490121","FORMOSA",318,35,78,140,31,249,0.110062893081761
"340490122","FORMOSA",323,80,204,20,1,225,0.247678018575851
"340490123","FORMOSA",239,79,136,20,0,156,0.330543933054393
"340490124","FORMOSA",307,63,122,70,16,208,0.205211726384365
"340490125","FORMOSA",260,21,177,40,3,220,0.0807692307692308
"340490126","FORMOSA",194,46,89,22,4,115,0.237113402061856
"340490707","FORMOSA",32,0,7,11,12,30,0
"340490127","FORMOSA",148,21,31,82,7,120,0.141891891891892
"340490128","FORMOSA",237,147,68,17,2,87,0.620253164556962
"340490201","FORMOSA",3,0,3,0,0,3,0
"340490301","FORMOSA",13,0,7,5,0,12,0
"340490614","FORMOSA",212,5,114,72,13,199,0.0235849056603774
"340561501","FORMOSA",159,0,27,78,33,138,0
"340490302","FORMOSA",148,11,24,73,26,123,0.0743243243243243
"340490303","FORMOSA",34,3,12,12,5,29,0.0882352941176471
"340490304","FORMOSA",43,0,2,32,7,41,0
"340490305","FORMOSA",43,0,4,24,15,43,0
"300840607","ENTRE RIOS",186,185,1,0,0,1,0.994623655913978
"340490401","FORMOSA",33,0,6,17,1,24,0
"340490402","FORMOSA",31,0,0,10,20,30,0
"340490701","FORMOSA",230,0,40,56,122,218,0
"340490403","FORMOSA",168,8,35,83,22,140,0.0476190476190476
"340490501","FORMOSA",16,0,0,15,0,15,0
"340490601","FORMOSA",101,0,28,17,45,90,0
"340490604","FORMOSA",104,0,30,31,22,83,0
"340490605","FORMOSA",9,0,0,3,4,7,0
"340490606","FORMOSA",71,0,9,22,40,71,0
"340561201","FORMOSA",12,0,1,10,1,12,0
"340491010","FORMOSA",353,332,11,3,5,19,0.940509915014164
"340490602","FORMOSA",230,0,40,90,77,207,0
"340490603","FORMOSA",196,4,30,83,72,185,0.0204081632653061
"340490607","FORMOSA",16,0,9,1,6,16,0
"340490608","FORMOSA",12,0,3,3,6,12,0
"340490708","FORMOSA",163,1,82,65,14,161,0.00613496932515337
"340490702","FORMOSA",101,0,34,22,41,97,0
"340490703","FORMOSA",414,20,125,157,82,364,0.0483091787439614
"340490704","FORMOSA",178,0,46,58,45,149,0
"340490705","FORMOSA",39,0,8,19,11,38,0
"340490803","FORMOSA",111,1,32,34,42,108,0.00900900900900901
"340490706","FORMOSA",177,0,25,85,52,162,0
"340491011","FORMOSA",226,37,134,46,3,183,0.163716814159292
"340490709","FORMOSA",62,1,12,10,38,60,0.0161290322580645
"340490710","FORMOSA",164,0,77,66,11,154,0
"340490801","FORMOSA",236,1,91,86,39,216,0.00423728813559322
"340490802","FORMOSA",93,0,30,26,33,89,0
"340490804","FORMOSA",569,0,154,101,232,487,0
"340490903","FORMOSA",215,1,76,75,52,203,0.00465116279069767
"340490805","FORMOSA",574,0,128,208,198,534,0
"340490806","FORMOSA",294,2,206,71,11,288,0.00680272108843537
"340490807","FORMOSA",160,0,73,61,23,157,0
"340490808","FORMOSA",175,1,100,38,32,170,0.00571428571428571
"340490901","FORMOSA",118,0,18,50,39,107,0
"340560708","FORMOSA",318,2,203,84,14,301,0.00628930817610063
"340490902","FORMOSA",306,0,47,96,149,292,0
"340490904","FORMOSA",10,0,5,2,2,9,0
"340491001","FORMOSA",6,0,2,4,0,6,0
"340491002","FORMOSA",54,0,10,30,7,47,0
"340491102","FORMOSA",140,0,55,56,13,124,0
"340491004","FORMOSA",304,40,151,89,12,252,0.131578947368421
"340491005","FORMOSA",336,318,8,5,0,13,0.946428571428571
"340491016","FORMOSA",341,241,83,17,0,100,0.706744868035191
"340491017","FORMOSA",210,61,97,8,0,105,0.29047619047619
"340491018","FORMOSA",280,101,67,57,17,141,0.360714285714286
"340491019","FORMOSA",276,33,151,72,15,238,0.119565217391304
"340491020","FORMOSA",273,104,118,29,13,160,0.380952380952381
"340491021","FORMOSA",261,49,157,38,4,199,0.187739463601533
"340491022","FORMOSA",127,126,1,0,0,1,0.992125984251969
"340491023","FORMOSA",1,0,0,0,0,0,0
"340491024","FORMOSA",36,4,17,13,2,32,0.111111111111111
"340491101","FORMOSA",296,3,113,162,16,291,0.0101351351351351
"340491003","FORMOSA",268,5,94,130,17,241,0.0186567164179104
"340491006","FORMOSA",350,331,14,2,2,18,0.945714285714286
"340491012","FORMOSA",318,87,176,38,6,220,0.273584905660377
"340491103","FORMOSA",241,12,169,55,2,226,0.0497925311203319
"340491104","FORMOSA",239,14,117,70,14,201,0.0585774058577406
"340491105","FORMOSA",191,24,130,27,2,159,0.12565445026178
"340491108","FORMOSA",114,7,98,9,0,107,0.0614035087719298
"340491109","FORMOSA",215,21,164,19,0,183,0.0976744186046512
"340560101","FORMOSA",313,3,95,136,32,263,0.00958466453674121
"340560102","FORMOSA",127,1,33,69,6,108,0.0078740157480315
"340560103","FORMOSA",270,0,189,68,6,263,0
"340560104","FORMOSA",300,21,199,49,5,253,0.07
"340560105","FORMOSA",221,3,97,87,13,197,0.0135746606334842
"340560106","FORMOSA",328,5,140,124,35,299,0.0152439024390244
"340560107","FORMOSA",260,3,190,61,3,254,0.0115384615384615
"340560108","FORMOSA",185,63,96,24,1,121,0.340540540540541
"340560110","FORMOSA",239,59,73,81,10,164,0.246861924686192
"340560111","FORMOSA",291,236,31,19,4,54,0.810996563573883
"340560112","FORMOSA",313,10,126,112,43,281,0.0319488817891374
"340560113","FORMOSA",224,4,150,44,14,208,0.0178571428571429
"340560204","FORMOSA",9,0,2,2,5,9,0
"340560205","FORMOSA",14,0,1,12,0,13,0
"340560301","FORMOSA",76,0,7,32,31,70,0
"340560114","FORMOSA",70,1,15,26,17,58,0.0142857142857143
"340560115","FORMOSA",144,5,22,51,33,106,0.0347222222222222
"340560116","FORMOSA",268,51,112,85,11,208,0.190298507462687
"340560117","FORMOSA",197,31,113,45,6,164,0.157360406091371
"340560201","FORMOSA",3,0,2,0,1,3,0
"340560202","FORMOSA",169,0,29,44,87,160,0
"340560203","FORMOSA",4,0,0,2,0,2,0
"221401312","CHACO",191,5,141,38,4,183,0.0261780104712042
"340560302","FORMOSA",21,0,7,4,10,21,0
"340560407","FORMOSA",198,0,127,44,10,181,0
"340560408","FORMOSA",314,13,176,76,21,273,0.0414012738853503
"340560409","FORMOSA",303,0,150,120,26,296,0
"340560303","FORMOSA",167,0,33,74,49,156,0
"340560304","FORMOSA",3,0,1,2,0,3,0
"340560709","FORMOSA",185,1,113,51,19,183,0.00540540540540541
"340560801","FORMOSA",47,0,12,24,11,47,0
"340560802","FORMOSA",58,0,5,25,25,55,0
"340560401","FORMOSA",11,0,1,4,0,5,0
"340560501","FORMOSA",187,0,24,119,39,182,0
"340560603","FORMOSA",76,0,4,68,4,76,0
"340560502","FORMOSA",111,0,26,29,34,89,0
"340560803","FORMOSA",15,0,0,7,2,9,0
"340560804","FORMOSA",24,0,10,9,1,20,0
"340561103","FORMOSA",202,16,157,22,1,180,0.0792079207920792
"340560402","FORMOSA",204,0,36,77,73,186,0
"340560403","FORMOSA",70,0,17,34,6,57,0
"340560404","FORMOSA",19,0,2,12,1,15,0
"340560405","FORMOSA",255,0,31,130,67,228,0
"340560406","FORMOSA",223,5,142,63,2,207,0.0224215246636771
"340561113","FORMOSA",192,4,117,59,10,186,0.0208333333333333
"340560503","FORMOSA",88,0,16,46,19,81,0
"340560504","FORMOSA",192,9,87,74,9,170,0.046875
"340560601","FORMOSA",86,0,12,29,33,74,0
"340560602","FORMOSA",71,0,20,36,9,65,0
"340560604","FORMOSA",35,0,14,11,3,28,0
"340560605","FORMOSA",85,0,14,47,22,83,0
"340560701","FORMOSA",213,0,34,107,36,177,0
"340560702","FORMOSA",51,0,10,27,10,47,0
"340560703","FORMOSA",29,0,8,15,5,28,0
"340560704","FORMOSA",27,0,13,13,0,26,0
"340560705","FORMOSA",228,5,132,70,8,210,0.0219298245614035
"340560706","FORMOSA",223,0,119,88,5,212,0
"340561109","FORMOSA",232,1,37,100,62,199,0.00431034482758621
"340560707","FORMOSA",280,5,195,66,6,267,0.0178571428571429
"300080610","ENTRE RIOS",225,219,3,3,0,6,0.973333333333333
"340560805","FORMOSA",51,0,4,30,15,49,0
"340560901","FORMOSA",67,0,9,22,32,63,0
"340560902","FORMOSA",45,0,2,14,20,36,0
"340560903","FORMOSA",15,0,7,4,1,12,0
"340561110","FORMOSA",219,4,104,79,11,194,0.0182648401826484
"340561005","FORMOSA",30,0,4,16,3,23,0
"340561101","FORMOSA",268,5,123,90,28,241,0.0186567164179104
"065682103","BUENOS AIRES",150,144,0,0,0,0,0.96
"340561001","FORMOSA",117,0,19,58,31,108,0
"340561002","FORMOSA",32,0,5,8,12,25,0
"340561003","FORMOSA",93,0,11,26,41,78,0
"340561004","FORMOSA",52,0,2,11,31,44,0
"340561111","FORMOSA",201,2,142,8,3,153,0.00995024875621891
"340561112","FORMOSA",257,7,208,10,1,219,0.0272373540856031
"340561505","FORMOSA",7,0,0,2,3,5,0
"340561104","FORMOSA",208,5,61,81,19,161,0.0240384615384615
"340561105","FORMOSA",257,6,134,82,4,220,0.0233463035019455
"340561106","FORMOSA",175,6,116,42,0,158,0.0342857142857143
"340561107","FORMOSA",198,23,127,30,1,158,0.116161616161616
"340561108","FORMOSA",285,11,173,71,3,247,0.0385964912280702
"340561506","FORMOSA",161,0,31,60,36,127,0
"340561114","FORMOSA",159,2,86,57,3,146,0.0125786163522013
"340561115","FORMOSA",215,2,159,36,13,208,0.00930232558139535
"340561116","FORMOSA",234,2,90,66,37,193,0.00854700854700855
"340561117","FORMOSA",233,9,54,106,35,195,0.0386266094420601
"340561118","FORMOSA",208,2,113,49,6,168,0.00961538461538462
"340561119","FORMOSA",275,6,102,129,21,252,0.0218181818181818
"340561120","FORMOSA",192,16,155,13,1,169,0.0833333333333333
"340561121","FORMOSA",219,3,76,89,13,178,0.0136986301369863
"340561122","FORMOSA",160,1,14,92,33,139,0.00625
"340561202","FORMOSA",124,1,25,72,16,113,0.00806451612903226
"340561203","FORMOSA",9,0,6,3,0,9,0
"340561301","FORMOSA",56,1,8,20,20,48,0.0178571428571429
"340561507","FORMOSA",184,5,96,26,38,160,0.0271739130434783
"340561302","FORMOSA",34,0,10,20,4,34,0
"340561401","FORMOSA",88,0,4,47,18,69,0
"340561402","FORMOSA",188,0,36,77,41,154,0
"340561403","FORMOSA",38,0,7,5,5,17,0
"340561404","FORMOSA",22,0,3,14,4,21,0
"340561405","FORMOSA",34,0,3,7,5,15,0
"340561406","FORMOSA",53,0,4,35,10,49,0
"340561407","FORMOSA",60,0,6,22,18,46,0
"340561408","FORMOSA",196,0,21,115,36,172,0
"340561409","FORMOSA",316,23,79,147,51,277,0.0727848101265823
"340561502","FORMOSA",28,0,3,10,14,27,0
"340561503","FORMOSA",71,1,11,28,27,66,0.0140845070422535
"340561504","FORMOSA",27,0,3,10,6,19,0
"340561508","FORMOSA",255,14,109,76,21,206,0.0549019607843137
"340561509","FORMOSA",236,2,96,109,25,230,0.00847457627118644
"340561510","FORMOSA",254,0,88,131,5,224,0
"340561511","FORMOSA",233,0,88,84,18,190,0
"340561512","FORMOSA",266,2,123,106,26,255,0.0075187969924812
"340561513","FORMOSA",212,0,90,90,20,200,0
"340561601","FORMOSA",62,0,14,21,25,60,0
"340561602","FORMOSA",16,0,1,12,3,16,0
"340561603","FORMOSA",20,0,1,18,0,19,0
"340561604","FORMOSA",64,0,5,26,11,42,0
"340561701","FORMOSA",32,0,1,11,15,27,0
"340561702","FORMOSA",34,0,4,21,7,32,0
"340561801","FORMOSA",72,0,19,36,16,71,0
"300080112","ENTRE RIOS",219,215,1,2,0,3,0.981735159817352
"340561802","FORMOSA",61,0,10,47,2,59,0
"340561803","FORMOSA",14,0,5,2,1,8,0
"340630101","FORMOSA",373,0,17,54,47,118,0
"300080102","ENTRE RIOS",187,125,45,16,0,61,0.668449197860963
"300080103","ENTRE RIOS",184,167,8,9,0,17,0.907608695652174
"340630102","FORMOSA",456,0,18,119,87,224,0
"340630201","FORMOSA",276,0,10,66,39,115,0
"300080113","ENTRE RIOS",188,176,5,7,0,12,0.936170212765957
"300080114","ENTRE RIOS",205,185,14,6,0,20,0.902439024390244
"300080201","ENTRE RIOS",150,146,3,1,0,4,0.973333333333333
"340630202","FORMOSA",378,0,17,86,79,182,0
"340630203","FORMOSA",241,0,14,34,91,139,0
"340630204","FORMOSA",358,0,46,108,132,286,0
"340630205","FORMOSA",319,0,31,108,73,212,0
"300080202","ENTRE RIOS",116,116,0,0,0,0,1
"300080301","ENTRE RIOS",50,0,41,8,0,49,0
"300080101","ENTRE RIOS",133,46,50,35,0,85,0.345864661654135
"300080104","ENTRE RIOS",171,92,40,36,0,76,0.538011695906433
"340630206","FORMOSA",192,0,75,67,18,160,0
"340630207","FORMOSA",203,0,22,61,61,144,0
"300080216","ENTRE RIOS",177,107,36,25,0,61,0.604519774011299
"300080105","ENTRE RIOS",170,140,16,8,0,24,0.823529411764706
"300080106","ENTRE RIOS",192,171,18,3,0,21,0.890625
"300080107","ENTRE RIOS",116,114,0,2,0,2,0.982758620689655
"300080108","ENTRE RIOS",173,162,9,1,0,10,0.936416184971098
"300080109","ENTRE RIOS",209,205,3,1,0,4,0.980861244019139
"300080110","ENTRE RIOS",226,215,7,4,0,11,0.951327433628319
"300080111","ENTRE RIOS",294,277,12,4,0,16,0.942176870748299
"300080203","ENTRE RIOS",138,137,1,0,0,1,0.992753623188406
"300080204","ENTRE RIOS",204,202,1,1,0,2,0.990196078431373
"300080205","ENTRE RIOS",206,203,1,2,0,3,0.985436893203884
"300080206","ENTRE RIOS",272,266,2,3,0,5,0.977941176470588
"300080207","ENTRE RIOS",334,284,21,24,0,45,0.850299401197605
"300080208","ENTRE RIOS",329,264,15,40,0,55,0.802431610942249
"300080209","ENTRE RIOS",164,161,1,2,0,3,0.981707317073171
"300080210","ENTRE RIOS",177,171,4,2,0,6,0.966101694915254
"300080211","ENTRE RIOS",171,168,1,1,0,2,0.982456140350877
"300080212","ENTRE RIOS",74,70,1,1,2,4,0.945945945945946
"300080213","ENTRE RIOS",59,58,0,1,0,1,0.983050847457627
"300080214","ENTRE RIOS",106,100,2,3,0,5,0.943396226415094
"300080215","ENTRE RIOS",181,158,8,14,0,22,0.87292817679558
"300080302","ENTRE RIOS",77,0,53,22,2,77,0
"300080303","ENTRE RIOS",95,3,61,29,0,90,0.0315789473684211
"300080304","ENTRE RIOS",90,55,12,23,0,35,0.611111111111111
"300080404","ENTRE RIOS",326,238,39,45,0,84,0.730061349693252
"300080305","ENTRE RIOS",193,112,43,38,0,81,0.580310880829015
"300080306","ENTRE RIOS",273,69,59,130,1,190,0.252747252747253
"300080307","ENTRE RIOS",181,130,21,27,0,48,0.718232044198895
"300080308","ENTRE RIOS",260,236,5,15,0,20,0.907692307692308
"300080309","ENTRE RIOS",79,70,6,3,0,9,0.886075949367089
"300080310","ENTRE RIOS",218,188,16,14,0,30,0.862385321100917
"300080317","ENTRE RIOS",60,0,47,8,0,55,0
"300080311","ENTRE RIOS",239,64,83,84,1,168,0.267782426778243
"300080312","ENTRE RIOS",202,70,63,64,0,127,0.346534653465347
"300080405","ENTRE RIOS",338,266,33,35,0,68,0.78698224852071
"300080609","ENTRE RIOS",182,180,1,1,0,2,0.989010989010989
"300080313","ENTRE RIOS",185,42,18,105,3,126,0.227027027027027
"300080314","ENTRE RIOS",102,0,70,32,0,102,0
"300080315","ENTRE RIOS",118,1,87,27,0,114,0.00847457627118644
"300080316","ENTRE RIOS",28,0,23,3,1,27,0
"220700601","CHACO",63,0,15,32,8,55,0
"300080406","ENTRE RIOS",382,327,26,22,0,48,0.856020942408377
"300080407","ENTRE RIOS",158,118,8,32,0,40,0.746835443037975
"300080318","ENTRE RIOS",55,1,45,7,0,52,0.0181818181818182
"300080319","ENTRE RIOS",54,0,31,18,0,49,0
"300080401","ENTRE RIOS",166,0,132,32,0,164,0
"300080402","ENTRE RIOS",362,223,75,58,2,135,0.616022099447514
"300080403","ENTRE RIOS",326,269,41,13,0,54,0.825153374233129
"300080408","ENTRE RIOS",247,245,1,1,0,2,0.991902834008097
"300080409","ENTRE RIOS",284,279,4,0,0,4,0.982394366197183
"300080410","ENTRE RIOS",331,311,10,10,0,20,0.939577039274924
"300080411","ENTRE RIOS",273,211,38,16,1,55,0.772893772893773
"300080412","ENTRE RIOS",426,373,28,22,1,51,0.875586854460094
"300080413","ENTRE RIOS",176,168,5,1,0,6,0.954545454545455
"300080501","ENTRE RIOS",41,0,36,5,0,41,0
"300080502","ENTRE RIOS",69,0,53,12,0,65,0
"300080503","ENTRE RIOS",75,0,38,23,0,61,0
"300080604","ENTRE RIOS",295,295,0,0,0,0,1
"220700602","CHACO",40,0,9,23,0,32,0
"300080504","ENTRE RIOS",156,2,108,40,0,148,0.0128205128205128
"300080511","ENTRE RIOS",70,2,44,23,1,68,0.0285714285714286
"300080505","ENTRE RIOS",55,0,29,26,0,55,0
"300080506","ENTRE RIOS",352,1,166,157,10,333,0.00284090909090909
"300080507","ENTRE RIOS",336,1,230,90,7,327,0.00297619047619048
"300080508","ENTRE RIOS",351,20,267,59,0,326,0.056980056980057
"300080509","ENTRE RIOS",175,16,93,56,0,149,0.0914285714285714
"300080510","ENTRE RIOS",199,105,74,18,0,92,0.527638190954774
"300080607","ENTRE RIOS",304,303,0,1,0,1,0.996710526315789
"300080608","ENTRE RIOS",369,327,26,14,1,41,0.886178861788618
"300080601","ENTRE RIOS",292,277,11,2,0,13,0.948630136986301
"300080602","ENTRE RIOS",353,347,1,5,0,6,0.98300283286119
"300080603","ENTRE RIOS",186,186,0,0,0,0,1
"300080605","ENTRE RIOS",367,359,2,6,0,8,0.978201634877384
"300080606","ENTRE RIOS",334,334,0,0,0,0,1
"300080611","ENTRE RIOS",340,338,1,1,0,2,0.994117647058824
"300080612","ENTRE RIOS",265,218,16,28,3,47,0.822641509433962
"300080701","ENTRE RIOS",7,0,4,3,0,7,0
"300080702","ENTRE RIOS",31,0,16,15,0,31,0
"300080706","ENTRE RIOS",16,1,5,10,0,15,0.0625
"300080707","ENTRE RIOS",36,0,20,16,0,36,0
"220700603","CHACO",73,0,39,14,14,67,0
"300080708","ENTRE RIOS",20,0,16,3,1,20,0
"300080709","ENTRE RIOS",23,0,11,11,1,23,0
"300150105","ENTRE RIOS",329,297,4,10,3,17,0.90273556231003
"300080703","ENTRE RIOS",97,4,42,46,2,90,0.0412371134020619
"300080704","ENTRE RIOS",10,0,7,3,0,10,0
"300080705","ENTRE RIOS",58,2,32,24,0,56,0.0344827586206897
"300080710","ENTRE RIOS",22,0,15,7,0,22,0
"300080711","ENTRE RIOS",67,58,1,0,0,1,0.865671641791045
"300080801","ENTRE RIOS",17,0,15,2,0,17,0
"300080802","ENTRE RIOS",12,0,11,0,0,11,0
"300080803","ENTRE RIOS",10,0,7,2,0,9,0
"300150203","ENTRE RIOS",274,245,12,9,1,22,0.894160583941606
"300080804","ENTRE RIOS",36,0,27,9,0,36,0
"820842722","SANTA FE",186,184,2,0,0,2,0.989247311827957
"300080805","ENTRE RIOS",24,1,12,9,0,21,0.0416666666666667
"300080806","ENTRE RIOS",16,0,14,1,0,15,0
"300080807","ENTRE RIOS",90,0,40,33,3,76,0
"300081004","ENTRE RIOS",17,0,11,6,0,17,0
"300081109","ENTRE RIOS",112,17,72,20,2,94,0.151785714285714
"300081110","ENTRE RIOS",417,213,133,54,3,190,0.510791366906475
"300080808","ENTRE RIOS",47,0,29,16,1,46,0
"300080809","ENTRE RIOS",15,0,12,2,1,15,0
"300080810","ENTRE RIOS",45,0,37,5,1,43,0
"300150201","ENTRE RIOS",411,244,10,130,0,140,0.59367396593674
"300080811","ENTRE RIOS",37,0,15,21,0,36,0
"300080901","ENTRE RIOS",23,0,14,6,0,20,0
"300080902","ENTRE RIOS",23,0,19,4,0,23,0
"300080903","ENTRE RIOS",20,1,12,6,0,18,0.05
"300080904","ENTRE RIOS",8,0,5,3,0,8,0
"300080905","ENTRE RIOS",30,0,23,6,0,29,0
"300080906","ENTRE RIOS",70,0,38,27,1,66,0
"300080907","ENTRE RIOS",14,0,9,2,2,13,0
"300080908","ENTRE RIOS",5,0,1,4,0,5,0
"300081001","ENTRE RIOS",27,0,11,14,0,25,0
"300150202","ENTRE RIOS",271,256,2,11,0,13,0.944649446494465
"300080909","ENTRE RIOS",31,0,24,7,0,31,0
"300081002","ENTRE RIOS",23,9,9,4,0,13,0.391304347826087
"300081101","ENTRE RIOS",34,0,15,12,2,29,0
"300080910","ENTRE RIOS",224,187,20,12,0,32,0.834821428571429
"300081003","ENTRE RIOS",171,157,5,2,1,8,0.91812865497076
"820842719","SANTA FE",202,202,0,0,0,0,1
"300081005","ENTRE RIOS",35,0,17,16,2,35,0
"300081006","ENTRE RIOS",16,0,11,3,2,16,0
"300081007","ENTRE RIOS",134,0,85,41,3,129,0
"300081008","ENTRE RIOS",22,0,17,3,0,20,0
"300081111","ENTRE RIOS",134,63,22,41,2,65,0.470149253731343
"300081201","ENTRE RIOS",1,0,0,1,0,1,0
"300150101","ENTRE RIOS",388,326,8,40,3,51,0.84020618556701
"300150502","ENTRE RIOS",393,390,2,1,0,3,0.99236641221374
"300081009","ENTRE RIOS",10,0,2,2,0,4,0
"300081102","ENTRE RIOS",23,0,6,8,0,14,0
"300081103","ENTRE RIOS",27,0,24,2,0,26,0
"300081104","ENTRE RIOS",16,0,10,4,1,15,0
"300150102","ENTRE RIOS",349,344,4,0,0,4,0.98567335243553
"300150302","ENTRE RIOS",354,347,1,6,0,7,0.980225988700565
"300081105","ENTRE RIOS",39,1,21,10,2,33,0.0256410256410256
"300150103","ENTRE RIOS",509,416,39,27,2,68,0.817288801571709
"300150104","ENTRE RIOS",458,415,21,7,0,28,0.906113537117904
"300081106","ENTRE RIOS",4,0,2,2,0,4,0
"300081107","ENTRE RIOS",23,2,19,0,0,19,0.0869565217391304
"300081108","ENTRE RIOS",224,3,179,37,0,216,0.0133928571428571
"300150106","ENTRE RIOS",407,310,14,43,1,58,0.761670761670762
"300150107","ENTRE RIOS",346,313,4,10,4,18,0.904624277456647
"300150108","ENTRE RIOS",286,197,65,13,1,79,0.688811188811189
"300150109","ENTRE RIOS",292,274,6,5,0,11,0.938356164383562
"300150110","ENTRE RIOS",197,115,42,27,0,69,0.583756345177665
"300150111","ENTRE RIOS",485,243,17,149,19,185,0.501030927835052
"300150112","ENTRE RIOS",346,231,44,42,2,88,0.667630057803468
"300150113","ENTRE RIOS",425,183,94,120,4,218,0.430588235294118
"300150303","ENTRE RIOS",424,424,0,0,0,0,1
"300150204","ENTRE RIOS",337,312,2,8,0,10,0.925816023738872
"300150503","ENTRE RIOS",215,209,4,1,0,5,0.972093023255814
"300150205","ENTRE RIOS",477,418,45,5,1,51,0.876310272536688
"300150206","ENTRE RIOS",337,326,4,4,0,8,0.967359050445104
"300150207","ENTRE RIOS",195,192,0,3,0,3,0.984615384615385
"300150208","ENTRE RIOS",349,330,6,8,0,14,0.945558739255014
"300150209","ENTRE RIOS",416,388,12,8,0,20,0.932692307692308
"300150210","ENTRE RIOS",422,368,12,17,4,33,0.872037914691943
"300150211","ENTRE RIOS",334,325,3,5,0,8,0.973053892215569
"300150212","ENTRE RIOS",401,352,21,20,0,41,0.877805486284289
"300150213","ENTRE RIOS",406,384,5,2,0,7,0.945812807881773
"300150214","ENTRE RIOS",236,226,2,3,0,5,0.957627118644068
"300150301","ENTRE RIOS",281,271,10,0,0,10,0.9644128113879
"300150304","ENTRE RIOS",349,330,15,4,0,19,0.945558739255014
"300150305","ENTRE RIOS",380,202,67,58,16,141,0.531578947368421
"300150306","ENTRE RIOS",52,30,19,2,0,21,0.576923076923077
"300150307","ENTRE RIOS",106,58,42,6,0,48,0.547169811320755
"300150308","ENTRE RIOS",388,296,75,15,0,90,0.762886597938144
"300150309","ENTRE RIOS",332,275,5,30,2,37,0.828313253012048
"300150310","ENTRE RIOS",228,191,10,21,2,33,0.837719298245614
"300150401","ENTRE RIOS",287,265,15,6,1,22,0.923344947735192
"300150402","ENTRE RIOS",189,187,2,0,0,2,0.989417989417989
"300150403","ENTRE RIOS",334,311,17,2,0,19,0.931137724550898
"300150404","ENTRE RIOS",309,294,10,3,0,13,0.951456310679612
"300150405","ENTRE RIOS",322,250,41,20,10,71,0.77639751552795
"300150713","ENTRE RIOS",197,191,2,2,0,4,0.969543147208122
"300150504","ENTRE RIOS",206,197,1,3,0,4,0.956310679611651
"300150406","ENTRE RIOS",386,347,34,5,0,39,0.898963730569948
"300150407","ENTRE RIOS",328,308,6,7,0,13,0.939024390243902
"300150408","ENTRE RIOS",312,238,26,38,0,64,0.762820512820513
"300150409","ENTRE RIOS",240,174,57,7,0,64,0.725
"300150410","ENTRE RIOS",318,264,37,12,0,49,0.830188679245283
"300150411","ENTRE RIOS",441,379,42,15,0,57,0.859410430839002
"300150412","ENTRE RIOS",412,314,48,26,9,83,0.762135922330097
"300150413","ENTRE RIOS",422,394,11,10,0,21,0.933649289099526
"300150414","ENTRE RIOS",263,261,0,1,0,1,0.992395437262357
"300150415","ENTRE RIOS",119,109,1,8,0,9,0.915966386554622
"300150416","ENTRE RIOS",441,431,3,5,0,8,0.977324263038549
"300150501","ENTRE RIOS",185,183,2,0,0,2,0.989189189189189
"300150505","ENTRE RIOS",185,75,43,24,9,76,0.405405405405405
"300150506","ENTRE RIOS",267,258,9,0,0,9,0.966292134831461
"300150507","ENTRE RIOS",256,197,22,24,1,47,0.76953125
"300150508","ENTRE RIOS",249,234,10,4,0,14,0.939759036144578
"300150509","ENTRE RIOS",276,150,48,42,4,94,0.543478260869565
"300150510","ENTRE RIOS",188,187,0,1,0,1,0.99468085106383
"300150511","ENTRE RIOS",188,187,1,0,0,1,0.99468085106383
"300150512","ENTRE RIOS",159,155,1,0,0,1,0.974842767295597
"300150513","ENTRE RIOS",166,165,1,0,0,1,0.993975903614458
"300150514","ENTRE RIOS",146,145,1,0,0,1,0.993150684931507
"300150515","ENTRE RIOS",221,221,0,0,0,0,1
"300150516","ENTRE RIOS",185,185,0,0,0,0,1
"300150517","ENTRE RIOS",208,208,0,0,0,0,1
"300150518","ENTRE RIOS",149,148,1,0,0,1,0.993288590604027
"300150519","ENTRE RIOS",197,193,4,0,0,4,0.979695431472081
"300150520","ENTRE RIOS",223,218,2,0,0,2,0.977578475336323
"300150521","ENTRE RIOS",113,106,2,1,0,3,0.938053097345133
"300150615","ENTRE RIOS",228,225,1,0,1,2,0.986842105263158
"300150522","ENTRE RIOS",384,254,42,54,4,100,0.661458333333333
"300150601","ENTRE RIOS",352,219,46,66,2,114,0.622159090909091
"300150602","ENTRE RIOS",206,159,33,12,1,46,0.771844660194175
"300150603","ENTRE RIOS",474,417,18,18,1,37,0.879746835443038
"300150604","ENTRE RIOS",418,381,20,11,0,31,0.911483253588517
"300150605","ENTRE RIOS",150,135,6,8,0,14,0.9
"300150606","ENTRE RIOS",264,245,10,7,0,17,0.928030303030303
"300150607","ENTRE RIOS",340,333,2,3,1,6,0.979411764705882
"300150608","ENTRE RIOS",245,245,0,0,0,0,1
"300150609","ENTRE RIOS",254,254,0,0,0,0,1
"300150610","ENTRE RIOS",230,230,0,0,0,0,1
"300150611","ENTRE RIOS",171,147,0,0,0,0,0.859649122807018
"300150612","ENTRE RIOS",196,196,0,0,0,0,1
"300150613","ENTRE RIOS",357,345,3,2,0,5,0.966386554621849
"300150614","ENTRE RIOS",449,432,9,3,0,12,0.962138084632517
"300150616","ENTRE RIOS",301,293,2,2,0,4,0.973421926910299
"300150617","ENTRE RIOS",268,266,2,0,0,2,0.992537313432836
"300150618","ENTRE RIOS",124,119,5,0,0,5,0.959677419354839
"300150619","ENTRE RIOS",213,213,0,0,0,0,1
"300150620","ENTRE RIOS",112,112,0,0,0,0,1
"300150621","ENTRE RIOS",136,136,0,0,0,0,1
"300150701","ENTRE RIOS",269,206,38,21,1,60,0.765799256505576
"300150702","ENTRE RIOS",169,162,4,3,0,7,0.958579881656805
"300150703","ENTRE RIOS",195,195,0,0,0,0,1
"300150704","ENTRE RIOS",154,154,0,0,0,0,1
"300150705","ENTRE RIOS",146,146,0,0,0,0,1
"300150706","ENTRE RIOS",118,118,0,0,0,0,1
"300150707","ENTRE RIOS",168,168,0,0,0,0,1
"300150708","ENTRE RIOS",174,172,2,0,0,2,0.988505747126437
"300150709","ENTRE RIOS",179,178,0,1,0,1,0.994413407821229
"300150710","ENTRE RIOS",256,138,59,35,16,110,0.5390625
"300150711","ENTRE RIOS",229,219,4,2,0,6,0.956331877729258
"300150712","ENTRE RIOS",247,199,8,8,2,18,0.805668016194332
"300150715","ENTRE RIOS",183,178,2,1,0,3,0.972677595628415
"300150716","ENTRE RIOS",284,260,5,6,0,11,0.915492957746479
"300150717","ENTRE RIOS",17,11,1,2,1,4,0.647058823529412
"300150718","ENTRE RIOS",421,394,7,9,2,18,0.935866983372922
"300150719","ENTRE RIOS",387,303,15,31,1,47,0.782945736434108
"300150720","ENTRE RIOS",131,49,9,39,3,51,0.374045801526718
"300150801","ENTRE RIOS",161,161,0,0,0,0,1
"300150802","ENTRE RIOS",142,141,1,0,0,1,0.992957746478873
"300150803","ENTRE RIOS",132,132,0,0,0,0,1
"300150804","ENTRE RIOS",149,149,0,0,0,0,1
"300150805","ENTRE RIOS",181,181,0,0,0,0,1
"300151001","ENTRE RIOS",187,17,55,71,25,151,0.0909090909090909
"221400118","CHACO",217,1,154,48,13,215,0.00460829493087558
"300150806","ENTRE RIOS",200,197,2,1,0,3,0.985
"300150807","ENTRE RIOS",359,358,1,0,0,1,0.997214484679666
"300150808","ENTRE RIOS",217,216,0,0,0,0,0.995391705069124
"300150809","ENTRE RIOS",177,177,0,0,0,0,1
"300150810","ENTRE RIOS",220,220,0,0,0,0,1
"300150811","ENTRE RIOS",221,219,1,0,0,1,0.990950226244344
"300150812","ENTRE RIOS",198,196,2,0,0,2,0.98989898989899
"300150813","ENTRE RIOS",5,3,0,2,0,2,0.6
"300150814","ENTRE RIOS",355,274,9,42,12,63,0.771830985915493
"300150815","ENTRE RIOS",93,83,3,2,2,7,0.89247311827957
"300150901","ENTRE RIOS",80,0,57,10,11,78,0
"300150902","ENTRE RIOS",91,1,65,16,3,84,0.010989010989011
"300151002","ENTRE RIOS",410,310,10,71,11,92,0.75609756097561
"300151003","ENTRE RIOS",183,92,65,25,0,90,0.502732240437158
"300150903","ENTRE RIOS",23,1,16,5,0,21,0.0434782608695652
"300150904","ENTRE RIOS",262,196,29,23,0,52,0.748091603053435
"300150905","ENTRE RIOS",316,230,49,35,0,84,0.727848101265823
"300150906","ENTRE RIOS",318,50,95,153,5,253,0.157232704402516
"300150907","ENTRE RIOS",298,42,126,101,5,232,0.140939597315436
"300150908","ENTRE RIOS",303,90,39,163,0,202,0.297029702970297
"300150909","ENTRE RIOS",142,8,117,16,0,133,0.0563380281690141
"300150910","ENTRE RIOS",124,18,71,32,1,104,0.145161290322581
"300151004","ENTRE RIOS",472,336,69,44,8,121,0.711864406779661
"300151005","ENTRE RIOS",394,237,38,83,3,124,0.601522842639594
"300151006","ENTRE RIOS",303,208,26,44,11,81,0.686468646864686
"300151007","ENTRE RIOS",307,198,30,63,3,96,0.644951140065147
"300151008","ENTRE RIOS",335,161,50,96,0,146,0.480597014925373
"300151009","ENTRE RIOS",416,200,55,127,10,192,0.480769230769231
"300151010","ENTRE RIOS",297,237,46,11,0,57,0.797979797979798
"300151011","ENTRE RIOS",398,206,53,95,8,156,0.517587939698492
"300151012","ENTRE RIOS",441,263,59,80,7,146,0.596371882086168
"300151013","ENTRE RIOS",295,68,108,91,0,199,0.230508474576271
"300151101","ENTRE RIOS",238,120,48,46,0,94,0.504201680672269
"300491007","ENTRE RIOS",305,291,5,6,2,13,0.954098360655738
"300210205","ENTRE RIOS",127,3,68,55,0,123,0.0236220472440945
"300151102","ENTRE RIOS",11,4,1,5,0,6,0.363636363636364
"300151103","ENTRE RIOS",224,185,28,10,0,38,0.825892857142857
"300151104","ENTRE RIOS",181,156,15,7,0,22,0.861878453038674
"300151105","ENTRE RIOS",349,142,85,97,6,188,0.406876790830946
"300151106","ENTRE RIOS",205,180,21,3,0,24,0.878048780487805
"300151107","ENTRE RIOS",203,68,37,86,1,124,0.334975369458128
"300151108","ENTRE RIOS",234,89,124,19,0,143,0.38034188034188
"300151401","ENTRE RIOS",11,0,6,5,0,11,0
"300151109","ENTRE RIOS",54,13,11,22,1,34,0.240740740740741
"300210206","ENTRE RIOS",93,5,29,58,0,87,0.0537634408602151
"300151110","ENTRE RIOS",237,6,122,103,4,229,0.0253164556962025
"300151111","ENTRE RIOS",177,65,77,24,3,104,0.367231638418079
"300151204","ENTRE RIOS",42,7,22,11,1,34,0.166666666666667
"300151208","ENTRE RIOS",65,2,34,15,3,52,0.0307692307692308
"300151201","ENTRE RIOS",59,0,45,7,2,54,0
"300151209","ENTRE RIOS",23,0,13,9,0,22,0
"300151210","ENTRE RIOS",48,2,41,5,0,46,0.0416666666666667
"300491008","ENTRE RIOS",184,178,0,6,0,6,0.967391304347826
"300151202","ENTRE RIOS",33,2,17,11,2,30,0.0606060606060606
"300151203","ENTRE RIOS",42,25,10,5,0,15,0.595238095238095
"300151211","ENTRE RIOS",58,6,23,29,0,52,0.103448275862069
"300560216","ENTRE RIOS",292,285,4,2,0,6,0.976027397260274
"300151205","ENTRE RIOS",12,9,2,1,0,3,0.75
"300151206","ENTRE RIOS",29,0,24,4,1,29,0
"300151207","ENTRE RIOS",16,1,12,3,0,15,0.0625
"300151212","ENTRE RIOS",275,167,70,24,0,94,0.607272727272727
"300151213","ENTRE RIOS",300,190,99,8,0,107,0.633333333333333
"300151214","ENTRE RIOS",296,142,136,17,0,153,0.47972972972973
"300151301","ENTRE RIOS",110,3,88,15,2,105,0.0272727272727273
"300151302","ENTRE RIOS",20,0,16,2,1,19,0
"300151303","ENTRE RIOS",17,0,15,0,1,16,0
"300151304","ENTRE RIOS",306,264,12,20,0,32,0.862745098039216
"300151305","ENTRE RIOS",140,90,4,37,4,45,0.642857142857143
"300151306","ENTRE RIOS",44,0,37,7,0,44,0
"300151307","ENTRE RIOS",50,3,38,9,0,47,0.06
"300151308","ENTRE RIOS",34,0,24,9,0,33,0
"300151309","ENTRE RIOS",15,0,11,2,0,13,0
"300151310","ENTRE RIOS",224,10,129,71,3,203,0.0446428571428571
"300151311","ENTRE RIOS",255,115,84,51,0,135,0.450980392156863
"300151312","ENTRE RIOS",193,121,28,35,1,64,0.626943005181347
"300151402","ENTRE RIOS",9,0,5,4,0,9,0
"300151407","ENTRE RIOS",32,0,22,4,5,31,0
"300151408","ENTRE RIOS",82,0,49,21,0,70,0
"300151404","ENTRE RIOS",59,13,16,13,1,30,0.220338983050847
"300151405","ENTRE RIOS",22,0,7,14,0,21,0
"300280513","ENTRE RIOS",156,138,14,3,1,18,0.884615384615385
"300151501","ENTRE RIOS",57,0,27,21,4,52,0
"300151502","ENTRE RIOS",54,1,33,11,0,44,0.0185185185185185
"300151503","ENTRE RIOS",6,0,2,2,1,5,0
"300151504","ENTRE RIOS",60,1,42,14,3,59,0.0166666666666667
"300151505","ENTRE RIOS",57,1,52,4,0,56,0.0175438596491228
"300280107","ENTRE RIOS",256,253,2,0,0,2,0.98828125
"300151403","ENTRE RIOS",58,0,31,18,0,49,0
"300151406","ENTRE RIOS",30,0,23,5,0,28,0
"300151509","ENTRE RIOS",34,1,23,6,2,31,0.0294117647058824
"300151506","ENTRE RIOS",68,2,46,9,0,55,0.0294117647058824
"300151507","ENTRE RIOS",56,0,22,23,2,47,0
"300151508","ENTRE RIOS",43,0,30,11,2,43,0
"300151510","ENTRE RIOS",161,1,71,70,8,149,0.0062111801242236
"300151511","ENTRE RIOS",236,17,131,66,5,202,0.0720338983050847
"300280514","ENTRE RIOS",293,287,2,0,0,2,0.979522184300341
"300151512","ENTRE RIOS",78,9,46,23,0,69,0.115384615384615
"221400201","CHACO",237,229,5,3,0,8,0.966244725738397
"300210210","ENTRE RIOS",297,259,13,25,0,38,0.872053872053872
"300210211","ENTRE RIOS",248,229,1,17,0,18,0.923387096774194
"300280415","ENTRE RIOS",207,196,7,3,0,10,0.946859903381642
"300151513","ENTRE RIOS",87,23,52,8,0,60,0.264367816091954
"300151514","ENTRE RIOS",102,22,56,22,0,78,0.215686274509804
"300151515","ENTRE RIOS",99,11,42,42,0,84,0.111111111111111
"300210106","ENTRE RIOS",272,256,7,7,0,14,0.941176470588235
"301130203","ENTRE RIOS",186,185,1,0,0,1,0.994623655913978
"300151601","ENTRE RIOS",11,0,4,7,0,11,0
"300210207","ENTRE RIOS",184,31,51,102,0,153,0.168478260869565
"300210312","ENTRE RIOS",41,1,0,37,0,37,0.024390243902439
"300151602","ENTRE RIOS",51,1,33,13,3,49,0.0196078431372549
"300151603","ENTRE RIOS",24,1,11,8,0,19,0.0416666666666667
"300151604","ENTRE RIOS",14,0,13,1,0,14,0
"300210208","ENTRE RIOS",168,141,14,8,1,23,0.839285714285714
"300210209","ENTRE RIOS",134,71,16,47,0,63,0.529850746268657
"300560217","ENTRE RIOS",231,218,10,1,0,11,0.943722943722944
"300151605","ENTRE RIOS",25,0,21,3,0,24,0
"300151606","ENTRE RIOS",131,0,92,21,5,118,0
"300151607","ENTRE RIOS",134,3,55,48,19,122,0.0223880597014925
"300210101","ENTRE RIOS",261,232,6,22,0,28,0.888888888888889
"300210102","ENTRE RIOS",291,83,106,99,1,206,0.285223367697594
"300210103","ENTRE RIOS",44,7,28,4,5,37,0.159090909090909
"300210104","ENTRE RIOS",313,212,44,56,0,100,0.677316293929712
"300210105","ENTRE RIOS",217,205,5,6,0,11,0.944700460829493
"300210107","ENTRE RIOS",283,208,18,54,1,73,0.734982332155477
"300210108","ENTRE RIOS",351,169,45,123,6,174,0.481481481481481
"300210109","ENTRE RIOS",180,167,4,8,0,12,0.927777777777778
"300210110","ENTRE RIOS",150,146,3,1,0,4,0.973333333333333
"300210111","ENTRE RIOS",172,171,1,0,0,1,0.994186046511628
"300210112","ENTRE RIOS",206,41,68,95,0,163,0.199029126213592
"300210201","ENTRE RIOS",207,177,11,19,0,30,0.855072463768116
"300210202","ENTRE RIOS",146,143,1,2,0,3,0.979452054794521
"300210203","ENTRE RIOS",261,147,50,63,0,113,0.563218390804598
"300210204","ENTRE RIOS",28,0,11,17,0,28,0
"300210212","ENTRE RIOS",358,129,74,129,12,215,0.360335195530726
"300210401","ENTRE RIOS",144,1,39,101,0,140,0.00694444444444444
"300280515","ENTRE RIOS",207,207,0,0,0,0,1
"300210301","ENTRE RIOS",59,0,19,23,6,48,0
"300210302","ENTRE RIOS",115,0,32,79,1,112,0
"300210303","ENTRE RIOS",170,0,74,93,1,168,0
"300210402","ENTRE RIOS",15,0,5,10,0,15,0
"300210403","ENTRE RIOS",79,0,14,61,2,77,0
"300210404","ENTRE RIOS",51,0,19,30,0,49,0
"300210405","ENTRE RIOS",163,1,68,94,0,162,0.00613496932515337
"300210406","ENTRE RIOS",113,4,22,87,0,109,0.0353982300884956
"300210407","ENTRE RIOS",9,0,0,7,0,7,0
"300210304","ENTRE RIOS",144,5,58,77,2,137,0.0347222222222222
"300210305","ENTRE RIOS",140,1,67,71,0,138,0.00714285714285714
"300210309","ENTRE RIOS",160,107,20,29,2,51,0.66875
"300210310","ENTRE RIOS",89,0,21,55,2,78,0
"300280608","ENTRE RIOS",207,171,15,9,2,26,0.826086956521739
"300210306","ENTRE RIOS",39,1,26,11,0,37,0.0256410256410256
"300210307","ENTRE RIOS",55,1,23,29,1,53,0.0181818181818182
"300210308","ENTRE RIOS",93,38,20,29,1,50,0.408602150537634
"300210311","ENTRE RIOS",58,0,20,29,8,57,0
"300210409","ENTRE RIOS",59,0,34,23,0,57,0
"300210410","ENTRE RIOS",105,1,24,79,0,103,0.00952380952380952
"300210501","ENTRE RIOS",70,0,17,49,2,68,0
"300210502","ENTRE RIOS",74,0,5,64,2,71,0
"300210503","ENTRE RIOS",31,0,2,27,1,30,0
"300210504","ENTRE RIOS",61,1,32,27,1,60,0.0163934426229508
"300210505","ENTRE RIOS",266,226,16,23,0,39,0.849624060150376
"300210506","ENTRE RIOS",251,213,18,19,0,37,0.848605577689243
"300210507","ENTRE RIOS",204,121,23,57,1,81,0.593137254901961
"300210508","ENTRE RIOS",27,0,9,17,1,27,0
"300280609","ENTRE RIOS",207,191,14,1,1,16,0.922705314009662
"300210509","ENTRE RIOS",6,0,2,4,0,6,0
"300280418","ENTRE RIOS",265,255,4,5,0,9,0.962264150943396
"300210510","ENTRE RIOS",43,0,9,28,2,39,0
"300210511","ENTRE RIOS",46,0,23,23,0,46,0
"300210512","ENTRE RIOS",166,0,66,99,0,165,0
"300210601","ENTRE RIOS",60,0,9,33,0,42,0
"300280802","ENTRE RIOS",37,0,34,2,1,37,0
"300210701","ENTRE RIOS",10,0,5,4,0,9,0
"300280419","ENTRE RIOS",281,258,5,0,0,5,0.918149466192171
"300280501","ENTRE RIOS",245,197,9,5,0,14,0.804081632653061
"300210602","ENTRE RIOS",57,0,19,37,1,57,0
"300210603","ENTRE RIOS",41,0,24,17,0,41,0
"300210604","ENTRE RIOS",161,71,36,51,0,87,0.440993788819876
"300210605","ENTRE RIOS",40,3,20,17,0,37,0.075
"300210606","ENTRE RIOS",21,0,13,8,0,21,0
"300280803","ENTRE RIOS",60,0,51,7,0,58,0
"300210702","ENTRE RIOS",17,0,11,6,0,17,0
"300210703","ENTRE RIOS",2,0,2,0,0,2,0
"300210706","ENTRE RIOS",173,170,2,1,0,3,0.982658959537572
"300210715","ENTRE RIOS",262,261,1,0,0,1,0.99618320610687
"300210809","ENTRE RIOS",32,0,6,25,1,32,0
"300210704","ENTRE RIOS",33,0,25,7,1,33,0
"300210705","ENTRE RIOS",16,0,3,12,0,15,0
"300210713","ENTRE RIOS",132,131,1,0,0,1,0.992424242424242
"300210707","ENTRE RIOS",143,97,38,7,0,45,0.678321678321678
"300210708","ENTRE RIOS",218,1,135,80,1,216,0.00458715596330275
"300210709","ENTRE RIOS",262,258,3,1,0,4,0.984732824427481
"300210710","ENTRE RIOS",268,265,3,0,0,3,0.988805970149254
"300210711","ENTRE RIOS",24,24,0,0,0,0,1
"300210712","ENTRE RIOS",199,198,1,0,0,1,0.994974874371859
"300210716","ENTRE RIOS",214,207,2,4,0,6,0.967289719626168
"300210801","ENTRE RIOS",14,0,9,5,0,14,0
"300210802","ENTRE RIOS",30,0,22,7,0,29,0
"300280203","ENTRE RIOS",250,143,24,75,0,99,0.572
"300210803","ENTRE RIOS",28,0,12,13,0,25,0
"300210804","ENTRE RIOS",110,23,46,40,0,86,0.209090909090909
"300210805","ENTRE RIOS",20,0,8,11,1,20,0
"300210806","ENTRE RIOS",27,0,14,10,1,25,0
"300210807","ENTRE RIOS",34,0,9,24,0,33,0
"300210808","ENTRE RIOS",14,0,1,8,5,14,0
"300210901","ENTRE RIOS",71,6,25,37,0,62,0.0845070422535211
"300210902","ENTRE RIOS",103,74,19,10,0,29,0.718446601941748
"300210903","ENTRE RIOS",228,221,1,5,0,6,0.969298245614035
"300210904","ENTRE RIOS",141,140,0,1,0,1,0.99290780141844
"300210905","ENTRE RIOS",402,394,2,4,0,6,0.980099502487562
"300280204","ENTRE RIOS",366,346,5,0,0,5,0.945355191256831
"221400202","CHACO",268,262,6,0,0,6,0.977611940298508
"300350105","ENTRE RIOS",297,26,97,154,2,253,0.0875420875420875
"300210906","ENTRE RIOS",98,46,32,20,0,52,0.469387755102041
"300210907","ENTRE RIOS",237,233,2,1,0,3,0.983122362869198
"300210908","ENTRE RIOS",188,188,0,0,0,0,1
"300210909","ENTRE RIOS",205,189,5,11,0,16,0.921951219512195
"300210910","ENTRE RIOS",188,176,3,8,0,11,0.936170212765957
"300210911","ENTRE RIOS",216,204,1,10,0,11,0.944444444444444
"300211001","ENTRE RIOS",29,1,9,19,0,28,0.0344827586206897
"300211002","ENTRE RIOS",153,137,11,5,0,16,0.895424836601307
"300211003","ENTRE RIOS",82,68,2,12,0,14,0.829268292682927
"300280307","ENTRE RIOS",3,0,2,1,0,3,0
"300280804","ENTRE RIOS",3,0,3,0,0,3,0
"300211004","ENTRE RIOS",190,161,3,25,0,28,0.847368421052632
"300211005","ENTRE RIOS",112,91,7,13,0,20,0.8125
"300211006","ENTRE RIOS",194,179,3,11,0,14,0.922680412371134
"300211007","ENTRE RIOS",233,221,2,10,0,12,0.948497854077253
"300211101","ENTRE RIOS",38,1,7,26,0,33,0.0263157894736842
"300211102","ENTRE RIOS",34,0,8,25,0,33,0
"300211103","ENTRE RIOS",28,0,17,8,1,26,0
"300211104","ENTRE RIOS",19,0,5,13,1,19,0
"300211105","ENTRE RIOS",16,0,6,9,0,15,0
"300211201","ENTRE RIOS",5,0,0,4,1,5,0
"300211202","ENTRE RIOS",4,0,0,4,0,4,0
"300211203","ENTRE RIOS",23,0,7,16,0,23,0
"300211204","ENTRE RIOS",42,0,6,33,1,40,0
"300211205","ENTRE RIOS",21,0,6,10,5,21,0
"300280416","ENTRE RIOS",283,274,0,1,0,1,0.968197879858657
"300211206","ENTRE RIOS",31,0,8,19,1,28,0
"300211207","ENTRE RIOS",23,0,0,19,4,23,0
"300211208","ENTRE RIOS",39,0,13,20,1,34,0
"300211209","ENTRE RIOS",32,0,1,23,3,27,0
"300211210","ENTRE RIOS",196,0,37,140,3,180,0
"300280417","ENTRE RIOS",233,220,3,3,2,8,0.944206008583691
"300280805","ENTRE RIOS",79,37,30,10,1,41,0.468354430379747
"300211211","ENTRE RIOS",13,0,10,2,1,13,0
"300211212","ENTRE RIOS",38,0,10,26,1,37,0
"300211301","ENTRE RIOS",32,0,2,9,3,14,0
"300211302","ENTRE RIOS",12,0,0,5,5,10,0
"300280101","ENTRE RIOS",86,85,0,0,0,0,0.988372093023256
"300280102","ENTRE RIOS",323,320,1,0,0,1,0.990712074303406
"300280103","ENTRE RIOS",219,218,1,0,0,1,0.995433789954338
"300280104","ENTRE RIOS",179,178,1,0,0,1,0.994413407821229
"300280105","ENTRE RIOS",366,345,3,3,0,6,0.942622950819672
"300280106","ENTRE RIOS",305,297,1,0,0,1,0.973770491803279
"300280108","ENTRE RIOS",208,208,0,0,0,0,1
"300280109","ENTRE RIOS",170,167,3,0,0,3,0.982352941176471
"300280110","ENTRE RIOS",325,320,0,0,0,0,0.984615384615385
"300280111","ENTRE RIOS",156,151,5,0,0,5,0.967948717948718
"300280112","ENTRE RIOS",197,192,4,0,0,4,0.974619289340102
"300280113","ENTRE RIOS",121,63,26,20,0,46,0.520661157024793
"300280114","ENTRE RIOS",49,9,18,15,0,33,0.183673469387755
"300280201","ENTRE RIOS",57,1,39,15,1,55,0.0175438596491228
"300280202","ENTRE RIOS",42,10,12,20,0,32,0.238095238095238
"300280806","ENTRE RIOS",50,0,42,1,0,43,0
"300280205","ENTRE RIOS",334,300,9,7,0,16,0.898203592814371
"300280206","ENTRE RIOS",274,171,40,61,0,101,0.624087591240876
"300280301","ENTRE RIOS",44,0,24,10,0,34,0
"300280302","ENTRE RIOS",7,0,7,0,0,7,0
"300280303","ENTRE RIOS",79,0,45,30,0,75,0
"300280304","ENTRE RIOS",7,0,5,0,0,5,0
"300280305","ENTRE RIOS",22,0,18,3,0,21,0
"300280306","ENTRE RIOS",53,0,35,15,0,50,0
"300280308","ENTRE RIOS",12,0,10,2,0,12,0
"300280401","ENTRE RIOS",148,147,0,0,0,0,0.993243243243243
"300280402","ENTRE RIOS",257,238,10,3,0,13,0.926070038910506
"300280403","ENTRE RIOS",336,330,4,1,0,5,0.982142857142857
"300280404","ENTRE RIOS",224,217,3,3,0,6,0.96875
"300280405","ENTRE RIOS",209,201,4,1,0,5,0.961722488038278
"300280406","ENTRE RIOS",279,270,8,0,0,8,0.967741935483871
"300280407","ENTRE RIOS",200,136,13,14,16,43,0.68
"300280408","ENTRE RIOS",252,232,3,10,0,13,0.920634920634921
"300280409","ENTRE RIOS",160,150,4,4,2,10,0.9375
"300280410","ENTRE RIOS",271,228,1,7,2,10,0.841328413284133
"300280411","ENTRE RIOS",215,209,0,1,0,1,0.972093023255814
"300280412","ENTRE RIOS",233,228,3,2,0,5,0.978540772532189
"300280413","ENTRE RIOS",199,185,11,0,0,11,0.92964824120603
"300280414","ENTRE RIOS",195,188,1,3,0,4,0.964102564102564
"300280502","ENTRE RIOS",286,272,2,5,0,7,0.951048951048951
"300280503","ENTRE RIOS",277,260,7,5,0,12,0.938628158844765
"300280504","ENTRE RIOS",219,169,4,22,3,29,0.771689497716895
"300280505","ENTRE RIOS",331,278,11,10,8,29,0.83987915407855
"300280506","ENTRE RIOS",132,129,1,0,0,1,0.977272727272727
"300280507","ENTRE RIOS",267,261,2,0,0,2,0.97752808988764
"300280508","ENTRE RIOS",178,177,0,0,0,0,0.99438202247191
"300280509","ENTRE RIOS",235,235,0,0,0,0,1
"300280510","ENTRE RIOS",172,172,0,0,0,0,1
"300280511","ENTRE RIOS",222,217,1,0,0,1,0.977477477477477
"300280512","ENTRE RIOS",323,315,3,1,1,5,0.975232198142415
"300280516","ENTRE RIOS",142,140,1,1,0,2,0.985915492957746
"300280807","ENTRE RIOS",24,0,19,2,0,21,0
"300280517","ENTRE RIOS",316,298,14,2,0,16,0.943037974683544
"300280518","ENTRE RIOS",293,261,15,12,1,28,0.890784982935154
"300280519","ENTRE RIOS",251,235,4,4,0,8,0.936254980079681
"300280601","ENTRE RIOS",83,12,45,13,4,62,0.144578313253012
"300280602","ENTRE RIOS",64,11,34,13,0,47,0.171875
"300280603","ENTRE RIOS",184,67,95,17,0,112,0.364130434782609
"300280604","ENTRE RIOS",42,0,35,3,0,38,0
"300280605","ENTRE RIOS",98,16,46,30,1,77,0.163265306122449
"300280606","ENTRE RIOS",109,47,47,2,2,51,0.431192660550459
"300280607","ENTRE RIOS",118,108,7,3,0,10,0.915254237288136
"300280808","ENTRE RIOS",67,0,54,10,0,64,0
"300280610","ENTRE RIOS",25,0,21,3,0,24,0
"300280611","ENTRE RIOS",59,0,53,5,0,58,0
"300280701","ENTRE RIOS",2,0,2,0,0,2,0
"300280702","ENTRE RIOS",3,0,2,1,0,3,0
"300280703","ENTRE RIOS",13,0,7,2,0,9,0
"300280704","ENTRE RIOS",32,0,21,7,2,30,0
"300280705","ENTRE RIOS",3,0,1,2,0,3,0
"300280706","ENTRE RIOS",12,0,5,6,1,12,0
"300280707","ENTRE RIOS",8,0,5,3,0,8,0
"300280708","ENTRE RIOS",101,18,33,42,2,77,0.178217821782178
"300280709","ENTRE RIOS",260,201,31,23,1,55,0.773076923076923
"300280710","ENTRE RIOS",342,293,15,25,0,40,0.85672514619883
"300280711","ENTRE RIOS",220,200,6,9,1,16,0.909090909090909
"300280712","ENTRE RIOS",200,105,38,42,4,84,0.525
"300280801","ENTRE RIOS",40,0,39,1,0,40,0
"300280901","ENTRE RIOS",60,2,25,8,0,33,0.0333333333333333
"300280902","ENTRE RIOS",16,0,15,0,0,15,0
"300280903","ENTRE RIOS",67,0,56,5,1,62,0
"300280904","ENTRE RIOS",54,0,44,8,0,52,0
"300350103","ENTRE RIOS",162,143,10,5,0,15,0.882716049382716
"300280905","ENTRE RIOS",31,0,29,1,0,30,0
"300280906","ENTRE RIOS",31,1,23,6,1,30,0.032258064516129
"300280907","ENTRE RIOS",237,231,1,1,0,2,0.974683544303797
"300281001","ENTRE RIOS",9,0,7,1,0,8,0
"300281002","ENTRE RIOS",23,0,16,6,0,22,0
"300281003","ENTRE RIOS",7,0,7,0,0,7,0
"301130204","ENTRE RIOS",232,204,14,14,0,28,0.879310344827586
"300281007","ENTRE RIOS",9,0,6,3,0,9,0
"300281004","ENTRE RIOS",6,0,3,1,0,4,0
"300281005","ENTRE RIOS",35,2,17,15,0,32,0.0571428571428571
"300281006","ENTRE RIOS",6,0,6,0,0,6,0
"300281008","ENTRE RIOS",86,3,54,22,3,79,0.0348837209302326
"300281101","ENTRE RIOS",19,0,18,1,0,19,0
"300281302","ENTRE RIOS",12,0,10,0,0,10,0
"300281205","ENTRE RIOS",29,0,28,1,0,29,0
"221401916","CHACO",221,4,136,45,7,188,0.0180995475113122
"300281102","ENTRE RIOS",2,0,1,1,0,2,0
"300281103","ENTRE RIOS",32,0,11,21,0,32,0
"300281104","ENTRE RIOS",37,0,24,11,0,35,0
"300281105","ENTRE RIOS",12,0,11,0,0,11,0
"300281106","ENTRE RIOS",11,0,8,3,0,11,0
"300281107","ENTRE RIOS",180,67,99,13,0,112,0.372222222222222
"300281108","ENTRE RIOS",143,19,108,11,0,119,0.132867132867133
"300490203","ENTRE RIOS",210,186,12,8,0,20,0.885714285714286
"300281201","ENTRE RIOS",49,0,45,4,0,49,0
"300281202","ENTRE RIOS",2,0,1,1,0,2,0
"300281203","ENTRE RIOS",30,1,27,1,0,28,0.0333333333333333
"300281204","ENTRE RIOS",62,9,46,4,1,51,0.145161290322581
"300490204","ENTRE RIOS",180,175,4,1,0,5,0.972222222222222
"300281206","ENTRE RIOS",37,0,35,0,0,35,0
"300281207","ENTRE RIOS",59,0,47,10,1,58,0
"300281301","ENTRE RIOS",16,0,14,0,0,14,0
"300281303","ENTRE RIOS",62,0,51,7,3,61,0
"221400204","CHACO",335,59,174,92,5,271,0.176119402985075
"300350104","ENTRE RIOS",389,379,2,3,0,5,0.974293059125964
"300281208","ENTRE RIOS",214,33,156,17,2,175,0.154205607476636
"300281209","ENTRE RIOS",15,1,9,2,0,11,0.0666666666666667
"300281210","ENTRE RIOS",91,53,33,2,0,35,0.582417582417582
"300281211","ENTRE RIOS",52,19,28,4,0,32,0.365384615384615
"300281212","ENTRE RIOS",62,10,47,5,0,52,0.161290322580645
"300281304","ENTRE RIOS",27,2,19,5,0,24,0.0740740740740741
"300281213","ENTRE RIOS",36,0,27,6,0,33,0
"300281214","ENTRE RIOS",46,0,34,7,0,41,0
"300281215","ENTRE RIOS",118,36,64,10,6,80,0.305084745762712
"300350102","ENTRE RIOS",213,66,44,84,0,128,0.309859154929577
"300281305","ENTRE RIOS",8,0,8,0,0,8,0
"300281306","ENTRE RIOS",31,1,28,2,0,30,0.032258064516129
"300281307","ENTRE RIOS",57,0,40,12,1,53,0
"300281308","ENTRE RIOS",10,0,8,2,0,10,0
"300281309","ENTRE RIOS",108,54,38,15,1,54,0.5
"300281310","ENTRE RIOS",12,0,8,3,0,11,0
"300350101","ENTRE RIOS",203,18,33,145,0,178,0.0886699507389163
"300350106","ENTRE RIOS",244,36,15,177,0,192,0.147540983606557
"300350107","ENTRE RIOS",272,267,1,3,0,4,0.981617647058823
"300350108","ENTRE RIOS",191,190,0,1,0,1,0.994764397905759
"300350109","ENTRE RIOS",134,116,1,15,1,17,0.865671641791045
"300350110","ENTRE RIOS",219,147,26,44,0,70,0.671232876712329
"300350111","ENTRE RIOS",140,115,1,15,1,17,0.821428571428571
"300350112","ENTRE RIOS",294,286,2,5,1,8,0.972789115646258
"300350113","ENTRE RIOS",275,269,1,2,0,3,0.978181818181818
"300350114","ENTRE RIOS",189,144,22,23,0,45,0.761904761904762
"300351007","ENTRE RIOS",200,150,14,33,0,47,0.75
"300350603","ENTRE RIOS",20,0,7,11,0,18,0
"300350115","ENTRE RIOS",216,133,20,61,0,81,0.615740740740741
"300350116","ENTRE RIOS",318,138,53,112,0,165,0.433962264150943
"300350117","ENTRE RIOS",309,246,33,26,0,59,0.796116504854369
"300350118","ENTRE RIOS",236,211,12,6,0,18,0.894067796610169
"300420105","ENTRE RIOS",198,189,3,3,0,6,0.954545454545455
"300350119","ENTRE RIOS",225,52,26,132,1,159,0.231111111111111
"300350201","ENTRE RIOS",29,0,2,9,0,11,0
"300350202","ENTRE RIOS",44,0,13,23,3,39,0
"300350203","ENTRE RIOS",56,0,23,28,3,54,0
"300350204","ENTRE RIOS",174,1,39,118,7,164,0.00574712643678161
"300350205","ENTRE RIOS",36,0,6,25,1,32,0
"300350206","ENTRE RIOS",80,0,21,48,0,69,0
"300350301","ENTRE RIOS",4,0,1,2,1,4,0
"300350601","ENTRE RIOS",5,0,3,1,0,4,0
"300350302","ENTRE RIOS",5,0,2,3,0,5,0
"300350303","ENTRE RIOS",9,0,2,6,1,9,0
"300350304","ENTRE RIOS",12,1,9,2,0,11,0.0833333333333333
"300350602","ENTRE RIOS",7,3,0,4,0,4,0.428571428571429
"300420106","ENTRE RIOS",270,253,10,7,0,17,0.937037037037037
"300350305","ENTRE RIOS",5,0,1,4,0,5,0
"300350403","ENTRE RIOS",36,1,6,24,3,33,0.0277777777777778
"300490205","ENTRE RIOS",199,187,8,4,0,12,0.939698492462312
"300350401","ENTRE RIOS",25,0,0,24,1,25,0
"300490209","ENTRE RIOS",227,221,2,4,0,6,0.973568281938326
"300490303","ENTRE RIOS",141,139,1,0,0,1,0.985815602836879
"300350402","ENTRE RIOS",8,0,0,6,0,6,0
"300350404","ENTRE RIOS",4,0,3,1,0,4,0
"300490206","ENTRE RIOS",194,174,13,5,0,18,0.896907216494845
"300350405","ENTRE RIOS",21,0,12,9,0,21,0
"300350406","ENTRE RIOS",15,0,12,2,0,14,0
"300350407","ENTRE RIOS",26,0,6,13,5,24,0
"300350604","ENTRE RIOS",9,0,1,7,0,8,0
"300350408","ENTRE RIOS",34,0,19,12,0,31,0
"300350409","ENTRE RIOS",45,0,26,18,1,45,0
"300350506","ENTRE RIOS",14,1,3,7,2,12,0.0714285714285714
"300350410","ENTRE RIOS",8,0,0,4,3,7,0
"300350411","ENTRE RIOS",12,1,5,5,0,10,0.0833333333333333
"300350507","ENTRE RIOS",66,24,27,15,0,42,0.363636363636364
"300420107","ENTRE RIOS",251,229,11,8,0,19,0.912350597609562
"300490207","ENTRE RIOS",150,148,1,0,0,1,0.986666666666667
"300350412","ENTRE RIOS",6,0,2,4,0,6,0
"300350413","ENTRE RIOS",3,0,0,3,0,3,0
"300350414","ENTRE RIOS",97,80,3,9,1,13,0.824742268041237
"300350501","ENTRE RIOS",26,0,6,7,0,13,0
"300350502","ENTRE RIOS",16,0,5,11,0,16,0
"300350503","ENTRE RIOS",4,0,1,3,0,4,0
"300350504","ENTRE RIOS",33,0,3,21,2,26,0
"300350505","ENTRE RIOS",13,0,6,6,0,12,0
"300350605","ENTRE RIOS",25,0,17,7,0,24,0
"300350606","ENTRE RIOS",17,0,8,4,0,12,0
"300350805","ENTRE RIOS",27,0,18,8,0,26,0
"300490208","ENTRE RIOS",196,195,1,0,0,1,0.994897959183674
"300350701","ENTRE RIOS",53,0,21,23,4,48,0
"300350702","ENTRE RIOS",30,0,20,8,0,28,0
"300350703","ENTRE RIOS",19,0,7,10,1,18,0
"300350704","ENTRE RIOS",22,1,5,15,0,20,0.0454545454545455
"300350705","ENTRE RIOS",24,0,15,6,3,24,0
"300350901","ENTRE RIOS",24,0,5,15,1,21,0
"300350706","ENTRE RIOS",37,0,29,7,0,36,0
"300350904","ENTRE RIOS",5,0,3,1,0,4,0
"300560113","ENTRE RIOS",185,184,1,0,0,1,0.994594594594595
"300350801","ENTRE RIOS",26,0,12,14,0,26,0
"300490210","ENTRE RIOS",340,301,18,14,0,32,0.885294117647059
"300350802","ENTRE RIOS",39,0,20,16,1,37,0
"300350803","ENTRE RIOS",28,0,8,12,7,27,0
"300350804","ENTRE RIOS",41,0,31,3,3,37,0
"300490211","ENTRE RIOS",263,262,1,0,0,1,0.996197718631179
"300350902","ENTRE RIOS",34,5,15,13,1,29,0.147058823529412
"300350903","ENTRE RIOS",10,0,7,2,0,9,0
"300490212","ENTRE RIOS",130,130,0,0,0,0,1
"300350905","ENTRE RIOS",29,0,9,18,0,27,0
"300350906","ENTRE RIOS",10,0,2,8,0,10,0
"300351004","ENTRE RIOS",13,0,7,4,2,13,0
"300351005","ENTRE RIOS",86,5,46,31,1,78,0.0581395348837209
"300350907","ENTRE RIOS",8,0,4,3,1,8,0
"300351001","ENTRE RIOS",1,0,1,0,0,1,0
"300351002","ENTRE RIOS",4,0,2,2,0,4,0
"300351003","ENTRE RIOS",28,1,11,14,2,27,0.0357142857142857
"300351006","ENTRE RIOS",92,31,32,28,0,60,0.33695652173913
"300351101","ENTRE RIOS",18,0,0,15,0,15,0
"300351102","ENTRE RIOS",37,7,7,20,1,28,0.189189189189189
"300351103","ENTRE RIOS",352,183,67,87,1,155,0.519886363636364
"300351104","ENTRE RIOS",195,174,13,7,1,21,0.892307692307692
"300351105","ENTRE RIOS",207,157,31,14,1,46,0.758454106280193
"300351106","ENTRE RIOS",134,133,0,1,0,1,0.992537313432836
"300420101","ENTRE RIOS",224,118,30,57,0,87,0.526785714285714
"300420102","ENTRE RIOS",251,118,68,50,0,118,0.470119521912351
"300420103","ENTRE RIOS",214,137,25,45,0,70,0.64018691588785
"300420104","ENTRE RIOS",284,268,2,13,0,15,0.943661971830986
"300420108","ENTRE RIOS",184,79,54,34,0,88,0.429347826086957
"300420109","ENTRE RIOS",131,107,14,7,0,21,0.816793893129771
"300420110","ENTRE RIOS",222,193,13,8,1,22,0.869369369369369
"300420111","ENTRE RIOS",236,124,39,52,1,92,0.525423728813559
"300420112","ENTRE RIOS",184,129,13,34,0,47,0.701086956521739
"300420201","ENTRE RIOS",57,0,36,20,0,56,0
"300420202","ENTRE RIOS",68,0,25,36,2,63,0
"300420203","ENTRE RIOS",44,1,19,18,3,40,0.0227272727272727
"300490304","ENTRE RIOS",181,181,0,0,0,0,1
"300490305","ENTRE RIOS",234,234,0,0,0,0,1
"300420501","ENTRE RIOS",17,0,12,4,1,17,0
"300420204","ENTRE RIOS",134,4,55,58,2,115,0.0298507462686567
"300420205","ENTRE RIOS",99,24,44,28,0,72,0.242424242424242
"300420206","ENTRE RIOS",92,0,25,56,5,86,0
"300420301","ENTRE RIOS",25,0,7,15,2,24,0
"300420502","ENTRE RIOS",12,0,0,4,0,4,0
"300420603","ENTRE RIOS",33,1,15,16,0,31,0.0303030303030303
"300420303","ENTRE RIOS",72,0,19,42,8,69,0
"300560114","ENTRE RIOS",228,227,1,0,0,1,0.995614035087719
"300420602","ENTRE RIOS",28,0,5,22,0,27,0
"300490306","ENTRE RIOS",296,283,6,7,0,13,0.956081081081081
"300840520","ENTRE RIOS",279,203,36,35,5,76,0.727598566308244
"300420302","ENTRE RIOS",63,0,28,27,1,56,0
"300420304","ENTRE RIOS",7,0,2,4,0,6,0
"300420406","ENTRE RIOS",25,0,22,1,0,23,0
"300560115","ENTRE RIOS",400,382,3,12,0,15,0.955
"300420305","ENTRE RIOS",49,0,15,30,4,49,0
"300420401","ENTRE RIOS",15,0,3,11,0,14,0
"300560116","ENTRE RIOS",340,322,14,2,0,16,0.947058823529412
"300420402","ENTRE RIOS",25,1,17,4,2,23,0.04
"300420403","ENTRE RIOS",13,1,10,2,0,12,0.0769230769230769
"300490213","ENTRE RIOS",230,230,0,0,0,0,1
"300420404","ENTRE RIOS",49,0,8,38,0,46,0
"300420405","ENTRE RIOS",8,0,4,4,0,8,0
"300420503","ENTRE RIOS",107,21,39,40,2,81,0.196261682242991
"300420504","ENTRE RIOS",41,0,19,13,1,33,0
"300420601","ENTRE RIOS",5,0,1,4,0,5,0
"221402102","CHACO",266,231,6,11,2,19,0.868421052631579
"300490307","ENTRE RIOS",258,238,14,5,0,19,0.922480620155039
"300560218","ENTRE RIOS",187,181,4,2,0,6,0.967914438502674
"300420604","ENTRE RIOS",34,0,16,17,0,33,0
"300490214","ENTRE RIOS",167,165,2,0,0,2,0.988023952095808
"300490215","ENTRE RIOS",131,131,0,0,0,0,1
"300490216","ENTRE RIOS",123,95,11,14,1,26,0.772357723577236
"300420701","ENTRE RIOS",20,0,11,6,0,17,0
"300490308","ENTRE RIOS",349,322,2,17,1,20,0.922636103151863
"300420605","ENTRE RIOS",16,0,13,3,0,16,0
"300490102","ENTRE RIOS",428,318,31,76,0,107,0.742990654205608
"300490508","ENTRE RIOS",34,0,21,9,1,31,0
"300420702","ENTRE RIOS",15,0,13,1,0,14,0
"300490113","ENTRE RIOS",155,152,3,0,0,3,0.980645161290323
"300490114","ENTRE RIOS",145,140,4,1,0,5,0.96551724137931
"300490201","ENTRE RIOS",242,227,6,9,0,15,0.93801652892562
"300420703","ENTRE RIOS",42,0,25,8,5,38,0
"300490219","ENTRE RIOS",269,268,0,1,0,1,0.996282527881041
"300420704","ENTRE RIOS",85,0,30,51,0,81,0
"300490101","ENTRE RIOS",91,31,28,32,0,60,0.340659340659341
"300490202","ENTRE RIOS",363,335,18,10,0,28,0.922865013774105
"221400719","CHACO",219,123,62,29,1,92,0.561643835616438
"300490103","ENTRE RIOS",252,115,79,58,0,137,0.456349206349206
"300490104","ENTRE RIOS",155,136,5,13,0,18,0.87741935483871
"300560219","ENTRE RIOS",169,169,0,0,0,0,1
"300490105","ENTRE RIOS",313,301,4,7,0,11,0.961661341853035
"300490106","ENTRE RIOS",328,309,9,6,0,15,0.942073170731707
"300490107","ENTRE RIOS",301,284,6,11,0,17,0.943521594684385
"300490108","ENTRE RIOS",305,293,5,4,0,9,0.960655737704918
"300490109","ENTRE RIOS",149,148,1,0,0,1,0.993288590604027
"300490110","ENTRE RIOS",188,188,0,0,0,0,1
"300490111","ENTRE RIOS",267,263,3,1,0,4,0.98501872659176
"300490112","ENTRE RIOS",200,200,0,0,0,0,1
"300490217","ENTRE RIOS",84,55,21,5,1,27,0.654761904761905
"300490218","ENTRE RIOS",269,263,4,2,0,6,0.977695167286245
"300490220","ENTRE RIOS",301,260,11,9,0,20,0.863787375415282
"300490221","ENTRE RIOS",237,165,39,26,0,65,0.69620253164557
"300560117","ENTRE RIOS",290,281,7,2,0,9,0.968965517241379
"300560118","ENTRE RIOS",114,113,1,0,0,1,0.991228070175439
"300490222","ENTRE RIOS",222,125,26,63,0,89,0.563063063063063
"300490301","ENTRE RIOS",389,367,8,11,1,20,0.943444730077121
"300490302","ENTRE RIOS",195,195,0,0,0,0,1
"300490309","ENTRE RIOS",386,358,15,7,0,22,0.927461139896373
"300490509","ENTRE RIOS",35,0,14,15,1,30,0
"300490310","ENTRE RIOS",385,326,7,30,0,37,0.846753246753247
"300490311","ENTRE RIOS",153,11,15,116,0,131,0.0718954248366013
"300490312","ENTRE RIOS",259,162,30,44,0,74,0.625482625482625
"300490401","ENTRE RIOS",136,0,71,62,0,133,0
"300490402","ENTRE RIOS",100,2,41,48,5,94,0.02
"300490403","ENTRE RIOS",90,2,33,50,0,83,0.0222222222222222
"500070505","MENDOZA",201,201,0,0,0,0,1
"300490404","ENTRE RIOS",17,0,10,4,1,15,0
"300490405","ENTRE RIOS",21,8,2,9,0,11,0.380952380952381
"300490406","ENTRE RIOS",7,0,2,5,0,7,0
"300490407","ENTRE RIOS",107,0,65,38,1,104,0
"300490408","ENTRE RIOS",42,0,15,24,0,39,0
"300490409","ENTRE RIOS",135,14,31,84,0,115,0.103703703703704
"300490415","ENTRE RIOS",210,113,48,42,1,91,0.538095238095238
"300490410","ENTRE RIOS",4,2,0,2,0,2,0.5
"300490411","ENTRE RIOS",166,1,101,64,0,165,0.00602409638554217
"300490412","ENTRE RIOS",357,233,30,80,1,111,0.65266106442577
"300490413","ENTRE RIOS",320,228,35,38,1,74,0.7125
"300490414","ENTRE RIOS",231,165,19,39,4,62,0.714285714285714
"300490416","ENTRE RIOS",3,0,0,3,0,3,0
"300490417","ENTRE RIOS",89,11,54,21,0,75,0.123595505617978
"300560119","ENTRE RIOS",194,193,1,0,0,1,0.994845360824742
"300560120","ENTRE RIOS",227,227,0,0,0,0,1
"300490501","ENTRE RIOS",23,0,2,21,0,23,0
"300490502","ENTRE RIOS",15,0,10,4,0,14,0
"300490503","ENTRE RIOS",37,0,15,19,0,34,0
"300490504","ENTRE RIOS",15,0,9,3,2,14,0
"300490505","ENTRE RIOS",22,0,8,14,0,22,0
"300490506","ENTRE RIOS",19,0,0,18,0,18,0
"300490507","ENTRE RIOS",27,0,7,19,0,26,0
"300560121","ENTRE RIOS",170,169,1,0,0,1,0.994117647058824
"300490510","ENTRE RIOS",37,0,18,16,1,35,0
"300490511","ENTRE RIOS",118,0,56,52,1,109,0
"300490512","ENTRE RIOS",49,0,15,33,0,48,0
"300490513","ENTRE RIOS",16,0,5,11,0,16,0
"300490601","ENTRE RIOS",27,0,11,11,4,26,0
"300490605","ENTRE RIOS",31,0,10,21,0,31,0
"300560122","ENTRE RIOS",227,227,0,0,0,0,1
"300560201","ENTRE RIOS",274,256,13,5,0,18,0.934306569343066
"300490602","ENTRE RIOS",26,5,14,7,0,21,0.192307692307692
"300490603","ENTRE RIOS",24,0,8,15,0,23,0
"300490710","ENTRE RIOS",11,0,7,4,0,11,0
"300490604","ENTRE RIOS",16,0,6,10,0,16,0
"300490707","ENTRE RIOS",20,1,14,5,0,19,0.05
"300490606","ENTRE RIOS",22,0,6,16,0,22,0
"300490607","ENTRE RIOS",10,0,7,2,0,9,0
"300490608","ENTRE RIOS",3,1,2,0,0,2,0.333333333333333
"300490609","ENTRE RIOS",37,0,32,4,0,36,0
"501051311","MENDOZA",119,119,0,0,0,0,1
"300490610","ENTRE RIOS",15,0,3,9,0,12,0
"300490709","ENTRE RIOS",14,0,7,7,0,14,0
"300491009","ENTRE RIOS",140,136,3,1,0,4,0.971428571428571
"300490611","ENTRE RIOS",114,1,45,50,5,100,0.0087719298245614
"300490701","ENTRE RIOS",17,0,11,6,0,17,0
"300490702","ENTRE RIOS",56,0,35,19,0,54,0
"300560507","ENTRE RIOS",230,218,4,7,0,11,0.947826086956522
"300490703","ENTRE RIOS",19,0,18,1,0,19,0
"180210313","CORRIENTES",208,16,150,38,0,188,0.0769230769230769
"300490704","ENTRE RIOS",7,0,5,2,0,7,0
"300490705","ENTRE RIOS",11,0,3,7,0,10,0
"300490706","ENTRE RIOS",39,0,22,17,0,39,0
"300560202","ENTRE RIOS",226,195,12,18,0,30,0.86283185840708
"300490708","ENTRE RIOS",32,0,23,8,0,31,0
"300490711","ENTRE RIOS",15,0,5,9,0,14,0
"300490712","ENTRE RIOS",12,0,1,8,1,10,0
"300491001","ENTRE RIOS",1,0,1,0,0,1,0
"300560220","ENTRE RIOS",267,266,0,0,0,0,0.99625468164794
"300490803","ENTRE RIOS",24,0,0,8,16,24,0
"300491010","ENTRE RIOS",322,315,3,4,0,7,0.978260869565217
"300490801","ENTRE RIOS",6,0,0,3,3,6,0
"300490802","ENTRE RIOS",28,0,8,15,1,24,0
"300491002","ENTRE RIOS",10,0,6,4,0,10,0
"300491003","ENTRE RIOS",20,0,8,11,1,20,0
"300560221","ENTRE RIOS",177,177,0,0,0,0,1
"300490804","ENTRE RIOS",27,0,0,5,0,5,0
"300490805","ENTRE RIOS",28,0,8,19,1,28,0
"300560105","ENTRE RIOS",373,352,8,10,0,18,0.943699731903485
"300560106","ENTRE RIOS",365,340,6,12,0,18,0.931506849315068
"300490806","ENTRE RIOS",46,1,21,13,9,43,0.0217391304347826
"300491011","ENTRE RIOS",308,284,9,12,1,22,0.922077922077922
"300490807","ENTRE RIOS",10,0,1,8,0,9,0
"300560107","ENTRE RIOS",379,308,35,28,0,63,0.812664907651715
"300560108","ENTRE RIOS",342,327,11,2,0,13,0.956140350877193
"300491004","ENTRE RIOS",18,3,5,10,0,15,0.166666666666667
"300491005","ENTRE RIOS",79,30,13,35,1,49,0.379746835443038
"300491006","ENTRE RIOS",199,194,2,3,0,5,0.974874371859296
"300490901","ENTRE RIOS",31,0,1,10,15,26,0
"300490902","ENTRE RIOS",77,0,0,34,36,70,0
"300560109","ENTRE RIOS",243,212,12,14,0,26,0.872427983539095
"300560110","ENTRE RIOS",382,332,23,21,1,45,0.869109947643979
"300560101","ENTRE RIOS",299,217,33,42,5,80,0.725752508361204
"300560102","ENTRE RIOS",249,222,4,13,0,17,0.891566265060241
"300560103","ENTRE RIOS",364,333,11,18,0,29,0.914835164835165
"300560104","ENTRE RIOS",309,289,12,6,0,18,0.935275080906149
"300560203","ENTRE RIOS",376,315,6,35,3,44,0.837765957446808
"300560204","ENTRE RIOS",153,136,4,12,0,16,0.888888888888889
"300560205","ENTRE RIOS",382,330,8,27,1,36,0.863874345549738
"300560206","ENTRE RIOS",381,355,15,5,0,20,0.931758530183727
"300560207","ENTRE RIOS",235,232,0,3,0,3,0.987234042553191
"300560208","ENTRE RIOS",201,195,3,1,0,4,0.970149253731343
"300560209","ENTRE RIOS",203,189,14,0,0,14,0.931034482758621
"300560210","ENTRE RIOS",197,190,5,0,0,5,0.964467005076142
"300560211","ENTRE RIOS",142,141,1,0,0,1,0.992957746478873
"300560212","ENTRE RIOS",201,199,1,1,0,2,0.990049751243781
"300560306","ENTRE RIOS",179,174,4,0,0,4,0.972067039106145
"300560307","ENTRE RIOS",214,213,1,0,0,1,0.995327102803738
"300560308","ENTRE RIOS",279,272,5,1,0,6,0.974910394265233
"300560309","ENTRE RIOS",175,175,0,0,0,0,1
"300560310","ENTRE RIOS",243,243,0,0,0,0,1
"300560311","ENTRE RIOS",185,181,4,0,0,4,0.978378378378378
"300560312","ENTRE RIOS",221,217,3,1,0,4,0.981900452488688
"300560313","ENTRE RIOS",343,318,6,10,0,16,0.927113702623907
"300560314","ENTRE RIOS",272,262,8,0,0,8,0.963235294117647
"300560315","ENTRE RIOS",118,110,5,3,0,8,0.932203389830508
"300560316","ENTRE RIOS",210,198,7,3,0,10,0.942857142857143
"300560317","ENTRE RIOS",332,308,11,9,0,20,0.927710843373494
"300560318","ENTRE RIOS",330,313,5,9,0,14,0.948484848484848
"300560319","ENTRE RIOS",125,114,4,3,0,7,0.912
"300560401","ENTRE RIOS",214,214,0,0,0,0,1
"300560402","ENTRE RIOS",192,187,4,1,0,5,0.973958333333333
"300560403","ENTRE RIOS",142,142,0,0,0,0,1
"300560404","ENTRE RIOS",160,160,0,0,0,0,1
"300560405","ENTRE RIOS",318,316,1,0,0,1,0.993710691823899
"300560406","ENTRE RIOS",241,233,4,4,0,8,0.966804979253112
"300560407","ENTRE RIOS",272,270,2,0,0,2,0.992647058823529
"300560408","ENTRE RIOS",333,297,22,13,0,35,0.891891891891892
"300560409","ENTRE RIOS",336,304,8,20,0,28,0.904761904761905
"300560410","ENTRE RIOS",359,350,6,3,0,9,0.974930362116992
"300560411","ENTRE RIOS",287,272,3,10,0,13,0.947735191637631
"300560412","ENTRE RIOS",272,222,14,24,0,38,0.816176470588235
"300560413","ENTRE RIOS",245,188,14,38,0,52,0.76734693877551
"300560414","ENTRE RIOS",386,280,29,73,0,102,0.725388601036269
"300560415","ENTRE RIOS",306,163,49,93,0,142,0.532679738562091
"300560416","ENTRE RIOS",203,112,26,59,1,86,0.551724137931034
"300560417","ENTRE RIOS",283,203,29,48,0,77,0.717314487632509
"300560418","ENTRE RIOS",257,178,23,52,0,75,0.692607003891051
"300560501","ENTRE RIOS",141,29,87,24,0,111,0.205673758865248
"300560502","ENTRE RIOS",151,138,11,2,0,13,0.913907284768212
"300560503","ENTRE RIOS",145,135,8,1,0,9,0.931034482758621
"300560504","ENTRE RIOS",317,316,1,0,0,1,0.996845425867508
"300560505","ENTRE RIOS",195,139,10,41,0,51,0.712820512820513
"300560506","ENTRE RIOS",158,154,2,0,0,2,0.974683544303797
"300560508","ENTRE RIOS",228,179,3,37,0,40,0.785087719298246
"300560509","ENTRE RIOS",198,176,6,15,0,21,0.888888888888889
"300560510","ENTRE RIOS",249,217,17,13,0,30,0.8714859437751
"300560511","ENTRE RIOS",299,279,16,4,0,20,0.933110367892977
"300560512","ENTRE RIOS",186,153,15,14,3,32,0.82258064516129
"300560513","ENTRE RIOS",305,266,23,12,0,35,0.872131147540984
"300560601","ENTRE RIOS",62,0,30,31,0,61,0
"300560602","ENTRE RIOS",120,40,45,34,0,79,0.333333333333333
"300560603","ENTRE RIOS",23,12,8,3,0,11,0.521739130434783
"300560604","ENTRE RIOS",46,9,19,15,0,34,0.195652173913043
"300560605","ENTRE RIOS",371,363,3,1,0,4,0.978436657681941
"300560606","ENTRE RIOS",312,268,3,34,0,37,0.858974358974359
"300560607","ENTRE RIOS",119,96,18,5,0,23,0.80672268907563
"300560608","ENTRE RIOS",349,325,19,5,0,24,0.931232091690544
"300560609","ENTRE RIOS",23,0,15,8,0,23,0
"300560610","ENTRE RIOS",198,102,68,28,0,96,0.515151515151515
"300560611","ENTRE RIOS",67,0,52,14,0,66,0
"300560612","ENTRE RIOS",19,0,11,8,0,19,0
"300560701","ENTRE RIOS",389,384,4,0,0,4,0.987146529562982
"300560702","ENTRE RIOS",342,167,63,104,0,167,0.488304093567251
"300560703","ENTRE RIOS",69,9,49,11,0,60,0.130434782608696
"300770212","ENTRE RIOS",102,83,2,17,0,19,0.813725490196078
"300700905","ENTRE RIOS",23,0,15,7,1,23,0
"300560704","ENTRE RIOS",33,0,25,7,0,32,0
"300560705","ENTRE RIOS",87,1,49,34,0,83,0.0114942528735632
"300560706","ENTRE RIOS",272,51,105,115,1,221,0.1875
"300560707","ENTRE RIOS",53,0,24,28,0,52,0
"300560803","ENTRE RIOS",1,0,0,1,0,1,0
"300560902","ENTRE RIOS",44,0,42,2,0,44,0
"300700108","ENTRE RIOS",244,198,26,18,1,45,0.811475409836066
"300560801","ENTRE RIOS",16,0,5,9,0,14,0
"300560810","ENTRE RIOS",57,8,11,37,0,48,0.140350877192982
"300770213","ENTRE RIOS",281,277,0,1,0,1,0.98576512455516
"300560802","ENTRE RIOS",12,0,8,4,0,12,0
"300700906","ENTRE RIOS",5,0,4,1,0,5,0
"300560805","ENTRE RIOS",14,0,0,14,0,14,0
"300560811","ENTRE RIOS",152,113,6,18,0,24,0.743421052631579
"300560804","ENTRE RIOS",44,0,27,15,0,42,0
"300560808","ENTRE RIOS",54,0,12,26,0,38,0
"300560806","ENTRE RIOS",11,0,9,1,0,10,0
"300560807","ENTRE RIOS",6,0,3,2,1,6,0
"300700416","ENTRE RIOS",21,0,13,1,3,17,0
"300560809","ENTRE RIOS",27,0,14,13,0,27,0
"300560812","ENTRE RIOS",100,43,21,31,0,52,0.43
"300560901","ENTRE RIOS",19,0,9,9,0,18,0
"300560903","ENTRE RIOS",7,1,0,6,0,6,0.142857142857143
"300560904","ENTRE RIOS",12,0,9,3,0,12,0
"300560905","ENTRE RIOS",8,0,4,4,0,8,0
"300560908","ENTRE RIOS",49,1,27,20,0,47,0.0204081632653061
"300560906","ENTRE RIOS",23,0,18,4,0,22,0
"180210604","CORRIENTES",382,327,18,31,1,50,0.856020942408377
"300560907","ENTRE RIOS",42,1,25,15,0,40,0.0238095238095238
"300561602","ENTRE RIOS",48,16,20,10,0,30,0.333333333333333
"300560909","ENTRE RIOS",36,0,34,1,1,36,0
"300701108","ENTRE RIOS",218,217,0,0,0,0,0.995412844036697
"300701408","ENTRE RIOS",248,213,7,13,1,21,0.858870967741935
"300560910","ENTRE RIOS",15,0,3,12,0,15,0
"300560911","ENTRE RIOS",118,0,78,38,0,116,0
"300561011","ENTRE RIOS",52,0,13,35,0,48,0
"300560912","ENTRE RIOS",9,0,7,2,0,9,0
"300561005","ENTRE RIOS",37,0,28,9,0,37,0
"300701409","ENTRE RIOS",225,199,5,21,0,26,0.884444444444444
"300560913","ENTRE RIOS",15,0,9,6,0,15,0
"300701412","ENTRE RIOS",258,248,1,6,0,7,0.961240310077519
"300561603","ENTRE RIOS",1,0,0,1,0,1,0
"300560914","ENTRE RIOS",6,0,6,0,0,6,0
"300560915","ENTRE RIOS",147,147,0,0,0,0,1
"180210803","CORRIENTES",284,274,3,3,0,6,0.964788732394366
"300561006","ENTRE RIOS",5,0,2,3,0,5,0
"300561805","ENTRE RIOS",25,0,20,2,0,22,0
"300560916","ENTRE RIOS",213,204,6,2,0,8,0.957746478873239
"300561001","ENTRE RIOS",44,2,9,22,9,40,0.0454545454545455
"300561002","ENTRE RIOS",5,0,3,2,0,5,0
"300561003","ENTRE RIOS",43,0,25,17,0,42,0
"300561004","ENTRE RIOS",70,1,55,10,1,66,0.0142857142857143
"300701410","ENTRE RIOS",207,207,0,0,0,0,1
"300561007","ENTRE RIOS",14,0,5,9,0,14,0
"300561008","ENTRE RIOS",23,0,6,16,0,22,0
"300561009","ENTRE RIOS",75,0,42,33,0,75,0
"300561010","ENTRE RIOS",19,0,17,2,0,19,0
"300561101","ENTRE RIOS",5,0,0,5,0,5,0
"300561102","ENTRE RIOS",17,0,10,7,0,17,0
"300561201","ENTRE RIOS",72,1,33,38,0,71,0.0138888888888889
"180210804","CORRIENTES",204,193,10,1,0,11,0.946078431372549
"300561103","ENTRE RIOS",17,0,8,8,0,16,0
"300770211","ENTRE RIOS",254,244,5,4,0,9,0.960629921259842
"300561104","ENTRE RIOS",14,0,3,11,0,14,0
"300561105","ENTRE RIOS",15,0,13,2,0,15,0
"300561504","ENTRE RIOS",202,149,38,11,0,49,0.737623762376238
"300701411","ENTRE RIOS",372,366,1,2,2,5,0.983870967741935
"300561106","ENTRE RIOS",20,0,12,7,0,19,0
"300561107","ENTRE RIOS",20,1,11,6,0,17,0.05
"300561108","ENTRE RIOS",7,0,2,5,0,7,0
"300561109","ENTRE RIOS",19,0,14,5,0,19,0
"300561110","ENTRE RIOS",19,1,7,6,3,16,0.0526315789473684
"300561111","ENTRE RIOS",108,0,66,39,0,105,0
"300561202","ENTRE RIOS",49,1,23,22,1,46,0.0204081632653061
"300561203","ENTRE RIOS",25,0,15,8,1,24,0
"300561204","ENTRE RIOS",42,0,29,4,0,33,0
"300561505","ENTRE RIOS",149,140,7,2,0,9,0.939597315436242
"300561506","ENTRE RIOS",216,210,4,2,0,6,0.972222222222222
"300561507","ENTRE RIOS",279,267,11,1,0,12,0.956989247311828
"300561508","ENTRE RIOS",161,160,1,0,0,1,0.993788819875776
"300561301","ENTRE RIOS",7,0,5,2,0,7,0
"300561205","ENTRE RIOS",46,0,38,8,0,46,0
"300561206","ENTRE RIOS",53,1,18,32,0,50,0.0188679245283019
"300561207","ENTRE RIOS",39,0,32,7,0,39,0
"300561509","ENTRE RIOS",255,243,6,3,0,9,0.952941176470588
"300561510","ENTRE RIOS",109,96,8,4,0,12,0.880733944954128
"180210805","CORRIENTES",255,244,3,3,0,6,0.956862745098039
"300561208","ENTRE RIOS",41,0,20,19,0,39,0
"300561209","ENTRE RIOS",16,0,8,8,0,16,0
"300561511","ENTRE RIOS",261,208,28,24,0,52,0.796934865900383
"300561512","ENTRE RIOS",242,241,0,1,0,1,0.995867768595041
"300561302","ENTRE RIOS",48,0,18,21,5,44,0
"300561303","ENTRE RIOS",23,0,19,3,0,22,0
"300561304","ENTRE RIOS",11,0,7,4,0,11,0
"300561305","ENTRE RIOS",12,0,11,1,0,12,0
"300561306","ENTRE RIOS",51,0,30,18,0,48,0
"300561307","ENTRE RIOS",18,0,3,14,0,17,0
"300561308","ENTRE RIOS",30,0,7,21,1,29,0
"300561309","ENTRE RIOS",8,0,0,8,0,8,0
"300561513","ENTRE RIOS",284,203,66,13,0,79,0.714788732394366
"300701109","ENTRE RIOS",214,139,29,42,0,71,0.649532710280374
"300561601","ENTRE RIOS",65,5,42,15,0,57,0.0769230769230769
"300561310","ENTRE RIOS",24,0,14,9,1,24,0
"300561401","ENTRE RIOS",49,0,34,13,1,48,0
"300561402","ENTRE RIOS",10,0,7,3,0,10,0
"300561403","ENTRE RIOS",17,0,15,2,0,17,0
"300561404","ENTRE RIOS",15,0,13,2,0,15,0
"300561405","ENTRE RIOS",18,0,8,7,2,17,0
"300561406","ENTRE RIOS",225,0,110,113,0,223,0
"300561501","ENTRE RIOS",176,48,109,14,1,124,0.272727272727273
"300561502","ENTRE RIOS",206,121,38,38,2,78,0.587378640776699
"300561503","ENTRE RIOS",224,113,76,33,0,109,0.504464285714286
"300561711","ENTRE RIOS",173,149,14,10,0,24,0.861271676300578
"300561604","ENTRE RIOS",132,38,76,16,2,94,0.287878787878788
"300561605","ENTRE RIOS",17,0,9,7,0,16,0
"300561701","ENTRE RIOS",21,2,2,16,0,18,0.0952380952380952
"300561712","ENTRE RIOS",174,134,17,21,0,38,0.770114942528736
"300561801","ENTRE RIOS",33,0,33,0,0,33,0
"300561802","ENTRE RIOS",13,0,9,4,0,13,0
"180210806","CORRIENTES",274,267,3,1,0,4,0.974452554744526
"300561702","ENTRE RIOS",65,7,21,35,0,56,0.107692307692308
"300561703","ENTRE RIOS",159,115,14,30,0,44,0.723270440251572
"300561704","ENTRE RIOS",262,245,11,5,0,16,0.935114503816794
"300561705","ENTRE RIOS",246,226,7,13,0,20,0.91869918699187
"300561706","ENTRE RIOS",134,85,29,18,1,48,0.634328358208955
"300561707","ENTRE RIOS",221,166,29,24,0,53,0.751131221719457
"300561708","ENTRE RIOS",175,171,2,2,0,4,0.977142857142857
"300561709","ENTRE RIOS",166,159,2,5,0,7,0.957831325301205
"300561710","ENTRE RIOS",154,94,13,45,0,58,0.61038961038961
"180210807","CORRIENTES",217,215,0,2,0,2,0.990783410138249
"300561803","ENTRE RIOS",8,0,6,2,0,8,0
"300561804","ENTRE RIOS",29,0,19,10,0,29,0
"300561806","ENTRE RIOS",21,0,15,3,0,18,0
"300561807","ENTRE RIOS",17,0,10,7,0,17,0
"300561808","ENTRE RIOS",65,5,51,5,2,58,0.0769230769230769
"300701110","ENTRE RIOS",343,295,28,18,1,47,0.860058309037901
"300630101","ENTRE RIOS",30,0,20,9,1,30,0
"300561809","ENTRE RIOS",77,0,53,17,0,70,0
"300561810","ENTRE RIOS",158,24,115,18,0,133,0.151898734177215
"300561811","ENTRE RIOS",184,3,124,57,0,181,0.016304347826087
"300561812","ENTRE RIOS",130,2,79,47,0,126,0.0153846153846154
"300561813","ENTRE RIOS",94,1,57,36,0,93,0.0106382978723404
"300561814","ENTRE RIOS",91,19,55,17,0,72,0.208791208791209
"300561815","ENTRE RIOS",21,3,11,7,0,18,0.142857142857143
"300630102","ENTRE RIOS",23,0,6,11,6,23,0
"300630103","ENTRE RIOS",100,13,49,28,10,87,0.13
"300630110","ENTRE RIOS",265,149,53,53,3,109,0.562264150943396
"300630104","ENTRE RIOS",43,1,22,15,5,42,0.0232558139534884
"300630201","ENTRE RIOS",37,22,5,6,3,14,0.594594594594595
"300630105","ENTRE RIOS",33,0,14,17,1,32,0
"300630106","ENTRE RIOS",11,0,2,8,1,11,0
"300630107","ENTRE RIOS",50,0,32,14,1,47,0
"300630108","ENTRE RIOS",41,0,27,12,1,40,0
"300630109","ENTRE RIOS",6,0,2,2,2,6,0
"300701413","ENTRE RIOS",329,313,3,7,0,10,0.951367781155015
"300630111","ENTRE RIOS",243,120,96,20,2,118,0.493827160493827
"300630202","ENTRE RIOS",17,0,9,7,0,16,0
"300630203","ENTRE RIOS",66,18,19,24,2,45,0.272727272727273
"300630204","ENTRE RIOS",274,115,126,30,2,158,0.41970802919708
"300630205","ENTRE RIOS",327,180,93,48,0,141,0.55045871559633
"300630206","ENTRE RIOS",293,113,119,55,1,175,0.385665529010239
"300630207","ENTRE RIOS",274,9,111,152,0,263,0.0328467153284672
"300701403","ENTRE RIOS",14,0,7,7,0,14,0
"300701501","ENTRE RIOS",4,0,0,3,0,3,0
"300630405","ENTRE RIOS",14,0,9,5,0,14,0
"300770111","ENTRE RIOS",147,139,3,3,0,6,0.945578231292517
"300630301","ENTRE RIOS",43,0,14,20,7,41,0
"300630401","ENTRE RIOS",3,0,2,1,0,3,0
"300630402","ENTRE RIOS",1,0,0,1,0,1,0
"221400720","CHACO",208,7,154,39,0,193,0.0336538461538462
"300630302","ENTRE RIOS",17,0,8,6,0,14,0
"300630303","ENTRE RIOS",28,0,10,13,3,26,0
"300630304","ENTRE RIOS",179,3,86,83,2,171,0.0167597765363128
"300770112","ENTRE RIOS",98,59,4,30,1,35,0.602040816326531
"300630403","ENTRE RIOS",6,0,0,6,0,6,0
"300630404","ENTRE RIOS",5,0,1,3,1,5,0
"300770113","ENTRE RIOS",306,287,3,13,0,16,0.937908496732026
"300630406","ENTRE RIOS",50,0,15,33,2,50,0
"300630407","ENTRE RIOS",14,0,3,5,2,10,0
"300770114","ENTRE RIOS",276,275,1,0,0,1,0.996376811594203
"300630408","ENTRE RIOS",16,0,4,12,0,16,0
"300630409","ENTRE RIOS",14,0,3,11,0,14,0
"300630413","ENTRE RIOS",259,7,151,88,8,247,0.027027027027027
"300630501","ENTRE RIOS",23,0,1,18,4,23,0
"300630510","ENTRE RIOS",10,0,3,6,1,10,0
"300630410","ENTRE RIOS",1,0,0,1,0,1,0
"300630411","ENTRE RIOS",3,0,2,1,0,3,0
"300630412","ENTRE RIOS",181,2,100,70,5,175,0.0110497237569061
"300770115","ENTRE RIOS",234,233,0,1,0,1,0.995726495726496
"300630502","ENTRE RIOS",39,0,7,25,1,33,0
"300630503","ENTRE RIOS",8,0,2,4,0,6,0
"300630504","ENTRE RIOS",33,0,17,12,2,31,0
"300770201","ENTRE RIOS",227,223,1,3,0,4,0.982378854625551
"300840518","ENTRE RIOS",235,21,103,107,2,212,0.0893617021276596
"300630505","ENTRE RIOS",76,5,46,19,2,67,0.0657894736842105
"300630506","ENTRE RIOS",7,0,1,6,0,7,0
"300630507","ENTRE RIOS",31,0,11,15,5,31,0
"300630508","ENTRE RIOS",128,1,50,60,12,122,0.0078125
"300630509","ENTRE RIOS",53,2,25,20,5,50,0.0377358490566038
"300840519","ENTRE RIOS",220,95,77,48,0,125,0.431818181818182
"300630511","ENTRE RIOS",14,0,6,3,3,12,0
"300630512","ENTRE RIOS",51,0,4,36,2,42,0
"300700107","ENTRE RIOS",208,152,45,8,0,53,0.730769230769231
"300630513","ENTRE RIOS",4,0,3,0,1,4,0
"300630514","ENTRE RIOS",1,0,0,1,0,1,0
"300700101","ENTRE RIOS",108,88,8,8,0,16,0.814814814814815
"300700102","ENTRE RIOS",163,161,2,0,0,2,0.987730061349693
"300700103","ENTRE RIOS",147,119,17,10,0,27,0.80952380952381
"221400908","CHACO",257,11,158,65,11,234,0.0428015564202335
"221400909","CHACO",275,0,182,77,4,263,0
"300770104","ENTRE RIOS",206,180,8,14,0,22,0.87378640776699
"300700104","ENTRE RIOS",182,83,33,63,1,97,0.456043956043956
"300700105","ENTRE RIOS",184,51,52,78,0,130,0.277173913043478
"300700106","ENTRE RIOS",265,10,75,164,1,240,0.0377358490566038
"300700109","ENTRE RIOS",257,217,12,25,0,37,0.844357976653696
"300700110","ENTRE RIOS",191,127,2,50,5,57,0.664921465968586
"300700204","ENTRE RIOS",219,33,49,116,9,174,0.150684931506849
"300700111","ENTRE RIOS",222,157,20,35,0,55,0.707207207207207
"300700112","ENTRE RIOS",176,171,2,2,0,4,0.971590909090909
"300700113","ENTRE RIOS",297,269,4,21,0,25,0.905723905723906
"300700114","ENTRE RIOS",372,270,21,53,4,78,0.725806451612903
"300700205","ENTRE RIOS",159,75,26,38,0,64,0.471698113207547
"300700115","ENTRE RIOS",317,282,8,24,0,32,0.889589905362776
"300700201","ENTRE RIOS",272,95,64,109,1,174,0.349264705882353
"300700202","ENTRE RIOS",200,176,9,7,2,18,0.88
"300700203","ENTRE RIOS",250,211,7,22,0,29,0.844
"300700206","ENTRE RIOS",264,214,32,9,1,42,0.810606060606061
"501051406","MENDOZA",168,138,15,15,0,30,0.821428571428571
"300700207","ENTRE RIOS",138,38,39,54,3,96,0.27536231884058
"300700208","ENTRE RIOS",149,1,46,84,8,138,0.00671140939597315
"300700209","ENTRE RIOS",211,64,14,128,0,142,0.303317535545024
"300700210","ENTRE RIOS",221,45,63,95,1,159,0.203619909502262
"300700301","ENTRE RIOS",5,0,2,2,1,5,0
"300700314","ENTRE RIOS",9,0,1,8,0,9,0
"300770202","ENTRE RIOS",290,281,2,7,0,9,0.968965517241379
"300700302","ENTRE RIOS",60,2,18,39,0,57,0.0333333333333333
"300700303","ENTRE RIOS",238,147,36,43,1,80,0.617647058823529
"300700304","ENTRE RIOS",239,63,103,73,0,176,0.263598326359833
"300700305","ENTRE RIOS",107,2,54,38,0,92,0.0186915887850467
"300700306","ENTRE RIOS",68,39,4,17,3,24,0.573529411764706
"300700307","ENTRE RIOS",52,0,12,34,1,47,0
"300700308","ENTRE RIOS",246,242,0,4,0,4,0.983739837398374
"300700309","ENTRE RIOS",122,113,2,7,0,9,0.926229508196721
"300700310","ENTRE RIOS",286,257,17,7,0,24,0.898601398601399
"300700311","ENTRE RIOS",151,55,51,42,2,95,0.364238410596026
"300700312","ENTRE RIOS",74,27,16,26,0,42,0.364864864864865
"300700313","ENTRE RIOS",29,0,8,13,4,25,0
"300700401","ENTRE RIOS",54,0,27,17,3,47,0
"300700402","ENTRE RIOS",35,0,12,21,1,34,0
"300700403","ENTRE RIOS",5,0,4,0,1,5,0
"300700404","ENTRE RIOS",15,0,0,12,0,12,0
"300700405","ENTRE RIOS",25,0,8,6,5,19,0
"300700406","ENTRE RIOS",88,41,29,11,0,40,0.465909090909091
"300700407","ENTRE RIOS",43,0,27,10,3,40,0
"300700408","ENTRE RIOS",68,1,16,43,5,64,0.0147058823529412
"300700415","ENTRE RIOS",60,0,38,17,0,55,0
"300770203","ENTRE RIOS",131,122,2,6,0,8,0.931297709923664
"300700409","ENTRE RIOS",31,1,9,17,1,27,0.032258064516129
"300700410","ENTRE RIOS",3,0,2,1,0,3,0
"300700411","ENTRE RIOS",49,0,27,15,4,46,0
"300700412","ENTRE RIOS",14,0,12,2,0,14,0
"300700413","ENTRE RIOS",35,0,24,8,1,33,0
"300700414","ENTRE RIOS",37,0,15,9,6,30,0
"300700501","ENTRE RIOS",39,0,23,7,1,31,0
"300700502","ENTRE RIOS",32,0,7,9,0,16,0
"300700505","ENTRE RIOS",46,0,24,18,1,43,0
"300700506","ENTRE RIOS",42,0,32,8,0,40,0
"300700503","ENTRE RIOS",37,0,25,5,2,32,0
"300700507","ENTRE RIOS",39,0,13,21,1,35,0
"300700504","ENTRE RIOS",10,0,7,0,0,7,0
"300700508","ENTRE RIOS",7,1,2,4,0,6,0.142857142857143
"300700601","ENTRE RIOS",8,2,5,1,0,6,0.25
"300700602","ENTRE RIOS",11,0,8,2,0,10,0
"300700607","ENTRE RIOS",19,0,17,1,0,18,0
"300700907","ENTRE RIOS",63,0,38,23,0,61,0
"300700509","ENTRE RIOS",29,0,18,9,0,27,0
"300700510","ENTRE RIOS",132,7,38,77,2,117,0.053030303030303
"300700511","ENTRE RIOS",202,3,78,114,2,194,0.0148514851485149
"300700603","ENTRE RIOS",10,0,0,9,1,10,0
"300700604","ENTRE RIOS",21,0,9,11,0,20,0
"300700605","ENTRE RIOS",5,0,2,2,0,4,0
"300700606","ENTRE RIOS",6,0,1,3,0,4,0
"300700608","ENTRE RIOS",67,1,3,58,0,61,0.0149253731343284
"300700609","ENTRE RIOS",25,0,2,21,1,24,0
"300770204","ENTRE RIOS",210,205,1,2,0,3,0.976190476190476
"300770205","ENTRE RIOS",217,217,0,0,0,0,1
"300700701","ENTRE RIOS",57,0,33,13,4,50,0
"300770206","ENTRE RIOS",192,163,8,18,0,26,0.848958333333333
"300700702","ENTRE RIOS",22,0,13,5,2,20,0
"300700703","ENTRE RIOS",49,0,14,18,12,44,0
"300770207","ENTRE RIOS",238,219,8,9,0,17,0.920168067226891
"300700704","ENTRE RIOS",20,0,15,4,0,19,0
"300700705","ENTRE RIOS",31,0,7,19,5,31,0
"300701001","ENTRE RIOS",1,0,0,1,0,1,0
"300701002","ENTRE RIOS",11,1,2,8,0,10,0.0909090909090909
"300700706","ENTRE RIOS",46,0,19,22,5,46,0
"300700801","ENTRE RIOS",13,0,3,5,1,9,0
"300700802","ENTRE RIOS",11,0,5,4,0,9,0
"300700805","ENTRE RIOS",16,0,10,4,2,16,0
"300770105","ENTRE RIOS",225,173,7,43,0,50,0.768888888888889
"300701404","ENTRE RIOS",17,5,9,3,0,12,0.294117647058824
"300700803","ENTRE RIOS",26,1,12,8,4,24,0.0384615384615385
"300700804","ENTRE RIOS",16,0,2,8,3,13,0
"300770106","ENTRE RIOS",191,174,3,13,0,16,0.910994764397906
"300700908","ENTRE RIOS",31,0,8,23,0,31,0
"300700806","ENTRE RIOS",21,0,11,9,0,20,0
"300700807","ENTRE RIOS",16,0,6,10,0,16,0
"300700808","ENTRE RIOS",11,1,2,7,0,9,0.0909090909090909
"300700809","ENTRE RIOS",17,0,11,5,0,16,0
"300700810","ENTRE RIOS",133,73,22,28,1,51,0.548872180451128
"300700909","ENTRE RIOS",77,0,48,24,0,72,0
"300700901","ENTRE RIOS",33,0,15,16,0,31,0
"300700904","ENTRE RIOS",28,0,6,20,0,26,0
"300700902","ENTRE RIOS",10,0,3,4,0,7,0
"300701004","ENTRE RIOS",196,143,2,42,0,44,0.729591836734694
"300770107","ENTRE RIOS",215,208,3,3,0,6,0.967441860465116
"300770108","ENTRE RIOS",184,177,5,1,0,6,0.96195652173913
"300700903","ENTRE RIOS",68,0,39,24,3,66,0
"300701405","ENTRE RIOS",312,263,6,25,3,34,0.842948717948718
"300701003","ENTRE RIOS",111,44,18,46,1,65,0.396396396396396
"300701005","ENTRE RIOS",210,181,7,15,0,22,0.861904761904762
"300701006","ENTRE RIOS",130,118,7,5,0,12,0.907692307692308
"300701007","ENTRE RIOS",159,154,5,0,0,5,0.968553459119497
"300701406","ENTRE RIOS",227,213,5,8,0,13,0.938325991189427
"300770208","ENTRE RIOS",210,208,2,0,0,2,0.990476190476191
"300701008","ENTRE RIOS",310,248,20,33,1,54,0.8
"300701009","ENTRE RIOS",275,258,2,10,0,12,0.938181818181818
"300701010","ENTRE RIOS",329,318,2,3,0,5,0.966565349544073
"300701011","ENTRE RIOS",192,155,21,13,1,35,0.807291666666667
"300770109","ENTRE RIOS",228,219,2,5,0,7,0.960526315789474
"300701101","ENTRE RIOS",193,160,27,5,0,32,0.829015544041451
"300701105","ENTRE RIOS",182,144,18,13,1,32,0.791208791208791
"300701106","ENTRE RIOS",358,355,0,1,0,1,0.991620111731844
"300701107","ENTRE RIOS",224,223,0,1,0,1,0.995535714285714
"300701102","ENTRE RIOS",161,110,34,6,4,44,0.683229813664596
"300701103","ENTRE RIOS",220,185,22,3,8,33,0.840909090909091
"300701104","ENTRE RIOS",320,292,8,13,5,26,0.9125
"300701111","ENTRE RIOS",331,239,22,31,9,62,0.722054380664653
"300770101","ENTRE RIOS",124,13,23,81,2,106,0.104838709677419
"300701201","ENTRE RIOS",83,0,22,38,15,75,0
"300701202","ENTRE RIOS",21,0,7,11,3,21,0
"300701203","ENTRE RIOS",20,0,12,7,1,20,0
"300701204","ENTRE RIOS",68,0,25,38,1,64,0
"300770102","ENTRE RIOS",269,255,8,6,0,14,0.947955390334573
"300770103","ENTRE RIOS",179,169,1,7,1,9,0.94413407821229
"300770110","ENTRE RIOS",351,332,2,14,0,16,0.945868945868946
"300701112","ENTRE RIOS",89,3,12,62,0,74,0.0337078651685393
"300701212","ENTRE RIOS",82,65,13,4,0,17,0.792682926829268
"300701213","ENTRE RIOS",310,246,25,36,1,62,0.793548387096774
"300701205","ENTRE RIOS",25,0,13,12,0,25,0
"300701206","ENTRE RIOS",28,0,3,24,0,27,0
"300701207","ENTRE RIOS",39,1,17,20,0,37,0.0256410256410256
"300701407","ENTRE RIOS",217,190,14,2,0,16,0.875576036866359
"300701208","ENTRE RIOS",25,0,17,8,0,25,0
"300701209","ENTRE RIOS",34,0,17,16,0,33,0
"300701210","ENTRE RIOS",21,0,19,0,0,19,0
"300701211","ENTRE RIOS",0,0,0,0,0,0,NA
"300701301","ENTRE RIOS",84,2,52,21,0,73,0.0238095238095238
"300701302","ENTRE RIOS",93,4,42,39,2,83,0.043010752688172
"300701306","ENTRE RIOS",18,0,9,9,0,18,0
"300701307","ENTRE RIOS",22,0,6,14,0,20,0
"300701303","ENTRE RIOS",26,0,11,13,0,24,0
"300701304","ENTRE RIOS",45,0,27,14,1,42,0
"300701305","ENTRE RIOS",12,0,3,7,0,10,0
"300701308","ENTRE RIOS",58,29,10,15,1,26,0.5
"300701309","ENTRE RIOS",185,159,11,7,0,18,0.859459459459459
"300770214","ENTRE RIOS",182,169,1,7,1,9,0.928571428571429
"300770215","ENTRE RIOS",210,208,2,0,0,2,0.990476190476191
"300770216","ENTRE RIOS",324,310,2,1,0,3,0.95679012345679
"300770217","ENTRE RIOS",113,85,1,24,0,25,0.752212389380531
"300770301","ENTRE RIOS",18,0,8,9,1,18,0
"300770302","ENTRE RIOS",75,5,11,57,2,70,0.0666666666666667
"300770303","ENTRE RIOS",20,6,3,11,0,14,0.3
"300770304","ENTRE RIOS",84,11,14,52,5,71,0.130952380952381
"300770305","ENTRE RIOS",100,19,12,69,0,81,0.19
"300770306","ENTRE RIOS",76,3,4,63,0,67,0.0394736842105263
"300770401","ENTRE RIOS",14,0,10,3,1,14,0
"300770402","ENTRE RIOS",20,0,10,9,1,20,0
"300770403","ENTRE RIOS",39,0,18,20,0,38,0
"300770417","ENTRE RIOS",16,0,9,5,1,15,0
"300770404","ENTRE RIOS",27,0,9,15,3,27,0
"300770405","ENTRE RIOS",51,5,5,38,1,44,0.0980392156862745
"300770406","ENTRE RIOS",27,0,19,5,3,27,0
"300770414","ENTRE RIOS",41,0,13,23,2,38,0
"300770407","ENTRE RIOS",28,0,13,5,0,18,0
"300770408","ENTRE RIOS",38,0,1,35,1,37,0
"300770409","ENTRE RIOS",15,0,9,3,1,13,0
"300770415","ENTRE RIOS",24,0,8,16,0,24,0
"300770416","ENTRE RIOS",32,0,12,13,5,30,0
"300840320","ENTRE RIOS",221,220,1,0,0,1,0.995475113122172
"300770410","ENTRE RIOS",31,1,8,14,6,28,0.032258064516129
"300770411","ENTRE RIOS",26,0,5,19,1,25,0
"300770412","ENTRE RIOS",15,0,3,9,0,12,0
"300770413","ENTRE RIOS",9,0,3,4,0,7,0
"300770501","ENTRE RIOS",32,0,9,19,3,31,0
"300770502","ENTRE RIOS",5,0,1,3,1,5,0
"300770507","ENTRE RIOS",42,0,8,28,1,37,0
"300770508","ENTRE RIOS",21,1,4,12,0,16,0.0476190476190476
"300770509","ENTRE RIOS",7,0,2,3,0,5,0
"300770503","ENTRE RIOS",24,0,3,20,0,23,0
"300770504","ENTRE RIOS",18,0,6,5,2,13,0
"300770505","ENTRE RIOS",48,0,11,33,0,44,0
"300770506","ENTRE RIOS",40,0,7,28,1,36,0
"300770511","ENTRE RIOS",10,0,9,1,0,10,0
"300770512","ENTRE RIOS",5,0,0,5,0,5,0
"300770513","ENTRE RIOS",30,0,2,28,0,30,0
"300770514","ENTRE RIOS",33,0,3,19,1,23,0
"300770515","ENTRE RIOS",20,0,4,11,4,19,0
"300770516","ENTRE RIOS",50,0,11,34,1,46,0
"300770517","ENTRE RIOS",29,0,1,23,0,24,0
"300770518","ENTRE RIOS",21,0,3,17,0,20,0
"300840521","ENTRE RIOS",214,151,28,35,0,63,0.705607476635514
"300770519","ENTRE RIOS",7,0,0,7,0,7,0
"300770601","ENTRE RIOS",46,0,25,21,0,46,0
"300770602","ENTRE RIOS",11,0,0,10,0,10,0
"300770603","ENTRE RIOS",41,0,18,20,2,40,0
"300770604","ENTRE RIOS",6,0,4,2,0,6,0
"300840321","ENTRE RIOS",175,174,1,0,0,1,0.994285714285714
"300770605","ENTRE RIOS",45,0,22,19,2,43,0
"300770606","ENTRE RIOS",38,0,7,23,6,36,0
"300770607","ENTRE RIOS",35,1,10,21,2,33,0.0285714285714286
"300770806","ENTRE RIOS",62,25,8,27,0,35,0.403225806451613
"300770608","ENTRE RIOS",14,0,0,13,0,13,0
"300770609","ENTRE RIOS",18,0,5,11,1,17,0
"300770610","ENTRE RIOS",30,0,17,13,0,30,0
"300770702","ENTRE RIOS",30,0,12,18,0,30,0
"300770611","ENTRE RIOS",19,0,11,8,0,19,0
"300770612","ENTRE RIOS",95,0,35,55,4,94,0
"300770703","ENTRE RIOS",16,0,9,6,0,15,0
"300770613","ENTRE RIOS",5,0,2,3,0,5,0
"300770807","ENTRE RIOS",6,0,1,4,1,6,0
"300770901","ENTRE RIOS",21,0,7,11,1,19,0
"300770701","ENTRE RIOS",47,0,29,18,0,47,0
"300770802","ENTRE RIOS",140,136,1,2,0,3,0.971428571428571
"300771106","ENTRE RIOS",8,0,4,4,0,8,0
"300840322","ENTRE RIOS",110,110,0,0,0,0,1
"300840323","ENTRE RIOS",170,170,0,0,0,0,1
"300840401","ENTRE RIOS",328,13,60,243,1,304,0.0396341463414634
"300840402","ENTRE RIOS",249,6,42,168,18,228,0.0240963855421687
"300770704","ENTRE RIOS",19,0,5,14,0,19,0
"300770705","ENTRE RIOS",24,1,1,22,0,23,0.0416666666666667
"300770706","ENTRE RIOS",235,196,12,26,0,38,0.834042553191489
"300770707","ENTRE RIOS",259,210,27,19,0,46,0.810810810810811
"300770803","ENTRE RIOS",146,138,5,2,0,7,0.945205479452055
"300770708","ENTRE RIOS",10,0,7,3,0,10,0
"300771107","ENTRE RIOS",3,0,1,2,0,3,0
"300770709","ENTRE RIOS",25,1,11,12,0,23,0.04
"300770804","ENTRE RIOS",170,148,3,19,0,22,0.870588235294118
"300770710","ENTRE RIOS",21,1,11,9,0,20,0.0476190476190476
"300771108","ENTRE RIOS",21,0,6,13,0,19,0
"300770711","ENTRE RIOS",7,0,1,6,0,7,0
"300770801","ENTRE RIOS",89,67,7,14,0,21,0.752808988764045
"300840908","ENTRE RIOS",131,130,1,0,0,1,0.99236641221374
"300770805","ENTRE RIOS",31,0,16,14,1,31,0
"300840502","ENTRE RIOS",242,191,26,23,0,49,0.789256198347107
"300770902","ENTRE RIOS",13,1,1,11,0,12,0.0769230769230769
"300770903","ENTRE RIOS",25,0,21,4,0,25,0
"300770904","ENTRE RIOS",66,1,17,42,1,60,0.0151515151515152
"300770905","ENTRE RIOS",8,0,0,8,0,8,0
"300770906","ENTRE RIOS",95,0,21,70,1,92,0
"300770907","ENTRE RIOS",20,0,4,14,1,19,0
"300771204","ENTRE RIOS",199,139,13,44,1,58,0.698492462311558
"300770908","ENTRE RIOS",23,0,1,17,0,18,0
"300771001","ENTRE RIOS",27,0,4,20,3,27,0
"300771002","ENTRE RIOS",31,0,12,13,1,26,0
"300771003","ENTRE RIOS",14,0,1,11,1,13,0
"300841004","ENTRE RIOS",181,128,38,13,0,51,0.707182320441989
"300771004","ENTRE RIOS",9,0,0,9,0,9,0
"300771005","ENTRE RIOS",13,0,0,12,0,12,0
"300771006","ENTRE RIOS",4,0,1,3,0,4,0
"300771113","ENTRE RIOS",38,0,11,26,1,38,0
"300771101","ENTRE RIOS",36,1,21,13,0,34,0.0277777777777778
"300771109","ENTRE RIOS",26,0,14,11,0,25,0
"300840405","ENTRE RIOS",281,21,133,118,2,253,0.0747330960854092
"300771112","ENTRE RIOS",37,3,1,30,0,31,0.0810810810810811
"300771102","ENTRE RIOS",20,0,20,0,0,20,0
"300771103","ENTRE RIOS",59,0,3,54,0,57,0
"300771104","ENTRE RIOS",23,0,12,9,0,21,0
"300771105","ENTRE RIOS",20,0,0,18,2,20,0
"300771110","ENTRE RIOS",33,0,9,24,0,33,0
"300771111","ENTRE RIOS",27,1,9,15,0,24,0.037037037037037
"300771209","ENTRE RIOS",29,2,5,19,3,27,0.0689655172413793
"300771210","ENTRE RIOS",14,0,5,9,0,14,0
"300771114","ENTRE RIOS",31,0,5,22,2,29,0
"300771211","ENTRE RIOS",10,0,7,2,0,9,0
"300771212","ENTRE RIOS",11,0,0,4,2,6,0
"300771213","ENTRE RIOS",2,0,0,2,0,2,0
"300840406","ENTRE RIOS",237,184,40,10,0,50,0.776371308016878
"300771115","ENTRE RIOS",20,0,13,5,1,19,0
"300771201","ENTRE RIOS",295,200,12,78,0,90,0.677966101694915
"300771202","ENTRE RIOS",132,71,11,48,1,60,0.537878787878788
"300771203","ENTRE RIOS",213,203,8,2,0,10,0.953051643192488
"300771205","ENTRE RIOS",199,190,7,2,0,9,0.954773869346734
"300771206","ENTRE RIOS",170,75,19,76,0,95,0.441176470588235
"300771207","ENTRE RIOS",236,158,19,57,1,77,0.669491525423729
"300771208","ENTRE RIOS",35,3,9,21,1,31,0.0857142857142857
"300840102","ENTRE RIOS",246,1,62,175,3,240,0.0040650406504065
"300840103","ENTRE RIOS",105,15,60,29,0,89,0.142857142857143
"300840104","ENTRE RIOS",294,5,57,212,1,270,0.0170068027210884
"300840101","ENTRE RIOS",273,27,89,146,0,235,0.0989010989010989
"300840204","ENTRE RIOS",196,196,0,0,0,0,1
"300840205","ENTRE RIOS",326,325,0,1,0,1,0.996932515337423
"300840105","ENTRE RIOS",276,19,57,179,1,237,0.0688405797101449
"300840206","ENTRE RIOS",187,186,0,0,0,0,0.994652406417112
"300840407","ENTRE RIOS",197,134,24,39,0,63,0.680203045685279
"300840108","ENTRE RIOS",373,211,26,122,0,148,0.565683646112601
"300840109","ENTRE RIOS",116,37,23,52,0,75,0.318965517241379
"300841005","ENTRE RIOS",212,145,42,25,0,67,0.683962264150943
"300840106","ENTRE RIOS",194,3,31,153,0,184,0.0154639175257732
"300840107","ENTRE RIOS",180,15,31,115,7,153,0.0833333333333333
"300840408","ENTRE RIOS",242,177,30,35,0,65,0.731404958677686
"300840110","ENTRE RIOS",200,162,5,27,0,32,0.81
"300840111","ENTRE RIOS",351,240,8,74,3,85,0.683760683760684
"300840503","ENTRE RIOS",257,151,30,40,0,70,0.587548638132296
"300840210","ENTRE RIOS",128,128,0,0,0,0,1
"300840113","ENTRE RIOS",354,215,20,84,5,109,0.607344632768362
"300840112","ENTRE RIOS",324,48,103,149,5,257,0.148148148148148
"300840207","ENTRE RIOS",174,163,5,6,0,11,0.936781609195402
"300840208","ENTRE RIOS",305,257,25,16,0,41,0.842622950819672
"300840209","ENTRE RIOS",232,229,1,2,0,3,0.987068965517241
"300840114","ENTRE RIOS",401,335,15,36,1,52,0.835411471321696
"300840201","ENTRE RIOS",223,110,22,80,3,105,0.493273542600897
"300840211","ENTRE RIOS",197,197,0,0,0,0,1
"300840212","ENTRE RIOS",250,249,0,0,0,0,0.996
"300840213","ENTRE RIOS",254,253,1,0,0,1,0.996062992125984
"300840214","ENTRE RIOS",158,158,0,0,0,0,1
"300840522","ENTRE RIOS",350,316,25,9,0,34,0.902857142857143
"300840409","ENTRE RIOS",345,147,45,144,6,195,0.426086956521739
"300840202","ENTRE RIOS",170,170,0,0,0,0,1
"300840215","ENTRE RIOS",251,238,1,12,0,13,0.948207171314741
"300840414","ENTRE RIOS",288,244,39,5,0,44,0.847222222222222
"300840504","ENTRE RIOS",339,254,13,72,0,85,0.749262536873156
"300840203","ENTRE RIOS",235,235,0,0,0,0,1
"300840306","ENTRE RIOS",266,266,0,0,0,0,1
"300840216","ENTRE RIOS",326,128,68,121,1,190,0.392638036809816
"300840217","ENTRE RIOS",272,253,13,6,0,19,0.930147058823529
"300840218","ENTRE RIOS",247,245,2,0,0,2,0.991902834008097
"300840219","ENTRE RIOS",223,223,0,0,0,0,1
"300840220","ENTRE RIOS",206,205,1,0,0,1,0.995145631067961
"300840221","ENTRE RIOS",208,205,3,0,0,3,0.985576923076923
"300840222","ENTRE RIOS",168,168,0,0,0,0,1
"300840223","ENTRE RIOS",167,167,0,0,0,0,1
"300840224","ENTRE RIOS",157,157,0,0,0,0,1
"300840307","ENTRE RIOS",209,207,1,0,0,1,0.990430622009569
"300840301","ENTRE RIOS",335,318,8,6,0,14,0.949253731343284
"300840308","ENTRE RIOS",218,218,0,0,0,0,1
"300840309","ENTRE RIOS",268,266,2,0,0,2,0.992537313432836
"300840310","ENTRE RIOS",305,259,20,26,0,46,0.849180327868852
"300840311","ENTRE RIOS",264,262,1,1,0,2,0.992424242424242
"300840312","ENTRE RIOS",219,212,4,3,0,7,0.968036529680365
"300840313","ENTRE RIOS",181,181,0,0,0,0,1
"300840314","ENTRE RIOS",319,317,2,0,0,2,0.993730407523511
"300840302","ENTRE RIOS",298,5,32,254,3,289,0.0167785234899329
"300840303","ENTRE RIOS",246,150,59,33,0,92,0.609756097560976
"300840304","ENTRE RIOS",238,206,9,23,0,32,0.865546218487395
"300840305","ENTRE RIOS",414,117,68,206,9,283,0.282608695652174
"300840403","ENTRE RIOS",112,23,77,11,1,89,0.205357142857143
"300840404","ENTRE RIOS",370,81,179,106,0,285,0.218918918918919
"300840523","ENTRE RIOS",370,282,25,59,0,84,0.762162162162162
"300840411","ENTRE RIOS",396,257,23,102,11,136,0.648989898989899
"221401101","CHACO",261,258,2,1,0,3,0.988505747126437
"300840415","ENTRE RIOS",400,350,18,17,3,38,0.875
"300840416","ENTRE RIOS",390,270,47,72,0,119,0.692307692307692
"300840417","ENTRE RIOS",345,234,47,59,0,106,0.678260869565217
"300840410","ENTRE RIOS",244,145,46,44,4,94,0.594262295081967
"300840412","ENTRE RIOS",289,214,37,36,0,73,0.740484429065744
"300840413","ENTRE RIOS",231,189,26,15,0,41,0.818181818181818
"300840418","ENTRE RIOS",307,179,38,86,0,124,0.583061889250814
"300840419","ENTRE RIOS",151,20,24,106,0,130,0.132450331125828
"300840420","ENTRE RIOS",231,227,4,0,0,4,0.982683982683983
"300840421","ENTRE RIOS",240,227,9,4,0,13,0.945833333333333
"300840501","ENTRE RIOS",392,330,38,24,0,62,0.841836734693878
"221401102","CHACO",303,286,13,4,0,17,0.943894389438944
"300840505","ENTRE RIOS",508,91,205,197,7,409,0.179133858267717
"221401104","CHACO",412,402,7,2,0,9,0.975728155339806
"300840506","ENTRE RIOS",224,111,74,37,0,111,0.495535714285714
"300840507","ENTRE RIOS",233,197,18,18,0,36,0.84549356223176
"300840508","ENTRE RIOS",306,238,22,44,0,66,0.777777777777778
"300840509","ENTRE RIOS",184,164,12,8,0,20,0.891304347826087
"300840516","ENTRE RIOS",373,234,74,62,1,137,0.627345844504021
"300840517","ENTRE RIOS",271,34,103,130,0,233,0.125461254612546
"221401103","CHACO",266,262,4,0,0,4,0.984962406015038
"300840524","ENTRE RIOS",347,298,24,24,0,48,0.858789625360231
"300840601","ENTRE RIOS",332,332,0,0,0,0,1
"300840602","ENTRE RIOS",104,104,0,0,0,0,1
"300840603","ENTRE RIOS",186,185,1,0,0,1,0.994623655913978
"300840510","ENTRE RIOS",237,212,16,9,0,25,0.894514767932489
"300840511","ENTRE RIOS",174,145,10,14,1,25,0.833333333333333
"300840512","ENTRE RIOS",330,328,2,0,0,2,0.993939393939394
"300840513","ENTRE RIOS",227,227,0,0,0,0,1
"300840514","ENTRE RIOS",370,369,0,0,0,0,0.997297297297297
"300840515","ENTRE RIOS",211,202,1,0,0,1,0.957345971563981
"300840608","ENTRE RIOS",335,333,2,0,0,2,0.994029850746269
"300840609","ENTRE RIOS",134,133,1,0,0,1,0.992537313432836
"300840610","ENTRE RIOS",81,80,0,1,0,1,0.987654320987654
"300840611","ENTRE RIOS",125,125,0,0,0,0,1
"300840612","ENTRE RIOS",245,237,3,4,0,7,0.96734693877551
"300840613","ENTRE RIOS",164,162,1,0,1,2,0.98780487804878
"300840614","ENTRE RIOS",177,176,1,0,0,1,0.994350282485876
"300840615","ENTRE RIOS",264,263,1,0,0,1,0.996212121212121
"300840616","ENTRE RIOS",303,300,2,1,0,3,0.99009900990099
"300840617","ENTRE RIOS",281,280,1,0,0,1,0.99644128113879
"300840618","ENTRE RIOS",254,253,1,0,0,1,0.996062992125984
"300840619","ENTRE RIOS",281,279,2,0,0,2,0.99288256227758
"300840620","ENTRE RIOS",343,343,0,0,0,0,1
"300840621","ENTRE RIOS",309,302,2,5,0,7,0.977346278317152
"300840805","ENTRE RIOS",385,147,76,147,0,223,0.381818181818182
"300840622","ENTRE RIOS",219,203,1,13,0,14,0.926940639269406
"300840623","ENTRE RIOS",272,253,5,14,0,19,0.930147058823529
"300840701","ENTRE RIOS",292,197,7,42,1,50,0.674657534246575
"300840702","ENTRE RIOS",273,271,2,0,0,2,0.992673992673993
"300840703","ENTRE RIOS",120,120,0,0,0,0,1
"300840704","ENTRE RIOS",109,109,0,0,0,0,1
"300840705","ENTRE RIOS",154,154,0,0,0,0,1
"300840706","ENTRE RIOS",210,210,0,0,0,0,1
"300840707","ENTRE RIOS",154,153,1,0,0,1,0.993506493506494
"300840708","ENTRE RIOS",325,324,1,0,0,1,0.996923076923077
"300840801","ENTRE RIOS",203,196,2,1,0,3,0.96551724137931
"300840813","ENTRE RIOS",44,43,1,0,0,1,0.977272727272727
"300841006","ENTRE RIOS",216,172,20,24,0,44,0.796296296296296
"300840709","ENTRE RIOS",380,372,5,1,0,6,0.978947368421053
"300840710","ENTRE RIOS",339,337,2,0,0,2,0.994100294985251
"300840711","ENTRE RIOS",356,354,2,0,0,2,0.99438202247191
"300840712","ENTRE RIOS",326,307,16,2,0,18,0.941717791411043
"300840802","ENTRE RIOS",300,297,2,1,0,3,0.99
"300840713","ENTRE RIOS",330,70,62,187,3,252,0.212121212121212
"300840803","ENTRE RIOS",240,221,9,10,0,19,0.920833333333333
"300840804","ENTRE RIOS",351,315,7,20,5,32,0.897435897435897
"300840812","ENTRE RIOS",252,209,15,24,0,39,0.829365079365079
"300840714","ENTRE RIOS",390,312,19,53,4,76,0.8
"300840715","ENTRE RIOS",311,273,15,19,2,36,0.877813504823151
"300840806","ENTRE RIOS",300,135,38,125,1,164,0.45
"300840807","ENTRE RIOS",332,317,5,10,0,15,0.954819277108434
"300840808","ENTRE RIOS",185,175,8,2,0,10,0.945945945945946
"300840809","ENTRE RIOS",236,232,1,3,0,4,0.983050847457627
"300840810","ENTRE RIOS",305,282,10,13,0,23,0.924590163934426
"300840811","ENTRE RIOS",298,291,2,5,0,7,0.976510067114094
"221401313","CHACO",229,10,121,92,0,213,0.0436681222707424
"700420416","SAN JUAN",321,12,225,83,0,308,0.0373831775700935
"300840814","ENTRE RIOS",338,306,12,14,0,26,0.905325443786982
"300840815","ENTRE RIOS",293,278,7,5,0,12,0.948805460750853
"300840816","ENTRE RIOS",317,40,73,188,5,266,0.126182965299685
"300840905","ENTRE RIOS",155,154,1,0,0,1,0.993548387096774
"300840906","ENTRE RIOS",237,232,2,0,0,2,0.978902953586498
"300840907","ENTRE RIOS",435,390,18,25,1,44,0.896551724137931
"300840817","ENTRE RIOS",278,121,34,118,1,153,0.435251798561151
"300840818","ENTRE RIOS",348,336,5,6,0,11,0.96551724137931
"300840819","ENTRE RIOS",364,320,11,9,0,20,0.879120879120879
"300840820","ENTRE RIOS",317,298,16,3,0,19,0.94006309148265
"300840821","ENTRE RIOS",383,332,34,17,0,51,0.866840731070496
"300840822","ENTRE RIOS",348,142,120,86,0,206,0.408045977011494
"300840823","ENTRE RIOS",184,47,65,68,1,134,0.255434782608696
"300840901","ENTRE RIOS",313,278,16,18,0,34,0.888178913738019
"300840902","ENTRE RIOS",286,195,39,52,0,91,0.681818181818182
"300840903","ENTRE RIOS",137,118,10,9,0,19,0.861313868613139
"300840904","ENTRE RIOS",303,272,8,16,0,24,0.897689768976898
"300840909","ENTRE RIOS",328,286,10,4,0,14,0.871951219512195
"300840910","ENTRE RIOS",246,215,15,16,0,31,0.873983739837398
"300840911","ENTRE RIOS",332,320,10,2,0,12,0.963855421686747
"300840912","ENTRE RIOS",270,260,3,7,0,10,0.962962962962963
"300840913","ENTRE RIOS",366,344,15,7,0,22,0.939890710382514
"300840914","ENTRE RIOS",303,280,10,9,0,19,0.924092409240924
"300840915","ENTRE RIOS",134,115,6,13,0,19,0.858208955223881
"300840916","ENTRE RIOS",270,248,12,7,0,19,0.918518518518519
"300840917","ENTRE RIOS",361,359,2,0,0,2,0.994459833795014
"300841001","ENTRE RIOS",280,209,37,34,0,71,0.746428571428571
"300841002","ENTRE RIOS",267,147,16,94,5,115,0.550561797752809
"300841003","ENTRE RIOS",263,229,10,24,0,34,0.870722433460076
"300841007","ENTRE RIOS",258,225,23,9,0,32,0.872093023255814
"300841008","ENTRE RIOS",304,256,27,16,0,43,0.842105263157895
"300841009","ENTRE RIOS",321,292,20,9,0,29,0.909657320872274
"300841010","ENTRE RIOS",222,173,19,30,0,49,0.779279279279279
"300841011","ENTRE RIOS",297,224,38,34,0,72,0.754208754208754
"300841012","ENTRE RIOS",239,195,17,26,0,43,0.815899581589958
"300841013","ENTRE RIOS",243,210,24,9,0,33,0.864197530864197
"300841014","ENTRE RIOS",351,316,10,25,0,35,0.9002849002849
"300841015","ENTRE RIOS",319,302,5,8,0,13,0.946708463949843
"300841016","ENTRE RIOS",207,144,40,22,0,62,0.695652173913043
"300841017","ENTRE RIOS",325,222,35,68,0,103,0.683076923076923
"300841018","ENTRE RIOS",313,149,58,103,0,161,0.476038338658147
"300841019","ENTRE RIOS",160,21,43,95,0,138,0.13125
"300841020","ENTRE RIOS",352,296,38,16,0,54,0.840909090909091
"300841021","ENTRE RIOS",292,18,80,192,0,272,0.0616438356164384
"300841101","ENTRE RIOS",108,80,12,15,0,27,0.740740740740741
"300841102","ENTRE RIOS",241,200,15,25,0,40,0.829875518672199
"300841506","ENTRE RIOS",347,339,1,4,0,5,0.976945244956772
"300841103","ENTRE RIOS",315,141,48,126,0,174,0.447619047619048
"300841104","ENTRE RIOS",244,239,2,0,0,2,0.979508196721312
"300841105","ENTRE RIOS",121,95,3,19,0,22,0.785123966942149
"300841508","ENTRE RIOS",349,341,5,3,0,8,0.977077363896848
"300841106","ENTRE RIOS",320,164,45,94,8,147,0.5125
"300841107","ENTRE RIOS",376,253,48,72,1,121,0.672872340425532
"300841108","ENTRE RIOS",247,204,20,21,0,41,0.825910931174089
"300841109","ENTRE RIOS",71,57,10,4,0,14,0.802816901408451
"300841110","ENTRE RIOS",407,398,5,3,0,8,0.977886977886978
"300841111","ENTRE RIOS",273,72,97,98,1,196,0.263736263736264
"300841112","ENTRE RIOS",249,5,119,125,0,244,0.0200803212851406
"300841113","ENTRE RIOS",183,1,16,157,0,173,0.00546448087431694
"300841114","ENTRE RIOS",314,4,79,223,1,303,0.0127388535031847
"300841201","ENTRE RIOS",79,11,24,44,0,68,0.139240506329114
"300841202","ENTRE RIOS",185,138,37,9,0,46,0.745945945945946
"300841203","ENTRE RIOS",50,3,3,44,0,47,0.06
"300841204","ENTRE RIOS",53,0,39,14,0,53,0
"300841209","ENTRE RIOS",56,0,23,31,1,55,0
"221401314","CHACO",204,13,109,77,4,190,0.0637254901960784
"300841205","ENTRE RIOS",239,136,63,35,0,98,0.569037656903766
"300841206","ENTRE RIOS",71,2,53,15,0,68,0.028169014084507
"300841207","ENTRE RIOS",290,284,4,2,0,6,0.979310344827586
"300841210","ENTRE RIOS",137,19,62,56,0,118,0.138686131386861
"300841414","ENTRE RIOS",344,45,151,147,0,298,0.130813953488372
"300841507","ENTRE RIOS",355,339,5,11,0,16,0.954929577464789
"300841208","ENTRE RIOS",56,0,13,42,1,56,0
"300841211","ENTRE RIOS",168,28,28,109,0,137,0.166666666666667
"300841212","ENTRE RIOS",7,0,0,6,0,6,0
"300841403","ENTRE RIOS",298,216,52,29,0,81,0.724832214765101
"300841404","ENTRE RIOS",341,22,68,244,1,313,0.0645161290322581
"221401315","CHACO",61,54,7,0,0,7,0.885245901639344
"300841301","ENTRE RIOS",295,8,127,155,0,282,0.0271186440677966
"300841302","ENTRE RIOS",190,3,26,148,0,174,0.0157894736842105
"300841405","ENTRE RIOS",306,52,44,198,1,243,0.169934640522876
"300841406","ENTRE RIOS",402,272,55,73,0,128,0.676616915422886
"300841407","ENTRE RIOS",382,310,40,31,0,71,0.81151832460733
"300841303","ENTRE RIOS",46,1,10,32,0,42,0.0217391304347826
"300841408","ENTRE RIOS",237,150,35,49,2,86,0.632911392405063
"300841409","ENTRE RIOS",305,249,34,21,0,55,0.816393442622951
"300841410","ENTRE RIOS",273,176,13,84,0,97,0.644688644688645
"300841411","ENTRE RIOS",302,58,96,146,0,242,0.19205298013245
"300841412","ENTRE RIOS",349,8,187,151,0,338,0.0229226361031519
"300841304","ENTRE RIOS",188,4,50,134,0,184,0.0212765957446809
"300841305","ENTRE RIOS",42,34,5,3,0,8,0.80952380952381
"300841306","ENTRE RIOS",161,7,19,132,1,152,0.0434782608695652
"300841307","ENTRE RIOS",184,3,11,150,1,162,0.016304347826087
"300841401","ENTRE RIOS",290,236,20,33,0,53,0.813793103448276
"300841402","ENTRE RIOS",369,313,38,18,0,56,0.848238482384824
"300841413","ENTRE RIOS",159,1,74,81,0,155,0.00628930817610063
"300841415","ENTRE RIOS",124,0,47,77,0,124,0
"300841416","ENTRE RIOS",295,3,92,198,0,290,0.0101694915254237
"300841417","ENTRE RIOS",342,23,84,213,4,301,0.0672514619883041
"300841501","ENTRE RIOS",276,251,14,6,0,20,0.909420289855073
"300841502","ENTRE RIOS",139,119,2,14,3,19,0.856115107913669
"300841503","ENTRE RIOS",404,384,6,11,0,17,0.95049504950495
"300841504","ENTRE RIOS",281,269,7,5,0,12,0.95729537366548
"300841505","ENTRE RIOS",144,135,4,5,0,9,0.9375
"300841509","ENTRE RIOS",196,153,18,22,0,40,0.780612244897959
"300841510","ENTRE RIOS",277,248,14,15,0,29,0.895306859205776
"300841511","ENTRE RIOS",161,158,0,3,0,3,0.981366459627329
"300841512","ENTRE RIOS",334,323,1,10,0,11,0.967065868263473
"300841513","ENTRE RIOS",4,0,1,3,0,4,0
"300841601","ENTRE RIOS",311,155,19,130,0,149,0.498392282958199
"500980816","MENDOZA",167,163,2,0,0,2,0.976047904191617
"300842615","ENTRE RIOS",108,1,17,89,0,106,0.00925925925925926
"140910608","CORDOBA",296,2,256,28,4,288,0.00675675675675676
"300841602","ENTRE RIOS",242,217,14,9,1,24,0.896694214876033
"300841603","ENTRE RIOS",293,272,10,11,0,21,0.928327645051195
"300841604","ENTRE RIOS",225,222,3,0,0,3,0.986666666666667
"300841605","ENTRE RIOS",200,194,4,1,0,5,0.97
"300841606","ENTRE RIOS",298,282,5,10,0,15,0.946308724832215
"300841607","ENTRE RIOS",336,329,4,2,0,6,0.979166666666667
"300841608","ENTRE RIOS",350,324,14,8,0,22,0.925714285714286
"300841609","ENTRE RIOS",266,243,15,7,0,22,0.913533834586466
"300841610","ENTRE RIOS",284,115,76,90,0,166,0.404929577464789
"300841611","ENTRE RIOS",319,208,64,47,0,111,0.652037617554859
"300841701","ENTRE RIOS",122,35,7,47,2,56,0.286885245901639
"300841702","ENTRE RIOS",286,274,3,5,0,8,0.958041958041958
"300841703","ENTRE RIOS",276,256,8,8,0,16,0.927536231884058
"300841704","ENTRE RIOS",273,244,16,10,0,26,0.893772893772894
"300841705","ENTRE RIOS",246,232,4,10,0,14,0.943089430894309
"300841706","ENTRE RIOS",168,155,6,6,0,12,0.922619047619048
"300841707","ENTRE RIOS",387,367,9,7,0,16,0.948320413436692
"300841708","ENTRE RIOS",283,228,13,28,1,42,0.80565371024735
"300841709","ENTRE RIOS",281,275,3,1,0,4,0.97864768683274
"300841710","ENTRE RIOS",327,323,2,0,0,2,0.987767584097859
"300841910","ENTRE RIOS",152,2,42,104,0,146,0.0131578947368421
"300841711","ENTRE RIOS",260,219,6,34,0,40,0.842307692307692
"300841712","ENTRE RIOS",223,213,6,4,0,10,0.955156950672646
"300841713","ENTRE RIOS",315,271,19,24,0,43,0.86031746031746
"300841714","ENTRE RIOS",404,211,23,150,0,173,0.522277227722772
"300841715","ENTRE RIOS",265,203,8,46,0,54,0.766037735849057
"300841716","ENTRE RIOS",210,129,15,54,0,69,0.614285714285714
"300841717","ENTRE RIOS",204,155,11,21,0,32,0.759803921568627
"300841718","ENTRE RIOS",195,185,2,2,0,4,0.948717948717949
"300841719","ENTRE RIOS",355,307,5,25,0,30,0.864788732394366
"300841906","ENTRE RIOS",136,0,65,70,0,135,0
"300841909","ENTRE RIOS",109,2,46,61,0,107,0.018348623853211
"300842616","ENTRE RIOS",105,1,43,54,0,97,0.00952380952380952
"140070702","CORDOBA",26,0,11,10,3,24,0
"300841907","ENTRE RIOS",81,0,19,59,0,78,0
"300841912","ENTRE RIOS",49,1,31,17,0,48,0.0204081632653061
"300841803","ENTRE RIOS",128,0,32,89,4,125,0
"300841804","ENTRE RIOS",97,1,23,61,4,88,0.0103092783505155
"300841908","ENTRE RIOS",17,0,7,9,0,16,0
"300844108","ENTRE RIOS",325,296,4,8,0,12,0.910769230769231
"140070604","CORDOBA",20,0,5,14,1,20,0
"300841801","ENTRE RIOS",29,1,7,15,0,22,0.0344827586206897
"300841802","ENTRE RIOS",276,7,39,198,15,252,0.0253623188405797
"300844109","ENTRE RIOS",206,162,15,27,0,42,0.786407766990291
"300841911","ENTRE RIOS",132,3,57,71,0,128,0.0227272727272727
"300841901","ENTRE RIOS",26,0,15,9,2,26,0
"300841902","ENTRE RIOS",10,0,5,5,0,10,0
"300841903","ENTRE RIOS",4,1,2,1,0,3,0.25
"300842202","ENTRE RIOS",130,0,46,78,3,127,0
"300841904","ENTRE RIOS",4,1,0,3,0,3,0.25
"300841905","ENTRE RIOS",155,0,37,116,0,153,0
"500980815","MENDOZA",209,183,6,1,0,7,0.875598086124402
"300842001","ENTRE RIOS",10,0,3,7,0,10,0
"300842002","ENTRE RIOS",72,0,36,36,0,72,0
"300842003","ENTRE RIOS",57,1,48,8,0,56,0.0175438596491228
"300910105","ENTRE RIOS",198,195,0,1,0,1,0.984848484848485
"300842004","ENTRE RIOS",46,29,6,11,0,17,0.630434782608696
"300842005","ENTRE RIOS",24,0,2,21,0,23,0
"300842103","ENTRE RIOS",159,0,88,69,0,157,0
"300842006","ENTRE RIOS",24,0,12,12,0,24,0
"300842007","ENTRE RIOS",26,0,12,14,0,26,0
"300842107","ENTRE RIOS",243,3,135,103,2,240,0.0123456790123457
"300842108","ENTRE RIOS",252,2,109,141,0,250,0.00793650793650794
"300842201","ENTRE RIOS",157,0,36,120,1,157,0
"221680207","CHACO",64,1,6,42,11,59,0.015625
"300842101","ENTRE RIOS",318,1,127,185,1,313,0.00314465408805031
"300842102","ENTRE RIOS",119,1,28,89,0,117,0.00840336134453781
"300842104","ENTRE RIOS",155,3,39,111,0,150,0.0193548387096774
"300842105","ENTRE RIOS",112,0,48,61,2,111,0
"300842106","ENTRE RIOS",463,2,94,361,0,455,0.00431965442764579
"140070603","CORDOBA",47,0,22,8,10,40,0
"140070403","CORDOBA",24,0,21,2,1,24,0
"300842203","ENTRE RIOS",55,1,33,21,0,54,0.0181818181818182
"300842204","ENTRE RIOS",94,0,30,63,1,94,0
"300842205","ENTRE RIOS",73,1,7,65,0,72,0.0136986301369863
"300842206","ENTRE RIOS",219,57,111,51,0,162,0.26027397260274
"300842207","ENTRE RIOS",38,0,4,31,1,36,0
"300842707","ENTRE RIOS",323,315,4,2,0,6,0.975232198142415
"300842308","ENTRE RIOS",319,311,6,1,0,7,0.974921630094044
"300842208","ENTRE RIOS",20,0,8,12,0,20,0
"300842706","ENTRE RIOS",112,79,3,27,0,30,0.705357142857143
"300842303","ENTRE RIOS",5,0,1,4,0,5,0
"300842309","ENTRE RIOS",307,301,2,4,0,6,0.980456026058632
"300842405","ENTRE RIOS",52,0,26,25,0,51,0
"300842503","ENTRE RIOS",39,0,5,31,1,37,0
"300842301","ENTRE RIOS",7,1,0,6,0,6,0.142857142857143
"300842302","ENTRE RIOS",67,27,8,31,1,40,0.402985074626866
"300842404","ENTRE RIOS",36,0,10,25,0,35,0
"300842304","ENTRE RIOS",38,3,8,27,0,35,0.0789473684210526
"300842305","ENTRE RIOS",212,152,26,34,0,60,0.716981132075472
"300842306","ENTRE RIOS",247,237,4,5,1,10,0.959514170040486
"300842307","ENTRE RIOS",156,151,1,3,0,4,0.967948717948718
"300842310","ENTRE RIOS",259,252,5,2,0,7,0.972972972972973
"300842311","ENTRE RIOS",54,1,36,16,0,52,0.0185185185185185
"300842708","ENTRE RIOS",230,223,1,3,0,4,0.969565217391304
"300842401","ENTRE RIOS",49,19,18,12,0,30,0.387755102040816
"300842402","ENTRE RIOS",24,0,9,15,0,24,0
"300842403","ENTRE RIOS",68,35,11,20,0,31,0.514705882352941
"300880105","ENTRE RIOS",230,229,0,1,0,1,0.995652173913044
"300842406","ENTRE RIOS",31,0,11,19,1,31,0
"300842407","ENTRE RIOS",76,0,33,43,0,76,0
"300842408","ENTRE RIOS",16,0,4,9,2,15,0
"300842409","ENTRE RIOS",243,3,120,118,1,239,0.0123456790123457
"300910116","ENTRE RIOS",332,297,10,21,0,31,0.894578313253012
"300842501","ENTRE RIOS",6,0,1,5,0,6,0
"300842502","ENTRE RIOS",7,0,1,6,0,7,0
"300880106","ENTRE RIOS",275,257,11,5,0,16,0.934545454545455
"300842504","ENTRE RIOS",37,0,7,24,3,34,0
"300842505","ENTRE RIOS",32,0,4,22,0,26,0
"300842506","ENTRE RIOS",211,210,0,0,0,0,0.995260663507109
"300843005","ENTRE RIOS",79,77,0,1,0,1,0.974683544303797
"300842507","ENTRE RIOS",248,176,8,54,0,62,0.709677419354839
"300842508","ENTRE RIOS",333,256,8,66,0,74,0.768768768768769
"300880107","ENTRE RIOS",232,215,4,9,0,13,0.926724137931034
"140070402","CORDOBA",7,0,2,0,4,6,0
"140070401","CORDOBA",21,0,15,3,1,19,0
"300842509","ENTRE RIOS",274,216,3,48,2,53,0.788321167883212
"300842510","ENTRE RIOS",219,210,2,6,1,9,0.958904109589041
"300843006","ENTRE RIOS",222,219,1,1,0,2,0.986486486486487
"300843007","ENTRE RIOS",199,196,2,1,0,3,0.984924623115578
"300842511","ENTRE RIOS",233,230,1,2,0,3,0.987124463519313
"300842512","ENTRE RIOS",83,64,3,16,0,19,0.771084337349398
"300842601","ENTRE RIOS",7,0,1,3,0,4,0
"141190212","CORDOBA",148,1,106,32,2,140,0.00675675675675676
"300842602","ENTRE RIOS",6,0,1,5,0,6,0
"300842603","ENTRE RIOS",6,0,2,3,0,5,0
"300842604","ENTRE RIOS",11,0,2,4,3,9,0
"300843008","ENTRE RIOS",146,143,2,1,0,3,0.979452054794521
"300842605","ENTRE RIOS",14,0,2,12,0,14,0
"300842606","ENTRE RIOS",11,0,0,11,0,11,0
"300842613","ENTRE RIOS",34,0,15,18,0,33,0
"300842614","ENTRE RIOS",9,0,9,0,0,9,0
"300842607","ENTRE RIOS",27,1,1,23,0,24,0.037037037037037
"300842608","ENTRE RIOS",14,0,3,10,0,13,0
"300842801","ENTRE RIOS",96,21,16,55,0,71,0.21875
"300843009","ENTRE RIOS",141,140,0,0,0,0,0.99290780141844
"300842612","ENTRE RIOS",20,0,11,8,1,20,0
"140070305","CORDOBA",86,0,55,9,6,70,0
"300842609","ENTRE RIOS",53,1,9,39,1,49,0.0188679245283019
"300842610","ENTRE RIOS",31,0,10,19,0,29,0
"300842611","ENTRE RIOS",18,0,18,0,0,18,0
"300843010","ENTRE RIOS",123,122,0,0,1,1,0.991869918699187
"300842701","ENTRE RIOS",19,2,9,8,0,17,0.105263157894737
"300842702","ENTRE RIOS",22,1,9,10,1,20,0.0454545454545455
"300842703","ENTRE RIOS",204,204,0,0,0,0,1
"300842704","ENTRE RIOS",284,277,2,4,0,6,0.975352112676056
"300842705","ENTRE RIOS",275,271,3,1,0,4,0.985454545454545
"300842802","ENTRE RIOS",9,0,3,5,0,8,0
"300842803","ENTRE RIOS",24,0,11,11,1,23,0
"300842804","ENTRE RIOS",6,0,0,6,0,6,0
"300842805","ENTRE RIOS",17,0,7,10,0,17,0
"300842806","ENTRE RIOS",22,0,12,7,3,22,0
"300842807","ENTRE RIOS",10,0,5,4,0,9,0
"300843011","ENTRE RIOS",150,150,0,0,0,0,1
"300842808","ENTRE RIOS",21,0,8,11,1,20,0
"300842809","ENTRE RIOS",25,0,9,16,0,25,0
"300842907","ENTRE RIOS",5,0,4,1,0,5,0
"221680301","CHACO",60,0,4,32,16,52,0
"300842810","ENTRE RIOS",18,0,4,7,1,12,0
"300843003","ENTRE RIOS",23,0,8,14,0,22,0
"300842811","ENTRE RIOS",14,0,1,11,0,12,0
"300842908","ENTRE RIOS",2,0,0,2,0,2,0
"300910106","ENTRE RIOS",188,186,2,0,0,2,0.98936170212766
"300842812","ENTRE RIOS",24,0,9,14,1,24,0
"300842813","ENTRE RIOS",19,0,10,7,2,19,0
"300842901","ENTRE RIOS",6,0,5,1,0,6,0
"300842902","ENTRE RIOS",9,0,0,9,0,9,0
"300843004","ENTRE RIOS",9,0,4,5,0,9,0
"300842903","ENTRE RIOS",12,0,4,6,0,10,0
"300842904","ENTRE RIOS",12,0,6,5,0,11,0
"300842905","ENTRE RIOS",7,0,0,6,1,7,0
"300842906","ENTRE RIOS",11,0,2,9,0,11,0
"300842909","ENTRE RIOS",12,0,4,6,0,10,0
"300842910","ENTRE RIOS",216,16,76,114,2,192,0.0740740740740741
"300843001","ENTRE RIOS",24,0,6,16,0,22,0
"300843002","ENTRE RIOS",53,30,7,14,0,21,0.566037735849057
"300843012","ENTRE RIOS",273,272,0,1,0,1,0.996336996336996
"300843013","ENTRE RIOS",225,223,1,1,0,2,0.991111111111111
"300843014","ENTRE RIOS",57,40,1,16,0,17,0.701754385964912
"300843101","ENTRE RIOS",21,1,13,7,0,20,0.0476190476190476
"300843102","ENTRE RIOS",36,0,2,34,0,36,0
"300843107","ENTRE RIOS",56,0,20,30,3,53,0
"300910117","ENTRE RIOS",208,159,23,24,0,47,0.764423076923077
"300843103","ENTRE RIOS",12,0,0,8,0,8,0
"300843104","ENTRE RIOS",5,0,0,5,0,5,0
"300843113","ENTRE RIOS",28,0,0,28,0,28,0
"300843105","ENTRE RIOS",17,0,4,11,1,16,0
"300843106","ENTRE RIOS",13,0,4,8,0,12,0
"300844311","ENTRE RIOS",193,175,6,11,1,18,0.906735751295337
"300844312","ENTRE RIOS",205,200,2,1,1,4,0.975609756097561
"300843108","ENTRE RIOS",14,0,2,12,0,14,0
"300910401","ENTRE RIOS",1,0,1,0,0,1,0
"300843109","ENTRE RIOS",30,0,6,22,2,30,0
"300843110","ENTRE RIOS",30,0,5,23,0,28,0
"300843111","ENTRE RIOS",17,0,8,9,0,17,0
"300843112","ENTRE RIOS",35,0,6,29,0,35,0
"300843305","ENTRE RIOS",89,9,16,58,1,75,0.101123595505618
"221680302","CHACO",93,0,2,56,20,78,0
"300843114","ENTRE RIOS",17,0,1,10,0,11,0
"300843115","ENTRE RIOS",99,0,19,76,3,98,0
"300843116","ENTRE RIOS",108,0,65,43,0,108,0
"300843201","ENTRE RIOS",22,0,3,17,1,21,0
"300843202","ENTRE RIOS",63,0,35,27,0,62,0
"300843212","ENTRE RIOS",98,1,63,34,0,97,0.0102040816326531
"300844313","ENTRE RIOS",199,197,1,0,0,1,0.989949748743719
"300843203","ENTRE RIOS",43,0,4,37,1,42,0
"300843504","ENTRE RIOS",8,0,3,5,0,8,0
"300843204","ENTRE RIOS",46,0,18,25,1,44,0
"300843205","ENTRE RIOS",109,2,43,59,2,104,0.018348623853211
"300843206","ENTRE RIOS",92,0,44,41,0,85,0
"300843207","ENTRE RIOS",70,0,20,46,2,68,0
"300843213","ENTRE RIOS",82,0,59,23,0,82,0
"300844401","ENTRE RIOS",293,288,1,2,0,3,0.982935153583618
"300843301","ENTRE RIOS",10,1,2,7,0,9,0.1
"300843505","ENTRE RIOS",16,0,7,8,1,16,0
"300843208","ENTRE RIOS",36,0,20,15,0,35,0
"300843209","ENTRE RIOS",159,2,109,46,1,156,0.0125786163522013
"300843210","ENTRE RIOS",31,0,10,21,0,31,0
"300843211","ENTRE RIOS",43,0,27,13,0,40,0
"300843304","ENTRE RIOS",7,0,3,4,0,7,0
"300843506","ENTRE RIOS",133,50,30,51,1,82,0.37593984962406
"300843302","ENTRE RIOS",27,2,4,21,0,25,0.0740740740740741
"300843303","ENTRE RIOS",16,0,9,6,1,16,0
"300844402","ENTRE RIOS",88,74,4,10,0,14,0.840909090909091
"300843401","ENTRE RIOS",4,0,0,4,0,4,0
"300843507","ENTRE RIOS",118,9,55,53,1,109,0.076271186440678
"300843508","ENTRE RIOS",139,35,53,51,0,104,0.251798561151079
"300843306","ENTRE RIOS",308,300,1,5,0,6,0.974025974025974
"300843307","ENTRE RIOS",346,308,5,15,0,20,0.890173410404624
"300843402","ENTRE RIOS",16,0,12,4,0,16,0
"300844403","ENTRE RIOS",368,366,1,0,0,1,0.994565217391304
"300843308","ENTRE RIOS",383,381,1,1,0,2,0.994778067885117
"300843309","ENTRE RIOS",217,114,37,54,1,92,0.525345622119816
"300843310","ENTRE RIOS",103,93,4,6,0,10,0.902912621359223
"300843311","ENTRE RIOS",126,118,0,2,0,2,0.936507936507937
"300843312","ENTRE RIOS",220,219,1,0,0,1,0.995454545454545
"300843313","ENTRE RIOS",219,213,0,4,1,5,0.972602739726027
"300843314","ENTRE RIOS",318,313,1,4,0,5,0.984276729559748
"300843706","ENTRE RIOS",235,229,3,1,0,4,0.974468085106383
"300843403","ENTRE RIOS",8,0,3,4,0,7,0
"300843404","ENTRE RIOS",12,0,3,7,0,10,0
"300843405","ENTRE RIOS",11,0,4,6,0,10,0
"300843406","ENTRE RIOS",0,0,0,0,0,0,NA
"300843415","ENTRE RIOS",75,1,33,34,3,70,0.0133333333333333
"300843416","ENTRE RIOS",147,1,45,97,0,142,0.00680272108843537
"820842821","SANTA FE",206,206,0,0,0,0,1
"300843407","ENTRE RIOS",49,0,19,28,1,48,0
"300843408","ENTRE RIOS",49,0,26,20,2,48,0
"300843409","ENTRE RIOS",17,0,3,12,0,15,0
"300843410","ENTRE RIOS",17,0,10,6,0,16,0
"300843501","ENTRE RIOS",12,0,6,6,0,12,0
"300843502","ENTRE RIOS",13,0,5,6,1,12,0
"300843503","ENTRE RIOS",19,1,6,10,1,17,0.0526315789473684
"300843411","ENTRE RIOS",14,0,1,12,1,14,0
"300843412","ENTRE RIOS",48,1,9,34,4,47,0.0208333333333333
"300843413","ENTRE RIOS",22,0,10,12,0,22,0
"300843414","ENTRE RIOS",32,0,0,30,0,30,0
"300910107","ENTRE RIOS",181,146,4,29,0,33,0.806629834254144
"300843601","ENTRE RIOS",17,0,4,13,0,17,0
"300843602","ENTRE RIOS",20,0,11,8,0,19,0
"300843603","ENTRE RIOS",26,0,4,21,1,26,0
"300843707","ENTRE RIOS",186,184,1,0,0,1,0.989247311827957
"300843708","ENTRE RIOS",134,133,0,1,0,1,0.992537313432836
"300843709","ENTRE RIOS",145,145,0,0,0,0,1
"300843802","ENTRE RIOS",14,0,3,7,0,10,0
"300844404","ENTRE RIOS",359,355,1,2,1,4,0.988857938718663
"300844405","ENTRE RIOS",146,144,2,0,0,2,0.986301369863014
"300843705","ENTRE RIOS",189,184,2,3,0,5,0.973544973544973
"300843801","ENTRE RIOS",4,0,1,3,0,4,0
"300844310","ENTRE RIOS",149,145,2,2,0,4,0.973154362416107
"300843604","ENTRE RIOS",20,0,5,15,0,20,0
"300843701","ENTRE RIOS",192,178,5,9,0,14,0.927083333333333
"300843702","ENTRE RIOS",155,148,3,3,0,6,0.954838709677419
"300843703","ENTRE RIOS",115,99,1,15,0,16,0.860869565217391
"300843704","ENTRE RIOS",370,368,1,0,0,1,0.994594594594595
"300844408","ENTRE RIOS",289,283,2,3,0,5,0.97923875432526
"300843710","ENTRE RIOS",207,201,2,2,0,4,0.971014492753623
"300843711","ENTRE RIOS",257,256,0,0,0,0,0.996108949416342
"300843712","ENTRE RIOS",178,168,3,1,0,4,0.943820224719101
"300843713","ENTRE RIOS",146,144,0,1,0,1,0.986301369863014
"300843714","ENTRE RIOS",265,258,1,2,0,3,0.973584905660377
"300843715","ENTRE RIOS",22,18,1,3,0,4,0.818181818181818
"300844409","ENTRE RIOS",144,124,9,11,0,20,0.861111111111111
"300844410","ENTRE RIOS",275,260,2,8,0,10,0.945454545454545
"140145009","CORDOBA",358,356,2,0,0,2,0.994413407821229
"300843803","ENTRE RIOS",15,0,7,8,0,15,0
"300843804","ENTRE RIOS",18,0,6,12,0,18,0
"300843805","ENTRE RIOS",34,0,16,17,0,33,0
"300844106","ENTRE RIOS",272,263,1,5,0,6,0.966911764705882
"300844107","ENTRE RIOS",2,2,0,0,0,0,1
"300843806","ENTRE RIOS",12,0,2,10,0,12,0
"300843807","ENTRE RIOS",25,0,12,13,0,25,0
"300843808","ENTRE RIOS",26,0,7,19,0,26,0
"300843809","ENTRE RIOS",16,0,14,2,0,16,0
"300843903","ENTRE RIOS",51,0,26,25,0,51,0
"300844005","ENTRE RIOS",24,0,11,13,0,24,0
"300843901","ENTRE RIOS",41,0,18,22,1,41,0
"300843902","ENTRE RIOS",26,0,8,17,0,25,0
"300844006","ENTRE RIOS",13,0,2,11,0,13,0
"300844411","ENTRE RIOS",215,202,3,8,0,11,0.93953488372093
"300843904","ENTRE RIOS",38,0,20,17,0,37,0
"300843905","ENTRE RIOS",9,0,7,2,0,9,0
"300843906","ENTRE RIOS",7,0,4,3,0,7,0
"300843907","ENTRE RIOS",14,0,7,7,0,14,0
"300843908","ENTRE RIOS",30,0,15,14,0,29,0
"300843909","ENTRE RIOS",26,0,9,17,0,26,0
"500280508","MENDOZA",492,226,104,114,4,222,0.459349593495935
"300844001","ENTRE RIOS",48,0,16,30,0,46,0
"300844002","ENTRE RIOS",22,0,11,9,1,21,0
"300844003","ENTRE RIOS",24,0,3,21,0,24,0
"300844004","ENTRE RIOS",63,0,51,10,1,62,0
"300844007","ENTRE RIOS",27,0,7,20,0,27,0
"300844008","ENTRE RIOS",42,0,25,16,1,42,0
"300844009","ENTRE RIOS",41,0,7,33,0,40,0
"300844101","ENTRE RIOS",7,0,0,7,0,7,0
"300844102","ENTRE RIOS",15,0,4,10,0,14,0
"300844103","ENTRE RIOS",19,0,3,15,1,19,0
"300844104","ENTRE RIOS",19,0,6,13,0,19,0
"300844105","ENTRE RIOS",293,275,11,7,0,18,0.938566552901024
"300844201","ENTRE RIOS",8,0,5,3,0,8,0
"300844202","ENTRE RIOS",47,0,8,39,0,47,0
"300844203","ENTRE RIOS",18,0,11,6,0,17,0
"300844204","ENTRE RIOS",50,0,36,13,0,49,0
"300844205","ENTRE RIOS",14,0,6,8,0,14,0
"300844206","ENTRE RIOS",10,0,1,9,0,10,0
"300844207","ENTRE RIOS",22,0,8,14,0,22,0
"300844406","ENTRE RIOS",196,191,5,0,0,5,0.974489795918367
"300844407","ENTRE RIOS",296,290,1,1,0,2,0.97972972972973
"140144910","CORDOBA",148,148,0,0,0,0,1
"300844208","ENTRE RIOS",20,0,7,13,0,20,0
"300844209","ENTRE RIOS",41,1,15,22,2,39,0.024390243902439
"300844301","ENTRE RIOS",343,325,9,5,0,14,0.947521865889213
"300844302","ENTRE RIOS",192,191,0,1,0,1,0.994791666666667
"300844303","ENTRE RIOS",252,243,7,1,0,8,0.964285714285714
"300844304","ENTRE RIOS",205,205,0,0,0,0,1
"300844305","ENTRE RIOS",260,258,1,1,0,2,0.992307692307692
"300844306","ENTRE RIOS",273,271,1,1,0,2,0.992673992673993
"300844307","ENTRE RIOS",279,277,1,1,0,2,0.992831541218638
"300844308","ENTRE RIOS",207,205,2,0,0,2,0.990338164251208
"300844309","ENTRE RIOS",368,352,6,7,0,13,0.956521739130435
"300880104","ENTRE RIOS",246,240,0,6,0,6,0.975609756097561
"300844501","ENTRE RIOS",35,0,4,31,0,35,0
"300844502","ENTRE RIOS",30,4,21,5,0,26,0.133333333333333
"300844503","ENTRE RIOS",40,25,5,9,0,14,0.625
"300844504","ENTRE RIOS",51,3,19,28,0,47,0.0588235294117647
"300844505","ENTRE RIOS",50,1,2,46,0,48,0.02
"300844506","ENTRE RIOS",36,0,15,21,0,36,0
"300844507","ENTRE RIOS",142,137,3,1,0,4,0.964788732394366
"300880101","ENTRE RIOS",279,276,0,0,0,0,0.989247311827957
"300880102","ENTRE RIOS",271,267,4,0,0,4,0.985239852398524
"300880103","ENTRE RIOS",364,335,6,18,0,24,0.92032967032967
"300880201","ENTRE RIOS",53,6,8,28,5,41,0.113207547169811
"300880306","ENTRE RIOS",236,230,2,3,0,5,0.974576271186441
"300880202","ENTRE RIOS",38,2,13,21,0,34,0.0526315789473684
"300880203","ENTRE RIOS",52,4,6,41,0,47,0.0769230769230769
"300880204","ENTRE RIOS",263,221,12,25,0,37,0.840304182509506
"140145906","CORDOBA",232,223,1,0,0,1,0.961206896551724
"300880205","ENTRE RIOS",386,273,19,76,2,97,0.707253886010363
"300880206","ENTRE RIOS",341,326,5,0,0,5,0.956011730205279
"300880207","ENTRE RIOS",318,318,0,0,0,0,1
"300880208","ENTRE RIOS",315,208,45,41,0,86,0.66031746031746
"300880209","ENTRE RIOS",196,61,56,74,0,130,0.311224489795918
"300880307","ENTRE RIOS",162,155,2,3,0,5,0.95679012345679
"300880308","ENTRE RIOS",161,150,4,5,0,9,0.93167701863354
"300910508","ENTRE RIOS",232,100,26,98,3,127,0.431034482758621
"300880210","ENTRE RIOS",108,14,27,60,3,90,0.12962962962963
"300880402","ENTRE RIOS",23,0,9,10,4,23,0
"300880301","ENTRE RIOS",131,85,23,22,0,45,0.648854961832061
"300880302","ENTRE RIOS",12,0,2,9,0,11,0
"300880303","ENTRE RIOS",6,1,3,0,2,5,0.166666666666667
"300880304","ENTRE RIOS",101,100,0,0,0,0,0.99009900990099
"300880305","ENTRE RIOS",157,148,1,5,0,6,0.942675159235669
"300880401","ENTRE RIOS",5,0,3,2,0,5,0
"300910102","ENTRE RIOS",314,135,35,138,2,175,0.429936305732484
"140145905","CORDOBA",247,236,7,3,0,10,0.955465587044534
"300880403","ENTRE RIOS",9,0,4,5,0,9,0
"300880404","ENTRE RIOS",17,0,12,4,0,16,0
"300880405","ENTRE RIOS",33,0,15,9,6,30,0
"300880706","ENTRE RIOS",21,0,16,4,1,21,0
"300880501","ENTRE RIOS",20,0,17,3,0,20,0
"300880502","ENTRE RIOS",5,0,5,0,0,5,0
"300880503","ENTRE RIOS",14,1,12,1,0,13,0.0714285714285714
"300880504","ENTRE RIOS",23,0,15,3,0,18,0
"300880707","ENTRE RIOS",30,1,21,6,2,29,0.0333333333333333
"700560202","SAN JUAN",262,0,132,119,7,258,0
"300880605","ENTRE RIOS",1,0,0,1,0,1,0
"300910103","ENTRE RIOS",385,336,8,40,0,48,0.872727272727273
"300880601","ENTRE RIOS",2,0,2,0,0,2,0
"300880602","ENTRE RIOS",11,1,4,5,0,9,0.0909090909090909
"300880603","ENTRE RIOS",7,0,4,2,0,6,0
"300880604","ENTRE RIOS",11,0,1,10,0,11,0
"300880606","ENTRE RIOS",8,0,0,7,0,7,0
"300880701","ENTRE RIOS",33,0,30,3,0,33,0
"300880702","ENTRE RIOS",17,0,13,3,0,16,0
"300880703","ENTRE RIOS",7,0,4,3,0,7,0
"300880704","ENTRE RIOS",23,0,15,3,4,22,0
"300880705","ENTRE RIOS",4,0,3,1,0,4,0
"300910101","ENTRE RIOS",277,2,36,209,2,247,0.0072202166064982
"300910104","ENTRE RIOS",261,257,0,3,0,3,0.984674329501916
"300910108","ENTRE RIOS",258,10,77,166,0,243,0.0387596899224806
"300910109","ENTRE RIOS",288,173,60,55,0,115,0.600694444444444
"300910110","ENTRE RIOS",183,53,40,89,0,129,0.289617486338798
"300910111","ENTRE RIOS",196,196,0,0,0,0,1
"300910112","ENTRE RIOS",170,147,13,10,0,23,0.864705882352941
"300910113","ENTRE RIOS",212,113,38,58,0,96,0.533018867924528
"300910114","ENTRE RIOS",56,3,20,31,0,51,0.0535714285714286
"300910115","ENTRE RIOS",175,84,24,61,0,85,0.48
"300910118","ENTRE RIOS",239,40,57,139,0,196,0.167364016736402
"300910201","ENTRE RIOS",9,0,0,9,0,9,0
"300910202","ENTRE RIOS",10,0,5,5,0,10,0
"300910203","ENTRE RIOS",56,27,3,26,0,29,0.482142857142857
"300910204","ENTRE RIOS",28,0,1,23,1,25,0
"300910205","ENTRE RIOS",46,0,16,28,1,45,0
"300910206","ENTRE RIOS",6,0,6,0,0,6,0
"300910207","ENTRE RIOS",52,7,10,31,1,42,0.134615384615385
"300910208","ENTRE RIOS",103,42,28,32,0,60,0.407766990291262
"300910209","ENTRE RIOS",20,0,2,17,0,19,0
"300980104","ENTRE RIOS",267,166,62,39,0,101,0.621722846441948
"300910301","ENTRE RIOS",15,0,4,11,0,15,0
"300910302","ENTRE RIOS",95,0,60,26,2,88,0
"300910507","ENTRE RIOS",260,244,11,4,0,15,0.938461538461538
"300910303","ENTRE RIOS",20,0,6,11,2,19,0
"300910304","ENTRE RIOS",60,0,32,25,2,59,0
"301130205","ENTRE RIOS",264,258,4,2,0,6,0.977272727272727
"300910306","ENTRE RIOS",39,0,16,19,0,35,0
"300980106","ENTRE RIOS",370,270,40,47,0,87,0.72972972972973
"300910305","ENTRE RIOS",28,0,9,16,3,28,0
"300910806","ENTRE RIOS",8,0,2,5,1,8,0
"300980105","ENTRE RIOS",268,244,9,13,0,22,0.91044776119403
"300910307","ENTRE RIOS",50,0,19,30,0,49,0
"300910308","ENTRE RIOS",9,0,4,5,0,9,0
"300910509","ENTRE RIOS",58,11,14,33,0,47,0.189655172413793
"300910309","ENTRE RIOS",24,0,9,15,0,24,0
"300910402","ENTRE RIOS",17,0,5,11,0,16,0
"300910403","ENTRE RIOS",37,0,21,14,2,37,0
"300911106","ENTRE RIOS",23,0,15,8,0,23,0
"301130206","ENTRE RIOS",127,127,0,0,0,0,1
"300910510","ENTRE RIOS",25,5,13,7,0,20,0.2
"300910511","ENTRE RIOS",11,0,4,7,0,11,0
"300910404","ENTRE RIOS",40,0,19,16,0,35,0
"300910405","ENTRE RIOS",19,0,9,9,0,18,0
"300980101","ENTRE RIOS",363,317,18,16,0,34,0.873278236914601
"300910406","ENTRE RIOS",11,0,7,3,0,10,0
"300910407","ENTRE RIOS",13,0,0,8,1,9,0
"300910501","ENTRE RIOS",219,104,21,91,0,112,0.474885844748858
"300910502","ENTRE RIOS",258,252,4,1,0,5,0.976744186046512
"300910503","ENTRE RIOS",236,228,2,2,0,4,0.966101694915254
"300910504","ENTRE RIOS",229,202,8,19,0,27,0.882096069868996
"300910505","ENTRE RIOS",138,138,0,0,0,0,1
"300910506","ENTRE RIOS",311,277,15,16,1,32,0.890675241157556
"300980317","ENTRE RIOS",151,149,2,0,0,2,0.986754966887417
"300910512","ENTRE RIOS",11,0,2,7,0,9,0
"300910601","ENTRE RIOS",18,0,5,7,6,18,0
"300910705","ENTRE RIOS",7,0,1,5,0,6,0
"300980207","ENTRE RIOS",206,200,2,3,0,5,0.970873786407767
"300910902","ENTRE RIOS",5,0,4,1,0,5,0
"300910602","ENTRE RIOS",12,0,1,11,0,12,0
"300910603","ENTRE RIOS",6,0,2,4,0,6,0
"300910604","ENTRE RIOS",19,0,4,11,4,19,0
"300910605","ENTRE RIOS",9,1,4,3,0,7,0.111111111111111
"300910804","ENTRE RIOS",5,0,2,2,0,4,0
"300980102","ENTRE RIOS",278,257,11,7,0,18,0.924460431654676
"300980318","ENTRE RIOS",223,221,1,1,0,2,0.991031390134529
"300910606","ENTRE RIOS",158,14,64,70,8,142,0.0886075949367089
"300910701","ENTRE RIOS",14,0,0,12,1,13,0
"300910702","ENTRE RIOS",74,0,42,32,0,74,0
"140144804","CORDOBA",244,233,1,0,0,1,0.954918032786885
"300910703","ENTRE RIOS",18,0,9,9,0,18,0
"300910704","ENTRE RIOS",5,0,3,2,0,5,0
"300910805","ENTRE RIOS",10,0,3,7,0,10,0
"300910706","ENTRE RIOS",6,0,1,4,0,5,0
"300910801","ENTRE RIOS",13,0,0,12,1,13,0
"300910802","ENTRE RIOS",17,0,8,9,0,17,0
"300910803","ENTRE RIOS",11,0,7,4,0,11,0
"300910807","ENTRE RIOS",14,0,0,14,0,14,0
"300910808","ENTRE RIOS",65,0,35,29,0,64,0
"300910901","ENTRE RIOS",14,0,3,9,2,14,0
"300980208","ENTRE RIOS",324,274,12,32,3,47,0.845679012345679
"300910903","ENTRE RIOS",35,0,16,18,1,35,0
"300910904","ENTRE RIOS",10,0,3,5,2,10,0
"301130207","ENTRE RIOS",131,130,1,0,0,1,0.99236641221374
"300980209","ENTRE RIOS",318,262,9,31,0,40,0.823899371069182
"300980113","ENTRE RIOS",377,370,5,1,0,6,0.981432360742706
"300980114","ENTRE RIOS",212,211,1,0,0,1,0.995283018867924
"300910905","ENTRE RIOS",23,0,4,13,3,20,0
"300910906","ENTRE RIOS",4,0,1,3,0,4,0
"300911001","ENTRE RIOS",137,101,20,16,0,36,0.737226277372263
"300911002","ENTRE RIOS",189,157,7,24,0,31,0.830687830687831
"300911003","ENTRE RIOS",171,134,16,18,0,34,0.783625730994152
"300911004","ENTRE RIOS",205,190,9,6,0,15,0.926829268292683
"740351611","SAN LUIS",248,229,5,13,0,18,0.923387096774194
"300911005","ENTRE RIOS",89,1,45,38,4,87,0.0112359550561798
"300911101","ENTRE RIOS",9,0,2,7,0,9,0
"300911102","ENTRE RIOS",16,0,5,10,1,16,0
"300911103","ENTRE RIOS",13,0,1,9,1,11,0
"141821103","CORDOBA",159,158,1,0,0,1,0.993710691823899
"300911104","ENTRE RIOS",7,0,4,3,0,7,0
"300911105","ENTRE RIOS",50,0,25,13,3,41,0
"300980103","ENTRE RIOS",233,47,63,115,7,185,0.201716738197425
"300980107","ENTRE RIOS",221,184,18,13,0,31,0.832579185520362
"300980108","ENTRE RIOS",262,176,16,63,0,79,0.67175572519084
"300980109","ENTRE RIOS",347,311,11,22,0,33,0.896253602305475
"300980110","ENTRE RIOS",323,284,14,22,2,38,0.879256965944272
"300980111","ENTRE RIOS",298,194,23,66,4,93,0.651006711409396
"300980307","ENTRE RIOS",231,231,0,0,0,0,1
"300980112","ENTRE RIOS",341,320,9,10,0,19,0.93841642228739
"300980115","ENTRE RIOS",264,258,5,0,0,5,0.977272727272727
"300980116","ENTRE RIOS",435,405,16,3,0,19,0.931034482758621
"300980117","ENTRE RIOS",296,290,3,2,0,5,0.97972972972973
"300980118","ENTRE RIOS",248,240,3,3,0,6,0.967741935483871
"300980119","ENTRE RIOS",225,218,2,1,0,3,0.968888888888889
"300980120","ENTRE RIOS",161,154,2,5,0,7,0.956521739130435
"300980201","ENTRE RIOS",304,266,19,17,0,36,0.875
"300980202","ENTRE RIOS",324,287,22,14,0,36,0.885802469135803
"300980203","ENTRE RIOS",300,283,11,6,0,17,0.943333333333333
"300980204","ENTRE RIOS",322,316,3,3,0,6,0.981366459627329
"300980205","ENTRE RIOS",318,317,1,0,0,1,0.99685534591195
"300980206","ENTRE RIOS",142,136,3,2,0,5,0.957746478873239
"300980210","ENTRE RIOS",251,235,5,8,0,13,0.936254980079681
"300980211","ENTRE RIOS",327,204,36,84,0,120,0.623853211009174
"300980212","ENTRE RIOS",333,8,185,135,0,320,0.024024024024024
"300980213","ENTRE RIOS",230,224,1,5,0,6,0.973913043478261
"300980214","ENTRE RIOS",287,262,7,3,0,10,0.912891986062718
"300980215","ENTRE RIOS",234,233,0,1,0,1,0.995726495726496
"300980301","ENTRE RIOS",160,157,0,2,1,3,0.98125
"300980302","ENTRE RIOS",212,207,4,0,0,4,0.976415094339623
"300980303","ENTRE RIOS",349,349,0,0,0,0,1
"300980304","ENTRE RIOS",331,330,1,0,0,1,0.996978851963746
"300980305","ENTRE RIOS",298,296,1,0,0,1,0.993288590604027
"300980306","ENTRE RIOS",206,206,0,0,0,0,1
"300980315","ENTRE RIOS",147,147,0,0,0,0,1
"300980316","ENTRE RIOS",277,273,1,3,0,4,0.985559566787004
"300980401","ENTRE RIOS",182,175,4,3,0,7,0.961538461538462
"300980402","ENTRE RIOS",226,222,1,2,0,3,0.982300884955752
"300980403","ENTRE RIOS",263,254,5,4,0,9,0.965779467680608
"300980404","ENTRE RIOS",178,177,0,0,0,0,0.99438202247191
"300980405","ENTRE RIOS",151,150,1,0,0,1,0.993377483443709
"300980406","ENTRE RIOS",210,209,1,0,0,1,0.995238095238095
"300980407","ENTRE RIOS",146,144,1,1,0,2,0.986301369863014
"300980408","ENTRE RIOS",189,188,0,0,0,0,0.994708994708995
"300980409","ENTRE RIOS",224,217,3,4,0,7,0.96875
"300980410","ENTRE RIOS",293,200,32,52,4,88,0.68259385665529
"300980411","ENTRE RIOS",289,279,3,4,0,7,0.965397923875433
"300980412","ENTRE RIOS",216,213,1,2,0,3,0.986111111111111
"300980413","ENTRE RIOS",303,291,4,6,0,10,0.96039603960396
"300980414","ENTRE RIOS",247,229,3,12,0,15,0.927125506072874
"300980415","ENTRE RIOS",179,179,0,0,0,0,1
"300980416","ENTRE RIOS",225,222,3,0,0,3,0.986666666666667
"300980417","ENTRE RIOS",249,248,1,0,0,1,0.995983935742972
"300980508","ENTRE RIOS",319,306,2,4,0,6,0.959247648902821
"300980418","ENTRE RIOS",268,199,28,36,1,65,0.742537313432836
"300980419","ENTRE RIOS",166,104,19,35,0,54,0.626506024096386
"300980420","ENTRE RIOS",167,144,16,6,0,22,0.862275449101796
"300980421","ENTRE RIOS",181,163,17,1,0,18,0.900552486187845
"300980501","ENTRE RIOS",118,0,54,50,3,107,0
"300980507","ENTRE RIOS",235,11,121,86,3,210,0.0468085106382979
"180210602","CORRIENTES",241,181,29,23,0,52,0.75103734439834
"300980502","ENTRE RIOS",153,12,96,39,3,138,0.0784313725490196
"300980503","ENTRE RIOS",47,4,15,22,0,37,0.0851063829787234
"300980504","ENTRE RIOS",267,218,18,17,2,37,0.816479400749064
"300980505","ENTRE RIOS",26,0,10,12,0,22,0
"300980506","ENTRE RIOS",319,194,29,86,0,115,0.608150470219436
"300980509","ENTRE RIOS",379,287,15,66,0,81,0.757255936675462
"300980510","ENTRE RIOS",249,244,2,3,0,5,0.979919678714859
"300980511","ENTRE RIOS",328,325,1,2,0,3,0.990853658536585
"300980512","ENTRE RIOS",268,263,1,3,0,4,0.98134328358209
"300980513","ENTRE RIOS",223,202,2,15,1,18,0.905829596412556
"300980514","ENTRE RIOS",70,2,44,23,0,67,0.0285714285714286
"300980601","ENTRE RIOS",11,0,8,2,1,11,0
"300980602","ENTRE RIOS",57,0,40,17,0,57,0
"300980707","ENTRE RIOS",285,279,4,2,0,6,0.978947368421053
"300980708","ENTRE RIOS",187,186,1,0,0,1,0.994652406417112
"180210217","CORRIENTES",340,340,0,0,0,0,1
"300980603","ENTRE RIOS",91,0,48,36,1,85,0
"300980604","ENTRE RIOS",82,3,65,14,0,79,0.0365853658536585
"300980605","ENTRE RIOS",229,5,111,111,2,224,0.0218340611353712
"300980606","ENTRE RIOS",365,88,104,152,3,259,0.241095890410959
"300980607","ENTRE RIOS",298,54,89,143,3,235,0.181208053691275
"300980608","ENTRE RIOS",343,335,7,1,0,8,0.97667638483965
"301130208","ENTRE RIOS",217,216,1,0,0,1,0.995391705069124
"300980609","ENTRE RIOS",131,100,20,11,0,31,0.763358778625954
"300980610","ENTRE RIOS",229,151,34,40,1,75,0.65938864628821
"300980611","ENTRE RIOS",343,188,37,103,3,143,0.548104956268222
"300980709","ENTRE RIOS",209,186,17,6,0,23,0.889952153110048
"220360904","CHACO",25,0,7,7,11,25,0
"300980612","ENTRE RIOS",37,0,15,20,0,35,0
"300980613","ENTRE RIOS",33,0,26,7,0,33,0
"300980710","ENTRE RIOS",201,199,0,0,1,1,0.990049751243781
"300980711","ENTRE RIOS",175,174,0,0,0,0,0.994285714285714
"300980712","ENTRE RIOS",151,149,1,0,0,1,0.986754966887417
"300980713","ENTRE RIOS",205,197,4,1,2,7,0.960975609756098
"300980714","ENTRE RIOS",174,119,8,41,0,49,0.683908045977011
"300980614","ENTRE RIOS",68,0,44,16,5,65,0
"300980715","ENTRE RIOS",223,211,2,5,0,7,0.946188340807175
"300980716","ENTRE RIOS",108,90,6,6,0,12,0.833333333333333
"300980801","ENTRE RIOS",13,0,9,4,0,13,0
"300980802","ENTRE RIOS",14,1,8,5,0,13,0.0714285714285714
"301130209","ENTRE RIOS",235,222,11,2,0,13,0.94468085106383
"300980701","ENTRE RIOS",370,367,0,2,0,2,0.991891891891892
"300980702","ENTRE RIOS",90,81,7,2,0,9,0.9
"300980703","ENTRE RIOS",250,247,0,0,0,0,0.988
"300980704","ENTRE RIOS",189,185,0,4,0,4,0.978835978835979
"300980705","ENTRE RIOS",115,109,1,3,0,4,0.947826086956522
"300980706","ENTRE RIOS",172,172,0,0,0,0,1
"300980803","ENTRE RIOS",6,0,0,6,0,6,0
"300980804","ENTRE RIOS",12,1,10,1,0,11,0.0833333333333333
"300980805","ENTRE RIOS",21,1,14,6,0,20,0.0476190476190476
"300980913","ENTRE RIOS",84,10,48,23,0,71,0.119047619047619
"180210418","CORRIENTES",225,25,142,48,2,192,0.111111111111111
"300980901","ENTRE RIOS",10,0,5,3,1,9,0
"300980902","ENTRE RIOS",9,0,6,3,0,9,0
"300980903","ENTRE RIOS",136,0,55,78,3,136,0
"300980904","ENTRE RIOS",1,0,0,0,1,1,0
"300981506","ENTRE RIOS",19,0,13,4,1,18,0
"300981507","ENTRE RIOS",39,0,30,7,0,37,0
"300980905","ENTRE RIOS",7,0,4,2,1,7,0
"300980906","ENTRE RIOS",50,0,29,18,2,49,0
"300980907","ENTRE RIOS",113,50,35,26,0,61,0.442477876106195
"300981302","ENTRE RIOS",7,2,0,5,0,5,0.285714285714286
"300980908","ENTRE RIOS",101,46,45,10,0,55,0.455445544554455
"300980909","ENTRE RIOS",23,0,19,4,0,23,0
"300980914","ENTRE RIOS",55,0,38,13,4,55,0
"300980910","ENTRE RIOS",33,0,18,13,1,32,0
"300980911","ENTRE RIOS",12,0,5,7,0,12,0
"300980912","ENTRE RIOS",75,0,27,46,2,75,0
"300980915","ENTRE RIOS",18,0,9,9,0,18,0
"300980916","ENTRE RIOS",14,0,7,6,1,14,0
"300980917","ENTRE RIOS",20,0,14,6,0,20,0
"300981001","ENTRE RIOS",223,193,23,7,0,30,0.865470852017937
"180210419","CORRIENTES",200,138,59,3,0,62,0.69
"500211408","MENDOZA",242,211,10,17,0,27,0.871900826446281
"300981002","ENTRE RIOS",218,200,12,4,0,16,0.917431192660551
"300981003","ENTRE RIOS",44,6,16,21,0,37,0.136363636363636
"300981004","ENTRE RIOS",24,0,7,17,0,24,0
"300981102","ENTRE RIOS",120,58,26,30,5,61,0.483333333333333
"300981103","ENTRE RIOS",127,95,10,19,0,29,0.748031496062992
"300981005","ENTRE RIOS",47,2,19,25,0,44,0.0425531914893617
"300981006","ENTRE RIOS",11,1,7,2,0,9,0.0909090909090909
"300981007","ENTRE RIOS",7,0,6,1,0,7,0
"300981101","ENTRE RIOS",119,107,5,7,0,12,0.899159663865546
"300981104","ENTRE RIOS",99,70,12,15,0,27,0.707070707070707
"301130210","ENTRE RIOS",220,213,4,2,0,6,0.968181818181818
"300981105","ENTRE RIOS",16,0,8,8,0,16,0
"300981106","ENTRE RIOS",10,0,9,1,0,10,0
"300981201","ENTRE RIOS",10,0,6,4,0,10,0
"300981202","ENTRE RIOS",6,0,5,1,0,6,0
"300981203","ENTRE RIOS",13,0,7,6,0,13,0
"300981505","ENTRE RIOS",33,2,28,2,0,30,0.0606060606060606
"300981204","ENTRE RIOS",6,0,1,5,0,6,0
"300981205","ENTRE RIOS",9,0,5,4,0,9,0
"300981206","ENTRE RIOS",7,0,5,2,0,7,0
"300981309","ENTRE RIOS",141,60,35,42,1,78,0.425531914893617
"300981310","ENTRE RIOS",153,127,19,3,0,22,0.830065359477124
"300981301","ENTRE RIOS",12,0,6,6,0,12,0
"301130305","ENTRE RIOS",197,112,32,40,4,76,0.568527918781726
"300981303","ENTRE RIOS",14,0,12,2,0,14,0
"300981304","ENTRE RIOS",5,0,1,4,0,5,0
"300981311","ENTRE RIOS",130,89,30,11,0,41,0.684615384615385
"300981404","ENTRE RIOS",11,0,9,2,0,11,0
"300981305","ENTRE RIOS",13,0,6,7,0,13,0
"300981306","ENTRE RIOS",23,0,19,2,0,21,0
"300981307","ENTRE RIOS",43,0,28,15,0,43,0
"300981308","ENTRE RIOS",22,0,22,0,0,22,0
"300981312","ENTRE RIOS",59,0,43,15,0,58,0
"501120101","MENDOZA",222,0,148,62,2,212,0
"300981313","ENTRE RIOS",21,0,18,3,0,21,0
"300981314","ENTRE RIOS",18,0,16,2,0,18,0
"300981401","ENTRE RIOS",34,0,19,8,0,27,0
"300981402","ENTRE RIOS",32,0,13,18,0,31,0
"300981403","ENTRE RIOS",37,1,29,6,1,36,0.027027027027027
"300981405","ENTRE RIOS",243,190,30,22,0,52,0.781893004115226
"740560717","SAN LUIS",331,312,1,15,0,16,0.942598187311178
"300981406","ENTRE RIOS",39,1,23,12,0,35,0.0256410256410256
"300981407","ENTRE RIOS",26,0,15,10,0,25,0
"300981408","ENTRE RIOS",14,0,9,4,0,13,0
"301050211","ENTRE RIOS",170,164,4,2,0,6,0.964705882352941
"300981409","ENTRE RIOS",327,235,33,55,0,88,0.718654434250764
"300981410","ENTRE RIOS",96,0,86,10,0,96,0
"300981411","ENTRE RIOS",98,0,92,3,0,95,0
"300981412","ENTRE RIOS",20,0,12,6,0,18,0
"300981416","ENTRE RIOS",39,1,13,24,1,38,0.0256410256410256
"301050212","ENTRE RIOS",205,204,1,0,0,1,0.995121951219512
"300981413","ENTRE RIOS",48,0,32,8,2,42,0
"300981414","ENTRE RIOS",52,0,45,5,0,50,0
"301050201","ENTRE RIOS",158,67,54,36,0,90,0.424050632911392
"300981415","ENTRE RIOS",28,0,15,13,0,28,0
"300981501","ENTRE RIOS",37,0,24,11,1,36,0
"300981502","ENTRE RIOS",94,27,45,20,2,67,0.287234042553192
"300981503","ENTRE RIOS",253,186,20,39,0,59,0.735177865612648
"300981504","ENTRE RIOS",134,42,45,44,0,89,0.313432835820896
"740561307","SAN LUIS",269,213,45,11,0,56,0.79182156133829
"300981508","ENTRE RIOS",44,2,30,12,0,42,0.0454545454545455
"300981509","ENTRE RIOS",56,54,2,0,0,2,0.964285714285714
"300981510","ENTRE RIOS",152,148,3,0,0,3,0.973684210526316
"300981511","ENTRE RIOS",200,199,1,0,0,1,0.995
"300981512","ENTRE RIOS",125,120,3,1,0,4,0.96
"300981513","ENTRE RIOS",119,113,4,2,0,6,0.949579831932773
"300981514","ENTRE RIOS",14,0,2,12,0,14,0
"300981515","ENTRE RIOS",17,0,12,5,0,17,0
"300981516","ENTRE RIOS",31,0,17,14,0,31,0
"300981601","ENTRE RIOS",5,0,5,0,0,5,0
"300981602","ENTRE RIOS",10,0,9,1,0,10,0
"300981603","ENTRE RIOS",51,0,33,18,0,51,0
"300981604","ENTRE RIOS",49,0,34,3,0,37,0
"300981703","ENTRE RIOS",113,2,77,27,0,104,0.0176991150442478
"300981605","ENTRE RIOS",86,0,81,4,0,85,0
"300981706","ENTRE RIOS",11,0,10,1,0,11,0
"301050202","ENTRE RIOS",216,24,147,39,1,187,0.111111111111111
"300981606","ENTRE RIOS",40,0,40,0,0,40,0
"300981701","ENTRE RIOS",28,0,19,8,0,27,0
"300981702","ENTRE RIOS",104,3,65,33,2,100,0.0288461538461538
"300981704","ENTRE RIOS",109,0,62,44,0,106,0
"300981705","ENTRE RIOS",31,0,17,12,1,30,0
"300981707","ENTRE RIOS",13,0,12,0,0,12,0
"301050112","ENTRE RIOS",160,159,1,0,0,1,0.99375
"301050203","ENTRE RIOS",221,34,136,44,1,181,0.153846153846154
"301050204","ENTRE RIOS",175,112,41,21,0,62,0.64
"300981708","ENTRE RIOS",25,0,22,3,0,25,0
"300981709","ENTRE RIOS",24,0,23,0,1,24,0
"301050205","ENTRE RIOS",190,131,36,22,0,58,0.689473684210526
"301050206","ENTRE RIOS",208,121,23,61,0,84,0.581730769230769
"301050207","ENTRE RIOS",212,7,100,103,0,203,0.0330188679245283
"301050208","ENTRE RIOS",202,22,95,83,0,178,0.108910891089109
"301050209","ENTRE RIOS",269,213,36,18,0,54,0.79182156133829
"301050210","ENTRE RIOS",240,240,0,0,0,0,1
"300981801","ENTRE RIOS",3,0,1,0,0,1,0
"301050107","ENTRE RIOS",243,150,44,48,0,92,0.617283950617284
"301050108","ENTRE RIOS",237,195,30,12,0,42,0.822784810126582
"301050109","ENTRE RIOS",168,65,43,37,0,80,0.386904761904762
"301050110","ENTRE RIOS",267,242,16,9,0,25,0.906367041198502
"301050111","ENTRE RIOS",152,144,8,0,0,8,0.947368421052632
"300981802","ENTRE RIOS",12,0,0,11,0,11,0
"301050101","ENTRE RIOS",199,133,31,33,0,64,0.668341708542714
"301050102","ENTRE RIOS",156,16,65,66,1,132,0.102564102564103
"301050103","ENTRE RIOS",185,25,99,56,0,155,0.135135135135135
"301050104","ENTRE RIOS",271,162,45,36,0,81,0.597785977859779
"301050105","ENTRE RIOS",129,98,17,13,0,30,0.75968992248062
"301050106","ENTRE RIOS",122,81,30,11,0,41,0.663934426229508
"180210420","CORRIENTES",166,142,9,12,0,21,0.855421686746988
"301050213","ENTRE RIOS",207,43,88,73,1,162,0.207729468599034
"301050301","ENTRE RIOS",256,5,182,61,1,244,0.01953125
"301130106","ENTRE RIOS",226,206,6,11,1,18,0.911504424778761
"301050302","ENTRE RIOS",37,25,7,5,0,12,0.675675675675676
"301050303","ENTRE RIOS",371,223,89,55,2,146,0.601078167115903
"301050304","ENTRE RIOS",236,75,97,59,0,156,0.317796610169492
"301050305","ENTRE RIOS",192,184,8,0,0,8,0.958333333333333
"301050306","ENTRE RIOS",296,244,30,22,0,52,0.824324324324324
"301050307","ENTRE RIOS",234,232,2,0,0,2,0.991452991452991
"301050308","ENTRE RIOS",243,212,8,7,1,16,0.872427983539095
"301050309","ENTRE RIOS",209,201,6,2,0,8,0.961722488038278
"301130107","ENTRE RIOS",181,170,2,9,0,11,0.939226519337017
"301050310","ENTRE RIOS",247,179,40,27,0,67,0.724696356275304
"301050401","ENTRE RIOS",119,119,0,0,0,0,1
"301050402","ENTRE RIOS",132,129,1,2,0,3,0.977272727272727
"301050403","ENTRE RIOS",197,194,3,0,0,3,0.984771573604061
"301050404","ENTRE RIOS",261,139,48,71,1,120,0.532567049808429
"301050405","ENTRE RIOS",176,110,46,19,0,65,0.625
"301050406","ENTRE RIOS",291,245,12,17,0,29,0.84192439862543
"301050407","ENTRE RIOS",192,88,26,75,0,101,0.458333333333333
"301050408","ENTRE RIOS",86,60,6,18,0,24,0.697674418604651
"180070117","CORRIENTES",262,215,18,26,1,45,0.820610687022901
"301050409","ENTRE RIOS",268,20,82,146,4,232,0.0746268656716418
"301050410","ENTRE RIOS",314,2,197,105,0,302,0.00636942675159236
"301050501","ENTRE RIOS",69,0,49,17,0,66,0
"301050603","ENTRE RIOS",8,0,3,5,0,8,0
"180211608","CORRIENTES",242,240,0,2,0,2,0.991735537190083
"301050502","ENTRE RIOS",15,0,6,9,0,15,0
"301050503","ENTRE RIOS",63,2,33,24,1,58,0.0317460317460317
"301130108","ENTRE RIOS",267,250,8,5,0,13,0.936329588014981
"301050504","ENTRE RIOS",60,0,30,27,0,57,0
"301050608","ENTRE RIOS",13,0,6,7,0,13,0
"301050601","ENTRE RIOS",38,0,17,21,0,38,0
"301050602","ENTRE RIOS",29,0,12,16,0,28,0
"301050611","ENTRE RIOS",35,6,5,20,1,26,0.171428571428571
"180070202","CORRIENTES",53,0,14,29,10,53,0
"180210501","CORRIENTES",241,237,3,1,0,4,0.983402489626556
"301050604","ENTRE RIOS",21,0,15,5,0,20,0
"301050605","ENTRE RIOS",55,0,10,42,3,55,0
"301050705","ENTRE RIOS",29,0,16,10,2,28,0
"301050609","ENTRE RIOS",47,0,30,14,3,47,0
"180210810","CORRIENTES",381,367,4,3,1,8,0.963254593175853
"301050606","ENTRE RIOS",111,1,44,61,2,107,0.00900900900900901
"301050607","ENTRE RIOS",19,0,8,10,1,19,0
"301130109","ENTRE RIOS",368,353,4,10,1,15,0.959239130434783
"301130110","ENTRE RIOS",234,204,15,14,0,29,0.871794871794872
"301130111","ENTRE RIOS",274,259,9,4,0,13,0.945255474452555
"301050610","ENTRE RIOS",191,0,50,127,4,181,0
"301130112","ENTRE RIOS",311,288,9,10,1,20,0.92604501607717
"301130113","ENTRE RIOS",211,208,0,2,0,2,0.985781990521327
"301050703","ENTRE RIOS",42,0,20,13,6,39,0
"301050612","ENTRE RIOS",63,0,29,31,1,61,0
"301050701","ENTRE RIOS",13,0,13,0,0,13,0
"301050702","ENTRE RIOS",29,0,24,5,0,29,0
"301130114","ENTRE RIOS",201,197,3,0,0,3,0.980099502487562
"301130115","ENTRE RIOS",316,293,11,7,0,18,0.927215189873418
"301050704","ENTRE RIOS",18,1,4,13,0,17,0.0555555555555556
"301130116","ENTRE RIOS",193,156,12,17,0,29,0.808290155440414
"301130117","ENTRE RIOS",191,150,10,26,1,37,0.785340314136126
"301050706","ENTRE RIOS",21,0,11,10,0,21,0
"141610813","CORDOBA",197,150,34,13,0,47,0.761421319796954
"180210812","CORRIENTES",214,142,38,31,0,69,0.663551401869159
"220360905","CHACO",23,0,2,7,10,19,0
"301050707","ENTRE RIOS",22,0,11,11,0,22,0
"301050708","ENTRE RIOS",42,1,16,23,0,39,0.0238095238095238
"301050709","ENTRE RIOS",21,0,10,8,0,18,0
"301130118","ENTRE RIOS",258,233,9,13,1,23,0.903100775193798
"301130211","ENTRE RIOS",260,220,9,25,1,35,0.846153846153846
"301130212","ENTRE RIOS",287,220,17,42,0,59,0.766550522648084
"301130213","ENTRE RIOS",130,109,8,9,1,18,0.838461538461538
"220360906","CHACO",189,0,87,70,21,178,0
"301050710","ENTRE RIOS",10,0,4,3,1,8,0
"301050711","ENTRE RIOS",136,1,44,85,3,132,0.00735294117647059
"301050712","ENTRE RIOS",132,0,43,77,6,126,0
"301130119","ENTRE RIOS",233,228,3,2,0,5,0.978540772532189
"301130120","ENTRE RIOS",107,106,1,0,0,1,0.990654205607477
"301130121","ENTRE RIOS",168,167,0,1,0,1,0.994047619047619
"220360907","CHACO",329,0,194,96,18,308,0
"301050713","ENTRE RIOS",18,0,14,4,0,18,0
"301130122","ENTRE RIOS",329,291,13,22,0,35,0.884498480243161
"301130123","ENTRE RIOS",316,293,15,8,0,23,0.927215189873418
"301130201","ENTRE RIOS",266,266,0,0,0,0,1
"301050714","ENTRE RIOS",12,0,3,8,0,11,0
"301050715","ENTRE RIOS",68,0,30,37,0,67,0
"301050801","ENTRE RIOS",25,0,1,0,17,18,0
"301050802","ENTRE RIOS",13,0,0,1,11,12,0
"301050812","ENTRE RIOS",58,0,17,15,26,58,0
"220390101","CHACO",110,0,19,50,18,87,0
"301050803","ENTRE RIOS",11,0,0,7,0,7,0
"301050804","ENTRE RIOS",17,0,2,1,14,17,0
"301050805","ENTRE RIOS",21,0,3,2,15,20,0
"301050806","ENTRE RIOS",25,0,0,11,10,21,0
"301130101","ENTRE RIOS",97,78,4,13,1,18,0.804123711340206
"301130102","ENTRE RIOS",1,0,0,0,1,1,0
"301130103","ENTRE RIOS",272,272,0,0,0,0,1
"301050807","ENTRE RIOS",26,1,1,18,1,20,0.0384615384615385
"301050809","ENTRE RIOS",15,0,0,12,2,14,0
"301050810","ENTRE RIOS",36,0,3,33,0,36,0
"301050811","ENTRE RIOS",25,0,1,9,13,23,0
"301050808","ENTRE RIOS",22,0,1,1,20,22,0
"301130104","ENTRE RIOS",206,162,18,18,0,36,0.786407766990291
"301130105","ENTRE RIOS",368,322,22,20,0,42,0.875
"301130214","ENTRE RIOS",269,225,23,20,0,43,0.836431226765799
"301130215","ENTRE RIOS",194,141,22,27,0,49,0.72680412371134
"301130216","ENTRE RIOS",191,147,10,28,1,39,0.769633507853403
"301130301","ENTRE RIOS",7,0,3,4,0,7,0
"301130302","ENTRE RIOS",67,1,38,19,5,62,0.0149253731343284
"301130303","ENTRE RIOS",183,8,54,105,9,168,0.0437158469945355
"301130304","ENTRE RIOS",66,0,44,15,2,61,0
"301130306","ENTRE RIOS",58,14,6,33,4,43,0.241379310344828
"301130307","ENTRE RIOS",308,210,23,57,4,84,0.681818181818182
"180210808","CORRIENTES",216,212,1,3,0,4,0.981481481481482
"301130308","ENTRE RIOS",144,113,11,16,1,28,0.784722222222222
"301130309","ENTRE RIOS",240,182,22,24,0,46,0.758333333333333
"301130310","ENTRE RIOS",338,253,24,49,0,73,0.748520710059172
"301130311","ENTRE RIOS",206,99,38,43,1,82,0.480582524271845
"301130312","ENTRE RIOS",13,7,2,1,0,3,0.538461538461538
"301130401","ENTRE RIOS",6,0,4,2,0,6,0
"180210314","CORRIENTES",337,113,89,106,14,209,0.335311572700297
"301130402","ENTRE RIOS",3,0,3,0,0,3,0
"301130403","ENTRE RIOS",12,0,9,3,0,12,0
"301130404","ENTRE RIOS",209,181,13,12,0,25,0.866028708133971
"301130405","ENTRE RIOS",261,251,3,2,0,5,0.961685823754789
"301130406","ENTRE RIOS",290,270,1,16,0,17,0.931034482758621
"180210315","CORRIENTES",365,323,18,12,1,31,0.884931506849315
"180070104","CORRIENTES",218,110,33,56,4,93,0.504587155963303
"180210502","CORRIENTES",255,250,2,1,0,3,0.980392156862745
"301130501","ENTRE RIOS",10,0,3,7,0,10,0
"301130502","ENTRE RIOS",0,0,0,0,0,0,NA
"301130503","ENTRE RIOS",14,0,3,10,0,13,0
"301130504","ENTRE RIOS",157,69,32,53,0,85,0.439490445859873
"301130505","ENTRE RIOS",137,114,4,17,2,23,0.832116788321168
"301131109","ENTRE RIOS",25,0,5,16,0,21,0
"140980310","CORDOBA",200,4,165,23,2,190,0.02
"301130506","ENTRE RIOS",118,112,1,5,0,6,0.949152542372881
"301130507","ENTRE RIOS",101,84,8,9,0,17,0.831683168316832
"301130601","ENTRE RIOS",18,0,3,13,1,17,0
"180070213","CORRIENTES",266,233,4,16,2,22,0.87593984962406
"180070214","CORRIENTES",390,364,2,3,1,6,0.933333333333333
"301130602","ENTRE RIOS",14,0,13,0,0,13,0
"301130603","ENTRE RIOS",64,0,30,31,1,62,0
"301131401","ENTRE RIOS",14,0,11,3,0,14,0
"301130604","ENTRE RIOS",17,0,12,5,0,17,0
"301131408","ENTRE RIOS",6,0,4,2,0,6,0
"180070215","CORRIENTES",267,266,1,0,0,1,0.99625468164794
"180210316","CORRIENTES",334,264,22,23,1,46,0.790419161676647
"301130605","ENTRE RIOS",12,0,8,2,0,10,0
"301130606","ENTRE RIOS",120,3,52,39,11,102,0.025
"180070102","CORRIENTES",168,2,72,68,13,153,0.0119047619047619
"180070103","CORRIENTES",257,15,150,82,5,237,0.0583657587548638
"180210809","CORRIENTES",398,389,5,3,0,8,0.977386934673367
"301130607","ENTRE RIOS",36,0,25,5,2,32,0
"301130609","ENTRE RIOS",38,0,14,16,0,30,0
"180070105","CORRIENTES",263,35,137,77,5,219,0.133079847908745
"180070216","CORRIENTES",167,73,32,22,20,74,0.437125748502994
"301130608","ENTRE RIOS",79,0,43,24,4,71,0
"301130702","ENTRE RIOS",97,0,44,39,11,94,0
"301130610","ENTRE RIOS",27,0,10,11,5,26,0
"301130701","ENTRE RIOS",22,0,17,4,0,21,0
"180070106","CORRIENTES",303,118,91,62,19,172,0.389438943894389
"180070107","CORRIENTES",183,168,14,1,0,15,0.918032786885246
"301130703","ENTRE RIOS",56,0,21,20,2,43,0
"301130704","ENTRE RIOS",28,0,11,11,1,23,0
"301130805","ENTRE RIOS",38,0,16,19,2,37,0
"180070108","CORRIENTES",292,252,31,6,0,37,0.863013698630137
"180070109","CORRIENTES",267,114,56,81,13,150,0.426966292134831
"301130705","ENTRE RIOS",56,0,14,34,1,49,0
"301130806","ENTRE RIOS",61,0,31,22,2,55,0
"180070110","CORRIENTES",229,102,77,42,3,122,0.445414847161572
"180210317","CORRIENTES",502,346,67,38,3,108,0.689243027888446
"301130706","ENTRE RIOS",116,0,38,72,1,111,0
"301130807","ENTRE RIOS",37,1,15,7,11,33,0.027027027027027
"301130801","ENTRE RIOS",16,0,6,7,1,14,0
"301130802","ENTRE RIOS",6,0,1,5,0,6,0
"301130811","ENTRE RIOS",12,0,8,4,0,12,0
"301130803","ENTRE RIOS",14,0,9,4,1,14,0
"301130804","ENTRE RIOS",16,0,10,4,0,14,0
"301130904","ENTRE RIOS",23,0,7,11,2,20,0
"180210318","CORRIENTES",256,233,5,0,0,5,0.91015625
"301130808","ENTRE RIOS",41,0,11,23,5,39,0
"301130809","ENTRE RIOS",17,0,17,0,0,17,0
"301130810","ENTRE RIOS",16,0,10,4,1,15,0
"180210319","CORRIENTES",323,316,2,0,0,2,0.978328173374613
"301130812","ENTRE RIOS",15,0,9,6,0,15,0
"301130813","ENTRE RIOS",23,0,8,11,2,21,0
"301130905","ENTRE RIOS",20,0,17,1,1,19,0
"180070111","CORRIENTES",233,0,143,58,16,217,0
"301130814","ENTRE RIOS",17,0,13,3,0,16,0
"301130815","ENTRE RIOS",30,0,21,6,3,30,0
"180070112","CORRIENTES",255,202,26,19,8,53,0.792156862745098
"180070113","CORRIENTES",323,286,30,7,0,37,0.885448916408669
"180070114","CORRIENTES",240,64,80,53,7,140,0.266666666666667
"140420611","CORDOBA",301,301,0,0,0,0,1
"301130901","ENTRE RIOS",22,0,10,6,0,16,0
"301130902","ENTRE RIOS",19,0,12,5,1,18,0
"301130903","ENTRE RIOS",28,0,20,5,0,25,0
"180070304","CORRIENTES",116,1,10,47,38,95,0.00862068965517241
"301130906","ENTRE RIOS",56,0,35,13,2,50,0
"301130907","ENTRE RIOS",19,0,9,8,2,19,0
"301131110","ENTRE RIOS",37,0,19,14,2,35,0
"301130908","ENTRE RIOS",13,1,4,7,0,11,0.0769230769230769
"301131003","ENTRE RIOS",30,0,19,8,0,27,0
"180070115","CORRIENTES",284,3,70,141,52,263,0.0105633802816901
"301131001","ENTRE RIOS",38,0,21,10,1,32,0
"301131002","ENTRE RIOS",65,0,24,23,10,57,0
"180070116","CORRIENTES",272,68,75,112,1,188,0.25
"140631002","CORDOBA",308,169,101,37,0,138,0.548701298701299
"301131004","ENTRE RIOS",53,0,31,17,3,51,0
"301131007","ENTRE RIOS",37,0,9,22,0,31,0
"301131206","ENTRE RIOS",27,0,9,14,4,27,0
"180070118","CORRIENTES",237,205,16,14,0,30,0.864978902953586
"301131005","ENTRE RIOS",49,1,18,26,0,44,0.0204081632653061
"301131006","ENTRE RIOS",24,0,12,10,2,24,0
"180070119","CORRIENTES",261,41,85,95,31,211,0.157088122605364
"180070120","CORRIENTES",242,158,49,27,6,82,0.652892561983471
"301131008","ENTRE RIOS",41,0,11,24,3,38,0
"180070121","CORRIENTES",254,193,27,22,4,53,0.759842519685039
"301131101","ENTRE RIOS",11,0,10,1,0,11,0
"301131102","ENTRE RIOS",4,0,4,0,0,4,0
"301131108","ENTRE RIOS",20,0,3,17,0,20,0
"180070122","CORRIENTES",279,130,58,65,19,142,0.46594982078853
"180070123","CORRIENTES",235,120,71,34,8,113,0.51063829787234
"301131103","ENTRE RIOS",42,0,18,23,1,42,0
"301131104","ENTRE RIOS",47,1,19,24,0,43,0.0212765957446809
"301131105","ENTRE RIOS",42,0,25,12,1,38,0
"180070124","CORRIENTES",271,271,0,0,0,0,1
"180070125","CORRIENTES",282,276,3,0,1,4,0.978723404255319
"180070305","CORRIENTES",113,28,28,34,7,69,0.247787610619469
"301131106","ENTRE RIOS",88,0,26,51,9,86,0
"301131107","ENTRE RIOS",11,0,0,10,1,11,0
"180210320","CORRIENTES",314,297,2,7,0,9,0.945859872611465
"301131201","ENTRE RIOS",20,8,1,8,0,9,0.4
"301131202","ENTRE RIOS",13,0,10,2,0,12,0
"180070201","CORRIENTES",74,1,11,33,17,61,0.0135135135135135
"141400404","CORDOBA",208,1,194,13,0,207,0.00480769230769231
"301131203","ENTRE RIOS",125,19,35,61,2,98,0.152
"301131204","ENTRE RIOS",77,5,43,18,2,63,0.0649350649350649
"301131205","ENTRE RIOS",10,0,4,4,1,9,0
"180070203","CORRIENTES",96,1,32,26,22,80,0.0104166666666667
"220140702","CHACO",105,1,9,23,56,88,0.00952380952380952
"301131207","ENTRE RIOS",19,1,15,1,1,17,0.0526315789473684
"301131304","ENTRE RIOS",24,2,4,15,0,19,0.0833333333333333
"301131208","ENTRE RIOS",31,0,22,4,2,28,0
"301131209","ENTRE RIOS",47,0,12,33,0,45,0
"301131301","ENTRE RIOS",4,0,1,2,0,3,0
"180210321","CORRIENTES",230,217,8,4,0,12,0.943478260869565
"220210703","CHACO",140,136,4,0,0,4,0.971428571428571
"301131302","ENTRE RIOS",33,0,25,8,0,33,0
"301131303","ENTRE RIOS",11,0,9,1,1,11,0
"301131305","ENTRE RIOS",5,0,0,5,0,5,0
"301131306","ENTRE RIOS",16,0,12,2,1,15,0
"301131307","ENTRE RIOS",5,0,0,2,1,3,0
"301131308","ENTRE RIOS",119,2,64,47,3,114,0.0168067226890756
"301131309","ENTRE RIOS",74,2,53,17,0,70,0.027027027027027
"180070211","CORRIENTES",59,0,10,27,5,42,0
"180070212","CORRIENTES",78,0,20,33,11,64,0
"301131402","ENTRE RIOS",30,0,20,9,0,29,0
"301131403","ENTRE RIOS",7,0,1,6,0,7,0
"301131404","ENTRE RIOS",8,0,8,0,0,8,0
"180070401","CORRIENTES",26,0,6,11,0,17,0
"301131405","ENTRE RIOS",33,0,15,14,1,30,0
"301131406","ENTRE RIOS",17,14,1,1,0,2,0.823529411764706
"301131407","ENTRE RIOS",10,0,3,7,0,10,0
"220390102","CHACO",50,0,4,33,4,41,0
"301131409","ENTRE RIOS",8,0,1,7,0,8,0
"301131410","ENTRE RIOS",4,0,2,1,0,3,0
"301131411","ENTRE RIOS",113,1,50,55,2,107,0.00884955752212389
"180070101","CORRIENTES",330,17,127,122,30,279,0.0515151515151515
"180070503","CORRIENTES",9,0,5,2,0,7,0
"180070204","CORRIENTES",98,0,17,53,18,88,0
"180070205","CORRIENTES",72,2,20,30,13,63,0.0277777777777778
"180070206","CORRIENTES",77,0,24,24,13,61,0
"180070207","CORRIENTES",70,0,16,26,11,53,0
"180070208","CORRIENTES",79,0,10,38,23,71,0
"180070209","CORRIENTES",72,1,10,36,14,60,0.0138888888888889
"180070210","CORRIENTES",19,0,0,8,10,18,0
"180210421","CORRIENTES",369,253,24,45,4,73,0.685636856368564
"180070217","CORRIENTES",156,1,20,68,42,130,0.00641025641025641
"180070218","CORRIENTES",153,129,2,7,10,19,0.843137254901961
"180070301","CORRIENTES",217,20,80,88,13,181,0.0921658986175115
"180070302","CORRIENTES",38,1,5,28,2,35,0.0263157894736842
"180070303","CORRIENTES",35,0,5,18,4,27,0
"180210422","CORRIENTES",258,231,16,8,0,24,0.895348837209302
"180070501","CORRIENTES",38,0,1,23,3,27,0
"180070502","CORRIENTES",19,0,4,7,1,12,0
"180210601","CORRIENTES",233,219,5,7,0,12,0.939914163090129
"180070504","CORRIENTES",31,1,12,6,4,22,0.032258064516129
"180070505","CORRIENTES",27,0,1,21,2,24,0
"180070506","CORRIENTES",39,0,1,32,6,39,0
"180140102","CORRIENTES",137,0,88,26,19,133,0
"180210410","CORRIENTES",321,59,150,99,1,250,0.183800623052959
"180070601","CORRIENTES",141,0,52,55,14,121,0
"180140101","CORRIENTES",120,0,62,39,14,115,0
"221120901","CHACO",35,0,2,18,5,25,0
"180070602","CORRIENTES",104,0,26,50,17,93,0
"180070701","CORRIENTES",63,0,18,26,16,60,0
"180070702","CORRIENTES",104,1,22,51,21,94,0.00961538461538462
"180070801","CORRIENTES",6,0,0,0,1,1,0
"180140103","CORRIENTES",147,0,78,31,36,145,0
"180140201","CORRIENTES",51,0,15,22,12,49,0
"180210301","CORRIENTES",272,226,14,24,0,38,0.830882352941177
"180070802","CORRIENTES",11,0,0,1,0,1,0
"180210110","CORRIENTES",203,203,0,0,0,0,1
"180210111","CORRIENTES",221,218,0,0,0,0,0.986425339366516
"180140202","CORRIENTES",12,0,8,0,4,12,0
"180140203","CORRIENTES",8,0,1,4,2,7,0
"180140301","CORRIENTES",61,0,5,40,9,54,0
"180140302","CORRIENTES",28,0,11,8,6,25,0
"180140303","CORRIENTES",42,0,18,13,11,42,0
"180210112","CORRIENTES",137,137,0,0,0,0,1
"180140401","CORRIENTES",55,0,20,21,7,48,0
"180140402","CORRIENTES",15,0,8,5,2,15,0
"180140501","CORRIENTES",0,0,0,0,0,0,NA
"180210113","CORRIENTES",451,449,1,0,1,2,0.995565410199557
"180210114","CORRIENTES",357,324,0,0,0,0,0.907563025210084
"180210115","CORRIENTES",413,412,0,0,0,0,0.997578692493947
"180210116","CORRIENTES",224,224,0,0,0,0,1
"180140502","CORRIENTES",0,0,0,0,0,0,NA
"180210101","CORRIENTES",454,436,10,7,0,17,0.960352422907489
"180210102","CORRIENTES",312,302,5,3,1,9,0.967948717948718
"180210103","CORRIENTES",403,384,7,10,0,17,0.952853598014888
"180210104","CORRIENTES",294,294,0,0,0,0,1
"180210105","CORRIENTES",259,259,0,0,0,0,1
"180210106","CORRIENTES",306,305,0,0,0,0,0.996732026143791
"180210107","CORRIENTES",234,232,0,0,0,0,0.991452991452991
"180210108","CORRIENTES",202,202,0,0,0,0,1
"180210109","CORRIENTES",274,274,0,0,0,0,1
"180210201","CORRIENTES",442,424,2,2,0,4,0.959276018099548
"180210202","CORRIENTES",255,254,0,0,0,0,0.996078431372549
"180210203","CORRIENTES",364,364,0,0,0,0,1
"180210204","CORRIENTES",215,215,0,0,0,0,1
"180210205","CORRIENTES",266,266,0,0,0,0,1
"180210206","CORRIENTES",284,284,0,0,0,0,1
"180210207","CORRIENTES",400,398,1,1,0,2,0.995
"180210208","CORRIENTES",348,343,0,3,0,3,0.985632183908046
"180210209","CORRIENTES",280,279,0,1,0,1,0.996428571428571
"180210210","CORRIENTES",290,290,0,0,0,0,1
"180210211","CORRIENTES",258,257,1,0,0,1,0.996124031007752
"180210212","CORRIENTES",236,236,0,0,0,0,1
"180210213","CORRIENTES",206,201,5,0,0,5,0.975728155339806
"180210214","CORRIENTES",428,425,3,0,0,3,0.992990654205608
"180210215","CORRIENTES",293,278,4,0,0,4,0.948805460750853
"180210216","CORRIENTES",291,286,5,0,0,5,0.982817869415808
"180210303","CORRIENTES",442,251,77,92,4,173,0.567873303167421
"180210304","CORRIENTES",485,347,58,57,2,117,0.715463917525773
"180210305","CORRIENTES",409,332,31,19,3,53,0.811735941320293
"180210306","CORRIENTES",293,166,28,67,4,99,0.566552901023891
"180210307","CORRIENTES",255,32,27,153,28,208,0.125490196078431
"180210411","CORRIENTES",505,225,143,108,1,252,0.445544554455446
"180210503","CORRIENTES",411,403,1,3,0,4,0.980535279805353
"180210412","CORRIENTES",244,40,163,38,1,202,0.163934426229508
"180210308","CORRIENTES",311,47,96,128,10,234,0.15112540192926
"180210309","CORRIENTES",300,116,48,124,4,176,0.386666666666667
"180210403","CORRIENTES",506,233,148,108,4,260,0.460474308300395
"180210404","CORRIENTES",362,218,43,79,7,129,0.602209944751381
"180210310","CORRIENTES",291,103,43,136,2,181,0.353951890034364
"180210311","CORRIENTES",252,239,5,0,0,5,0.948412698412698
"180210401","CORRIENTES",444,152,150,124,4,278,0.342342342342342
"180210402","CORRIENTES",220,219,1,0,0,1,0.995454545454545
"180210413","CORRIENTES",268,206,37,24,1,62,0.76865671641791
"180210603","CORRIENTES",317,273,17,20,1,38,0.861198738170347
"180210405","CORRIENTES",255,153,25,61,1,87,0.6
"180210406","CORRIENTES",385,7,101,231,12,344,0.0181818181818182
"180210414","CORRIENTES",330,239,53,33,1,87,0.724242424242424
"180210415","CORRIENTES",240,206,13,20,0,33,0.858333333333333
"180210416","CORRIENTES",249,224,8,17,0,25,0.899598393574297
"180210417","CORRIENTES",328,258,60,8,0,68,0.786585365853659
"180210407","CORRIENTES",403,40,108,211,11,330,0.0992555831265509
"180210408","CORRIENTES",244,132,24,63,23,110,0.540983606557377
"180210409","CORRIENTES",323,97,83,123,5,211,0.30030959752322
"180210504","CORRIENTES",319,307,6,3,1,10,0.962382445141066
"180210505","CORRIENTES",179,171,4,1,0,5,0.955307262569832
"180210506","CORRIENTES",299,238,27,30,1,58,0.795986622073579
"180210507","CORRIENTES",331,216,61,50,0,111,0.652567975830816
"180210508","CORRIENTES",203,172,21,7,3,31,0.847290640394089
"180210509","CORRIENTES",286,257,13,13,2,28,0.898601398601399
"180210510","CORRIENTES",244,237,4,3,0,7,0.971311475409836
"180210511","CORRIENTES",315,308,2,3,0,5,0.977777777777778
"180210512","CORRIENTES",454,444,6,2,0,8,0.977973568281938
"180210513","CORRIENTES",348,325,11,11,1,23,0.933908045977011
"180210514","CORRIENTES",250,204,23,21,2,46,0.816
"180210515","CORRIENTES",207,188,11,7,1,19,0.908212560386473
"180210516","CORRIENTES",199,147,23,29,0,52,0.738693467336683
"180210605","CORRIENTES",348,275,41,29,0,70,0.790229885057471
"180210811","CORRIENTES",524,505,4,13,0,17,0.963740458015267
"180210606","CORRIENTES",581,392,83,93,1,177,0.674698795180723
"180210607","CORRIENTES",268,254,8,3,0,11,0.947761194029851
"180210608","CORRIENTES",259,226,1,11,0,12,0.872586872586873
"180210609","CORRIENTES",336,314,0,0,0,0,0.93452380952381
"180210610","CORRIENTES",260,246,14,0,0,14,0.946153846153846
"180210611","CORRIENTES",198,192,6,0,0,6,0.96969696969697
"180210612","CORRIENTES",344,310,10,8,2,20,0.901162790697674
"180210613","CORRIENTES",349,260,27,53,1,81,0.744985673352435
"180210614","CORRIENTES",366,308,28,20,1,49,0.841530054644809
"180210615","CORRIENTES",284,243,12,19,1,32,0.855633802816901
"180210616","CORRIENTES",331,296,16,14,0,30,0.894259818731118
"180210701","CORRIENTES",340,15,87,207,6,300,0.0441176470588235
"740561304","SAN LUIS",219,215,2,2,0,4,0.981735159817352
"220390302","CHACO",9,0,1,2,5,8,0
"180210702","CORRIENTES",268,102,64,83,3,150,0.380597014925373
"180210703","CORRIENTES",482,410,28,26,4,58,0.850622406639004
"180210704","CORRIENTES",346,343,3,0,0,3,0.991329479768786
"180210705","CORRIENTES",296,296,0,0,0,0,1
"180210706","CORRIENTES",207,206,1,0,0,1,0.995169082125604
"180210707","CORRIENTES",422,401,11,10,0,21,0.950236966824645
"180210708","CORRIENTES",565,296,77,132,4,213,0.523893805309735
"180210709","CORRIENTES",322,270,20,19,0,39,0.838509316770186
"180210710","CORRIENTES",370,289,27,44,3,74,0.781081081081081
"180211612","CORRIENTES",213,93,48,65,5,118,0.436619718309859
"180210711","CORRIENTES",416,108,71,186,25,282,0.259615384615385
"180210712","CORRIENTES",344,330,1,10,0,11,0.959302325581395
"180210713","CORRIENTES",303,268,5,0,0,5,0.884488448844885
"180210714","CORRIENTES",264,257,6,0,0,6,0.973484848484849
"180210715","CORRIENTES",285,164,25,82,2,109,0.575438596491228
"180210716","CORRIENTES",236,191,7,25,0,32,0.809322033898305
"180210801","CORRIENTES",198,188,5,4,0,9,0.94949494949495
"180210802","CORRIENTES",269,246,14,7,0,21,0.91449814126394
"180210813","CORRIENTES",231,118,40,55,4,99,0.510822510822511
"180210901","CORRIENTES",188,188,0,0,0,0,1
"180210902","CORRIENTES",208,208,0,0,0,0,1
"180210903","CORRIENTES",291,262,1,1,0,2,0.900343642611684
"180210904","CORRIENTES",240,239,1,0,0,1,0.995833333333333
"180210905","CORRIENTES",273,264,4,3,0,7,0.967032967032967
"180210906","CORRIENTES",446,444,1,0,0,1,0.995515695067265
"180210907","CORRIENTES",435,422,8,2,1,11,0.970114942528736
"180210908","CORRIENTES",432,427,5,0,0,5,0.988425925925926
"180210909","CORRIENTES",323,320,3,0,0,3,0.990712074303406
"180210910","CORRIENTES",296,293,3,0,0,3,0.989864864864865
"180210911","CORRIENTES",207,206,1,0,0,1,0.995169082125604
"180210912","CORRIENTES",427,419,5,1,0,6,0.981264637002342
"180210913","CORRIENTES",224,223,1,0,0,1,0.995535714285714
"180210914","CORRIENTES",317,307,7,2,1,10,0.968454258675079
"180210915","CORRIENTES",238,232,1,2,0,3,0.974789915966387
"180211001","CORRIENTES",280,10,77,171,2,250,0.0357142857142857
"180211609","CORRIENTES",290,267,14,5,1,20,0.920689655172414
"180211002","CORRIENTES",292,132,54,103,1,158,0.452054794520548
"180211003","CORRIENTES",303,10,149,135,1,285,0.033003300330033
"180211004","CORRIENTES",321,24,178,105,4,287,0.0747663551401869
"180211005","CORRIENTES",253,3,118,121,1,240,0.0118577075098814
"180211006","CORRIENTES",480,309,63,106,1,170,0.64375
"180211007","CORRIENTES",325,200,63,55,1,119,0.615384615384615
"180211104","CORRIENTES",114,7,54,30,5,89,0.0614035087719298
"180211102","CORRIENTES",23,2,7,10,1,18,0.0869565217391304
"180211610","CORRIENTES",182,13,66,100,1,167,0.0714285714285714
"180211901","CORRIENTES",262,259,2,0,0,2,0.988549618320611
"180211105","CORRIENTES",151,6,55,79,6,140,0.0397350993377483
"180211101","CORRIENTES",304,5,118,118,27,263,0.0164473684210526
"740351109","SAN LUIS",165,162,3,0,0,3,0.981818181818182
"220490303","CHACO",43,0,6,30,6,42,0
"180211103","CORRIENTES",154,3,68,66,4,138,0.0194805194805195
"180211505","CORRIENTES",286,285,1,0,0,1,0.996503496503496
"180211506","CORRIENTES",221,209,0,10,0,10,0.945701357466063
"180211106","CORRIENTES",356,6,161,149,5,315,0.0168539325842697
"180211107","CORRIENTES",312,2,164,117,3,284,0.00641025641025641
"180211108","CORRIENTES",231,4,85,105,11,201,0.0173160173160173
"180211109","CORRIENTES",268,17,86,126,15,227,0.0634328358208955
"180211611","CORRIENTES",268,108,86,70,1,157,0.402985074626866
"140631108","CORDOBA",226,20,127,76,1,204,0.0884955752212389
"180211110","CORRIENTES",217,1,110,84,17,211,0.00460829493087558
"180211507","CORRIENTES",237,189,14,32,0,46,0.79746835443038
"180211508","CORRIENTES",238,234,1,0,0,1,0.983193277310924
"220280306","CHACO",207,0,183,4,0,187,0
"180211201","CORRIENTES",27,0,8,12,0,20,0
"180211212","CORRIENTES",348,10,115,162,13,290,0.028735632183908
"180211213","CORRIENTES",98,0,18,68,0,86,0
"180211202","CORRIENTES",46,0,8,26,4,38,0
"180211203","CORRIENTES",35,0,7,25,2,34,0
"180211210","CORRIENTES",324,126,15,125,14,154,0.388888888888889
"180211211","CORRIENTES",270,268,1,1,0,2,0.992592592592593
"180211509","CORRIENTES",194,194,0,0,0,0,1
"180211601","CORRIENTES",183,151,2,22,0,24,0.825136612021858
"180211602","CORRIENTES",197,167,8,16,0,24,0.847715736040609
"180211204","CORRIENTES",48,0,18,24,3,45,0
"180211205","CORRIENTES",187,0,81,74,8,163,0
"180211206","CORRIENTES",148,2,60,66,11,137,0.0135135135135135
"180211510","CORRIENTES",177,177,0,0,0,0,1
"180211511","CORRIENTES",421,419,1,0,0,1,0.995249406175772
"140420610","CORDOBA",206,203,1,2,0,3,0.985436893203884
"180211207","CORRIENTES",145,3,21,55,17,93,0.0206896551724138
"180211208","CORRIENTES",331,6,173,132,2,307,0.0181268882175227
"180211209","CORRIENTES",432,46,187,168,7,362,0.106481481481481
"180211512","CORRIENTES",244,243,0,0,0,0,0.995901639344262
"180211301","CORRIENTES",319,7,157,127,3,287,0.0219435736677116
"180211513","CORRIENTES",231,231,0,0,0,0,1
"180211514","CORRIENTES",246,245,0,0,0,0,0.995934959349594
"180211515","CORRIENTES",199,199,0,0,0,0,1
"180211603","CORRIENTES",369,347,3,10,0,13,0.940379403794038
"180211604","CORRIENTES",504,476,17,8,0,25,0.944444444444444
"180211605","CORRIENTES",170,166,0,4,0,4,0.976470588235294
"180211606","CORRIENTES",196,196,0,0,0,0,1
"180211607","CORRIENTES",233,231,1,0,0,1,0.991416309012876
"180211302","CORRIENTES",170,3,97,52,4,153,0.0176470588235294
"180211307","CORRIENTES",225,16,88,90,3,181,0.0711111111111111
"180211516","CORRIENTES",468,415,38,13,0,51,0.886752136752137
"180211303","CORRIENTES",51,0,16,21,3,40,0
"180211304","CORRIENTES",16,0,6,9,0,15,0
"180211305","CORRIENTES",118,1,76,35,0,111,0.00847457627118644
"180211306","CORRIENTES",190,6,86,86,2,174,0.0315789473684211
"180211502","CORRIENTES",256,256,0,0,0,0,1
"180211503","CORRIENTES",118,118,0,0,0,0,1
"180211504","CORRIENTES",128,128,0,0,0,0,1
"180211401","CORRIENTES",5,0,0,1,1,2,0
"180211402","CORRIENTES",10,1,0,5,0,5,0.1
"180211501","CORRIENTES",297,295,0,0,0,0,0.993265993265993
"180211613","CORRIENTES",242,16,126,93,2,221,0.0661157024793388
"180211614","CORRIENTES",292,58,148,83,1,232,0.198630136986301
"180212101","CORRIENTES",334,321,2,4,4,10,0.961077844311377
"180211615","CORRIENTES",345,73,130,129,1,260,0.211594202898551
"180211616","CORRIENTES",345,197,59,77,0,136,0.571014492753623
"180211701","CORRIENTES",302,265,11,14,0,25,0.877483443708609
"180211702","CORRIENTES",339,274,38,23,0,61,0.808259587020649
"180211703","CORRIENTES",404,322,18,21,2,41,0.797029702970297
"180211704","CORRIENTES",330,281,18,6,1,25,0.851515151515152
"180211705","CORRIENTES",262,261,1,0,0,1,0.99618320610687
"180211706","CORRIENTES",426,408,2,12,0,14,0.957746478873239
"180211707","CORRIENTES",250,239,3,4,1,8,0.956
"140490317","CORDOBA",196,0,173,23,0,196,0
"180211708","CORRIENTES",293,186,55,49,0,104,0.63481228668942
"180211709","CORRIENTES",272,234,12,16,0,28,0.860294117647059
"180211710","CORRIENTES",318,318,0,0,0,0,1
"180212102","CORRIENTES",253,248,2,0,0,2,0.980237154150198
"180211711","CORRIENTES",291,290,1,0,0,1,0.996563573883162
"180211712","CORRIENTES",213,212,1,0,0,1,0.995305164319249
"180211713","CORRIENTES",299,266,16,9,4,29,0.889632107023411
"180211714","CORRIENTES",219,219,0,0,0,0,1
"180211715","CORRIENTES",266,222,29,14,0,43,0.834586466165414
"180211716","CORRIENTES",216,216,0,0,0,0,1
"180211717","CORRIENTES",225,223,2,0,0,2,0.991111111111111
"180211718","CORRIENTES",398,380,1,0,0,1,0.954773869346734
"180211801","CORRIENTES",429,292,91,43,0,134,0.680652680652681
"180211802","CORRIENTES",292,286,3,3,0,6,0.979452054794521
"180211803","CORRIENTES",424,412,9,2,1,12,0.971698113207547
"180211804","CORRIENTES",487,142,125,205,4,334,0.291581108829569
"180211805","CORRIENTES",261,146,63,42,2,107,0.559386973180077
"180211806","CORRIENTES",260,89,111,59,1,171,0.342307692307692
"180211807","CORRIENTES",417,235,90,79,4,173,0.563549160671463
"180211808","CORRIENTES",386,385,0,0,0,0,0.99740932642487
"180211809","CORRIENTES",517,280,60,152,3,215,0.541586073500967
"180211810","CORRIENTES",261,261,0,0,0,0,1
"180211811","CORRIENTES",331,254,29,31,1,61,0.767371601208459
"180211812","CORRIENTES",448,373,18,40,1,59,0.832589285714286
"180211813","CORRIENTES",421,326,72,17,0,89,0.774346793349169
"180211902","CORRIENTES",306,298,4,2,0,6,0.973856209150327
"180211903","CORRIENTES",233,232,1,0,0,1,0.995708154506438
"180211904","CORRIENTES",202,172,0,0,0,0,0.851485148514851
"180211905","CORRIENTES",297,270,4,15,1,20,0.909090909090909
"220360702","CHACO",25,0,5,9,7,21,0
"180211906","CORRIENTES",257,226,0,2,0,2,0.879377431906615
"180211907","CORRIENTES",226,224,0,0,0,0,0.991150442477876
"180211908","CORRIENTES",405,388,6,3,0,9,0.958024691358025
"180211909","CORRIENTES",332,321,6,2,0,8,0.966867469879518
"180211910","CORRIENTES",127,102,0,0,0,0,0.803149606299213
"180211911","CORRIENTES",296,291,4,1,0,5,0.983108108108108
"180211912","CORRIENTES",514,506,4,4,0,8,0.98443579766537
"180211913","CORRIENTES",196,184,3,6,0,9,0.938775510204082
"180211914","CORRIENTES",232,230,2,0,0,2,0.991379310344828
"180211915","CORRIENTES",297,218,32,41,4,77,0.734006734006734
"180211916","CORRIENTES",234,226,1,3,0,4,0.965811965811966
"180211917","CORRIENTES",181,177,0,4,0,4,0.977900552486188
"180211918","CORRIENTES",314,141,101,62,2,165,0.449044585987261
"180212001","CORRIENTES",396,330,27,25,0,52,0.833333333333333
"220360801","CHACO",16,0,5,7,0,12,0
"180212002","CORRIENTES",429,278,47,77,10,134,0.648018648018648
"180212003","CORRIENTES",477,337,77,54,1,132,0.706498951781971
"180212004","CORRIENTES",300,241,30,26,1,57,0.803333333333333
"180212005","CORRIENTES",251,179,23,43,0,66,0.713147410358566
"180212006","CORRIENTES",368,347,7,3,5,15,0.942934782608696
"180212007","CORRIENTES",308,288,10,7,1,18,0.935064935064935
"180212008","CORRIENTES",283,279,1,3,0,4,0.985865724381625
"180560107","CORRIENTES",156,3,134,16,0,150,0.0192307692307692
"180212009","CORRIENTES",288,162,75,49,1,125,0.5625
"180212010","CORRIENTES",338,98,124,107,2,233,0.289940828402367
"180212011","CORRIENTES",446,153,126,159,0,285,0.34304932735426
"180212012","CORRIENTES",302,97,135,66,0,201,0.321192052980132
"180212013","CORRIENTES",364,146,133,77,4,214,0.401098901098901
"180212103","CORRIENTES",392,342,15,22,0,37,0.872448979591837
"180212104","CORRIENTES",334,327,3,2,0,5,0.979041916167665
"180212105","CORRIENTES",177,176,1,0,0,1,0.994350282485876
"180212106","CORRIENTES",438,429,4,0,0,4,0.979452054794521
"180212107","CORRIENTES",353,251,30,56,1,87,0.711048158640227
"180212204","CORRIENTES",474,11,58,357,11,426,0.0232067510548523
"140560318","CORDOBA",188,0,172,9,3,184,0
"180212108","CORRIENTES",375,273,22,52,5,79,0.728
"180212109","CORRIENTES",282,147,60,66,0,126,0.521276595744681
"180212110","CORRIENTES",407,321,47,29,3,79,0.788697788697789
"180212111","CORRIENTES",400,333,44,16,0,60,0.8325
"180212112","CORRIENTES",409,351,12,25,1,38,0.858190709046455
"180212201","CORRIENTES",175,132,7,9,0,16,0.754285714285714
"180212202","CORRIENTES",275,108,71,67,1,139,0.392727272727273
"180212203","CORRIENTES",369,156,57,104,37,198,0.422764227642276
"221330308","CHACO",65,0,14,35,10,59,0
"180212205","CORRIENTES",309,24,73,152,22,247,0.0776699029126214
"180212206","CORRIENTES",310,34,57,172,9,238,0.109677419354839
"180212207","CORRIENTES",486,72,82,239,35,356,0.148148148148148
"180212208","CORRIENTES",274,127,24,97,4,125,0.463503649635036
"180280309","CORRIENTES",374,1,76,93,143,312,0.00267379679144385
"180212209","CORRIENTES",400,159,142,87,3,232,0.3975
"180212210","CORRIENTES",329,187,59,70,1,130,0.56838905775076
"180212211","CORRIENTES",368,344,5,10,4,19,0.934782608695652
"180212212","CORRIENTES",486,414,27,34,1,62,0.851851851851852
"140490316","CORDOBA",216,1,192,18,2,212,0.00462962962962963
"180212301","CORRIENTES",462,229,76,127,2,205,0.495670995670996
"180212302","CORRIENTES",400,220,44,125,0,169,0.55
"180212303","CORRIENTES",404,313,9,55,1,65,0.774752475247525
"180212304","CORRIENTES",323,247,48,22,1,71,0.764705882352941
"180212305","CORRIENTES",413,396,10,6,0,16,0.958837772397094
"220360802","CHACO",4,0,0,2,0,2,0
"180212306","CORRIENTES",273,222,17,30,0,47,0.813186813186813
"180212307","CORRIENTES",365,239,99,11,1,111,0.654794520547945
"180280302","CORRIENTES",15,0,5,6,4,15,0
"180212308","CORRIENTES",298,298,0,0,0,0,1
"180212309","CORRIENTES",351,350,0,0,0,0,0.997150997150997
"180212310","CORRIENTES",352,311,24,14,0,38,0.883522727272727
"180212311","CORRIENTES",392,229,69,92,0,161,0.584183673469388
"180212312","CORRIENTES",406,108,128,149,0,277,0.266009852216749
"180212313","CORRIENTES",401,393,0,8,0,8,0.980049875311721
"180212314","CORRIENTES",116,11,36,62,1,99,0.0948275862068965
"180280101","CORRIENTES",413,77,115,92,101,308,0.186440677966102
"180280102","CORRIENTES",183,0,83,62,32,177,0
"180280103","CORRIENTES",297,3,206,48,37,291,0.0101010101010101
"180280201","CORRIENTES",21,0,12,2,7,21,0
"180280202","CORRIENTES",27,0,7,8,11,26,0
"181120205","CORRIENTES",32,1,22,9,0,31,0.03125
"180280301","CORRIENTES",560,3,177,170,139,486,0.00535714285714286
"180280303","CORRIENTES",85,0,19,28,34,81,0
"180280304","CORRIENTES",5,0,2,1,0,3,0
"180280305","CORRIENTES",18,0,3,3,8,14,0
"180280306","CORRIENTES",36,0,2,14,17,33,0
"180280307","CORRIENTES",39,0,10,4,21,35,0
"180280308","CORRIENTES",171,0,29,60,67,156,0
"180280310","CORRIENTES",268,4,154,77,23,254,0.0149253731343284
"180280311","CORRIENTES",337,10,152,119,48,319,0.029673590504451
"180280312","CORRIENTES",538,7,245,161,96,502,0.0130111524163569
"180280410","CORRIENTES",36,1,7,9,6,22,0.0277777777777778
"180280401","CORRIENTES",235,1,145,58,16,219,0.00425531914893617
"180280402","CORRIENTES",21,0,8,7,0,15,0
"180280403","CORRIENTES",45,0,5,22,10,37,0
"180280404","CORRIENTES",6,0,3,0,2,5,0
"180280405","CORRIENTES",138,21,25,35,47,107,0.152173913043478
"141611113","CORDOBA",261,252,7,2,0,9,0.96551724137931
"180280406","CORRIENTES",143,1,67,52,16,135,0.00699300699300699
"180280407","CORRIENTES",123,0,41,28,47,116,0
"180280408","CORRIENTES",79,1,32,17,11,60,0.0126582278481013
"180280409","CORRIENTES",94,2,26,31,29,86,0.0212765957446809
"180280411","CORRIENTES",67,6,33,6,16,55,0.0895522388059701
"180280412","CORRIENTES",161,0,63,43,40,146,0
"180280413","CORRIENTES",126,1,37,54,31,122,0.00793650793650794
"180280501","CORRIENTES",19,0,3,13,1,17,0
"180280502","CORRIENTES",22,1,14,3,0,17,0.0454545454545455
"180350102","CORRIENTES",206,55,35,95,4,134,0.266990291262136
"180280503","CORRIENTES",17,0,17,0,0,17,0
"141401403","CORDOBA",241,191,33,16,0,49,0.79253112033195
"180351808","CORRIENTES",343,284,25,30,0,55,0.82798833819242
"180280601","CORRIENTES",25,0,12,9,4,25,0
"180280602","CORRIENTES",4,0,4,0,0,4,0
"180280603","CORRIENTES",22,0,1,3,18,22,0
"180350101","CORRIENTES",294,199,25,41,1,67,0.67687074829932
"141190908","CORDOBA",241,33,198,10,0,208,0.136929460580913
"180280604","CORRIENTES",85,4,13,41,15,69,0.0470588235294118
"180280605","CORRIENTES",12,0,1,4,4,9,0
"180280606","CORRIENTES",20,0,8,3,4,15,0
"180280701","CORRIENTES",64,0,21,15,27,63,0
"180280702","CORRIENTES",149,106,13,19,8,40,0.711409395973154
"140490315","CORDOBA",121,2,114,5,0,119,0.0165289256198347
"180280703","CORRIENTES",23,0,5,6,2,13,0
"180280704","CORRIENTES",16,0,2,3,6,11,0
"180280705","CORRIENTES",26,0,13,3,5,21,0
"180280706","CORRIENTES",24,0,13,2,7,22,0
"180280707","CORRIENTES",16,0,3,1,3,7,0
"180351913","CORRIENTES",289,183,28,49,2,79,0.633217993079585
"180350103","CORRIENTES",342,132,36,148,3,187,0.385964912280702
"180350104","CORRIENTES",300,255,17,25,0,42,0.85
"180350105","CORRIENTES",321,315,4,2,0,6,0.981308411214953
"180350106","CORRIENTES",155,154,1,0,0,1,0.993548387096774
"180350107","CORRIENTES",189,187,1,0,0,1,0.989417989417989
"180350108","CORRIENTES",171,168,2,1,0,3,0.982456140350877
"180350109","CORRIENTES",232,196,14,4,0,18,0.844827586206897
"180350110","CORRIENTES",212,174,11,20,1,32,0.820754716981132
"180350111","CORRIENTES",294,193,26,55,1,82,0.656462585034014
"180350112","CORRIENTES",220,141,34,28,10,72,0.640909090909091
"180350113","CORRIENTES",232,205,13,9,0,22,0.883620689655172
"180702010","CORRIENTES",222,170,19,22,2,43,0.765765765765766
"180350114","CORRIENTES",6,1,3,2,0,5,0.166666666666667
"180350115","CORRIENTES",225,45,33,134,1,168,0.2
"180350116","CORRIENTES",201,11,39,140,3,182,0.054726368159204
"180350201","CORRIENTES",34,1,21,10,2,33,0.0294117647058824
"180350501","CORRIENTES",114,0,32,73,3,108,0
"141401402","CORDOBA",263,164,87,11,0,98,0.623574144486692
"180350301","CORRIENTES",50,0,11,33,4,48,0
"180350302","CORRIENTES",33,0,11,17,2,30,0
"180351506","CORRIENTES",110,0,15,66,14,95,0
"180350303","CORRIENTES",41,2,9,17,1,27,0.0487804878048781
"180350401","CORRIENTES",17,1,9,7,0,16,0.0588235294117647
"180350402","CORRIENTES",33,0,14,16,0,30,0
"221330306","CHACO",44,1,4,23,8,35,0.0227272727272727
"180350502","CORRIENTES",78,3,33,36,0,69,0.0384615384615385
"180350503","CORRIENTES",12,0,8,4,0,12,0
"180350601","CORRIENTES",30,0,17,7,3,27,0
"180350602","CORRIENTES",25,0,11,14,0,25,0
"180350603","CORRIENTES",114,5,34,51,7,92,0.043859649122807
"180350701","CORRIENTES",41,0,26,10,5,41,0
"180350702","CORRIENTES",19,0,14,2,1,17,0
"180351507","CORRIENTES",9,0,3,3,2,8,0
"180350801","CORRIENTES",21,0,13,3,0,16,0
"180351509","CORRIENTES",27,0,3,11,9,23,0
"180351510","CORRIENTES",229,51,106,62,6,174,0.222707423580786
"180350802","CORRIENTES",73,0,31,33,5,69,0
"180350901","CORRIENTES",18,0,3,13,1,17,0
"180351511","CORRIENTES",202,91,26,63,8,97,0.450495049504951
"180350902","CORRIENTES",30,0,10,19,1,30,0
"180351001","CORRIENTES",16,0,0,14,0,14,0
"180351002","CORRIENTES",6,0,0,6,0,6,0
"180351102","CORRIENTES",36,0,7,28,1,36,0
"180351101","CORRIENTES",147,3,40,89,2,131,0.0204081632653061
"180351806","CORRIENTES",173,173,0,0,0,0,1
"180351807","CORRIENTES",310,306,4,0,0,4,0.987096774193548
"180420102","CORRIENTES",328,8,258,48,5,311,0.024390243902439
"180351201","CORRIENTES",44,0,6,27,11,44,0
"180351809","CORRIENTES",285,223,30,28,0,58,0.782456140350877
"180351810","CORRIENTES",308,140,38,109,3,150,0.454545454545455
"180351811","CORRIENTES",173,124,12,29,0,41,0.716763005780347
"180420101","CORRIENTES",240,42,155,37,2,194,0.175
"180351202","CORRIENTES",15,0,0,12,2,14,0
"180351502","CORRIENTES",291,0,42,171,28,241,0
"180351203","CORRIENTES",24,1,14,5,4,23,0.0416666666666667
"180351301","CORRIENTES",70,0,24,37,2,63,0
"180351901","CORRIENTES",119,47,17,44,2,63,0.394957983193277
"180351902","CORRIENTES",223,134,22,60,1,83,0.600896860986547
"180351302","CORRIENTES",25,0,2,17,1,20,0
"180351503","CORRIENTES",29,0,5,9,12,26,0
"180351504","CORRIENTES",30,0,3,21,0,24,0
"180351505","CORRIENTES",26,0,16,8,0,24,0
"180351303","CORRIENTES",74,2,11,39,16,66,0.027027027027027
"180351401","CORRIENTES",147,0,15,45,19,79,0
"180351402","CORRIENTES",39,0,2,29,4,35,0
"180351501","CORRIENTES",308,64,89,116,19,224,0.207792207792208
"180351508","CORRIENTES",26,0,3,9,13,25,0
"180351903","CORRIENTES",347,295,8,38,0,46,0.85014409221902
"180351904","CORRIENTES",356,313,11,20,2,33,0.879213483146067
"180351601","CORRIENTES",20,0,10,3,7,20,0
"180351905","CORRIENTES",302,222,31,43,0,74,0.735099337748344
"180351906","CORRIENTES",200,199,0,1,0,1,0.995
"180351602","CORRIENTES",20,0,4,13,0,17,0
"180351907","CORRIENTES",177,159,0,1,0,1,0.898305084745763
"180351701","CORRIENTES",12,0,1,5,1,7,0
"180351908","CORRIENTES",140,126,3,10,0,13,0.9
"180351909","CORRIENTES",202,190,4,6,0,10,0.940594059405941
"180351910","CORRIENTES",224,191,7,18,2,27,0.852678571428571
"180351911","CORRIENTES",172,172,0,0,0,0,1
"180351702","CORRIENTES",11,0,4,6,0,10,0
"180351801","CORRIENTES",357,353,1,1,0,2,0.988795518207283
"180351802","CORRIENTES",377,373,3,1,0,4,0.989389920424403
"180351803","CORRIENTES",182,176,6,0,0,6,0.967032967032967
"180351804","CORRIENTES",216,164,16,29,0,45,0.759259259259259
"180351805","CORRIENTES",326,313,4,9,0,13,0.960122699386503
"141190907","CORDOBA",209,10,182,9,7,198,0.0478468899521531
"180420103","CORRIENTES",218,4,146,53,1,200,0.018348623853211
"180420104","CORRIENTES",361,89,182,51,20,253,0.246537396121884
"180420105","CORRIENTES",209,21,112,48,10,170,0.100478468899522
"180700209","CORRIENTES",52,0,13,26,2,41,0
"220430105","CHACO",240,0,98,92,12,202,0
"221401205","CHACO",206,205,1,0,0,1,0.995145631067961
"180420106","CORRIENTES",243,4,105,96,16,217,0.0164609053497942
"180420107","CORRIENTES",296,26,187,65,2,254,0.0878378378378378
"180420108","CORRIENTES",295,5,220,57,7,284,0.0169491525423729
"180420109","CORRIENTES",234,4,151,59,3,213,0.0170940170940171
"180420201","CORRIENTES",8,0,3,2,3,8,0
"180420202","CORRIENTES",67,0,13,28,18,59,0
"180560404","CORRIENTES",6,0,0,6,0,6,0
"180420203","CORRIENTES",8,0,1,5,2,8,0
"180420301","CORRIENTES",107,0,28,48,23,99,0
"180490202","CORRIENTES",129,1,41,39,26,106,0.00775193798449612
"180490203","CORRIENTES",59,0,8,24,6,38,0
"180420204","CORRIENTES",36,0,13,15,3,31,0
"180420302","CORRIENTES",25,1,3,9,12,24,0.04
"180420305","CORRIENTES",55,0,6,34,8,48,0
"180420306","CORRIENTES",54,0,5,26,3,34,0
"180490204","CORRIENTES",21,0,2,11,1,14,0
"180490205","CORRIENTES",16,0,5,3,6,14,0
"221400418","CHACO",136,6,101,10,1,112,0.0441176470588235
"180420303","CORRIENTES",28,0,9,12,4,25,0
"180420304","CORRIENTES",132,1,49,50,13,112,0.00757575757575758
"180490206","CORRIENTES",9,0,1,7,1,9,0
"180560602","CORRIENTES",2,0,1,1,0,2,0
"180420307","CORRIENTES",160,0,52,71,16,139,0
"180420501","CORRIENTES",93,0,18,45,15,78,0
"180420308","CORRIENTES",22,0,2,10,7,19,0
"180420401","CORRIENTES",43,0,11,24,7,42,0
"180420402","CORRIENTES",14,0,1,11,1,13,0
"180490303","CORRIENTES",25,0,7,14,2,23,0
"180490304","CORRIENTES",36,0,12,18,6,36,0
"141190906","CORDOBA",226,10,193,18,5,216,0.0442477876106195
"180420403","CORRIENTES",50,0,29,5,13,47,0
"180420404","CORRIENTES",21,0,0,7,7,14,0
"180420405","CORRIENTES",30,0,1,29,0,30,0
"180700101","CORRIENTES",259,216,12,12,8,32,0.833976833976834
"180420502","CORRIENTES",67,3,17,32,10,59,0.0447761194029851
"180420506","CORRIENTES",190,0,63,86,25,174,0
"180420507","CORRIENTES",157,1,78,35,10,123,0.00636942675159236
"180420503","CORRIENTES",70,0,5,42,10,57,0
"180420603","CORRIENTES",0,0,0,0,0,0,NA
"180490305","CORRIENTES",35,0,3,27,4,34,0
"180420504","CORRIENTES",147,0,24,67,25,116,0
"180420505","CORRIENTES",34,0,16,14,2,32,0
"180420601","CORRIENTES",2,0,0,0,0,0,0
"180490107","CORRIENTES",270,222,33,13,2,48,0.822222222222222
"180490108","CORRIENTES",207,194,9,4,0,13,0.93719806763285
"180420602","CORRIENTES",11,0,0,0,4,4,0
"180700102","CORRIENTES",253,251,1,1,0,2,0.992094861660079
"180490101","CORRIENTES",240,37,74,68,45,187,0.154166666666667
"180490114","CORRIENTES",219,61,67,78,11,156,0.278538812785388
"180490115","CORRIENTES",192,91,43,40,1,84,0.473958333333333
"180490116","CORRIENTES",388,252,66,42,21,129,0.649484536082474
"180700103","CORRIENTES",284,279,3,2,0,5,0.982394366197183
"180700104","CORRIENTES",213,171,20,17,0,37,0.802816901408451
"180490102","CORRIENTES",248,49,63,97,25,185,0.19758064516129
"180490117","CORRIENTES",301,113,77,80,17,174,0.375415282392027
"180702104","CORRIENTES",336,156,49,113,6,168,0.464285714285714
"180490118","CORRIENTES",171,76,47,38,1,86,0.444444444444444
"180490103","CORRIENTES",397,163,65,99,50,214,0.410579345088161
"180490104","CORRIENTES",378,236,42,77,14,133,0.624338624338624
"180490105","CORRIENTES",188,106,37,43,1,81,0.563829787234043
"180490106","CORRIENTES",169,157,9,2,1,12,0.928994082840237
"180702105","CORRIENTES",319,126,112,65,4,181,0.394984326018809
"180490201","CORRIENTES",30,0,2,17,3,22,0
"180700105","CORRIENTES",233,143,56,25,5,86,0.613733905579399
"180490109","CORRIENTES",305,211,35,44,9,88,0.691803278688525
"180490110","CORRIENTES",328,314,9,3,1,13,0.957317073170732
"180490111","CORRIENTES",191,133,43,13,0,56,0.696335078534031
"180490112","CORRIENTES",214,140,48,23,1,72,0.654205607476635
"180490113","CORRIENTES",377,132,95,98,34,227,0.350132625994695
"180700106","CORRIENTES",273,260,6,5,0,11,0.952380952380952
"180490207","CORRIENTES",217,100,57,32,12,101,0.460829493087558
"180490301","CORRIENTES",284,0,74,163,31,268,0
"180701602","CORRIENTES",40,0,12,22,2,36,0
"180490302","CORRIENTES",6,0,4,2,0,6,0
"180490306","CORRIENTES",200,0,31,92,51,174,0
"180490307","CORRIENTES",98,1,36,43,3,82,0.0102040816326531
"180490308","CORRIENTES",254,20,138,77,8,223,0.078740157480315
"180490603","CORRIENTES",16,0,0,1,8,9,0
"180700107","CORRIENTES",266,266,0,0,0,0,1
"180490401","CORRIENTES",70,1,4,31,34,69,0.0142857142857143
"180560108","CORRIENTES",140,4,75,58,1,134,0.0285714285714286
"180702106","CORRIENTES",238,22,166,44,0,210,0.092436974789916
"180490404","CORRIENTES",39,0,0,14,16,30,0
"180490405","CORRIENTES",44,0,5,8,16,29,0
"180490501","CORRIENTES",73,0,10,44,13,67,0
"180490502","CORRIENTES",16,0,2,5,8,15,0
"180490402","CORRIENTES",72,0,14,47,10,71,0
"180490403","CORRIENTES",29,0,0,19,5,24,0
"180490703","CORRIENTES",150,1,33,70,27,130,0.00666666666666667
"180490601","CORRIENTES",16,0,5,10,1,16,0
"180490602","CORRIENTES",11,0,3,7,1,11,0
"180490704","CORRIENTES",217,1,21,106,80,207,0.00460829493087558
"180490705","CORRIENTES",16,0,0,12,1,13,0
"180560109","CORRIENTES",156,1,130,19,2,151,0.00641025641025641
"180630503","CORRIENTES",55,0,3,8,41,52,0
"180490503","CORRIENTES",4,0,0,0,1,1,0
"180490701","CORRIENTES",629,183,150,151,91,392,0.29093799682035
"180490801","CORRIENTES",43,0,5,25,12,42,0
"180490902","CORRIENTES",46,0,3,1,37,41,0
"180490903","CORRIENTES",17,0,1,4,2,7,0
"180700108","CORRIENTES",241,228,3,6,2,11,0.946058091286307
"180700109","CORRIENTES",229,209,3,15,1,19,0.912663755458515
"180490904","CORRIENTES",19,0,5,7,1,13,0
"180490802","CORRIENTES",61,0,8,26,22,56,0
"180490901","CORRIENTES",9,0,0,0,9,9,0
"180491001","CORRIENTES",116,0,19,13,81,113,0
"180491002","CORRIENTES",45,0,15,6,23,44,0
"180560401","CORRIENTES",39,3,22,9,4,35,0.0769230769230769
"180491003","CORRIENTES",14,0,0,9,5,14,0
"180491101","CORRIENTES",17,0,0,1,11,12,0
"180560101","CORRIENTES",254,55,51,127,12,190,0.216535433070866
"180560106","CORRIENTES",160,48,65,45,1,111,0.3
"180560102","CORRIENTES",239,29,124,78,5,207,0.121338912133891
"180560103","CORRIENTES",325,46,94,148,20,262,0.141538461538462
"141190905","CORDOBA",256,10,213,29,1,243,0.0390625
"180560104","CORRIENTES",314,171,56,74,3,133,0.544585987261146
"180560105","CORRIENTES",162,46,83,28,1,112,0.283950617283951
"221401206","CHACO",264,257,0,0,0,0,0.973484848484849
"180560110","CORRIENTES",118,4,47,51,3,101,0.0338983050847458
"180560402","CORRIENTES",16,0,4,8,0,12,0
"180700110","CORRIENTES",243,165,26,48,2,76,0.679012345679012
"180560201","CORRIENTES",87,0,29,44,11,84,0
"180700113","CORRIENTES",219,159,11,32,6,49,0.726027397260274
"180630504","CORRIENTES",16,0,2,13,1,16,0
"180560202","CORRIENTES",35,0,2,20,13,35,0
"180560403","CORRIENTES",12,0,4,6,1,11,0
"180560504","CORRIENTES",5,0,2,2,1,5,0
"180560603","CORRIENTES",3,0,0,3,0,3,0
"180560604","CORRIENTES",10,0,4,5,1,10,0
"180560605","CORRIENTES",2,0,1,0,1,2,0
"180630601","CORRIENTES",26,0,1,14,8,23,0
"180560301","CORRIENTES",71,0,10,53,5,68,0
"180560302","CORRIENTES",18,0,2,15,0,17,0
"180560303","CORRIENTES",15,0,3,8,4,15,0
"180700111","CORRIENTES",333,254,36,37,3,76,0.762762762762763
"180560501","CORRIENTES",10,0,5,2,1,8,0
"180700112","CORRIENTES",234,172,10,41,3,54,0.735042735042735
"221401207","CHACO",249,244,1,4,0,5,0.979919678714859
"180560502","CORRIENTES",10,0,2,6,0,8,0
"180560503","CORRIENTES",17,0,1,12,4,17,0
"180700114","CORRIENTES",256,203,24,26,0,50,0.79296875
"180630101","CORRIENTES",485,319,102,34,22,158,0.657731958762887
"180630102","CORRIENTES",364,240,39,34,42,115,0.659340659340659
"180700115","CORRIENTES",300,253,12,22,1,35,0.843333333333333
"180630103","CORRIENTES",230,94,49,48,33,130,0.408695652173913
"180630104","CORRIENTES",272,140,42,54,33,129,0.514705882352941
"180560601","CORRIENTES",5,0,0,4,0,4,0
"180700116","CORRIENTES",205,112,36,46,1,83,0.546341463414634
"180630201","CORRIENTES",196,89,53,32,4,89,0.454081632653061
"180630202","CORRIENTES",340,183,85,52,12,149,0.538235294117647
"180630205","CORRIENTES",201,11,96,76,8,180,0.054726368159204
"180700117","CORRIENTES",232,117,47,46,2,95,0.504310344827586
"181680723","CORRIENTES",227,205,4,11,0,15,0.903083700440529
"180630206","CORRIENTES",230,139,32,23,32,87,0.604347826086956
"180630401","CORRIENTES",123,3,69,33,13,115,0.024390243902439
"180630203","CORRIENTES",32,0,10,19,1,30,0
"180630204","CORRIENTES",138,38,23,26,47,96,0.27536231884058
"180630303","CORRIENTES",64,0,7,5,38,50,0
"180630301","CORRIENTES",138,0,20,22,81,123,0
"180630302","CORRIENTES",20,0,1,4,15,20,0
"180700118","CORRIENTES",91,4,25,53,4,82,0.043956043956044
"180630304","CORRIENTES",42,2,1,29,8,38,0.0476190476190476
"180630402","CORRIENTES",32,0,5,9,17,31,0
"180630403","CORRIENTES",6,0,1,5,0,6,0
"180630404","CORRIENTES",22,0,5,9,8,22,0
"180630405","CORRIENTES",3,0,1,1,0,2,0
"180700208","CORRIENTES",5,0,1,1,3,5,0
"220430106","CHACO",268,0,144,102,17,263,0
"180630406","CORRIENTES",37,0,19,9,4,32,0
"180630407","CORRIENTES",6,0,1,3,2,6,0
"180630408","CORRIENTES",8,0,0,3,3,6,0
"180630501","CORRIENTES",36,0,7,12,16,35,0
"180630705","CORRIENTES",87,0,11,21,55,87,0
"180630502","CORRIENTES",44,0,8,10,26,44,0
"180702107","CORRIENTES",87,2,37,37,5,79,0.0229885057471264
"180630602","CORRIENTES",27,0,0,13,12,25,0
"180630603","CORRIENTES",8,0,0,6,2,8,0
"180630706","CORRIENTES",38,0,1,21,14,36,0
"180630701","CORRIENTES",137,0,21,49,64,134,0
"180630702","CORRIENTES",31,0,6,19,3,28,0
"180630703","CORRIENTES",52,0,6,4,32,42,0
"180630704","CORRIENTES",97,0,13,26,48,87,0
"180630801","CORRIENTES",28,0,5,6,17,28,0
"220210607","CHACO",265,0,27,125,82,234,0
"180630802","CORRIENTES",76,0,9,12,53,74,0
"180702108","CORRIENTES",182,4,33,100,14,147,0.021978021978022
"180630803","CORRIENTES",56,0,10,9,36,55,0
"180630804","CORRIENTES",111,0,28,10,60,98,0
"180630805","CORRIENTES",73,0,10,38,23,71,0
"180630806","CORRIENTES",131,1,90,29,11,130,0.00763358778625954
"180702109","CORRIENTES",305,65,133,91,6,230,0.213114754098361
"180630901","CORRIENTES",1,0,0,0,1,1,0
"180700201","CORRIENTES",173,50,21,30,25,76,0.289017341040462
"180700202","CORRIENTES",173,0,54,80,16,150,0
"180700203","CORRIENTES",148,3,57,54,17,128,0.0202702702702703
"180700204","CORRIENTES",92,1,56,23,4,83,0.0108695652173913
"180700205","CORRIENTES",30,0,11,11,4,26,0
"180700206","CORRIENTES",33,0,6,11,7,24,0
"180700207","CORRIENTES",27,0,2,6,13,21,0
"180700210","CORRIENTES",3,0,0,3,0,3,0
"180700301","CORRIENTES",185,0,54,71,45,170,0
"180700402","CORRIENTES",40,0,0,27,8,35,0
"180702110","CORRIENTES",259,36,86,116,13,215,0.138996138996139
"180700302","CORRIENTES",107,1,10,55,28,93,0.00934579439252336
"180700303","CORRIENTES",40,0,7,18,15,40,0
"180700401","CORRIENTES",30,0,3,11,16,30,0
"180701004","CORRIENTES",43,0,9,13,10,32,0
"180702013","CORRIENTES",264,214,35,14,1,50,0.810606060606061
"180702111","CORRIENTES",245,22,114,89,7,210,0.0897959183673469
"180700403","CORRIENTES",22,0,1,13,4,18,0
"180700404","CORRIENTES",24,0,1,7,15,23,0
"180700501","CORRIENTES",61,1,15,15,30,60,0.0163934426229508
"180702014","CORRIENTES",211,203,4,3,0,7,0.962085308056872
"180700502","CORRIENTES",37,0,13,7,8,28,0
"180700503","CORRIENTES",10,0,2,5,2,9,0
"180700603","CORRIENTES",31,0,6,9,8,23,0
"220070509","CHACO",326,2,74,106,80,260,0.00613496932515337
"141190802","CORDOBA",212,1,184,18,2,204,0.00471698113207547
"180702101","CORRIENTES",200,192,3,3,0,6,0.96
"180700601","CORRIENTES",25,0,1,13,8,22,0
"180700602","CORRIENTES",12,0,7,4,0,11,0
"180702002","CORRIENTES",221,216,2,2,1,5,0.97737556561086
"180700701","CORRIENTES",30,0,9,11,8,28,0
"180700801","CORRIENTES",56,0,8,28,9,45,0
"180700702","CORRIENTES",7,0,7,0,0,7,0
"180700703","CORRIENTES",13,0,8,1,4,13,0
"180700802","CORRIENTES",47,0,6,16,24,46,0
"180702003","CORRIENTES",212,202,4,6,0,10,0.952830188679245
"180700803","CORRIENTES",58,0,12,21,21,54,0
"180700804","CORRIENTES",79,0,20,21,31,72,0
"180701001","CORRIENTES",31,0,4,15,7,26,0
"180702004","CORRIENTES",353,353,0,0,0,0,1
"180700901","CORRIENTES",50,1,8,21,6,35,0.02
"180700902","CORRIENTES",61,0,17,26,6,49,0
"180701002","CORRIENTES",53,0,9,14,22,45,0
"180701003","CORRIENTES",115,0,14,33,40,87,0
"180701005","CORRIENTES",111,0,1,55,7,63,0
"180701101","CORRIENTES",85,0,14,25,36,75,0
"180701102","CORRIENTES",103,0,10,16,53,79,0
"180701502","CORRIENTES",67,1,35,15,3,53,0.0149253731343284
"180702011","CORRIENTES",217,205,8,3,1,12,0.944700460829493
"180701201","CORRIENTES",186,1,67,54,35,156,0.00537634408602151
"180701202","CORRIENTES",70,0,13,20,36,69,0
"180701203","CORRIENTES",50,0,12,26,5,43,0
"180701403","CORRIENTES",124,0,9,33,19,61,0
"180702012","CORRIENTES",242,237,2,0,0,2,0.979338842975207
"180702102","CORRIENTES",19,1,14,4,0,18,0.0526315789473684
"180701204","CORRIENTES",96,0,25,37,25,87,0
"180701301","CORRIENTES",104,0,9,51,27,87,0
"180701302","CORRIENTES",34,0,5,7,18,30,0
"180701303","CORRIENTES",167,0,20,71,54,145,0
"180701404","CORRIENTES",72,2,11,38,15,64,0.0277777777777778
"180701501","CORRIENTES",62,0,16,33,11,60,0
"180701304","CORRIENTES",17,0,7,6,1,14,0
"180701401","CORRIENTES",106,0,10,52,29,91,0
"180701402","CORRIENTES",92,0,8,28,55,91,0
"180701503","CORRIENTES",111,0,10,53,20,83,0
"180701504","CORRIENTES",13,0,0,4,8,12,0
"180701505","CORRIENTES",33,2,7,12,4,23,0.0606060606060606
"180701506","CORRIENTES",331,328,0,0,0,0,0.990936555891239
"180701507","CORRIENTES",292,270,2,20,0,22,0.924657534246575
"180701508","CORRIENTES",383,381,1,1,0,2,0.994778067885117
"180701509","CORRIENTES",350,331,0,0,0,0,0.945714285714286
"180701601","CORRIENTES",82,2,38,17,7,62,0.024390243902439
"180701603","CORRIENTES",59,0,19,23,11,53,0
"180701604","CORRIENTES",60,0,10,33,11,54,0
"180701605","CORRIENTES",64,0,37,22,3,62,0
"180701606","CORRIENTES",71,0,23,19,19,61,0
"180701607","CORRIENTES",93,0,39,22,15,76,0
"180702015","CORRIENTES",192,192,0,0,0,0,1
"180702016","CORRIENTES",271,271,0,0,0,0,1
"180702103","CORRIENTES",386,341,23,18,1,42,0.883419689119171
"180701701","CORRIENTES",62,0,18,19,18,55,0
"180701702","CORRIENTES",16,0,7,5,4,16,0
"180701703","CORRIENTES",64,18,9,17,6,32,0.28125
"180701704","CORRIENTES",23,0,5,10,4,19,0
"180701801","CORRIENTES",65,0,12,28,11,51,0
"180701802","CORRIENTES",75,0,20,28,18,66,0
"180701803","CORRIENTES",81,0,45,21,8,74,0
"180702212","CORRIENTES",382,345,6,29,2,37,0.903141361256545
"180701901","CORRIENTES",5,0,0,0,5,5,0
"180701902","CORRIENTES",145,0,6,45,39,90,0
"180702005","CORRIENTES",286,268,4,10,0,14,0.937062937062937
"180701903","CORRIENTES",6,0,0,0,1,1,0
"180701904","CORRIENTES",13,0,0,0,1,1,0
"180701907","CORRIENTES",4,0,0,0,1,1,0
"180702006","CORRIENTES",298,267,16,2,2,20,0.895973154362416
"180702007","CORRIENTES",260,208,26,22,4,52,0.8
"180702008","CORRIENTES",346,265,33,44,0,77,0.765895953757225
"180702009","CORRIENTES",268,251,1,14,0,15,0.936567164179104
"180701905","CORRIENTES",14,0,0,1,0,1,0
"180701906","CORRIENTES",0,0,0,0,0,0,NA
"180701908","CORRIENTES",3,0,0,0,0,0,0
"180701909","CORRIENTES",25,0,0,0,6,6,0
"180702001","CORRIENTES",231,230,0,0,1,1,0.995670995670996
"740351106","SAN LUIS",214,212,1,1,0,2,0.990654205607477
"180702112","CORRIENTES",264,112,28,65,30,123,0.424242424242424
"180702113","CORRIENTES",362,12,109,186,29,324,0.0331491712707182
"180702114","CORRIENTES",234,7,119,94,5,218,0.0299145299145299
"180702115","CORRIENTES",370,279,39,38,0,77,0.754054054054054
"180702116","CORRIENTES",313,162,61,69,0,130,0.517571884984026
"180702117","CORRIENTES",259,73,52,87,22,161,0.281853281853282
"180702201","CORRIENTES",384,165,64,99,7,170,0.4296875
"180702202","CORRIENTES",343,24,103,174,28,305,0.0699708454810496
"180702203","CORRIENTES",311,67,184,58,1,243,0.215434083601286
"180702204","CORRIENTES",421,41,228,132,9,369,0.0973871733966746
"180702205","CORRIENTES",214,71,48,74,1,123,0.331775700934579
"180702206","CORRIENTES",343,102,126,103,2,231,0.297376093294461
"180702207","CORRIENTES",225,184,21,16,2,39,0.817777777777778
"180702208","CORRIENTES",251,20,60,137,19,216,0.0796812749003984
"180702209","CORRIENTES",205,199,4,1,0,5,0.970731707317073
"180702210","CORRIENTES",456,327,50,44,19,113,0.717105263157895
"180702211","CORRIENTES",24,0,1,8,13,22,0
"180702213","CORRIENTES",323,323,0,0,0,0,1
"180702214","CORRIENTES",261,215,17,19,8,44,0.823754789272031
"180702215","CORRIENTES",357,237,6,76,19,101,0.663865546218487
"180702216","CORRIENTES",287,155,62,38,5,105,0.54006968641115
"180702217","CORRIENTES",273,214,19,23,1,43,0.783882783882784
"180702218","CORRIENTES",316,14,139,137,4,280,0.0443037974683544
"180770101","CORRIENTES",199,7,61,107,17,185,0.0351758793969849
"180770102","CORRIENTES",161,66,66,27,0,93,0.409937888198758
"180770201","CORRIENTES",168,34,31,58,17,106,0.202380952380952
"141401808","CORDOBA",294,2,261,17,1,279,0.00680272108843537
"180770103","CORRIENTES",320,65,160,86,5,251,0.203125
"180770104","CORRIENTES",314,134,88,84,2,174,0.426751592356688
"180770206","CORRIENTES",13,2,0,8,1,9,0.153846153846154
"180770105","CORRIENTES",209,86,66,47,3,116,0.411483253588517
"180770106","CORRIENTES",216,21,110,76,4,190,0.0972222222222222
"180770202","CORRIENTES",86,1,46,25,2,73,0.0116279069767442
"180770203","CORRIENTES",68,2,24,30,4,58,0.0294117647058824
"180770204","CORRIENTES",94,3,44,27,4,75,0.0319148936170213
"180770205","CORRIENTES",67,0,40,23,1,64,0
"180770207","CORRIENTES",14,0,6,3,5,14,0
"180770208","CORRIENTES",146,119,17,6,2,25,0.815068493150685
"180770301","CORRIENTES",165,0,76,48,30,154,0
"180770302","CORRIENTES",56,0,12,30,6,48,0
"180770401","CORRIENTES",23,0,9,11,2,22,0
"180770402","CORRIENTES",76,2,2,64,2,68,0.0263157894736842
"180770501","CORRIENTES",23,0,8,7,6,21,0
"180770502","CORRIENTES",32,0,12,7,4,23,0
"180770503","CORRIENTES",5,0,0,4,1,5,0
"180840104","CORRIENTES",190,7,103,54,20,177,0.0368421052631579
"180840105","CORRIENTES",227,12,164,42,2,208,0.052863436123348
"180840106","CORRIENTES",247,1,142,95,5,242,0.00404858299595142
"180770601","CORRIENTES",0,0,0,0,0,0,NA
"180840112","CORRIENTES",303,224,51,25,0,76,0.739273927392739
"180770602","CORRIENTES",1,0,0,0,1,1,0
"180840107","CORRIENTES",374,22,240,84,9,333,0.0588235294117647
"180840108","CORRIENTES",297,15,213,62,5,280,0.0505050505050505
"141401316","CORDOBA",266,74,182,10,0,192,0.278195488721804
"180770603","CORRIENTES",0,0,0,0,0,0,NA
"180841104","CORRIENTES",81,3,23,32,18,73,0.037037037037037
"180840101","CORRIENTES",346,3,120,147,56,323,0.00867052023121387
"180840102","CORRIENTES",222,3,149,62,4,215,0.0135135135135135
"180840103","CORRIENTES",244,4,153,77,4,234,0.0163934426229508
"180840109","CORRIENTES",238,31,152,53,1,206,0.130252100840336
"180840110","CORRIENTES",224,82,120,21,0,141,0.366071428571429
"180840111","CORRIENTES",246,152,73,17,2,92,0.617886178861789
"180840113","CORRIENTES",221,221,0,0,0,0,1
"180840114","CORRIENTES",311,306,1,1,2,4,0.983922829581994
"181330507","CORRIENTES",64,3,52,8,0,60,0.046875
"180840115","CORRIENTES",306,305,1,0,0,1,0.996732026143791
"180840116","CORRIENTES",326,326,0,0,0,0,1
"180910109","CORRIENTES",225,162,33,23,2,58,0.72
"180840117","CORRIENTES",128,112,5,11,0,16,0.875
"180840118","CORRIENTES",445,25,228,113,45,386,0.0561797752808989
"180840201","CORRIENTES",293,8,83,128,58,269,0.0273037542662116
"180980402","CORRIENTES",25,0,4,9,11,24,0
"180840202","CORRIENTES",14,0,6,8,0,14,0
"180840203","CORRIENTES",71,0,22,29,19,70,0
"180840204","CORRIENTES",134,1,34,60,33,127,0.00746268656716418
"180980403","CORRIENTES",52,0,5,7,34,46,0
"180840205","CORRIENTES",234,113,34,41,31,106,0.482905982905983
"180910504","CORRIENTES",37,0,8,18,6,32,0
"180840206","CORRIENTES",7,0,4,3,0,7,0
"180840301","CORRIENTES",71,0,6,42,21,69,0
"180840306","CORRIENTES",36,0,3,9,20,32,0
"180840401","CORRIENTES",3,0,0,1,2,3,0
"180840702","CORRIENTES",10,0,2,4,2,8,0
"181052111","CORRIENTES",314,93,182,24,2,208,0.296178343949045
"180980501","CORRIENTES",19,0,10,0,9,19,0
"180840302","CORRIENTES",21,0,1,15,2,18,0
"180840303","CORRIENTES",6,0,0,3,3,6,0
"180840304","CORRIENTES",10,0,0,6,4,10,0
"180840305","CORRIENTES",6,0,2,0,2,4,0
"180841001","CORRIENTES",173,3,58,90,16,164,0.0173410404624277
"180840402","CORRIENTES",4,0,3,0,1,4,0
"180840403","CORRIENTES",24,0,20,1,1,22,0
"180840502","CORRIENTES",47,0,9,6,31,46,0
"180840503","CORRIENTES",30,0,8,11,11,30,0
"180841002","CORRIENTES",201,2,86,70,38,194,0.00995024875621891
"180840404","CORRIENTES",8,0,4,3,0,7,0
"180840501","CORRIENTES",36,1,21,14,0,35,0.0277777777777778
"180841003","CORRIENTES",178,1,74,70,19,163,0.00561797752808989
"180840601","CORRIENTES",19,0,7,3,9,19,0
"180840701","CORRIENTES",27,1,7,8,10,25,0.037037037037037
"180840602","CORRIENTES",15,0,9,6,0,15,0
"180840603","CORRIENTES",19,0,10,7,2,19,0
"700980403","SAN JUAN",290,249,22,15,1,38,0.858620689655172
"180840703","CORRIENTES",13,0,6,5,2,13,0
"180840801","CORRIENTES",6,0,0,5,1,6,0
"180841004","CORRIENTES",97,0,46,26,24,96,0
"180841005","CORRIENTES",39,0,10,18,10,38,0
"180841006","CORRIENTES",13,0,5,8,0,13,0
"180840802","CORRIENTES",18,0,7,10,0,17,0
"180840901","CORRIENTES",23,0,3,17,1,21,0
"180841007","CORRIENTES",77,0,11,40,23,74,0
"181052112","CORRIENTES",468,322,114,8,8,130,0.688034188034188
"180840902","CORRIENTES",23,0,3,19,1,23,0
"180840903","CORRIENTES",32,0,11,17,0,28,0
"180841008","CORRIENTES",17,0,5,5,4,14,0
"180841009","CORRIENTES",8,0,6,0,2,8,0
"180841101","CORRIENTES",265,81,138,36,5,179,0.305660377358491
"180910503","CORRIENTES",74,1,8,41,13,62,0.0135135135135135
"180841102","CORRIENTES",75,16,25,20,14,59,0.213333333333333
"180841103","CORRIENTES",28,0,8,6,13,27,0
"180841105","CORRIENTES",136,0,36,55,43,134,0
"180841106","CORRIENTES",19,0,6,4,6,16,0
"180841107","CORRIENTES",15,0,8,5,2,15,0
"180841108","CORRIENTES",37,0,3,6,22,31,0
"180841109","CORRIENTES",312,43,150,93,10,253,0.137820512820513
"180841201","CORRIENTES",229,1,88,64,60,212,0.00436681222707424
"180910404","CORRIENTES",63,0,13,28,18,59,0
"180841202","CORRIENTES",45,0,6,8,30,44,0
"180841203","CORRIENTES",126,0,6,27,92,125,0
"180910102","CORRIENTES",224,200,4,13,4,21,0.892857142857143
"180910103","CORRIENTES",173,164,2,4,0,6,0.947976878612717
"180910104","CORRIENTES",242,150,5,51,10,66,0.619834710743802
"180910105","CORRIENTES",311,172,9,69,3,81,0.553054662379421
"180910106","CORRIENTES",301,259,2,25,0,27,0.86046511627907
"180910107","CORRIENTES",276,191,24,49,0,73,0.692028985507246
"180841204","CORRIENTES",38,0,1,8,26,35,0
"180841205","CORRIENTES",3,0,0,2,1,3,0
"180841206","CORRIENTES",0,0,0,0,0,0,NA
"180841207","CORRIENTES",0,0,0,0,0,0,NA
"180910101","CORRIENTES",311,286,9,12,1,22,0.919614147909968
"180910108","CORRIENTES",245,214,5,19,0,24,0.873469387755102
"181050106","CORRIENTES",368,57,249,39,10,298,0.154891304347826
"180910110","CORRIENTES",455,139,24,209,33,266,0.305494505494506
"180910201","CORRIENTES",194,70,26,55,17,98,0.360824742268041
"180910202","CORRIENTES",103,1,19,57,9,85,0.00970873786407767
"180910203","CORRIENTES",236,13,37,73,71,181,0.0550847457627119
"180910210","CORRIENTES",136,10,27,51,12,90,0.0735294117647059
"181120202","CORRIENTES",69,0,24,27,1,52,0
"180910204","CORRIENTES",134,7,32,52,11,95,0.0522388059701493
"180910205","CORRIENTES",17,1,2,5,4,11,0.0588235294117647
"180910206","CORRIENTES",131,1,15,24,39,78,0.00763358778625954
"180910207","CORRIENTES",169,93,8,40,5,53,0.550295857988166
"180910208","CORRIENTES",194,98,22,22,25,69,0.505154639175258
"180910209","CORRIENTES",260,20,62,103,30,195,0.0769230769230769
"180910211","CORRIENTES",125,5,14,55,11,80,0.04
"180910212","CORRIENTES",59,0,6,5,0,11,0
"180910301","CORRIENTES",152,0,22,84,10,116,0
"180910302","CORRIENTES",93,0,20,45,4,69,0
"141401205","CORDOBA",346,302,14,25,2,41,0.872832369942196
"220210101","CHACO",33,0,4,9,14,27,0
"180910303","CORRIENTES",106,0,14,66,11,91,0
"180910304","CORRIENTES",33,0,2,22,5,29,0
"180910305","CORRIENTES",64,0,8,17,30,55,0
"180910401","CORRIENTES",132,9,62,41,6,109,0.0681818181818182
"180910402","CORRIENTES",84,0,33,17,28,78,0
"180910403","CORRIENTES",69,0,14,30,9,53,0
"181050201","CORRIENTES",14,0,9,4,0,13,0
"180910405","CORRIENTES",114,0,7,44,27,78,0
"180910406","CORRIENTES",50,6,9,23,5,37,0.12
"180910407","CORRIENTES",23,0,1,16,4,21,0
"180910501","CORRIENTES",15,0,1,11,1,13,0
"180910502","CORRIENTES",19,0,3,6,6,15,0
"181050104","CORRIENTES",332,57,229,15,4,248,0.171686746987952
"180910803","CORRIENTES",274,2,41,103,70,214,0.0072992700729927
"180910505","CORRIENTES",11,0,3,3,0,6,0
"180910506","CORRIENTES",14,0,0,5,4,9,0
"180910601","CORRIENTES",10,0,1,7,1,9,0
"181050105","CORRIENTES",204,13,152,23,1,176,0.0637254901960784
"220210201","CHACO",45,0,13,12,6,31,0
"180910602","CORRIENTES",7,0,0,5,1,6,0
"180910702","CORRIENTES",50,0,2,11,16,29,0
"180910703","CORRIENTES",108,0,19,53,11,83,0
"141050505","CORDOBA",334,10,305,11,0,316,0.029940119760479
"180910603","CORRIENTES",12,0,4,8,0,12,0
"180910701","CORRIENTES",187,4,113,58,5,176,0.0213903743315508
"180910704","CORRIENTES",129,0,16,70,8,94,0
"180910705","CORRIENTES",38,0,4,16,16,36,0
"180910706","CORRIENTES",256,2,109,105,11,225,0.0078125
"180910801","CORRIENTES",36,0,16,17,0,33,0
"180910802","CORRIENTES",200,28,15,108,29,152,0.14
"180980201","CORRIENTES",102,2,11,33,10,54,0.0196078431372549
"180910804","CORRIENTES",160,0,35,42,19,96,0
"180910805","CORRIENTES",51,0,6,38,2,46,0
"180910806","CORRIENTES",116,1,18,56,21,95,0.00862068965517241
"180910901","CORRIENTES",3,0,0,0,0,0,0
"180910902","CORRIENTES",1,0,0,0,0,0,0
"180980202","CORRIENTES",60,0,4,19,32,55,0
"180910903","CORRIENTES",0,0,0,0,0,0,NA
"180980101","CORRIENTES",237,56,105,54,10,169,0.236286919831224
"180980102","CORRIENTES",255,182,34,36,1,71,0.713725490196078
"180980103","CORRIENTES",378,45,86,155,54,295,0.119047619047619
"180980104","CORRIENTES",211,174,18,14,1,33,0.824644549763033
"180980105","CORRIENTES",167,109,25,21,7,53,0.652694610778443
"180980106","CORRIENTES",248,86,54,86,12,152,0.346774193548387
"180980107","CORRIENTES",233,4,68,95,53,216,0.0171673819742489
"181050109","CORRIENTES",284,209,47,16,1,64,0.735915492957746
"180980203","CORRIENTES",183,6,9,79,75,163,0.0327868852459016
"180980301","CORRIENTES",71,1,11,18,40,69,0.0140845070422535
"180980302","CORRIENTES",122,0,10,53,29,92,0
"180980303","CORRIENTES",47,0,6,12,28,46,0
"180980304","CORRIENTES",72,0,3,17,35,55,0
"181050110","CORRIENTES",301,299,2,0,0,2,0.993355481727575
"181050111","CORRIENTES",152,149,3,0,0,3,0.980263157894737
"700280310","SAN JUAN",183,127,34,20,0,54,0.693989071038251
"180980401","CORRIENTES",6,0,0,6,0,6,0
"180980502","CORRIENTES",18,0,1,8,7,16,0
"180980503","CORRIENTES",18,0,2,2,12,16,0
"181050112","CORRIENTES",269,86,170,2,3,175,0.319702602230483
"181050113","CORRIENTES",385,246,79,37,1,117,0.638961038961039
"181050204","CORRIENTES",332,321,10,1,0,11,0.966867469879518
"181050301","CORRIENTES",7,0,1,3,3,7,0
"181051202","CORRIENTES",49,1,6,36,0,42,0.0204081632653061
"220211505","CHACO",277,7,152,47,9,208,0.0252707581227437
"181050101","CORRIENTES",263,183,45,9,3,57,0.695817490494297
"181050102","CORRIENTES",270,70,163,26,1,190,0.259259259259259
"181050103","CORRIENTES",307,26,192,50,5,247,0.0846905537459283
"181050107","CORRIENTES",448,138,225,36,5,266,0.308035714285714
"181050108","CORRIENTES",123,7,92,14,1,107,0.0569105691056911
"220211607","CHACO",293,183,90,19,1,110,0.62457337883959
"181051201","CORRIENTES",40,0,22,4,0,26,0
"141401204","CORDOBA",236,4,193,35,1,229,0.0169491525423729
"181050114","CORRIENTES",363,308,34,11,0,45,0.848484848484849
"181050115","CORRIENTES",191,187,4,0,0,4,0.979057591623037
"181120207","CORRIENTES",23,0,20,3,0,23,0
"181050202","CORRIENTES",74,8,40,17,3,60,0.108108108108108
"181050803","CORRIENTES",31,11,19,1,0,20,0.354838709677419
"181050804","CORRIENTES",3,0,3,0,0,3,0
"220211612","CHACO",242,83,123,31,3,157,0.34297520661157
"181050502","CORRIENTES",21,0,13,6,2,21,0
"181050203","CORRIENTES",44,4,17,13,5,35,0.0909090909090909
"181050302","CORRIENTES",49,9,32,3,3,38,0.183673469387755
"181050802","CORRIENTES",23,0,11,7,4,22,0
"181050805","CORRIENTES",188,179,5,2,0,7,0.952127659574468
"220360108","CHACO",253,0,182,34,7,223,0
"181051302","CORRIENTES",25,0,11,1,0,12,0
"220210608","CHACO",279,10,52,163,36,251,0.03584229390681
"181050401","CORRIENTES",15,0,15,0,0,15,0
"181050402","CORRIENTES",6,5,0,1,0,1,0.833333333333333
"181050501","CORRIENTES",12,0,3,9,0,12,0
"181120701","CORRIENTES",330,135,76,87,13,176,0.409090909090909
"181050904","CORRIENTES",261,138,59,48,2,109,0.528735632183908
"181051305","CORRIENTES",25,0,8,9,1,18,0
"220210715","CHACO",237,172,56,9,0,65,0.725738396624473
"181050806","CORRIENTES",6,0,5,1,0,6,0
"181050901","CORRIENTES",246,113,66,57,2,125,0.459349593495935
"141050506","CORDOBA",243,15,222,5,0,227,0.0617283950617284
"181470401","CORRIENTES",20,0,8,10,0,18,0
"181050503","CORRIENTES",12,0,9,1,2,12,0
"181050601","CORRIENTES",27,0,8,15,0,23,0
"181051502","CORRIENTES",1,0,0,1,0,1,0
"220210716","CHACO",182,170,10,2,0,12,0.934065934065934
"181050602","CORRIENTES",20,0,10,5,2,17,0
"181050603","CORRIENTES",14,0,13,0,1,14,0
"181052113","CORRIENTES",375,118,161,60,3,224,0.314666666666667
"181050701","CORRIENTES",9,0,7,2,0,9,0
"181050702","CORRIENTES",7,0,3,4,0,7,0
"220210717","CHACO",151,148,3,0,0,3,0.980132450331126
"181050801","CORRIENTES",33,4,14,8,2,24,0.121212121212121
"181120108","CORRIENTES",348,243,16,64,4,84,0.698275862068966
"181051104","CORRIENTES",10,0,7,3,0,10,0
"181120109","CORRIENTES",217,203,3,6,0,9,0.935483870967742
"181120206","CORRIENTES",38,0,29,5,4,38,0
"181120102","CORRIENTES",79,69,10,0,0,10,0.873417721518987
"181050902","CORRIENTES",12,0,4,7,1,12,0
"181050903","CORRIENTES",19,2,14,3,0,17,0.105263157894737
"181051001","CORRIENTES",3,0,0,2,0,2,0
"181120110","CORRIENTES",171,153,7,6,1,14,0.894736842105263
"181051002","CORRIENTES",3,0,3,0,0,3,0
"181051003","CORRIENTES",88,0,64,11,2,77,0
"181051101","CORRIENTES",405,141,138,102,4,244,0.348148148148148
"181051102","CORRIENTES",15,0,11,2,0,13,0
"181120111","CORRIENTES",189,188,0,1,0,1,0.994708994708995
"220980118","CHACO",184,77,23,43,20,86,0.418478260869565
"181051103","CORRIENTES",17,1,9,6,0,15,0.0588235294117647
"181120112","CORRIENTES",217,200,2,8,0,10,0.921658986175115
"181120113","CORRIENTES",162,162,0,0,0,0,1
"141470113","CORDOBA",214,1,191,18,0,209,0.00467289719626168
"181051203","CORRIENTES",27,0,15,9,0,24,0
"181051303","CORRIENTES",4,0,3,0,0,3,0
"181051304","CORRIENTES",48,0,16,23,1,40,0
"181051204","CORRIENTES",82,2,24,46,4,74,0.024390243902439
"181051301","CORRIENTES",83,0,31,41,1,73,0
"181051306","CORRIENTES",2,0,1,0,0,1,0
"181051503","CORRIENTES",4,0,2,1,0,3,0
"181120203","CORRIENTES",48,0,34,5,4,43,0
"181051401","CORRIENTES",5,0,5,0,0,5,0
"181051601","CORRIENTES",83,0,17,44,4,65,0
"181051602","CORRIENTES",22,0,3,13,0,16,0
"141401203","CORDOBA",243,1,145,90,1,236,0.00411522633744856
"181051402","CORRIENTES",6,0,5,1,0,6,0
"181051603","CORRIENTES",20,0,2,10,4,16,0
"181051403","CORRIENTES",7,0,4,3,0,7,0
"181051404","CORRIENTES",2,0,2,0,0,2,0
"181051501","CORRIENTES",9,0,8,1,0,9,0
"181052102","CORRIENTES",439,421,10,0,0,10,0.958997722095672
"181051604","CORRIENTES",18,0,5,7,4,16,0
"181051605","CORRIENTES",23,1,12,3,0,15,0.0434782608695652
"181052103","CORRIENTES",275,177,79,9,1,89,0.643636363636364
"181052104","CORRIENTES",233,76,132,6,11,149,0.32618025751073
"181051701","CORRIENTES",5,0,5,0,0,5,0
"181051702","CORRIENTES",7,0,6,1,0,7,0
"181051801","CORRIENTES",33,0,9,16,5,30,0
"181051802","CORRIENTES",9,0,8,0,0,8,0
"181051901","CORRIENTES",15,0,9,4,0,13,0
"181051902","CORRIENTES",21,0,7,0,0,7,0
"181052105","CORRIENTES",263,259,3,0,0,3,0.984790874524715
"181052001","CORRIENTES",4,0,1,3,0,4,0
"181052106","CORRIENTES",298,277,14,7,0,21,0.929530201342282
"181052107","CORRIENTES",381,123,186,31,20,237,0.322834645669291
"181052108","CORRIENTES",289,263,22,4,0,26,0.910034602076125
"181120114","CORRIENTES",349,325,6,3,0,9,0.931232091690544
"181052002","CORRIENTES",11,0,10,1,0,11,0
"181052003","CORRIENTES",24,0,23,1,0,24,0
"181052101","CORRIENTES",180,179,1,0,0,1,0.994444444444444
"181052109","CORRIENTES",213,105,74,18,2,94,0.492957746478873
"181052110","CORRIENTES",190,27,124,30,1,155,0.142105263157895
"181052114","CORRIENTES",254,244,3,2,0,5,0.960629921259842
"181120101","CORRIENTES",280,240,3,34,0,37,0.857142857142857
"181120201","CORRIENTES",24,0,13,6,2,21,0
"181120103","CORRIENTES",61,47,8,6,0,14,0.770491803278688
"181120104","CORRIENTES",326,325,0,1,0,1,0.996932515337423
"181120105","CORRIENTES",218,214,3,0,0,3,0.981651376146789
"181120106","CORRIENTES",326,326,0,0,0,0,1
"181120107","CORRIENTES",283,219,13,35,1,49,0.773851590106007
"181120208","CORRIENTES",15,0,1,11,0,12,0
"181120407","CORRIENTES",22,1,12,4,1,17,0.0454545454545455
"140982307","CORDOBA",194,187,3,4,0,7,0.963917525773196
"181120914","CORRIENTES",225,155,11,36,0,47,0.688888888888889
"181120209","CORRIENTES",28,0,12,11,2,25,0
"181120210","CORRIENTES",43,1,27,9,0,36,0.0232558139534884
"181120211","CORRIENTES",4,0,1,1,0,2,0
"181120401","CORRIENTES",44,2,13,27,0,40,0.0454545454545455
"181120212","CORRIENTES",119,0,60,49,2,111,0
"181120301","CORRIENTES",17,0,9,7,0,16,0
"181120302","CORRIENTES",8,0,6,1,1,8,0
"181120406","CORRIENTES",8,0,2,5,0,7,0
"181120912","CORRIENTES",207,203,3,1,0,4,0.980676328502415
"181120303","CORRIENTES",18,2,10,3,3,16,0.111111111111111
"181120304","CORRIENTES",4,0,4,0,0,4,0
"141470909","CORDOBA",226,192,29,5,0,34,0.849557522123894
"221400712","CHACO",195,189,2,3,0,5,0.969230769230769
"181120402","CORRIENTES",19,0,8,10,0,18,0
"181120403","CORRIENTES",52,1,20,26,1,47,0.0192307692307692
"181120404","CORRIENTES",159,3,50,91,3,144,0.0188679245283019
"181120405","CORRIENTES",35,0,28,6,0,34,0
"181120809","CORRIENTES",259,142,34,31,33,98,0.548262548262548
"181120810","CORRIENTES",405,391,2,0,0,2,0.965432098765432
"181120408","CORRIENTES",6,0,5,1,0,6,0
"181120409","CORRIENTES",17,0,12,2,0,14,0
"181120410","CORRIENTES",22,0,9,12,0,21,0
"140982011","CORDOBA",183,183,0,0,0,0,1
"181120411","CORRIENTES",10,0,4,2,0,6,0
"181120501","CORRIENTES",2,0,1,1,0,2,0
"181120602","CORRIENTES",58,0,34,5,16,55,0
"181400109","CORRIENTES",275,5,100,122,17,239,0.0181818181818182
"181120502","CORRIENTES",28,0,18,7,2,27,0
"181120913","CORRIENTES",500,411,18,50,2,70,0.822
"181120503","CORRIENTES",20,0,16,0,1,17,0
"181120702","CORRIENTES",100,6,54,28,11,93,0.06
"181120504","CORRIENTES",5,3,2,0,0,2,0.6
"181120601","CORRIENTES",27,0,22,4,1,27,0
"181120703","CORRIENTES",19,1,9,1,7,17,0.0526315789473684
"500491411","MENDOZA",157,66,20,71,0,91,0.420382165605096
"181120603","CORRIENTES",7,0,6,0,0,6,0
"181120704","CORRIENTES",47,1,39,3,3,45,0.0212765957446809
"181120801","CORRIENTES",55,5,40,2,1,43,0.0909090909090909
"181120604","CORRIENTES",14,0,8,5,0,13,0
"221680303","CHACO",18,0,6,2,6,14,0
"181120705","CORRIENTES",24,0,23,0,0,23,0
"181120706","CORRIENTES",10,0,5,4,1,10,0
"181120707","CORRIENTES",12,0,10,1,1,12,0
"181120708","CORRIENTES",11,0,6,3,0,9,0
"181120709","CORRIENTES",0,0,0,0,0,0,NA
"181120710","CORRIENTES",34,0,29,3,1,33,0
"181120802","CORRIENTES",50,2,36,9,3,48,0.04
"181120803","CORRIENTES",72,1,49,13,6,68,0.0138888888888889
"181120805","CORRIENTES",15,0,10,2,3,15,0
"181120806","CORRIENTES",308,252,44,10,1,55,0.818181818181818
"181120807","CORRIENTES",291,268,18,4,1,23,0.920962199312715
"181120808","CORRIENTES",489,340,52,54,11,117,0.695296523517382
"500350506","MENDOZA",113,1,70,40,1,111,0.00884955752212389
"181120804","CORRIENTES",87,2,46,23,10,79,0.0229885057471264
"181400402","CORRIENTES",20,0,1,15,2,18,0
"181120901","CORRIENTES",210,158,25,11,3,39,0.752380952380952
"181120902","CORRIENTES",245,227,3,8,0,11,0.926530612244898
"181120903","CORRIENTES",216,210,4,1,1,6,0.972222222222222
"181120904","CORRIENTES",186,184,0,1,0,1,0.989247311827957
"181120905","CORRIENTES",231,230,1,0,0,1,0.995670995670996
"181120906","CORRIENTES",194,194,0,0,0,0,1
"181120907","CORRIENTES",306,305,1,0,0,1,0.996732026143791
"181120908","CORRIENTES",323,311,2,3,0,5,0.962848297213622
"181120909","CORRIENTES",241,238,1,1,0,2,0.987551867219917
"181120910","CORRIENTES",253,245,2,1,3,6,0.968379446640316
"181120911","CORRIENTES",285,277,3,2,0,5,0.971929824561404
"181190101","CORRIENTES",238,24,107,84,18,209,0.100840336134454
"181190102","CORRIENTES",244,236,6,0,2,8,0.967213114754098
"181190103","CORRIENTES",352,320,21,6,1,28,0.909090909090909
"181190104","CORRIENTES",497,463,11,12,2,25,0.93158953722334
"181190105","CORRIENTES",316,282,18,10,5,33,0.892405063291139
"181190106","CORRIENTES",153,148,3,2,0,5,0.967320261437909
"181190107","CORRIENTES",215,207,4,3,0,7,0.962790697674419
"181190108","CORRIENTES",285,203,57,20,5,82,0.712280701754386
"181190109","CORRIENTES",423,110,209,73,8,290,0.260047281323877
"220140602","CHACO",218,33,152,29,2,183,0.151376146788991
"181190110","CORRIENTES",269,89,143,27,1,171,0.330855018587361
"220140605","CHACO",167,3,128,33,3,164,0.0179640718562874
"181190111","CORRIENTES",245,71,115,46,3,164,0.289795918367347
"181190112","CORRIENTES",80,74,5,0,1,6,0.925
"181190113","CORRIENTES",146,15,65,50,5,120,0.102739726027397
"181190114","CORRIENTES",190,187,2,0,0,2,0.984210526315789
"181190115","CORRIENTES",399,97,212,72,9,293,0.243107769423559
"181190116","CORRIENTES",300,161,106,21,4,131,0.536666666666667
"181190117","CORRIENTES",212,42,53,66,24,143,0.19811320754717
"220140603","CHACO",248,2,202,43,0,245,0.00806451612903226
"181400110","CORRIENTES",303,35,123,114,13,250,0.115511551155116
"181190201","CORRIENTES",10,0,3,7,0,10,0
"181190202","CORRIENTES",16,0,9,6,0,15,0
"181190301","CORRIENTES",91,4,45,36,6,87,0.043956043956044
"181330102","CORRIENTES",145,4,95,25,3,123,0.0275862068965517
"181190302","CORRIENTES",100,15,34,29,2,65,0.15
"181190402","CORRIENTES",18,0,6,10,2,18,0
"181260103","CORRIENTES",251,174,34,24,12,70,0.693227091633466
"181191506","CORRIENTES",183,176,5,1,0,6,0.961748633879781
"181190303","CORRIENTES",8,0,3,4,0,7,0
"181190401","CORRIENTES",262,88,65,92,7,164,0.33587786259542
"181190904","CORRIENTES",3,0,0,3,0,3,0
"181190403","CORRIENTES",22,0,6,5,4,15,0
"181191003","CORRIENTES",22,0,14,5,3,22,0
"181260104","CORRIENTES",347,104,151,77,4,232,0.29971181556196
"181191508","CORRIENTES",281,94,114,58,6,178,0.334519572953737
"181190404","CORRIENTES",27,0,5,16,2,23,0
"181190501","CORRIENTES",24,0,2,0,18,20,0
"181191407","CORRIENTES",327,270,28,18,4,50,0.825688073394495
"181190502","CORRIENTES",20,0,8,12,0,20,0
"181190601","CORRIENTES",210,14,60,100,9,169,0.0666666666666667
"181191501","CORRIENTES",254,96,87,44,12,143,0.377952755905512
"181191502","CORRIENTES",164,97,45,14,2,61,0.591463414634146
"181191002","CORRIENTES",31,0,11,12,1,24,0
"181190602","CORRIENTES",12,0,0,6,5,11,0
"181190703","CORRIENTES",9,0,2,5,1,8,0
"181191503","CORRIENTES",365,320,25,11,0,36,0.876712328767123
"181191504","CORRIENTES",298,253,22,11,6,39,0.848993288590604
"181191505","CORRIENTES",327,312,9,3,3,15,0.954128440366973
"181190701","CORRIENTES",15,0,3,12,0,15,0
"181190702","CORRIENTES",41,1,9,16,7,32,0.024390243902439
"181191507","CORRIENTES",234,214,9,6,3,18,0.914529914529915
"221680304","CHACO",40,0,2,23,0,25,0
"181190801","CORRIENTES",8,1,4,1,0,5,0.125
"181190802","CORRIENTES",23,0,7,7,9,23,0
"181190901","CORRIENTES",139,14,70,31,19,120,0.100719424460432
"181190902","CORRIENTES",7,0,0,6,1,7,0
"181190903","CORRIENTES",11,0,6,2,0,8,0
"181191509","CORRIENTES",206,84,84,22,4,110,0.407766990291262
"181191510","CORRIENTES",232,225,6,1,0,7,0.969827586206897
"181190905","CORRIENTES",13,0,10,2,0,12,0
"181191001","CORRIENTES",39,0,5,25,3,33,0
"181191511","CORRIENTES",303,297,4,2,0,6,0.98019801980198
"181191512","CORRIENTES",206,205,1,0,0,1,0.995145631067961
"181191513","CORRIENTES",229,218,7,3,0,10,0.951965065502183
"181191101","CORRIENTES",12,1,5,5,1,11,0.0833333333333333
"181191102","CORRIENTES",11,0,5,5,1,11,0
"181191103","CORRIENTES",17,0,8,8,0,16,0
"181191201","CORRIENTES",17,0,0,6,11,17,0
"181191514","CORRIENTES",69,52,11,0,0,11,0.753623188405797
"221680305","CHACO",34,0,6,21,0,27,0
"181191202","CORRIENTES",11,0,7,2,0,9,0
"181191203","CORRIENTES",13,1,5,6,1,12,0.0769230769230769
"220140701","CHACO",31,0,7,9,4,20,0
"181191301","CORRIENTES",1,0,0,1,0,1,0
"181191401","CORRIENTES",122,3,34,64,9,107,0.0245901639344262
"181191515","CORRIENTES",319,50,215,44,5,264,0.156739811912226
"181191516","CORRIENTES",168,166,1,0,0,1,0.988095238095238
"181191402","CORRIENTES",212,109,35,50,15,100,0.514150943396226
"181191403","CORRIENTES",378,231,68,64,2,134,0.611111111111111
"181191404","CORRIENTES",153,1,59,55,18,132,0.0065359477124183
"181191405","CORRIENTES",394,391,2,0,1,3,0.99238578680203
"181191406","CORRIENTES",216,29,89,62,8,159,0.134259259259259
"181191517","CORRIENTES",115,98,6,2,8,16,0.852173913043478
"181191519","CORRIENTES",367,189,69,73,18,160,0.514986376021798
"181191520","CORRIENTES",399,346,44,6,2,52,0.867167919799499
"181191521","CORRIENTES",267,181,38,33,1,72,0.677902621722846
"181191522","CORRIENTES",241,35,144,43,4,191,0.145228215767635
"181191523","CORRIENTES",224,224,0,0,0,0,1
"181260101","CORRIENTES",315,73,74,107,28,209,0.231746031746032
"181260102","CORRIENTES",317,158,80,55,18,153,0.498422712933754
"500140403","MENDOZA",8,0,4,2,2,8,0
"181260105","CORRIENTES",368,3,206,114,27,347,0.00815217391304348
"181260106","CORRIENTES",390,242,77,45,6,128,0.620512820512821
"181260107","CORRIENTES",415,329,20,52,4,76,0.792771084337349
"181260108","CORRIENTES",378,226,19,83,32,134,0.597883597883598
"220210102","CHACO",43,0,7,32,1,40,0
"181260109","CORRIENTES",277,60,94,82,17,193,0.216606498194946
"181260201","CORRIENTES",51,0,10,20,15,45,0
"181260202","CORRIENTES",313,0,90,93,106,289,0
"181260203","CORRIENTES",7,0,0,3,3,6,0
"181330402","CORRIENTES",33,0,19,9,5,33,0
"181260301","CORRIENTES",135,2,19,24,68,111,0.0148148148148148
"181260302","CORRIENTES",35,2,10,12,10,32,0.0571428571428571
"181260401","CORRIENTES",40,0,2,13,23,38,0
"500070501","MENDOZA",253,253,0,0,0,0,1
"181260402","CORRIENTES",31,0,9,6,15,30,0
"181260501","CORRIENTES",301,0,43,91,109,243,0
"181260502","CORRIENTES",109,0,23,61,12,96,0
"181260601","CORRIENTES",112,0,7,33,66,106,0
"181260602","CORRIENTES",18,0,1,9,2,12,0
"181260603","CORRIENTES",7,0,0,4,2,6,0
"181260801","CORRIENTES",59,0,15,35,5,55,0
"181260802","CORRIENTES",34,0,3,16,9,28,0
"181260901","CORRIENTES",283,1,150,89,7,246,0.00353356890459364
"220210202","CHACO",34,0,5,6,19,30,0
"181260701","CORRIENTES",350,117,32,101,62,195,0.334285714285714
"181260702","CORRIENTES",63,0,2,5,26,33,0
"181260902","CORRIENTES",360,2,217,120,4,341,0.00555555555555556
"181260903","CORRIENTES",81,1,23,23,24,70,0.0123456790123457
"181330403","CORRIENTES",77,3,11,40,21,72,0.038961038961039
"220210301","CHACO",18,0,2,11,1,14,0
"181260703","CORRIENTES",131,1,25,40,31,96,0.00763358778625954
"181330101","CORRIENTES",209,5,157,31,7,195,0.0239234449760766
"181260904","CORRIENTES",60,1,26,21,9,56,0.0166666666666667
"220210302","CHACO",54,0,9,29,7,45,0
"220210303","CHACO",33,0,11,8,6,25,0
"181330103","CORRIENTES",145,5,92,41,5,138,0.0344827586206897
"181330104","CORRIENTES",32,0,8,24,0,32,0
"181330201","CORRIENTES",41,0,32,4,0,36,0
"181330202","CORRIENTES",62,3,36,23,0,59,0.0483870967741935
"181330203","CORRIENTES",69,0,29,25,1,55,0
"181330501","CORRIENTES",277,8,181,69,5,255,0.0288808664259928
"220210401","CHACO",64,0,11,27,14,52,0
"220210402","CHACO",10,0,2,4,4,10,0
"181330204","CORRIENTES",123,1,50,49,8,107,0.00813008130081301
"181330205","CORRIENTES",65,2,13,44,2,59,0.0307692307692308
"181330206","CORRIENTES",166,4,135,25,1,161,0.0240963855421687
"181330207","CORRIENTES",167,7,132,21,2,155,0.0419161676646707
"181330208","CORRIENTES",204,5,169,28,0,197,0.0245098039215686
"181330209","CORRIENTES",90,7,68,10,0,78,0.0777777777777778
"181330210","CORRIENTES",88,2,58,28,0,86,0.0227272727272727
"181330211","CORRIENTES",32,4,26,2,0,28,0.125
"181330212","CORRIENTES",106,1,61,33,6,100,0.00943396226415094
"181330213","CORRIENTES",90,2,58,29,1,88,0.0222222222222222
"181330214","CORRIENTES",359,15,243,49,4,296,0.0417827298050139
"181330215","CORRIENTES",71,0,30,22,9,61,0
"181330216","CORRIENTES",18,0,6,4,2,12,0
"181330301","CORRIENTES",259,1,186,44,6,236,0.00386100386100386
"181330504","CORRIENTES",67,1,31,25,6,62,0.0149253731343284
"181330302","CORRIENTES",142,1,54,60,19,133,0.00704225352112676
"181330303","CORRIENTES",26,0,9,11,5,25,0
"181330304","CORRIENTES",22,0,8,11,3,22,0
"181330305","CORRIENTES",2,0,1,1,0,2,0
"181330502","CORRIENTES",250,3,152,66,3,221,0.012
"181330503","CORRIENTES",69,0,28,34,5,67,0
"181330401","CORRIENTES",180,1,48,104,13,165,0.00555555555555556
"181330505","CORRIENTES",57,0,15,26,2,43,0
"181330506","CORRIENTES",73,1,14,44,10,68,0.0136986301369863
"220211504","CHACO",294,119,108,54,6,168,0.404761904761905
"181330601","CORRIENTES",1,0,0,0,0,0,0
"181330602","CORRIENTES",0,0,0,0,0,0,NA
"181330603","CORRIENTES",1,0,0,0,1,1,0
"220070601","CHACO",117,0,15,49,9,73,0
"181400101","CORRIENTES",274,23,68,162,3,233,0.0839416058394161
"181400102","CORRIENTES",209,60,30,85,25,140,0.287081339712919
"181400103","CORRIENTES",259,9,122,102,19,243,0.0347490347490347
"181400104","CORRIENTES",254,201,35,16,1,52,0.791338582677165
"181400105","CORRIENTES",286,110,87,78,8,173,0.384615384615385
"181400106","CORRIENTES",335,305,12,16,0,28,0.91044776119403
"181400107","CORRIENTES",266,19,134,94,7,235,0.0714285714285714
"181400108","CORRIENTES",259,132,37,68,8,113,0.50965250965251
"181400201","CORRIENTES",81,0,6,19,44,69,0
"181400202","CORRIENTES",90,1,16,68,0,84,0.0111111111111111
"181400302","CORRIENTES",37,0,4,24,4,32,0
"181400403","CORRIENTES",15,0,0,0,10,10,0
"181400203","CORRIENTES",439,90,95,213,24,332,0.20501138952164
"181400303","CORRIENTES",17,0,1,5,9,15,0
"181400204","CORRIENTES",41,0,9,31,1,41,0
"181400401","CORRIENTES",13,0,4,9,0,13,0
"181400205","CORRIENTES",5,0,0,4,1,5,0
"181400206","CORRIENTES",185,149,3,3,1,7,0.805405405405405
"181400301","CORRIENTES",28,0,3,24,0,27,0
"181400404","CORRIENTES",22,0,0,10,12,22,0
"181400405","CORRIENTES",56,0,0,2,46,48,0
"181400501","CORRIENTES",26,0,0,20,4,24,0
"181400502","CORRIENTES",15,0,1,0,13,14,0
"181400503","CORRIENTES",13,0,0,9,3,12,0
"181400504","CORRIENTES",17,0,1,3,10,14,0
"181400601","CORRIENTES",58,0,7,28,16,51,0
"181400602","CORRIENTES",70,0,2,23,44,69,0
"181400603","CORRIENTES",2,0,0,2,0,2,0
"181470104","CORRIENTES",229,118,77,33,0,110,0.51528384279476
"181400604","CORRIENTES",7,0,0,6,1,7,0
"181400701","CORRIENTES",41,0,4,3,25,32,0
"181400702","CORRIENTES",21,0,4,9,6,19,0
"181400703","CORRIENTES",71,0,8,36,14,58,0
"220070802","CHACO",53,0,1,26,14,41,0
"181400704","CORRIENTES",12,0,0,10,2,12,0
"181400801","CORRIENTES",10,0,0,6,2,8,0
"181400802","CORRIENTES",32,0,1,29,1,31,0
"181400803","CORRIENTES",72,0,8,37,17,62,0
"181400804","CORRIENTES",22,0,1,17,3,21,0
"181470105","CORRIENTES",292,206,53,27,3,83,0.705479452054795
"181400805","CORRIENTES",36,0,0,25,8,33,0
"181400806","CORRIENTES",17,0,0,0,17,17,0
"181400807","CORRIENTES",6,0,0,5,1,6,0
"181400808","CORRIENTES",1,0,0,1,0,1,0
"181400809","CORRIENTES",11,0,0,3,6,9,0
"181400901","CORRIENTES",9,0,1,2,4,7,0
"181400902","CORRIENTES",40,0,0,3,37,40,0
"181400903","CORRIENTES",39,0,0,17,13,30,0
"181470101","CORRIENTES",283,167,48,62,0,110,0.590106007067138
"181470102","CORRIENTES",290,188,63,33,1,97,0.648275862068965
"181470103","CORRIENTES",273,50,102,89,14,205,0.183150183150183
"500560507","MENDOZA",265,1,247,15,0,262,0.00377358490566038
"181470106","CORRIENTES",343,116,86,120,7,213,0.338192419825073
"181470107","CORRIENTES",229,55,76,81,8,165,0.240174672489083
"181470201","CORRIENTES",61,0,40,18,0,58,0
"181470202","CORRIENTES",57,0,18,26,5,49,0
"181470203","CORRIENTES",35,1,15,5,10,30,0.0285714285714286
"181470204","CORRIENTES",20,0,4,8,1,13,0
"181470205","CORRIENTES",175,0,81,76,11,168,0
"181470206","CORRIENTES",239,0,157,74,3,234,0
"181470207","CORRIENTES",185,0,128,39,13,180,0
"181470301","CORRIENTES",13,0,2,9,0,11,0
"181470302","CORRIENTES",19,0,6,10,2,18,0
"181470303","CORRIENTES",11,0,2,7,0,9,0
"181470304","CORRIENTES",18,0,6,10,1,17,0
"181470402","CORRIENTES",13,0,2,8,3,13,0
"181470403","CORRIENTES",12,1,7,4,0,11,0.0833333333333333
"181470602","CORRIENTES",11,0,0,9,2,11,0
"181680725","CORRIENTES",440,334,15,67,1,83,0.759090909090909
"220210719","CHACO",391,378,4,6,0,10,0.966751918158568
"181470501","CORRIENTES",11,0,5,6,0,11,0
"181470502","CORRIENTES",28,0,6,21,0,27,0
"181470604","CORRIENTES",3,0,0,3,0,3,0
"181470503","CORRIENTES",7,0,6,1,0,7,0
"181470701","CORRIENTES",19,0,3,16,0,19,0
"220210508","CHACO",348,10,286,52,0,338,0.028735632183908
"181470601","CORRIENTES",4,0,0,4,0,4,0
"181470603","CORRIENTES",9,0,6,2,0,8,0
"740561509","SAN LUIS",246,243,0,0,0,0,0.98780487804878
"181470702","CORRIENTES",5,0,5,0,0,5,0
"181470703","CORRIENTES",4,0,4,0,0,4,0
"181470801","CORRIENTES",168,1,46,99,8,153,0.00595238095238095
"181471102","CORRIENTES",8,0,2,6,0,8,0
"181471103","CORRIENTES",1,0,1,0,0,1,0
"220210718","CHACO",223,218,5,0,0,5,0.977578475336323
"181470802","CORRIENTES",167,0,46,102,8,156,0
"181470803","CORRIENTES",17,0,1,15,1,17,0
"181540102","CORRIENTES",360,0,289,39,10,338,0
"181540103","CORRIENTES",249,0,144,45,42,231,0
"181470804","CORRIENTES",16,0,2,11,2,15,0
"181470901","CORRIENTES",9,0,3,5,1,9,0
"181540201","CORRIENTES",54,0,4,11,39,54,0
"181470902","CORRIENTES",30,0,6,19,0,25,0
"181470903","CORRIENTES",26,0,9,12,1,22,0
"181540204","CORRIENTES",7,0,2,0,2,4,0
"181540301","CORRIENTES",2,0,2,0,0,2,0
"181610202","CORRIENTES",116,0,35,49,12,96,0
"181471001","CORRIENTES",14,0,7,4,3,14,0
"181540302","CORRIENTES",3,0,1,1,0,2,0
"181540401","CORRIENTES",63,0,15,5,33,53,0
"181471002","CORRIENTES",12,0,0,6,6,12,0
"181540402","CORRIENTES",38,0,7,17,10,34,0
"181540501","CORRIENTES",3,0,2,0,1,3,0
"181540502","CORRIENTES",4,0,1,1,2,4,0
"181471003","CORRIENTES",14,0,6,7,1,14,0
"181471004","CORRIENTES",4,0,2,2,0,4,0
"181471101","CORRIENTES",7,0,1,6,0,7,0
"181471201","CORRIENTES",104,1,64,28,8,100,0.00961538461538462
"181471202","CORRIENTES",20,0,11,3,3,17,0
"181471203","CORRIENTES",9,0,4,4,0,8,0
"181681001","CORRIENTES",2,0,0,2,0,2,0
"181471204","CORRIENTES",117,3,68,29,9,106,0.0256410256410256
"181540101","CORRIENTES",416,0,217,82,86,385,0
"181540202","CORRIENTES",310,0,51,63,157,271,0
"181540203","CORRIENTES",220,0,18,42,123,183,0
"181540601","CORRIENTES",32,0,3,9,17,29,0
"181540602","CORRIENTES",11,0,3,0,8,11,0
"181540603","CORRIENTES",18,0,0,0,14,14,0
"181540701","CORRIENTES",233,0,122,53,52,227,0
"181540704","CORRIENTES",252,0,138,61,46,245,0
"181540801","CORRIENTES",12,0,2,6,3,11,0
"181540702","CORRIENTES",126,0,21,36,55,112,0
"181540703","CORRIENTES",127,0,66,14,43,123,0
"181610201","CORRIENTES",97,0,31,22,10,63,0
"181540802","CORRIENTES",13,0,8,4,0,12,0
"181540901","CORRIENTES",0,0,0,0,0,0,NA
"181610101","CORRIENTES",199,16,69,95,10,174,0.0804020100502513
"181610102","CORRIENTES",226,1,85,95,16,196,0.00442477876106195
"181610103","CORRIENTES",219,71,87,52,5,144,0.324200913242009
"181610104","CORRIENTES",234,80,117,26,2,145,0.341880341880342
"140980516","CORDOBA",202,24,145,32,0,177,0.118811881188119
"181610105","CORRIENTES",287,43,94,108,16,218,0.149825783972125
"181610106","CORRIENTES",363,221,64,57,2,123,0.608815426997245
"181610107","CORRIENTES",210,4,70,92,4,166,0.019047619047619
"181610108","CORRIENTES",170,118,31,19,1,51,0.694117647058824
"740561405","SAN LUIS",360,295,50,15,0,65,0.819444444444444
"181610203","CORRIENTES",73,0,13,40,11,64,0
"181610204","CORRIENTES",60,3,12,30,6,48,0.05
"181610304","CORRIENTES",2,0,0,0,1,1,0
"220211703","CHACO",237,31,106,83,4,193,0.130801687763713
"181610401","CORRIENTES",154,6,40,78,11,129,0.038961038961039
"181610205","CORRIENTES",26,0,3,9,12,24,0
"181610206","CORRIENTES",107,0,75,16,9,100,0
"181610301","CORRIENTES",94,1,13,27,37,77,0.0106382978723404
"181610302","CORRIENTES",2,0,0,0,2,2,0
"181610303","CORRIENTES",31,0,2,15,9,26,0
"181610404","CORRIENTES",61,0,24,18,9,51,0
"181680708","CORRIENTES",1,0,0,1,0,1,0
"181610402","CORRIENTES",80,0,35,23,20,78,0
"181610403","CORRIENTES",12,0,2,4,6,12,0
"181610405","CORRIENTES",233,16,119,55,12,186,0.0686695278969957
"181610501","CORRIENTES",31,0,10,13,0,23,0
"220211704","CHACO",144,141,3,0,0,3,0.979166666666667
"181610502","CORRIENTES",27,3,9,8,6,23,0.111111111111111
"181610603","CORRIENTES",90,0,21,53,5,79,0
"181610503","CORRIENTES",32,0,13,8,3,24,0
"181610504","CORRIENTES",298,35,170,63,10,243,0.11744966442953
"181610604","CORRIENTES",12,0,1,8,1,10,0
"181680709","CORRIENTES",0,0,0,0,0,0,NA
"181610505","CORRIENTES",314,50,120,77,33,230,0.159235668789809
"181610601","CORRIENTES",289,21,171,70,14,255,0.0726643598615917
"181680101","CORRIENTES",57,6,6,24,18,48,0.105263157894737
"500980719","MENDOZA",344,6,292,11,1,304,0.0174418604651163
"181610602","CORRIENTES",73,1,15,32,17,64,0.0136986301369863
"181610605","CORRIENTES",131,0,30,77,11,118,0
"181680710","CORRIENTES",9,0,5,3,1,9,0
"181680902","CORRIENTES",2,0,2,0,0,2,0
"181680724","CORRIENTES",225,176,21,25,0,46,0.782222222222222
"181610606","CORRIENTES",55,0,14,18,9,41,0
"181610607","CORRIENTES",276,44,134,75,10,219,0.159420289855072
"181680110","CORRIENTES",271,206,35,12,5,52,0.760147601476015
"181680102","CORRIENTES",270,205,26,18,6,50,0.759259259259259
"181680103","CORRIENTES",272,244,10,12,0,22,0.897058823529412
"181680104","CORRIENTES",315,292,6,16,0,22,0.926984126984127
"181680105","CORRIENTES",228,174,33,19,0,52,0.763157894736842
"181680106","CORRIENTES",291,166,32,69,10,111,0.570446735395189
"181680107","CORRIENTES",308,199,14,73,2,89,0.646103896103896
"181680108","CORRIENTES",317,90,86,117,8,211,0.28391167192429
"220210604","CHACO",124,0,4,50,18,72,0
"181680109","CORRIENTES",346,14,128,175,19,322,0.0404624277456647
"181680201","CORRIENTES",91,0,11,49,24,84,0
"181680712","CORRIENTES",401,22,123,202,37,362,0.0548628428927681
"181680501","CORRIENTES",66,0,6,42,4,52,0
"181680720","CORRIENTES",292,132,37,116,3,156,0.452054794520548
"181680202","CORRIENTES",60,0,17,33,10,60,0
"181680713","CORRIENTES",325,272,33,18,0,51,0.836923076923077
"181680714","CORRIENTES",204,178,9,3,0,12,0.872549019607843
"500980711","MENDOZA",197,187,3,1,0,4,0.949238578680203
"181680301","CORRIENTES",30,0,7,17,4,28,0
"181680701","CORRIENTES",265,50,53,132,20,205,0.188679245283019
"181680702","CORRIENTES",460,211,54,168,16,238,0.458695652173913
"181680502","CORRIENTES",9,0,0,4,3,7,0
"181680715","CORRIENTES",250,220,19,9,1,29,0.88
"181680716","CORRIENTES",264,251,4,4,1,9,0.950757575757576
"181680302","CORRIENTES",27,1,2,22,1,25,0.037037037037037
"181680703","CORRIENTES",442,278,48,82,4,134,0.6289592760181
"181680704","CORRIENTES",254,157,35,53,6,94,0.618110236220472
"181680303","CORRIENTES",15,0,1,8,0,9,0
"181680401","CORRIENTES",10,0,3,6,0,9,0
"181680402","CORRIENTES",15,0,2,8,4,14,0
"181680721","CORRIENTES",242,183,16,37,1,54,0.756198347107438
"181680403","CORRIENTES",14,0,3,11,0,14,0
"181680705","CORRIENTES",595,64,81,336,96,513,0.107563025210084
"181680601","CORRIENTES",7,0,4,3,0,7,0
"181680602","CORRIENTES",11,0,2,6,2,10,0
"181680706","CORRIENTES",389,9,111,198,48,357,0.0231362467866324
"181680707","CORRIENTES",204,2,97,75,26,198,0.00980392156862745
"181680722","CORRIENTES",440,194,52,170,14,236,0.440909090909091
"181680711","CORRIENTES",148,0,13,124,4,141,0
"181680603","CORRIENTES",77,0,5,31,31,67,0
"181680604","CORRIENTES",24,0,12,11,1,24,0
"181680717","CORRIENTES",230,229,1,0,0,1,0.995652173913044
"181680718","CORRIENTES",401,397,3,1,0,4,0.99002493765586
"181680719","CORRIENTES",360,343,1,0,0,1,0.952777777777778
"220211705","CHACO",224,164,46,9,0,55,0.732142857142857
"181680726","CORRIENTES",3,0,0,3,0,3,0
"181680727","CORRIENTES",253,84,45,118,2,165,0.33201581027668
"181680801","CORRIENTES",54,5,7,25,10,42,0.0925925925925926
"181680802","CORRIENTES",20,0,3,14,0,17,0
"181681002","CORRIENTES",57,1,4,45,2,51,0.0175438596491228
"181681601","CORRIENTES",181,1,41,117,19,177,0.00552486187845304
"181680803","CORRIENTES",2,0,1,1,0,2,0
"181680804","CORRIENTES",15,1,4,7,1,12,0.0666666666666667
"181680901","CORRIENTES",7,0,2,4,1,7,0
"181680903","CORRIENTES",8,0,1,7,0,8,0
"181680904","CORRIENTES",5,0,0,4,0,4,0
"220210601","CHACO",155,1,12,103,26,141,0.00645161290322581
"181681003","CORRIENTES",27,1,7,12,5,24,0.037037037037037
"181681101","CORRIENTES",5,0,3,0,0,3,0
"220210720","CHACO",179,70,104,5,0,109,0.391061452513966
"181750106","CORRIENTES",294,178,51,55,4,110,0.605442176870748
"740561402","SAN LUIS",208,203,3,2,0,5,0.975961538461538
"181681102","CORRIENTES",5,0,0,3,2,5,0
"181681705","CORRIENTES",216,137,37,25,5,67,0.634259259259259
"181681706","CORRIENTES",259,248,6,4,0,10,0.957528957528958
"220210602","CHACO",47,0,10,15,13,38,0
"181681103","CORRIENTES",78,1,17,51,3,71,0.0128205128205128
"181750107","CORRIENTES",341,258,25,44,5,74,0.756598240469208
"181750108","CORRIENTES",78,41,3,32,2,37,0.525641025641026
"181681201","CORRIENTES",110,1,24,40,36,100,0.00909090909090909
"181681202","CORRIENTES",5,0,2,2,0,4,0
"181681707","CORRIENTES",335,265,30,34,1,65,0.791044776119403
"181681708","CORRIENTES",384,249,42,70,15,127,0.6484375
"181681710","CORRIENTES",342,92,65,136,12,213,0.269005847953216
"220070701","CHACO",288,1,23,81,120,224,0.00347222222222222
"181681203","CORRIENTES",16,0,7,5,4,16,0
"181681302","CORRIENTES",41,0,2,18,18,38,0
"181681303","CORRIENTES",161,11,45,68,34,147,0.0683229813664596
"220210603","CHACO",92,0,15,50,1,66,0
"181681204","CORRIENTES",9,0,4,4,1,9,0
"181681301","CORRIENTES",10,0,5,4,0,9,0
"181681403","CORRIENTES",22,0,0,16,5,21,0
"221400117","CHACO",238,12,136,63,6,205,0.0504201680672269
"181681304","CORRIENTES",9,0,5,2,1,8,0
"181681305","CORRIENTES",73,0,17,34,13,64,0
"181681709","CORRIENTES",299,126,40,113,3,156,0.421404682274247
"181681306","CORRIENTES",161,1,35,77,40,152,0.0062111801242236
"181681307","CORRIENTES",477,472,3,0,0,3,0.989517819706499
"181681401","CORRIENTES",201,3,73,89,24,186,0.0149253731343284
"181681402","CORRIENTES",58,0,14,35,8,57,0
"181750103","CORRIENTES",227,211,8,7,0,15,0.929515418502203
"181750105","CORRIENTES",326,150,57,87,10,154,0.460122699386503
"181681404","CORRIENTES",64,0,17,37,6,60,0
"181681501","CORRIENTES",53,0,15,19,13,47,0
"181681502","CORRIENTES",6,0,1,4,1,6,0
"181750202","CORRIENTES",18,1,9,7,1,17,0.0555555555555556
"181681602","CORRIENTES",109,4,6,10,3,19,0.036697247706422
"181681603","CORRIENTES",32,0,12,14,2,28,0
"181681604","CORRIENTES",8,0,3,5,0,8,0
"181681701","CORRIENTES",344,88,94,121,6,221,0.255813953488372
"181681702","CORRIENTES",311,293,12,4,0,16,0.942122186495177
"181681703","CORRIENTES",337,276,29,18,0,47,0.818991097922849
"181681704","CORRIENTES",253,121,63,63,2,128,0.478260869565217
"181681711","CORRIENTES",176,119,3,36,0,39,0.676136363636364
"181681712","CORRIENTES",325,324,0,1,0,1,0.996923076923077
"181681713","CORRIENTES",279,274,5,0,0,5,0.982078853046595
"181681714","CORRIENTES",256,254,2,0,0,2,0.9921875
"181750101","CORRIENTES",216,9,87,98,17,202,0.0416666666666667
"181750102","CORRIENTES",195,70,43,66,13,122,0.358974358974359
"181750104","CORRIENTES",289,187,34,58,4,96,0.647058823529412
"181750401","CORRIENTES",26,0,8,15,1,24,0
"220070209","CHACO",136,0,21,34,48,103,0
"181750302","CORRIENTES",26,0,6,17,1,24,0
"181750201","CORRIENTES",12,0,4,8,0,12,0
"220070301","CHACO",32,0,3,3,7,13,0
"220070302","CHACO",68,0,8,23,20,51,0
"181750203","CORRIENTES",13,0,5,6,2,13,0
"181750402","CORRIENTES",41,0,0,29,6,35,0
"220070303","CHACO",29,0,0,0,29,29,0
"220070304","CHACO",99,0,0,23,41,64,0
"181750204","CORRIENTES",30,0,15,3,8,26,0
"181750301","CORRIENTES",15,0,10,0,1,11,0
"220070401","CHACO",42,0,2,17,8,27,0
"220070402","CHACO",29,0,2,13,1,16,0
"181750503","CORRIENTES",18,0,6,8,1,15,0
"181750601","CORRIENTES",56,0,15,23,7,45,0
"220070403","CHACO",28,0,7,7,1,15,0
"220070404","CHACO",27,0,4,1,15,20,0
"220210721","CHACO",246,129,57,51,0,108,0.524390243902439
"220070504","CHACO",59,0,10,11,2,23,0
"181750602","CORRIENTES",40,0,9,26,1,36,0
"220070702","CHACO",338,1,63,105,87,255,0.0029585798816568
"181750303","CORRIENTES",25,0,10,10,2,22,0
"220070501","CHACO",100,1,20,24,12,56,0.01
"220070502","CHACO",194,1,35,83,37,155,0.00515463917525773
"220070503","CHACO",174,4,108,51,9,168,0.0229885057471264
"220070901","CHACO",274,2,104,84,61,249,0.0072992700729927
"181750403","CORRIENTES",58,0,2,32,3,37,0
"181750501","CORRIENTES",99,0,15,60,11,86,0
"181750502","CORRIENTES",6,0,4,1,1,6,0
"181750603","CORRIENTES",8,0,4,3,1,8,0
"220070505","CHACO",58,0,17,14,21,52,0
"220070506","CHACO",270,2,51,125,54,230,0.00740740740740741
"220210816","CHACO",204,1,77,86,17,180,0.00490196078431373
"220070507","CHACO",184,1,102,69,5,176,0.00543478260869565
"220070602","CHACO",89,2,9,33,23,65,0.0224719101123595
"220070603","CHACO",131,0,16,42,44,102,0
"181750604","CORRIENTES",9,0,7,2,0,9,0
"181750802","CORRIENTES",7,0,1,6,0,7,0
"220070101","CHACO",375,5,192,81,45,318,0.0133333333333333
"220070102","CHACO",451,4,231,142,13,386,0.00886917960088692
"181750605","CORRIENTES",21,0,6,15,0,21,0
"220070103","CHACO",271,3,152,75,10,237,0.011070110701107
"220070104","CHACO",209,0,87,75,20,182,0
"220070201","CHACO",81,0,10,36,17,63,0
"220210901","CHACO",19,0,5,4,9,18,0
"181750701","CORRIENTES",3,0,3,0,0,3,0
"220070202","CHACO",37,0,7,10,12,29,0
"220070203","CHACO",48,0,9,3,10,22,0
"220070204","CHACO",109,0,10,34,38,82,0
"220070205","CHACO",32,0,0,5,22,27,0
"220070206","CHACO",77,0,12,6,24,42,0
"220070207","CHACO",82,0,10,11,18,39,0
"220210902","CHACO",37,0,1,32,4,37,0
"220070604","CHACO",52,0,14,18,18,50,0
"181750702","CORRIENTES",8,0,4,4,0,8,0
"220070208","CHACO",410,3,107,148,114,369,0.00731707317073171
"220070508","CHACO",354,3,100,131,71,302,0.00847457627118644
"181750801","CORRIENTES",9,0,0,9,0,9,0
"220070703","CHACO",147,2,61,72,4,137,0.0136054421768707
"220070704","CHACO",221,0,133,51,3,187,0
"220070705","CHACO",388,1,215,82,55,352,0.00257731958762887
"220070706","CHACO",290,1,127,66,68,261,0.00344827586206897
"220070707","CHACO",242,0,40,91,56,187,0
"220070708","CHACO",385,1,154,105,82,341,0.0025974025974026
"220070801","CHACO",89,1,21,27,19,67,0.0112359550561798
"220070803","CHACO",67,0,8,46,1,55,0
"220070804","CHACO",44,0,7,13,18,38,0
"220070805","CHACO",16,0,1,11,2,14,0
"220070806","CHACO",34,0,0,18,14,32,0
"220070807","CHACO",233,0,45,70,91,206,0
"220070902","CHACO",229,6,62,76,5,143,0.0262008733624454
"220070903","CHACO",87,0,25,47,14,86,0
"220070904","CHACO",203,4,104,64,13,181,0.0197044334975369
"220070905","CHACO",322,2,92,85,74,251,0.0062111801242236
"220140302","CHACO",4,0,1,1,2,4,0
"220140303","CHACO",8,0,0,2,6,8,0
"220140304","CHACO",4,0,2,2,0,4,0
"220140305","CHACO",38,0,16,16,5,37,0
"220140101","CHACO",6,0,2,4,0,6,0
"220140102","CHACO",88,0,38,41,7,86,0
"220211001","CHACO",38,0,4,33,0,37,0
"220210704","CHACO",571,90,390,80,11,481,0.157618213660245
"220140103","CHACO",168,125,22,13,2,37,0.744047619047619
"220140201","CHACO",5,0,1,4,0,5,0
"220140401","CHACO",305,2,202,57,32,291,0.00655737704918033
"220210701","CHACO",294,226,42,19,3,64,0.768707482993197
"220140202","CHACO",18,0,9,6,1,16,0
"220140203","CHACO",25,0,1,20,1,22,0
"220140306","CHACO",27,0,7,14,1,22,0
"220140307","CHACO",276,0,178,65,7,250,0
"220140308","CHACO",261,0,189,56,8,253,0
"220210903","CHACO",47,0,12,17,1,30,0
"220140301","CHACO",9,0,1,3,1,5,0
"220210605","CHACO",247,8,80,97,40,217,0.0323886639676113
"220140402","CHACO",187,0,151,30,2,183,0
"220140406","CHACO",96,7,36,40,7,83,0.0729166666666667
"220140409","CHACO",168,73,27,43,13,83,0.43452380952381
"220140410","CHACO",281,134,70,52,2,124,0.476868327402135
"220140411","CHACO",190,3,180,5,0,185,0.0157894736842105
"220140604","CHACO",404,9,237,132,12,381,0.0222772277227723
"740561310","SAN LUIS",213,166,25,22,0,47,0.779342723004695
"220140403","CHACO",56,0,32,6,15,53,0
"220140404","CHACO",67,1,18,32,4,54,0.0149253731343284
"220140405","CHACO",337,20,143,132,25,300,0.0593471810089021
"220140407","CHACO",71,0,31,26,5,62,0
"220140408","CHACO",258,111,134,11,0,145,0.430232558139535
"220140412","CHACO",341,13,86,164,40,290,0.0381231671554252
"220211002","CHACO",48,0,12,18,16,46,0
"220210702","CHACO",196,195,0,1,0,1,0.994897959183674
"220140501","CHACO",280,9,195,56,7,258,0.0321428571428571
"220140502","CHACO",381,3,293,74,4,371,0.0078740157480315
"220140503","CHACO",292,5,260,21,1,282,0.0171232876712329
"220140504","CHACO",315,4,189,105,10,304,0.0126984126984127
"220140505","CHACO",168,0,109,32,9,150,0
"220140601","CHACO",331,104,145,62,1,208,0.314199395770393
"220140703","CHACO",51,0,18,16,4,38,0
"220140704","CHACO",253,83,132,31,5,168,0.328063241106719
"220140705","CHACO",219,66,117,22,6,145,0.301369863013699
"220140801","CHACO",68,0,16,14,12,42,0
"220210403","CHACO",169,1,50,101,4,155,0.00591715976331361
"220210501","CHACO",47,2,1,23,1,25,0.0425531914893617
"220210502","CHACO",114,0,12,40,32,84,0
"220140802","CHACO",54,0,7,11,19,37,0
"220140803","CHACO",96,2,23,28,8,59,0.0208333333333333
"220140804","CHACO",21,0,7,4,6,17,0
"220210503","CHACO",169,5,59,68,23,150,0.029585798816568
"220210504","CHACO",203,203,0,0,0,0,1
"220210505","CHACO",230,160,19,38,4,61,0.695652173913043
"220210506","CHACO",256,5,78,110,25,213,0.01953125
"220210507","CHACO",314,96,196,19,2,217,0.305732484076433
"220140805","CHACO",92,0,19,45,16,80,0
"220140901","CHACO",16,0,8,4,2,14,0
"220140902","CHACO",24,0,3,10,7,20,0
"220210705","CHACO",248,3,181,54,1,236,0.0120967741935484
"220210706","CHACO",174,171,0,0,0,0,0.982758620689655
"220210707","CHACO",178,177,1,0,0,1,0.99438202247191
"220210708","CHACO",332,37,224,64,4,292,0.11144578313253
"220210709","CHACO",312,229,76,7,0,83,0.733974358974359
"220210710","CHACO",243,78,97,54,8,159,0.320987654320988
"220210711","CHACO",214,147,41,17,3,61,0.686915887850467
"220210712","CHACO",165,117,30,17,0,47,0.709090909090909
"220210713","CHACO",346,318,20,6,1,27,0.919075144508671
"220210714","CHACO",254,154,67,27,2,96,0.606299212598425
"220210722","CHACO",113,109,4,0,0,4,0.964601769911504
"220210723","CHACO",164,162,2,0,0,2,0.98780487804878
"220210801","CHACO",376,5,196,149,17,362,0.0132978723404255
"220210802","CHACO",268,2,39,154,48,241,0.00746268656716418
"220210803","CHACO",299,128,23,58,46,127,0.42809364548495
"220210804","CHACO",287,8,167,96,4,267,0.0278745644599303
"220210805","CHACO",143,73,57,12,0,69,0.510489510489511
"220210806","CHACO",291,22,157,91,2,250,0.0756013745704467
"220210807","CHACO",249,203,36,6,0,42,0.815261044176707
"220210808","CHACO",328,31,141,101,18,260,0.0945121951219512
"220210809","CHACO",255,5,128,71,10,209,0.0196078431372549
"220210810","CHACO",198,49,101,35,2,138,0.247474747474747
"220210811","CHACO",240,5,49,144,34,227,0.0208333333333333
"220210812","CHACO",217,3,78,88,11,177,0.0138248847926267
"220210813","CHACO",239,6,122,84,12,218,0.0251046025104603
"220210814","CHACO",296,115,30,127,16,173,0.388513513513513
"220210815","CHACO",207,1,35,88,54,177,0.00483091787439614
"220211506","CHACO",800,16,122,474,66,662,0.02
"220211507","CHACO",221,15,135,48,10,193,0.0678733031674208
"220211508","CHACO",407,8,209,120,28,357,0.0196560196560197
"220211509","CHACO",282,5,168,97,8,273,0.0177304964539007
"220211510","CHACO",290,285,5,0,0,5,0.982758620689655
"220211511","CHACO",369,367,1,1,0,2,0.994579945799458
"220211512","CHACO",260,118,4,78,5,87,0.453846153846154
"220211513","CHACO",146,144,2,0,0,2,0.986301369863014
"220211601","CHACO",300,9,75,199,3,277,0.03
"220211602","CHACO",287,172,72,26,2,100,0.599303135888502
"220211603","CHACO",158,139,17,2,0,19,0.879746835443038
"220211604","CHACO",212,66,108,33,4,145,0.311320754716981
"220211605","CHACO",369,0,105,229,23,357,0
"220211606","CHACO",182,23,110,36,10,156,0.126373626373626
"220211608","CHACO",262,15,186,50,6,242,0.0572519083969466
"220211609","CHACO",200,3,57,64,10,131,0.015
"220211610","CHACO",288,11,171,79,1,251,0.0381944444444444
"220211611","CHACO",331,5,211,93,11,315,0.0151057401812689
"740561309","SAN LUIS",334,282,40,10,0,50,0.844311377245509
"220211613","CHACO",307,225,66,16,0,82,0.732899022801303
"220211614","CHACO",260,3,60,163,24,247,0.0115384615384615
"220211615","CHACO",247,1,39,164,27,230,0.00404858299595142
"220211616","CHACO",287,197,79,9,2,90,0.686411149825784
"220211617","CHACO",198,0,56,114,12,182,0
"220211618","CHACO",330,3,56,212,20,288,0.00909090909090909
"220211701","CHACO",213,209,3,1,0,4,0.981220657276995
"220211702","CHACO",157,151,1,4,0,5,0.961783439490446
"220211706","CHACO",291,50,188,39,3,230,0.171821305841924
"220211708","CHACO",211,7,139,25,11,175,0.033175355450237
"220211709","CHACO",360,3,191,155,6,352,0.00833333333333333
"220211710","CHACO",314,13,213,75,6,294,0.0414012738853503
"220211711","CHACO",270,29,175,58,3,236,0.107407407407407
"220211712","CHACO",317,11,141,114,1,256,0.0347003154574132
"220211713","CHACO",266,2,87,145,17,249,0.0075187969924812
"220211714","CHACO",344,16,139,131,24,294,0.0465116279069767
"220211715","CHACO",193,25,80,63,10,153,0.129533678756477
"220211716","CHACO",248,10,106,96,12,214,0.0403225806451613
"220211717","CHACO",211,4,73,101,21,195,0.018957345971564
"220211718","CHACO",245,1,85,128,9,222,0.00408163265306122
"220280101","CHACO",275,0,106,113,42,261,0
"220280102","CHACO",444,0,313,88,31,432,0
"221400503","CHACO",228,174,27,27,0,54,0.763157894736842
"220280103","CHACO",272,0,201,53,15,269,0
"220280104","CHACO",303,0,267,25,3,295,0
"220280105","CHACO",391,0,297,76,11,384,0
"220280106","CHACO",313,0,176,103,30,309,0
"220280107","CHACO",285,0,246,30,6,282,0
"220280108","CHACO",231,0,139,65,10,214,0
"220280109","CHACO",297,0,107,120,56,283,0
"220280110","CHACO",293,0,167,55,46,268,0
"220280111","CHACO",179,0,114,51,0,165,0
"220280112","CHACO",255,0,181,64,6,251,0
"220280113","CHACO",352,0,191,103,39,333,0
"220280114","CHACO",330,0,253,69,5,327,0
"220280115","CHACO",342,0,184,79,45,308,0
"220280116","CHACO",336,0,133,148,40,321,0
"220630205","CHACO",19,0,0,6,3,9,0
"220280117","CHACO",362,0,261,75,18,354,0
"220280118","CHACO",316,0,145,107,31,283,0
"220280201","CHACO",171,0,15,69,62,146,0
"220280202","CHACO",63,0,13,17,31,61,0
"220280203","CHACO",168,0,11,89,27,127,0
"220280301","CHACO",178,0,44,79,39,162,0
"220280302","CHACO",141,0,8,45,33,86,0
"220280303","CHACO",44,0,5,11,17,33,0
"220280304","CHACO",55,0,13,14,21,48,0
"220280305","CHACO",68,0,9,14,14,37,0
"220280307","CHACO",279,0,253,7,0,260,0
"220280308","CHACO",233,0,142,72,10,224,0
"220360109","CHACO",174,0,131,33,0,164,0
"220280309","CHACO",385,0,163,166,40,369,0
"220280310","CHACO",320,0,32,149,88,269,0
"220280311","CHACO",329,0,138,113,46,297,0
"220280401","CHACO",42,0,9,26,4,39,0
"220280402","CHACO",29,0,1,16,7,24,0
"220280403","CHACO",42,0,2,26,12,40,0
"220280501","CHACO",106,0,2,20,31,53,0
"220280502","CHACO",18,0,2,3,10,15,0
"220280503","CHACO",40,0,1,32,1,34,0
"220360101","CHACO",267,0,47,86,93,226,0
"220360102","CHACO",291,0,127,129,19,275,0
"220360103","CHACO",113,0,71,26,3,100,0
"220360104","CHACO",182,0,106,63,11,180,0
"220360105","CHACO",316,0,199,85,14,298,0
"220360106","CHACO",385,0,230,83,48,361,0
"220360107","CHACO",237,0,137,92,3,232,0
"220360110","CHACO",303,0,133,96,51,280,0
"220360111","CHACO",217,0,149,56,6,211,0
"220360112","CHACO",293,0,137,114,27,278,0
"220360113","CHACO",284,0,119,145,5,269,0
"220360114","CHACO",232,0,81,100,30,211,0
"220360201","CHACO",61,0,16,16,13,45,0
"220360202","CHACO",79,0,5,22,38,65,0
"220360203","CHACO",69,0,2,2,58,62,0
"220360204","CHACO",26,0,5,20,0,25,0
"220360301","CHACO",2,0,0,1,1,2,0
"220360604","CHACO",35,0,6,5,24,35,0
"220360302","CHACO",159,0,15,80,4,99,0
"220360303","CHACO",35,0,17,16,0,33,0
"220360304","CHACO",145,0,4,54,48,106,0
"220360903","CHACO",4,0,2,2,0,4,0
"220360305","CHACO",64,0,9,41,9,59,0
"220360401","CHACO",28,0,7,15,5,27,0
"220360402","CHACO",20,0,6,10,1,17,0
"220360403","CHACO",87,0,39,23,20,82,0
"220360404","CHACO",26,0,6,15,0,21,0
"220360405","CHACO",118,0,46,47,11,104,0
"220360406","CHACO",31,0,8,6,13,27,0
"220360501","CHACO",17,0,4,5,5,14,0
"220360502","CHACO",41,0,20,13,2,35,0
"220360601","CHACO",31,0,7,9,7,23,0
"220360602","CHACO",26,0,2,4,2,8,0
"220360603","CHACO",124,0,33,34,6,73,0
"220360701","CHACO",29,0,15,2,4,21,0
"220360803","CHACO",6,0,4,0,1,5,0
"220360804","CHACO",7,0,0,3,3,6,0
"220360805","CHACO",2,0,0,2,0,2,0
"220360901","CHACO",446,0,221,140,44,405,0
"220360902","CHACO",145,0,78,25,10,113,0
"220390103","CHACO",14,0,0,8,4,12,0
"220390104","CHACO",14,0,1,10,0,11,0
"220390105","CHACO",138,0,40,59,25,124,0
"220390106","CHACO",277,0,147,83,27,257,0
"220390107","CHACO",234,0,171,41,21,233,0
"220390108","CHACO",192,0,93,74,16,183,0
"220430503","CHACO",18,0,2,10,0,12,0
"220390109","CHACO",298,0,157,81,34,272,0
"220390110","CHACO",221,0,157,51,12,220,0
"220390111","CHACO",218,0,148,34,23,205,0
"220390201","CHACO",31,0,10,14,7,31,0
"220390202","CHACO",34,0,8,14,12,34,0
"220390203","CHACO",32,0,7,10,13,30,0
"220390204","CHACO",51,0,4,20,9,33,0
"220390301","CHACO",26,0,5,9,3,17,0
"220390303","CHACO",43,0,7,17,4,28,0
"220390304","CHACO",34,0,11,13,10,34,0
"220390305","CHACO",95,0,26,13,10,49,0
"220430101","CHACO",262,0,167,64,24,255,0
"220430102","CHACO",208,0,152,43,8,203,0
"220430103","CHACO",312,0,108,121,51,280,0
"220430104","CHACO",239,0,66,95,55,216,0
"220430201","CHACO",142,0,85,43,10,138,0
"220430202","CHACO",82,0,9,19,47,75,0
"220430203","CHACO",100,0,21,50,22,93,0
"220430204","CHACO",45,0,1,32,1,34,0
"220430205","CHACO",351,0,167,110,16,293,0
"220430301","CHACO",16,0,1,10,1,12,0
"220430302","CHACO",146,0,10,82,27,119,0
"220430303","CHACO",152,0,6,91,17,114,0
"220430304","CHACO",175,0,7,92,20,119,0
"220430305","CHACO",237,0,72,91,44,207,0
"220430401","CHACO",18,0,2,9,3,14,0
"220430402","CHACO",92,0,12,32,24,68,0
"220430403","CHACO",37,0,2,17,1,20,0
"220430501","CHACO",31,0,7,5,2,14,0
"220430502","CHACO",58,0,9,15,28,52,0
"220490101","CHACO",266,0,132,74,44,250,0
"220490102","CHACO",268,0,60,108,71,239,0
"220490103","CHACO",302,0,99,113,59,271,0
"220490104","CHACO",283,0,107,128,17,252,0
"220490201","CHACO",23,0,8,8,7,23,0
"220490202","CHACO",24,0,2,7,9,18,0
"220490203","CHACO",4,0,0,3,1,4,0
"220490301","CHACO",40,0,4,17,17,38,0
"220490302","CHACO",44,0,8,14,14,36,0
"220490304","CHACO",454,0,146,197,75,418,0
"220490305","CHACO",21,0,1,2,15,18,0
"220490306","CHACO",25,0,2,11,10,23,0
"220490307","CHACO",180,0,71,71,17,159,0
"220490308","CHACO",145,0,11,55,5,71,0
"220490309","CHACO",282,0,176,45,35,256,0
"220490310","CHACO",174,0,16,26,91,133,0
"220490311","CHACO",407,0,126,182,57,365,0
"220490401","CHACO",29,0,3,16,8,27,0
"220490402","CHACO",16,0,2,6,7,15,0
"220490403","CHACO",48,0,7,16,2,25,0
"220560101","CHACO",401,2,302,62,30,394,0.00498753117206983
"220560102","CHACO",456,9,309,100,11,420,0.0197368421052632
"220560201","CHACO",329,9,157,83,63,303,0.027355623100304
"220560202","CHACO",27,0,9,11,5,25,0
"220560203","CHACO",38,1,6,9,18,33,0.0263157894736842
"220560204","CHACO",2,0,0,2,0,2,0
"220560301","CHACO",49,0,10,31,6,47,0
"220560302","CHACO",52,0,3,17,25,45,0
"220560303","CHACO",88,1,23,31,1,55,0.0113636363636364
"220560304","CHACO",52,1,19,13,11,43,0.0192307692307692
"220560305","CHACO",241,6,166,58,6,230,0.024896265560166
"220560306","CHACO",265,2,200,48,9,257,0.00754716981132075
"220560307","CHACO",19,0,4,13,2,19,0
"220560308","CHACO",11,0,2,5,4,11,0
"220560309","CHACO",227,1,134,68,10,212,0.00440528634361234
"220560310","CHACO",284,6,215,50,4,269,0.0211267605633803
"220630109","CHACO",230,1,164,34,5,203,0.00434782608695652
"220630304","CHACO",203,0,5,54,85,144,0
"220560313","CHACO",385,6,218,135,13,366,0.0155844155844156
"220560311","CHACO",322,21,191,69,15,275,0.0652173913043478
"220560402","CHACO",17,0,10,7,0,17,0
"220630101","CHACO",262,3,136,57,45,238,0.0114503816793893
"220560312","CHACO",105,3,17,64,1,82,0.0285714285714286
"220630102","CHACO",301,4,180,63,17,260,0.0132890365448505
"220630103","CHACO",200,2,117,66,2,185,0.01
"220630104","CHACO",243,3,180,34,2,216,0.0123456790123457
"220630105","CHACO",242,4,169,38,8,215,0.0165289256198347
"220630106","CHACO",250,0,143,63,14,220,0
"220630107","CHACO",297,20,207,38,15,260,0.0673400673400673
"220560314","CHACO",314,14,219,66,8,293,0.0445859872611465
"220560401","CHACO",14,0,1,10,3,14,0
"220630108","CHACO",283,5,170,59,18,247,0.0176678445229682
"220630202","CHACO",365,1,28,101,79,208,0.00273972602739726
"220630203","CHACO",283,0,20,131,104,255,0
"220630204","CHACO",126,0,1,77,38,116,0
"220630206","CHACO",84,0,8,15,47,70,0
"220630305","CHACO",209,0,8,88,14,110,0
"220630306","CHACO",277,0,14,66,24,104,0
"140980311","CORDOBA",251,0,209,32,7,248,0
"220630207","CHACO",56,0,1,31,18,50,0
"220630307","CHACO",155,0,2,14,96,112,0
"220630308","CHACO",114,0,11,34,37,82,0
"220630309","CHACO",427,2,95,238,47,380,0.00468384074941452
"220630208","CHACO",266,19,28,80,76,184,0.0714285714285714
"220630213","CHACO",71,0,1,34,11,46,0
"220630310","CHACO",433,1,69,216,52,337,0.0023094688221709
"220630311","CHACO",394,1,141,188,15,344,0.00253807106598985
"220630401","CHACO",362,11,71,64,96,231,0.0303867403314917
"220630402","CHACO",46,0,0,11,16,27,0
"220630915","CHACO",360,3,69,129,78,276,0.00833333333333333
"220630209","CHACO",87,0,8,14,26,48,0
"220630210","CHACO",273,11,67,86,31,184,0.0402930402930403
"220630211","CHACO",64,0,3,35,7,45,0
"220630214","CHACO",367,4,152,106,50,308,0.0108991825613079
"220630215","CHACO",257,3,148,82,13,243,0.0116731517509728
"220630216","CHACO",76,3,53,15,4,72,0.0394736842105263
"220630301","CHACO",208,0,21,81,50,152,0
"220630212","CHACO",218,0,22,62,81,165,0
"220630302","CHACO",192,0,18,46,116,180,0
"220630303","CHACO",94,0,3,2,36,41,0
"220630403","CHACO",81,0,9,29,13,51,0
"220630404","CHACO",337,7,115,124,40,279,0.0207715133531157
"220630814","CHACO",221,2,141,16,8,165,0.00904977375565611
"220630816","CHACO",323,8,153,70,64,287,0.0247678018575851
"220630817","CHACO",336,7,167,95,29,291,0.0208333333333333
"220630818","CHACO",144,2,95,20,5,120,0.0138888888888889
"220630826","CHACO",122,1,98,7,5,110,0.00819672131147541
"221050105","CHACO",165,0,113,30,1,144,0
"220630919","CHACO",357,1,41,184,86,311,0.00280112044817927
"220630920","CHACO",345,5,66,119,103,288,0.0144927536231884
"220630921","CHACO",385,11,105,166,66,337,0.0285714285714286
"220630922","CHACO",163,12,121,27,1,149,0.0736196319018405
"220630923","CHACO",261,2,77,99,38,214,0.00766283524904215
"740420302","SAN LUIS",67,1,36,24,1,61,0.0149253731343284
"220630501","CHACO",69,0,2,1,19,22,0
"220630827","CHACO",148,0,66,52,13,131,0
"220630502","CHACO",54,0,0,31,14,45,0
"220630503","CHACO",152,0,2,51,32,85,0
"220630824","CHACO",208,0,16,36,100,152,0
"220630825","CHACO",170,4,101,42,18,161,0.0235294117647059
"220700405","CHACO",72,0,1,39,13,53,0
"220630504","CHACO",103,0,0,52,12,64,0
"220630505","CHACO",200,0,1,59,81,141,0
"220630506","CHACO",169,6,52,33,33,118,0.0355029585798817
"220630507","CHACO",156,1,26,68,32,126,0.00641025641025641
"220630508","CHACO",424,1,137,114,105,356,0.00235849056603774
"220630509","CHACO",346,2,116,146,40,302,0.00578034682080925
"141470911","CORDOBA",210,126,73,7,0,80,0.6
"220630601","CHACO",16,0,2,9,0,11,0
"220630602","CHACO",254,0,31,39,63,133,0
"220630603","CHACO",223,0,1,42,82,125,0
"220630604","CHACO",3,0,0,1,1,2,0
"220630605","CHACO",331,0,85,78,100,263,0
"220630701","CHACO",149,1,22,69,33,124,0.00671140939597315
"220630702","CHACO",510,11,2,88,274,364,0.0215686274509804
"220630703","CHACO",132,5,11,25,83,119,0.0378787878787879
"220630704","CHACO",16,0,1,4,2,7,0
"220630705","CHACO",469,8,198,151,50,399,0.0170575692963753
"220630801","CHACO",384,4,140,125,70,335,0.0104166666666667
"220630928","CHACO",180,2,73,71,26,170,0.0111111111111111
"220630929","CHACO",191,1,47,79,41,167,0.00523560209424084
"220630930","CHACO",209,3,88,63,26,177,0.0143540669856459
"220630931","CHACO",283,2,173,32,3,208,0.00706713780918728
"220630932","CHACO",225,1,77,84,20,181,0.00444444444444444
"220700101","CHACO",291,6,136,96,37,269,0.0206185567010309
"220700102","CHACO",262,1,115,91,20,226,0.00381679389312977
"220700103","CHACO",366,22,122,122,45,289,0.0601092896174863
"220770101","CHACO",282,189,40,25,0,65,0.670212765957447
"220700104","CHACO",365,2,135,139,19,293,0.00547945205479452
"220700105","CHACO",251,3,107,80,54,241,0.0119521912350598
"220700201","CHACO",49,0,7,40,0,47,0
"141470910","CORDOBA",209,114,68,24,3,95,0.545454545454545
"220700202","CHACO",350,3,151,130,30,311,0.00857142857142857
"220700203","CHACO",28,0,4,10,9,23,0
"220700204","CHACO",25,0,7,13,2,22,0
"220700205","CHACO",142,2,20,67,40,127,0.0140845070422535
"220700206","CHACO",386,2,101,177,40,318,0.00518134715025907
"220700301","CHACO",296,4,88,133,53,274,0.0135135135135135
"220700302","CHACO",64,0,35,18,3,56,0
"220700406","CHACO",356,2,77,187,64,328,0.00561797752808989
"220700303","CHACO",53,0,5,28,4,37,0
"220700304","CHACO",56,0,2,20,16,38,0
"220700305","CHACO",48,0,4,7,28,39,0
"220700306","CHACO",68,0,9,23,21,53,0
"220700307","CHACO",332,4,114,138,62,314,0.0120481927710843
"220700308","CHACO",250,4,59,152,14,225,0.016
"220700309","CHACO",217,1,93,71,23,187,0.00460829493087558
"220700310","CHACO",130,0,29,38,35,102,0
"220700311","CHACO",194,0,37,106,27,170,0
"220700401","CHACO",298,0,82,138,52,272,0
"220700402","CHACO",63,1,8,35,19,62,0.0158730158730159
"220700403","CHACO",73,0,13,53,2,68,0
"220700404","CHACO",33,0,9,9,5,23,0
"220770102","CHACO",166,121,22,21,0,43,0.728915662650602
"220840504","CHACO",277,5,105,108,37,250,0.0180505415162455
"220770103","CHACO",405,262,75,48,9,132,0.646913580246914
"220770104","CHACO",260,14,170,57,14,241,0.0538461538461538
"220770105","CHACO",248,213,22,13,0,35,0.858870967741935
"220840502","CHACO",281,24,141,73,27,241,0.0854092526690391
"141400312","CORDOBA",250,15,229,6,0,235,0.06
"221050106","CHACO",265,0,174,75,7,256,0
"220841101","CHACO",368,6,136,158,40,334,0.016304347826087
"220770106","CHACO",218,105,66,33,8,107,0.481651376146789
"220770107","CHACO",296,243,16,28,5,49,0.820945945945946
"220770201","CHACO",75,3,28,28,10,66,0.04
"220770202","CHACO",216,0,95,91,9,195,0
"220840503","CHACO",288,0,157,94,27,278,0
"220770203","CHACO",47,0,29,8,2,39,0
"220770204","CHACO",24,0,13,8,0,21,0
"220770205","CHACO",33,0,13,16,3,32,0
"220770206","CHACO",116,26,49,9,4,62,0.224137931034483
"220770207","CHACO",37,20,11,2,0,13,0.540540540540541
"220770304","CHACO",120,0,51,46,12,109,0
"220770401","CHACO",6,0,4,1,0,5,0
"220980502","CHACO",53,0,6,36,7,49,0
"220770208","CHACO",78,6,43,22,2,67,0.0769230769230769
"220770301","CHACO",71,3,33,21,13,67,0.0422535211267606
"220770305","CHACO",32,0,6,18,5,29,0
"220840601","CHACO",308,5,162,101,38,301,0.0162337662337662
"220980117","CHACO",205,114,64,17,6,87,0.55609756097561
"220770302","CHACO",266,183,21,48,5,74,0.68796992481203
"220770303","CHACO",166,2,60,75,7,142,0.0120481927710843
"220770306","CHACO",11,0,4,6,0,10,0
"220770307","CHACO",25,0,5,14,2,21,0
"220770308","CHACO",10,0,2,6,0,8,0
"220841005","CHACO",303,5,195,83,9,287,0.0165016501650165
"220770402","CHACO",15,0,0,11,0,11,0
"220770403","CHACO",14,0,3,10,1,14,0
"220840101","CHACO",501,7,243,118,45,406,0.0139720558882236
"220840102","CHACO",250,9,104,70,10,184,0.036
"220840103","CHACO",284,5,155,85,8,248,0.0176056338028169
"220840104","CHACO",279,7,120,97,8,225,0.025089605734767
"220840105","CHACO",406,2,24,179,103,306,0.00492610837438424
"220840201","CHACO",19,0,0,1,16,17,0
"220840202","CHACO",111,0,4,59,36,99,0
"220840205","CHACO",588,0,32,324,103,459,0
"220840203","CHACO",255,1,11,75,111,197,0.00392156862745098
"220840206","CHACO",140,1,7,111,11,129,0.00714285714285714
"220840204","CHACO",160,0,27,91,4,122,0
"220840303","CHACO",92,0,4,54,7,65,0
"220980301","CHACO",163,0,40,77,39,156,0
"220840207","CHACO",85,0,9,36,23,68,0
"220840208","CHACO",225,4,151,58,10,219,0.0177777777777778
"220840209","CHACO",398,12,128,127,39,294,0.0301507537688442
"220840301","CHACO",18,0,4,0,6,10,0
"220840302","CHACO",26,0,1,7,12,20,0
"220840401","CHACO",108,0,25,54,14,93,0
"220840404","CHACO",39,0,4,14,16,34,0
"220980503","CHACO",39,0,7,18,12,37,0
"220840402","CHACO",92,0,26,44,16,86,0
"220840403","CHACO",47,1,7,23,4,34,0.0212765957446809
"220840501","CHACO",267,0,178,53,11,242,0
"220980119","CHACO",334,248,12,37,13,62,0.74251497005988
"220840602","CHACO",30,0,0,18,10,28,0
"220840603","CHACO",51,0,8,20,15,43,0
"220840604","CHACO",120,0,35,52,16,103,0
"220840605","CHACO",208,2,165,34,0,199,0.00961538461538462
"220841006","CHACO",167,2,52,62,27,141,0.0119760479041916
"220980120","CHACO",269,218,33,16,1,50,0.810408921933085
"220840606","CHACO",18,0,4,10,4,18,0
"220840607","CHACO",7,0,1,2,0,3,0
"220841102","CHACO",175,104,61,7,0,68,0.594285714285714
"220841103","CHACO",135,0,57,69,2,128,0
"220841104","CHACO",278,7,138,113,6,257,0.0251798561151079
"220840701","CHACO",143,2,15,77,19,111,0.013986013986014
"220840702","CHACO",13,0,0,9,0,9,0
"220840703","CHACO",22,0,4,8,4,16,0
"220840704","CHACO",18,0,0,16,1,17,0
"220980601","CHACO",130,28,54,22,4,80,0.215384615384615
"220840705","CHACO",27,4,7,8,3,18,0.148148148148148
"220840706","CHACO",38,1,10,11,15,36,0.0263157894736842
"220840707","CHACO",64,0,12,35,15,62,0
"220840801","CHACO",148,0,17,78,36,131,0
"220910105","CHACO",234,1,111,37,28,176,0.00427350427350427
"220910201","CHACO",47,0,3,13,9,25,0
"220840802","CHACO",72,1,7,29,21,57,0.0138888888888889
"220840803","CHACO",110,1,9,51,27,87,0.00909090909090909
"220840804","CHACO",214,0,27,89,54,170,0
"220910202","CHACO",79,0,12,18,31,61,0
"220910203","CHACO",73,0,8,21,25,54,0
"220840805","CHACO",136,0,13,48,48,109,0
"220840904","CHACO",39,0,12,21,2,35,0
"220910204","CHACO",89,0,13,18,3,34,0
"221120902","CHACO",26,0,2,5,1,8,0
"220840901","CHACO",15,0,3,6,3,12,0
"220840902","CHACO",13,0,1,8,3,12,0
"220841001","CHACO",88,1,20,33,8,61,0.0113636363636364
"221120903","CHACO",40,0,13,9,15,37,0
"220840903","CHACO",79,0,14,28,14,56,0
"220841002","CHACO",283,4,132,105,17,254,0.0141342756183746
"220841003","CHACO",13,0,1,8,3,12,0
"220841004","CHACO",143,80,16,29,5,50,0.559440559440559
"220841105","CHACO",259,173,27,56,2,85,0.667953667953668
"220841106","CHACO",269,1,129,123,14,266,0.00371747211895911
"220841107","CHACO",240,148,56,14,0,70,0.616666666666667
"220841108","CHACO",274,193,41,38,0,79,0.704379562043796
"220841109","CHACO",157,11,82,51,3,136,0.0700636942675159
"220841110","CHACO",392,375,11,5,0,16,0.956632653061224
"220841111","CHACO",259,85,45,75,15,135,0.328185328185328
"220841112","CHACO",248,4,108,125,8,241,0.0161290322580645
"220841201","CHACO",421,214,53,105,17,175,0.508313539192399
"220841202","CHACO",335,112,54,138,0,192,0.334328358208955
"220910301","CHACO",115,0,17,42,29,88,0
"220980501","CHACO",75,0,10,33,12,55,0
"220841203","CHACO",217,7,56,122,13,191,0.032258064516129
"220841204","CHACO",264,47,76,111,4,191,0.178030303030303
"220841205","CHACO",244,223,12,4,0,16,0.913934426229508
"220841206","CHACO",207,173,20,12,0,32,0.835748792270531
"220841207","CHACO",308,219,57,20,2,79,0.711038961038961
"220841208","CHACO",195,99,33,50,1,84,0.507692307692308
"220841209","CHACO",210,89,49,59,6,114,0.423809523809524
"220841210","CHACO",260,11,17,115,86,218,0.0423076923076923
"220841211","CHACO",361,285,4,59,4,67,0.789473684210526
"220910507","CHACO",277,8,181,61,19,261,0.0288808664259928
"220841212","CHACO",239,4,68,130,15,213,0.0167364016736402
"220841213","CHACO",258,57,101,91,4,196,0.22093023255814
"220841214","CHACO",256,31,49,140,16,205,0.12109375
"220841215","CHACO",265,13,180,33,22,235,0.0490566037735849
"220841216","CHACO",391,117,33,107,94,234,0.29923273657289
"220841217","CHACO",186,4,56,66,38,160,0.021505376344086
"220910101","CHACO",339,12,228,47,29,304,0.0353982300884956
"220910102","CHACO",252,1,179,47,5,231,0.00396825396825397
"220910103","CHACO",389,2,212,86,28,326,0.0051413881748072
"220910104","CHACO",269,1,214,33,8,255,0.00371747211895911
"220910302","CHACO",133,0,10,28,59,97,0
"220910303","CHACO",183,0,26,105,48,179,0
"220910304","CHACO",61,0,4,16,39,59,0
"220910401","CHACO",96,0,14,21,32,67,0
"220910402","CHACO",135,0,11,26,63,100,0
"220910403","CHACO",130,0,18,45,28,91,0
"220910404","CHACO",61,0,18,31,5,54,0
"220910501","CHACO",445,42,169,147,55,371,0.0943820224719101
"220910502","CHACO",254,0,115,65,51,231,0
"220910503","CHACO",104,0,7,56,22,85,0
"220910504","CHACO",110,0,9,45,33,87,0
"220910505","CHACO",62,0,5,27,27,59,0
"220910506","CHACO",100,0,13,34,36,83,0
"220910508","CHACO",444,0,242,94,46,382,0
"220910509","CHACO",348,210,54,26,31,111,0.603448275862069
"220910510","CHACO",283,248,11,7,3,21,0.876325088339223
"220910511","CHACO",223,6,72,66,65,203,0.0269058295964126
"220910512","CHACO",270,4,145,56,29,230,0.0148148148148148
"220910513","CHACO",277,1,153,75,19,247,0.0036101083032491
"220910601","CHACO",44,0,2,10,21,33,0
"220910602","CHACO",119,1,17,28,55,100,0.00840336134453781
"220910701","CHACO",44,0,13,9,11,33,0
"220910702","CHACO",44,0,7,11,8,26,0
"220910703","CHACO",111,0,14,18,31,63,0
"220910704","CHACO",102,2,18,40,35,93,0.0196078431372549
"220980101","CHACO",287,226,38,11,9,58,0.787456445993031
"220980102","CHACO",163,0,19,69,41,129,0
"220980103","CHACO",516,221,134,86,27,247,0.428294573643411
"220980104","CHACO",272,246,15,4,1,20,0.904411764705882
"220980105","CHACO",300,19,134,89,1,224,0.0633333333333333
"220980106","CHACO",276,14,122,120,7,249,0.0507246376811594
"220980107","CHACO",284,206,19,41,0,60,0.725352112676056
"220980108","CHACO",241,149,45,36,4,85,0.618257261410788
"220980109","CHACO",246,221,20,3,2,25,0.898373983739837
"220980110","CHACO",311,42,131,121,2,254,0.135048231511254
"220980111","CHACO",375,69,134,154,12,300,0.184
"220980112","CHACO",163,145,6,4,1,11,0.889570552147239
"220980113","CHACO",118,110,7,1,0,8,0.932203389830508
"220980114","CHACO",133,119,8,6,0,14,0.894736842105263
"220980115","CHACO",167,156,8,0,0,8,0.934131736526946
"220980116","CHACO",161,149,10,1,0,11,0.925465838509317
"140982012","CORDOBA",211,208,3,0,0,3,0.985781990521327
"220980121","CHACO",331,61,106,92,33,231,0.18429003021148
"220980122","CHACO",254,119,28,72,10,110,0.468503937007874
"220980123","CHACO",264,162,35,27,6,68,0.613636363636364
"220980201","CHACO",57,28,4,14,4,22,0.491228070175439
"220980202","CHACO",135,0,5,65,35,105,0
"220980203","CHACO",12,1,0,6,2,8,0.0833333333333333
"220980204","CHACO",25,0,6,6,4,16,0
"220980205","CHACO",45,0,14,14,3,31,0
"220980206","CHACO",44,0,12,25,1,38,0
"220980207","CHACO",77,0,10,23,25,58,0
"220980208","CHACO",46,0,19,11,15,45,0
"220980209","CHACO",69,0,4,23,39,66,0
"220980210","CHACO",25,0,9,6,10,25,0
"220980211","CHACO",81,0,6,30,14,50,0
"220980212","CHACO",43,0,11,10,7,28,0
"220980213","CHACO",60,0,5,10,15,30,0
"220980214","CHACO",209,1,8,151,26,185,0.00478468899521531
"220980302","CHACO",291,0,129,109,37,275,0
"220980303","CHACO",278,0,121,132,14,267,0
"220980304","CHACO",206,8,139,46,12,197,0.0388349514563107
"220980305","CHACO",266,0,168,78,3,249,0
"220980306","CHACO",217,0,47,88,40,175,0
"220980307","CHACO",213,7,102,85,12,199,0.0328638497652582
"220980401","CHACO",217,2,140,35,32,207,0.00921658986175115
"220980402","CHACO",36,0,13,9,8,30,0
"220980403","CHACO",37,0,11,13,12,36,0
"220980404","CHACO",25,0,3,20,0,23,0
"220980405","CHACO",28,0,3,19,2,24,0
"220980406","CHACO",289,2,17,49,88,154,0.0069204152249135
"220980407","CHACO",114,0,50,43,13,106,0
"220980408","CHACO",303,0,126,94,12,232,0
"220980602","CHACO",59,0,1,28,24,53,0
"220980603","CHACO",66,0,9,24,11,44,0
"220980604","CHACO",11,0,0,6,0,6,0
"220980605","CHACO",40,1,8,26,1,35,0.025
"220980701","CHACO",436,75,94,203,36,333,0.172018348623853
"220980702","CHACO",409,9,136,149,23,308,0.0220048899755501
"220980703","CHACO",197,3,82,73,10,165,0.0152284263959391
"220980704","CHACO",202,52,82,46,12,140,0.257425742574257
"220980705","CHACO",195,170,18,7,0,25,0.871794871794872
"220980706","CHACO",298,40,120,108,6,234,0.134228187919463
"220980707","CHACO",467,68,164,169,31,364,0.145610278372591
"220980708","CHACO",427,7,66,273,9,348,0.0163934426229508
"220980709","CHACO",356,197,72,54,12,138,0.553370786516854
"220980710","CHACO",261,147,62,33,6,101,0.563218390804598
"220980711","CHACO",83,0,66,7,5,78,0
"220980712","CHACO",170,4,45,87,24,156,0.0235294117647059
"220980713","CHACO",151,2,59,52,24,135,0.0132450331125828
"220980714","CHACO",223,1,51,119,20,190,0.00448430493273543
"220980715","CHACO",398,30,65,222,35,322,0.0753768844221105
"220980716","CHACO",27,0,1,23,1,25,0
"220980717","CHACO",321,54,97,132,21,250,0.168224299065421
"220980718","CHACO",563,225,106,174,29,309,0.399644760213144
"220980719","CHACO",99,1,15,41,29,85,0.0101010101010101
"220980720","CHACO",274,7,38,186,28,252,0.0255474452554745
"221050101","CHACO",184,0,67,68,30,165,0
"221050102","CHACO",200,0,93,70,4,167,0
"221050103","CHACO",191,0,129,40,6,175,0
"221050104","CHACO",173,0,145,22,3,170,0
"221050107","CHACO",326,0,173,107,23,303,0
"221050108","CHACO",357,0,191,80,64,335,0
"221050109","CHACO",317,0,221,61,16,298,0
"221050110","CHACO",217,0,152,44,13,209,0
"221050111","CHACO",228,0,131,81,6,218,0
"221050112","CHACO",246,0,191,41,6,238,0
"221050113","CHACO",171,0,107,25,6,138,0
"221050114","CHACO",232,0,49,145,13,207,0
"221050115","CHACO",160,0,33,74,38,145,0
"221050201","CHACO",113,0,19,35,45,99,0
"221050202","CHACO",84,0,6,29,30,65,0
"221050203","CHACO",153,0,18,70,23,111,0
"221050204","CHACO",45,0,6,11,20,37,0
"221050205","CHACO",115,0,11,35,20,66,0
"221050301","CHACO",555,0,228,149,118,495,0
"221050302","CHACO",35,0,3,5,11,19,0
"221050405","CHACO",49,0,3,17,3,23,0
"221050303","CHACO",347,0,51,139,107,297,0
"221050304","CHACO",104,0,14,36,41,91,0
"221050305","CHACO",70,0,6,20,8,34,0
"221050306","CHACO",150,0,15,57,22,94,0
"221050307","CHACO",67,0,8,41,8,57,0
"221050308","CHACO",37,0,4,9,8,21,0
"221050309","CHACO",66,0,5,26,17,48,0
"221050310","CHACO",95,0,28,51,11,90,0
"221050311","CHACO",416,0,306,80,13,399,0
"221050312","CHACO",415,0,223,104,41,368,0
"221050313","CHACO",16,0,8,2,5,15,0
"221050314","CHACO",327,0,65,147,62,274,0
"221050315","CHACO",286,0,141,100,33,274,0
"221050316","CHACO",328,0,170,93,23,286,0
"221050317","CHACO",278,0,43,137,85,265,0
"221050401","CHACO",21,0,2,10,6,18,0
"221050402","CHACO",26,0,11,8,5,24,0
"221050403","CHACO",71,0,7,22,3,32,0
"221050404","CHACO",97,0,2,37,26,65,0
"221120101","CHACO",359,3,227,75,17,319,0.00835654596100279
"221120102","CHACO",286,3,212,39,18,269,0.0104895104895105
"221120103","CHACO",425,2,184,153,36,373,0.00470588235294118
"221120104","CHACO",383,1,197,136,28,361,0.00261096605744125
"221120105","CHACO",413,2,215,108,38,361,0.00484261501210654
"221120106","CHACO",486,1,143,153,88,384,0.00205761316872428
"221120201","CHACO",0,0,0,0,0,0,NA
"221120202","CHACO",50,0,22,21,0,43,0
"221120203","CHACO",19,0,3,1,7,11,0
"221120301","CHACO",230,0,179,35,11,225,0
"221120302","CHACO",437,28,349,42,3,394,0.0640732265446224
"221120303","CHACO",34,0,5,9,15,29,0
"221120304","CHACO",24,0,0,8,6,14,0
"221120305","CHACO",33,0,5,17,1,23,0
"221120306","CHACO",191,0,139,31,16,186,0
"221120401","CHACO",199,14,127,34,16,177,0.0703517587939698
"221120402","CHACO",175,9,64,75,21,160,0.0514285714285714
"221120403","CHACO",107,0,4,42,43,89,0
"221120404","CHACO",142,0,32,41,29,102,0
"221120405","CHACO",31,0,5,5,20,30,0
"221120406","CHACO",40,0,4,9,2,15,0
"221120407","CHACO",311,4,171,105,27,303,0.0128617363344051
"221120408","CHACO",49,0,4,19,15,38,0
"221120501","CHACO",19,0,6,9,1,16,0
"221120502","CHACO",26,0,6,13,0,19,0
"221120503","CHACO",18,0,5,6,5,16,0
"221120504","CHACO",32,0,6,10,2,18,0
"221120505","CHACO",41,0,19,11,7,37,0
"221120601","CHACO",15,0,3,6,5,14,0
"221120602","CHACO",32,0,13,8,4,25,0
"221120603","CHACO",39,0,5,7,20,32,0
"221120701","CHACO",42,0,9,5,19,33,0
"221120702","CHACO",33,0,6,15,3,24,0
"221120801","CHACO",56,0,5,23,14,42,0
"221120802","CHACO",67,1,10,36,2,48,0.0149253731343284
"221120803","CHACO",78,0,5,22,5,32,0
"221121001","CHACO",90,0,11,46,8,65,0
"221121002","CHACO",55,2,10,8,2,20,0.0363636363636364
"221121003","CHACO",16,0,0,2,9,11,0
"221190101","CHACO",229,129,46,35,9,90,0.563318777292576
"221190102","CHACO",318,64,61,158,21,240,0.20125786163522
"221190103","CHACO",384,108,81,128,35,244,0.28125
"221190104","CHACO",402,161,103,108,17,228,0.400497512437811
"221190105","CHACO",228,101,48,70,3,121,0.442982456140351
"221190106","CHACO",348,179,78,71,11,160,0.514367816091954
"221190107","CHACO",293,126,42,64,19,125,0.430034129692833
"221190108","CHACO",289,115,69,74,17,160,0.397923875432526
"221190201","CHACO",161,6,35,83,17,135,0.0372670807453416
"221190202","CHACO",200,11,41,102,26,169,0.055
"221190203","CHACO",104,0,20,50,20,90,0
"221190204","CHACO",89,1,8,34,34,76,0.0112359550561798
"221190205","CHACO",164,0,15,55,57,127,0
"221190206","CHACO",57,0,5,32,8,45,0
"221190207","CHACO",23,0,1,16,4,21,0
"221190208","CHACO",41,0,10,19,9,38,0
"221190301","CHACO",47,0,0,22,16,38,0
"221190302","CHACO",13,0,0,5,3,8,0
"221190303","CHACO",26,1,4,7,13,24,0.0384615384615385
"221260101","CHACO",283,0,225,52,0,277,0
"221260102","CHACO",203,0,185,15,1,201,0
"221260103","CHACO",160,0,112,45,0,157,0
"221260104","CHACO",238,0,171,50,6,227,0
"221260105","CHACO",193,0,159,24,5,188,0
"221260201","CHACO",25,0,6,16,2,24,0
"221260202","CHACO",111,0,43,47,11,101,0
"221260203","CHACO",49,0,15,27,4,46,0
"140560317","CORDOBA",184,5,160,14,2,176,0.0271739130434783
"221260204","CHACO",46,0,26,16,3,45,0
"221260301","CHACO",250,0,97,109,12,218,0
"221260302","CHACO",48,0,11,20,1,32,0
"221260311","CHACO",56,0,13,31,6,50,0
"221260312","CHACO",206,0,57,87,16,160,0
"221260313","CHACO",179,0,146,27,1,174,0
"221260314","CHACO",303,0,238,45,7,290,0
"221260303","CHACO",100,0,54,23,11,88,0
"221260304","CHACO",172,0,137,31,1,169,0
"221260305","CHACO",231,0,174,39,7,220,0
"221260306","CHACO",25,0,19,6,0,25,0
"221260307","CORRIENTES",16,0,1,7,7,15,0
"221260315","CHACO",12,0,9,0,1,10,0
"221260308","CHACO",19,0,10,3,2,15,0
"221260309","CHACO",11,0,7,4,0,11,0
"221260310","CHACO",18,0,4,10,4,18,0
"221330101","CHACO",218,29,87,54,34,175,0.13302752293578
"221330102","CHACO",305,121,92,78,2,172,0.39672131147541
"221330103","CHACO",318,164,72,55,20,147,0.515723270440252
"221330104","CHACO",327,94,153,49,6,208,0.287461773700306
"221330105","CHACO",170,141,16,12,0,28,0.829411764705882
"221330106","CHACO",337,180,88,61,5,154,0.534124629080119
"221330107","CHACO",170,118,31,19,1,51,0.694117647058824
"221330108","CHACO",456,10,93,207,80,380,0.0219298245614035
"221330109","CHACO",371,64,85,157,12,254,0.172506738544474
"221330110","CHACO",186,13,81,69,10,160,0.0698924731182796
"221330111","CHACO",272,134,63,58,6,127,0.492647058823529
"221330112","CHACO",217,54,62,73,15,150,0.248847926267281
"221330113","CHACO",178,64,36,35,15,86,0.359550561797753
"221330114","CHACO",376,4,63,176,72,311,0.0106382978723404
"221330307","CHACO",43,0,11,23,7,41,0
"221330115","CHACO",347,104,107,126,7,240,0.29971181556196
"221330116","CHACO",174,117,29,17,10,56,0.672413793103448
"221330117","CHACO",145,23,70,44,3,117,0.158620689655172
"221330118","CHACO",238,10,126,69,14,209,0.0420168067226891
"221330119","CHACO",282,6,85,115,40,240,0.0212765957446809
"221330120","CHACO",249,186,36,25,1,62,0.746987951807229
"221330201","CHACO",52,0,10,7,26,43,0
"221330202","CHACO",105,0,18,43,34,95,0
"221330203","CHACO",113,0,11,55,43,109,0
"221330204","CHACO",23,0,3,12,5,20,0
"221330205","CHACO",83,0,4,17,58,79,0
"221330206","CHACO",81,0,9,31,27,67,0
"221330207","CHACO",217,1,66,126,5,197,0.00460829493087558
"221330208","CHACO",53,0,7,16,18,41,0
"221330301","CHACO",85,0,13,37,28,78,0
"221330302","CHACO",110,0,10,41,51,102,0
"221330303","CHACO",65,1,3,17,44,64,0.0153846153846154
"221330304","CHACO",59,0,16,26,11,53,0
"221330305","CHACO",69,1,13,42,5,60,0.0144927536231884
"221330411","CHACO",121,3,4,74,10,88,0.0247933884297521
"221330412","CHACO",353,274,4,48,9,61,0.776203966005666
"221330413","CHACO",312,243,37,10,4,51,0.778846153846154
"221330414","CHACO",211,152,33,1,0,34,0.720379146919431
"221330415","CHACO",134,2,10,61,34,105,0.0149253731343284
"221330501","CHACO",48,0,1,38,1,40,0
"221330502","CHACO",272,0,26,71,141,238,0
"221330503","CHACO",57,0,7,21,29,57,0
"221330504","CHACO",32,0,0,16,16,32,0
"221330505","CHACO",53,0,4,20,12,36,0
"221330506","CHACO",17,0,10,4,1,15,0
"221330507","CHACO",18,0,14,3,1,18,0
"221330508","CHACO",22,0,3,4,10,17,0
"221400101","CHACO",133,63,29,29,6,64,0.473684210526316
"221400102","CHACO",407,116,186,39,25,250,0.285012285012285
"221400417","CHACO",71,1,60,9,0,69,0.0140845070422535
"221400103","CHACO",174,94,53,22,4,79,0.540229885057471
"221400104","CHACO",310,255,33,16,1,50,0.82258064516129
"221400105","CHACO",237,3,193,36,0,229,0.0126582278481013
"221400106","CHACO",288,7,106,126,25,257,0.0243055555555556
"221400107","CHACO",358,34,176,89,25,290,0.0949720670391061
"221400114","CHACO",111,1,62,36,2,100,0.00900900900900901
"221400115","CHACO",230,54,50,101,8,159,0.234782608695652
"221400108","CHACO",123,2,62,45,11,118,0.016260162601626
"221400109","CHACO",292,21,201,58,2,261,0.0719178082191781
"221400110","CHACO",202,14,135,48,1,184,0.0693069306930693
"221400111","CHACO",381,13,319,43,1,363,0.0341207349081365
"221400112","CHACO",258,20,178,52,1,231,0.0775193798449612
"221400113","CHACO",239,3,84,99,20,203,0.0125523012552301
"221400116","CHACO",200,7,148,40,3,191,0.035
"221400205","CHACO",224,14,184,22,2,208,0.0625
"221400206","CHACO",368,18,269,66,3,338,0.0489130434782609
"221400207","CHACO",355,11,154,154,12,320,0.0309859154929577
"221400208","CHACO",302,15,186,95,1,282,0.0496688741721854
"221400209","CHACO",219,15,157,43,2,202,0.0684931506849315
"221400210","CHACO",339,11,263,56,2,321,0.0324483775811209
"221400501","CHACO",236,179,50,6,0,56,0.758474576271186
"141470110","CORDOBA",363,9,280,62,2,344,0.0247933884297521
"221400718","CHACO",302,13,234,47,4,285,0.043046357615894
"221400211","CHACO",270,11,180,68,3,251,0.0407407407407407
"221400301","CHACO",207,207,0,0,0,0,1
"221400302","CHACO",201,198,1,1,0,2,0.985074626865672
"221400303","CHACO",281,238,4,0,0,4,0.846975088967972
"221400304","CHACO",251,251,0,0,0,0,1
"221400305","CHACO",272,267,5,0,0,5,0.981617647058823
"221400306","CHACO",214,194,3,8,0,11,0.906542056074766
"221400307","CHACO",202,181,20,0,0,20,0.896039603960396
"221400308","CHACO",232,212,16,3,0,19,0.913793103448276
"221400309","CHACO",250,45,132,68,0,200,0.18
"221400310","CHACO",209,175,20,14,0,34,0.837320574162679
"221400311","CHACO",234,156,71,3,4,78,0.666666666666667
"221400312","CHACO",335,11,203,101,5,309,0.0328358208955224
"221400502","CHACO",217,175,39,3,0,42,0.806451612903226
"221400313","CHACO",367,16,216,99,10,325,0.0435967302452316
"221400401","CHACO",128,127,1,0,0,1,0.9921875
"221400402","CHACO",185,184,0,1,0,1,0.994594594594595
"221400403","CHACO",228,225,1,2,0,3,0.986842105263158
"221400404","CHACO",273,262,11,0,0,11,0.95970695970696
"221400405","CHACO",270,251,15,3,0,18,0.92962962962963
"221400406","CHACO",224,219,4,1,0,5,0.977678571428571
"221400407","CHACO",267,264,1,0,0,1,0.98876404494382
"221400408","CHACO",204,204,0,0,0,0,1
"221400409","CHACO",288,235,31,20,0,51,0.815972222222222
"221400410","CHACO",219,197,18,4,0,22,0.899543378995434
"221400411","CHACO",291,216,40,32,2,74,0.742268041237113
"221400412","CHACO",294,167,99,25,3,127,0.568027210884354
"221400413","CHACO",163,128,25,10,0,35,0.785276073619632
"221400414","CHACO",255,26,174,50,3,227,0.101960784313725
"221400415","CHACO",139,85,27,13,2,42,0.611510791366906
"221400416","CHACO",201,130,63,5,2,70,0.646766169154229
"221400604","CHACO",241,225,16,0,0,16,0.933609958506224
"221400504","CHACO",241,178,26,22,9,57,0.738589211618257
"221400505","CHACO",402,107,132,137,19,288,0.266169154228856
"221400506","CHACO",277,139,34,86,7,127,0.501805054151625
"221400507","CHACO",296,45,143,90,10,243,0.152027027027027
"221400508","CHACO",338,5,153,115,17,285,0.014792899408284
"221400509","CHACO",211,9,139,55,3,197,0.042654028436019
"221400510","CHACO",246,16,133,89,0,222,0.0650406504065041
"221400711","CHACO",214,199,9,5,0,14,0.929906542056075
"221400511","CHACO",233,6,106,99,13,218,0.0257510729613734
"221400512","CHACO",302,25,102,134,8,244,0.0827814569536424
"221400513","CHACO",312,149,31,97,7,135,0.477564102564103
"221400514","CHACO",256,14,99,96,17,212,0.0546875
"221400601","CHACO",377,18,179,148,13,340,0.0477453580901857
"221400602","CHACO",253,168,63,15,5,83,0.66403162055336
"221400715","CHACO",193,21,133,35,0,168,0.10880829015544
"221400603","CHACO",279,261,14,3,0,17,0.935483870967742
"221400605","CHACO",308,75,159,59,2,220,0.243506493506494
"221400606","CHACO",387,26,288,55,12,355,0.0671834625322997
"221400607","CHACO",211,124,49,34,4,87,0.587677725118483
"221400608","CHACO",405,332,18,27,2,47,0.819753086419753
"221400609","CHACO",375,375,0,0,0,0,1
"221400610","CHACO",337,312,8,6,1,15,0.925816023738872
"221400611","CHACO",283,77,108,90,1,199,0.27208480565371
"221400713","CHACO",180,31,135,12,2,149,0.172222222222222
"221400714","CHACO",295,12,211,66,2,279,0.0406779661016949
"221400716","CHACO",287,25,174,70,2,246,0.0871080139372822
"221400612","CHACO",165,8,97,51,4,152,0.0484848484848485
"221400701","CHACO",257,240,10,3,0,13,0.933852140077821
"221400702","CHACO",329,251,29,41,1,71,0.762917933130699
"221400703","CHACO",299,114,163,15,0,178,0.381270903010033
"221400704","CHACO",240,2,139,57,3,199,0.00833333333333333
"221400705","CHACO",234,31,112,83,6,201,0.132478632478632
"221400706","CHACO",335,133,118,76,0,194,0.397014925373134
"221400707","CHACO",211,189,17,5,0,22,0.895734597156398
"221400708","CHACO",265,8,188,60,6,254,0.030188679245283
"221400709","CHACO",209,187,6,1,0,7,0.894736842105263
"221400710","CHACO",234,228,3,0,0,3,0.974358974358974
"221400721","CHACO",255,79,117,42,7,166,0.309803921568627
"221400722","CHACO",10,10,0,0,0,0,1
"221400723","CHACO",251,1,177,62,2,241,0.00398406374501992
"221400724","CHACO",328,1,221,61,4,286,0.00304878048780488
"221400725","CHACO",250,10,180,53,5,238,0.04
"221400726","CHACO",243,216,10,12,0,22,0.888888888888889
"221400727","CHACO",269,57,87,117,2,206,0.211895910780669
"221400728","CHACO",193,26,103,60,0,163,0.134715025906736
"221400729","CHACO",153,9,91,49,3,143,0.0588235294117647
"221400801","CHACO",260,257,3,0,0,3,0.988461538461539
"221400802","CHACO",255,254,0,0,0,0,0.996078431372549
"221400803","CHACO",256,219,32,4,1,37,0.85546875
"221400804","CHACO",122,122,0,0,0,0,1
"221400805","CHACO",205,201,3,1,0,4,0.980487804878049
"221400806","CHACO",214,212,1,1,0,2,0.990654205607477
"221400807","CHACO",259,258,1,0,0,1,0.996138996138996
"221400808","CHACO",308,305,3,0,0,3,0.99025974025974
"221400809","CHACO",148,146,2,0,0,2,0.986486486486487
"221400810","CHACO",289,18,186,60,1,247,0.0622837370242214
"221400811","CHACO",238,29,156,45,1,202,0.121848739495798
"221400812","CHACO",177,174,2,1,0,3,0.983050847457627
"221400813","CHACO",239,232,6,0,0,6,0.97071129707113
"221400814","CHACO",293,287,5,1,0,6,0.979522184300341
"221400815","CHACO",281,277,3,0,0,3,0.98576512455516
"221400816","CHACO",120,119,1,0,0,1,0.991666666666667
"221400817","CHACO",184,181,3,0,0,3,0.983695652173913
"221400818","CHACO",167,167,0,0,0,0,1
"221400901","CHACO",232,218,14,0,0,14,0.939655172413793
"221400902","CHACO",397,365,7,3,2,12,0.919395465994962
"221400903","CHACO",322,300,0,0,0,0,0.93167701863354
"221400904","CHACO",331,136,134,49,0,183,0.410876132930514
"221400905","CHACO",308,230,53,23,2,78,0.746753246753247
"221400906","CHACO",359,359,0,0,0,0,1
"221400907","CHACO",270,136,44,54,5,103,0.503703703703704
"221400910","CHACO",358,357,1,0,0,1,0.997206703910615
"221400911","CHACO",253,253,0,0,0,0,1
"221400912","CHACO",182,181,1,0,0,1,0.994505494505495
"221400913","CHACO",352,348,4,0,0,4,0.988636363636364
"221400914","CHACO",399,398,1,0,0,1,0.99749373433584
"221400915","CHACO",353,348,0,1,0,1,0.985835694050991
"221400916","CHACO",341,276,41,22,1,64,0.809384164222874
"221400917","CHACO",222,43,75,84,13,172,0.193693693693694
"221400918","CHACO",226,224,2,0,0,2,0.991150442477876
"221401001","CHACO",306,89,146,54,13,213,0.290849673202614
"221401002","CHACO",200,10,91,49,1,141,0.05
"221401003","CHACO",283,57,98,89,32,219,0.201413427561837
"221401004","CHACO",366,62,241,42,9,292,0.169398907103825
"221401005","CHACO",306,223,18,47,1,66,0.72875816993464
"221401006","CHACO",329,50,197,61,14,272,0.151975683890578
"140560316","CORDOBA",290,5,245,25,3,273,0.0172413793103448
"221401007","CHACO",369,11,123,174,19,316,0.029810298102981
"221401008","CHACO",259,18,184,50,5,239,0.0694980694980695
"221401009","CHACO",386,8,248,103,7,358,0.0207253886010363
"221401010","CHACO",259,104,111,39,2,152,0.401544401544402
"221401011","CHACO",265,204,48,11,0,59,0.769811320754717
"221401012","CHACO",248,6,182,45,4,231,0.0241935483870968
"221401013","CHACO",264,200,21,24,13,58,0.757575757575758
"221401014","CHACO",275,3,155,74,11,240,0.0109090909090909
"221401015","CHACO",260,5,124,88,11,223,0.0192307692307692
"221401017","CHACO",277,126,35,76,5,116,0.454873646209386
"221401018","CHACO",263,1,105,128,8,241,0.00380228136882129
"221401019","CHACO",205,0,116,59,5,180,0
"221401020","CHACO",287,20,209,19,3,231,0.0696864111498258
"221401021","CHACO",220,1,47,60,45,152,0.00454545454545455
"221401022","CHACO",235,3,97,103,10,210,0.0127659574468085
"140560315","CORDOBA",199,1,182,16,0,198,0.0050251256281407
"221401105","CHACO",224,173,32,0,0,32,0.772321428571429
"221401106","CHACO",205,175,17,12,1,30,0.853658536585366
"221401107","CHACO",247,227,11,3,0,14,0.919028340080972
"221401108","CHACO",209,193,6,4,0,10,0.923444976076555
"221401109","CHACO",168,120,16,11,0,27,0.714285714285714
"221401110","CHACO",198,197,1,0,0,1,0.994949494949495
"221401111","CHACO",299,203,59,36,0,95,0.678929765886288
"221401112","CHACO",285,281,3,0,0,3,0.985964912280702
"221401113","CHACO",182,166,8,4,2,14,0.912087912087912
"221401114","CHACO",220,209,4,6,1,11,0.95
"221401115","CHACO",220,169,24,2,0,26,0.768181818181818
"221401201","CHACO",178,175,3,0,0,3,0.98314606741573
"221401202","CHACO",189,189,0,0,0,0,1
"221401203","CHACO",224,223,1,0,0,1,0.995535714285714
"221401204","CHACO",247,242,3,0,0,3,0.979757085020243
"221401208","CHACO",345,343,2,0,0,2,0.994202898550725
"221401209","CHACO",159,146,7,1,0,8,0.918238993710692
"140560314","CORDOBA",261,1,210,29,1,240,0.00383141762452107
"221401210","CHACO",373,366,5,1,0,6,0.981233243967828
"221401211","CHACO",349,340,7,1,0,8,0.974212034383954
"221401212","CHACO",186,156,28,1,1,30,0.838709677419355
"221401213","CHACO",394,336,44,13,0,57,0.852791878172589
"221401214","CHACO",210,203,3,2,1,6,0.966666666666667
"221401215","CHACO",432,351,45,29,2,76,0.8125
"221401216","CHACO",159,155,4,0,0,4,0.974842767295597
"221401217","CHACO",360,273,68,16,1,85,0.758333333333333
"221401301","CHACO",213,195,12,6,0,18,0.915492957746479
"221401302","CHACO",265,243,18,3,1,22,0.916981132075472
"221401303","CHACO",254,228,21,5,0,26,0.897637795275591
"221401304","CHACO",250,210,32,2,2,36,0.84
"221401305","CHACO",275,160,69,29,7,105,0.581818181818182
"221401306","CHACO",212,139,43,22,0,65,0.655660377358491
"221401307","CHACO",283,253,13,5,0,18,0.893992932862191
"221401308","CHACO",393,51,246,87,5,338,0.129770992366412
"221401309","CHACO",162,16,91,22,0,113,0.0987654320987654
"221401310","CHACO",178,13,105,51,1,157,0.0730337078651685
"221401311","CHACO",214,5,163,40,2,205,0.0233644859813084
"221401401","CHACO",141,131,0,0,0,0,0.929078014184397
"221401402","CHACO",219,216,2,1,0,3,0.986301369863014
"221401403","CHACO",292,290,2,0,0,2,0.993150684931507
"221401404","CHACO",266,265,0,0,0,0,0.996240601503759
"221401405","CHACO",191,190,0,0,0,0,0.994764397905759
"221401406","CHACO",366,363,3,0,0,3,0.991803278688525
"221401407","CHACO",230,46,125,51,0,176,0.2
"221401408","CHACO",214,214,0,0,0,0,1
"221401409","CHACO",193,192,0,0,0,0,0.994818652849741
"221401410","CHACO",181,160,15,5,1,21,0.883977900552486
"221401411","CHACO",244,38,84,111,4,199,0.155737704918033
"221401412","CHACO",101,94,7,0,0,7,0.930693069306931
"221401413","CHACO",171,171,0,0,0,0,1
"221401614","CHACO",129,2,69,53,1,123,0.0155038759689922
"221401501","CHACO",312,289,12,8,1,21,0.926282051282051
"221401502","CHACO",233,231,2,0,0,2,0.991416309012876
"221401503","CHACO",304,297,3,0,0,3,0.976973684210526
"221401504","CHACO",260,259,1,0,0,1,0.996153846153846
"221401505","CHACO",197,197,0,0,0,0,1
"221401506","CHACO",364,362,1,0,0,1,0.994505494505495
"221401507","CHACO",283,268,10,5,0,15,0.946996466431095
"221401508","CHACO",277,274,3,0,0,3,0.989169675090253
"221401509","CHACO",192,192,0,0,0,0,1
"221401510","CHACO",342,341,0,1,0,1,0.997076023391813
"221401601","CHACO",254,8,142,99,0,241,0.031496062992126
"221401602","CHACO",108,67,29,11,0,40,0.62037037037037
"221401603","CHACO",219,180,30,9,0,39,0.821917808219178
"221401604","CHACO",379,123,156,81,5,242,0.324538258575198
"221401605","CHACO",302,6,188,93,2,283,0.0198675496688742
"221401606","CHACO",295,11,182,65,14,261,0.0372881355932203
"221401607","CHACO",246,43,171,24,4,199,0.17479674796748
"221401608","CHACO",191,2,109,72,5,186,0.0104712041884817
"221401609","CHACO",392,135,159,67,1,227,0.344387755102041
"221401610","CHACO",277,236,30,7,1,38,0.851985559566787
"221401611","CHACO",125,2,97,23,1,121,0.016
"221401612","CHACO",220,198,9,12,0,21,0.9
"221401613","CHACO",158,3,115,34,2,151,0.0189873417721519
"221401615","CHACO",215,197,14,2,1,17,0.916279069767442
"221401616","CHACO",285,87,156,35,2,193,0.305263157894737
"221401617","CHACO",235,0,105,113,3,221,0
"221401618","CHACO",300,10,275,11,3,289,0.0333333333333333
"221401619","CHACO",258,230,3,24,1,28,0.891472868217054
"221401620","CHACO",223,4,97,83,27,207,0.0179372197309417
"221401621","CHACO",284,151,57,58,8,123,0.53169014084507
"221401622","CHACO",52,3,33,12,3,48,0.0576923076923077
"221401623","CHACO",79,14,44,17,0,61,0.177215189873418
"221401624","CHACO",61,7,41,10,1,52,0.114754098360656
"221401625","CHACO",186,93,49,33,1,83,0.5
"221401701","CHACO",165,1,43,74,14,131,0.00606060606060606
"221401710","CHACO",187,2,100,68,9,177,0.0106951871657754
"221401801","CHACO",254,7,140,72,21,233,0.0275590551181102
"221401702","CHACO",307,3,157,106,3,266,0.00977198697068404
"221401703","CHACO",370,128,115,91,6,212,0.345945945945946
"221401704","CHACO",262,5,188,56,3,247,0.0190839694656489
"221401705","CHACO",379,15,127,152,18,297,0.0395778364116095
"221401706","CHACO",347,5,180,140,12,332,0.0144092219020173
"221401707","CHACO",229,14,188,24,0,212,0.0611353711790393
"221401708","CHACO",194,9,60,109,7,176,0.0463917525773196
"221401709","CHACO",189,76,62,47,1,110,0.402116402116402
"221401812","CHACO",199,7,135,53,2,190,0.0351758793969849
"221401802","CHACO",328,13,180,103,7,290,0.0396341463414634
"221401803","CHACO",215,9,138,55,6,199,0.0418604651162791
"221401804","CHACO",253,18,139,65,3,207,0.0711462450592885
"221401805","CHACO",222,4,129,70,13,212,0.018018018018018
"221401904","CHACO",349,213,56,56,3,115,0.610315186246418
"221401905","CHACO",164,7,122,33,0,155,0.0426829268292683
"221401806","CHACO",317,3,159,108,24,291,0.00946372239747634
"221401807","CHACO",333,19,217,82,5,304,0.0570570570570571
"221401808","CHACO",264,14,223,23,1,247,0.053030303030303
"221401809","CHACO",240,3,179,35,4,218,0.0125
"221401810","CHACO",257,2,132,92,12,236,0.00778210116731518
"221401811","CHACO",239,7,140,84,1,225,0.0292887029288703
"221401813","CHACO",234,7,180,42,3,225,0.0299145299145299
"221401814","CHACO",229,130,84,14,0,98,0.567685589519651
"221401815","CHACO",203,16,129,43,2,174,0.0788177339901478
"221401816","CHACO",396,8,247,112,8,367,0.0202020202020202
"221401906","CHACO",213,4,147,59,1,207,0.0187793427230047
"221401907","CHACO",339,9,214,73,1,288,0.0265486725663717
"221401908","CHACO",199,1,122,41,19,182,0.0050251256281407
"221401817","CHACO",186,9,69,50,26,145,0.0483870967741935
"221401818","CHACO",9,0,0,0,9,9,0
"221401819","CHACO",270,31,175,48,10,233,0.114814814814815
"221401820","CHACO",250,12,168,66,0,234,0.048
"221401901","CHACO",386,150,137,62,1,200,0.38860103626943
"221401902","CHACO",84,7,55,16,3,74,0.0833333333333333
"221401903","CHACO",208,9,149,48,1,198,0.0432692307692308
"140631211","CORDOBA",288,168,33,80,1,114,0.583333333333333
"221401909","CHACO",225,1,183,35,1,219,0.00444444444444444
"221401910","CHACO",160,123,27,10,0,37,0.76875
"221401911","CHACO",214,13,175,25,1,201,0.0607476635514019
"221401912","CHACO",229,9,167,46,2,215,0.0393013100436681
"221401913","CHACO",212,9,126,54,9,189,0.0424528301886792
"221401914","CHACO",165,19,129,15,1,145,0.115151515151515
"221401915","CHACO",196,2,157,31,1,189,0.0102040816326531
"221402001","CHACO",230,4,193,28,0,221,0.0173913043478261
"221402002","CHACO",306,2,242,33,19,294,0.0065359477124183
"221402003","CHACO",195,5,167,21,1,189,0.0256410256410256
"221402004","CHACO",276,3,196,68,3,267,0.0108695652173913
"221402005","CHACO",394,3,144,174,36,354,0.00761421319796954
"221402006","CHACO",359,12,72,203,17,292,0.0334261838440111
"740560613","SAN LUIS",289,263,15,10,0,25,0.910034602076125
"221402007","CHACO",254,4,119,94,17,230,0.015748031496063
"221402008","CHACO",237,4,191,36,0,227,0.0168776371308017
"221402009","CHACO",269,4,203,56,2,261,0.0148698884758364
"221402010","CHACO",213,64,93,43,4,140,0.300469483568075
"221402011","CHACO",199,2,147,44,4,195,0.0100502512562814
"221402101","CHACO",301,275,11,6,0,17,0.913621262458472
"221402103","CHACO",268,196,18,26,5,49,0.73134328358209
"221402104","CHACO",144,4,33,75,5,113,0.0277777777777778
"221402105","CHACO",379,213,40,102,8,150,0.562005277044855
"221402501","CHACO",306,10,229,66,0,295,0.0326797385620915
"140490306","CORDOBA",165,3,145,16,0,161,0.0181818181818182
"221402106","CHACO",502,222,179,75,19,273,0.442231075697211
"221402107","CHACO",64,45,14,3,1,18,0.703125
"221402108","CHACO",255,211,19,21,1,41,0.827450980392157
"221402502","CHACO",286,4,252,27,0,279,0.013986013986014
"221402709","CHACO",233,127,43,50,1,94,0.545064377682403
"221402109","CHACO",44,3,3,25,9,37,0.0681818181818182
"140560313","CORDOBA",354,11,313,30,0,343,0.0310734463276836
"140420918","CORDOBA",237,234,2,1,0,3,0.987341772151899
"140420903","CORDOBA",252,232,19,1,0,20,0.920634920634921
"221402201","CHACO",25,1,7,5,8,20,0.04
"221402202","CHACO",33,6,8,16,1,25,0.181818181818182
"221402203","CHACO",59,2,8,29,17,54,0.0338983050847458
"221403012","CHACO",198,117,60,6,0,66,0.590909090909091
"221402607","CHACO",363,180,122,51,6,179,0.495867768595041
"221680106","CHACO",277,252,11,12,0,23,0.909747292418773
"221402204","CHACO",17,0,2,11,2,15,0
"221402205","CHACO",45,0,1,17,23,41,0
"140631210","CORDOBA",354,193,28,120,1,149,0.545197740112994
"221402206","CHACO",41,1,1,4,13,18,0.024390243902439
"221402510","CHACO",340,4,103,167,19,289,0.0117647058823529
"221402511","CHACO",430,17,154,209,28,391,0.0395348837209302
"221402301","CHACO",5,0,3,2,0,5,0
"221402302","CHACO",2,0,0,0,2,2,0
"221402512","CHACO",360,7,76,126,72,274,0.0194444444444444
"740351015","SAN LUIS",200,197,3,0,0,3,0.985
"221402303","CHACO",16,0,12,3,0,15,0
"221402304","CHACO",117,2,59,46,3,108,0.0170940170940171
"221402305","CHACO",19,1,8,8,1,17,0.0526315789473684
"221402401","CHACO",199,8,118,63,3,184,0.0402010050251256
"221402405","CHACO",50,1,5,31,11,47,0.02
"221402406","CHACO",90,5,31,28,6,65,0.0555555555555556
"221402407","CHACO",2,0,0,0,0,0,0
"221402402","CHACO",10,0,1,5,1,7,0
"221402403","CHACO",29,0,15,4,5,24,0
"221402404","CHACO",257,6,194,47,2,243,0.0233463035019455
"221402411","CHACO",176,0,132,28,16,176,0
"221402408","CHACO",6,0,1,0,5,6,0
"221402409","CHACO",58,1,18,27,10,55,0.0172413793103448
"221402410","CHACO",78,1,19,39,10,68,0.0128205128205128
"221402503","CHACO",434,163,110,116,16,242,0.375576036866359
"221402504","CHACO",355,263,80,12,0,92,0.740845070422535
"221402505","CHACO",494,112,259,76,36,371,0.226720647773279
"221402513","CHACO",153,2,79,61,3,143,0.0130718954248366
"221402514","CHACO",70,0,50,17,1,68,0
"221402506","CHACO",202,30,92,55,15,162,0.148514851485149
"221402507","CHACO",87,1,39,9,25,73,0.0114942528735632
"221402508","CHACO",332,10,236,76,5,317,0.0301204819277108
"221402509","CHACO",277,7,150,91,13,254,0.0252707581227437
"221402515","CHACO",130,7,108,14,0,122,0.0538461538461538
"221402516","CHACO",164,5,82,51,14,147,0.0304878048780488
"221402517","CHACO",117,4,103,7,3,113,0.0341880341880342
"221402518","CHACO",236,157,52,24,0,76,0.665254237288136
"221402601","CHACO",218,1,79,119,10,208,0.00458715596330275
"221402602","CHACO",311,300,9,2,0,11,0.964630225080386
"221402603","CHACO",310,138,157,10,2,169,0.445161290322581
"221402604","CHACO",264,86,111,55,9,175,0.325757575757576
"221402605","CHACO",256,41,163,32,10,205,0.16015625
"221402606","CHACO",220,152,56,7,3,66,0.690909090909091
"221402608","CHACO",349,141,125,83,0,208,0.404011461318052
"221402609","CHACO",171,10,39,85,20,144,0.0584795321637427
"221402701","CHACO",322,264,37,13,5,55,0.819875776397516
"221402702","CHACO",333,315,7,3,7,17,0.945945945945946
"221402703","CHACO",247,238,0,5,1,6,0.963562753036437
"221402704","CHACO",291,278,4,4,1,9,0.9553264604811
"221402705","CHACO",311,281,8,12,0,20,0.903536977491961
"221402706","CHACO",226,132,41,32,12,85,0.584070796460177
"221402707","CHACO",388,256,64,48,3,115,0.65979381443299
"221402708","CHACO",264,254,7,1,0,8,0.962121212121212
"221402710","CHACO",179,166,2,8,0,10,0.927374301675978
"740351013","SAN LUIS",232,231,1,0,0,1,0.995689655172414
"221402711","CHACO",322,16,102,153,13,268,0.0496894409937888
"221402712","CHACO",243,228,2,0,0,2,0.938271604938272
"221402713","CHACO",242,133,29,62,1,92,0.549586776859504
"221402714","CHACO",466,304,119,31,2,152,0.652360515021459
"221402715","CHACO",316,277,0,0,0,0,0.876582278481013
"221402716","CHACO",371,370,1,0,0,1,0.997304582210243
"221402717","CHACO",352,351,1,0,0,1,0.997159090909091
"221402718","CHACO",334,331,2,0,0,2,0.991017964071856
"221402719","CHACO",356,286,9,23,0,32,0.803370786516854
"221402720","CHACO",255,1,40,130,12,182,0.00392156862745098
"221402721","CHACO",242,104,94,32,2,128,0.429752066115702
"221402722","CHACO",284,1,32,131,44,207,0.00352112676056338
"221402723","CHACO",219,91,34,48,23,105,0.415525114155251
"221402724","CHACO",152,0,27,86,12,125,0
"221402725","CHACO",199,0,14,106,22,142,0
"221402726","CHACO",205,22,86,76,12,174,0.107317073170732
"221402801","CHACO",331,242,32,22,1,55,0.731117824773414
"221402802","CHACO",316,277,3,0,0,3,0.876582278481013
"221402803","CHACO",217,144,36,27,7,70,0.663594470046083
"221402804","CHACO",285,279,3,0,0,3,0.978947368421053
"221402805","CHACO",392,389,3,0,0,3,0.99234693877551
"221402806","CHACO",202,29,52,73,22,147,0.143564356435644
"221402807","CHACO",134,14,87,25,4,116,0.104477611940299
"221402808","CHACO",405,23,279,94,5,378,0.0567901234567901
"221680105","CHACO",266,238,13,9,3,25,0.894736842105263
"140560410","CORDOBA",204,1,100,92,3,195,0.00490196078431373
"221402809","CHACO",249,236,1,4,2,7,0.947791164658635
"221402810","CHACO",359,338,12,5,2,19,0.94150417827298
"221402811","CHACO",300,199,37,42,7,86,0.663333333333333
"221402901","CHACO",186,3,85,74,0,159,0.0161290322580645
"221402902","CHACO",223,26,63,87,6,156,0.116591928251121
"221402903","CHACO",251,5,126,83,11,220,0.0199203187250996
"221402904","CHACO",280,271,2,5,0,7,0.967857142857143
"221402905","CHACO",270,4,108,82,6,196,0.0148148148148148
"221402906","CHACO",281,252,14,10,1,25,0.896797153024911
"221402907","CHACO",118,52,26,31,1,58,0.440677966101695
"221402908","CHACO",289,186,33,57,9,99,0.643598615916955
"221402909","CHACO",339,288,27,20,1,48,0.849557522123894
"700280914","SAN JUAN",176,176,0,0,0,0,1
"221402910","CHACO",386,385,0,0,0,0,0.99740932642487
"221402911","CHACO",321,290,16,15,0,31,0.903426791277259
"221402912","CHACO",161,157,3,1,0,4,0.975155279503106
"221402913","CHACO",249,243,3,0,0,3,0.975903614457831
"221402914","CHACO",289,8,95,116,8,219,0.027681660899654
"221402915","CHACO",272,14,189,65,1,255,0.0514705882352941
"221402916","CHACO",207,5,30,97,13,140,0.0241545893719807
"221402919","CHACO",188,1,18,62,64,144,0.00531914893617021
"221402920","CHACO",224,1,63,106,19,188,0.00446428571428571
"221403001","CHACO",242,2,105,116,9,230,0.00826446280991736
"221403002","CHACO",227,2,105,80,4,189,0.00881057268722467
"221403010","CHACO",145,4,127,13,1,141,0.0275862068965517
"221403003","CHACO",381,33,196,113,18,327,0.0866141732283465
"221403004","CHACO",221,33,163,12,13,188,0.149321266968326
"221403005","CHACO",396,25,290,67,11,368,0.0631313131313131
"221403006","CHACO",163,91,62,8,1,71,0.558282208588957
"221403007","CHACO",402,363,10,17,6,33,0.902985074626866
"221403008","CHACO",117,1,33,41,25,99,0.00854700854700855
"221403009","CHACO",337,4,135,170,15,320,0.0118694362017804
"221540103","CHACO",104,0,30,22,34,86,0
"221403011","CHACO",232,20,91,79,12,182,0.0862068965517241
"221403013","CHACO",130,85,14,19,5,38,0.653846153846154
"221470101","CHACO",62,0,7,22,17,46,0
"221470102","CHACO",17,1,3,12,1,16,0.0588235294117647
"221470103","CHACO",41,0,1,13,13,27,0
"221470104","CHACO",65,4,19,18,21,58,0.0615384615384615
"221470105","CHACO",112,1,25,70,14,109,0.00892857142857143
"221470106","CHACO",133,0,15,99,3,117,0
"221470107","CHACO",44,0,6,6,31,43,0
"221470108","CHACO",45,0,2,17,22,41,0
"221470201","CHACO",365,2,178,132,39,349,0.00547945205479452
"221470202","CHACO",191,3,137,45,4,186,0.0157068062827225
"221470203","CHACO",306,7,217,69,5,291,0.0228758169934641
"221470204","CHACO",175,1,63,87,18,168,0.00571428571428571
"221470205","CHACO",167,4,136,21,6,163,0.0239520958083832
"221470206","CHACO",296,7,218,47,9,274,0.0236486486486486
"221470301","CHACO",391,18,70,153,50,273,0.0460358056265985
"221470302","CHACO",50,0,11,25,8,44,0
"221470303","CHACO",101,0,15,50,23,88,0
"221470304","CHACO",39,0,5,27,4,36,0
"221470305","CHACO",471,2,68,183,150,401,0.00424628450106157
"221470306","CHACO",365,4,96,154,60,310,0.010958904109589
"221470307","CHACO",85,1,16,61,3,80,0.0117647058823529
"221540104","CHACO",153,0,66,48,27,141,0
"221540105","CHACO",320,2,201,75,25,301,0.00625
"221540106","CHACO",119,0,45,36,26,107,0
"221470401","CHACO",281,2,159,88,11,258,0.00711743772241993
"221680107","CHACO",547,139,93,207,48,348,0.254113345521024
"221470402","CHACO",99,5,43,33,7,83,0.0505050505050505
"221470403","CHACO",54,0,2,25,15,42,0
"221470404","CHACO",37,0,8,25,2,35,0
"221540101","CHACO",365,1,99,221,5,325,0.00273972602739726
"221540102","CHACO",256,1,88,69,71,228,0.00390625
"700630205","SAN JUAN",264,6,201,46,2,249,0.0227272727272727
"221540201","CHACO",273,46,71,118,26,215,0.168498168498169
"221680108","CHACO",304,0,50,186,52,288,0
"221540202","CHACO",353,44,130,133,3,266,0.124645892351275
"221540203","CHACO",30,0,7,17,4,28,0
"221540204","CHACO",165,0,18,98,32,148,0
"221540205","CHACO",37,0,4,19,9,32,0
"221540206","CHACO",265,46,72,113,14,199,0.173584905660377
"221540301","CHACO",242,3,139,77,9,225,0.012396694214876
"221540302","CHACO",345,11,208,83,11,302,0.0318840579710145
"221540308","CHACO",95,0,11,39,30,80,0
"221540309","CHACO",201,45,119,30,4,153,0.223880597014925
"700770209","SAN JUAN",308,15,275,18,0,293,0.0487012987012987
"221540303","CHACO",100,3,14,37,25,76,0.03
"700770811","SAN JUAN",251,0,95,134,3,232,0
"221540304","CHACO",61,0,9,45,0,54,0
"221540305","CHACO",124,0,34,76,1,111,0
"221540306","CHACO",30,0,3,5,14,22,0
"221540307","CHACO",367,11,235,66,9,310,0.0299727520435967
"221540310","CHACO",106,0,17,44,27,88,0
"221540311","CHACO",256,2,146,78,13,237,0.0078125
"221680308","CHACO",51,0,6,29,11,46,0
"221610101","CHACO",51,0,5,2,12,19,0
"221610102","CHACO",50,0,1,20,23,44,0
"221610103","CHACO",18,0,2,11,2,15,0
"221610201","CHACO",342,232,27,58,5,90,0.678362573099415
"221610202","CHACO",66,0,14,36,9,59,0
"221610301","CHACO",399,13,209,119,42,370,0.0325814536340852
"221610302","CHACO",64,0,32,24,3,59,0
"221680109","CHACO",289,56,63,103,38,204,0.193771626297578
"221680110","CHACO",334,15,135,135,17,287,0.0449101796407186
"221680111","CHACO",158,4,54,53,22,129,0.0253164556962025
"700770603","SAN JUAN",135,97,25,7,3,35,0.718518518518519
"221610303","CHACO",15,0,9,6,0,15,0
"221610304","CHACO",21,0,3,10,8,21,0
"221610401","CHACO",61,0,8,27,26,61,0
"700770910","SAN JUAN",326,1,133,188,0,321,0.00306748466257669
"221610203","CHACO",29,0,5,16,0,21,0
"221680307","CHACO",51,0,9,11,5,25,0
"221610402","CHACO",10,1,2,4,3,9,0.1
"221680101","CHACO",341,313,16,8,2,26,0.917888563049853
"221680102","CHACO",258,232,13,4,5,22,0.89922480620155
"221680104","CHACO",291,14,101,141,25,267,0.0481099656357388
"221680112","CHACO",325,85,36,173,11,220,0.261538461538462
"221680113","CHACO",334,200,48,63,14,125,0.598802395209581
"221680114","CHACO",275,35,102,121,13,236,0.127272727272727
"221680115","CHACO",224,3,28,139,9,176,0.0133928571428571
"221680116","CHACO",188,0,20,96,47,163,0
"221680117","CHACO",201,1,114,55,7,176,0.00497512437810945
"221680201","CHACO",52,0,27,9,8,44,0
"221680202","CHACO",80,0,16,41,21,78,0
"221680203","CHACO",42,0,7,15,17,39,0
"221680204","CHACO",41,0,13,9,4,26,0
"221680205","CHACO",66,0,5,14,4,23,0
"221610305","CHACO",30,0,5,17,7,29,0
"221680103","CHACO",265,4,69,147,28,244,0.0150943396226415
"221680206","CHACO",23,0,7,6,6,19,0
"221680306","CHACO",63,0,0,58,0,58,0
"221680309","CHACO",392,94,84,131,31,246,0.239795918367347
"221680310","CHACO",493,56,77,255,49,381,0.113590263691684
"221680401","CHACO",82,0,14,20,24,58,0
"221680402","CHACO",158,0,9,66,21,96,0
"221680403","CHACO",140,2,14,46,56,116,0.0142857142857143
"221680404","CHACO",60,0,1,17,37,55,0
"221680405","CHACO",69,0,1,38,5,44,0
"221680406","CHACO",89,0,17,43,22,82,0
"221680407","CHACO",48,1,4,39,3,46,0.0208333333333333
"221680408","CHACO",59,0,8,24,5,37,0
"221680409","CHACO",287,0,62,139,62,263,0
"700350301","SAN JUAN",252,6,82,124,33,239,0.0238095238095238
"700280709","SAN JUAN",322,167,59,90,0,149,0.518633540372671
"701260202","SAN JUAN",274,0,45,103,96,244,0
"700140105","SAN JUAN",241,6,126,60,35,221,0.024896265560166
"700840410","SAN JUAN",267,11,214,42,0,256,0.0411985018726592
"701330104","SAN JUAN",85,0,38,44,3,85,0
"700560601","SAN JUAN",65,0,12,18,27,57,0
"700280610","SAN JUAN",184,173,2,6,0,8,0.940217391304348
"700280608","SAN JUAN",305,300,2,3,0,5,0.983606557377049
"701260107","SAN JUAN",266,69,122,56,1,179,0.259398496240602
"700560104","SAN JUAN",207,0,57,126,12,195,0
"700280907","SAN JUAN",211,202,7,2,0,9,0.957345971563981
"700280905","SAN JUAN",257,213,21,23,0,44,0.828793774319066
"700280603","SAN JUAN",214,186,17,10,0,27,0.869158878504673
"700280516","SAN JUAN",192,21,138,33,0,171,0.109375
"700280515","SAN JUAN",192,124,17,48,0,65,0.645833333333333
"700280506","SAN JUAN",329,257,53,19,0,72,0.781155015197568
"700350104","SAN JUAN",271,122,55,54,7,116,0.450184501845018
"701260205","SAN JUAN",119,1,59,22,17,98,0.00840336134453781
"700280811","SAN JUAN",184,167,6,6,0,12,0.907608695652174
"700280713","SAN JUAN",216,68,61,83,0,144,0.314814814814815
"700560702","SAN JUAN",57,0,18,19,11,48,0
"701260103","SAN JUAN",248,1,32,78,113,223,0.00403225806451613
"700770313","SAN JUAN",250,6,57,174,0,231,0.024
"700280410","SAN JUAN",248,137,64,47,0,111,0.55241935483871
"700700107","SAN JUAN",266,28,153,80,0,233,0.105263157894737
"700280409","SAN JUAN",187,151,11,25,0,36,0.807486631016043
"140420902","CORDOBA",305,288,10,7,0,17,0.944262295081967
"700280405","SAN JUAN",290,237,26,26,0,52,0.817241379310345
"700280321","SAN JUAN",184,167,2,4,0,6,0.907608695652174
"700350707","SAN JUAN",263,233,15,9,0,24,0.885931558935361
"700350706","SAN JUAN",207,191,4,3,0,7,0.922705314009662
"700350704","SAN JUAN",234,62,89,65,8,162,0.264957264957265
"700350501","SAN JUAN",115,0,18,42,41,101,0
"700350205","SAN JUAN",175,163,0,0,0,0,0.931428571428571
"700350105","SAN JUAN",344,285,26,17,2,45,0.828488372093023
"140420701","CORDOBA",377,170,93,108,3,204,0.450928381962865
"700070204","SAN JUAN",430,5,318,52,30,400,0.0116279069767442
"700280116","SAN JUAN",206,203,2,1,0,3,0.985436893203884
"700280311","SAN JUAN",198,133,18,44,0,62,0.671717171717172
"701260201","SAN JUAN",340,30,275,21,4,300,0.0882352941176471
"700770801","SAN JUAN",184,20,37,123,1,161,0.108695652173913
"700350701","SAN JUAN",213,99,31,59,18,108,0.464788732394366
"700350601","SAN JUAN",24,0,1,20,0,21,0
"700280716","SAN JUAN",156,141,12,3,0,15,0.903846153846154
"700280211","SAN JUAN",185,184,1,0,0,1,0.994594594594595
"700280204","SAN JUAN",178,144,29,5,0,34,0.808988764044944
"700280113","SAN JUAN",146,143,3,0,0,3,0.979452054794521
"700280108","SAN JUAN",218,216,2,0,0,2,0.990825688073395
"700280107","SAN JUAN",158,154,4,0,0,4,0.974683544303797
"700210404","SAN JUAN",325,0,197,117,4,318,0
"701120101","SAN JUAN",181,0,51,116,10,177,0
"701050107","SAN JUAN",373,11,189,131,19,339,0.0294906166219839
"700980402","SAN JUAN",243,239,2,1,0,3,0.983539094650206
"700980305","SAN JUAN",324,178,88,41,4,133,0.549382716049383
"700980302","SAN JUAN",290,207,20,59,0,79,0.713793103448276
"700980207","SAN JUAN",356,115,142,95,2,239,0.323033707865169
"700980107","SAN JUAN",305,3,38,237,16,291,0.00983606557377049
"700980106","SAN JUAN",412,29,150,225,0,375,0.0703883495145631
"700910112","SAN JUAN",342,271,50,16,3,69,0.792397660818713
"700910111","SAN JUAN",150,0,56,53,10,119,0
"700840215","SAN JUAN",318,33,114,166,0,280,0.10377358490566
"140420804","CORDOBA",176,176,0,0,0,0,1
"700840210","SAN JUAN",334,324,9,1,0,10,0.970059880239521
"700771011","SAN JUAN",233,3,163,67,0,230,0.0128755364806867
"700771008","SAN JUAN",233,15,72,144,0,216,0.0643776824034335
"700771007","SAN JUAN",342,82,178,65,1,244,0.239766081871345
"700770804","SAN JUAN",242,1,126,106,1,233,0.00413223140495868
"701190207","SAN JUAN",212,0,140,72,0,212,0
"700770505","SAN JUAN",228,145,62,21,0,83,0.635964912280702
"700700501","SAN JUAN",295,3,148,127,4,279,0.0101694915254237
"700700518","SAN JUAN",206,1,95,102,4,201,0.00485436893203883
"700700207","SAN JUAN",549,2,163,334,34,531,0.00364298724954463
"700700113","SAN JUAN",333,2,181,103,39,323,0.00600600600600601
"700770508","SAN JUAN",218,3,67,132,14,213,0.0137614678899083
"700700110","SAN JUAN",202,2,109,91,0,200,0.0099009900990099
"140420803","CORDOBA",328,324,2,2,0,4,0.98780487804878
"700770502","SAN JUAN",334,3,128,139,41,308,0.00898203592814371
"700770412","SAN JUAN",352,3,190,154,0,344,0.00852272727272727
"700770405","SAN JUAN",264,56,127,81,0,208,0.212121212121212
"140560409","CORDOBA",218,4,161,50,0,211,0.018348623853211
"700770309","SAN JUAN",326,9,136,167,1,304,0.0276073619631902
"700770201","SAN JUAN",354,2,160,148,2,310,0.00564971751412429
"700770104","SAN JUAN",295,52,196,4,0,200,0.176271186440678
"700700504","SAN JUAN",177,3,60,87,3,150,0.0169491525423729
"700560105","SAN JUAN",347,0,212,96,10,318,0
"700700108","SAN JUAN",264,1,72,177,8,257,0.00378787878787879
"700490203","SAN JUAN",256,0,183,42,6,231,0
"700490202","SAN JUAN",171,0,84,64,18,166,0
"700420509","SAN JUAN",325,9,243,68,0,311,0.0276923076923077
"700420506","SAN JUAN",347,8,173,130,0,303,0.0230547550432277
"700420408","SAN JUAN",265,15,229,19,0,248,0.0566037735849057
"500560404","MENDOZA",388,5,153,160,33,346,0.0128865979381443
"700420215","SAN JUAN",220,0,96,114,4,214,0
"700420208","SAN JUAN",224,3,33,182,2,217,0.0133928571428571
"700420210","SAN JUAN",313,4,237,62,0,299,0.012779552715655
"700420206","SAN JUAN",327,1,127,189,2,318,0.00305810397553517
"700560108","SAN JUAN",143,0,64,67,9,140,0
"700420205","SAN JUAN",287,2,101,136,3,240,0.00696864111498258
"700700112","SAN JUAN",286,4,185,94,0,279,0.013986013986014
"700420105","SAN JUAN",322,7,211,100,0,311,0.0217391304347826
"700350711","SAN JUAN",251,158,20,46,16,82,0.629482071713147
"700210601","SAN JUAN",10,0,3,5,0,8,0
"700210501","SAN JUAN",11,0,2,2,6,10,0
"700700103","SAN JUAN",402,13,139,199,22,360,0.0323383084577114
"700280707","SAN JUAN",309,214,48,43,1,92,0.692556634304207
"700280703","SAN JUAN",286,192,50,41,1,92,0.671328671328671
"700280619","SAN JUAN",159,156,3,0,0,3,0.981132075471698
"701190205","SAN JUAN",118,0,31,65,3,99,0
"700910101","SAN JUAN",218,1,102,70,33,205,0.00458715596330275
"700280809","SAN JUAN",327,256,5,3,0,8,0.782874617737003
"140420802","CORDOBA",161,160,1,0,0,1,0.993788819875776
"700630202","SAN JUAN",326,5,181,89,37,307,0.0153374233128834
"701260401","SAN JUAN",58,0,4,12,1,17,0
"700350201","SAN JUAN",232,1,133,66,23,222,0.00431034482758621
"701050106","SAN JUAN",240,5,134,83,9,226,0.0208333333333333
"701050104","SAN JUAN",128,0,71,43,4,118,0
"700280606","SAN JUAN",174,108,16,48,0,64,0.620689655172414
"700280505","SAN JUAN",147,135,7,5,0,12,0.918367346938776
"700280414","SAN JUAN",282,9,189,83,0,272,0.0319148936170213
"700070303","SAN JUAN",120,0,42,60,8,110,0
"700280413","SAN JUAN",247,123,64,45,0,109,0.497975708502024
"700280412","SAN JUAN",338,183,76,75,2,153,0.541420118343195
"700280411","SAN JUAN",176,124,45,6,0,51,0.704545454545455
"700280318","SAN JUAN",293,268,1,3,0,4,0.914675767918089
"700560204","SAN JUAN",134,0,66,68,0,134,0
"700280301","SAN JUAN",224,131,19,67,2,88,0.584821428571429
"700350114","SAN JUAN",348,327,11,9,0,20,0.939655172413793
"700350110","SAN JUAN",259,225,12,18,0,30,0.868725868725869
"700350101","SAN JUAN",338,163,16,83,33,132,0.482248520710059
"700280913","SAN JUAN",171,42,74,54,1,129,0.245614035087719
"700700105","SAN JUAN",308,2,96,187,12,295,0.00649350649350649
"700070101","SAN JUAN",330,16,258,47,0,305,0.0484848484848485
"700280909","SAN JUAN",244,243,0,0,0,0,0.995901639344262
"700280614","SAN JUAN",217,208,6,3,0,9,0.95852534562212
"700070203","SAN JUAN",211,2,157,37,12,206,0.00947867298578199
"700840313","SAN JUAN",259,4,242,12,0,254,0.0154440154440154
"700700502","SAN JUAN",244,12,142,86,4,232,0.0491803278688525
"700700115","SAN JUAN",334,8,271,55,0,326,0.0239520958083832
"700630203","SAN JUAN",302,15,220,56,1,277,0.0496688741721854
"700070403","SAN JUAN",325,1,223,65,24,312,0.00307692307692308
"700280208","SAN JUAN",187,116,28,42,0,70,0.620320855614973
"700280115","SAN JUAN",144,143,1,0,0,1,0.993055555555556
"700140107","SAN JUAN",417,102,240,47,15,302,0.244604316546763
"700980405","SAN JUAN",232,192,15,25,0,40,0.827586206896552
"700980306","SAN JUAN",251,2,120,113,9,242,0.00796812749003984
"700980116","SAN JUAN",428,346,18,53,0,71,0.808411214953271
"700980204","SAN JUAN",226,28,107,68,5,180,0.123893805309735
"700840606","SAN JUAN",289,7,236,46,0,282,0.0242214532871972
"700840605","SAN JUAN",259,6,209,44,0,253,0.0231660231660232
"700840602","SAN JUAN",417,3,95,304,2,401,0.00719424460431655
"700771002","SAN JUAN",420,10,180,208,0,388,0.0238095238095238
"701190202","SAN JUAN",442,0,289,131,1,421,0
"700840318","SAN JUAN",245,91,92,55,1,148,0.371428571428571
"700840316","SAN JUAN",294,137,122,32,0,154,0.465986394557823
"700840308","SAN JUAN",375,220,103,50,0,153,0.586666666666667
"700840216","SAN JUAN",302,2,170,122,0,292,0.00662251655629139
"700840211","SAN JUAN",364,283,35,43,2,80,0.777472527472527
"700840209","SAN JUAN",261,214,23,22,1,46,0.81992337164751
"700840202","SAN JUAN",207,27,121,59,0,180,0.130434782608696
"701260208","SAN JUAN",215,0,66,113,24,203,0
"701260207","SAN JUAN",162,0,144,18,0,162,0
"701260206","SAN JUAN",215,2,190,15,0,205,0.00930232558139535
"700840204","SAN JUAN",337,15,237,82,1,320,0.0445103857566766
"700771001","SAN JUAN",199,27,126,45,0,171,0.135678391959799
"700770909","SAN JUAN",242,235,3,0,0,3,0.971074380165289
"700770803","SAN JUAN",402,0,107,246,0,353,0
"700770802","SAN JUAN",214,3,71,130,1,202,0.014018691588785
"700840415","SAN JUAN",245,5,68,166,1,235,0.0204081632653061
"700770410","SAN JUAN",359,6,131,220,1,352,0.0167130919220056
"700770403","SAN JUAN",218,4,127,87,0,214,0.018348623853211
"700770307","SAN JUAN",391,12,58,317,1,376,0.030690537084399
"700770213","SAN JUAN",312,14,163,100,2,265,0.0448717948717949
"700700515","SAN JUAN",348,2,89,243,2,334,0.00574712643678161
"700700509","SAN JUAN",294,2,128,116,0,244,0.00680272108843537
"700700503","SAN JUAN",263,0,24,174,32,230,0
"700490204","SAN JUAN",253,0,185,56,4,245,0
"700560205","SAN JUAN",264,0,147,114,1,262,0
"700420511","SAN JUAN",252,9,155,85,0,240,0.0357142857142857
"700420419","SAN JUAN",184,2,58,123,0,181,0.0108695652173913
"700420406","SAN JUAN",359,5,217,135,0,352,0.0139275766016713
"700420214","SAN JUAN",284,6,138,135,1,274,0.0211267605633803
"700140202","SAN JUAN",121,0,38,36,23,97,0
"701190301","SAN JUAN",67,0,8,33,6,47,0
"700350204","SAN JUAN",167,0,48,56,45,149,0
"700140101","SAN JUAN",120,0,47,53,12,112,0
"701050303","SAN JUAN",412,109,103,90,44,237,0.264563106796116
"740350912","SAN LUIS",247,243,3,1,0,4,0.983805668016194
"701050103","SAN JUAN",100,1,36,46,4,86,0.01
"700560102","SAN JUAN",270,0,45,124,72,241,0
"700280804","SAN JUAN",172,106,10,53,0,63,0.616279069767442
"700280714","SAN JUAN",305,186,70,47,0,117,0.60983606557377
"700070307","SAN JUAN",309,79,150,33,7,190,0.255663430420712
"700280117","SAN JUAN",163,163,0,0,0,0,1
"700280712","SAN JUAN",347,253,69,23,1,93,0.729106628242075
"700700111","SAN JUAN",211,6,122,78,4,204,0.028436018957346
"701260104","SAN JUAN",306,93,41,57,60,158,0.303921568627451
"700280708","SAN JUAN",303,154,48,98,1,147,0.508250825082508
"700280705","SAN JUAN",289,252,15,21,0,36,0.8719723183391
"700280617","SAN JUAN",301,202,32,67,0,99,0.67109634551495
"700280601","SAN JUAN",310,100,100,103,1,204,0.32258064516129
"700280613","SAN JUAN",309,296,8,5,0,13,0.957928802588997
"700280502","SAN JUAN",305,280,17,6,0,23,0.918032786885246
"700280403","SAN JUAN",228,216,3,8,0,11,0.947368421052632
"700280401","SAN JUAN",131,100,8,23,0,31,0.763358778625954
"700280308","SAN JUAN",262,193,39,27,0,66,0.736641221374046
"700350113","SAN JUAN",253,188,35,23,1,59,0.743083003952569
"500980905","MENDOZA",321,244,49,25,0,74,0.7601246105919
"700070202","SAN JUAN",236,2,154,41,16,211,0.00847457627118644
"700070201","SAN JUAN",286,1,142,53,75,270,0.0034965034965035
"700070104","SAN JUAN",263,4,191,68,0,259,0.0152091254752852
"701260106","SAN JUAN",222,6,163,40,8,211,0.027027027027027
"701190201","SAN JUAN",283,0,119,154,2,275,0
"700210302","SAN JUAN",250,0,105,135,2,242,0
"700980113","SAN JUAN",238,217,14,7,0,21,0.911764705882353
"700980105","SAN JUAN",281,99,76,95,5,176,0.352313167259786
"700840412","SAN JUAN",385,15,211,153,1,365,0.038961038961039
"700350503","SAN JUAN",95,30,8,47,3,58,0.315789473684211
"700280702","SAN JUAN",243,216,13,13,0,26,0.888888888888889
"700280205","SAN JUAN",206,166,13,27,0,40,0.805825242718447
"700280112","SAN JUAN",232,230,1,1,0,2,0.991379310344828
"700280111","SAN JUAN",207,207,0,0,0,0,1
"700280104","SAN JUAN",222,222,0,0,0,0,1
"700280103","SAN JUAN",242,237,2,0,0,2,0.979338842975207
"700210203","SAN JUAN",269,0,138,98,15,251,0
"700980407","SAN JUAN",162,143,9,10,0,19,0.882716049382716
"700980308","SAN JUAN",308,33,98,163,1,262,0.107142857142857
"700980301","SAN JUAN",429,387,26,14,0,40,0.902097902097902
"700980206","SAN JUAN",366,180,97,68,10,175,0.491803278688525
"700980202","SAN JUAN",180,1,82,84,6,172,0.00555555555555556
"740350911","SAN LUIS",318,315,3,0,0,3,0.990566037735849
"700980111","SAN JUAN",321,317,2,0,0,2,0.987538940809969
"700980109","SAN JUAN",357,296,27,29,0,56,0.829131652661064
"700910102","SAN JUAN",230,102,57,51,14,122,0.443478260869565
"700840503","SAN JUAN",428,12,214,164,6,384,0.0280373831775701
"700840502","SAN JUAN",228,5,186,37,0,223,0.0219298245614035
"700840314","SAN JUAN",266,41,198,25,0,223,0.154135338345865
"700840311","SAN JUAN",343,314,18,11,0,29,0.915451895043732
"700420106","SAN JUAN",384,17,229,131,0,360,0.0442708333333333
"700350502","SAN JUAN",68,1,0,21,18,39,0.0147058823529412
"700840307","SAN JUAN",418,164,126,118,0,244,0.392344497607655
"700840201","SAN JUAN",277,8,70,168,12,250,0.0288808664259928
"700770501","SAN JUAN",276,219,10,46,0,56,0.793478260869565
"700770402","SAN JUAN",188,22,99,65,0,164,0.117021276595745
"700770808","SAN JUAN",262,3,92,162,0,254,0.0114503816793893
"700770205","SAN JUAN",345,3,111,226,1,338,0.00869565217391304
"700770203","SAN JUAN",346,16,177,141,0,318,0.046242774566474
"700700517","SAN JUAN",299,149,73,64,3,140,0.498327759197324
"700560213","SAN JUAN",188,0,180,8,0,188,0
"701120201","SAN JUAN",15,0,2,11,0,13,0
"700140201","SAN JUAN",74,0,15,33,11,59,0
"700560209","SAN JUAN",224,0,127,76,17,220,0
"700490303","SAN JUAN",76,0,47,25,3,75,0
"700420508","SAN JUAN",331,17,159,153,0,312,0.0513595166163142
"700420503","SAN JUAN",253,7,189,51,4,244,0.0276679841897233
"700420414","SAN JUAN",410,7,184,207,2,393,0.0170731707317073
"700420404","SAN JUAN",359,3,88,241,9,338,0.00835654596100279
"700420418","SAN JUAN",201,4,155,42,0,197,0.0199004975124378
"700420209","SAN JUAN",372,11,189,118,6,313,0.0295698924731183
"700420203","SAN JUAN",365,4,202,143,9,354,0.010958904109589
"700420104","SAN JUAN",375,12,330,32,0,362,0.032
"700420201","SAN JUAN",371,9,274,64,1,339,0.0242587601078167
"700700203","SAN JUAN",349,6,69,234,17,320,0.0171919770773639
"700280605","SAN JUAN",315,300,6,7,0,13,0.952380952380952
"700280512","SAN JUAN",213,200,6,7,0,13,0.938967136150235
"700280507","SAN JUAN",183,171,7,5,0,12,0.934426229508197
"700280404","SAN JUAN",166,144,14,7,0,21,0.867469879518072
"700280320","SAN JUAN",162,155,4,2,0,6,0.95679012345679
"701260204","SAN JUAN",194,0,36,42,92,170,0
"701260105","SAN JUAN",192,1,81,67,29,177,0.00520833333333333
"701190102","SAN JUAN",90,0,56,25,1,82,0
"700280704","SAN JUAN",331,216,37,73,0,110,0.652567975830816
"700560401","SAN JUAN",22,0,2,3,13,18,0
"700560103","SAN JUAN",163,0,30,90,27,147,0
"700490201","SAN JUAN",113,0,60,19,13,92,0
"701050305","SAN JUAN",266,11,92,84,30,206,0.0413533834586466
"700280906","SAN JUAN",171,160,8,3,0,11,0.935672514619883
"700280904","SAN JUAN",170,159,5,6,0,11,0.935294117647059
"700280902","SAN JUAN",293,286,3,4,0,7,0.976109215017065
"700280805","SAN JUAN",238,186,23,28,0,51,0.781512605042017
"700280710","SAN JUAN",267,179,31,57,0,88,0.670411985018727
"701050202","SAN JUAN",472,38,175,111,85,371,0.0805084745762712
"700770409","SAN JUAN",201,2,33,164,0,197,0.00995024875621891
"700280313","SAN JUAN",318,206,41,39,0,80,0.647798742138365
"700280303","SAN JUAN",325,285,20,19,1,40,0.876923076923077
"700350106","SAN JUAN",296,257,8,12,1,21,0.868243243243243
"700070206","SAN JUAN",323,7,224,73,10,307,0.021671826625387
"700070205","SAN JUAN",453,5,281,75,35,391,0.011037527593819
"700070103","SAN JUAN",303,6,171,78,12,261,0.0198019801980198
"701330102","SAN JUAN",533,0,352,147,6,505,0
"700980412","SAN JUAN",179,164,7,8,0,15,0.916201117318436
"140560208","CORDOBA",232,215,14,2,0,16,0.926724137931034
"700771009","SAN JUAN",207,1,104,99,0,203,0.00483091787439614
"700770807","SAN JUAN",223,4,50,166,0,216,0.0179372197309417
"700840411","SAN JUAN",199,14,180,5,0,185,0.0703517587939698
"700910114","SAN JUAN",290,11,98,130,34,262,0.0379310344827586
"700770908","SAN JUAN",250,30,109,101,0,210,0.12
"700280203","SAN JUAN",350,309,18,23,0,41,0.882857142857143
"700280109","SAN JUAN",158,145,0,1,0,1,0.917721518987342
"700280101","SAN JUAN",285,281,4,0,0,4,0.985964912280702
"701050301","SAN JUAN",307,5,196,99,5,300,0.0162866449511401
"700980406","SAN JUAN",257,211,37,9,0,46,0.821011673151751
"700980401","SAN JUAN",423,359,26,37,0,63,0.848699763593381
"700980303","SAN JUAN",176,126,15,28,2,45,0.715909090909091
"700980117","SAN JUAN",188,73,37,76,1,114,0.388297872340426
"700980103","SAN JUAN",261,63,107,87,1,195,0.241379310344828
"700980101","SAN JUAN",290,13,80,183,4,267,0.0448275862068966
"700840611","SAN JUAN",296,21,184,90,0,274,0.0709459459459459
"700840607","SAN JUAN",264,13,200,45,0,245,0.0492424242424242
"700840603","SAN JUAN",230,5,174,51,0,225,0.0217391304347826
"700840504","SAN JUAN",559,28,347,114,45,506,0.0500894454382826
"700840315","SAN JUAN",323,18,245,60,0,305,0.0557275541795666
"700840312","SAN JUAN",345,269,48,28,0,76,0.779710144927536
"700840309","SAN JUAN",356,246,43,65,0,108,0.691011235955056
"700420108","SAN JUAN",256,18,84,146,2,232,0.0703125
"700840212","SAN JUAN",390,298,59,30,0,89,0.764102564102564
"700771004","SAN JUAN",305,191,79,30,0,109,0.626229508196721
"700770906","SAN JUAN",270,5,167,88,1,256,0.0185185185185185
"700770814","SAN JUAN",293,2,72,209,0,281,0.0068259385665529
"700770805","SAN JUAN",319,3,97,207,4,308,0.00940438871473354
"700840414","SAN JUAN",215,12,98,83,0,181,0.0558139534883721
"700840407","SAN JUAN",239,10,45,178,1,224,0.0418410041841004
"700630103","SAN JUAN",367,8,219,104,25,348,0.0217983651226158
"701190206","SAN JUAN",236,0,132,104,0,236,0
"700770504","SAN JUAN",148,1,39,87,5,131,0.00675675675675676
"700770413","SAN JUAN",197,3,134,60,0,194,0.0152284263959391
"700770411","SAN JUAN",208,2,109,96,0,205,0.00961538461538462
"700770407","SAN JUAN",295,252,31,11,0,42,0.854237288135593
"700770311","SAN JUAN",342,142,101,93,0,194,0.415204678362573
"700770308","SAN JUAN",232,2,128,54,0,182,0.00862068965517241
"700770305","SAN JUAN",272,18,77,170,3,250,0.0661764705882353
"700770212","SAN JUAN",229,10,134,79,0,213,0.0436681222707424
"700700507","SAN JUAN",282,157,67,57,0,124,0.556737588652482
"700700302","SAN JUAN",236,3,88,80,57,225,0.0127118644067797
"700770512","SAN JUAN",299,7,252,39,0,291,0.0234113712374582
"700770510","SAN JUAN",327,14,303,10,0,313,0.0428134556574924
"700770509","SAN JUAN",156,90,50,9,2,61,0.576923076923077
"700420107","SAN JUAN",209,5,106,90,1,197,0.0239234449760766
"700770101","SAN JUAN",162,2,48,69,14,131,0.0123456790123457
"700770506","SAN JUAN",147,52,66,26,1,93,0.353741496598639
"701120104","SAN JUAN",247,0,96,128,10,234,0
"700560109","SAN JUAN",176,0,70,90,13,173,0
"700490207","SAN JUAN",238,0,129,83,11,223,0
"700420513","SAN JUAN",302,7,129,158,0,287,0.0231788079470199
"700420417","SAN JUAN",447,10,135,289,6,430,0.0223713646532438
"700420409","SAN JUAN",238,13,190,29,1,220,0.0546218487394958
"700420303","SAN JUAN",311,4,62,213,23,298,0.0128617363344051
"700420207","SAN JUAN",506,12,309,169,3,481,0.0237154150197628
"700280514","SAN JUAN",153,119,8,22,0,30,0.777777777777778
"700350202","SAN JUAN",126,0,22,58,46,126,0
"700420403","SAN JUAN",227,13,141,68,0,209,0.0572687224669604
"700770703","SAN JUAN",144,2,33,56,38,127,0.0138888888888889
"700560501","SAN JUAN",9,0,1,1,5,7,0
"700350403","SAN JUAN",208,0,70,71,53,194,0
"700210701","SAN JUAN",9,0,0,6,3,9,0
"700210405","SAN JUAN",40,0,10,25,4,39,0
"700210402","SAN JUAN",39,0,2,33,3,38,0
"700700201","SAN JUAN",73,0,20,38,15,73,0
"700770601","SAN JUAN",328,0,120,148,38,306,0
"700210101","SAN JUAN",88,0,7,52,9,68,0
"700770702","SAN JUAN",181,0,75,51,41,167,0
"700770701","SAN JUAN",227,1,100,67,43,210,0.00440528634361234
"700910104","SAN JUAN",307,15,191,72,20,283,0.0488599348534202
"701050304","SAN JUAN",199,1,44,58,40,142,0.0050251256281407
"700770602","SAN JUAN",276,0,127,70,49,246,0
"700560301","SAN JUAN",132,0,44,59,19,122,0
"700700202","SAN JUAN",108,0,22,37,40,99,0
"701050203","SAN JUAN",202,4,67,85,26,178,0.0198019801980198
"701050201","SAN JUAN",445,7,199,91,87,377,0.0157303370786517
"700630104","SAN JUAN",73,0,44,20,7,71,0
"700910110","SAN JUAN",87,2,33,26,15,74,0.0229885057471264
"700910103","SAN JUAN",103,5,35,49,11,95,0.0485436893203883
"700280910","SAN JUAN",268,219,37,11,0,48,0.817164179104478
"700280802","SAN JUAN",191,152,13,26,0,39,0.795811518324607
"700280706","SAN JUAN",266,198,28,39,0,67,0.744360902255639
"700280607","SAN JUAN",239,184,20,32,0,52,0.769874476987448
"700280602","SAN JUAN",292,282,2,8,0,10,0.965753424657534
"700280513","SAN JUAN",227,159,37,31,0,68,0.700440528634361
"700280406","SAN JUAN",301,266,27,8,0,35,0.883720930232558
"700280319","SAN JUAN",209,198,8,3,0,11,0.947368421052632
"700280316","SAN JUAN",308,278,11,10,0,21,0.902597402597403
"700280304","SAN JUAN",323,220,21,77,1,99,0.681114551083591
"700350111","SAN JUAN",312,271,24,16,0,40,0.868589743589744
"700350109","SAN JUAN",262,221,11,10,5,26,0.843511450381679
"700350107","SAN JUAN",231,199,7,17,1,25,0.861471861471861
"700350103","SAN JUAN",317,192,21,69,14,104,0.605678233438486
"700350102","SAN JUAN",301,19,78,137,48,263,0.0631229235880399
"700070207","SAN JUAN",161,0,99,39,12,150,0
"700700304","SAN JUAN",294,222,31,12,7,50,0.755102040816326
"700070102","SAN JUAN",389,2,222,154,2,378,0.0051413881748072
"700420515","SAN JUAN",251,3,64,179,4,247,0.0119521912350598
"700070304","SAN JUAN",197,0,80,102,7,189,0
"701050307","SAN JUAN",302,30,192,69,5,266,0.0993377483443709
"700560701","SAN JUAN",158,0,56,55,40,151,0
"700420103","SAN JUAN",259,11,190,14,0,204,0.0424710424710425
"700280110","SAN JUAN",235,234,1,0,0,1,0.995744680851064
"700280102","SAN JUAN",240,239,0,1,0,1,0.995833333333333
"700280202","SAN JUAN",291,180,38,55,0,93,0.618556701030928
"700280201","SAN JUAN",263,136,82,44,0,126,0.517110266159696
"700280309","SAN JUAN",291,252,16,23,0,39,0.865979381443299
"701050108","SAN JUAN",325,9,148,136,8,292,0.0276923076923077
"700980410","SAN JUAN",178,118,22,8,0,30,0.662921348314607
"700980409","SAN JUAN",227,221,2,4,0,6,0.973568281938326
"700980307","SAN JUAN",376,184,66,111,0,177,0.48936170212766
"700980104","SAN JUAN",301,122,55,117,0,172,0.40531561461794
"700910106","SAN JUAN",109,1,42,35,15,92,0.00917431192660551
"700840613","SAN JUAN",184,0,75,106,0,181,0
"700840601","SAN JUAN",323,9,157,155,0,312,0.0278637770897833
"700840604","SAN JUAN",333,11,281,41,0,322,0.033033033033033
"700840320","SAN JUAN",270,187,69,13,0,82,0.692592592592593
"700770810","SAN JUAN",405,13,282,108,2,392,0.0320987654320988
"700840305","SAN JUAN",482,369,58,32,1,91,0.765560165975104
"700840217","SAN JUAN",238,89,101,47,0,148,0.373949579831933
"700840208","SAN JUAN",318,253,22,42,1,65,0.79559748427673
"700840205","SAN JUAN",257,29,78,146,1,225,0.11284046692607
"700771006","SAN JUAN",315,129,87,79,1,167,0.40952380952381
"700770912","SAN JUAN",287,7,166,108,0,274,0.024390243902439
"700770907","SAN JUAN",255,3,174,76,0,250,0.0117647058823529
"700770902","SAN JUAN",257,56,108,89,2,199,0.217898832684825
"700770901","SAN JUAN",299,93,89,111,2,202,0.311036789297659
"700770812","SAN JUAN",289,8,100,174,2,276,0.027681660899654
"700420109","SAN JUAN",248,3,75,156,1,232,0.0120967741935484
"700840501","SAN JUAN",329,7,113,200,2,315,0.0212765957446809
"701190303","SAN JUAN",176,0,48,104,4,156,0
"700770416","SAN JUAN",208,5,63,140,0,203,0.0240384615384615
"700770408","SAN JUAN",246,199,17,28,0,45,0.808943089430894
"700770106","SAN JUAN",250,6,132,97,2,231,0.024
"700770105","SAN JUAN",232,7,186,39,0,225,0.0301724137931034
"700980304","SAN JUAN",325,269,17,26,3,46,0.827692307692308
"700420505","SAN JUAN",399,1,37,294,10,341,0.0025062656641604
"700700512","SAN JUAN",376,11,180,170,9,359,0.0292553191489362
"701120102","SAN JUAN",367,0,175,161,19,355,0
"701120105","SAN JUAN",293,0,163,107,6,276,0
"700700109","SAN JUAN",268,5,133,124,3,260,0.0186567164179104
"700560206","SAN JUAN",266,0,233,32,0,265,0
"700420510","SAN JUAN",428,12,353,62,0,415,0.0280373831775701
"700420504","SAN JUAN",315,7,250,54,0,304,0.0222222222222222
"700420413","SAN JUAN",360,17,251,89,1,341,0.0472222222222222
"700420407","SAN JUAN",334,8,198,128,0,326,0.0239520958083832
"700420216","SAN JUAN",365,1,152,205,0,357,0.00273972602739726
"700420111","SAN JUAN",203,21,30,123,26,179,0.103448275862069
"700420110","SAN JUAN",273,1,89,176,0,265,0.00366300366300366
"700420101","SAN JUAN",190,3,98,80,1,179,0.0157894736842105
"700350710","SAN JUAN",245,7,52,162,11,225,0.0285714285714286
"700350302","SAN JUAN",249,6,92,94,33,219,0.0240963855421687
"700490401","SAN JUAN",8,0,1,3,0,4,0
"700210702","SAN JUAN",1,0,0,0,1,1,0
"700210204","SAN JUAN",54,0,6,37,4,47,0
"700210202","SAN JUAN",51,0,3,34,3,40,0
"700350402","SAN JUAN",239,8,111,67,19,197,0.0334728033472803
"701050102","SAN JUAN",170,0,78,59,19,156,0
"700910108","SAN JUAN",89,0,55,25,5,85,0
"700280801","SAN JUAN",226,78,84,61,0,145,0.345132743362832
"700280711","SAN JUAN",316,148,52,114,0,166,0.468354430379747
"700700204","SAN JUAN",208,2,31,111,46,188,0.00961538461538462
"700350112","SAN JUAN",320,300,11,7,0,18,0.9375
"700980205","SAN JUAN",392,18,214,100,28,342,0.0459183673469388
"700840101","SAN JUAN",13,0,5,6,1,12,0
"700140103","SAN JUAN",353,4,225,63,24,312,0.0113314447592068
"700630204","SAN JUAN",240,2,95,81,48,224,0.00833333333333333
"700490206","SAN JUAN",83,0,23,28,23,74,0
"700280908","SAN JUAN",334,285,18,30,0,48,0.853293413173653
"700280903","SAN JUAN",212,179,18,14,0,32,0.844339622641509
"700280810","SAN JUAN",318,246,26,43,0,69,0.773584905660377
"700770210","SAN JUAN",179,21,68,81,1,150,0.11731843575419
"700280807","SAN JUAN",251,222,21,8,0,29,0.884462151394422
"700280604","SAN JUAN",237,166,38,32,0,70,0.70042194092827
"701190101","SAN JUAN",61,0,26,28,1,55,0
"700210201","SAN JUAN",297,0,153,132,5,290,0
"700280618","SAN JUAN",265,166,41,50,1,92,0.626415094339623
"700280616","SAN JUAN",144,111,11,22,0,33,0.770833333333333
"700280609","SAN JUAN",289,258,15,16,0,31,0.892733564013841
"700280509","SAN JUAN",185,1,118,40,0,158,0.00540540540540541
"700280503","SAN JUAN",164,145,16,3,0,19,0.884146341463415
"700280408","SAN JUAN",284,232,29,21,0,50,0.816901408450704
"700280315","SAN JUAN",153,137,8,8,0,16,0.895424836601307
"700280314","SAN JUAN",206,156,20,29,0,49,0.757281553398058
"700280307","SAN JUAN",195,182,3,8,0,11,0.933333333333333
"700490101","SAN JUAN",98,0,44,29,9,82,0
"700350703","SAN JUAN",246,195,13,13,0,26,0.792682926829268
"700350702","SAN JUAN",451,388,36,6,0,42,0.860310421286031
"700771005","SAN JUAN",301,287,5,9,0,14,0.953488372093023
"700280916","SAN JUAN",307,220,33,46,0,79,0.716612377850163
"700280915","SAN JUAN",304,235,33,30,0,63,0.773026315789474
"700280912","SAN JUAN",167,66,32,61,1,94,0.395209580838323
"700280118","SAN JUAN",179,177,2,0,0,2,0.988826815642458
"700070308","SAN JUAN",271,258,5,4,0,9,0.952029520295203
"701330103","SAN JUAN",419,0,212,170,2,384,0
"700490205","SAN JUAN",168,0,142,14,6,162,0
"700980114","SAN JUAN",232,41,35,154,0,189,0.176724137931034
"700910109","SAN JUAN",280,164,80,28,5,113,0.585714285714286
"700280213","SAN JUAN",181,165,6,10,0,16,0.911602209944751
"700280209","SAN JUAN",233,228,3,0,0,3,0.978540772532189
"500700811","MENDOZA",268,247,10,10,0,20,0.921641791044776
"700280206","SAN JUAN",215,197,17,1,0,18,0.916279069767442
"700280114","SAN JUAN",236,234,2,0,0,2,0.991525423728814
"700280106","SAN JUAN",248,245,2,0,0,2,0.987903225806452
"700210401","SAN JUAN",264,0,133,125,2,260,0
"700980102","SAN JUAN",215,24,107,80,0,187,0.111627906976744
"700840610","SAN JUAN",475,9,124,297,29,450,0.0189473684210526
"700910113","SAN JUAN",249,5,227,14,0,241,0.0200803212851406
"700840417","SAN JUAN",213,67,56,62,2,120,0.314553990610329
"700840310","SAN JUAN",359,295,40,21,0,61,0.821727019498607
"700840304","SAN JUAN",327,132,48,129,1,178,0.403669724770642
"700840301","SAN JUAN",363,7,221,108,0,329,0.0192837465564738
"700770911","SAN JUAN",340,2,114,214,0,328,0.00588235294117647
"700840207","SAN JUAN",244,199,26,19,0,45,0.815573770491803
"700771003","SAN JUAN",212,65,39,106,0,145,0.306603773584906
"700770815","SAN JUAN",284,8,57,203,2,262,0.028169014084507
"700770806","SAN JUAN",411,20,225,143,3,371,0.048661800486618
"500211401","MENDOZA",127,127,0,0,0,0,1
"700840409","SAN JUAN",311,8,161,132,1,294,0.0257234726688103
"700840406","SAN JUAN",193,3,104,64,0,168,0.0155440414507772
"700770904","SAN JUAN",318,18,83,208,3,294,0.0566037735849057
"700700104","SAN JUAN",288,3,141,126,9,276,0.0104166666666667
"701260101","SAN JUAN",362,215,109,8,18,135,0.593922651933702
"700770401","SAN JUAN",205,35,85,80,2,167,0.170731707317073
"700770312","SAN JUAN",233,19,23,183,2,208,0.0815450643776824
"700770304","SAN JUAN",354,8,203,134,0,337,0.0225988700564972
"700770301","SAN JUAN",262,6,238,13,0,251,0.0229007633587786
"700770208","SAN JUAN",413,16,333,58,0,391,0.0387409200968523
"700770103","SAN JUAN",3,0,0,3,0,3,0
"700700513","SAN JUAN",343,3,114,221,0,335,0.0087463556851312
"700700511","SAN JUAN",446,6,176,229,2,407,0.0134529147982063
"700070302","SAN JUAN",221,49,94,67,8,169,0.221719457013575
"700700206","SAN JUAN",529,12,241,229,26,496,0.0226843100189036
"700700102","SAN JUAN",399,2,112,224,27,363,0.0050125313283208
"700770511","SAN JUAN",375,8,254,103,2,359,0.0213333333333333
"700420507","SAN JUAN",361,2,224,126,7,357,0.00554016620498615
"700420501","SAN JUAN",404,1,131,220,6,357,0.00247524752475248
"700420412","SAN JUAN",367,6,189,167,0,356,0.0163487738419619
"700420401","SAN JUAN",281,9,208,57,3,268,0.0320284697508897
"701050306","SAN JUAN",325,39,171,109,2,282,0.12
"700560203","SAN JUAN",307,0,165,132,7,304,0
"700560201","SAN JUAN",258,0,158,88,7,253,0
"700560106","SAN JUAN",116,0,19,45,27,91,0
"700560207","SAN JUAN",198,0,50,111,4,165,0
"700420512","SAN JUAN",290,6,187,91,2,280,0.0206896551724138
"700420213","SAN JUAN",361,3,143,208,1,352,0.00831024930747922
"700420212","SAN JUAN",403,7,189,179,3,371,0.0173697270471464
"700420211","SAN JUAN",218,14,109,91,2,202,0.0642201834862385
"700420202","SAN JUAN",210,1,180,11,0,191,0.00476190476190476
"700350709","SAN JUAN",284,201,26,49,4,79,0.707746478873239
"700350401","SAN JUAN",104,0,27,47,15,89,0
"700210205","SAN JUAN",13,0,0,5,3,8,0
"700980408","SAN JUAN",151,118,31,2,0,33,0.781456953642384
"500980509","MENDOZA",186,175,9,2,0,11,0.940860215053763
"700700401","SAN JUAN",39,1,8,20,5,33,0.0256410256410256
"700280701","SAN JUAN",342,320,12,10,0,22,0.935672514619883
"700700101","SAN JUAN",255,0,71,148,21,240,0
"701050101","SAN JUAN",101,1,22,41,12,75,0.0099009900990099
"700560101","SAN JUAN",175,0,19,65,81,165,0
"700490301","SAN JUAN",87,0,37,25,13,75,0
"700140102","SAN JUAN",140,0,43,57,23,123,0
"140420801","CORDOBA",225,224,0,1,0,1,0.995555555555556
"701190302","SAN JUAN",67,0,6,34,6,46,0
"700070306","SAN JUAN",258,224,12,1,1,14,0.868217054263566
"700280612","SAN JUAN",280,262,15,1,0,16,0.935714285714286
"700280501","SAN JUAN",295,255,29,11,0,40,0.864406779661017
"700770204","SAN JUAN",376,2,301,68,0,369,0.00531914893617021
"701050105","SAN JUAN",145,0,53,71,9,133,0
"700280901","SAN JUAN",341,306,11,24,0,35,0.897360703812317
"700280715","SAN JUAN",252,104,94,54,0,148,0.412698412698413
"700280305","SAN JUAN",287,188,54,38,1,93,0.655052264808362
"700350708","SAN JUAN",221,221,0,0,0,0,1
"700350705","SAN JUAN",308,181,51,56,1,108,0.587662337662338
"700350108","SAN JUAN",300,254,20,2,0,22,0.846666666666667
"700280212","SAN JUAN",138,96,14,2,0,16,0.695652173913043
"700280207","SAN JUAN",200,166,23,9,0,32,0.83
"700630101","SAN JUAN",121,1,48,55,10,113,0.00826446280991736
"700280511","SAN JUAN",300,27,207,66,0,273,0.09
"700280510","SAN JUAN",200,13,138,49,0,187,0.065
"700280508","SAN JUAN",226,109,78,39,0,117,0.482300884955752
"700280611","SAN JUAN",269,250,3,16,0,19,0.929368029739777
"700280407","SAN JUAN",240,216,10,14,0,24,0.9
"700280306","SAN JUAN",301,295,1,1,0,2,0.980066445182724
"700280302","SAN JUAN",226,143,19,61,0,80,0.632743362831858
"701050302","SAN JUAN",476,411,14,25,7,46,0.863445378151261
"700980203","SAN JUAN",237,0,53,159,17,229,0
"700280615","SAN JUAN",249,135,72,41,0,113,0.542168674698795
"700980110","SAN JUAN",311,205,33,67,0,100,0.659163987138264
"700840612","SAN JUAN",292,13,133,140,1,274,0.0445205479452055
"700840505","SAN JUAN",212,6,123,63,0,186,0.0283018867924528
"700840404","SAN JUAN",223,23,192,8,0,200,0.103139013452915
"700840403","SAN JUAN",305,11,249,45,0,294,0.0360655737704918
"700840506","SAN JUAN",200,14,154,32,0,186,0.07
"700840401","SAN JUAN",486,34,220,225,1,446,0.0699588477366255
"700840306","SAN JUAN",376,173,87,112,1,200,0.460106382978723
"700840302","SAN JUAN",322,197,34,90,0,124,0.611801242236025
"700840206","SAN JUAN",233,218,8,7,0,15,0.935622317596567
"700840203","SAN JUAN",262,23,154,78,3,235,0.0877862595419847
"700770809","SAN JUAN",363,9,103,244,2,349,0.0247933884297521
"700840413","SAN JUAN",208,5,128,72,0,200,0.0240384615384615
"700840408","SAN JUAN",269,3,177,85,0,262,0.0111524163568773
"700770414","SAN JUAN",207,3,50,144,1,195,0.0144927536231884
"700840405","SAN JUAN",410,15,222,170,0,392,0.0365853658536585
"700770905","SAN JUAN",398,390,3,0,0,3,0.979899497487437
"700770503","SAN JUAN",222,154,35,0,0,35,0.693693693693694
"700770415","SAN JUAN",221,1,104,106,0,210,0.00452488687782805
"700770310","SAN JUAN",357,10,230,116,1,347,0.0280112044817927
"700770302","SAN JUAN",283,7,186,85,0,271,0.0247349823321555
"700770206","SAN JUAN",344,21,217,101,4,322,0.061046511627907
"740280407","SAN LUIS",288,53,196,28,6,230,0.184027777777778
"700770202","SAN JUAN",374,3,154,176,1,331,0.00802139037433155
"700700514","SAN JUAN",379,4,149,205,4,358,0.0105540897097625
"700700505","SAN JUAN",235,10,149,40,0,189,0.0425531914893617
"700700205","SAN JUAN",245,10,124,100,1,225,0.0408163265306122
"500700403","MENDOZA",365,3,227,116,4,347,0.00821917808219178
"700770507","SAN JUAN",286,9,160,115,1,276,0.0314685314685315
"700560212","SAN JUAN",222,0,82,121,11,214,0
"700560211","SAN JUAN",318,0,202,97,2,301,0
"700560107","SAN JUAN",97,0,68,13,15,96,0
"700560208","SAN JUAN",284,0,146,130,0,276,0
"700490302","SAN JUAN",172,0,136,22,2,160,0
"700420514","SAN JUAN",420,15,233,169,0,402,0.0357142857142857
"700420411","SAN JUAN",230,7,55,167,0,222,0.0304347826086957
"700420410","SAN JUAN",250,2,89,146,3,238,0.008
"700420405","SAN JUAN",310,23,200,79,0,279,0.0741935483870968
"700420301","SAN JUAN",268,3,153,102,1,256,0.0111940298507463
"500140701","MENDOZA",422,5,270,105,12,387,0.0118483412322275
"700420102","SAN JUAN",382,11,318,46,0,364,0.0287958115183246
"700420112","SAN JUAN",206,9,47,136,1,184,0.0436893203883495
"700070305","SAN JUAN",57,0,23,24,7,54,0
"701330201","SAN JUAN",4,0,1,1,0,2,0
"700700303","SAN JUAN",226,2,29,122,51,202,0.00884955752212389
"700210301","SAN JUAN",97,0,11,61,16,88,0
"700350203","SAN JUAN",248,3,47,90,92,229,0.0120967741935484
"700840416","SAN JUAN",226,4,173,47,0,220,0.0176991150442478
"700140301","SAN JUAN",15,0,1,3,6,10,0
"740350802","SAN LUIS",157,4,32,104,3,139,0.0254777070063694
"701260102","SAN JUAN",245,0,48,110,74,232,0
"700910201","SAN JUAN",15,0,0,4,1,5,0
"700140104","SAN JUAN",217,2,128,44,20,192,0.00921658986175115
"701260301","SAN JUAN",270,2,59,83,57,199,0.00740740740740741
"700070402","SAN JUAN",137,1,52,37,26,115,0.0072992700729927
"700070301","SAN JUAN",383,3,196,134,38,368,0.00783289817232376
"700280808","SAN JUAN",196,185,11,0,0,11,0.943877551020408
"700070401","SAN JUAN",159,1,82,34,20,136,0.00628930817610063
"700630201","SAN JUAN",44,0,16,26,0,42,0
"700490102","SAN JUAN",30,0,11,6,4,21,0
"700280806","SAN JUAN",266,258,5,3,0,8,0.969924812030075
"700280803","SAN JUAN",211,168,28,13,0,41,0.796208530805687
"700700114","SAN JUAN",431,5,146,151,92,389,0.0116009280742459
"700840402","SAN JUAN",218,9,197,12,0,209,0.0412844036697248
"500980611","MENDOZA",337,3,276,51,2,329,0.00890207715133531
"700630102","SAN JUAN",181,49,57,30,9,96,0.270718232044199
"701330101","SAN JUAN",155,0,81,50,7,138,0
"700910107","SAN JUAN",137,11,71,39,12,122,0.0802919708029197
"700560302","SAN JUAN",245,0,101,93,36,230,0
"700280911","SAN JUAN",84,77,1,6,0,7,0.916666666666667
"701120103","SAN JUAN",127,0,39,73,7,119,0
"700280504","SAN JUAN",307,261,25,20,0,45,0.850162866449511
"700280402","SAN JUAN",180,153,11,16,0,27,0.85
"700280317","SAN JUAN",188,184,0,4,0,4,0.978723404255319
"700280312","SAN JUAN",179,146,5,25,0,30,0.815642458100559
"701260203","SAN JUAN",285,6,188,75,12,275,0.0210526315789474
"700840214","SAN JUAN",217,5,131,77,1,209,0.0230414746543779
"700630106","SAN JUAN",269,25,176,45,13,234,0.0929368029739777
"700280210","SAN JUAN",266,261,1,4,0,5,0.981203007518797
"700280105","SAN JUAN",114,114,0,0,0,0,1
"700140106","SAN JUAN",317,1,247,53,1,301,0.00315457413249211
"700210403","SAN JUAN",299,0,130,162,6,298,0
"700980411","SAN JUAN",220,175,17,24,0,41,0.795454545454545
"700980404","SAN JUAN",331,310,11,10,0,21,0.936555891238671
"700980201","SAN JUAN",343,10,128,160,22,310,0.0291545189504373
"700980118","SAN JUAN",294,6,106,166,3,275,0.0204081632653061
"700980115","SAN JUAN",243,195,4,42,0,46,0.802469135802469
"700980112","SAN JUAN",300,253,25,20,0,45,0.843333333333333
"700980108","SAN JUAN",275,214,22,33,0,55,0.778181818181818
"700840609","SAN JUAN",303,10,171,101,0,272,0.033003300330033
"700840608","SAN JUAN",280,9,221,40,0,261,0.0321428571428571
"700840319","SAN JUAN",262,122,83,56,0,139,0.465648854961832
"700840317","SAN JUAN",242,141,58,40,1,99,0.582644628099174
"700840303","SAN JUAN",302,140,27,111,0,138,0.463576158940397
"700840213","SAN JUAN",229,65,98,66,0,164,0.283842794759825
"700840102","SAN JUAN",67,30,12,25,0,37,0.447761194029851
"700771013","SAN JUAN",333,4,175,140,3,318,0.012012012012012
"700771012","SAN JUAN",212,4,125,77,0,202,0.0188679245283019
"700771010","SAN JUAN",308,14,123,160,2,285,0.0454545454545455
"700770903","SAN JUAN",275,74,111,84,0,195,0.269090909090909
"700770813","SAN JUAN",459,1,164,273,5,442,0.00217864923747277
"700770406","SAN JUAN",306,229,66,11,0,77,0.748366013071895
"700770404","SAN JUAN",260,8,169,79,1,249,0.0307692307692308
"700770306","SAN JUAN",363,7,194,156,1,351,0.0192837465564738
"700770303","SAN JUAN",273,5,246,22,0,268,0.0183150183150183
"700770211","SAN JUAN",269,15,170,84,0,254,0.0557620817843866
"700770207","SAN JUAN",329,5,261,61,0,322,0.0151975683890578
"700770102","SAN JUAN",482,73,322,77,0,399,0.151452282157676
"700700516","SAN JUAN",377,15,56,171,68,295,0.0397877984084881
"700700510","SAN JUAN",300,5,194,96,1,291,0.0166666666666667
"700700508","SAN JUAN",304,1,131,158,1,290,0.00328947368421053
"700700506","SAN JUAN",293,148,67,78,0,145,0.505119453924915
"700700106","SAN JUAN",274,1,114,145,5,264,0.00364963503649635
"140420715","CORDOBA",339,291,13,24,0,37,0.858407079646018
"701050308","SAN JUAN",236,37,132,55,0,187,0.156779661016949
"700420502","SAN JUAN",330,5,174,146,0,320,0.0151515151515152
"700420415","SAN JUAN",289,7,137,124,0,261,0.0242214532871972
"700420402","SAN JUAN",491,7,383,91,1,475,0.0142566191446029
"700420304","SAN JUAN",48,2,19,23,3,45,0.0416666666666667
"700420302","SAN JUAN",323,4,118,182,13,313,0.0123839009287926
"700420217","SAN JUAN",350,6,156,183,0,339,0.0171428571428571
"700420204","SAN JUAN",482,0,82,351,5,438,0
"701190204","SAN JUAN",28,0,5,18,0,23,0
"500840705","MENDOZA",313,58,164,80,7,251,0.185303514376997
"500840703","MENDOZA",168,93,49,13,7,69,0.553571428571429
"700070501","SAN JUAN",41,0,20,14,2,36,0
"700350602","SAN JUAN",75,0,4,19,18,41,0
"700700305","SAN JUAN",129,3,29,77,8,114,0.0232558139534884
"700630105","SAN JUAN",34,2,16,6,4,26,0.0588235294117647
"140420714","CORDOBA",168,166,0,2,0,2,0.988095238095238
"701190203","SAN JUAN",56,0,20,26,0,46,0
"701190103","SAN JUAN",32,0,5,13,0,18,0
"700910105","SAN JUAN",69,5,30,23,5,58,0.072463768115942
"500350205","MENDOZA",324,221,74,25,0,99,0.682098765432099
"700560210","SAN JUAN",58,0,16,32,8,56,0
"500980102","MENDOZA",488,2,190,161,54,405,0.00409836065573771
"500910301","MENDOZA",256,6,116,107,3,226,0.0234375
"500840702","MENDOZA",244,1,141,88,5,234,0.00409836065573771
"500840301","MENDOZA",222,5,162,42,6,210,0.0225225225225225
"500350301","MENDOZA",488,49,327,86,5,418,0.100409836065574
"500350201","MENDOZA",388,156,167,55,2,224,0.402061855670103
"500350103","MENDOZA",271,2,185,63,4,252,0.00738007380073801
"500770121","MENDOZA",191,1,60,100,7,167,0.00523560209424084
"500700414","MENDOZA",314,5,150,152,2,304,0.0159235668789809
"500700209","MENDOZA",304,4,182,103,3,288,0.0131578947368421
"500140601","MENDOZA",335,164,74,89,4,167,0.48955223880597
"500700803","MENDOZA",297,293,4,0,0,4,0.986531986531986
"500630703","MENDOZA",178,87,34,54,0,88,0.48876404494382
"500630406","MENDOZA",536,19,215,255,17,487,0.0354477611940298
"500560602","MENDOZA",251,3,145,42,6,193,0.0119521912350598
"500560403","MENDOZA",366,45,170,96,31,297,0.122950819672131
"500980604","MENDOZA",308,4,184,101,7,292,0.012987012987013
"501260315","MENDOZA",187,4,68,95,8,171,0.0213903743315508
"500980819","MENDOZA",321,1,234,76,6,316,0.00311526479750779
"500490202","MENDOZA",70,10,15,29,0,44,0.142857142857143
"500490201","MENDOZA",406,7,174,136,24,334,0.0172413793103448
"500350501","MENDOZA",536,8,412,96,6,514,0.0149253731343284
"500281712","MENDOZA",541,14,236,248,10,494,0.0258780036968577
"500700213","MENDOZA",377,10,353,10,0,363,0.026525198938992
"501190204","MENDOZA",424,5,210,147,22,379,0.0117924528301887
"501190608","MENDOZA",290,284,4,0,0,4,0.979310344827586
"501190604","MENDOZA",367,323,34,8,0,42,0.880108991825613
"501051915","MENDOZA",157,1,83,63,0,146,0.00636942675159236
"501051911","MENDOZA",145,8,63,66,0,129,0.0551724137931034
"500490203","MENDOZA",189,158,2,16,0,18,0.835978835978836
"140420713","CORDOBA",249,229,9,8,0,17,0.919678714859438
"501051910","MENDOZA",350,332,6,9,0,15,0.948571428571429
"501051907","MENDOZA",379,11,215,140,8,363,0.029023746701847
"501051810","MENDOZA",328,242,59,23,0,82,0.73780487804878
"501051806","MENDOZA",297,111,68,116,0,184,0.373737373737374
"501190201","MENDOZA",86,0,51,25,2,78,0
"501051604","MENDOZA",276,2,158,102,1,261,0.0072463768115942
"501051002","MENDOZA",285,60,84,110,16,210,0.210526315789474
"500491414","MENDOZA",194,171,11,6,2,19,0.881443298969072
"500631008","MENDOZA",364,245,74,44,0,118,0.673076923076923
"500280412","MENDOZA",268,222,2,40,0,42,0.828358208955224
"501260312","MENDOZA",382,156,164,52,0,216,0.408376963350785
"501260310","MENDOZA",249,217,21,10,0,31,0.8714859437751
"501260304","MENDOZA",400,300,60,35,0,95,0.75
"501051801","MENDOZA",348,292,21,35,0,56,0.839080459770115
"501051713","MENDOZA",250,181,47,20,0,67,0.724
"501051705","MENDOZA",226,72,78,69,0,147,0.31858407079646
"501051701","MENDOZA",303,158,42,69,0,111,0.521452145214521
"501051818","MENDOZA",321,318,0,1,0,1,0.990654205607477
"501051512","MENDOZA",181,129,11,35,2,48,0.712707182320442
"501051505","MENDOZA",300,164,83,46,0,129,0.546666666666667
"501051409","MENDOZA",182,157,17,8,0,25,0.862637362637363
"501051206","MENDOZA",141,0,70,58,4,132,0
"500280214","MENDOZA",185,179,2,4,0,6,0.967567567567568
"500701006","MENDOZA",400,13,231,155,0,386,0.0325
"500700913","MENDOZA",179,174,0,0,0,0,0.972067039106145
"500700904","MENDOZA",369,345,9,14,0,23,0.934959349593496
"500700507","MENDOZA",270,253,14,2,0,16,0.937037037037037
"500700424","MENDOZA",216,85,57,68,2,127,0.393518518518519
"500700409","MENDOZA",477,12,184,260,0,444,0.0251572327044025
"500700208","MENDOZA",346,6,278,60,2,340,0.0173410404624277
"500631116","MENDOZA",231,202,24,5,0,29,0.874458874458874
"500631110","MENDOZA",128,119,4,3,2,9,0.9296875
"500700117","MENDOZA",463,8,362,81,1,444,0.0172786177105832
"501190609","MENDOZA",197,194,1,1,0,2,0.984771573604061
"500631001","MENDOZA",244,12,131,99,0,230,0.0491803278688525
"140421103","CORDOBA",258,255,1,1,0,2,0.988372093023256
"500630911","MENDOZA",192,192,0,0,0,0,1
"500630908","MENDOZA",244,211,11,21,0,32,0.864754098360656
"501050415","MENDOZA",190,138,34,18,0,52,0.726315789473684
"500980902","MENDOZA",161,135,24,2,0,26,0.838509316770186
"500980818","MENDOZA",385,371,1,1,0,2,0.963636363636364
"500980812","MENDOZA",198,167,21,7,0,28,0.843434343434343
"500980805","MENDOZA",465,388,63,4,0,67,0.834408602150538
"500980715","MENDOZA",508,15,411,72,4,487,0.0295275590551181
"500491008","MENDOZA",187,185,1,1,0,2,0.989304812834225
"500491001","MENDOZA",462,435,3,4,0,7,0.941558441558442
"501050706","MENDOZA",298,42,99,134,7,240,0.140939597315436
"501050519","MENDOZA",189,182,7,0,0,7,0.962962962962963
"501050514","MENDOZA",301,102,95,103,0,198,0.338870431893688
"501050411","MENDOZA",353,61,130,158,0,288,0.172804532577904
"501050409","MENDOZA",229,27,69,132,0,201,0.117903930131004
"500910106","MENDOZA",224,5,170,47,0,217,0.0223214285714286
"500840805","MENDOZA",390,249,105,28,0,133,0.638461538461538
"500840216","MENDOZA",193,173,11,5,2,18,0.896373056994819
"500840214","MENDOZA",328,238,65,20,0,85,0.725609756097561
"500840207","MENDOZA",359,283,62,8,1,71,0.788300835654596
"500840810","MENDOZA",323,111,128,60,1,189,0.343653250773994
"500770125","MENDOZA",275,2,91,175,0,266,0.00727272727272727
"500701009","MENDOZA",217,203,10,4,0,14,0.935483870967742
"500490911","MENDOZA",369,368,1,0,0,1,0.997289972899729
"500490812","MENDOZA",417,407,3,2,0,5,0.976019184652278
"500490703","MENDOZA",232,229,1,0,0,1,0.987068965517241
"500490702","MENDOZA",238,228,5,0,0,5,0.957983193277311
"500980709","MENDOZA",267,266,1,0,0,1,0.99625468164794
"500490413","MENDOZA",146,144,2,0,0,2,0.986301369863014
"500490312","MENDOZA",265,263,2,0,0,2,0.992452830188679
"500490221","MENDOZA",412,408,1,1,0,2,0.990291262135922
"500490217","MENDOZA",235,210,8,2,0,10,0.893617021276596
"500420406","MENDOZA",464,23,275,155,3,433,0.0495689655172414
"500281105","MENDOZA",347,315,10,15,0,25,0.907780979827089
"500281101","MENDOZA",226,219,3,2,0,5,0.969026548672566
"500280913","MENDOZA",305,305,0,0,0,0,1
"500281009","MENDOZA",246,244,1,1,0,2,0.991869918699187
"500280902","MENDOZA",243,242,1,0,0,1,0.995884773662551
"500491118","MENDOZA",210,206,0,2,0,2,0.980952380952381
"500070212","MENDOZA",157,157,0,0,0,0,1
"500280807","MENDOZA",286,279,5,1,0,6,0.975524475524476
"500071110","MENDOZA",287,287,0,0,0,0,1
"140981706","CORDOBA",236,121,85,27,0,112,0.51271186440678
"500630904","MENDOZA",271,233,26,12,0,38,0.859778597785978
"500630309","MENDOZA",336,21,252,61,0,313,0.0625
"500630306","MENDOZA",367,8,238,111,0,349,0.0217983651226158
"500630204","MENDOZA",239,229,5,1,0,6,0.9581589958159
"500700418","MENDOZA",323,3,203,108,0,311,0.00928792569659443
"500630113","MENDOZA",305,50,155,93,0,248,0.163934426229508
"501050512","MENDOZA",192,108,54,30,0,84,0.5625
"500630312","MENDOZA",471,171,73,185,6,264,0.363057324840764
"500630213","MENDOZA",239,237,1,1,0,2,0.99163179916318
"500280705","MENDOZA",170,105,45,20,0,65,0.617647058823529
"500211405","MENDOZA",315,308,1,0,0,1,0.977777777777778
"500491303","MENDOZA",267,241,15,7,0,22,0.902621722846442
"500491302","MENDOZA",461,390,3,54,2,59,0.845986984815618
"500491214","MENDOZA",232,232,0,0,0,0,1
"500491212","MENDOZA",341,338,0,3,0,3,0.991202346041056
"500491312","MENDOZA",438,414,8,8,0,16,0.945205479452055
"500491205","MENDOZA",310,309,0,0,1,1,0.996774193548387
"500211406","MENDOZA",330,322,0,0,0,0,0.975757575757576
"140560113","CORDOBA",309,278,25,6,0,31,0.899676375404531
"500491112","MENDOZA",381,374,5,1,0,6,0.981627296587926
"500280816","MENDOZA",235,229,2,4,0,6,0.974468085106383
"500280815","MENDOZA",324,321,2,0,0,2,0.990740740740741
"500280609","MENDOZA",106,1,55,45,0,100,0.00943396226415094
"500280703","MENDOZA",233,87,113,32,0,145,0.373390557939914
"500280314","MENDOZA",422,378,12,22,0,34,0.895734597156398
"500280309","MENDOZA",289,259,15,4,1,20,0.896193771626298
"500280306","MENDOZA",336,294,21,10,0,31,0.875
"500280515","MENDOZA",212,1,162,41,2,205,0.00471698113207547
"500280108","MENDOZA",265,260,5,0,0,5,0.981132075471698
"500280103","MENDOZA",234,227,3,3,0,6,0.97008547008547
"500280102","MENDOZA",208,201,3,3,0,6,0.966346153846154
"500211507","MENDOZA",298,297,1,0,0,1,0.996644295302013
"500211403","MENDOZA",347,337,1,0,0,1,0.971181556195965
"500210804","MENDOZA",111,105,1,3,0,4,0.945945945945946
"500210706","MENDOZA",330,319,6,4,0,10,0.966666666666667
"500210703","MENDOZA",338,333,4,1,0,5,0.985207100591716
"500210606","MENDOZA",334,333,1,0,0,1,0.997005988023952
"500210605","MENDOZA",346,334,9,3,0,12,0.965317919075145
"500282005","MENDOZA",252,213,30,6,0,36,0.845238095238095
"500630802","MENDOZA",275,182,56,37,0,93,0.661818181818182
"500630801","MENDOZA",254,225,21,7,0,28,0.885826771653543
"500420404","MENDOZA",249,116,103,29,1,133,0.465863453815261
"500350207","MENDOZA",299,255,31,3,0,34,0.852842809364548
"500282007","MENDOZA",322,289,22,11,0,33,0.897515527950311
"500282004","MENDOZA",179,169,3,3,0,6,0.94413407821229
"500700609","MENDOZA",227,226,0,0,0,0,0.995594713656388
"500282001","MENDOZA",354,303,34,17,0,51,0.855932203389831
"500281909","MENDOZA",367,301,28,35,0,63,0.82016348773842
"500281906","MENDOZA",334,201,81,48,0,129,0.601796407185629
"500281901","MENDOZA",414,249,49,108,0,157,0.601449275362319
"500281806","MENDOZA",241,228,9,3,0,12,0.946058091286307
"500281709","MENDOZA",203,112,73,14,0,87,0.551724137931034
"500281701","MENDOZA",193,47,131,12,0,143,0.243523316062176
"500281609","MENDOZA",423,409,11,3,0,14,0.966903073286052
"500281607","MENDOZA",180,180,0,0,0,0,1
"500281507","MENDOZA",315,298,1,1,0,2,0.946031746031746
"500980814","MENDOZA",215,206,6,3,0,9,0.958139534883721
"500071101","MENDOZA",210,208,2,0,0,2,0.990476190476191
"500281502","MENDOZA",498,23,231,228,12,471,0.0461847389558233
"500281413","MENDOZA",288,287,0,1,0,1,0.996527777777778
"500281216","MENDOZA",302,293,8,1,0,9,0.970198675496689
"500210309","MENDOZA",324,309,11,4,0,15,0.953703703703704
"500210301","MENDOZA",313,312,0,0,0,0,0.996805111821086
"500210202","MENDOZA",240,235,1,2,0,3,0.979166666666667
"500210109","MENDOZA",284,284,0,0,0,0,1
"500210104","MENDOZA",314,313,1,0,0,1,0.996815286624204
"500211203","MENDOZA",167,157,9,1,0,10,0.940119760479042
"500700421","MENDOZA",356,16,133,200,2,335,0.0449438202247191
"500210101","MENDOZA",208,208,0,0,0,0,1
"500140613","MENDOZA",281,2,142,132,1,275,0.00711743772241993
"500071017","MENDOZA",311,310,1,0,0,1,0.996784565916399
"500211310","MENDOZA",264,263,0,0,0,0,0.996212121212121
"501050509","MENDOZA",283,130,108,44,0,152,0.459363957597173
"500211208","MENDOZA",233,202,2,22,0,24,0.866952789699571
"500211205","MENDOZA",330,324,4,2,0,6,0.981818181818182
"500211111","MENDOZA",180,180,0,0,0,0,1
"500070608","MENDOZA",349,348,1,0,0,1,0.997134670487106
"500211110","MENDOZA",232,230,2,0,0,2,0.991379310344828
"500211006","MENDOZA",357,351,4,2,0,6,0.983193277310924
"500210915","MENDOZA",332,330,2,0,0,2,0.993975903614458
"500210907","MENDOZA",250,242,3,2,0,5,0.968
"500210905","MENDOZA",315,309,0,2,0,2,0.980952380952381
"500210911","MENDOZA",320,317,2,1,0,3,0.990625
"500070708","MENDOZA",173,171,1,1,0,2,0.988439306358382
"500070706","MENDOZA",305,305,0,0,0,0,1
"500070705","MENDOZA",248,244,3,0,0,3,0.983870967741935
"500070702","MENDOZA",346,344,2,0,0,2,0.994219653179191
"500070104","MENDOZA",245,245,0,0,0,0,1
"500070209","MENDOZA",304,303,0,0,0,0,0.996710526315789
"500070208","MENDOZA",209,208,0,0,0,0,0.995215311004785
"501050420","MENDOZA",197,11,71,115,0,186,0.0558375634517767
"500700413","MENDOZA",432,231,142,49,0,191,0.534722222222222
"500630112","MENDOZA",133,69,17,47,0,64,0.518796992481203
"501190402","MENDOZA",165,1,101,44,8,153,0.00606060606060606
"500281415","MENDOZA",218,215,3,0,0,3,0.986238532110092
"500770124","MENDOZA",281,2,118,134,0,252,0.00711743772241993
"500280809","MENDOZA",305,283,7,15,0,22,0.927868852459016
"500280414","MENDOZA",312,303,1,3,0,4,0.971153846153846
"500140712","MENDOZA",276,268,6,2,0,8,0.971014492753623
"500491010","MENDOZA",284,282,2,0,0,2,0.992957746478873
"500490918","MENDOZA",218,217,1,0,0,1,0.995412844036697
"500631111","MENDOZA",163,25,91,47,0,138,0.153374233128834
"501120303","MENDOZA",117,0,52,53,2,107,0
"501051601","MENDOZA",388,8,181,173,5,359,0.0206185567010309
"500490213","MENDOZA",382,340,25,16,0,41,0.890052356020942
"500070111","MENDOZA",152,152,0,0,0,0,1
"501050105","MENDOZA",255,2,72,155,9,236,0.00784313725490196
"500910205","MENDOZA",245,1,124,109,3,236,0.00408163265306122
"500910113","MENDOZA",231,2,91,122,3,216,0.00865800865800866
"500770203","MENDOZA",19,0,4,6,7,17,0
"500980203","MENDOZA",65,0,39,20,1,60,0
"500700608","MENDOZA",459,432,7,6,0,13,0.941176470588235
"500630601","MENDOZA",30,14,1,11,1,13,0.466666666666667
"500630217","MENDOZA",36,0,19,15,1,35,0
"500490501","MENDOZA",7,0,2,4,0,6,0
"500490101","MENDOZA",4,0,0,4,0,4,0
"500840407","MENDOZA",239,1,209,22,0,231,0.00418410041841004
"500420301","MENDOZA",48,0,24,7,0,31,0
"500140504","MENDOZA",259,2,144,85,6,235,0.00772200772200772
"500140412","MENDOZA",151,23,53,51,9,113,0.152317880794702
"500700103","MENDOZA",422,14,264,140,0,404,0.033175355450237
"501051712","MENDOZA",357,243,75,39,0,114,0.680672268907563
"500700405","MENDOZA",404,32,206,154,2,362,0.0792079207920792
"500140305","MENDOZA",66,0,19,25,4,48,0
"500140405","MENDOZA",329,2,156,126,19,301,0.0060790273556231
"500490601","MENDOZA",0,0,0,0,0,0,NA
"501051005","MENDOZA",47,0,0,15,5,20,0
"500980104","MENDOZA",389,0,180,94,40,314,0
"500910302","MENDOZA",348,1,153,158,12,323,0.0028735632183908
"500840706","MENDOZA",173,3,114,37,5,156,0.0173410404624277
"500840302","MENDOZA",423,8,257,124,9,390,0.0189125295508274
"500700419","MENDOZA",362,2,147,198,3,348,0.00552486187845304
"500700214","MENDOZA",247,3,205,35,0,240,0.0121457489878543
"500700207","MENDOZA",522,147,214,122,4,340,0.281609195402299
"500700105","MENDOZA",478,7,234,192,7,433,0.0146443514644351
"500700706","MENDOZA",413,1,267,135,2,404,0.00242130750605327
"500630502","MENDOZA",261,4,116,118,5,239,0.0153256704980843
"500630501","MENDOZA",300,31,113,133,7,253,0.103333333333333
"500630411","MENDOZA",535,31,332,158,3,493,0.0579439252336449
"500630402","MENDOZA",389,11,139,190,27,356,0.0282776349614396
"500560604","MENDOZA",397,11,275,82,5,362,0.0277078085642317
"500560501","MENDOZA",293,7,137,94,11,242,0.0238907849829352
"500700613","MENDOZA",254,254,0,0,0,0,1
"500420101","MENDOZA",178,4,108,59,1,168,0.0224719101123595
"500350504","MENDOZA",390,4,280,95,0,375,0.0102564102564103
"500280509","MENDOZA",345,21,212,98,5,315,0.0608695652173913
"500140615","MENDOZA",458,7,216,165,20,401,0.0152838427947598
"500140505","MENDOZA",225,2,146,60,12,218,0.00888888888888889
"501260501","MENDOZA",758,13,319,360,8,687,0.0171503957783641
"501190613","MENDOZA",579,455,33,59,5,97,0.785837651122625
"501190406","MENDOZA",278,2,163,90,6,259,0.00719424460431655
"501190405","MENDOZA",146,88,11,38,1,50,0.602739726027397
"501190404","MENDOZA",123,41,11,37,8,56,0.333333333333333
"501120201","MENDOZA",312,0,220,67,15,302,0
"501051208","MENDOZA",252,1,103,105,7,215,0.00396825396825397
"501051008","MENDOZA",386,0,100,246,7,353,0
"501050602","MENDOZA",298,34,117,132,2,251,0.114093959731544
"501051702","MENDOZA",260,3,132,120,1,253,0.0115384615384615
"501050508","MENDOZA",198,108,43,45,0,88,0.545454545454545
"501050202","MENDOZA",399,4,120,238,4,362,0.0100250626566416
"500770201","MENDOZA",183,0,28,91,12,131,0
"501050607","MENDOZA",297,0,204,89,0,293,0
"500631009","MENDOZA",176,35,46,91,0,137,0.198863636363636
"500631002","MENDOZA",169,6,113,47,0,160,0.0355029585798817
"500630218","MENDOZA",275,102,34,111,6,151,0.370909090909091
"500490307","MENDOZA",17,12,4,1,0,5,0.705882352941177
"500070407","MENDOZA",177,177,0,0,0,0,1
"501051906","MENDOZA",432,5,64,325,11,400,0.0115740740740741
"501051904","MENDOZA",241,162,28,47,0,75,0.672199170124481
"501051714","MENDOZA",175,121,35,17,0,52,0.691428571428571
"501051504","MENDOZA",204,89,51,64,0,115,0.436274509803922
"501051412","MENDOZA",262,213,31,18,0,49,0.812977099236641
"501051401","MENDOZA",312,278,27,7,0,34,0.891025641025641
"501051817","MENDOZA",184,175,6,2,0,8,0.951086956521739
"500701003","MENDOZA",253,249,2,1,0,3,0.984189723320158
"500701002","MENDOZA",259,259,0,0,0,0,1
"500701001","MENDOZA",303,162,40,91,1,132,0.534653465346535
"500700908","MENDOZA",397,380,4,10,1,15,0.957178841309824
"500700905","MENDOZA",223,216,5,1,0,6,0.968609865470852
"500700903","MENDOZA",663,399,79,168,0,247,0.601809954751131
"500700815","MENDOZA",236,174,28,33,0,61,0.73728813559322
"500210305","MENDOZA",179,173,5,1,0,6,0.966480446927374
"500631114","MENDOZA",316,311,4,0,0,4,0.984177215189873
"500631102","MENDOZA",161,155,2,0,0,2,0.962732919254658
"501050513","MENDOZA",326,265,57,4,0,61,0.812883435582822
"501050421","MENDOZA",522,223,145,151,2,298,0.4272030651341
"501050405","MENDOZA",363,133,101,126,0,227,0.366391184573003
"501050404","MENDOZA",162,61,88,12,0,100,0.376543209876543
"501050309","MENDOZA",298,0,167,124,0,291,0
"501050501","MENDOZA",193,185,3,3,0,6,0.958549222797927
"501050204","MENDOZA",408,10,309,89,0,398,0.0245098039215686
"500980909","MENDOZA",399,264,96,30,1,127,0.661654135338346
"500631015","MENDOZA",194,7,143,43,0,186,0.0360824742268041
"500630914","MENDOZA",399,398,0,0,0,0,0.99749373433584
"500490915","MENDOZA",287,278,5,2,0,7,0.968641114982578
"501050518","MENDOZA",157,107,33,17,0,50,0.681528662420382
"500980506","MENDOZA",358,218,99,24,1,124,0.608938547486033
"500980411","MENDOZA",292,289,2,1,0,3,0.98972602739726
"500980404","MENDOZA",361,361,0,0,0,0,1
"500840812","MENDOZA",372,351,20,0,0,20,0.943548387096774
"500840811","MENDOZA",299,281,17,1,0,18,0.939799331103679
"500840809","MENDOZA",352,27,259,57,0,316,0.0767045454545455
"500840804","MENDOZA",236,89,105,37,0,142,0.377118644067797
"500840803","MENDOZA",361,10,277,63,4,344,0.0277008310249307
"500840204","MENDOZA",505,322,163,17,0,180,0.637623762376238
"500770127","MENDOZA",285,2,108,169,1,278,0.00701754385964912
"500980607","MENDOZA",235,7,162,47,6,215,0.0297872340425532
"500490810","MENDOZA",304,296,5,0,0,5,0.973684210526316
"500490803","MENDOZA",220,218,0,0,0,0,0.990909090909091
"500490801","MENDOZA",284,279,1,2,0,3,0.982394366197183
"500490407","MENDOZA",290,284,4,0,0,4,0.979310344827586
"500490406","MENDOZA",225,224,0,0,0,0,0.995555555555556
"500420411","MENDOZA",219,90,113,16,0,129,0.410958904109589
"500281107","MENDOZA",328,297,18,10,1,29,0.905487804878049
"500281104","MENDOZA",417,370,27,13,0,40,0.887290167865707
"500281003","MENDOZA",210,199,7,2,1,10,0.947619047619048
"500281001","MENDOZA",314,307,2,4,0,6,0.977707006369427
"500630903","MENDOZA",193,60,82,46,4,132,0.310880829015544
"500630901","MENDOZA",284,229,28,20,0,48,0.806338028169014
"500630304","MENDOZA",152,1,74,76,0,150,0.00657894736842105
"500630206","MENDOZA",161,155,2,3,0,5,0.962732919254658
"500560603","MENDOZA",361,288,36,21,2,59,0.797783933518006
"500560405","MENDOZA",191,156,26,6,1,33,0.816753926701571
"500491408","MENDOZA",316,315,0,1,0,1,0.996835443037975
"500491407","MENDOZA",313,313,0,0,0,0,1
"500491406","MENDOZA",372,372,0,0,0,0,1
"500491308","MENDOZA",365,351,5,1,0,6,0.961643835616438
"500491306","MENDOZA",196,193,2,0,0,2,0.98469387755102
"500491301","MENDOZA",284,269,8,3,2,13,0.947183098591549
"500491202","MENDOZA",261,223,16,21,0,37,0.854406130268199
"500491114","MENDOZA",241,228,2,2,0,4,0.946058091286307
"500491113","MENDOZA",110,105,4,0,0,4,0.954545454545455
"500280611","MENDOZA",255,199,34,19,0,53,0.780392156862745
"500280602","MENDOZA",195,188,4,3,0,7,0.964102564102564
"500280519","MENDOZA",284,2,166,111,2,279,0.00704225352112676
"500280415","MENDOZA",326,311,9,2,0,11,0.95398773006135
"500280310","MENDOZA",468,427,20,21,0,41,0.912393162393162
"500280209","MENDOZA",292,282,4,5,0,9,0.965753424657534
"500280206","MENDOZA",342,341,0,0,0,0,0.997076023391813
"500280112","MENDOZA",175,167,7,1,0,8,0.954285714285714
"500280111","MENDOZA",345,333,7,5,0,12,0.965217391304348
"500211603","MENDOZA",234,225,8,0,0,8,0.961538461538462
"500211601","MENDOZA",425,421,2,2,0,4,0.990588235294118
"500211508","MENDOZA",173,173,0,0,0,0,1
"500211504","MENDOZA",188,182,6,0,0,6,0.968085106382979
"500211605","MENDOZA",289,278,4,5,0,9,0.961937716262976
"500210802","MENDOZA",233,196,9,21,3,33,0.841201716738197
"500210613","MENDOZA",365,363,2,0,0,2,0.994520547945206
"500210601","MENDOZA",374,351,8,10,2,20,0.938502673796791
"500210508","MENDOZA",413,413,0,0,0,0,1
"500630812","MENDOZA",335,268,36,31,0,67,0.8
"500630705","MENDOZA",40,1,14,24,0,38,0.025
"500350206","MENDOZA",187,152,17,3,0,20,0.812834224598931
"500350104","MENDOZA",221,1,201,19,0,220,0.00452488687782805
"500282010","MENDOZA",213,201,7,5,0,12,0.943661971830986
"500282009","MENDOZA",338,333,2,3,0,5,0.985207100591716
"500281904","MENDOZA",298,174,11,103,1,115,0.583892617449664
"500281602","MENDOZA",205,199,4,2,0,6,0.970731707317073
"140560106","CORDOBA",366,22,304,36,1,341,0.0601092896174863
"501051903","MENDOZA",179,104,43,31,1,75,0.581005586592179
"500281810","MENDOZA",286,246,21,18,0,39,0.86013986013986
"500281707","MENDOZA",405,33,236,133,0,369,0.0814814814814815
"740351009","SAN LUIS",257,257,0,0,0,0,1
"500281610","MENDOZA",297,288,5,3,0,8,0.96969696969697
"500281404","MENDOZA",308,308,0,0,0,0,1
"500281312","MENDOZA",199,195,1,3,0,4,0.979899497487437
"500281311","MENDOZA",223,217,4,2,0,6,0.973094170403587
"500281310","MENDOZA",286,280,5,1,0,6,0.979020979020979
"500281305","MENDOZA",301,275,15,9,1,25,0.913621262458472
"500281304","MENDOZA",318,297,10,10,0,20,0.933962264150943
"500281219","MENDOZA",377,356,9,10,0,19,0.944297082228117
"500281212","MENDOZA",233,52,150,25,0,175,0.223175965665236
"500210413","MENDOZA",239,237,1,1,0,2,0.99163179916318
"500210410","MENDOZA",211,207,3,1,0,4,0.981042654028436
"500210405","MENDOZA",186,182,3,1,0,4,0.978494623655914
"500210214","MENDOZA",215,204,6,4,0,10,0.948837209302326
"500210306","MENDOZA",252,249,1,2,0,3,0.988095238095238
"500210209","MENDOZA",295,295,0,0,0,0,1
"500210203","MENDOZA",217,213,0,0,0,0,0.981566820276498
"500210117","MENDOZA",152,152,0,0,0,0,1
"500210116","MENDOZA",306,290,11,3,0,14,0.947712418300654
"500210107","MENDOZA",656,467,34,125,8,167,0.711890243902439
"500211108","MENDOZA",203,202,1,0,0,1,0.995073891625616
"500281206","MENDOZA",278,275,2,1,0,3,0.989208633093525
"500210106","MENDOZA",281,135,18,99,5,122,0.480427046263345
"500140611","MENDOZA",373,317,36,19,0,55,0.849865951742627
"500140609","MENDOZA",312,197,75,37,0,112,0.631410256410256
"500140602","MENDOZA",241,39,97,96,0,193,0.161825726141079
"500140409","MENDOZA",338,223,66,41,4,111,0.659763313609467
"501050506","MENDOZA",285,146,89,48,0,137,0.512280701754386
"500071207","MENDOZA",135,132,0,0,0,0,0.977777777777778
"500071201","MENDOZA",152,152,0,0,0,0,1
"500071113","MENDOZA",179,178,0,0,0,0,0.994413407821229
"500071107","MENDOZA",257,253,4,0,0,4,0.98443579766537
"500211305","MENDOZA",331,328,3,0,0,3,0.990936555891239
"500211109","MENDOZA",256,253,3,0,0,3,0.98828125
"500211103","MENDOZA",155,153,0,2,0,2,0.987096774193548
"500211004","MENDOZA",308,305,1,0,0,1,0.99025974025974
"500211001","MENDOZA",260,257,1,0,0,1,0.988461538461539
"500210806","MENDOZA",327,326,1,0,0,1,0.996941896024465
"501051309","MENDOZA",277,260,14,3,0,17,0.938628158844765
"500070906","MENDOZA",269,269,0,0,0,0,1
"500070902","MENDOZA",190,190,0,0,0,0,1
"500070807","MENDOZA",212,211,1,0,0,1,0.995283018867924
"500070711","MENDOZA",354,351,3,0,0,3,0.991525423728814
"500070506","MENDOZA",299,297,2,0,0,2,0.993311036789298
"500070202","MENDOZA",250,250,0,0,0,0,1
"500070115","MENDOZA",192,192,0,0,0,0,1
"500070206","MENDOZA",354,351,0,2,0,2,0.991525423728814
"500070205","MENDOZA",239,234,0,2,0,2,0.97907949790795
"500070408","MENDOZA",167,167,0,0,0,0,1
"501190310","MENDOZA",334,298,8,8,0,16,0.892215568862275
"501051912","MENDOZA",302,3,190,90,1,281,0.00993377483443709
"501051608","MENDOZA",66,0,11,48,6,65,0
"501050907","MENDOZA",275,2,119,144,4,267,0.00727272727272727
"501050515","MENDOZA",270,238,25,5,0,30,0.881481481481482
"500700604","MENDOZA",212,203,4,5,0,9,0.957547169811321
"500631103","MENDOZA",401,389,6,2,0,8,0.970074812967581
"500631007","MENDOZA",206,197,3,5,0,8,0.956310679611651
"740420202","SAN LUIS",106,1,54,47,0,101,0.00943396226415094
"500630214","MENDOZA",260,258,2,0,0,2,0.992307692307692
"500770111","MENDOZA",46,0,19,27,0,46,0
"500630105","MENDOZA",187,39,121,27,0,148,0.20855614973262
"500350213","MENDOZA",260,250,9,1,0,10,0.961538461538462
"500770122","MENDOZA",355,0,120,201,3,324,0
"500701004","MENDOZA",306,280,6,20,0,26,0.915032679738562
"500211105","MENDOZA",147,147,0,0,0,0,1
"500210406","MENDOZA",230,229,0,0,0,0,0.995652173913044
"500140411","MENDOZA",188,0,87,56,13,156,0
"500281715","MENDOZA",244,4,81,89,36,206,0.0163934426229508
"501260318","MENDOZA",77,1,24,48,0,72,0.012987012987013
"500491101","MENDOZA",7,0,0,7,0,7,0
"500490502","MENDOZA",147,2,42,97,2,141,0.0136054421768707
"501051012","MENDOZA",255,110,14,113,7,134,0.431372549019608
"501050301","MENDOZA",22,0,4,15,0,19,0
"501050103","MENDOZA",282,3,94,157,8,259,0.0106382978723404
"500980302","MENDOZA",161,2,87,55,6,148,0.0124223602484472
"500980103","MENDOZA",261,5,116,70,22,208,0.0191570881226054
"501050806","MENDOZA",83,0,7,31,12,50,0
"501050804","MENDOZA",21,0,6,7,1,14,0
"501050603","MENDOZA",50,0,18,21,5,44,0
"500350102","MENDOZA",230,1,141,73,5,219,0.00434782608695652
"500280507","MENDOZA",543,11,290,194,8,492,0.0202578268876611
"500140201","MENDOZA",59,0,13,31,6,50,0
"500770402","MENDOZA",220,10,23,83,26,132,0.0454545454545455
"500770302","MENDOZA",39,0,0,20,1,21,0
"500560614","MENDOZA",73,2,30,30,1,61,0.0273972602739726
"501050601","MENDOZA",45,0,7,31,3,41,0
"501190303","MENDOZA",428,370,29,12,1,42,0.864485981308411
"501260101","MENDOZA",107,2,34,54,11,99,0.0186915887850467
"500770401","MENDOZA",14,0,0,8,1,9,0
"500700206","MENDOZA",273,1,126,95,18,239,0.00366300366300366
"500700205","MENDOZA",293,1,122,127,31,280,0.00341296928327645
"500700115","MENDOZA",153,0,70,66,10,146,0
"500630401","MENDOZA",249,0,65,131,31,227,0
"141821102","CORDOBA",242,233,6,3,0,9,0.962809917355372
"500490313","MENDOZA",472,17,138,218,30,386,0.0360169491525424
"500350402","MENDOZA",135,0,77,46,5,128,0
"501120204","MENDOZA",383,0,324,46,3,373,0
"501190101","MENDOZA",2,0,2,0,0,2,0
"501120301","MENDOZA",94,0,46,36,3,85,0
"501050903","MENDOZA",229,3,42,82,64,188,0.0131004366812227
"501051805","MENDOZA",333,227,79,27,0,106,0.681681681681682
"141820614","CORDOBA",144,136,7,0,0,7,0.944444444444444
"501050802","MENDOZA",155,0,59,69,7,135,0
"501050801","MENDOZA",243,0,68,95,38,201,0
"501120102","MENDOZA",554,0,446,93,2,541,0
"500350502","MENDOZA",144,1,57,62,8,127,0.00694444444444444
"500840305","MENDOZA",308,4,153,123,4,280,0.012987012987013
"500840103","MENDOZA",267,0,158,61,22,241,0
"500840101","MENDOZA",347,7,303,30,3,336,0.0201729106628242
"500350203","MENDOZA",477,250,136,84,1,221,0.524109014675052
"500630301","MENDOZA",17,0,3,9,3,15,0
"500280511","MENDOZA",435,8,259,151,4,414,0.0183908045977011
"500140715","MENDOZA",301,11,217,69,0,286,0.0365448504983389
"500140502","MENDOZA",236,3,96,88,20,204,0.0127118644067797
"501190401","MENDOZA",418,15,292,94,1,387,0.0358851674641148
"501190311","MENDOZA",269,137,93,32,3,128,0.509293680297398
"500980605","MENDOZA",304,6,172,98,6,276,0.0197368421052632
"500770120","MENDOZA",267,1,77,171,0,248,0.00374531835205993
"500700417","MENDOZA",382,8,179,179,1,359,0.0209424083769634
"500630310","MENDOZA",682,134,244,269,0,513,0.196480938416422
"500560615","MENDOZA",293,1,173,79,4,256,0.00341296928327645
"500560701","MENDOZA",175,2,90,35,15,140,0.0114285714285714
"500350214","MENDOZA",344,104,150,76,2,228,0.302325581395349
"500071309","MENDOZA",333,193,69,60,2,131,0.57957957957958
"501051515","MENDOZA",171,84,38,41,0,79,0.491228070175439
"501051914","MENDOZA",306,3,161,101,2,264,0.00980392156862745
"501051908","MENDOZA",364,215,88,59,0,147,0.590659340659341
"501051816","MENDOZA",246,218,25,3,0,28,0.886178861788618
"501051814","MENDOZA",168,110,22,36,0,58,0.654761904761905
"501051808","MENDOZA",200,142,38,17,0,55,0.71
"501051707","MENDOZA",148,141,5,2,0,7,0.952702702702703
"501051518","MENDOZA",382,3,127,229,5,361,0.00785340314136126
"501051301","MENDOZA",182,154,9,19,0,28,0.846153846153846
"500700902","MENDOZA",345,304,12,24,0,36,0.881159420289855
"500700810","MENDOZA",360,339,10,9,0,19,0.941666666666667
"500700807","MENDOZA",211,204,6,1,0,7,0.966824644549763
"500700707","MENDOZA",273,267,4,1,0,5,0.978021978021978
"500700705","MENDOZA",312,206,25,73,0,98,0.66025641025641
"501260319","MENDOZA",306,268,14,17,0,31,0.875816993464052
"500700601","MENDOZA",451,425,11,10,0,21,0.942350332594235
"500700513","MENDOZA",320,268,32,18,1,51,0.8375
"500700410","MENDOZA",112,5,31,70,1,102,0.0446428571428571
"140211904","CORDOBA",162,7,150,4,1,155,0.0432098765432099
"500700408","MENDOZA",526,19,325,154,0,479,0.0361216730038023
"500700402","MENDOZA",337,257,59,20,0,79,0.762611275964392
"500700107","MENDOZA",148,8,134,4,0,138,0.0540540540540541
"500631106","MENDOZA",174,165,4,3,0,7,0.948275862068966
"500630913","MENDOZA",256,252,3,0,0,3,0.984375
"500630905","MENDOZA",358,294,27,27,0,54,0.82122905027933
"500700802","MENDOZA",274,271,1,1,0,2,0.989051094890511
"141820613","CORDOBA",228,134,92,2,0,94,0.587719298245614
"500491013","MENDOZA",231,228,1,2,0,3,0.987012987012987
"501050413","MENDOZA",301,190,81,27,0,108,0.631229235880399
"501050407","MENDOZA",425,37,38,326,1,365,0.0870588235294118
"501050403","MENDOZA",241,3,168,70,0,238,0.012448132780083
"501050111","MENDOZA",294,31,107,152,1,260,0.105442176870748
"500980906","MENDOZA",308,227,65,9,0,74,0.737012987012987
"500980903","MENDOZA",378,306,39,29,1,69,0.80952380952381
"500980809","MENDOZA",290,274,9,6,0,15,0.944827586206897
"500980714","MENDOZA",270,256,9,4,0,13,0.948148148148148
"500980409","MENDOZA",352,343,3,5,0,8,0.974431818181818
"500491003","MENDOZA",209,98,48,62,0,110,0.4688995215311
"501050705","MENDOZA",310,68,141,89,6,236,0.219354838709677
"501050520","MENDOZA",201,65,51,77,1,129,0.323383084577114
"501050416","MENDOZA",251,61,112,77,0,189,0.243027888446215
"501050408","MENDOZA",342,35,136,154,1,291,0.10233918128655
"140144615","CORDOBA",320,264,32,20,0,52,0.825
"500980706","MENDOZA",295,292,2,0,0,2,0.989830508474576
"500980511","MENDOZA",206,156,32,16,0,48,0.757281553398058
"500980505","MENDOZA",336,2,227,89,3,319,0.00595238095238095
"500980405","MENDOZA",314,311,1,1,0,2,0.990445859872611
"500910111","MENDOZA",370,244,120,3,0,123,0.659459459459459
"500910107","MENDOZA",254,24,181,46,1,228,0.094488188976378
"500840808","MENDOZA",430,387,37,5,0,42,0.9
"500910109","MENDOZA",302,50,174,77,1,252,0.165562913907285
"500770119","MENDOZA",315,3,108,190,0,298,0.00952380952380952
"500770117","MENDOZA",321,2,197,122,0,319,0.00623052959501558
"500770112","MENDOZA",297,4,190,101,0,291,0.0134680134680135
"500701008","MENDOZA",207,197,2,5,0,7,0.951690821256039
"500490816","MENDOZA",189,182,0,4,1,5,0.962962962962963
"500280303","MENDOZA",226,205,3,4,0,7,0.907079646017699
"500490814","MENDOZA",340,340,0,0,0,0,1
"500490808","MENDOZA",414,408,1,1,0,2,0.985507246376812
"500490715","MENDOZA",272,267,3,0,0,3,0.981617647058823
"500490403","MENDOZA",337,334,2,0,0,2,0.991097922848665
"500490305","MENDOZA",329,303,11,13,0,24,0.9209726443769
"500490210","MENDOZA",337,303,5,24,0,29,0.899109792284866
"500280313","MENDOZA",437,399,14,23,0,37,0.91304347826087
"500490205","MENDOZA",310,295,3,7,0,10,0.951612903225806
"500490319","MENDOZA",269,193,11,46,0,57,0.717472118959108
"501051502","MENDOZA",184,98,44,41,0,85,0.532608695652174
"500420409","MENDOZA",202,71,126,1,0,127,0.351485148514851
"500280910","MENDOZA",342,331,6,3,0,9,0.967836257309941
"500630205","MENDOZA",237,232,1,1,0,2,0.978902953586498
"500280210","MENDOZA",207,203,2,2,0,4,0.980676328502415
"500420408","MENDOZA",288,140,129,19,0,148,0.486111111111111
"141611001","CORDOBA",241,239,1,1,0,2,0.991701244813278
"500281118","MENDOZA",237,219,4,11,0,15,0.924050632911392
"500281111","MENDOZA",212,195,12,5,0,17,0.919811320754717
"500281106","MENDOZA",273,257,7,4,0,11,0.941391941391941
"500281102","MENDOZA",262,251,4,5,0,9,0.958015267175573
"500281010","MENDOZA",340,332,5,1,0,6,0.976470588235294
"500281005","MENDOZA",207,188,15,2,0,17,0.908212560386473
"500281004","MENDOZA",335,318,7,8,0,15,0.949253731343284
"500280914","MENDOZA",175,174,0,0,0,0,0.994285714285714
"500630104","MENDOZA",320,209,83,25,0,108,0.653125
"500560616","MENDOZA",184,6,138,33,1,172,0.0326086956521739
"500491401","MENDOZA",272,266,1,0,0,1,0.977941176470588
"500630203","MENDOZA",300,292,2,5,0,7,0.973333333333333
"500630108","MENDOZA",182,40,123,19,0,142,0.21978021978022
"500281209","MENDOZA",288,253,8,26,0,34,0.878472222222222
"500280812","MENDOZA",308,304,2,1,0,3,0.987012987012987
"500280805","MENDOZA",305,291,7,5,0,12,0.954098360655738
"500280804","MENDOZA",205,194,7,4,0,11,0.946341463414634
"500280803","MENDOZA",200,188,9,3,0,12,0.94
"500280709","MENDOZA",325,318,6,0,0,6,0.978461538461538
"500280104","MENDOZA",177,176,0,0,0,0,0.994350282485876
"500280606","MENDOZA",470,463,3,2,0,5,0.985106382978723
"500210709","MENDOZA",283,264,8,2,0,10,0.932862190812721
"500210707","MENDOZA",231,227,1,2,0,3,0.982683982683983
"500280409","MENDOZA",362,360,0,1,1,2,0.994475138121547
"500280404","MENDOZA",244,183,25,29,0,54,0.75
"500280315","MENDOZA",492,374,29,72,8,109,0.760162601626016
"500210801","MENDOZA",273,256,4,4,0,8,0.937728937728938
"500210610","MENDOZA",221,205,12,4,0,16,0.927601809954751
"500210609","MENDOZA",195,186,7,2,0,9,0.953846153846154
"500210608","MENDOZA",400,386,8,6,0,14,0.965
"500210607","MENDOZA",318,315,3,0,0,3,0.990566037735849
"500210603","MENDOZA",275,262,6,1,0,7,0.952727272727273
"500210503","MENDOZA",260,216,19,23,0,42,0.830769230769231
"500630806","MENDOZA",137,136,0,0,0,0,0.992700729927007
"500350216","MENDOZA",453,267,130,33,3,166,0.589403973509934
"500350211","MENDOZA",248,239,5,3,0,8,0.963709677419355
"500281811","MENDOZA",259,38,85,130,1,216,0.146718146718147
"500281805","MENDOZA",387,328,30,21,0,51,0.847545219638243
"500281706","MENDOZA",376,321,26,20,0,46,0.853723404255319
"500281608","MENDOZA",346,313,8,6,0,14,0.904624277456647
"500281309","MENDOZA",204,200,2,1,0,3,0.980392156862745
"500281214","MENDOZA",250,225,11,13,0,24,0.9
"500281208","MENDOZA",180,144,18,17,0,35,0.8
"500210909","MENDOZA",267,257,6,3,0,9,0.962546816479401
"500210411","MENDOZA",359,352,5,1,1,7,0.98050139275766
"500210403","MENDOZA",297,291,3,2,0,5,0.97979797979798
"500210316","MENDOZA",182,174,7,1,0,8,0.956043956043956
"500210219","MENDOZA",119,112,6,0,0,6,0.941176470588235
"500210218","MENDOZA",66,52,6,8,0,14,0.787878787878788
"500210210","MENDOZA",218,214,1,0,0,1,0.981651376146789
"500210207","MENDOZA",318,308,3,7,0,10,0.968553459119497
"500210114","MENDOZA",242,239,1,2,0,3,0.987603305785124
"500210113","MENDOZA",300,297,0,2,0,2,0.99
"500210110","MENDOZA",244,244,0,0,0,0,1
"500210105","MENDOZA",271,264,5,2,0,7,0.974169741697417
"500140716","MENDOZA",364,348,6,9,0,15,0.956043956043956
"500140714","MENDOZA",268,32,179,50,2,231,0.119402985074627
"500140616","MENDOZA",351,93,175,81,1,257,0.264957264957265
"500140608","MENDOZA",199,191,5,2,0,7,0.959798994974874
"500140304","MENDOZA",278,6,165,67,24,256,0.0215827338129496
"500140408","MENDOZA",379,255,50,42,11,103,0.672823218997362
"500071105","MENDOZA",310,308,2,0,0,2,0.993548387096774
"500071018","MENDOZA",0,0,0,0,0,0,NA
"500211309","MENDOZA",314,314,0,0,0,0,1
"500211211","MENDOZA",279,257,13,9,0,22,0.921146953405018
"500211106","MENDOZA",262,262,0,0,0,0,1
"500211007","MENDOZA",393,378,3,2,0,5,0.961832061068702
"500070201","MENDOZA",365,364,1,0,0,1,0.997260273972603
"500070107","MENDOZA",212,212,0,0,0,0,1
"500071303","MENDOZA",285,277,2,4,0,6,0.971929824561404
"500071302","MENDOZA",297,245,11,28,0,39,0.824915824915825
"500071209","MENDOZA",244,243,1,0,0,1,0.995901639344262
"500071208","MENDOZA",192,192,0,0,0,0,1
"500071205","MENDOZA",138,137,1,0,0,1,0.992753623188406
"500071111","MENDOZA",186,185,1,0,0,1,0.994623655913978
"500210903","MENDOZA",223,221,2,0,0,2,0.991031390134529
"500210913","MENDOZA",246,244,1,1,0,2,0.991869918699187
"500980811","MENDOZA",435,435,0,0,0,0,1
"500070801","MENDOZA",164,162,0,2,0,2,0.98780487804878
"500070704","MENDOZA",233,232,1,0,0,1,0.995708154506438
"500070701","MENDOZA",212,204,6,2,0,8,0.962264150943396
"500070605","MENDOZA",189,188,1,0,0,1,0.994708994708995
"500070601","MENDOZA",212,209,3,0,0,3,0.985849056603774
"500070512","MENDOZA",123,123,0,0,0,0,1
"500070313","MENDOZA",166,165,1,0,0,1,0.993975903614458
"500070301","MENDOZA",258,255,0,1,0,1,0.988372093023256
"500070102","MENDOZA",273,250,1,21,0,22,0.915750915750916
"500070207","MENDOZA",233,233,0,0,0,0,1
"500070405","MENDOZA",124,113,0,0,0,0,0.911290322580645
"501050906","MENDOZA",318,13,204,96,2,302,0.0408805031446541
"501050605","MENDOZA",194,5,116,69,1,186,0.0257731958762887
"501050308","MENDOZA",199,1,119,72,0,191,0.0050251256281407
"500980413","MENDOZA",216,214,1,0,0,1,0.990740740740741
"500700412","MENDOZA",382,231,114,25,0,139,0.604712041884817
"500631011","MENDOZA",330,314,6,9,0,15,0.951515151515152
"500491404","MENDOZA",145,145,0,0,0,0,1
"500491213","MENDOZA",234,229,0,5,0,5,0.978632478632479
"500840202","MENDOZA",295,44,212,31,1,244,0.149152542372881
"500281211","MENDOZA",234,144,17,67,0,84,0.615384615384615
"500490505","MENDOZA",468,360,42,58,0,100,0.769230769230769
"140149120","CORDOBA",234,23,204,7,0,211,0.0982905982905983
"501051207","MENDOZA",90,0,14,57,10,81,0
"500490311","MENDOZA",202,201,1,0,0,1,0.995049504950495
"500071202","MENDOZA",90,90,0,0,0,0,1
"500770202","MENDOZA",93,1,2,63,1,66,0.010752688172043
"501260502","MENDOZA",306,6,72,165,12,249,0.0196078431372549
"141610923","CORDOBA",225,210,11,4,0,15,0.933333333333333
"501051102","MENDOZA",273,1,76,171,8,255,0.00366300366300366
"501050902","MENDOZA",14,0,2,4,1,7,0
"500980601","MENDOZA",191,4,98,63,5,166,0.0209424083769634
"500980305","MENDOZA",285,3,177,70,5,252,0.0105263157894737
"501051605","MENDOZA",466,4,161,243,8,412,0.00858369098712446
"501051603","MENDOZA",395,4,100,249,12,361,0.010126582278481
"500980609","MENDOZA",253,0,143,65,21,229,0
"501260205","MENDOZA",4,0,0,3,0,3,0
"501051004","MENDOZA",105,0,6,77,10,93,0
"500700422","MENDOZA",304,8,108,174,6,288,0.0263157894736842
"500770301","MENDOZA",228,0,70,119,13,202,0
"140146604","CORDOBA",233,233,0,0,0,0,1
"500910601","MENDOZA",79,0,32,29,8,69,0
"500980101","MENDOZA",326,0,142,120,30,292,0
"500910401","MENDOZA",42,0,9,15,16,40,0
"500910102","MENDOZA",164,2,50,76,11,137,0.0121951219512195
"500910303","MENDOZA",249,0,69,110,29,208,0
"500840308","MENDOZA",249,3,163,75,0,238,0.0120481927710843
"500700602","MENDOZA",470,445,13,4,0,17,0.946808510638298
"500770102","MENDOZA",95,0,12,40,10,62,0
"500700113","MENDOZA",232,1,62,110,31,203,0.00431034482758621
"500700112","MENDOZA",294,2,158,107,16,281,0.00680272108843537
"500210813","MENDOZA",143,1,4,85,27,116,0.00699300699300699
"500700508","MENDOZA",283,280,0,1,0,1,0.989399293286219
"501190312","MENDOZA",198,9,100,64,9,173,0.0454545454545455
"500630701","MENDOZA",7,2,3,2,0,5,0.285714285714286
"500700201","MENDOZA",197,2,57,104,12,173,0.0101522842639594
"500630405","MENDOZA",293,14,127,146,1,274,0.0477815699658703
"501260102","MENDOZA",8,0,0,5,0,5,0
"501190205","MENDOZA",363,1,182,124,9,315,0.00275482093663912
"501190203","MENDOZA",52,0,20,30,0,50,0
"501190202","MENDOZA",137,0,75,54,0,129,0
"501120203","MENDOZA",114,0,96,13,0,109,0
"501051607","MENDOZA",185,0,22,91,32,145,0
"501190611","MENDOZA",212,209,1,0,0,1,0.985849056603774
"500840217","MENDOZA",104,12,45,31,2,78,0.115384615384615
"500700425","MENDOZA",259,6,152,95,0,247,0.0231660231660232
"500700411","MENDOZA",305,72,165,63,1,229,0.236065573770492
"500700308","MENDOZA",246,11,136,63,16,215,0.0447154471544715
"500700116","MENDOZA",560,6,239,209,50,498,0.0107142857142857
"500630409","MENDOZA",358,2,147,195,3,345,0.00558659217877095
"500630311","MENDOZA",287,15,156,106,0,262,0.0522648083623693
"500560406","MENDOZA",270,4,161,71,19,251,0.0148148148148148
"500420412","MENDOZA",126,0,108,10,2,120,0
"500280501","MENDOZA",163,116,25,9,1,35,0.711656441717791
"500280516","MENDOZA",487,7,245,203,9,457,0.0143737166324435
"501260314","MENDOZA",369,305,20,36,2,58,0.826558265582656
"501050305","MENDOZA",231,4,96,120,1,217,0.0173160173160173
"500490603","MENDOZA",52,45,4,1,0,5,0.865384615384615
"500490503","MENDOZA",445,128,77,204,10,291,0.287640449438202
"501190602","MENDOZA",102,66,16,19,0,35,0.647058823529412
"501190409","MENDOZA",453,40,217,148,11,376,0.0883002207505519
"501190403","MENDOZA",442,6,296,114,9,419,0.0135746606334842
"501120103","MENDOZA",209,0,129,62,6,197,0
"501050901","MENDOZA",142,0,30,74,25,129,0
"500980907","MENDOZA",528,134,155,148,46,349,0.253787878787879
"500980820","MENDOZA",252,3,162,74,3,239,0.0119047619047619
"501051011","MENDOZA",220,1,91,112,6,209,0.00454545454545455
"500560608","MENDOZA",247,3,157,75,2,234,0.0121457489878543
"500560401","MENDOZA",160,0,65,65,16,146,0
"500980810","MENDOZA",294,289,3,1,0,4,0.982993197278912
"501260307","MENDOZA",285,187,65,32,0,97,0.656140350877193
"141610922","CORDOBA",283,282,1,0,0,1,0.996466431095406
"501051902","MENDOZA",405,228,100,72,1,173,0.562962962962963
"501051809","MENDOZA",236,202,21,12,0,33,0.855932203389831
"501051410","MENDOZA",212,172,38,2,0,40,0.811320754716981
"501051408","MENDOZA",194,135,41,16,0,57,0.695876288659794
"501051407","MENDOZA",164,149,8,7,0,15,0.908536585365854
"501051403","MENDOZA",202,156,35,11,0,46,0.772277227722772
"501051304","MENDOZA",182,120,53,6,0,59,0.659340659340659
"500700910","MENDOZA",238,200,14,21,0,35,0.840336134453782
"500700909","MENDOZA",226,211,8,2,1,11,0.933628318584071
"501051106","MENDOZA",469,1,232,194,5,431,0.00213219616204691
"500700907","MENDOZA",288,271,10,7,0,17,0.940972222222222
"500700506","MENDOZA",326,302,14,10,0,24,0.926380368098159
"500700501","MENDOZA",519,512,3,0,0,3,0.986512524084778
"500700108","MENDOZA",205,1,196,7,0,203,0.0048780487804878
"500631108","MENDOZA",291,275,13,0,0,13,0.945017182130584
"500631104","MENDOZA",312,306,0,0,0,0,0.980769230769231
"500491011","MENDOZA",249,248,0,1,0,1,0.995983935742972
"501050708","MENDOZA",236,85,94,48,3,145,0.360169491525424
"501050417","MENDOZA",302,150,103,49,0,152,0.496688741721854
"501050304","MENDOZA",562,13,115,387,21,523,0.0231316725978648
"501050108","MENDOZA",358,350,8,0,0,8,0.977653631284916
"500980904","MENDOZA",368,304,44,17,0,61,0.826086956521739
"500980806","MENDOZA",455,388,54,7,0,61,0.852747252747253
"500980803","MENDOZA",414,197,128,68,5,201,0.475845410628019
"500980718","MENDOZA",255,249,5,1,0,6,0.976470588235294
"500980717","MENDOZA",203,200,2,0,0,2,0.985221674876847
"500980716","MENDOZA",347,347,0,0,0,0,1
"500980712","MENDOZA",227,226,1,0,0,1,0.995594713656388
"500980707","MENDOZA",288,282,0,0,0,0,0.979166666666667
"500980510","MENDOZA",208,200,7,0,0,7,0.961538461538462
"500980508","MENDOZA",410,9,338,44,3,385,0.0219512195121951
"500980412","MENDOZA",260,257,2,0,0,2,0.988461538461539
"500980410","MENDOZA",205,205,0,0,0,0,1
"141610921","CORDOBA",362,326,28,7,0,35,0.900552486187845
"500980407","MENDOZA",408,336,13,6,0,19,0.823529411764706
"500980308","MENDOZA",379,6,294,61,6,361,0.0158311345646438
"500910203","MENDOZA",386,210,112,51,0,163,0.544041450777202
"500840802","MENDOZA",326,252,55,8,2,65,0.773006134969325
"500840215","MENDOZA",290,279,0,0,0,0,0.962068965517241
"500840213","MENDOZA",352,307,40,5,0,45,0.872159090909091
"500840209","MENDOZA",183,173,6,0,1,7,0.945355191256831
"500840208","MENDOZA",227,209,14,4,0,18,0.920704845814978
"500770123","MENDOZA",347,5,249,92,0,341,0.0144092219020173
"500770118","MENDOZA",229,5,74,139,0,213,0.0218340611353712
"500770108","MENDOZA",297,7,224,65,1,290,0.0235690235690236
"500701012","MENDOZA",335,292,27,16,0,43,0.871641791044776
"500701011","MENDOZA",199,195,1,3,0,4,0.979899497487437
"500490912","MENDOZA",174,170,2,1,0,3,0.977011494252874
"141610920","CORDOBA",218,207,1,1,0,2,0.94954128440367
"501051709","MENDOZA",264,156,87,20,0,107,0.590909090909091
"500490906","MENDOZA",306,294,7,5,0,12,0.96078431372549
"500490901","MENDOZA",385,367,8,3,0,11,0.953246753246753
"500490819","MENDOZA",202,193,1,6,0,7,0.955445544554455
"500490817","MENDOZA",337,334,1,0,0,1,0.991097922848665
"500490905","MENDOZA",339,337,0,2,0,2,0.994100294985251
"500490807","MENDOZA",332,323,6,1,0,7,0.97289156626506
"500490712","MENDOZA",261,256,2,2,0,4,0.980842911877395
"500490710","MENDOZA",153,152,0,0,0,0,0.993464052287582
"141610919","CORDOBA",240,220,17,3,0,20,0.916666666666667
"500490412","MENDOZA",253,249,2,1,0,3,0.984189723320158
"501051706","MENDOZA",217,214,1,0,0,1,0.986175115207373
"500490411","MENDOZA",344,336,4,2,0,6,0.976744186046512
"500490410","MENDOZA",274,265,7,0,0,7,0.967153284671533
"500490405","MENDOZA",223,217,3,0,0,3,0.973094170403587
"500490404","MENDOZA",326,298,1,1,0,2,0.914110429447853
"500490320","MENDOZA",290,125,41,103,7,151,0.431034482758621
"500281201","MENDOZA",429,310,66,47,0,113,0.722610722610723
"141610918","CORDOBA",336,332,4,0,0,4,0.988095238095238
"500281117","MENDOZA",271,253,9,8,0,17,0.933579335793358
"500700110","MENDOZA",804,20,435,304,0,739,0.0248756218905473
"500490316","MENDOZA",291,230,9,18,9,36,0.790378006872852
"501050510","MENDOZA",292,188,66,38,0,104,0.643835616438356
"500490208","MENDOZA",250,171,13,38,6,57,0.684
"500280912","MENDOZA",286,273,7,5,0,12,0.954545454545455
"500280905","MENDOZA",312,308,2,0,0,2,0.987179487179487
"500280903","MENDOZA",303,302,0,0,0,0,0.996699669966997
"500980722","MENDOZA",218,2,122,80,8,210,0.00917431192660551
"500980721","MENDOZA",213,100,63,43,2,108,0.469483568075117
"500630207","MENDOZA",173,172,0,0,0,0,0.994219653179191
"501051310","MENDOZA",282,244,27,11,0,38,0.865248226950355
"500630201","MENDOZA",235,234,0,0,0,0,0.995744680851064
"500560611","MENDOZA",305,301,1,0,0,1,0.986885245901639
"500700808","MENDOZA",281,271,4,2,0,6,0.9644128113879
"500560606","MENDOZA",384,273,65,38,2,105,0.7109375
"500491402","MENDOZA",415,412,0,0,0,0,0.992771084337349
"500491217","MENDOZA",235,234,0,0,0,0,0.995744680851064
"500491211","MENDOZA",169,169,0,0,0,0,1
"500491206","MENDOZA",253,251,2,0,0,2,0.992094861660079
"500211407","MENDOZA",368,363,0,0,0,0,0.986413043478261
"500630109","MENDOZA",349,15,247,87,0,334,0.0429799426934097
"500280819","MENDOZA",156,147,7,2,0,9,0.942307692307692
"500280806","MENDOZA",289,268,15,2,0,17,0.927335640138408
"500280305","MENDOZA",303,291,1,3,0,4,0.96039603960396
"500280711","MENDOZA",271,258,4,4,0,8,0.952029520295203
"500280518","MENDOZA",159,79,30,31,2,63,0.49685534591195
"500280505","MENDOZA",175,0,12,143,2,157,0
"500280502","MENDOZA",348,139,66,119,6,191,0.399425287356322
"500280413","MENDOZA",385,368,6,8,0,14,0.955844155844156
"500211502","MENDOZA",301,299,2,0,0,2,0.993355481727575
"141610917","CORDOBA",225,211,7,7,0,14,0.937777777777778
"500280408","MENDOZA",261,46,78,135,0,213,0.176245210727969
"500280308","MENDOZA",354,340,10,3,0,13,0.96045197740113
"140146603","CORDOBA",146,146,0,0,0,0,1
"500280405","MENDOZA",247,150,57,37,2,96,0.607287449392713
"141610916","CORDOBA",198,198,0,0,0,0,1
"500280403","MENDOZA",445,287,36,117,0,153,0.644943820224719
"500280304","MENDOZA",365,334,8,17,0,25,0.915068493150685
"500280211","MENDOZA",295,290,3,1,0,4,0.983050847457627
"500280207","MENDOZA",235,232,3,0,0,3,0.987234042553191
"500280204","MENDOZA",181,172,9,0,0,9,0.950276243093923
"500211610","MENDOZA",172,165,3,4,0,7,0.959302325581395
"500211607","MENDOZA",348,322,17,8,0,25,0.925287356321839
"500211402","MENDOZA",234,231,0,0,1,1,0.987179487179487
"500210910","MENDOZA",290,287,1,0,0,1,0.989655172413793
"500210710","MENDOZA",161,141,17,3,0,20,0.875776397515528
"500980507","MENDOZA",257,167,73,7,1,81,0.649805447470817
"500210705","MENDOZA",279,268,7,3,0,10,0.960573476702509
"500210704","MENDOZA",271,267,3,1,0,4,0.985239852398524
"500210701","MENDOZA",268,251,10,6,0,16,0.936567164179104
"141610915","CORDOBA",313,307,3,1,0,4,0.980830670926518
"500210602","MENDOZA",260,255,2,0,0,2,0.980769230769231
"500210511","MENDOZA",245,244,0,1,0,1,0.995918367346939
"500210510","MENDOZA",271,270,1,0,0,1,0.996309963099631
"500210509","MENDOZA",364,360,4,0,0,4,0.989010989010989
"500980416","MENDOZA",159,147,8,4,0,12,0.924528301886792
"500210501","MENDOZA",152,134,13,4,1,18,0.881578947368421
"500630810","MENDOZA",175,160,11,1,0,12,0.914285714285714
"500630804","MENDOZA",374,374,0,0,0,0,1
"500281907","MENDOZA",205,162,4,35,0,39,0.790243902439024
"500420405","MENDOZA",177,5,130,42,0,172,0.0282485875706215
"500281506","MENDOZA",395,334,21,30,0,51,0.845569620253165
"140146302","CORDOBA",224,219,4,1,0,5,0.977678571428571
"500420410","MENDOZA",210,33,83,89,1,173,0.157142857142857
"500350218","MENDOZA",277,275,1,0,0,1,0.992779783393502
"500282006","MENDOZA",280,256,16,7,0,23,0.914285714285714
"500282002","MENDOZA",250,236,8,5,0,13,0.944
"141610914","CORDOBA",218,215,1,0,0,1,0.986238532110092
"500281903","MENDOZA",189,147,2,39,0,41,0.777777777777778
"500281801","MENDOZA",266,239,16,7,0,23,0.898496240601504
"500281704","MENDOZA",229,198,23,4,0,27,0.864628820960699
"500281703","MENDOZA",345,288,19,32,0,51,0.834782608695652
"500281601","MENDOZA",278,265,8,5,0,13,0.953237410071942
"140147410","CORDOBA",262,240,18,4,0,22,0.916030534351145
"500281409","MENDOZA",296,295,1,0,0,1,0.996621621621622
"500281406","MENDOZA",252,252,0,0,0,0,1
"500281403","MENDOZA",216,216,0,0,0,0,1
"500281401","MENDOZA",184,170,0,13,0,13,0.923913043478261
"500700509","MENDOZA",219,214,4,0,0,4,0.977168949771689
"500210415","MENDOZA",175,169,3,1,0,4,0.965714285714286
"500210119","MENDOZA",128,128,0,0,0,0,1
"500210108","MENDOZA",317,314,1,0,0,1,0.990536277602524
"500140709","MENDOZA",327,307,18,2,0,20,0.938837920489297
"500980713","MENDOZA",195,195,0,0,0,0,1
"500140707","MENDOZA",300,161,81,58,0,139,0.536666666666667
"500140606","MENDOZA",251,207,31,13,0,44,0.824701195219124
"500140713","MENDOZA",230,135,71,18,3,92,0.58695652173913
"500140410","MENDOZA",320,182,63,52,4,119,0.56875
"501050505","MENDOZA",183,145,36,2,0,38,0.792349726775956
"500070707","MENDOZA",234,234,0,0,0,0,1
"500071307","MENDOZA",347,151,54,109,6,169,0.435158501440922
"500071203","MENDOZA",159,159,0,0,0,0,1
"500071104","MENDOZA",294,294,0,0,0,0,1
"500071022","MENDOZA",122,3,5,100,0,105,0.0245901639344262
"740350909","SAN LUIS",262,259,2,0,0,2,0.988549618320611
"500071016","MENDOZA",119,4,15,73,5,93,0.0336134453781513
"500070401","MENDOZA",227,225,0,0,0,0,0.991189427312775
"500210809","MENDOZA",201,201,0,0,0,0,1
"500071013","MENDOZA",1,1,0,0,0,0,1
"500211308","MENDOZA",234,234,0,0,0,0,1
"500211306","MENDOZA",233,232,0,0,0,0,0.995708154506438
"500211302","MENDOZA",176,172,2,2,0,4,0.977272727272727
"500211210","MENDOZA",240,238,0,1,0,1,0.991666666666667
"500211209","MENDOZA",269,210,44,15,0,59,0.780669144981413
"500211206","MENDOZA",239,231,5,1,0,6,0.96652719665272
"500211101","MENDOZA",203,203,0,0,0,0,1
"500980708","MENDOZA",185,180,4,0,0,4,0.972972972972973
"500211009","MENDOZA",293,293,0,0,0,0,1
"500210906","MENDOZA",282,277,1,3,0,4,0.982269503546099
"500070810","MENDOZA",264,262,2,0,0,2,0.992424242424242
"500070710","MENDOZA",297,296,0,1,0,1,0.996632996632997
"500070607","MENDOZA",297,287,4,4,0,8,0.966329966329966
"500070314","MENDOZA",149,132,0,0,0,0,0.885906040268456
"500070310","MENDOZA",169,169,0,0,0,0,1
"500070309","MENDOZA",133,133,0,0,0,0,1
"500070305","MENDOZA",126,126,0,0,0,0,1
"500070116","MENDOZA",113,113,0,0,0,0,1
"500070113","MENDOZA",131,131,0,0,0,0,1
"500070410","MENDOZA",146,146,0,0,0,0,1
"500070210","MENDOZA",255,255,0,0,0,0,1
"500070406","MENDOZA",60,58,2,0,0,2,0.966666666666667
"501120205","MENDOZA",344,0,213,111,13,337,0
"501050808","MENDOZA",116,1,78,24,5,107,0.00862068965517241
"500700611","MENDOZA",208,204,1,1,0,2,0.980769230769231
"500700504","MENDOZA",234,232,1,0,0,1,0.991452991452991
"500631013","MENDOZA",334,309,5,18,0,23,0.925149700598802
"740350812","SAN LUIS",212,123,49,36,0,85,0.580188679245283
"500631006","MENDOZA",250,229,5,14,0,19,0.916
"500491203","MENDOZA",373,366,5,1,0,6,0.981233243967828
"500281802","MENDOZA",303,296,5,2,0,7,0.976897689768977
"500910208","MENDOZA",353,234,49,64,0,113,0.662889518413598
"500910204","MENDOZA",343,250,70,20,0,90,0.728862973760933
"500280402","MENDOZA",221,198,11,9,0,20,0.895927601809955
"500071308","MENDOZA",291,162,36,65,10,111,0.556701030927835
"500490304","MENDOZA",366,344,5,13,0,18,0.939890710382514
"501051204","MENDOZA",84,0,29,45,3,77,0
"501051201","MENDOZA",116,0,48,49,6,103,0
"500840303","MENDOZA",266,2,180,68,3,251,0.0075187969924812
"501051009","MENDOZA",226,3,75,134,4,213,0.0132743362831858
"501050701","MENDOZA",8,0,2,5,0,7,0
"501050113","MENDOZA",272,9,131,123,0,254,0.0330882352941176
"500980612","MENDOZA",236,0,169,56,2,227,0
"500980610","MENDOZA",154,0,79,57,6,142,0
"500980501","MENDOZA",178,1,85,63,15,163,0.00561797752808989
"500980304","MENDOZA",240,1,155,68,4,227,0.00416666666666667
"500630305","MENDOZA",350,6,156,175,2,333,0.0171428571428571
"500560201","MENDOZA",300,2,66,58,40,164,0.00666666666666667
"500560502","MENDOZA",121,1,36,55,11,102,0.00826446280991736
"500980705","MENDOZA",344,303,12,18,1,31,0.880813953488372
"140145908","CORDOBA",122,116,0,0,0,0,0.950819672131147
"501051602","MENDOZA",447,3,180,215,11,406,0.00671140939597315
"500770103","MENDOZA",159,0,39,104,7,150,0
"500700306","MENDOZA",172,2,55,75,13,143,0.0116279069767442
"500700303","MENDOZA",370,1,123,169,29,321,0.0027027027027027
"500700104","MENDOZA",183,2,91,76,3,170,0.0109289617486339
"500700202","MENDOZA",308,3,77,187,13,277,0.00974025974025974
"500420302","MENDOZA",29,0,7,16,0,23,0
"500420102","MENDOZA",78,0,27,38,3,68,0
"500350303","MENDOZA",351,0,248,72,6,326,0
"500140303","MENDOZA",82,0,11,36,10,57,0
"501260202","MENDOZA",100,2,30,58,1,89,0.02
"500910101","MENDOZA",553,11,382,146,2,530,0.0198915009041591
"501190501","MENDOZA",80,0,24,53,0,77,0
"500840304","MENDOZA",343,5,209,96,10,315,0.0145772594752187
"501190206","MENDOZA",265,2,38,151,15,204,0.00754716981132075
"501051606","MENDOZA",29,0,0,16,4,20,0
"501050106","MENDOZA",351,1,185,149,3,337,0.00284900284900285
"500630408","MENDOZA",216,0,73,116,7,196,0
"500140302","MENDOZA",95,0,20,54,9,83,0
"500910304","MENDOZA",240,1,174,52,0,226,0.00416666666666667
"500910201","MENDOZA",330,115,62,111,9,182,0.348484848484849
"500700304","MENDOZA",292,1,159,121,2,282,0.00342465753424658
"500700211","MENDOZA",389,2,200,110,45,355,0.0051413881748072
"500630410","MENDOZA",376,4,92,247,11,350,0.0106382978723404
"500560610","MENDOZA",239,1,114,55,44,213,0.00418410041841004
"500560503","MENDOZA",220,1,118,59,13,190,0.00454545454545455
"501260309","MENDOZA",356,5,121,204,6,331,0.0140449438202247
"501260303","MENDOZA",551,367,74,95,0,169,0.666061705989111
"140145909","CORDOBA",240,240,0,0,0,0,1
"500770110","MENDOZA",271,5,138,125,0,263,0.018450184501845
"500491104","MENDOZA",160,23,46,79,2,127,0.14375
"500491102","MENDOZA",26,25,0,1,0,1,0.961538461538462
"500420402","MENDOZA",114,0,92,19,1,112,0
"500350202","MENDOZA",326,6,251,61,0,312,0.0184049079754601
"501260313","MENDOZA",234,106,45,71,3,119,0.452991452991453
"501051101","MENDOZA",358,4,100,205,20,325,0.0111731843575419
"501051110","MENDOZA",244,1,99,93,11,203,0.00409836065573771
"501050807","MENDOZA",177,0,37,66,24,127,0
"500840306","MENDOZA",254,3,150,78,14,242,0.0118110236220472
"501051001","MENDOZA",19,0,5,9,1,15,0
"501050307","MENDOZA",288,0,106,167,3,276,0
"501050104","MENDOZA",294,3,77,185,7,269,0.0102040816326531
"500980606","MENDOZA",320,3,160,85,17,262,0.009375
"501120105","MENDOZA",158,0,92,53,0,145,0
"140145907","CORDOBA",218,210,2,0,0,2,0.963302752293578
"501260306","MENDOZA",375,299,47,27,1,75,0.797333333333333
"501190610","MENDOZA",264,244,13,7,0,20,0.924242424242424
"501190408","MENDOZA",458,10,323,105,1,429,0.0218340611353712
"501190308","MENDOZA",574,361,90,78,2,170,0.628919860627178
"501190305","MENDOZA",420,363,25,26,0,51,0.864285714285714
"501051901","MENDOZA",191,73,56,60,0,116,0.382198952879581
"501051815","MENDOZA",300,280,15,5,0,20,0.933333333333333
"501051811","MENDOZA",243,203,28,12,0,40,0.835390946502058
"501051802","MENDOZA",129,129,0,0,0,0,1
"501051711","MENDOZA",286,196,59,28,0,87,0.685314685314685
"500700106","MENDOZA",431,9,285,131,0,416,0.0208816705336427
"501051704","MENDOZA",263,43,88,131,0,219,0.163498098859316
"501190304","MENDOZA",430,381,31,10,1,42,0.886046511627907
"501051703","MENDOZA",265,4,92,157,1,250,0.0150943396226415
"500700704","MENDOZA",187,179,5,0,0,5,0.957219251336898
"500700610","MENDOZA",221,221,0,0,0,0,1
"501051519","MENDOZA",274,3,33,208,8,249,0.0109489051094891
"501051514","MENDOZA",245,121,42,77,0,119,0.493877551020408
"501051501","MENDOZA",378,200,95,80,0,175,0.529100529100529
"500700605","MENDOZA",252,245,5,2,0,7,0.972222222222222
"500700603","MENDOZA",447,410,19,15,0,34,0.917225950782998
"500700512","MENDOZA",373,341,9,12,0,21,0.914209115281501
"500700511","MENDOZA",371,358,8,4,1,13,0.964959568733154
"501051312","MENDOZA",211,186,17,8,0,25,0.881516587677725
"501051303","MENDOZA",244,165,51,28,0,79,0.676229508196721
"500701005","MENDOZA",151,144,4,1,0,5,0.95364238410596
"500700901","MENDOZA",273,213,15,39,0,54,0.78021978021978
"500700814","MENDOZA",307,209,46,51,0,97,0.680781758957655
"500700812","MENDOZA",314,266,22,20,1,43,0.847133757961783
"500700809","MENDOZA",219,214,3,0,0,3,0.977168949771689
"500631105","MENDOZA",346,124,58,147,4,209,0.358381502890173
"500631101","MENDOZA",376,370,3,3,0,6,0.984042553191489
"500631016","MENDOZA",118,4,57,57,0,114,0.0338983050847458
"500631005","MENDOZA",289,7,216,66,0,282,0.0242214532871972
"500980703","MENDOZA",254,169,52,26,1,79,0.665354330708661
"500980403","MENDOZA",333,331,0,0,0,0,0.993993993993994
"500910206","MENDOZA",314,251,26,22,3,51,0.799363057324841
"500840813","MENDOZA",406,258,29,71,20,120,0.635467980295567
"500840203","MENDOZA",248,3,163,79,1,243,0.0120967741935484
"500630915","MENDOZA",315,294,3,17,0,20,0.933333333333333
"500980108","MENDOZA",310,3,245,48,1,294,0.00967741935483871
"500491012","MENDOZA",291,291,0,0,0,0,1
"500491009","MENDOZA",221,220,1,0,0,1,0.995475113122172
"500491004","MENDOZA",166,163,0,0,0,0,0.981927710843373
"501050606","MENDOZA",287,0,113,140,26,279,0
"500980910","MENDOZA",280,209,51,17,0,68,0.746428571428571
"500980802","MENDOZA",431,318,66,31,2,99,0.737819025522042
"500701010","MENDOZA",322,311,6,4,0,10,0.96583850931677
"500490908","MENDOZA",207,200,3,1,0,4,0.966183574879227
"500490907","MENDOZA",277,276,1,0,0,1,0.996389891696751
"500490904","MENDOZA",184,180,0,4,0,4,0.978260869565217
"500490708","MENDOZA",218,214,0,1,0,1,0.981651376146789
"500490707","MENDOZA",213,208,0,4,0,4,0.976525821596244
"500490701","MENDOZA",225,214,0,10,0,10,0.951111111111111
"500490408","MENDOZA",212,205,2,2,0,4,0.966981132075472
"500281103","MENDOZA",425,383,16,23,1,40,0.901176470588235
"500281008","MENDOZA",395,369,11,14,0,25,0.934177215189873
"500281112","MENDOZA",294,273,10,7,1,18,0.928571428571429
"500490318","MENDOZA",228,193,14,12,0,26,0.846491228070175
"500490306","MENDOZA",355,218,30,89,1,120,0.614084507042253
"500490216","MENDOZA",385,357,5,6,0,11,0.927272727272727
"500490212","MENDOZA",351,331,4,9,0,13,0.943019943019943
"500281110","MENDOZA",359,297,19,8,0,27,0.827298050139276
"500280820","MENDOZA",197,186,11,0,0,11,0.944162436548223
"500491201","MENDOZA",169,128,7,27,0,34,0.757396449704142
"500490206","MENDOZA",318,223,18,65,1,84,0.70125786163522
"500420407","MENDOZA",247,3,168,65,1,234,0.0121457489878543
"500281204","MENDOZA",322,303,9,3,0,12,0.940993788819876
"500281115","MENDOZA",297,276,3,10,0,13,0.929292929292929
"140145904","CORDOBA",273,269,3,0,0,3,0.985347985347985
"500280911","MENDOZA",159,144,13,2,0,15,0.905660377358491
"500280909","MENDOZA",284,279,4,1,0,5,0.982394366197183
"500280907","MENDOZA",165,164,0,1,0,1,0.993939393939394
"500700510","MENDOZA",403,392,3,4,0,7,0.972704714640198
"500630902","MENDOZA",0,0,0,0,0,0,NA
"500630209","MENDOZA",191,188,2,1,0,3,0.984293193717278
"500630110","MENDOZA",170,6,125,39,0,164,0.0352941176470588
"500630107","MENDOZA",364,179,102,72,0,174,0.491758241758242
"500491412","MENDOZA",325,287,16,13,0,29,0.883076923076923
"500280808","MENDOZA",303,292,6,4,0,10,0.963696369636964
"500491310","MENDOZA",370,362,3,3,0,6,0.978378378378378
"500491305","MENDOZA",209,205,0,0,0,0,0.980861244019139
"500491304","MENDOZA",335,315,11,3,0,14,0.940298507462687
"500491204","MENDOZA",204,184,7,11,0,18,0.901960784313726
"500070703","MENDOZA",254,251,2,0,0,2,0.988188976377953
"500700416","MENDOZA",396,4,174,201,1,376,0.0101010101010101
"500280904","MENDOZA",179,179,0,0,0,0,1
"500280802","MENDOZA",177,164,5,0,0,5,0.926553672316384
"500280707","MENDOZA",276,275,0,1,0,1,0.996376811594203
"500280613","MENDOZA",305,279,14,12,0,26,0.914754098360656
"500280704","MENDOZA",306,298,3,5,0,8,0.973856209150327
"500280607","MENDOZA",339,301,7,22,0,29,0.887905604719764
"500280603","MENDOZA",203,152,9,7,0,16,0.748768472906404
"500280517","MENDOZA",555,8,296,218,8,522,0.0144144144144144
"500280411","MENDOZA",321,283,0,14,0,14,0.881619937694704
"500280208","MENDOZA",205,199,2,3,0,5,0.970731707317073
"500280203","MENDOZA",256,249,6,1,0,7,0.97265625
"500280107","MENDOZA",242,242,0,0,0,0,1
"500211503","MENDOZA",125,122,0,1,2,3,0.976
"500211409","MENDOZA",303,137,49,102,0,151,0.452145214521452
"500211404","MENDOZA",238,228,2,2,0,4,0.957983193277311
"500281807","MENDOZA",409,378,18,5,0,23,0.924205378973105
"141610912","CORDOBA",245,241,2,1,0,3,0.983673469387755
"500211314","MENDOZA",230,190,18,18,0,36,0.826086956521739
"500700415","MENDOZA",217,5,169,42,0,211,0.0230414746543779
"500210803","MENDOZA",306,108,11,157,11,179,0.352941176470588
"500210702","MENDOZA",316,304,9,2,0,11,0.962025316455696
"500210612","MENDOZA",269,260,4,1,0,5,0.966542750929368
"500210419","MENDOZA",127,110,8,5,0,13,0.866141732283465
"141610911","CORDOBA",266,266,0,0,0,0,1
"500210418","MENDOZA",327,313,7,5,0,12,0.957186544342508
"500281408","MENDOZA",304,301,3,0,0,3,0.990131578947368
"500630813","MENDOZA",260,181,66,12,0,78,0.696153846153846
"500630809","MENDOZA",346,339,3,1,0,4,0.979768786127168
"500630706","MENDOZA",25,0,7,17,1,25,0
"500700711","MENDOZA",263,258,4,1,0,5,0.980988593155893
"500281705","MENDOZA",238,223,10,4,0,14,0.936974789915966
"500281702","MENDOZA",284,243,26,15,0,41,0.855633802816901
"500281402","MENDOZA",212,212,0,0,0,0,1
"500281307","MENDOZA",180,169,9,2,0,11,0.938888888888889
"500281301","MENDOZA",318,310,6,0,0,6,0.974842767295597
"500281809","MENDOZA",303,294,3,5,0,8,0.97029702970297
"500281808","MENDOZA",247,25,91,118,2,211,0.101214574898785
"500281603","MENDOZA",229,218,7,3,0,10,0.951965065502183
"500070303","MENDOZA",302,300,0,1,0,1,0.993377483443709
"500281218","MENDOZA",268,263,4,0,0,4,0.98134328358209
"500281215","MENDOZA",229,223,4,2,0,6,0.973799126637555
"500281207","MENDOZA",232,229,3,0,0,3,0.987068965517241
"500210401","MENDOZA",290,258,24,3,0,27,0.889655172413793
"500210317","MENDOZA",217,208,6,1,0,7,0.95852534562212
"500210315","MENDOZA",169,149,9,11,0,20,0.881656804733728
"500210308","MENDOZA",361,330,12,3,0,15,0.914127423822715
"500210206","MENDOZA",259,248,7,2,0,9,0.957528957528958
"500140708","MENDOZA",325,138,105,73,0,178,0.424615384615385
"500140702","MENDOZA",330,4,169,138,1,308,0.0121212121212121
"500140406","MENDOZA",339,260,33,34,5,72,0.766961651917404
"500071304","MENDOZA",325,239,22,46,0,68,0.735384615384615
"500280706","MENDOZA",310,310,0,0,0,0,1
"500071210","MENDOZA",233,231,1,0,1,2,0.991416309012876
"500071206","MENDOZA",195,195,0,0,0,0,1
"500071112","MENDOZA",174,173,1,0,0,1,0.994252873563218
"500071109","MENDOZA",230,219,0,0,0,0,0.952173913043478
"500071108","MENDOZA",375,372,2,1,0,3,0.992
"141610910","CORDOBA",214,208,3,2,0,5,0.97196261682243
"500211307","MENDOZA",347,342,2,0,0,2,0.985590778097983
"500070214","MENDOZA",270,269,0,1,0,1,0.996296296296296
"500211207","MENDOZA",297,288,1,1,0,2,0.96969696969697
"500211102","MENDOZA",46,45,1,0,0,1,0.978260869565217
"500211010","MENDOZA",214,208,0,3,0,3,0.97196261682243
"500210904","MENDOZA",263,258,2,3,0,5,0.980988593155893
"500210808","MENDOZA",297,295,2,0,0,2,0.993265993265993
"500071010","MENDOZA",332,313,5,3,0,8,0.942771084337349
"500070606","MENDOZA",422,376,5,7,21,33,0.890995260663507
"500070604","MENDOZA",215,215,0,0,0,0,1
"500070603","MENDOZA",239,237,0,2,0,2,0.99163179916318
"500070510","MENDOZA",284,283,0,0,0,0,0.996478873239437
"500070509","MENDOZA",265,265,0,0,0,0,1
"500070507","MENDOZA",164,164,0,0,0,0,1
"500070504","MENDOZA",163,163,0,0,0,0,1
"500070316","MENDOZA",156,156,0,0,0,0,1
"500071001","MENDOZA",326,315,2,8,1,11,0.966257668711656
"500070910","MENDOZA",263,263,0,0,0,0,1
"500070908","MENDOZA",221,218,3,0,0,3,0.986425339366516
"500070806","MENDOZA",251,250,0,1,0,1,0.99601593625498
"500070805","MENDOZA",173,172,1,0,0,1,0.994219653179191
"500070311","MENDOZA",176,176,0,0,0,0,1
"500070203","MENDOZA",349,349,0,0,0,0,1
"500070106","MENDOZA",268,268,0,0,0,0,1
"501051302","MENDOZA",216,193,10,13,0,23,0.893518518518518
"500630111","MENDOZA",151,7,69,74,1,144,0.0463576158940397
"500491405","MENDOZA",341,333,3,3,0,6,0.976539589442815
"500491110","MENDOZA",387,376,9,2,0,11,0.971576227390181
"500281803","MENDOZA",410,374,31,1,0,32,0.91219512195122
"500281606","MENDOZA",187,187,0,0,0,0,1
"500211005","MENDOZA",171,168,2,0,0,2,0.982456140350877
"500490310","MENDOZA",188,188,0,0,0,0,1
"500071006","MENDOZA",413,406,4,0,0,4,0.983050847457627
"500210307","MENDOZA",183,182,1,0,0,1,0.994535519125683
"500980201","MENDOZA",23,0,12,7,0,19,0
"501260503","MENDOZA",281,1,42,200,9,251,0.00355871886120996
"501260401","MENDOZA",276,2,54,179,8,241,0.0072463768115942
"501051203","MENDOZA",106,1,24,57,11,92,0.00943396226415094
"501051107","MENDOZA",403,4,43,196,64,303,0.00992555831265509
"501051105","MENDOZA",572,3,175,312,21,508,0.00524475524475524
"501051109","MENDOZA",135,3,25,80,13,118,0.0222222222222222
"501050703","MENDOZA",242,1,55,106,18,179,0.00413223140495868
"500980107","MENDOZA",135,0,50,43,17,110,0
"501050203","MENDOZA",268,0,73,135,30,238,0
"501050110","MENDOZA",223,0,60,135,13,208,0
"500980912","MENDOZA",273,79,132,37,7,176,0.289377289377289
"500980817","MENDOZA",187,4,95,56,11,162,0.0213903743315508
"500980206","MENDOZA",41,0,13,12,1,26,0
"500910104","MENDOZA",165,0,62,76,8,146,0
"500840704","MENDOZA",167,5,93,61,4,158,0.029940119760479
"500840401","MENDOZA",60,1,27,28,1,56,0.0166666666666667
"500770101","MENDOZA",90,0,0,38,22,60,0
"500700114","MENDOZA",305,2,133,128,27,288,0.00655737704918033
"500560601","MENDOZA",121,0,31,67,8,106,0
"500281714","MENDOZA",226,1,114,79,16,209,0.00442477876106195
"500630504","MENDOZA",203,3,66,107,7,180,0.0147783251231527
"500630503","MENDOZA",178,1,49,76,11,136,0.00561797752808989
"500700118","MENDOZA",248,3,157,67,10,234,0.0120967741935484
"500560505","MENDOZA",140,5,73,33,2,108,0.0357142857142857
"140420609","CORDOBA",305,297,5,2,0,7,0.973770491803279
"500350302","MENDOZA",348,3,190,131,14,335,0.00862068965517241
"501050109","MENDOZA",96,2,47,45,0,92,0.0208333333333333
"500980911","MENDOZA",327,267,40,1,0,41,0.81651376146789
"500910305","MENDOZA",347,4,135,188,3,326,0.0115273775216138
"500910112","MENDOZA",225,1,111,99,5,215,0.00444444444444444
"500910108","MENDOZA",367,3,261,99,0,360,0.00817438692098093
"500910105","MENDOZA",405,57,282,61,0,343,0.140740740740741
"500700302","MENDOZA",563,12,309,163,34,506,0.0213143872113677
"500630407","MENDOZA",283,7,158,94,3,255,0.0247349823321555
"500560506","MENDOZA",223,2,116,62,21,199,0.00896860986547085
"500560504","MENDOZA",297,2,189,70,17,276,0.00673400673400673
"500560409","MENDOZA",309,43,150,75,10,235,0.13915857605178
"501260317","MENDOZA",278,103,77,62,8,147,0.370503597122302
"500980710","MENDOZA",158,150,7,0,0,7,0.949367088607595
"500210201","MENDOZA",268,251,7,6,0,13,0.936567164179104
"500420403","MENDOZA",123,0,87,28,3,118,0
"501190607","MENDOZA",436,416,9,6,1,16,0.954128440366973
"501190309","MENDOZA",509,469,13,6,0,19,0.921414538310413
"501051411","MENDOZA",242,201,22,19,0,41,0.830578512396694
"500210115","MENDOZA",372,97,63,186,5,254,0.260752688172043
"500140404","MENDOZA",281,126,83,48,11,142,0.448398576512456
"500700816","MENDOZA",319,14,213,90,0,303,0.0438871473354232
"501260301","MENDOZA",800,75,252,379,30,661,0.09375
"500560612","MENDOZA",222,6,120,65,12,197,0.027027027027027
"501051205","MENDOZA",309,3,164,122,6,292,0.00970873786407767
"500490506","MENDOZA",154,0,68,81,2,151,0
"500210917","MENDOZA",179,175,2,2,0,4,0.977653631284916
"501190407","MENDOZA",508,13,374,103,2,479,0.0255905511811024
"501120104","MENDOZA",424,0,269,132,5,406,0
"501051007","MENDOZA",317,1,109,155,14,278,0.00315457413249211
"500700813","MENDOZA",233,178,22,31,0,53,0.763948497854077
"500700804","MENDOZA",331,331,0,0,0,0,1
"501050904","MENDOZA",323,0,192,121,4,317,0
"501050306","MENDOZA",435,4,186,211,10,407,0.00919540229885057
"501260302","MENDOZA",182,147,20,11,0,31,0.807692307692308
"501190601","MENDOZA",260,30,99,113,7,219,0.115384615384615
"501190302","MENDOZA",376,316,46,5,0,51,0.840425531914894
"501190301","MENDOZA",450,198,118,117,3,238,0.44
"500700606","MENDOZA",302,279,11,9,0,20,0.923841059602649
"140145903","CORDOBA",288,284,4,0,0,4,0.986111111111111
"501051913","MENDOZA",254,5,146,97,1,244,0.0196850393700787
"501051813","MENDOZA",219,218,1,0,0,1,0.995433789954338
"501051517","MENDOZA",369,24,322,23,0,345,0.0650406504065041
"501051516","MENDOZA",175,12,54,108,1,163,0.0685714285714286
"501051510","MENDOZA",245,108,41,80,1,122,0.440816326530612
"501051506","MENDOZA",249,169,42,37,0,79,0.678714859437751
"141610909","CORDOBA",239,232,3,3,0,6,0.97071129707113
"501051404","MENDOZA",209,188,14,7,0,21,0.899521531100478
"501051402","MENDOZA",131,96,34,1,0,35,0.732824427480916
"500700912","MENDOZA",300,282,5,7,0,12,0.94
"500700911","MENDOZA",403,325,10,60,0,70,0.806451612903226
"140145902","CORDOBA",156,154,1,1,0,2,0.987179487179487
"500700407","MENDOZA",468,109,168,167,0,335,0.232905982905983
"500700109","MENDOZA",656,15,361,210,4,575,0.0228658536585366
"500631115","MENDOZA",212,204,5,3,0,8,0.962264150943396
"500631107","MENDOZA",122,113,0,1,0,1,0.926229508196721
"501050419","MENDOZA",411,238,34,133,2,169,0.579075425790754
"500631004","MENDOZA",188,55,64,62,2,128,0.292553191489362
"500980704","MENDOZA",233,185,38,8,0,46,0.793991416309013
"500980702","MENDOZA",352,278,43,16,0,59,0.789772727272727
"500630909","MENDOZA",302,291,9,0,0,9,0.963576158940397
"500491006","MENDOZA",188,187,1,0,0,1,0.99468085106383
"500490917","MENDOZA",232,230,1,0,0,1,0.991379310344828
"501051413","MENDOZA",326,248,45,31,0,76,0.760736196319018
"500630907","MENDOZA",424,78,61,254,4,319,0.183962264150943
"500491111","MENDOZA",270,236,24,10,0,34,0.874074074074074
"500491119","MENDOZA",303,292,3,3,0,6,0.963696369636964
"500210212","MENDOZA",337,336,1,0,0,1,0.997032640949555
"500491103","MENDOZA",356,307,13,21,0,34,0.862359550561798
"501050521","MENDOZA",187,82,53,48,1,102,0.438502673796791
"500491109","MENDOZA",196,108,69,18,0,87,0.551020408163265
"500491108","MENDOZA",174,173,1,0,0,1,0.994252873563218
"500491107","MENDOZA",120,119,0,0,0,0,0.991666666666667
"500491106","MENDOZA",199,79,95,25,0,120,0.396984924623116
"500630212","MENDOZA",232,226,4,2,0,6,0.974137931034483
"501050410","MENDOZA",217,8,126,75,0,201,0.0368663594470046
"501050402","MENDOZA",314,29,114,168,0,282,0.0923566878980892
"501050401","MENDOZA",306,109,130,66,0,196,0.356209150326797
"500980417","MENDOZA",378,310,49,13,4,66,0.82010582010582
"500980415","MENDOZA",402,384,14,3,0,17,0.955223880597015
"500980402","MENDOZA",306,304,0,0,0,0,0.993464052287582
"500840801","MENDOZA",214,188,20,5,0,25,0.878504672897196
"500770115","MENDOZA",229,0,59,156,1,216,0
"500770109","MENDOZA",270,11,125,116,0,241,0.0407407407407407
"500701007","MENDOZA",219,202,15,1,0,16,0.922374429223744
"500490910","MENDOZA",274,270,1,0,0,1,0.985401459854015
"500490903","MENDOZA",209,202,3,0,0,3,0.966507177033493
"500490820","MENDOZA",240,237,0,3,0,3,0.9875
"500490818","MENDOZA",250,225,14,7,1,22,0.9
"500281203","MENDOZA",300,293,5,0,0,5,0.976666666666667
"500281113","MENDOZA",194,167,17,8,0,25,0.860824742268041
"500490815","MENDOZA",345,324,6,7,5,18,0.939130434782609
"500490809","MENDOZA",332,319,6,0,0,6,0.960843373493976
"500490709","MENDOZA",288,248,18,16,0,34,0.861111111111111
"500490402","MENDOZA",350,342,6,1,0,7,0.977142857142857
"500490321","MENDOZA",322,115,51,80,3,134,0.357142857142857
"500490211","MENDOZA",281,233,11,25,1,37,0.829181494661922
"141610308","CORDOBA",194,0,168,22,1,191,0
"500281108","MENDOZA",340,311,13,8,2,23,0.914705882352941
"500281007","MENDOZA",374,339,24,9,0,33,0.906417112299465
"500280906","MENDOZA",363,358,5,0,0,5,0.986225895316804
"500280901","MENDOZA",315,311,1,0,1,2,0.987301587301587
"500491116","MENDOZA",290,287,0,1,0,1,0.989655172413793
"141610908","CORDOBA",212,212,0,0,0,0,1
"500630814","MENDOZA",367,122,124,112,1,237,0.332425068119891
"500630308","MENDOZA",220,193,14,11,0,25,0.877272727272727
"500630208","MENDOZA",242,240,2,0,0,2,0.991735537190083
"500560613","MENDOZA",236,91,93,24,13,130,0.385593220338983
"500491410","MENDOZA",317,301,6,1,0,7,0.949526813880126
"500491409","MENDOZA",260,260,0,0,0,0,1
"500491307","MENDOZA",381,353,10,15,1,26,0.926509186351706
"500491313","MENDOZA",247,241,1,0,0,1,0.975708502024291
"500491115","MENDOZA",175,172,1,0,0,1,0.982857142857143
"500280818","MENDOZA",147,141,1,4,0,5,0.959183673469388
"500280712","MENDOZA",318,309,3,6,0,9,0.971698113207547
"500280710","MENDOZA",213,209,4,0,0,4,0.981220657276995
"500280504","MENDOZA",248,6,97,121,6,224,0.0241935483870968
"500280317","MENDOZA",301,294,3,3,0,6,0.976744186046512
"500280212","MENDOZA",322,314,5,3,0,8,0.975155279503106
"500280105","MENDOZA",241,240,1,0,0,1,0.995850622406639
"500211608","MENDOZA",328,312,16,0,0,16,0.951219512195122
"500211602","MENDOZA",396,372,1,2,0,3,0.939393939393939
"141401717","CORDOBA",266,14,212,32,2,246,0.0526315789473684
"500211506","MENDOZA",192,191,1,0,0,1,0.994791666666667
"500211501","MENDOZA",416,402,12,2,0,14,0.966346153846154
"500211606","MENDOZA",389,376,6,7,0,13,0.966580976863753
"500281302","MENDOZA",317,305,6,2,0,8,0.962145110410095
"500281213","MENDOZA",226,218,6,1,0,7,0.964601769911504
"500211410","MENDOZA",293,290,0,0,0,0,0.989761092150171
"500211313","MENDOZA",399,377,12,9,0,21,0.944862155388471
"500210604","MENDOZA",312,278,0,0,0,0,0.891025641025641
"140146606","CORDOBA",229,228,1,0,0,1,0.995633187772926
"500210507","MENDOZA",292,289,1,2,0,3,0.98972602739726
"500210505","MENDOZA",257,257,0,0,0,0,1
"500630805","MENDOZA",260,260,0,0,0,0,1
"500630803","MENDOZA",297,283,11,2,0,13,0.952861952861953
"500490919","MENDOZA",173,168,1,1,0,2,0.971098265895954
"500350210","MENDOZA",356,334,8,12,0,20,0.938202247191011
"500350209","MENDOZA",415,407,6,0,0,6,0.980722891566265
"500350208","MENDOZA",230,176,46,8,0,54,0.765217391304348
"500350204","MENDOZA",233,210,17,6,0,23,0.901287553648069
"500282011","MENDOZA",242,240,1,0,1,2,0.991735537190083
"500281905","MENDOZA",529,288,93,130,1,224,0.544423440453686
"500281902","MENDOZA",243,202,8,29,0,37,0.831275720164609
"140145806","CORDOBA",292,289,2,0,1,3,0.98972602739726
"500281812","MENDOZA",225,88,78,49,0,127,0.391111111111111
"500281710","MENDOZA",291,261,17,13,0,30,0.896907216494845
"500281611","MENDOZA",357,350,3,2,0,5,0.980392156862745
"500491403","MENDOZA",275,275,0,0,0,0,1
"500281604","MENDOZA",296,290,3,3,0,6,0.97972972972973
"500210416","MENDOZA",194,184,8,2,0,10,0.948453608247423
"500210404","MENDOZA",322,304,15,3,0,18,0.944099378881988
"500210313","MENDOZA",203,196,4,3,0,7,0.96551724137931
"500210312","MENDOZA",203,198,0,4,0,4,0.975369458128079
"500210304","MENDOZA",316,307,6,3,0,9,0.971518987341772
"500210302","MENDOZA",162,160,1,1,0,2,0.987654320987654
"500210215","MENDOZA",333,322,10,1,0,11,0.966966966966967
"500210111","MENDOZA",379,365,11,2,0,13,0.963060686015831
"500140710","MENDOZA",375,263,55,54,1,110,0.701333333333333
"500140604","MENDOZA",303,262,26,15,0,41,0.864686468646865
"501050507","MENDOZA",232,102,76,48,0,124,0.439655172413793
"500071103","MENDOZA",265,264,1,0,0,1,0.99622641509434
"500281505","MENDOZA",427,397,14,2,0,16,0.929742388758782
"500281414","MENDOZA",223,223,0,0,0,0,1
"500281411","MENDOZA",232,232,0,0,0,0,1
"500071021","MENDOZA",249,232,2,5,0,7,0.931726907630522
"500071020","MENDOZA",259,235,15,7,1,23,0.907335907335907
"500070402","MENDOZA",196,196,0,0,0,0,1
"500211311","MENDOZA",334,333,1,0,0,1,0.997005988023952
"500211202","MENDOZA",317,307,4,5,0,9,0.968454258675079
"500211201","MENDOZA",148,140,3,5,0,8,0.945945945945946
"500211604","MENDOZA",376,373,2,0,0,2,0.992021276595745
"500211008","MENDOZA",284,281,3,0,0,3,0.98943661971831
"500210908","MENDOZA",151,148,1,1,0,2,0.980132450331126
"501050517","MENDOZA",213,155,31,26,0,57,0.727699530516432
"500210901","MENDOZA",186,179,2,2,0,4,0.962365591397849
"500210807","MENDOZA",383,376,5,2,0,7,0.981723237597911
"500210805","MENDOZA",212,203,3,0,1,4,0.957547169811321
"501051308","MENDOZA",152,140,8,3,0,11,0.921052631578947
"500071011","MENDOZA",188,176,1,2,1,4,0.936170212765957
"500071009","MENDOZA",325,307,11,0,0,11,0.944615384615385
"140145805","CORDOBA",280,278,2,0,0,2,0.992857142857143
"500071007","MENDOZA",241,234,6,1,0,7,0.970954356846473
"500071004","MENDOZA",381,366,5,1,0,6,0.960629921259842
"500070911","MENDOZA",217,217,0,0,0,0,1
"500980105","MENDOZA",282,1,176,74,4,254,0.00354609929078014
"500070909","MENDOZA",82,82,0,0,0,0,1
"500070907","MENDOZA",256,255,0,1,0,1,0.99609375
"500070903","MENDOZA",199,199,0,0,0,0,1
"500070808","MENDOZA",147,147,0,0,0,0,1
"500070804","MENDOZA",108,108,0,0,0,0,1
"500070610","MENDOZA",343,329,7,0,0,7,0.959183673469388
"500070609","MENDOZA",198,198,0,0,0,0,1
"500070602","MENDOZA",225,223,2,0,0,2,0.991111111111111
"500070508","MENDOZA",265,265,0,0,0,0,1
"500070306","MENDOZA",114,114,0,0,0,0,1
"500070304","MENDOZA",230,216,0,0,0,0,0.939130434782609
"500070117","MENDOZA",162,162,0,0,0,0,1
"140147409","CORDOBA",250,149,85,15,0,100,0.596
"500070109","MENDOZA",202,202,0,0,0,0,1
"500070403","MENDOZA",121,121,0,0,0,0,1
"500070502","MENDOZA",260,257,2,0,0,2,0.988461538461539
"500070412","MENDOZA",226,226,0,0,0,0,1
"501051006","MENDOZA",317,39,131,135,11,277,0.123028391167192
"500700305","MENDOZA",567,5,422,122,8,552,0.00881834215167548
"500282003","MENDOZA",199,182,10,6,0,16,0.914572864321608
"500281804","MENDOZA",307,176,36,90,0,126,0.57328990228013
"500840212","MENDOZA",260,243,15,2,0,17,0.934615384615385
"500280410","MENDOZA",249,134,18,90,2,110,0.538152610441767
"500490813","MENDOZA",152,151,1,0,0,1,0.993421052631579
"500490706","MENDOZA",210,207,3,0,0,3,0.985714285714286
"500490409","MENDOZA",381,376,1,3,1,5,0.986876640419947
"500490214","MENDOZA",271,259,2,0,0,2,0.955719557195572
"501260308","MENDOZA",161,80,40,39,0,79,0.496894409937888
"501051108","MENDOZA",183,0,40,111,11,162,0
"500840701","MENDOZA",125,0,68,46,2,116,0
"500910306","MENDOZA",357,9,195,136,5,336,0.0252100840336134
"500910207","MENDOZA",292,202,18,57,0,75,0.691780821917808
"500840403","MENDOZA",327,0,232,85,2,319,0
"500980908","MENDOZA",287,269,11,4,0,15,0.937282229965157
"500280513","MENDOZA",322,9,203,86,12,301,0.0279503105590062
"501051812","MENDOZA",215,214,1,0,0,1,0.995348837209302
"501051803","MENDOZA",232,220,12,0,0,12,0.948275862068966
"501051708","MENDOZA",244,222,17,5,0,22,0.909836065573771
"501051513","MENDOZA",342,168,82,83,0,165,0.491228070175439
"501051511","MENDOZA",298,105,45,143,0,188,0.352348993288591
"501051003","MENDOZA",50,0,5,17,6,28,0
"500280503","MENDOZA",341,3,117,165,15,297,0.00879765395894428
"500140501","MENDOZA",335,2,130,167,14,311,0.00597014925373134
"500980901","MENDOZA",258,234,22,2,0,24,0.906976744186046
"501050805","MENDOZA",8,0,0,1,2,3,0
"501050803","MENDOZA",126,9,36,67,5,108,0.0714285714285714
"501050303","MENDOZA",237,4,59,157,5,221,0.0168776371308017
"501050302","MENDOZA",222,2,68,127,8,203,0.00900900900900901
"500980205","MENDOZA",100,0,63,24,3,90,0
"500980821","MENDOZA",122,108,8,1,0,9,0.885245901639344
"500840501","MENDOZA",80,1,26,37,1,64,0.0125
"500840405","MENDOZA",189,1,112,46,13,171,0.00529100529100529
"500980204","MENDOZA",126,0,74,34,5,113,0
"500840201","MENDOZA",519,92,239,154,7,400,0.177263969171484
"500980202","MENDOZA",210,1,135,54,3,192,0.00476190476190476
"500770104","MENDOZA",90,0,5,57,3,65,0
"500631112","MENDOZA",163,81,41,40,0,81,0.496932515337423
"500700203","MENDOZA",211,1,70,84,18,172,0.004739336492891
"500140301","MENDOZA",35,0,4,22,1,27,0
"500140401","MENDOZA",188,0,77,57,31,165,0
"500140407","MENDOZA",10,6,3,0,1,4,0.6
"500630602","MENDOZA",47,1,1,34,3,38,0.0212765957446809
"500630303","MENDOZA",59,0,11,43,2,56,0
"500490315","MENDOZA",329,3,65,184,46,295,0.00911854103343465
"500700102","MENDOZA",295,2,168,103,5,276,0.00677966101694915
"500490302","MENDOZA",291,3,71,120,48,239,0.0103092783505155
"500350503","MENDOZA",94,0,48,34,7,89,0
"500350401","MENDOZA",119,2,48,60,3,111,0.0168067226890756
"500281713","MENDOZA",254,6,163,67,16,246,0.0236220472440945
"740350811","SAN LUIS",381,264,42,68,2,112,0.692913385826772
"500630702","MENDOZA",28,1,16,11,0,27,0.0357142857142857
"500630307","MENDOZA",335,15,150,167,0,317,0.0447761194029851
"500560609","MENDOZA",331,12,157,98,14,269,0.0362537764350453
"500560402","MENDOZA",230,2,131,63,16,210,0.00869565217391304
"501190612","MENDOZA",375,200,78,78,1,157,0.533333333333333
"501120302","MENDOZA",241,0,153,67,3,223,0
"501051804","MENDOZA",411,411,0,0,0,0,1
"140145804","CORDOBA",222,220,0,1,1,2,0.990990990990991
"500490602","MENDOZA",46,45,0,0,1,1,0.978260869565217
"500350505","MENDOZA",112,0,69,32,6,107,0
"500350403","MENDOZA",390,47,227,87,7,321,0.120512820512821
"500280514","MENDOZA",319,2,136,121,30,287,0.00626959247648903
"501260504","MENDOZA",338,3,131,156,13,300,0.00887573964497041
"501051010","MENDOZA",44,1,23,19,0,42,0.0227272727272727
"500980603","MENDOZA",266,1,199,50,9,258,0.0037593984962406
"500980608","MENDOZA",305,1,214,72,5,291,0.00327868852459016
"500350507","MENDOZA",211,90,66,42,2,110,0.42654028436019
"500070308","MENDOZA",124,112,0,0,0,0,0.903225806451613
"501260311","MENDOZA",349,275,40,29,0,69,0.787965616045845
"501260305","MENDOZA",374,294,45,33,0,78,0.786096256684492
"501190605","MENDOZA",257,228,20,6,0,26,0.88715953307393
"501190603","MENDOZA",385,313,42,13,0,55,0.812987012987013
"501120304","MENDOZA",306,0,260,39,3,302,0
"501051909","MENDOZA",300,147,134,19,0,153,0.49
"501051509","MENDOZA",224,109,42,69,1,112,0.486607142857143
"501051405","MENDOZA",307,236,53,18,0,71,0.768729641693811
"500700805","MENDOZA",460,397,16,40,0,56,0.86304347826087
"500700801","MENDOZA",313,184,79,48,0,127,0.587859424920128
"500700712","MENDOZA",173,171,2,0,0,2,0.988439306358382
"500700710","MENDOZA",171,165,4,2,0,6,0.964912280701754
"500491005","MENDOZA",257,255,0,1,0,1,0.992217898832685
"500700703","MENDOZA",311,283,20,5,0,25,0.909967845659164
"500700701","MENDOZA",219,212,3,0,0,3,0.968036529680365
"500700514","MENDOZA",310,252,30,22,0,52,0.812903225806452
"500630707","MENDOZA",53,0,26,27,0,53,0
"500700406","MENDOZA",485,146,190,138,1,329,0.301030927835052
"500631113","MENDOZA",324,302,9,12,0,21,0.932098765432099
"500491002","MENDOZA",335,332,1,0,0,1,0.991044776119403
"500490916","MENDOZA",309,306,1,0,0,1,0.990291262135922
"501050707","MENDOZA",228,80,68,58,8,134,0.350877192982456
"501050608","MENDOZA",98,0,54,43,0,97,0
"501050418","MENDOZA",354,6,210,134,0,344,0.0169491525423729
"500980813","MENDOZA",234,233,0,1,0,1,0.995726495726496
"500980808","MENDOZA",351,325,0,0,0,0,0.925925925925926
"500980807","MENDOZA",379,364,9,2,0,11,0.96042216358839
"500980804","MENDOZA",390,21,323,40,2,365,0.0538461538461538
"140146605","CORDOBA",193,192,1,0,0,1,0.994818652849741
"500630912","MENDOZA",290,272,12,6,0,18,0.937931034482759
"500630906","MENDOZA",360,332,8,11,0,19,0.922222222222222
"500491311","MENDOZA",355,344,5,1,0,6,0.969014084507042
"500491007","MENDOZA",356,354,0,0,0,0,0.99438202247191
"501050504","MENDOZA",264,208,19,36,0,55,0.787878787878788
"500980504","MENDOZA",325,1,190,114,5,309,0.00307692307692308
"500980406","MENDOZA",335,302,32,0,1,33,0.901492537313433
"500840807","MENDOZA",243,219,22,2,0,24,0.901234567901235
"500840806","MENDOZA",427,295,84,47,0,131,0.690866510538642
"500840406","MENDOZA",209,2,145,56,1,202,0.00956937799043062
"500840309","MENDOZA",262,6,183,68,0,251,0.0229007633587786
"500840210","MENDOZA",233,218,8,1,0,9,0.935622317596567
"500840104","MENDOZA",240,1,186,50,1,237,0.00416666666666667
"500840205","MENDOZA",370,309,35,19,4,58,0.835135135135135
"500281109","MENDOZA",314,285,16,9,1,26,0.907643312101911
"140145803","CORDOBA",165,155,6,2,0,8,0.939393939393939
"500770116","MENDOZA",394,30,276,87,0,363,0.0761421319796954
"500770113","MENDOZA",311,3,158,139,0,297,0.00964630225080386
"500770107","MENDOZA",235,6,128,99,0,227,0.025531914893617
"500630704","MENDOZA",65,0,30,33,0,63,0
"500770106","MENDOZA",246,5,164,74,0,238,0.0203252032520325
"500490909","MENDOZA",299,291,1,6,0,7,0.973244147157191
"500490902","MENDOZA",220,218,2,0,0,2,0.990909090909091
"500490811","MENDOZA",333,324,2,1,0,3,0.972972972972973
"500490804","MENDOZA",304,292,7,2,1,10,0.960526315789474
"500490802","MENDOZA",347,347,0,0,0,0,1
"500490714","MENDOZA",172,169,3,0,0,3,0.982558139534884
"500490705","MENDOZA",361,353,2,3,1,6,0.977839335180055
"500910110","MENDOZA",218,104,90,21,0,111,0.477064220183486
"740561114","SAN LUIS",121,116,5,0,0,5,0.958677685950413
"500490308","MENDOZA",287,232,16,18,0,34,0.808362369337979
"500280908","MENDOZA",365,364,0,0,0,0,0.997260273972603
"500980720","MENDOZA",187,185,1,0,0,1,0.989304812834225
"500630216","MENDOZA",214,159,7,38,0,45,0.742990654205608
"500630211","MENDOZA",331,302,16,6,0,22,0.91238670694864
"500630210","MENDOZA",209,202,3,4,0,7,0.966507177033493
"500490301","MENDOZA",255,150,35,38,8,81,0.588235294117647
"500490218","MENDOZA",289,266,0,22,0,22,0.920415224913495
"500490209","MENDOZA",295,276,6,1,0,7,0.935593220338983
"500281205","MENDOZA",270,262,5,3,0,8,0.97037037037037
"500630202","MENDOZA",320,319,1,0,0,1,0.996875
"500630106","MENDOZA",171,49,102,20,0,122,0.286549707602339
"500630103","MENDOZA",382,305,37,38,1,76,0.798429319371728
"500630102","MENDOZA",229,31,172,26,0,198,0.135371179039301
"500280201","MENDOZA",271,265,0,5,0,5,0.977859778597786
"140144805","CORDOBA",237,233,3,1,0,4,0.983122362869198
"500280702","MENDOZA",223,221,0,0,0,0,0.991031390134529
"500560607","MENDOZA",114,94,12,4,3,19,0.824561403508772
"500560605","MENDOZA",398,342,31,17,2,50,0.85929648241206
"500560408","MENDOZA",192,172,16,3,0,19,0.895833333333333
"500491309","MENDOZA",357,339,8,4,0,12,0.949579831932773
"500491216","MENDOZA",331,329,2,0,0,2,0.993957703927492
"500280109","MENDOZA",225,220,3,1,0,4,0.977777777777778
"141401206","CORDOBA",353,73,164,101,4,269,0.206798866855524
"500491208","MENDOZA",216,205,5,4,0,9,0.949074074074074
"500491207","MENDOZA",339,339,0,0,0,0,1
"500280817","MENDOZA",230,225,3,2,0,5,0.978260869565217
"500280813","MENDOZA",321,307,4,3,0,7,0.956386292834891
"500280708","MENDOZA",264,259,4,0,0,4,0.981060606060606
"500280701","MENDOZA",214,174,30,4,2,36,0.813084112149533
"500280612","MENDOZA",102,4,44,53,1,98,0.0392156862745098
"500280610","MENDOZA",321,228,39,48,1,88,0.710280373831776
"500280605","MENDOZA",274,163,29,56,2,87,0.594890510948905
"500280506","MENDOZA",266,1,151,100,6,257,0.0037593984962406
"500280406","MENDOZA",276,232,27,15,0,42,0.840579710144927
"500280311","MENDOZA",334,321,12,0,0,12,0.961077844311377
"500280307","MENDOZA",333,306,17,8,0,25,0.918918918918919
"500630807","MENDOZA",237,237,0,0,0,0,1
"500280202","MENDOZA",247,236,9,2,0,11,0.955465587044534
"500211509","MENDOZA",164,157,4,3,0,7,0.957317073170732
"500210611","MENDOZA",270,258,10,2,0,12,0.955555555555556
"500210512","MENDOZA",280,278,2,0,0,2,0.992857142857143
"500210506","MENDOZA",304,298,2,0,0,2,0.980263157894737
"500210502","MENDOZA",221,205,6,8,0,14,0.927601809954751
"500210420","MENDOZA",169,143,7,1,0,8,0.846153846153846
"500630811","MENDOZA",279,223,40,16,0,56,0.799283154121864
"500630808","MENDOZA",311,311,0,0,0,0,1
"500700612","MENDOZA",428,416,2,2,0,4,0.97196261682243
"500350212","MENDOZA",271,214,42,10,0,52,0.789667896678967
"500281910","MENDOZA",333,245,41,46,1,88,0.735735735735736
"500281908","MENDOZA",326,294,10,21,0,31,0.901840490797546
"500281508","MENDOZA",254,3,152,89,0,241,0.0118110236220472
"500281504","MENDOZA",278,229,29,18,2,49,0.823741007194245
"500210402","MENDOZA",236,227,1,7,0,8,0.961864406779661
"500210314","MENDOZA",234,232,0,2,0,2,0.991452991452991
"500210310","MENDOZA",250,245,3,2,0,5,0.98
"500210311","MENDOZA",314,307,3,3,0,6,0.977707006369427
"500281501","MENDOZA",338,84,135,68,1,204,0.248520710059172
"500281412","MENDOZA",329,327,0,0,0,0,0.993920972644377
"500281405","MENDOZA",313,309,2,2,0,4,0.987220447284345
"500281306","MENDOZA",204,184,11,9,0,20,0.901960784313726
"500281303","MENDOZA",363,345,13,3,0,16,0.950413223140496
"500210408","MENDOZA",270,264,1,3,2,6,0.977777777777778
"140144803","CORDOBA",282,276,2,0,0,2,0.978723404255319
"500210217","MENDOZA",315,294,5,14,0,19,0.933333333333333
"500210213","MENDOZA",269,231,11,22,0,33,0.858736059479554
"500210208","MENDOZA",267,266,1,0,0,1,0.99625468164794
"500210118","MENDOZA",186,183,3,0,0,3,0.983870967741935
"500210112","MENDOZA",205,199,1,2,0,3,0.970731707317073
"500140614","MENDOZA",181,3,109,48,12,169,0.0165745856353591
"500140607","MENDOZA",245,235,8,2,0,10,0.959183673469388
"500140603","MENDOZA",244,199,24,20,1,45,0.815573770491803
"500071306","MENDOZA",242,24,41,174,0,215,0.0991735537190083
"500070411","MENDOZA",165,165,0,0,0,0,1
"500071301","MENDOZA",403,312,7,62,3,72,0.774193548387097
"500071102","MENDOZA",309,307,2,0,0,2,0.993527508090615
"500211312","MENDOZA",272,271,0,0,0,0,0.996323529411765
"500211204","MENDOZA",226,193,18,10,0,28,0.853982300884956
"500211112","MENDOZA",208,206,1,1,0,2,0.990384615384615
"500211012","MENDOZA",170,165,1,0,0,1,0.970588235294118
"500211002","MENDOZA",317,314,1,1,0,2,0.990536277602524
"500210916","MENDOZA",202,194,6,2,0,8,0.96039603960396
"500070511","MENDOZA",238,237,0,1,0,1,0.995798319327731
"500070503","MENDOZA",271,254,0,0,0,0,0.937269372693727
"500210914","MENDOZA",187,178,9,0,0,9,0.951871657754011
"500210912","MENDOZA",256,255,1,0,0,1,0.99609375
"500210812","MENDOZA",203,198,3,2,0,5,0.975369458128079
"500210811","MENDOZA",380,373,6,0,0,6,0.981578947368421
"500070905","MENDOZA",295,294,1,0,0,1,0.996610169491525
"500070901","MENDOZA",223,222,1,0,0,1,0.995515695067265
"500070809","MENDOZA",188,188,0,0,0,0,1
"500070709","MENDOZA",169,169,0,0,0,0,1
"500070215","MENDOZA",178,177,0,1,0,1,0.99438202247191
"500070105","MENDOZA",266,264,1,0,0,1,0.992481203007519
"500070103","MENDOZA",313,313,0,0,0,0,1
"500070101","MENDOZA",344,341,0,1,0,1,0.991279069767442
"500070409","MENDOZA",191,191,0,0,0,0,1
"500070404","MENDOZA",181,181,0,0,0,0,1
"501051905","MENDOZA",271,265,2,2,1,5,0.977859778597786
"501051807","MENDOZA",168,99,54,15,0,69,0.589285714285714
"501050516","MENDOZA",308,232,35,38,0,73,0.753246753246753
"500631014","MENDOZA",182,161,1,5,0,6,0.884615384615385
"500631010","MENDOZA",329,309,6,13,0,19,0.939209726443769
"500630403","MENDOZA",308,4,102,187,0,289,0.012987012987013
"500350101","MENDOZA",430,417,11,1,0,12,0.969767441860465
"500281503","MENDOZA",139,0,134,5,0,139,0
"500910209","MENDOZA",311,185,102,18,0,120,0.594855305466238
"500280604","MENDOZA",385,334,26,17,0,43,0.867532467532467
"500211303","MENDOZA",382,371,11,0,0,11,0.971204188481675
"500210513","MENDOZA",241,239,2,0,0,2,0.991701244813278
"500071305","MENDOZA",217,201,5,8,0,13,0.926267281105991
"500490317","MENDOZA",306,285,6,3,0,9,0.931372549019608
"500490303","MENDOZA",322,301,3,11,0,14,0.934782608695652
"501120601","MENDOZA",147,0,90,47,3,140,0
"501260402","MENDOZA",12,0,7,5,0,12,0
"501051202","MENDOZA",125,0,30,68,9,107,0
"501050704","MENDOZA",269,2,106,109,23,238,0.00743494423791822
"501050107","MENDOZA",332,36,209,75,2,286,0.108433734939759
"500980502","MENDOZA",58,0,31,21,1,53,0
"140144802","CORDOBA",269,269,0,0,0,0,1
"500840404","MENDOZA",99,0,47,42,2,91,0
"500700420","MENDOZA",319,1,109,191,8,308,0.00313479623824451
"500700307","MENDOZA",180,1,70,96,1,167,0.00555555555555556
"500700215","MENDOZA",119,0,49,38,12,99,0
"500700212","MENDOZA",337,0,215,84,20,319,0
"500700111","MENDOZA",321,1,152,88,26,266,0.00311526479750779
"500630404","MENDOZA",102,1,43,49,1,93,0.00980392156862745
"140143115","CORDOBA",254,6,240,3,4,247,0.0236220472440945
"500840601","MENDOZA",48,0,24,14,1,39,0
"500420401","MENDOZA",68,0,23,31,0,54,0
"140144801","CORDOBA",174,171,3,0,0,3,0.982758620689655
"500560301","MENDOZA",226,1,46,67,30,143,0.00442477876106195
"500281716","MENDOZA",325,6,166,118,15,299,0.0184615384615385
"501120501","MENDOZA",86,0,34,29,2,65,0
"500840206","MENDOZA",284,153,73,44,1,118,0.538732394366197
"501120401","MENDOZA",197,0,97,69,2,168,0
"500700101","MENDOZA",240,4,43,142,8,193,0.0166666666666667
"500071311","MENDOZA",50,0,15,28,5,48,0
"500980301","MENDOZA",264,11,96,120,20,236,0.0416666666666667
"500980106","MENDOZA",399,3,207,122,17,346,0.0075187969924812
"500840105","MENDOZA",188,0,136,35,6,177,0
"140148201","CORDOBA",315,315,0,0,0,0,1
"500560101","MENDOZA",239,1,8,36,36,80,0.00418410041841004
"500490314","MENDOZA",427,1,118,258,12,388,0.00234192037470726
"501260204","MENDOZA",105,1,27,59,1,87,0.00952380952380952
"501051609","MENDOZA",211,0,29,100,38,167,0
"500980306","MENDOZA",407,21,243,134,6,383,0.0515970515970516
"500840102","MENDOZA",174,5,96,54,10,160,0.028735632183908
"500700301","MENDOZA",459,8,295,125,8,428,0.0174291938997821
"500700210","MENDOZA",359,7,192,131,8,331,0.0194986072423398
"500560407","MENDOZA",508,155,185,104,37,326,0.30511811023622
"500350404","MENDOZA",155,0,123,30,0,153,0
"500140703","MENDOZA",472,142,165,134,9,308,0.300847457627119
"500140503","MENDOZA",206,3,145,48,3,196,0.0145631067961165
"501260316","MENDOZA",225,164,36,17,0,53,0.728888888888889
"501190614","MENDOZA",393,100,45,180,19,244,0.254452926208651
"501120202","MENDOZA",250,0,177,55,1,233,0
"501050102","MENDOZA",343,2,49,202,30,281,0.00583090379008746
"500980602","MENDOZA",237,0,135,80,7,222,0
"500980503","MENDOZA",258,1,153,84,5,242,0.00387596899224806
"500980303","MENDOZA",347,6,235,84,4,323,0.0172910662824208
"500840307","MENDOZA",268,2,187,64,7,258,0.00746268656716418
"500630302","MENDOZA",224,7,64,145,0,209,0.03125
"500140506","MENDOZA",180,5,60,59,22,141,0.0277777777777778
"501051307","MENDOZA",248,172,50,25,0,75,0.693548387096774
"501051306","MENDOZA",191,142,36,11,1,48,0.743455497382199
"501190606","MENDOZA",238,231,0,0,0,0,0.970588235294118
"501190307","MENDOZA",353,290,33,21,1,55,0.821529745042493
"501190306","MENDOZA",442,389,23,23,0,46,0.880090497737557
"501051710","MENDOZA",237,148,51,31,0,82,0.624472573839662
"141400714","CORDOBA",285,26,194,62,0,256,0.0912280701754386
"501051508","MENDOZA",313,180,71,61,0,132,0.575079872204473
"501051507","MENDOZA",213,165,14,32,0,46,0.774647887323944
"501051503","MENDOZA",222,125,51,42,0,93,0.563063063063063
"501051103","MENDOZA",263,1,134,120,6,260,0.00380228136882129
"500700906","MENDOZA",197,184,11,2,0,13,0.934010152284264
"140149807","CORDOBA",414,13,295,90,5,390,0.0314009661835749
"500700806","MENDOZA",363,361,1,0,0,1,0.994490358126722
"500700709","MENDOZA",178,175,2,0,0,2,0.98314606741573
"500700708","MENDOZA",278,270,5,1,0,6,0.971223021582734
"500700702","MENDOZA",295,284,8,2,0,10,0.96271186440678
"500700607","MENDOZA",287,266,2,1,0,3,0.926829268292683
"500700505","MENDOZA",349,347,1,0,0,1,0.994269340974212
"500700503","MENDOZA",165,157,8,0,0,8,0.951515151515152
"500700502","MENDOZA",301,294,3,2,0,5,0.976744186046512
"500700423","MENDOZA",335,38,155,121,11,287,0.113432835820896
"500700404","MENDOZA",467,10,200,236,3,439,0.0214132762312634
"500700401","MENDOZA",149,31,66,50,0,116,0.208053691275168
"500631109","MENDOZA",277,273,2,0,0,2,0.985559566787004
"500490914","MENDOZA",293,286,3,3,0,6,0.976109215017065
"501050414","MENDOZA",286,216,34,33,0,67,0.755244755244755
"500770114","MENDOZA",460,22,303,129,0,432,0.0478260869565217
"500770105","MENDOZA",285,10,182,91,1,274,0.0350877192982456
"141400713","CORDOBA",347,215,102,30,0,132,0.619596541786744
"500631003","MENDOZA",256,7,118,130,0,248,0.02734375
"500630910","MENDOZA",295,278,2,1,0,3,0.942372881355932
"500491105","MENDOZA",153,0,92,58,0,150,0
"500840211","MENDOZA",308,269,32,7,0,39,0.873376623376623
"500770128","MENDOZA",4,0,3,1,0,4,0
"500770126","MENDOZA",270,1,68,186,2,256,0.0037037037037037
"140148003","CORDOBA",190,190,0,0,0,0,1
"500631012","MENDOZA",187,120,37,22,0,59,0.641711229946524
"500980408","MENDOZA",280,279,1,0,0,1,0.996428571428571
"140149806","CORDOBA",256,11,227,15,2,244,0.04296875
"501050412","MENDOZA",250,13,129,108,0,237,0.052
"501050406","MENDOZA",293,184,65,42,0,107,0.627986348122867
"501050310","MENDOZA",239,6,132,93,0,225,0.0251046025104603
"501050422","MENDOZA",102,52,36,14,0,50,0.509803921568627
"500980801","MENDOZA",340,241,58,33,2,93,0.708823529411765
"500980512","MENDOZA",393,327,60,1,0,61,0.83206106870229
"500980401","MENDOZA",248,245,2,0,1,3,0.987903225806452
"500910202","MENDOZA",548,476,31,28,0,59,0.868613138686131
"740561003","SAN LUIS",354,211,72,65,0,137,0.596045197740113
"500701013","MENDOZA",199,34,92,66,3,161,0.170854271356784
"500490913","MENDOZA",258,245,3,8,0,11,0.949612403100775
"500490805","MENDOZA",386,343,7,15,1,23,0.88860103626943
"500490713","MENDOZA",268,266,1,1,0,2,0.992537313432836
"500490711","MENDOZA",263,252,2,5,0,7,0.958174904942966
"500140610","MENDOZA",271,227,29,14,0,43,0.837638376383764
"500490704","MENDOZA",349,313,16,15,2,33,0.896848137535817
"501050511","MENDOZA",264,205,46,13,0,59,0.776515151515151
"500490414","MENDOZA",308,280,15,8,0,23,0.909090909090909
"500281006","MENDOZA",321,290,15,12,1,28,0.903426791277259
"740351111","SAN LUIS",368,223,63,78,0,141,0.605978260869565
"500490219","MENDOZA",434,417,4,5,0,9,0.960829493087558
"500490215","MENDOZA",300,296,0,0,0,0,0.986666666666667
"500490207","MENDOZA",418,371,14,8,1,23,0.88755980861244
"500490204","MENDOZA",303,290,4,1,0,5,0.957095709570957
"500281202","MENDOZA",287,285,0,0,0,0,0.993031358885017
"500281116","MENDOZA",214,194,4,7,0,11,0.906542056074766
"500140605","MENDOZA",248,211,25,11,0,36,0.850806451612903
"500281002","MENDOZA",225,200,11,13,0,24,0.888888888888889
"500630215","MENDOZA",272,262,4,3,0,7,0.963235294117647
"500490309","MENDOZA",445,174,66,161,8,235,0.391011235955056
"500490220","MENDOZA",276,256,12,7,0,19,0.927536231884058
"500281114","MENDOZA",229,227,1,0,0,1,0.991266375545852
"500071310","MENDOZA",0,0,0,0,0,0,NA
"500071204","MENDOZA",115,115,0,0,0,0,1
"500630101","MENDOZA",284,209,49,24,1,74,0.735915492957746
"500491413","MENDOZA",294,226,13,41,6,60,0.768707482993197
"500491314","MENDOZA",187,185,0,2,0,2,0.989304812834225
"500280614","MENDOZA",350,313,18,14,1,33,0.894285714285714
"500280608","MENDOZA",271,210,37,21,0,58,0.774907749077491
"500491210","MENDOZA",222,222,0,0,0,0,1
"500491209","MENDOZA",184,178,2,3,0,5,0.967391304347826
"500491117","MENDOZA",370,358,5,1,1,7,0.967567567567568
"141400712","CORDOBA",217,197,18,2,0,20,0.907834101382488
"500280814","MENDOZA",166,159,5,2,0,7,0.957831325301205
"500280811","MENDOZA",350,345,2,3,0,5,0.985714285714286
"500280810","MENDOZA",239,236,1,0,0,1,0.98744769874477
"500280801","MENDOZA",282,259,17,5,0,22,0.918439716312057
"500280601","MENDOZA",245,229,6,0,2,8,0.93469387755102
"500280512","MENDOZA",185,0,141,43,0,184,0
"500280301","MENDOZA",351,320,16,14,0,30,0.911680911680912
"500280213","MENDOZA",184,182,1,1,0,2,0.989130434782609
"141400711","CORDOBA",331,208,117,6,0,123,0.628398791540785
"500280407","MENDOZA",271,265,1,3,0,4,0.977859778597786
"500280401","MENDOZA",213,119,53,41,0,94,0.55868544600939
"500280316","MENDOZA",254,242,5,0,0,5,0.952755905511811
"500280312","MENDOZA",366,350,13,3,0,16,0.956284153005464
"500280302","MENDOZA",352,309,27,12,0,39,0.877840909090909
"500210412","MENDOZA",366,353,5,4,0,9,0.96448087431694
"500280205","MENDOZA",312,304,3,5,0,8,0.974358974358974
"500280110","MENDOZA",300,291,3,0,0,3,0.97
"500280106","MENDOZA",345,342,2,1,0,3,0.991304347826087
"500280101","MENDOZA",133,129,4,0,0,4,0.969924812030075
"500211609","MENDOZA",205,196,5,4,0,9,0.95609756097561
"500211505","MENDOZA",193,190,3,0,0,3,0.984455958549223
"500210708","MENDOZA",271,247,8,16,0,24,0.911439114391144
"500210504","MENDOZA",41,36,1,2,0,3,0.878048780487805
"500350215","MENDOZA",249,215,18,11,0,29,0.863453815261044
"500350217","MENDOZA",227,220,6,0,0,6,0.969162995594714
"500282008","MENDOZA",201,185,10,6,0,16,0.920398009950249
"740560901","SAN LUIS",260,256,3,0,0,3,0.984615384615385
"500281711","MENDOZA",135,86,47,2,0,49,0.637037037037037
"500281708","MENDOZA",268,224,29,14,0,43,0.835820895522388
"500281605","MENDOZA",380,373,2,2,0,4,0.981578947368421
"500281410","MENDOZA",260,260,0,0,0,0,1
"500281407","MENDOZA",280,275,1,4,0,5,0.982142857142857
"500281308","MENDOZA",293,259,25,9,0,34,0.883959044368601
"500281217","MENDOZA",286,272,11,2,0,13,0.951048951048951
"500281210","MENDOZA",354,310,35,7,0,42,0.875706214689266
"500210417","MENDOZA",234,227,5,0,0,5,0.97008547008547
"140149805","CORDOBA",166,8,106,52,0,158,0.0481927710843374
"500210414","MENDOZA",334,322,7,3,0,10,0.964071856287425
"740351104","SAN LUIS",237,198,17,22,0,39,0.835443037974684
"500210409","MENDOZA",307,294,10,1,0,11,0.957654723127036
"500210407","MENDOZA",229,217,6,3,1,10,0.947598253275109
"500210303","MENDOZA",170,163,7,0,0,7,0.958823529411765
"500210216","MENDOZA",346,335,5,1,0,6,0.968208092485549
"500210211","MENDOZA",244,240,4,0,0,4,0.983606557377049
"500210205","MENDOZA",249,238,4,1,0,5,0.955823293172691
"500210204","MENDOZA",348,340,1,0,0,1,0.977011494252874
"141611112","CORDOBA",318,313,3,2,0,5,0.984276729559748
"500210103","MENDOZA",106,103,2,1,0,3,0.971698113207547
"500071106","MENDOZA",362,360,2,0,0,2,0.994475138121547
"500210102","MENDOZA",278,278,0,0,0,0,1
"500140711","MENDOZA",266,193,33,38,1,72,0.725563909774436
"500140706","MENDOZA",248,66,162,18,0,180,0.266129032258065
"500140705","MENDOZA",379,4,159,187,7,353,0.0105540897097625
"500140704","MENDOZA",156,3,110,32,1,143,0.0192307692307692
"500140617","MENDOZA",253,246,6,0,1,7,0.972332015810277
"500140612","MENDOZA",343,84,172,76,4,252,0.244897959183673
"740560815","SAN LUIS",236,236,0,0,0,0,1
"500071019","MENDOZA",351,348,3,0,0,3,0.991452991452991
"740560603","SAN LUIS",248,247,0,0,0,0,0.995967741935484
"500211304","MENDOZA",319,314,4,0,0,4,0.984326018808777
"500211301","MENDOZA",198,195,2,0,0,2,0.984848484848485
"500211107","MENDOZA",218,214,4,0,0,4,0.981651376146789
"500211104","MENDOZA",200,195,2,3,0,5,0.975
"500211011","MENDOZA",179,179,0,0,0,0,1
"500211003","MENDOZA",208,207,0,0,0,0,0.995192307692308
"500071002","MENDOZA",242,239,2,1,0,3,0.987603305785124
"500070912","MENDOZA",146,143,3,0,0,3,0.979452054794521
"740560808","SAN LUIS",271,264,0,0,0,0,0.974169741697417
"740351019","SAN LUIS",357,334,7,16,0,23,0.935574229691877
"500210902","MENDOZA",300,294,3,2,0,5,0.98
"500210810","MENDOZA",269,254,7,7,0,14,0.944237918215613
"500071015","MENDOZA",156,2,30,114,4,148,0.0128205128205128
"500071014","MENDOZA",259,252,2,0,0,2,0.972972972972973
"500071012","MENDOZA",250,240,9,0,0,9,0.96
"500071008","MENDOZA",293,280,3,4,0,7,0.955631399317406
"500071005","MENDOZA",335,320,5,7,0,12,0.955223880597015
"141400709","CORDOBA",233,77,134,20,1,155,0.330472103004292
"500070904","MENDOZA",282,270,0,0,0,0,0.957446808510638
"500070811","MENDOZA",142,142,0,0,0,0,1
"500070802","MENDOZA",153,153,0,0,0,0,1
"500070611","MENDOZA",138,138,0,0,0,0,1
"500070317","MENDOZA",96,96,0,0,0,0,1
"500070312","MENDOZA",162,158,1,0,0,1,0.975308641975309
"500070302","MENDOZA",311,311,0,0,0,0,1
"500070114","MENDOZA",163,163,0,0,0,0,1
"500070112","MENDOZA",160,160,0,0,0,0,1
"500070110","MENDOZA",109,109,0,0,0,0,1
"500070108","MENDOZA",239,239,0,0,0,0,1
"500070211","MENDOZA",321,321,0,0,0,0,1
"500070204","MENDOZA",287,285,1,0,0,1,0.993031358885017
"501051305","MENDOZA",160,122,22,13,0,35,0.7625
"501051209","MENDOZA",212,0,19,113,50,182,0
"501050905","MENDOZA",201,2,107,88,3,198,0.00995024875621891
"500980307","MENDOZA",174,1,118,50,2,170,0.00574712643678161
"740070507","SAN LUIS",374,6,270,84,6,360,0.0160427807486631
"500491215","MENDOZA",389,388,0,1,0,1,0.997429305912596
"500211315","MENDOZA",223,220,3,0,0,3,0.986547085201794
"500490806","MENDOZA",289,280,6,0,0,6,0.968858131487889
"500490507","MENDOZA",376,3,129,223,1,353,0.00797872340425532
"500490504","MENDOZA",361,312,10,18,3,31,0.864265927977839
"500490401","MENDOZA",254,253,0,1,0,1,0.996062992125984
"500071003","MENDOZA",277,276,0,1,0,1,0.996389891696751
"500070803","MENDOZA",358,357,0,1,0,1,0.997206703910615
"500420201","MENDOZA",49,0,19,13,3,35,0
"501051104","MENDOZA",200,1,30,119,12,161,0.005
"501050702","MENDOZA",206,0,54,86,16,156,0
"501050604","MENDOZA",2,0,0,2,0,2,0
"501050205","MENDOZA",406,6,122,260,1,383,0.0147783251231527
"501050201","MENDOZA",4,0,1,2,0,3,0
"501050112","MENDOZA",351,10,157,173,1,331,0.0284900284900285
"501050101","MENDOZA",9,0,0,3,4,7,0
"500980701","MENDOZA",166,4,133,23,0,156,0.0240963855421687
"500910501","MENDOZA",26,0,8,6,2,16,0
"500910307","MENDOZA",283,0,79,150,14,243,0
"500910103","MENDOZA",158,11,34,88,7,129,0.069620253164557
"500840402","MENDOZA",195,0,101,89,1,191,0
"500770403","MENDOZA",109,0,3,51,14,68,0
"500700204","MENDOZA",317,0,124,132,35,291,0
"500631017","MENDOZA",377,4,189,169,8,366,0.0106100795755968
"740561505","SAN LUIS",259,257,1,0,0,1,0.992277992277992
"500350105","MENDOZA",276,5,158,85,8,251,0.0181159420289855
"500280520","MENDOZA",186,6,121,45,7,173,0.032258064516129
"500280510","MENDOZA",370,8,191,145,7,343,0.0216216216216216
"500140402","MENDOZA",115,3,42,46,2,90,0.0260869565217391
"501260203","MENDOZA",84,1,18,44,13,75,0.0119047619047619
"501260201","MENDOZA",11,0,2,5,3,10,0
"500980414","MENDOZA",22,1,13,5,0,18,0.0454545454545455
"740561503","SAN LUIS",307,257,34,14,0,48,0.837133550488599
"740561501","SAN LUIS",206,4,106,85,5,196,0.0194174757281553
"740561412","SAN LUIS",234,198,21,11,0,32,0.846153846153846
"740561017","SAN LUIS",317,292,19,6,0,25,0.921135646687697
"740560905","SAN LUIS",216,215,0,0,0,0,0.99537037037037
"740561902","SAN LUIS",53,0,16,32,0,48,0
"740561802","SAN LUIS",65,2,11,46,1,58,0.0307692307692308
"740561401","SAN LUIS",230,230,0,0,0,0,1
"740560716","SAN LUIS",303,297,3,2,0,5,0.98019801980198
"740560203","SAN LUIS",104,0,53,48,0,101,0
"740490304","SAN LUIS",286,1,237,43,0,280,0.0034965034965035
"740351018","SAN LUIS",228,177,11,35,0,46,0.776315789473684
"500140101","MENDOZA",118,0,27,65,6,98,0
"740630503","SAN LUIS",141,0,81,52,1,134,0
"740351210","SAN LUIS",337,281,11,39,0,50,0.833827893175074
"740560804","SAN LUIS",241,240,0,0,0,0,0.995850622406639
"740560708","SAN LUIS",357,354,1,0,0,1,0.991596638655462
"740560514","SAN LUIS",277,94,103,68,2,173,0.339350180505415
"740560509","SAN LUIS",406,147,192,66,0,258,0.362068965517241
"740561218","SAN LUIS",33,3,7,20,0,27,0.0909090909090909
"740561217","SAN LUIS",144,8,39,97,0,136,0.0555555555555556
"740561215","SAN LUIS",430,257,92,66,1,159,0.597674418604651
"740561110","SAN LUIS",206,159,10,7,0,17,0.771844660194175
"740561016","SAN LUIS",278,263,13,2,0,15,0.946043165467626
"740561015","SAN LUIS",291,229,55,7,0,62,0.786941580756014
"740561005","SAN LUIS",370,329,22,16,0,38,0.889189189189189
"740560909","SAN LUIS",246,242,1,0,0,1,0.983739837398374
"740560907","SAN LUIS",246,245,1,0,0,1,0.995934959349594
"740560505","SAN LUIS",206,202,4,0,0,4,0.980582524271845
"740560406","SAN LUIS",296,69,168,53,0,221,0.233108108108108
"740351101","SAN LUIS",61,0,49,11,0,60,0
"740350908","SAN LUIS",282,280,2,0,0,2,0.99290780141844
"740560403","SAN LUIS",156,64,64,19,0,83,0.41025641025641
"740560706","SAN LUIS",504,451,22,27,0,49,0.89484126984127
"740560702","SAN LUIS",341,306,15,19,0,34,0.897360703812317
"740560205","SAN LUIS",155,63,26,64,0,90,0.406451612903226
"740490103","SAN LUIS",115,0,91,23,0,114,0
"740420403","SAN LUIS",311,78,138,86,0,224,0.2508038585209
"740420405","SAN LUIS",74,33,39,2,0,41,0.445945945945946
"740420306","SAN LUIS",381,105,118,142,6,266,0.275590551181102
"740420102","SAN LUIS",46,2,27,8,0,35,0.0434782608695652
"740560711","SAN LUIS",141,126,9,2,0,11,0.893617021276596
"740351703","SAN LUIS",20,0,3,14,2,19,0
"740350814","SAN LUIS",311,303,4,4,0,8,0.97427652733119
"740351701","SAN LUIS",60,0,35,24,1,60,0
"740351601","SAN LUIS",210,58,66,81,0,147,0.276190476190476
"740351505","SAN LUIS",3,3,0,0,0,0,1
"740280408","SAN LUIS",268,40,131,76,14,221,0.149253731343284
"740280405","SAN LUIS",376,68,266,41,0,307,0.180851063829787
"740280402","SAN LUIS",166,27,77,58,3,138,0.162650602409639
"740560304","SAN LUIS",192,191,1,0,0,1,0.994791666666667
"740490412","SAN LUIS",218,3,205,8,0,213,0.0137614678899083
"740350712","SAN LUIS",263,236,18,2,0,20,0.897338403041825
"740350707","SAN LUIS",259,177,31,47,1,79,0.683397683397683
"740490411","SAN LUIS",315,4,270,40,0,310,0.0126984126984127
"740350603","SAN LUIS",34,0,14,17,1,32,0
"740490402","SAN LUIS",314,5,260,44,1,305,0.0159235668789809
"740350819","SAN LUIS",317,247,30,40,0,70,0.779179810725552
"740350303","SAN LUIS",20,0,3,15,2,20,0
"740350204","SAN LUIS",21,0,8,11,2,21,0
"740280404","SAN LUIS",326,70,207,48,0,255,0.214723926380368
"740280301","SAN LUIS",129,50,39,37,1,77,0.387596899224806
"740280205","SAN LUIS",137,1,73,49,1,123,0.0072992700729927
"740351609","SAN LUIS",254,170,47,37,0,84,0.669291338582677
"740351310","SAN LUIS",292,290,1,0,0,1,0.993150684931507
"740351307","SAN LUIS",41,41,0,0,0,0,1
"740351303","SAN LUIS",351,350,1,0,0,1,0.997150997150997
"740351216","SAN LUIS",235,13,50,157,3,210,0.0553191489361702
"740561803","SAN LUIS",13,0,0,10,0,10,0
"740561904","SAN LUIS",3,0,0,3,0,3,0
"740561703","SAN LUIS",11,0,0,6,2,8,0
"740490213","SAN LUIS",84,0,12,41,23,76,0
"740420406","SAN LUIS",18,0,14,2,2,18,0
"740561109","SAN LUIS",174,145,20,9,0,29,0.833333333333333
"740420401","SAN LUIS",20,0,5,11,2,18,0
"740561014","SAN LUIS",261,203,47,11,0,58,0.777777777777778
"740420101","SAN LUIS",18,0,3,9,0,12,0
"740350406","SAN LUIS",17,1,6,9,0,15,0.0588235294117647
"740280201","SAN LUIS",73,0,28,38,1,67,0
"740210302","SAN LUIS",37,1,21,9,1,31,0.027027027027027
"740140505","SAN LUIS",45,0,16,17,1,34,0
"740140402","SAN LUIS",61,0,15,29,0,44,0
"740140301","SAN LUIS",37,0,10,6,1,17,0
"740140201","SAN LUIS",15,0,4,8,0,12,0
"740561001","SAN LUIS",325,293,11,21,0,32,0.901538461538462
"740351218","SAN LUIS",111,13,20,78,0,98,0.117117117117117
"740070203","SAN LUIS",55,0,7,26,2,35,0
"740070202","SAN LUIS",56,1,13,27,1,41,0.0178571428571429
"740490106","SAN LUIS",46,2,31,9,0,40,0.0434782608695652
"740420103","SAN LUIS",35,0,16,12,0,28,0
"740560317","SAN LUIS",0,0,0,0,0,0,NA
"740070505","SAN LUIS",77,0,24,24,1,49,0
"740630301","SAN LUIS",159,0,46,69,3,118,0
"740561514","SAN LUIS",246,240,1,0,0,1,0.975609756097561
"740490306","SAN LUIS",214,54,128,31,1,160,0.252336448598131
"740560315","SAN LUIS",252,248,2,0,0,2,0.984126984126984
"740560104","SAN LUIS",73,0,18,50,0,68,0
"740210304","SAN LUIS",281,1,163,115,0,278,0.00355871886120996
"740350901","SAN LUIS",261,261,0,0,0,0,1
"740560615","SAN LUIS",352,330,16,4,0,20,0.9375
"740351504","SAN LUIS",83,81,1,0,0,1,0.975903614457831
"740351003","SAN LUIS",231,231,0,0,0,0,1
"740350708","SAN LUIS",299,122,124,50,0,174,0.408026755852843
"740280203","SAN LUIS",258,2,174,70,0,244,0.00775193798449612
"740561515","SAN LUIS",118,117,0,0,0,0,0.991525423728814
"740561511","SAN LUIS",277,273,0,2,0,2,0.985559566787004
"740561510","SAN LUIS",225,223,1,1,0,2,0.991111111111111
"740561417","SAN LUIS",355,352,0,0,0,0,0.991549295774648
"740561408","SAN LUIS",272,194,58,19,0,77,0.713235294117647
"740560902","SAN LUIS",267,267,0,0,0,0,1
"740560725","SAN LUIS",233,171,41,19,0,60,0.733905579399142
"740561302","SAN LUIS",157,136,14,7,0,21,0.866242038216561
"740561212","SAN LUIS",230,124,71,30,1,102,0.539130434782609
"740560501","SAN LUIS",157,46,84,25,0,109,0.292993630573248
"740560407","SAN LUIS",215,9,147,53,0,200,0.0418604651162791
"740560404","SAN LUIS",149,44,53,50,1,104,0.295302013422819
"740560305","SAN LUIS",211,211,0,0,0,0,1
"740560302","SAN LUIS",207,207,0,0,0,0,1
"740280309","SAN LUIS",236,11,192,32,0,224,0.0466101694915254
"740280308","SAN LUIS",288,17,228,42,0,270,0.0590277777777778
"740280106","SAN LUIS",250,51,137,60,0,197,0.204
"740070410","SAN LUIS",214,2,126,68,1,195,0.00934579439252336
"740070409","SAN LUIS",174,16,136,20,0,156,0.0919540229885057
"740351606","SAN LUIS",248,87,66,90,2,158,0.350806451612903
"740351405","SAN LUIS",217,190,20,6,0,26,0.875576036866359
"740351402","SAN LUIS",16,0,13,3,0,16,0
"740351305","SAN LUIS",358,356,0,1,0,1,0.994413407821229
"740351017","SAN LUIS",221,178,5,34,0,39,0.805429864253394
"740350913","SAN LUIS",274,268,6,0,0,6,0.978102189781022
"740350905","SAN LUIS",45,4,5,25,0,30,0.0888888888888889
"740350806","SAN LUIS",195,46,43,94,1,138,0.235897435897436
"740350804","SAN LUIS",347,218,33,79,3,115,0.628242074927954
"740350801","SAN LUIS",296,199,35,57,2,94,0.672297297297297
"740210306","SAN LUIS",269,17,202,48,0,250,0.0631970260223048
"740350815","SAN LUIS",274,254,9,10,0,19,0.927007299270073
"740630304","SAN LUIS",60,0,12,32,0,44,0
"740560408","SAN LUIS",55,0,15,34,0,49,0
"740351302","SAN LUIS",5,5,0,0,0,0,1
"740560707","SAN LUIS",141,130,8,3,0,11,0.921985815602837
"740280406","SAN LUIS",176,17,145,14,0,159,0.0965909090909091
"740560607","SAN LUIS",245,174,34,34,0,68,0.710204081632653
"740630502","SAN LUIS",16,0,5,8,1,14,0
"740420301","SAN LUIS",6,0,1,5,0,6,0
"740210407","SAN LUIS",29,0,3,25,0,28,0
"740210310","SAN LUIS",43,0,15,18,4,37,0
"740560102","SAN LUIS",17,0,6,8,0,14,0
"740490107","SAN LUIS",10,0,3,3,3,9,0
"740420602","SAN LUIS",31,0,20,9,2,31,0
"740350402","SAN LUIS",27,0,16,7,0,23,0
"740070306","SAN LUIS",43,0,11,17,0,28,0
"740350103","SAN LUIS",85,1,46,31,0,77,0.0117647058823529
"740280302","SAN LUIS",73,0,9,28,7,44,0
"740280110","SAN LUIS",39,0,8,15,2,25,0
"740560701","SAN LUIS",273,167,48,50,0,98,0.611721611721612
"740280109","SAN LUIS",74,0,40,30,3,73,0
"740140504","SAN LUIS",14,0,5,8,1,14,0
"740350302","SAN LUIS",36,0,15,19,0,34,0
"740350301","SAN LUIS",24,0,5,13,2,20,0
"740490208","SAN LUIS",200,3,164,31,1,196,0.015
"740560614","SAN LUIS",253,208,3,10,0,13,0.822134387351779
"740350104","SAN LUIS",18,1,4,13,0,17,0.0555555555555556
"740350101","SAN LUIS",11,0,2,9,0,11,0
"740420404","SAN LUIS",388,86,186,97,9,292,0.221649484536082
"740420204","SAN LUIS",122,2,57,46,7,110,0.0163934426229508
"740351604","SAN LUIS",230,101,75,53,0,128,0.439130434782609
"740351607","SAN LUIS",238,91,83,59,1,143,0.382352941176471
"740280401","SAN LUIS",18,0,0,16,0,16,0
"740140401","SAN LUIS",32,1,6,17,1,24,0.03125
"740630305","SAN LUIS",67,0,27,17,1,45,0
"740350716","SAN LUIS",262,252,8,2,0,10,0.961832061068702
"740070411","SAN LUIS",66,1,27,28,0,55,0.0151515151515152
"740070307","SAN LUIS",15,0,5,6,0,11,0
"740561113","SAN LUIS",236,225,4,3,0,7,0.953389830508475
"740561011","SAN LUIS",390,273,73,44,0,117,0.7
"740490416","SAN LUIS",268,137,122,7,1,130,0.511194029850746
"740210303","SAN LUIS",287,0,200,84,2,286,0
"740561508","SAN LUIS",321,295,13,11,0,24,0.919003115264797
"740561415","SAN LUIS",348,343,5,0,0,5,0.985632183908046
"740560809","SAN LUIS",242,239,3,0,0,3,0.987603305785124
"740560807","SAN LUIS",247,247,0,0,0,0,1
"740560805","SAN LUIS",240,239,0,0,0,0,0.995833333333333
"740560723","SAN LUIS",168,98,40,30,0,70,0.583333333333333
"740561704","SAN LUIS",18,0,9,9,0,18,0
"740561002","SAN LUIS",205,175,25,5,0,30,0.853658536585366
"740560910","SAN LUIS",307,306,1,0,0,1,0.996742671009772
"740560507","SAN LUIS",222,84,104,31,0,135,0.378378378378378
"740561303","SAN LUIS",249,245,2,2,0,4,0.983935742971888
"740561219","SAN LUIS",210,103,45,45,0,90,0.49047619047619
"740561213","SAN LUIS",332,227,42,58,0,100,0.683734939759036
"740561211","SAN LUIS",192,154,12,24,0,36,0.802083333333333
"740561209","SAN LUIS",228,123,31,69,0,100,0.539473684210526
"740561208","SAN LUIS",187,156,23,6,0,29,0.834224598930481
"740561121","SAN LUIS",237,215,17,3,0,20,0.907172995780591
"740561118","SAN LUIS",396,262,51,81,0,132,0.661616161616162
"740561116","SAN LUIS",168,167,1,0,0,1,0.994047619047619
"740561115","SAN LUIS",158,158,0,0,0,0,1
"740560512","SAN LUIS",397,146,149,77,7,233,0.367758186397985
"740560713","SAN LUIS",431,360,24,41,0,65,0.835266821345708
"740490401","SAN LUIS",431,1,379,45,1,425,0.00232018561484919
"740560705","SAN LUIS",473,296,79,91,0,170,0.625792811839323
"740560704","SAN LUIS",473,307,79,71,1,151,0.649048625792812
"740280310","SAN LUIS",274,40,180,51,0,231,0.145985401459854
"740560312","SAN LUIS",310,309,1,0,0,1,0.996774193548387
"740560307","SAN LUIS",266,266,0,0,0,0,1
"740560303","SAN LUIS",129,129,0,0,0,0,1
"740560610","SAN LUIS",331,228,49,44,0,93,0.688821752265861
"740490417","SAN LUIS",200,4,179,17,0,196,0.02
"740351409","SAN LUIS",285,285,0,0,0,0,1
"740351408","SAN LUIS",365,364,1,0,0,1,0.997260273972603
"740351406","SAN LUIS",372,369,0,1,0,1,0.991935483870968
"740560611","SAN LUIS",293,290,3,0,0,3,0.989761092150171
"740490415","SAN LUIS",466,4,376,80,0,456,0.00858369098712446
"740561013","SAN LUIS",288,256,25,5,0,30,0.888888888888889
"740490410","SAN LUIS",270,1,254,15,0,269,0.0037037037037037
"740280105","SAN LUIS",176,18,100,56,2,158,0.102272727272727
"740070508","SAN LUIS",300,3,244,51,0,295,0.01
"740070413","SAN LUIS",302,3,200,85,5,290,0.00993377483443709
"740350817","SAN LUIS",357,263,51,39,1,91,0.736694677871149
"740351214","SAN LUIS",339,117,101,100,3,204,0.345132743362832
"740351203","SAN LUIS",209,207,2,0,0,2,0.990430622009569
"740351112","SAN LUIS",370,48,62,247,0,309,0.12972972972973
"740351107","SAN LUIS",185,183,1,1,0,2,0.989189189189189
"740351016","SAN LUIS",347,300,32,12,0,44,0.864553314121037
"740351014","SAN LUIS",163,163,0,0,0,0,1
"740351006","SAN LUIS",402,399,0,3,0,3,0.992537313432836
"740350916","SAN LUIS",265,244,6,8,0,14,0.920754716981132
"740350813","SAN LUIS",206,165,12,27,0,39,0.800970873786408
"740350810","SAN LUIS",273,148,45,76,0,121,0.542124542124542
"740350809","SAN LUIS",258,165,21,46,0,67,0.63953488372093
"740350803","SAN LUIS",2,0,0,1,1,2,0
"740350706","SAN LUIS",234,132,25,69,3,97,0.564102564102564
"740350702","SAN LUIS",264,151,46,62,0,108,0.571969696969697
"740070402","SAN LUIS",302,0,204,65,3,272,0
"740420308","SAN LUIS",190,3,137,46,2,185,0.0157894736842105
"140982701","CORDOBA",368,8,208,131,7,346,0.0217391304347826
"740210307","SAN LUIS",376,5,290,74,0,364,0.0132978723404255
"740210308","SAN LUIS",392,19,270,97,1,368,0.048469387755102
"740210113","SAN LUIS",15,0,14,1,0,15,0
"740350818","SAN LUIS",306,182,35,83,1,119,0.594771241830065
"740210102","SAN LUIS",79,14,33,26,1,60,0.177215189873418
"740561602","SAN LUIS",60,0,19,29,0,48,0
"740561702","SAN LUIS",4,0,1,3,0,4,0
"740490102","SAN LUIS",48,0,27,15,0,42,0
"740420307","SAN LUIS",53,0,20,30,1,51,0
"740420303","SAN LUIS",23,0,13,5,2,20,0
"740351804","SAN LUIS",17,0,13,4,0,17,0
"740351801","SAN LUIS",52,0,25,20,2,47,0
"740350605","SAN LUIS",13,0,2,11,0,13,0
"740280303","SAN LUIS",12,0,4,8,0,12,0
"740210112","SAN LUIS",92,5,41,28,4,73,0.0543478260869565
"740210406","SAN LUIS",42,0,25,15,1,41,0
"740210202","SAN LUIS",42,0,5,19,7,31,0
"740280411","SAN LUIS",16,0,0,13,0,13,0
"740140501","SAN LUIS",37,0,4,15,0,19,0
"740070502","SAN LUIS",23,0,0,10,0,10,0
"740490104","SAN LUIS",73,0,58,8,0,66,0
"740351008","SAN LUIS",284,283,0,0,0,0,0.996478873239437
"740561201","SAN LUIS",489,14,199,251,3,453,0.0286298568507157
"740351806","SAN LUIS",20,0,18,2,0,20,0
"740280306","SAN LUIS",235,67,104,61,0,165,0.285106382978723
"740561513","SAN LUIS",310,309,0,0,0,0,0.996774193548387
"740561107","SAN LUIS",379,363,6,9,0,15,0.95778364116095
"740561418","SAN LUIS",316,220,32,46,0,78,0.69620253164557
"740560904","SAN LUIS",161,161,0,0,0,0,1
"740560814","SAN LUIS",229,227,1,0,0,1,0.991266375545852
"740560726","SAN LUIS",345,268,30,40,0,70,0.776811594202899
"740560714","SAN LUIS",253,251,2,0,0,2,0.992094861660079
"740560513","SAN LUIS",359,155,94,86,0,180,0.431754874651811
"740561306","SAN LUIS",136,107,26,3,0,29,0.786764705882353
"740561301","SAN LUIS",183,168,10,5,0,15,0.918032786885246
"740561205","SAN LUIS",235,183,14,37,0,51,0.778723404255319
"740561202","SAN LUIS",296,67,55,160,1,216,0.226351351351351
"740561122","SAN LUIS",322,256,45,20,0,65,0.795031055900621
"740351201","SAN LUIS",283,276,2,3,1,6,0.975265017667845
"740561120","SAN LUIS",216,195,11,7,0,18,0.902777777777778
"740560712","SAN LUIS",324,290,15,10,1,26,0.895061728395062
"740420207","SAN LUIS",350,1,212,113,12,337,0.00285714285714286
"740350407","SAN LUIS",167,0,79,62,1,142,0
"740560311","SAN LUIS",351,349,0,0,0,0,0.994301994301994
"740560310","SAN LUIS",332,331,0,0,0,0,0.996987951807229
"740351401","SAN LUIS",389,369,12,6,0,18,0.948586118251928
"740351308","SAN LUIS",347,347,0,0,0,0,1
"740351213","SAN LUIS",160,100,21,35,0,56,0.625
"740560309","SAN LUIS",0,0,0,0,0,0,NA
"740561012","SAN LUIS",414,340,49,24,0,73,0.821256038647343
"740490414","SAN LUIS",262,4,239,15,0,254,0.0152671755725191
"740560609","SAN LUIS",303,257,26,18,1,45,0.848184818481848
"740070510","SAN LUIS",210,13,161,25,3,189,0.0619047619047619
"740351204","SAN LUIS",216,216,0,0,0,0,1
"740070504","SAN LUIS",117,5,66,37,4,107,0.0427350427350427
"740070407","SAN LUIS",220,7,183,26,0,209,0.0318181818181818
"740351403","SAN LUIS",304,301,1,2,0,3,0.990131578947368
"740351114","SAN LUIS",316,170,11,130,0,141,0.537974683544304
"740351010","SAN LUIS",191,148,16,24,0,40,0.774869109947644
"740351007","SAN LUIS",322,320,1,0,0,1,0.993788819875776
"740351005","SAN LUIS",432,418,7,7,0,14,0.967592592592593
"740351001","SAN LUIS",455,416,12,25,0,37,0.914285714285714
"740350714","SAN LUIS",272,268,0,3,0,3,0.985294117647059
"740350704","SAN LUIS",206,124,13,64,0,77,0.601941747572815
"740350701","SAN LUIS",26,0,10,16,0,26,0
"740070305","SAN LUIS",339,58,198,68,0,266,0.171091445427729
"740350816","SAN LUIS",242,234,3,3,0,6,0.966942148760331
"740351209","SAN LUIS",335,182,76,68,0,144,0.543283582089552
"141820612","CORDOBA",325,99,123,95,1,219,0.304615384615385
"740560715","SAN LUIS",247,246,0,0,0,0,0.995951417004049
"740630401","SAN LUIS",119,0,29,42,1,72,0
"740561705","SAN LUIS",24,0,7,11,1,19,0
"740350403","SAN LUIS",42,1,14,22,1,37,0.0238095238095238
"740560612","SAN LUIS",296,265,2,3,0,5,0.89527027027027
"740560202","SAN LUIS",85,5,44,29,0,73,0.0588235294117647
"740560401","SAN LUIS",61,2,25,21,1,47,0.0327868852459016
"740350401","SAN LUIS",23,0,8,10,0,18,0
"740420205","SAN LUIS",92,0,42,38,0,80,0
"740351803","SAN LUIS",34,0,6,10,0,16,0
"740351705","SAN LUIS",55,0,15,38,0,53,0
"740350405","SAN LUIS",12,0,6,5,0,11,0
"740561504","SAN LUIS",112,66,29,17,0,46,0.589285714285714
"740280204","SAN LUIS",92,0,36,49,2,87,0
"740210403","SAN LUIS",26,4,9,12,0,21,0.153846153846154
"740561416","SAN LUIS",341,326,5,3,0,8,0.956011730205279
"740561411","SAN LUIS",175,158,12,5,0,17,0.902857142857143
"740210404","SAN LUIS",47,5,23,18,0,41,0.106382978723404
"740560813","SAN LUIS",239,238,0,0,0,0,0.99581589958159
"740560810","SAN LUIS",301,300,0,0,0,0,0.996677740863787
"740140203","SAN LUIS",26,0,0,18,1,19,0
"740140102","SAN LUIS",47,0,13,22,2,37,0
"740070401","SAN LUIS",127,0,68,44,2,114,0
"740351211","SAN LUIS",147,146,0,1,0,1,0.993197278911565
"740420208","SAN LUIS",353,4,211,113,10,334,0.0113314447592068
"740070301","SAN LUIS",11,0,3,6,0,9,0
"740560802","SAN LUIS",343,61,87,185,1,273,0.177842565597668
"740560801","SAN LUIS",270,63,64,137,0,201,0.233333333333333
"740070102","SAN LUIS",71,0,14,21,6,41,0
"740420501","SAN LUIS",28,0,7,11,5,23,0
"740351002","SAN LUIS",203,198,5,0,0,5,0.975369458128079
"141820611","CORDOBA",202,194,8,0,0,8,0.96039603960396
"740560402","SAN LUIS",84,27,44,11,0,55,0.321428571428571
"740560721","SAN LUIS",391,298,47,42,1,90,0.762148337595908
"740561701","SAN LUIS",34,1,7,23,0,30,0.0294117647058824
"740630202","SAN LUIS",140,0,9,75,15,99,0
"740561506","SAN LUIS",312,309,2,0,0,2,0.990384615384615
"740560510","SAN LUIS",262,154,89,18,0,107,0.587786259541985
"740560506","SAN LUIS",284,87,103,85,0,188,0.306338028169014
"740561406","SAN LUIS",342,258,60,23,0,83,0.754385964912281
"740561308","SAN LUIS",249,173,32,44,0,76,0.694779116465863
"740561216","SAN LUIS",392,369,16,3,0,19,0.941326530612245
"740561214","SAN LUIS",293,280,5,0,0,5,0.955631399317406
"740561210","SAN LUIS",206,121,60,22,0,82,0.587378640776699
"740560405","SAN LUIS",146,61,75,10,0,85,0.417808219178082
"740560318","SAN LUIS",8,8,0,0,0,0,1
"740560608","SAN LUIS",159,127,31,1,0,32,0.79874213836478
"740490209","SAN LUIS",255,2,238,15,0,253,0.00784313725490196
"740490204","SAN LUIS",259,2,212,41,1,254,0.00772200772200772
"740351603","SAN LUIS",195,104,64,27,0,91,0.533333333333333
"740351506","SAN LUIS",7,0,1,3,3,7,0
"740350404","SAN LUIS",50,1,16,30,0,46,0.02
"740560313","SAN LUIS",336,335,1,0,0,1,0.99702380952381
"740490419","SAN LUIS",186,0,177,7,0,184,0
"740350906","SAN LUIS",243,199,13,30,0,43,0.818930041152263
"740490409","SAN LUIS",200,0,179,18,0,197,0
"740490405","SAN LUIS",459,1,420,34,0,454,0.00217864923747277
"740490404","SAN LUIS",172,2,157,12,0,169,0.0116279069767442
"740350904","SAN LUIS",289,156,36,94,0,130,0.539792387543253
"740280107","SAN LUIS",332,56,166,64,0,230,0.168674698795181
"740210309","SAN LUIS",189,2,177,9,0,186,0.0105820105820106
"740070509","SAN LUIS",265,3,205,53,0,258,0.0113207547169811
"740351410","SAN LUIS",339,338,1,0,0,1,0.997050147492625
"740351404","SAN LUIS",294,269,0,0,0,0,0.914965986394558
"740351311","SAN LUIS",296,295,0,0,0,0,0.996621621621622
"740351309","SAN LUIS",348,348,0,0,0,0,1
"740351217","SAN LUIS",169,114,24,25,3,52,0.674556213017751
"740351205","SAN LUIS",320,319,1,0,0,1,0.996875
"740351202","SAN LUIS",263,256,3,4,0,7,0.973384030418251
"740350915","SAN LUIS",249,230,6,13,0,19,0.923694779116466
"740350914","SAN LUIS",299,277,16,5,0,21,0.926421404682274
"740350903","SAN LUIS",276,270,4,0,0,4,0.978260869565217
"740350808","SAN LUIS",261,250,4,7,0,11,0.957854406130268
"740350713","SAN LUIS",372,334,21,17,0,38,0.897849462365591
"740070304","SAN LUIS",372,31,179,133,4,316,0.0833333333333333
"740210106","SAN LUIS",46,3,29,14,0,43,0.0652173913043478
"740351612","SAN LUIS",264,168,69,22,3,94,0.636363636363636
"740140303","SAN LUIS",47,0,1,30,1,32,0
"740630101","SAN LUIS",83,0,15,15,2,32,0
"740561801","SAN LUIS",4,0,0,4,0,4,0
"740351704","SAN LUIS",55,1,13,34,0,47,0.0181818181818182
"740070412","SAN LUIS",8,0,2,6,0,8,0
"740561706","SAN LUIS",5,0,0,3,0,3,0
"740490201","SAN LUIS",66,0,23,28,4,55,0
"740490101","SAN LUIS",29,0,14,11,1,26,0
"740420201","SAN LUIS",27,0,22,4,0,26,0
"740490205","SAN LUIS",195,1,163,31,0,194,0.00512820512820513
"740420305","SAN LUIS",31,0,15,10,5,30,0
"740561601","SAN LUIS",94,0,33,47,1,81,0
"740490207","SAN LUIS",215,1,171,34,0,205,0.00465116279069767
"140144607","CORDOBA",250,227,17,5,1,23,0.908
"740350502","SAN LUIS",22,0,3,17,0,20,0
"740280202","SAN LUIS",177,1,95,73,0,168,0.00564971751412429
"740561404","SAN LUIS",344,326,11,7,0,18,0.947674418604651
"740561312","SAN LUIS",241,195,29,17,0,46,0.809128630705394
"740561311","SAN LUIS",352,302,31,17,0,48,0.857954545454545
"740561119","SAN LUIS",210,177,8,23,0,31,0.842857142857143
"740351110","SAN LUIS",306,289,4,9,0,13,0.944444444444444
"740350304","SAN LUIS",66,4,44,18,0,62,0.0606060606060606
"740210311","SAN LUIS",29,0,15,11,0,26,0
"740280101","SAN LUIS",52,0,16,21,6,43,0
"740561105","SAN LUIS",262,249,8,5,0,13,0.950381679389313
"740140404","SAN LUIS",157,0,42,84,4,130,0
"740140302","SAN LUIS",37,0,12,20,0,32,0
"740070503","SAN LUIS",12,0,2,10,0,12,0
"740560916","SAN LUIS",136,109,14,13,0,27,0.801470588235294
"740560908","SAN LUIS",288,287,1,0,0,1,0.996527777777778
"740070501","SAN LUIS",23,0,6,12,0,18,0
"740561104","SAN LUIS",278,221,19,38,0,57,0.794964028776978
"740210105","SAN LUIS",73,4,24,26,1,51,0.0547945205479452
"740070303","SAN LUIS",46,0,12,22,1,35,0
"740561901","SAN LUIS",28,0,5,18,0,23,0
"740490303","SAN LUIS",423,1,325,84,2,411,0.00236406619385343
"740561103","SAN LUIS",352,319,14,19,0,33,0.90625
"740630504","SAN LUIS",119,0,40,43,4,87,0
"740561101","SAN LUIS",254,205,16,32,0,48,0.807086614173228
"740561117","SAN LUIS",225,218,5,2,0,7,0.968888888888889
"740560601","SAN LUIS",8,2,2,2,2,6,0.25
"740630402","SAN LUIS",149,0,18,42,5,65,0
"740351304","SAN LUIS",355,355,0,0,0,0,1
"740210405","SAN LUIS",308,115,135,36,0,171,0.373376623376623
"740630302","SAN LUIS",60,1,37,20,0,57,0.0166666666666667
"740561410","SAN LUIS",183,169,7,7,0,14,0.923497267759563
"740561409","SAN LUIS",290,234,33,22,0,55,0.806896551724138
"740560718","SAN LUIS",205,190,5,10,0,15,0.926829268292683
"740280311","SAN LUIS",250,17,200,29,0,229,0.068
"740560308","SAN LUIS",283,283,0,0,0,0,1
"740490413","SAN LUIS",367,10,313,44,0,357,0.0272479564032698
"740490408","SAN LUIS",182,0,170,12,0,182,0
"740490406","SAN LUIS",437,5,397,32,0,429,0.011441647597254
"740210401","SAN LUIS",87,2,63,22,0,85,0.0229885057471264
"740350902","SAN LUIS",274,268,4,2,0,6,0.978102189781022
"740070414","SAN LUIS",331,1,240,68,0,308,0.00302114803625378
"740351605","SAN LUIS",192,42,71,77,2,150,0.21875
"740351407","SAN LUIS",315,315,0,0,0,0,1
"740351301","SAN LUIS",281,278,1,0,0,1,0.98932384341637
"740351215","SAN LUIS",252,49,46,150,1,197,0.194444444444444
"740351206","SAN LUIS",234,176,12,45,0,57,0.752136752136752
"740351102","SAN LUIS",217,46,63,103,1,167,0.211981566820276
"740351020","SAN LUIS",45,0,39,4,1,44,0
"740351012","SAN LUIS",201,201,0,0,0,0,1
"740350907","SAN LUIS",360,315,16,27,0,43,0.875
"740350821","SAN LUIS",25,2,0,22,0,22,0.08
"740350805","SAN LUIS",339,279,22,31,0,53,0.823008849557522
"740350715","SAN LUIS",205,199,4,2,0,6,0.970731707317073
"740070405","SAN LUIS",272,16,212,41,1,254,0.0588235294117647
"740210109","SAN LUIS",142,76,40,23,0,63,0.535211267605634
"740210108","SAN LUIS",75,41,23,10,0,33,0.546666666666667
"740210305","SAN LUIS",441,7,378,49,1,428,0.0158730158730159
"740560511","SAN LUIS",127,116,9,2,0,11,0.913385826771654
"740490210","SAN LUIS",187,1,155,29,1,185,0.0053475935828877
"740140503","SAN LUIS",165,10,83,58,1,142,0.0606060606060606
"740140403","SAN LUIS",208,4,153,46,0,199,0.0192307692307692
"740351108","SAN LUIS",176,176,0,0,0,0,1
"740561903","SAN LUIS",5,0,0,5,0,5,0
"740560911","SAN LUIS",227,226,1,0,0,1,0.995594713656388
"740630501","SAN LUIS",39,0,3,17,6,26,0
"740561804","SAN LUIS",13,0,0,10,0,10,0
"740351805","SAN LUIS",29,0,10,18,0,28,0
"140143716","CORDOBA",192,184,4,4,0,8,0.958333333333333
"740561603","SAN LUIS",47,0,4,29,0,33,0
"740560616","SAN LUIS",250,217,17,16,0,33,0.868
"740560515","SAN LUIS",32,0,5,16,0,21,0
"740560201","SAN LUIS",62,2,24,36,0,60,0.032258064516129
"740490301","SAN LUIS",102,0,70,29,0,99,0
"740420601","SAN LUIS",23,0,10,13,0,23,0
"740420502","SAN LUIS",7,0,0,7,0,7,0
"740351103","SAN LUIS",263,233,4,26,0,30,0.885931558935361
"740140204","SAN LUIS",14,0,5,8,0,13,0
"140982107","CORDOBA",233,231,2,0,0,2,0.991416309012876
"740280307","SAN LUIS",23,0,17,6,0,23,0
"740280305","SAN LUIS",40,0,12,21,2,35,0
"740351602","SAN LUIS",210,87,75,43,0,118,0.414285714285714
"740561220","SAN LUIS",280,212,38,29,0,67,0.757142857142857
"740210204","SAN LUIS",64,0,20,34,3,57,0
"740490211","SAN LUIS",132,6,93,33,0,126,0.0454545454545455
"740351105","SAN LUIS",169,158,5,6,0,11,0.93491124260355
"740210103","SAN LUIS",48,0,12,28,1,41,0
"740350711","SAN LUIS",246,138,44,57,3,104,0.560975609756098
"740350705","SAN LUIS",218,134,36,39,1,76,0.614678899082569
"740280410","SAN LUIS",51,0,12,24,11,47,0
"740140406","SAN LUIS",28,0,1,21,0,22,0
"740560906","SAN LUIS",262,257,3,0,0,3,0.980916030534351
"740560812","SAN LUIS",291,290,1,0,0,1,0.996563573883162
"740560101","SAN LUIS",34,1,7,21,1,29,0.0294117647058824
"740350703","SAN LUIS",297,154,60,60,0,120,0.518518518518518
"740561206","SAN LUIS",241,181,35,23,0,58,0.75103734439834
"740070506","SAN LUIS",76,0,18,33,0,51,0
"740070101","SAN LUIS",47,0,14,13,2,29,0
"740560811","SAN LUIS",177,176,1,0,0,1,0.994350282485876
"740560803","SAN LUIS",228,226,1,0,0,1,0.991228070175439
"740420402","SAN LUIS",62,0,35,21,2,58,0
"740351502","SAN LUIS",135,2,103,29,0,132,0.0148148148148148
"740560722","SAN LUIS",240,165,57,18,0,75,0.6875
"740420603","SAN LUIS",308,4,215,75,5,295,0.012987012987013
"740560204","SAN LUIS",499,259,60,127,19,206,0.519038076152305
"740420206","SAN LUIS",84,4,77,3,0,80,0.0476190476190476
"140143715","CORDOBA",217,212,3,1,0,4,0.976958525345622
"740210203","SAN LUIS",113,1,15,55,8,78,0.00884955752212389
"740351212","SAN LUIS",181,177,1,3,0,4,0.977900552486188
"740561707","SAN LUIS",246,0,99,134,5,238,0
"740561204","SAN LUIS",393,385,4,1,0,5,0.979643765903308
"740561108","SAN LUIS",259,242,9,8,0,17,0.934362934362934
"740560314","SAN LUIS",285,278,1,0,0,1,0.975438596491228
"740070408","SAN LUIS",266,15,212,37,2,251,0.056390977443609
"740630102","SAN LUIS",224,70,62,85,3,150,0.3125
"740561507","SAN LUIS",314,289,18,3,0,21,0.920382165605096
"740561502","SAN LUIS",227,191,22,7,0,29,0.841409691629956
"740561414","SAN LUIS",313,246,33,26,0,59,0.78594249201278
"740560720","SAN LUIS",308,217,53,28,2,83,0.704545454545455
"740560508","SAN LUIS",310,146,79,83,1,163,0.470967741935484
"740561403","SAN LUIS",302,279,16,6,0,22,0.923841059602649
"740561207","SAN LUIS",228,175,48,0,0,48,0.767543859649123
"740561112","SAN LUIS",228,224,3,1,0,4,0.982456140350877
"740561106","SAN LUIS",265,236,16,9,0,25,0.890566037735849
"740561010","SAN LUIS",301,296,2,3,0,5,0.983388704318937
"740561007","SAN LUIS",320,319,0,0,0,0,0.996875
"740560915","SAN LUIS",282,281,0,0,0,0,0.99645390070922
"740560914","SAN LUIS",226,213,13,0,0,13,0.942477876106195
"740560913","SAN LUIS",67,67,0,0,0,0,1
"740560912","SAN LUIS",161,160,1,0,0,1,0.993788819875776
"740351011","SAN LUIS",289,261,24,1,0,25,0.903114186851211
"740560503","SAN LUIS",102,18,32,44,0,76,0.176470588235294
"740560605","SAN LUIS",362,249,68,41,0,109,0.687845303867403
"740560604","SAN LUIS",224,224,0,0,0,0,1
"740560502","SAN LUIS",347,239,54,42,1,97,0.688760806916426
"740490305","SAN LUIS",230,3,194,32,0,226,0.0130434782608696
"740560703","SAN LUIS",25,16,0,9,0,9,0.64
"740350601","SAN LUIS",73,0,12,38,12,62,0
"740350820","SAN LUIS",193,180,10,3,0,13,0.932642487046632
"740280403","SAN LUIS",321,45,237,38,0,275,0.14018691588785
"740560316","SAN LUIS",339,337,2,0,0,2,0.994100294985251
"740560306","SAN LUIS",329,328,0,0,0,0,0.996960486322188
"740350917","SAN LUIS",275,156,50,54,1,105,0.567272727272727
"140982106","CORDOBA",198,196,1,0,0,1,0.98989898989899
"740070404","SAN LUIS",248,0,135,89,2,226,0
"740210110","SAN LUIS",90,61,21,7,0,28,0.677777777777778
"740351207","SAN LUIS",246,145,32,60,1,93,0.589430894308943
"740490418","SAN LUIS",186,1,161,22,0,183,0.00537634408602151
"740560301","SAN LUIS",9,9,0,0,0,0,1
"740490407","SAN LUIS",243,3,209,29,0,238,0.0123456790123457
"740280108","SAN LUIS",63,7,34,19,0,53,0.111111111111111
"740070406","SAN LUIS",224,9,192,21,0,213,0.0401785714285714
"740351208","SAN LUIS",278,139,47,85,5,137,0.5
"740351113","SAN LUIS",218,34,42,122,0,164,0.155963302752294
"740210107","SAN LUIS",79,13,41,23,1,65,0.164556962025316
"740140405","SAN LUIS",182,57,87,37,0,124,0.313186813186813
"740140304","SAN LUIS",52,39,4,7,1,12,0.75
"740490203","SAN LUIS",51,0,11,28,1,40,0
"740561413","SAN LUIS",285,238,29,18,0,47,0.835087719298246
"740561407","SAN LUIS",205,108,40,54,1,95,0.526829268292683
"740490202","SAN LUIS",59,0,5,26,4,35,0
"740490105","SAN LUIS",41,0,5,23,8,36,0
"740420304","SAN LUIS",235,30,107,87,4,198,0.127659574468085
"141610811","CORDOBA",184,125,44,14,0,58,0.679347826086957
"740420203","SAN LUIS",19,0,14,5,0,19,0
"740351503","SAN LUIS",55,3,13,28,4,45,0.0545454545454545
"740560903","SAN LUIS",273,273,0,0,0,0,1
"740350602","SAN LUIS",78,0,35,39,1,75,0
"740350501","SAN LUIS",35,2,14,16,1,31,0.0571428571428571
"740350305","SAN LUIS",21,0,11,9,0,20,0
"740350205","SAN LUIS",13,0,9,3,0,12,0
"740350201","SAN LUIS",10,0,10,0,0,10,0
"740560806","SAN LUIS",99,99,0,0,0,0,1
"740560724","SAN LUIS",224,153,41,30,0,71,0.683035714285714
"740560719","SAN LUIS",286,248,26,7,0,33,0.867132867132867
"740561305","SAN LUIS",238,224,9,5,0,14,0.941176470588235
"740350102","SAN LUIS",13,0,4,9,0,13,0
"740350202","SAN LUIS",6,0,2,4,0,6,0
"740140103","SAN LUIS",26,0,3,15,0,18,0
"740280206","SAN LUIS",188,1,121,64,0,185,0.00531914893617021
"740561512","SAN LUIS",291,284,5,0,0,5,0.975945017182131
"140143714","CORDOBA",207,195,8,2,1,11,0.942028985507246
"740070302","SAN LUIS",24,0,8,8,2,18,0
"740070201","SAN LUIS",67,0,8,29,1,38,0
"740560103","SAN LUIS",56,0,1,37,3,41,0
"740351610","SAN LUIS",358,246,81,28,0,109,0.687150837988827
"740561006","SAN LUIS",321,319,1,0,0,1,0.993769470404984
"740350203","SAN LUIS",26,0,14,11,1,26,0
"740561203","SAN LUIS",426,405,4,14,1,19,0.950704225352113
"740561111","SAN LUIS",204,198,6,0,0,6,0.970588235294118
"740561102","SAN LUIS",360,293,15,45,0,60,0.813888888888889
"740561018","SAN LUIS",341,325,10,6,0,16,0.953079178885631
"740561009","SAN LUIS",133,68,10,3,0,13,0.511278195488722
"740561008","SAN LUIS",217,217,0,0,0,0,1
"740561004","SAN LUIS",275,213,38,21,0,59,0.774545454545455
"740560504","SAN LUIS",212,212,0,0,0,0,1
"740560606","SAN LUIS",413,328,38,40,1,79,0.794188861985472
"740560617","SAN LUIS",384,298,48,27,0,75,0.776041666666667
"740560206","SAN LUIS",334,148,31,134,6,171,0.44311377245509
"740490206","SAN LUIS",253,0,177,70,3,250,0
"740351507","SAN LUIS",22,0,18,3,0,21,0
"740280409","SAN LUIS",66,35,14,10,2,26,0.53030303030303
"740560710","SAN LUIS",376,263,63,35,0,98,0.699468085106383
"740350807","SAN LUIS",155,89,32,31,0,63,0.574193548387097
"740560105","SAN LUIS",175,0,82,85,4,171,0
"740490403","SAN LUIS",197,2,162,29,0,191,0.0101522842639594
"740280104","SAN LUIS",175,34,137,2,0,139,0.194285714285714
"740280103","SAN LUIS",294,63,184,46,0,230,0.214285714285714
"740280102","SAN LUIS",330,45,176,100,0,276,0.136363636363636
"740351608","SAN LUIS",235,158,61,16,0,77,0.672340425531915
"740350710","SAN LUIS",343,138,76,124,1,201,0.402332361516035
"740351004","SAN LUIS",276,272,3,0,0,3,0.985507246376812
"740070403","SAN LUIS",157,6,104,36,2,142,0.0382165605095541
"740210111","SAN LUIS",84,83,0,0,1,1,0.988095238095238
"740350709","SAN LUIS",224,117,59,43,1,103,0.522321428571429
"740630303","SAN LUIS",80,0,10,31,7,48,0
"740280304","SAN LUIS",75,0,26,43,1,70,0
"740630201","SAN LUIS",74,0,2,26,2,30,0
"740561805","SAN LUIS",5,0,0,5,0,5,0
"740490302","SAN LUIS",43,0,32,11,0,43,0
"740490212","SAN LUIS",44,0,30,11,3,44,0
"740351802","SAN LUIS",37,0,14,21,0,35,0
"140142916","CORDOBA",305,283,17,3,0,20,0.927868852459016
"740351702","SAN LUIS",65,1,28,32,0,60,0.0153846153846154
"740351501","SAN LUIS",11,0,9,2,0,11,0
"740350604","SAN LUIS",13,0,3,9,0,12,0
"740210402","SAN LUIS",12,1,5,4,0,9,0.0833333333333333
"140143607","CORDOBA",262,258,2,1,0,3,0.984732824427481
"140142702","CORDOBA",323,242,73,6,0,79,0.74922600619195
"740210301","SAN LUIS",16,0,4,9,2,15,0
"740210201","SAN LUIS",56,0,8,33,0,41,0
"740140202","SAN LUIS",20,0,4,6,1,11,0
"740210104","SAN LUIS",26,0,2,18,0,20,0
"740210101","SAN LUIS",20,0,0,15,0,15,0
"140140109","CORDOBA",399,7,338,47,2,387,0.0175438596491228
"141610702","CORDOBA",175,3,172,0,0,172,0.0171428571428571
"740140502","SAN LUIS",36,0,5,11,2,18,0
"140140108","CORDOBA",233,3,209,20,0,229,0.0128755364806867
"140146002","CORDOBA",246,233,10,3,0,13,0.947154471544715
"740140101","SAN LUIS",8,0,4,2,1,7,0
"141750202","CORDOBA",155,0,87,56,2,145,0
"141470304","CORDOBA",125,1,94,20,5,119,0.008
"141470302","CORDOBA",105,1,69,16,14,99,0.00952380952380952
"140700210","CORDOBA",88,0,43,16,2,61,0
"140280706","CORDOBA",79,2,28,14,2,44,0.0253164556962025
"140210103","CORDOBA",52,0,38,5,7,50,0
"140070201","CORDOBA",94,1,79,10,3,92,0.0106382978723404
"141750209","CORDOBA",140,0,66,33,6,105,0
"140142701","CORDOBA",251,233,11,5,0,16,0.928286852589641
"140145716","CORDOBA",107,107,0,0,0,0,1
"140145715","CORDOBA",311,311,0,0,0,0,1
"140145519","CORDOBA",285,284,0,0,0,0,0.996491228070175
"141820702","CORDOBA",76,1,25,45,3,73,0.0131578947368421
"141750101","CORDOBA",35,0,8,3,13,24,0
"141820202","CORDOBA",108,0,41,59,7,107,0
"141680309","CORDOBA",51,0,26,22,2,50,0
"141680108","CORDOBA",90,0,53,26,3,82,0
"141610503","CORDOBA",92,0,43,41,6,90,0
"141610407","CORDOBA",84,1,66,6,5,77,0.0119047619047619
"140140607","CORDOBA",439,11,373,43,5,421,0.0250569476082005
"141610401","CORDOBA",53,0,34,17,0,51,0
"141540107","CORDOBA",34,0,19,8,2,29,0
"141540102","CORDOBA",45,0,31,6,1,38,0
"141470305","CORDOBA",87,0,42,12,21,75,0
"140140606","CORDOBA",277,62,189,15,2,206,0.223826714801444
"141470303","CORDOBA",129,2,85,21,10,116,0.0155038759689922
"140141310","CORDOBA",166,2,85,49,4,138,0.0120481927710843
"140141306","CORDOBA",186,4,111,67,1,179,0.021505376344086
"140141201","CORDOBA",258,5,121,108,0,229,0.0193798449612403
"140141018","CORDOBA",198,154,40,0,4,44,0.777777777777778
"140141001","CORDOBA",157,149,6,2,0,8,0.949044585987261
"140140502","CORDOBA",342,272,60,2,0,62,0.795321637426901
"141821208","CORDOBA",205,138,46,21,0,67,0.673170731707317
"141610815","CORDOBA",218,6,158,45,2,205,0.0275229357798165
"140140404","CORDOBA",272,29,187,55,1,243,0.106617647058824
"140140812","CORDOBA",256,204,12,40,0,52,0.796875
"140140504","CORDOBA",384,282,69,12,3,84,0.734375
"140210205","CORDOBA",97,4,74,14,2,90,0.0412371134020619
"140140705","CORDOBA",310,7,221,75,1,297,0.0225806451612903
"141470204","CORDOBA",215,3,142,44,8,194,0.013953488372093
"140140503","CORDOBA",241,212,7,11,4,22,0.879668049792531
"141050106","CORDOBA",79,3,44,20,6,70,0.0379746835443038
"140140309","CORDOBA",359,11,187,142,4,333,0.0306406685236769
"140140301","CORDOBA",127,3,92,32,0,124,0.0236220472440945
"141821312","CORDOBA",252,3,155,72,15,242,0.0119047619047619
"140143903","CORDOBA",345,344,1,0,0,1,0.997101449275362
"140631209","CORDOBA",341,281,11,45,3,59,0.824046920821114
"141470103","CORDOBA",173,2,78,60,11,149,0.0115606936416185
"140145518","CORDOBA",136,136,0,0,0,0,1
"140141407","CORDOBA",390,9,357,18,2,377,0.0230769230769231
"140140101","CORDOBA",160,112,4,37,1,42,0.7
"141540212","CORDOBA",90,0,87,3,0,90,0
"141821202","CORDOBA",188,99,70,16,1,87,0.526595744680851
"141821201","CORDOBA",214,128,75,10,0,85,0.598130841121495
"140140201","CORDOBA",241,174,57,7,3,67,0.721991701244813
"141400804","CORDOBA",177,0,100,56,10,166,0
"141400801","CORDOBA",161,0,89,42,15,146,0
"140144404","CORDOBA",208,5,185,16,0,201,0.0240384615384615
"141330408","CORDOBA",129,0,88,24,8,120,0
"140145209","CORDOBA",187,162,23,1,1,25,0.866310160427808
"140070715","CORDOBA",77,0,17,37,11,65,0
"140070307","CORDOBA",32,0,27,1,3,31,0
"140910605","CORDOBA",21,0,13,7,0,20,0
"140070704","CORDOBA",6,0,2,2,1,5,0
"141400204","CORDOBA",95,0,71,17,5,93,0
"141050103","CORDOBA",124,1,81,30,5,116,0.00806451612903226
"140142616","CORDOBA",267,263,1,3,0,4,0.98501872659176
"140070602","CORDOBA",84,0,59,20,1,80,0
"140910802","CORDOBA",74,0,57,12,3,72,0
"140280101","CORDOBA",25,0,1,10,10,21,0
"140070407","CORDOBA",79,0,69,5,2,76,0
"140070703","CORDOBA",13,0,7,3,0,10,0
"140070701","CORDOBA",24,0,13,7,0,20,0
"140070413","CORDOBA",25,0,20,3,1,24,0
"140070103","CORDOBA",79,1,58,8,6,72,0.0126582278481013
"140070102","CORDOBA",123,1,63,20,13,96,0.00813008130081301
"140070107","CORDOBA",10,0,9,1,0,10,0
"140910203","CORDOBA",79,0,46,15,8,69,0
"140770207","CORDOBA",56,0,32,7,5,44,0
"140700206","CORDOBA",95,0,50,21,5,76,0
"140490213","CORDOBA",69,1,44,14,1,59,0.0144927536231884
"140490207","CORDOBA",52,0,18,15,1,34,0
"140143204","CORDOBA",245,117,119,9,0,128,0.477551020408163
"140490202","CORDOBA",45,0,12,17,1,30,0
"140280702","CORDOBA",58,0,29,7,2,38,0
"140280701","CORDOBA",56,0,32,3,0,35,0
"140280602","CORDOBA",95,0,70,13,3,86,0
"141470205","CORDOBA",290,2,127,127,19,273,0.00689655172413793
"140144705","CORDOBA",192,168,17,6,0,23,0.875
"140982704","CORDOBA",226,175,34,17,0,51,0.774336283185841
"141470202","CORDOBA",510,7,415,71,7,493,0.0137254901960784
"141050101","CORDOBA",82,1,59,14,3,76,0.0121951219512195
"141190501","CORDOBA",82,1,44,8,24,76,0.0121951219512195
"141470201","CORDOBA",175,1,136,25,9,170,0.00571428571428571
"141821310","CORDOBA",184,2,83,95,3,181,0.0108695652173913
"141821309","CORDOBA",163,1,128,33,1,162,0.00613496932515337
"141821308","CORDOBA",117,0,29,67,9,105,0
"141470102","CORDOBA",183,2,136,37,7,180,0.0109289617486339
"141401705","CORDOBA",84,0,56,21,6,83,0
"141401007","CORDOBA",129,1,84,40,2,126,0.00775193798449612
"141401006","CORDOBA",127,0,64,51,5,120,0
"141401002","CORDOBA",69,2,20,35,2,57,0.0289855072463768
"141401001","CORDOBA",83,0,28,45,10,83,0
"141330405","CORDOBA",130,0,75,41,5,121,0
"141330204","CORDOBA",275,2,171,65,2,238,0.00727272727272727
"141821307","CORDOBA",283,2,190,84,1,275,0.00706713780918728
"140144202","CORDOBA",139,8,131,0,0,131,0.0575539568345324
"141820902","CORDOBA",339,160,77,98,2,177,0.471976401179941
"140140205","CORDOBA",227,96,131,0,0,131,0.422907488986784
"141821110","CORDOBA",357,241,83,25,2,110,0.675070028011205
"141821109","CORDOBA",388,130,65,150,5,220,0.335051546391753
"141330305","CORDOBA",119,0,58,31,9,98,0
"141400202","CORDOBA",99,0,65,25,4,94,0
"141190301","CORDOBA",110,0,89,18,2,109,0
"141821306","CORDOBA",247,1,169,74,0,243,0.00404858299595142
"141330108","CORDOBA",218,0,88,100,3,191,0
"141260604","CORDOBA",110,0,87,19,1,107,0
"141120306","CORDOBA",124,0,27,58,16,101,0
"141260304","CORDOBA",267,1,196,40,11,247,0.00374531835205993
"141821305","CORDOBA",210,1,161,48,0,209,0.00476190476190476
"141821304","CORDOBA",293,4,205,80,1,286,0.0136518771331058
"141260302","CORDOBA",3,0,2,1,0,3,0
"141050410","CORDOBA",97,0,74,15,4,93,0
"141260103","CORDOBA",47,0,19,9,4,32,0
"141120304","CORDOBA",188,0,126,41,6,173,0
"141120309","CORDOBA",68,0,20,22,14,56,0
"141120201","CORDOBA",187,0,98,58,20,176,0
"141050604","CORDOBA",113,0,76,28,4,108,0
"141050404","CORDOBA",55,1,19,33,0,52,0.0181818181818182
"141821303","CORDOBA",238,1,161,76,0,237,0.00420168067226891
"141821302","CORDOBA",299,10,246,40,3,289,0.0334448160535117
"141680311","CORDOBA",342,3,302,29,3,334,0.0087719298245614
"141050305","CORDOBA",109,1,81,15,5,101,0.00917431192660551
"141050303","CORDOBA",55,0,48,3,0,51,0
"141821204","CORDOBA",331,131,164,33,1,198,0.395770392749245
"141050208","CORDOBA",70,0,40,15,2,57,0
"141050306","CORDOBA",44,0,34,6,4,44,0
"141050110","CORDOBA",73,0,49,17,4,70,0
"141050109","CORDOBA",127,0,83,40,1,124,0
"141050108","CORDOBA",86,0,38,37,3,78,0
"141821301","CORDOBA",320,2,211,100,3,314,0.00625
"140981106","CORDOBA",97,0,54,31,2,87,0
"141821211","CORDOBA",247,155,57,29,2,88,0.62753036437247
"141821210","CORDOBA",200,154,36,10,0,46,0.77
"141821203","CORDOBA",277,199,66,12,0,78,0.71841155234657
"140980902","CORDOBA",145,2,57,81,2,140,0.0137931034482759
"140911608","CORDOBA",140,3,96,35,3,134,0.0214285714285714
"141821209","CORDOBA",194,93,87,12,1,100,0.479381443298969
"140980509","CORDOBA",50,0,23,24,2,49,0
"140980203","CORDOBA",84,0,77,5,2,84,0
"140911703","CORDOBA",9,0,6,1,2,9,0
"140700201","CORDOBA",47,0,19,14,2,35,0
"141821108","CORDOBA",269,149,55,57,0,112,0.553903345724907
"140911309","CORDOBA",111,1,89,15,2,106,0.00900900900900901
"141820906","CORDOBA",241,191,34,15,0,49,0.79253112033195
"140910204","CORDOBA",50,1,23,17,3,43,0.02
"140910201","CORDOBA",92,0,57,22,0,79,0
"140840404","CORDOBA",76,1,31,43,1,75,0.0131578947368421
"140840307","CORDOBA",25,0,15,6,0,21,0
"140770203","CORDOBA",124,0,48,31,16,95,0
"141821107","CORDOBA",206,194,4,5,3,12,0.941747572815534
"140770202","CORDOBA",83,0,48,22,3,73,0
"140840103","CORDOBA",49,0,28,13,3,44,0
"141821207","CORDOBA",287,198,73,15,1,89,0.689895470383275
"141821206","CORDOBA",363,195,123,31,4,158,0.537190082644628
"140700103","CORDOBA",106,0,66,12,7,85,0
"140700101","CORDOBA",84,0,28,28,17,73,0
"140630701","CORDOBA",100,0,46,46,0,92,0
"140560612","CORDOBA",70,0,47,18,0,65,0
"140630303","CORDOBA",108,1,53,49,2,104,0.00925925925925926
"140560611","CORDOBA",57,0,23,30,1,54,0
"140141403","CORDOBA",343,136,163,36,3,202,0.396501457725948
"140630211","CORDOBA",29,0,16,13,0,29,0
"140630209","CORDOBA",24,0,10,13,0,23,0
"140630104","CORDOBA",12,0,6,5,0,11,0
"140560613","CORDOBA",71,0,35,27,6,68,0
"141820802","CORDOBA",239,144,55,37,0,92,0.602510460251046
"141750112","CORDOBA",104,0,82,19,1,102,0
"140560401","CORDOBA",34,0,22,12,0,34,0
"141820707","CORDOBA",128,2,50,75,0,125,0.015625
"141820705","CORDOBA",48,0,27,17,4,48,0
"141610805","CORDOBA",160,119,36,4,0,40,0.74375
"140490211","CORDOBA",126,1,95,21,2,118,0.00793650793650794
"140490204","CORDOBA",81,0,44,15,5,64,0
"140350206","CORDOBA",103,0,61,37,1,99,0
"140350106","CORDOBA",46,0,33,9,1,43,0
"141401902","CORDOBA",224,4,215,3,0,218,0.0178571428571429
"141400520","CORDOBA",383,5,297,65,11,373,0.0130548302872063
"141050416","CORDOBA",85,0,59,22,1,82,0
"140980210","CORDOBA",265,2,247,16,0,263,0.00754716981132075
"140630811","CORDOBA",200,2,148,35,10,193,0.01
"140490324","CORDOBA",167,5,114,39,4,157,0.029940119760479
"140490305","CORDOBA",234,2,198,28,0,226,0.00854700854700855
"140350513","CORDOBA",292,0,221,64,6,291,0
"140490201","CORDOBA",200,5,92,68,4,164,0.025
"140280103","CORDOBA",98,7,29,17,2,48,0.0714285714285714
"141400904","CORDOBA",138,4,78,37,3,118,0.0289855072463768
"140490109","CORDOBA",109,1,45,52,2,99,0.00917431192660551
"140149202","CORDOBA",174,14,138,22,0,160,0.0804597701149425
"140148004","CORDOBA",190,190,0,0,0,0,1
"140146914","CORDOBA",354,352,2,0,0,2,0.994350282485876
"140146805","CORDOBA",120,119,0,1,0,1,0.991666666666667
"140146602","CORDOBA",414,413,1,0,0,1,0.997584541062802
"140070113","CORDOBA",166,60,83,8,7,98,0.36144578313253
"140420308","CORDOBA",187,23,94,62,2,158,0.122994652406417
"140420209","CORDOBA",126,25,21,59,17,97,0.198412698412698
"140145208","CORDOBA",213,202,9,1,0,10,0.948356807511737
"140420208","CORDOBA",130,2,45,77,0,122,0.0153846153846154
"140350309","CORDOBA",47,1,18,20,0,38,0.0212765957446809
"140350307","CORDOBA",187,0,122,60,3,185,0
"140350306","CORDOBA",67,0,45,14,5,64,0
"140280604","CORDOBA",56,0,33,20,0,53,0
"140140111","CORDOBA",190,10,171,9,0,180,0.0526315789473684
"140140110","CORDOBA",273,39,229,5,0,234,0.142857142857143
"140280501","CORDOBA",163,2,83,61,3,147,0.0122699386503067
"140210504","CORDOBA",64,0,51,6,3,60,0
"141821205","CORDOBA",236,125,94,14,0,108,0.529661016949153
"140280104","CORDOBA",250,2,77,75,15,167,0.008
"141470601","CORDOBA",133,19,73,20,18,111,0.142857142857143
"141260303","CORDOBA",115,0,68,27,2,97,0
"141821106","CORDOBA",272,194,39,37,2,78,0.713235294117647
"140280102","CORDOBA",143,0,34,34,1,69,0
"140143405","CORDOBA",176,15,138,23,0,161,0.0852272727272727
"140210802","CORDOBA",152,0,66,71,6,143,0
"141260206","CORDOBA",223,1,65,85,11,161,0.00448430493273543
"141190506","CORDOBA",34,0,30,2,1,33,0
"141120302","CORDOBA",91,0,60,23,2,85,0
"141120106","CORDOBA",86,0,57,12,15,84,0
"141821105","CORDOBA",190,183,2,5,0,7,0.963157894736842
"140210607","CORDOBA",56,1,33,7,12,52,0.0178571428571429
"141330201","CORDOBA",165,5,114,31,9,154,0.0303030303030303
"140140204","CORDOBA",282,30,249,3,0,252,0.106382978723404
"140210502","CORDOBA",87,0,71,13,0,84,0
"140210313","CORDOBA",99,1,51,33,7,91,0.0101010101010101
"140210308","CORDOBA",108,0,94,10,3,107,0
"141260607","CORDOBA",135,0,95,20,8,123,0
"140143608","CORDOBA",268,107,135,23,2,160,0.399253731343284
"140143207","CORDOBA",377,312,48,13,0,61,0.827586206896552
"140143206","CORDOBA",329,193,114,20,0,134,0.586626139817629
"141821104","CORDOBA",225,225,0,0,0,0,1
"141120104","CORDOBA",94,0,51,26,7,84,0
"141050111","CORDOBA",61,0,42,18,0,60,0
"140980506","CORDOBA",135,55,61,16,0,77,0.407407407407407
"140141617","CORDOBA",321,1,171,82,23,276,0.00311526479750779
"140141611","CORDOBA",330,196,56,55,2,113,0.593939393939394
"140141603","CORDOBA",455,7,223,182,13,418,0.0153846153846154
"140141304","CORDOBA",358,4,271,73,1,345,0.0111731843575419
"140141601","CORDOBA",349,151,133,53,0,186,0.432664756446991
"140141610","CORDOBA",254,44,154,48,1,203,0.173228346456693
"140141520","CORDOBA",424,17,274,59,41,374,0.0400943396226415
"140143205","CORDOBA",360,4,321,32,0,353,0.0111111111111111
"141610814","CORDOBA",264,220,39,5,0,44,0.833333333333333
"141821010","CORDOBA",325,69,128,110,6,244,0.212307692307692
"141821003","CORDOBA",205,183,12,9,0,21,0.892682926829268
"141820712","CORDOBA",138,1,98,34,3,135,0.0072463768115942
"141820711","CORDOBA",229,0,109,88,16,213,0
"141820904","CORDOBA",230,107,75,43,2,120,0.465217391304348
"141820903","CORDOBA",293,110,85,78,3,166,0.37542662116041
"141820901","CORDOBA",294,179,68,45,0,113,0.608843537414966
"141820811","CORDOBA",219,217,0,0,0,0,0.990867579908676
"141820810","CORDOBA",315,307,2,5,0,7,0.974603174603175
"141820809","CORDOBA",332,309,20,1,1,22,0.930722891566265
"141820808","CORDOBA",179,172,3,3,1,7,0.960893854748603
"141820807","CORDOBA",208,202,4,2,0,6,0.971153846153846
"141820615","CORDOBA",313,199,75,31,4,110,0.635782747603834
"141820509","CORDOBA",208,6,150,47,4,201,0.0288461538461538
"141820609","CORDOBA",418,152,234,31,0,265,0.363636363636364
"141820521","CORDOBA",223,2,106,100,5,211,0.00896860986547085
"141820520","CORDOBA",224,0,140,81,1,222,0
"141820519","CORDOBA",152,1,86,61,2,149,0.00657894736842105
"141820518","CORDOBA",414,11,221,180,1,402,0.0265700483091787
"141820517","CORDOBA",169,0,98,62,8,168,0
"141820516","CORDOBA",229,3,90,124,6,220,0.0131004366812227
"141820515","CORDOBA",266,1,162,101,0,263,0.0037593984962406
"141820415","CORDOBA",319,0,227,88,3,318,0
"141820414","CORDOBA",209,16,161,28,1,190,0.076555023923445
"141821002","CORDOBA",307,304,1,2,0,3,0.990228013029316
"141820307","CORDOBA",312,2,292,16,0,308,0.00641025641025641
"141821001","CORDOBA",219,218,1,0,0,1,0.995433789954338
"141820208","CORDOBA",195,5,168,17,2,187,0.0256410256410256
"141610709","CORDOBA",308,4,266,36,2,304,0.012987012987013
"141820207","CORDOBA",248,7,234,7,0,241,0.0282258064516129
"141820206","CORDOBA",248,1,191,53,3,247,0.00403225806451613
"141820911","CORDOBA",302,302,0,0,0,0,1
"141820413","CORDOBA",285,2,200,71,5,276,0.00701754385964912
"141820412","CORDOBA",216,4,84,102,15,201,0.0185185185185185
"141820806","CORDOBA",316,267,24,4,2,30,0.844936708860759
"141820805","CORDOBA",327,270,45,11,0,56,0.825688073394495
"141820214","CORDOBA",170,2,128,31,5,164,0.0117647058823529
"141820213","CORDOBA",328,21,267,32,2,301,0.0640243902439024
"141820804","CORDOBA",231,184,37,9,1,47,0.796536796536797
"141820115","CORDOBA",191,1,114,43,17,174,0.00523560209424084
"141820114","CORDOBA",148,0,97,40,4,141,0
"141820803","CORDOBA",277,155,69,48,1,118,0.55956678700361
"141820910","CORDOBA",361,290,25,43,1,69,0.803324099722992
"141820113","CORDOBA",252,15,169,64,1,234,0.0595238095238095
"141820112","CORDOBA",235,3,207,23,1,231,0.0127659574468085
"141820111","CORDOBA",193,5,143,43,0,186,0.0259067357512953
"141750212","CORDOBA",217,0,206,9,0,215,0
"141820801","CORDOBA",213,36,76,70,2,148,0.169014084507042
"141820716","CORDOBA",247,1,177,65,4,246,0.00404858299595142
"141750114","CORDOBA",233,0,217,13,2,232,0
"141750113","CORDOBA",221,0,185,28,4,217,0
"141750111","CORDOBA",188,0,126,34,18,178,0
"141820909","CORDOBA",309,106,76,118,2,196,0.343042071197411
"141820715","CORDOBA",314,5,247,58,0,305,0.0159235668789809
"141820908","CORDOBA",366,137,77,145,1,223,0.37431693989071
"141610708","CORDOBA",294,19,216,49,0,265,0.0646258503401361
"141820714","CORDOBA",226,0,192,31,1,224,0
"141820713","CORDOBA",180,1,141,33,2,176,0.00555555555555556
"141820907","CORDOBA",230,172,28,27,1,56,0.747826086956522
"141820619","CORDOBA",114,0,69,29,12,110,0
"140145207","CORDOBA",223,211,10,2,0,12,0.946188340807175
"141610810","CORDOBA",303,226,70,6,0,76,0.745874587458746
"141610808","CORDOBA",210,72,98,39,0,137,0.342857142857143
"141610807","CORDOBA",289,168,82,37,0,119,0.581314878892734
"141611009","CORDOBA",204,197,3,3,0,6,0.965686274509804
"141610715","CORDOBA",384,10,354,18,1,373,0.0260416666666667
"141610714","CORDOBA",266,4,238,20,1,259,0.0150375939849624
"141610713","CORDOBA",301,18,274,8,0,282,0.0598006644518272
"141610712","CORDOBA",360,11,315,20,12,347,0.0305555555555556
"141610711","CORDOBA",198,2,175,21,0,196,0.0101010101010101
"141610710","CORDOBA",245,18,206,19,2,227,0.073469387755102
"140631208","CORDOBA",260,255,2,3,0,5,0.980769230769231
"141610707","CORDOBA",222,21,190,10,1,201,0.0945945945945946
"141610706","CORDOBA",275,1,257,14,1,272,0.00363636363636364
"141610705","CORDOBA",150,2,147,0,0,147,0.0133333333333333
"141610704","CORDOBA",152,3,141,8,0,149,0.0197368421052632
"141610703","CORDOBA",316,23,280,10,3,293,0.0727848101265823
"141610701","CORDOBA",242,6,225,9,2,236,0.0247933884297521
"141610614","CORDOBA",212,1,164,39,2,205,0.00471698113207547
"141610512","CORDOBA",200,2,115,80,1,196,0.01
"141610511","CORDOBA",232,1,165,66,0,231,0.00431034482758621
"141610510","CORDOBA",204,7,170,27,0,197,0.0343137254901961
"141610509","CORDOBA",213,1,167,44,0,211,0.00469483568075117
"141610508","CORDOBA",189,2,123,63,1,187,0.0105820105820106
"141610507","CORDOBA",339,3,208,122,3,333,0.00884955752212389
"141610506","CORDOBA",232,3,135,80,6,221,0.0129310344827586
"141610605","CORDOBA",185,0,155,25,4,184,0
"141610806","CORDOBA",178,9,137,32,0,169,0.050561797752809
"141610310","CORDOBA",307,4,284,13,4,301,0.0130293159609121
"141610309","CORDOBA",191,0,150,38,2,190,0
"141610307","CORDOBA",325,9,276,37,1,314,0.0276923076923077
"141610306","CORDOBA",245,4,194,23,10,227,0.0163265306122449
"141610604","CORDOBA",296,2,277,14,3,294,0.00675675675675676
"141610603","CORDOBA",335,5,294,26,9,329,0.0149253731343284
"141610602","CORDOBA",291,41,202,37,10,249,0.140893470790378
"141610601","CORDOBA",210,0,171,28,8,207,0
"141610216","CORDOBA",228,2,195,17,5,217,0.0087719298245614
"141610215","CORDOBA",212,3,196,6,4,206,0.0141509433962264
"141610214","CORDOBA",228,2,198,27,0,225,0.0087719298245614
"141610212","CORDOBA",197,0,170,24,1,195,0
"141610112","CORDOBA",244,1,154,58,17,229,0.00409836065573771
"141610211","CORDOBA",238,1,211,25,0,236,0.00420168067226891
"141610210","CORDOBA",212,5,197,9,1,207,0.0235849056603774
"141610209","CORDOBA",277,12,253,10,0,263,0.0433212996389892
"141540211","CORDOBA",278,0,259,16,1,276,0
"141471004","CORDOBA",222,167,48,5,1,54,0.752252252252252
"141610208","CORDOBA",239,0,221,18,0,239,0
"141610804","CORDOBA",185,98,84,3,0,87,0.52972972972973
"141610803","CORDOBA",191,138,43,9,1,53,0.722513089005236
"141610116","CORDOBA",265,0,239,24,0,263,0
"141610115","CORDOBA",159,1,130,26,1,157,0.00628930817610063
"141610114","CORDOBA",167,0,142,23,1,166,0
"141610113","CORDOBA",296,2,242,45,3,290,0.00675675675675676
"141610802","CORDOBA",123,22,82,16,1,99,0.178861788617886
"141610801","CORDOBA",220,16,192,11,0,203,0.0727272727272727
"141610207","CORDOBA",212,8,193,10,0,203,0.0377358490566038
"141610613","CORDOBA",274,2,247,18,5,270,0.0072992700729927
"141610612","CORDOBA",257,11,236,10,0,246,0.0428015564202335
"141540209","CORDOBA",173,0,133,31,2,166,0
"141610611","CORDOBA",224,6,195,23,0,218,0.0267857142857143
"141471015","CORDOBA",460,7,293,90,45,428,0.0152173913043478
"141471014","CORDOBA",447,25,317,65,30,412,0.0559284116331096
"141471013","CORDOBA",293,25,198,57,6,261,0.0853242320819113
"141471012","CORDOBA",276,31,152,77,5,234,0.11231884057971
"141471011","CORDOBA",441,90,243,86,11,340,0.204081632653061
"141471009","CORDOBA",248,49,146,49,3,198,0.19758064516129
"141471008","CORDOBA",363,100,163,71,18,252,0.275482093663912
"141471006","CORDOBA",225,214,8,2,0,10,0.951111111111111
"141471005","CORDOBA",320,235,73,8,4,85,0.734375
"140143713","CORDOBA",241,212,25,2,0,27,0.879668049792531
"141471003","CORDOBA",186,114,60,6,5,71,0.612903225806452
"141471002","CORDOBA",273,112,129,19,13,161,0.41025641025641
"141471001","CORDOBA",222,106,102,4,10,116,0.477477477477477
"141470919","CORDOBA",265,3,215,36,1,252,0.0113207547169811
"141470918","CORDOBA",225,1,145,52,3,200,0.00444444444444444
"141470917","CORDOBA",195,55,108,27,2,137,0.282051282051282
"141470916","CORDOBA",244,131,89,23,0,112,0.536885245901639
"141470915","CORDOBA",267,193,63,7,2,72,0.722846441947566
"141470914","CORDOBA",251,192,39,18,2,59,0.764940239043825
"141470913","CORDOBA",382,190,141,45,4,190,0.49738219895288
"141470907","CORDOBA",172,133,36,1,2,39,0.773255813953488
"141470906","CORDOBA",336,169,123,39,3,165,0.50297619047619
"141470904","CORDOBA",213,36,132,39,4,175,0.169014084507042
"141470903","CORDOBA",413,12,303,80,11,394,0.0290556900726392
"141401719","CORDOBA",258,2,175,56,7,238,0.00775193798449612
"141470902","CORDOBA",413,9,228,143,4,375,0.0217917675544794
"141470901","CORDOBA",319,13,181,87,6,274,0.0407523510971787
"141470817","CORDOBA",122,122,0,0,0,0,1
"141470816","CORDOBA",203,200,2,1,0,3,0.985221674876847
"141470815","CORDOBA",238,224,10,3,0,13,0.941176470588235
"141470814","CORDOBA",254,228,19,7,0,26,0.897637795275591
"141470813","CORDOBA",263,246,15,2,0,17,0.935361216730038
"141470412","CORDOBA",351,0,274,61,8,343,0
"141470812","CORDOBA",343,6,275,40,21,336,0.0174927113702624
"141611018","CORDOBA",289,289,0,0,0,0,1
"141401718","CORDOBA",68,0,25,29,6,60,0
"141470802","CORDOBA",323,144,107,44,17,168,0.445820433436532
"141470801","CORDOBA",263,101,127,21,13,161,0.384030418250951
"141470411","CORDOBA",241,3,216,12,3,231,0.012448132780083
"141470410","CORDOBA",232,0,198,27,2,227,0
"141470714","CORDOBA",160,7,123,16,7,146,0.04375
"141470713","CORDOBA",46,0,33,5,8,46,0
"141470608","CORDOBA",170,0,146,16,4,166,0
"141401414","CORDOBA",389,389,0,0,0,0,1
"141470711","CORDOBA",100,1,81,5,13,99,0.01
"141611017","CORDOBA",355,346,4,3,0,7,0.974647887323944
"141470808","CORDOBA",298,257,31,10,0,41,0.86241610738255
"141470807","CORDOBA",297,175,83,34,3,120,0.589225589225589
"141470806","CORDOBA",400,358,36,4,0,40,0.895
"141470805","CORDOBA",470,217,174,67,2,243,0.461702127659574
"141470409","CORDOBA",176,1,165,10,0,175,0.00568181818181818
"141401318","CORDOBA",233,0,139,62,3,204,0
"141470308","CORDOBA",344,3,175,128,12,315,0.00872093023255814
"141470810","CORDOBA",172,159,11,1,1,13,0.924418604651163
"141470107","CORDOBA",294,0,256,16,0,272,0
"141470610","CORDOBA",158,0,138,16,1,155,0
"141470609","CORDOBA",136,0,106,20,3,129,0
"141470804","CORDOBA",241,233,7,0,0,7,0.966804979253112
"141470309","CORDOBA",254,0,217,25,9,251,0
"141470603","CORDOBA",134,2,100,18,13,131,0.0149253731343284
"141470507","CORDOBA",114,0,98,14,0,112,0
"141470106","CORDOBA",254,11,229,9,0,238,0.0433070866141732
"141470105","CORDOBA",366,1,330,30,0,360,0.00273224043715847
"141470104","CORDOBA",318,3,241,56,6,303,0.00943396226415094
"141470605","CORDOBA",90,0,73,7,9,89,0
"141470710","CORDOBA",97,2,77,3,5,85,0.0206185567010309
"141470709","CORDOBA",61,5,39,3,11,53,0.0819672131147541
"141470408","CORDOBA",334,3,282,21,0,303,0.00898203592814371
"141471010","CORDOBA",387,300,67,19,1,87,0.775193798449612
"141470912","CORDOBA",361,41,262,51,3,316,0.113573407202216
"141470314","CORDOBA",127,1,101,20,5,126,0.0078740157480315
"141611016","CORDOBA",245,240,3,1,0,4,0.979591836734694
"141470811","CORDOBA",232,171,45,12,4,61,0.737068965517241
"141470809","CORDOBA",257,215,38,2,1,41,0.836575875486381
"141401908","CORDOBA",209,4,199,4,0,203,0.0191387559808612
"141401907","CORDOBA",203,13,170,17,1,188,0.0640394088669951
"141401906","CORDOBA",221,0,204,16,0,220,0
"141401905","CORDOBA",137,0,135,1,0,136,0
"141401904","CORDOBA",189,0,176,13,0,189,0
"141401903","CORDOBA",165,6,157,2,0,159,0.0363636363636364
"141401901","CORDOBA",366,8,303,38,4,345,0.0218579234972678
"141401812","CORDOBA",239,5,221,11,0,232,0.0209205020920502
"141401811","CORDOBA",254,4,248,2,0,250,0.015748031496063
"141401810","CORDOBA",213,2,187,24,0,211,0.00938967136150235
"141401806","CORDOBA",273,7,219,31,3,253,0.0256410256410256
"141401805","CORDOBA",227,9,142,46,8,196,0.039647577092511
"141401804","CORDOBA",221,1,208,8,0,216,0.00452488687782805
"141401803","CORDOBA",231,2,214,14,0,228,0.00865800865800866
"141401802","CORDOBA",254,4,201,43,2,246,0.015748031496063
"141401801","CORDOBA",218,3,195,19,0,214,0.0137614678899083
"141401720","CORDOBA",202,0,162,37,0,199,0
"141820905","CORDOBA",224,76,71,74,0,145,0.339285714285714
"141680206","CORDOBA",198,0,173,18,1,192,0
"141680114","CORDOBA",312,0,242,54,8,304,0
"141680113","CORDOBA",147,2,123,10,5,138,0.0136054421768707
"141680112","CORDOBA",272,1,243,27,0,270,0.00367647058823529
"141680205","CORDOBA",161,0,137,19,2,158,0
"141611111","CORDOBA",370,350,11,4,0,15,0.945945945945946
"141401317","CORDOBA",324,2,237,71,3,311,0.00617283950617284
"141611115","CORDOBA",220,220,0,0,0,0,1
"141611110","CORDOBA",228,165,24,30,0,54,0.723684210526316
"141611109","CORDOBA",173,150,17,5,0,22,0.867052023121387
"141821005","CORDOBA",162,45,25,73,12,110,0.277777777777778
"141611108","CORDOBA",202,191,10,1,0,11,0.945544554455445
"141611107","CORDOBA",219,217,1,1,0,2,0.990867579908676
"141680212","CORDOBA",239,7,177,38,3,218,0.0292887029288703
"141680210","CORDOBA",195,2,179,8,0,187,0.0102564102564103
"141680209","CORDOBA",217,3,199,9,1,209,0.0138248847926267
"141821007","CORDOBA",282,258,8,15,0,23,0.914893617021277
"141680208","CORDOBA",295,6,252,37,0,289,0.0203389830508475
"141680207","CORDOBA",278,3,225,47,3,275,0.0107913669064748
"141611002","CORDOBA",290,288,2,0,0,2,0.993103448275862
"141680204","CORDOBA",158,4,145,4,2,151,0.0253164556962025
"141821006","CORDOBA",215,132,28,47,4,79,0.613953488372093
"141820618","CORDOBA",124,11,67,46,0,113,0.0887096774193548
"141820617","CORDOBA",213,199,10,3,0,13,0.934272300469484
"141820616","CORDOBA",207,70,75,58,2,135,0.338164251207729
"141680313","CORDOBA",342,20,256,59,1,316,0.0584795321637427
"141611117","CORDOBA",223,172,32,12,1,45,0.771300448430493
"141611116","CORDOBA",318,248,39,25,1,65,0.779874213836478
"141611106","CORDOBA",251,234,17,0,0,17,0.932270916334661
"141611105","CORDOBA",225,219,3,2,0,5,0.973333333333333
"141611104","CORDOBA",308,273,20,14,0,34,0.886363636363636
"141611103","CORDOBA",175,143,18,12,0,30,0.817142857142857
"141611102","CORDOBA",214,169,34,10,0,44,0.789719626168224
"141611101","CORDOBA",368,320,35,10,1,46,0.869565217391304
"141611019","CORDOBA",291,279,9,2,0,11,0.958762886597938
"141611008","CORDOBA",244,238,3,3,0,6,0.975409836065574
"141611007","CORDOBA",358,351,5,1,0,6,0.980446927374302
"141611004","CORDOBA",238,236,1,0,0,1,0.991596638655462
"141611003","CORDOBA",285,283,1,1,0,2,0.992982456140351
"141610907","CORDOBA",245,243,1,1,0,2,0.991836734693878
"141611012","CORDOBA",325,325,0,0,0,0,1
"141611011","CORDOBA",194,192,2,0,0,2,0.989690721649485
"141611010","CORDOBA",177,177,0,0,0,0,1
"141610906","CORDOBA",287,236,20,27,0,47,0.822299651567944
"141610905","CORDOBA",265,235,17,10,1,28,0.886792452830189
"141610904","CORDOBA",241,200,29,7,0,36,0.829875518672199
"141610903","CORDOBA",262,230,17,9,0,26,0.877862595419847
"141610902","CORDOBA",301,234,35,28,1,64,0.777408637873754
"141610901","CORDOBA",218,142,43,25,2,70,0.651376146788991
"141610817","CORDOBA",324,17,233,70,2,305,0.0524691358024691
"141610816","CORDOBA",195,108,56,28,1,85,0.553846153846154
"141401715","CORDOBA",285,6,254,18,1,273,0.0210526315789474
"141401714","CORDOBA",367,5,330,31,1,362,0.0136239782016349
"141401713","CORDOBA",174,4,162,8,0,170,0.0229885057471264
"141401712","CORDOBA",202,4,192,6,0,198,0.0198019801980198
"141401613","CORDOBA",191,2,162,21,0,183,0.0104712041884817
"141401612","CORDOBA",231,3,178,43,1,222,0.012987012987013
"141401611","CORDOBA",349,3,284,60,1,345,0.00859598853868195
"141401807","CORDOBA",208,8,188,10,2,200,0.0384615384615385
"141401610","CORDOBA",357,3,273,63,9,345,0.00840336134453781
"141401609","CORDOBA",244,1,204,35,4,243,0.00409836065573771
"141401608","CORDOBA",362,2,261,91,6,358,0.00552486187845304
"141401607","CORDOBA",214,5,181,24,1,206,0.0233644859813084
"141401213","CORDOBA",262,75,171,14,1,186,0.286259541984733
"141401401","CORDOBA",320,185,100,34,1,135,0.578125
"141401513","CORDOBA",441,0,331,84,12,427,0
"141401512","CORDOBA",331,0,305,26,0,331,0
"141401511","CORDOBA",285,4,252,28,1,281,0.0140350877192982
"141401510","CORDOBA",308,1,282,22,0,304,0.00324675324675325
"141401509","CORDOBA",248,1,225,20,0,245,0.00403225806451613
"141401508","CORDOBA",177,0,159,14,1,174,0
"141401507","CORDOBA",228,0,181,44,1,226,0
"141401423","CORDOBA",260,158,88,12,0,100,0.607692307692308
"141401422","CORDOBA",194,156,28,9,0,37,0.804123711340206
"141401421","CORDOBA",224,138,57,28,0,85,0.616071428571429
"141401420","CORDOBA",202,150,40,11,0,51,0.742574257425743
"141401419","CORDOBA",276,237,22,12,0,34,0.858695652173913
"141401418","CORDOBA",302,205,84,11,0,95,0.678807947019868
"141401417","CORDOBA",261,203,44,14,0,58,0.777777777777778
"141401416","CORDOBA",315,232,71,11,1,83,0.736507936507937
"141401415","CORDOBA",316,315,0,0,0,0,0.996835443037975
"141401413","CORDOBA",381,373,5,3,0,8,0.979002624671916
"141401315","CORDOBA",342,1,282,51,2,335,0.00292397660818713
"141401314","CORDOBA",202,191,7,4,0,11,0.945544554455445
"141401313","CORDOBA",283,149,92,39,1,132,0.526501766784452
"141401312","CORDOBA",226,167,44,15,0,59,0.738938053097345
"141401311","CORDOBA",242,240,2,0,0,2,0.991735537190083
"141401310","CORDOBA",226,207,14,5,0,19,0.915929203539823
"141401309","CORDOBA",245,214,23,8,0,31,0.873469387755102
"141401308","CORDOBA",181,180,1,0,0,1,0.994475138121547
"141401307","CORDOBA",192,188,4,0,0,4,0.979166666666667
"141401306","CORDOBA",240,234,3,2,0,5,0.975
"141401305","CORDOBA",275,159,89,24,0,113,0.578181818181818
"141401304","CORDOBA",254,120,93,41,0,134,0.47244094488189
"141401303","CORDOBA",204,201,3,0,0,3,0.985294117647059
"141401302","CORDOBA",221,221,0,0,0,0,1
"141401301","CORDOBA",212,210,0,1,0,1,0.990566037735849
"141401219","CORDOBA",226,120,76,28,2,106,0.530973451327434
"141401218","CORDOBA",189,184,5,0,0,5,0.973544973544973
"141401217","CORDOBA",271,271,0,0,0,0,1
"141401216","CORDOBA",208,207,1,0,0,1,0.995192307692308
"141401215","CORDOBA",221,213,5,3,0,8,0.963800904977376
"141401214","CORDOBA",213,175,28,10,0,38,0.821596244131455
"141401202","CORDOBA",174,70,90,13,1,104,0.402298850574713
"141401201","CORDOBA",199,5,157,34,1,192,0.0251256281407035
"141401121","CORDOBA",335,163,154,18,0,172,0.486567164179104
"141401120","CORDOBA",350,286,60,4,0,64,0.817142857142857
"141401119","CORDOBA",306,295,9,2,0,11,0.964052287581699
"141401118","CORDOBA",323,318,5,0,0,5,0.984520123839009
"141401117","CORDOBA",184,183,1,0,0,1,0.994565217391304
"141401116","CORDOBA",216,213,3,0,0,3,0.986111111111111
"141401115","CORDOBA",196,194,2,0,0,2,0.989795918367347
"141401114","CORDOBA",282,256,23,2,0,25,0.907801418439716
"141401113","CORDOBA",289,246,25,18,0,43,0.85121107266436
"141401112","CORDOBA",219,197,14,8,0,22,0.899543378995434
"141401111","CORDOBA",237,214,15,8,0,23,0.90295358649789
"141401110","CORDOBA",291,210,63,15,3,81,0.721649484536082
"141401109","CORDOBA",242,208,34,0,0,34,0.859504132231405
"141401108","CORDOBA",455,377,53,25,0,78,0.828571428571429
"141401107","CORDOBA",211,172,27,11,1,39,0.815165876777251
"141401106","CORDOBA",192,177,11,4,0,15,0.921875
"141401105","CORDOBA",299,254,36,7,2,45,0.849498327759197
"141401104","CORDOBA",220,183,29,8,0,37,0.831818181818182
"141401103","CORDOBA",361,306,50,5,0,55,0.847645429362881
"141401102","CORDOBA",219,125,72,22,0,94,0.570776255707763
"140631007","CORDOBA",356,278,45,32,1,78,0.780898876404494
"141401101","CORDOBA",136,1,130,5,0,135,0.00735294117647059
"141401016","CORDOBA",348,303,32,13,0,45,0.870689655172414
"141401015","CORDOBA",284,226,31,21,1,53,0.795774647887324
"141401014","CORDOBA",215,174,26,13,2,41,0.809302325581395
"141401013","CORDOBA",161,133,23,4,0,27,0.826086956521739
"141401012","CORDOBA",364,302,46,11,3,60,0.82967032967033
"141401011","CORDOBA",272,173,74,22,0,96,0.636029411764706
"141401010","CORDOBA",274,149,87,31,2,120,0.543795620437956
"141401009","CORDOBA",219,0,199,18,1,218,0
"141401008","CORDOBA",182,0,164,16,0,180,0
"141400915","CORDOBA",374,1,333,36,3,372,0.00267379679144385
"141400914","CORDOBA",302,3,244,46,5,295,0.00993377483443709
"141400913","CORDOBA",272,3,243,26,0,269,0.0110294117647059
"141400912","CORDOBA",210,1,180,28,0,208,0.00476190476190476
"141400911","CORDOBA",353,1,308,43,1,352,0.0028328611898017
"140982308","CORDOBA",332,325,3,3,0,6,0.978915662650602
"141400910","CORDOBA",259,3,191,60,2,253,0.0115830115830116
"141400821","CORDOBA",179,1,147,22,7,176,0.00558659217877095
"141400710","CORDOBA",368,37,274,42,8,324,0.10054347826087
"141400820","CORDOBA",355,161,171,22,0,193,0.453521126760563
"141400819","CORDOBA",266,95,126,36,7,169,0.357142857142857
"141400818","CORDOBA",307,64,190,45,2,237,0.208469055374593
"141400817","CORDOBA",279,213,44,22,0,66,0.763440860215054
"141400815","CORDOBA",249,134,76,36,1,113,0.538152610441767
"141400809","CORDOBA",294,2,235,42,9,286,0.00680272108843537
"141401017","CORDOBA",306,155,115,32,2,149,0.506535947712418
"141400720","CORDOBA",279,64,164,38,11,213,0.229390681003584
"141400719","CORDOBA",292,162,123,7,0,130,0.554794520547945
"141400718","CORDOBA",347,246,95,6,0,101,0.708933717579251
"141400717","CORDOBA",116,20,84,8,0,92,0.172413793103448
"141400716","CORDOBA",317,267,31,0,0,31,0.842271293375394
"141400715","CORDOBA",284,100,157,25,1,183,0.352112676056338
"141400706","CORDOBA",390,142,197,38,8,243,0.364102564102564
"141400705","CORDOBA",389,74,249,53,4,306,0.190231362467866
"141400704","CORDOBA",198,164,31,2,0,33,0.828282828282828
"141400703","CORDOBA",243,212,27,4,0,31,0.872427983539095
"141400702","CORDOBA",344,274,61,8,0,69,0.796511627906977
"141400619","CORDOBA",328,3,292,29,0,321,0.00914634146341463
"141400618","CORDOBA",184,1,162,21,0,183,0.00543478260869565
"141400616","CORDOBA",378,9,344,22,1,367,0.0238095238095238
"141400615","CORDOBA",147,5,124,16,0,140,0.0340136054421769
"141400614","CORDOBA",251,10,204,31,6,241,0.0398406374501992
"141400613","CORDOBA",115,0,90,13,7,110,0
"141400612","CORDOBA",197,1,132,45,10,187,0.0050761421319797
"141400611","CORDOBA",243,2,224,14,1,239,0.00823045267489712
"141400610","CORDOBA",374,4,332,32,6,370,0.0106951871657754
"141400617","CORDOBA",189,4,157,26,1,184,0.0211640211640212
"141400516","CORDOBA",279,2,206,66,3,275,0.00716845878136201
"140982309","CORDOBA",258,242,7,8,0,15,0.937984496124031
"141400515","CORDOBA",265,0,228,37,0,265,0
"141400514","CORDOBA",292,0,256,33,0,289,0
"141400513","CORDOBA",202,0,158,42,1,201,0
"140982408","CORDOBA",201,201,0,0,0,0,1
"140982407","CORDOBA",189,188,1,0,0,1,0.994708994708995
"140982406","CORDOBA",375,373,1,1,0,2,0.994666666666667
"140982405","CORDOBA",368,363,3,2,0,5,0.986413043478261
"140982404","CORDOBA",328,321,3,4,0,7,0.978658536585366
"140982403","CORDOBA",138,135,3,0,0,3,0.978260869565217
"140982402","CORDOBA",212,212,0,0,0,0,1
"140982401","CORDOBA",295,293,2,0,0,2,0.993220338983051
"140982314","CORDOBA",222,128,34,25,1,60,0.576576576576577
"140982312","CORDOBA",423,409,6,7,0,13,0.966903073286052
"140982311","CORDOBA",262,245,3,7,0,10,0.935114503816794
"140982310","CORDOBA",254,246,4,3,0,7,0.968503937007874
"140982306","CORDOBA",267,265,0,0,0,0,0.99250936329588
"140982305","CORDOBA",178,177,1,0,0,1,0.99438202247191
"140982304","CORDOBA",414,401,5,3,0,8,0.968599033816425
"140982303","CORDOBA",232,220,7,4,0,11,0.948275862068966
"140982302","CORDOBA",265,257,4,3,1,8,0.969811320754717
"140982301","CORDOBA",358,355,3,0,0,3,0.991620111731844
"141540210","CORDOBA",182,0,176,6,0,182,0
"140982313","CORDOBA",334,294,22,17,0,39,0.880239520958084
"140982212","CORDOBA",230,87,81,53,1,135,0.378260869565217
"140982211","CORDOBA",299,265,1,22,2,25,0.88628762541806
"140982210","CORDOBA",357,193,64,82,3,149,0.540616246498599
"140982209","CORDOBA",271,117,52,88,1,141,0.431734317343173
"140982208","CORDOBA",304,257,30,13,2,45,0.845394736842105
"140982207","CORDOBA",335,291,29,15,0,44,0.86865671641791
"140982206","CORDOBA",360,357,1,2,0,3,0.991666666666667
"140982205","CORDOBA",398,397,0,1,0,1,0.99748743718593
"140982204","CORDOBA",201,169,14,14,0,28,0.840796019900497
"140982203","CORDOBA",345,337,6,2,0,8,0.976811594202899
"141400405","CORDOBA",213,4,204,4,0,208,0.0187793427230047
"140982202","CORDOBA",397,396,0,1,0,1,0.997481108312343
"140982201","CORDOBA",399,382,7,9,0,16,0.957393483709273
"140982114","CORDOBA",340,316,7,11,0,18,0.929411764705882
"140982113","CORDOBA",287,237,25,19,3,47,0.825783972125436
"140982112","CORDOBA",254,164,49,31,0,80,0.645669291338583
"140982111","CORDOBA",341,324,12,1,0,13,0.950146627565982
"140982110","CORDOBA",328,316,5,6,0,11,0.963414634146341
"140982109","CORDOBA",339,339,0,0,0,0,1
"140982108","CORDOBA",347,339,5,3,0,8,0.976945244956772
"140982105","CORDOBA",237,235,1,1,0,2,0.991561181434599
"140982104","CORDOBA",260,260,0,0,0,0,1
"140982103","CORDOBA",419,392,15,11,0,26,0.935560859188544
"140982102","CORDOBA",188,124,24,38,1,63,0.659574468085106
"140982101","CORDOBA",261,118,22,120,0,142,0.452107279693487
"140982019","CORDOBA",93,93,0,0,0,0,1
"140982018","CORDOBA",349,329,8,0,0,8,0.94269340974212
"140982017","CORDOBA",316,316,0,0,0,0,1
"141470407","CORDOBA",313,3,287,20,2,309,0.00958466453674121
"141470406","CORDOBA",139,1,71,44,4,119,0.00719424460431655
"141470313","CORDOBA",118,3,102,8,5,115,0.0254237288135593
"141470908","CORDOBA",308,199,75,14,0,89,0.646103896103896
"141470405","CORDOBA",166,8,125,26,5,156,0.0481927710843374
"141470310","CORDOBA",296,0,253,26,12,291,0
"140982016","CORDOBA",284,282,1,1,0,2,0.992957746478873
"140982015","CORDOBA",155,155,0,0,0,0,1
"140982014","CORDOBA",230,229,1,0,0,1,0.995652173913044
"140982013","CORDOBA",223,222,1,0,0,1,0.995515695067265
"140982010","CORDOBA",295,288,4,2,0,6,0.976271186440678
"140982009","CORDOBA",229,149,14,51,1,66,0.650655021834061
"140982007","CORDOBA",256,243,11,2,0,13,0.94921875
"140982006","CORDOBA",334,328,4,2,0,6,0.982035928143713
"140982005","CORDOBA",139,139,0,0,0,0,1
"140982004","CORDOBA",179,178,1,0,0,1,0.994413407821229
"140982003","CORDOBA",287,285,2,0,0,2,0.993031358885017
"140982002","CORDOBA",230,213,7,10,0,17,0.926086956521739
"140982001","CORDOBA",115,67,36,12,0,48,0.582608695652174
"140981912","CORDOBA",335,311,18,3,1,22,0.928358208955224
"141610609","CORDOBA",227,3,191,26,6,223,0.013215859030837
"140981904","CORDOBA",232,13,81,113,9,203,0.0560344827586207
"140981903","CORDOBA",335,192,20,88,7,115,0.573134328358209
"140981902","CORDOBA",595,9,193,315,39,547,0.0151260504201681
"140981901","CORDOBA",201,1,164,30,0,194,0.00497512437810945
"140981813","CORDOBA",313,211,20,66,10,96,0.674121405750799
"140981812","CORDOBA",305,265,25,14,0,39,0.868852459016393
"140981811","CORDOBA",319,310,5,3,0,8,0.971786833855799
"140981810","CORDOBA",442,265,79,81,0,160,0.599547511312217
"140981809","CORDOBA",451,389,35,24,0,59,0.862527716186253
"141610608","CORDOBA",204,2,173,27,1,201,0.00980392156862745
"140981907","CORDOBA",223,61,63,87,4,154,0.273542600896861
"140981808","CORDOBA",331,279,33,15,0,48,0.842900302114804
"140981807","CORDOBA",315,293,13,9,0,22,0.93015873015873
"140981806","CORDOBA",295,263,16,16,0,32,0.891525423728814
"140981805","CORDOBA",382,281,60,37,0,97,0.735602094240838
"140981804","CORDOBA",441,384,42,12,0,54,0.870748299319728
"140981803","CORDOBA",454,348,45,58,0,103,0.766519823788546
"140981802","CORDOBA",399,333,47,16,0,63,0.834586466165414
"140981713","CORDOBA",276,238,17,19,0,36,0.86231884057971
"140981711","CORDOBA",324,295,17,10,0,27,0.910493827160494
"140981710","CORDOBA",266,240,17,6,3,26,0.902255639097744
"140981709","CORDOBA",249,175,53,20,0,73,0.70281124497992
"140981707","CORDOBA",204,131,59,11,2,72,0.642156862745098
"140981705","CORDOBA",401,330,32,37,1,70,0.822942643391521
"140981704","CORDOBA",208,72,86,12,0,98,0.346153846153846
"140981703","CORDOBA",297,219,53,25,0,78,0.737373737373737
"140981702","CORDOBA",283,1,158,119,1,278,0.00353356890459364
"140981701","CORDOBA",436,11,254,153,10,417,0.0252293577981651
"140981615","CORDOBA",176,176,0,0,0,0,1
"140981614","CORDOBA",197,197,0,0,0,0,1
"140981612","CORDOBA",353,350,3,0,0,3,0.991501416430595
"140981611","CORDOBA",346,339,2,3,0,5,0.979768786127168
"140981610","CORDOBA",396,366,13,13,1,27,0.924242424242424
"140981609","CORDOBA",432,373,28,25,1,54,0.863425925925926
"140981905","CORDOBA",213,16,96,87,6,189,0.0751173708920188
"140981605","CORDOBA",399,373,11,15,0,26,0.93483709273183
"140981604","CORDOBA",207,170,12,17,0,29,0.821256038647343
"140981603","CORDOBA",193,137,23,26,4,53,0.709844559585492
"140981602","CORDOBA",371,205,75,79,4,158,0.55256064690027
"140981601","CORDOBA",283,16,162,102,0,264,0.0565371024734982
"140981515","CORDOBA",247,242,5,0,0,5,0.979757085020243
"140981514","CORDOBA",324,308,7,9,0,16,0.950617283950617
"140981513","CORDOBA",359,178,83,87,4,174,0.495821727019499
"140981512","CORDOBA",165,127,35,3,0,38,0.76969696969697
"140981511","CORDOBA",278,275,3,0,0,3,0.989208633093525
"140982914","CORDOBA",310,2,256,48,3,307,0.00645161290322581
"140981510","CORDOBA",346,129,123,91,0,214,0.372832369942197
"140981507","CORDOBA",288,249,16,20,0,36,0.864583333333333
"140981504","CORDOBA",289,203,56,29,0,85,0.70242214532872
"140981503","CORDOBA",355,145,147,54,0,201,0.408450704225352
"140981502","CORDOBA",321,2,136,148,11,295,0.00623052959501558
"140981501","CORDOBA",323,63,125,120,1,246,0.195046439628483
"140981410","CORDOBA",270,51,61,152,4,217,0.188888888888889
"140981708","CORDOBA",318,293,19,4,1,24,0.921383647798742
"140981506","CORDOBA",217,150,37,29,0,66,0.691244239631336
"140981608","CORDOBA",193,185,3,5,0,8,0.958549222797927
"140980908","CORDOBA",244,176,42,23,3,68,0.721311475409836
"140980907","CORDOBA",261,196,31,15,0,46,0.75095785440613
"140980905","CORDOBA",230,108,77,41,3,121,0.469565217391304
"140980904","CORDOBA",202,13,79,104,1,184,0.0643564356435644
"140981111","CORDOBA",275,7,199,59,2,260,0.0254545454545455
"140981110","CORDOBA",195,16,142,31,1,174,0.0820512820512821
"140980914","CORDOBA",263,184,50,24,1,75,0.699619771863118
"140980811","CORDOBA",106,0,71,26,5,102,0
"140980810","CORDOBA",152,0,105,42,1,148,0
"140980609","CORDOBA",36,0,22,13,1,36,0
"140980605","CORDOBA",34,0,21,10,2,33,0
"140980515","CORDOBA",226,3,191,31,1,223,0.0132743362831858
"140560320","CORDOBA",212,0,176,33,2,211,0
"140980309","CORDOBA",208,7,178,20,3,201,0.0336538461538462
"140980807","CORDOBA",171,26,100,41,2,143,0.152046783625731
"140980706","CORDOBA",31,2,14,15,0,29,0.0645161290322581
"140982913","CORDOBA",267,1,183,79,1,263,0.00374531835205993
"140980913","CORDOBA",279,210,56,12,1,69,0.752688172043011
"140980912","CORDOBA",365,258,45,53,5,103,0.706849315068493
"140980911","CORDOBA",118,92,20,6,0,26,0.779661016949153
"140980910","CORDOBA",215,156,34,22,2,58,0.725581395348837
"140980909","CORDOBA",260,73,87,84,6,177,0.280769230769231
"140981607","CORDOBA",225,182,11,28,2,41,0.808888888888889
"140980512","CORDOBA",292,3,241,48,0,289,0.0102739726027397
"141190909","CORDOBA",273,89,161,20,2,183,0.326007326007326
"140980511","CORDOBA",247,1,216,29,0,245,0.00404858299595142
"140980510","CORDOBA",274,6,134,132,0,266,0.0218978102189781
"140982912","CORDOBA",217,1,122,90,1,213,0.00460829493087558
"140982911","CORDOBA",231,4,178,48,0,226,0.0173160173160173
"140980708","CORDOBA",48,3,20,25,0,45,0.0625
"140980707","CORDOBA",55,0,28,22,3,53,0
"140982910","CORDOBA",259,1,186,69,3,258,0.00386100386100386
"140980517","CORDOBA",298,55,214,29,0,243,0.184563758389262
"140980308","CORDOBA",295,5,266,19,0,285,0.0169491525423729
"140980307","CORDOBA",212,3,203,5,0,208,0.0141509433962264
"140980306","CORDOBA",312,1,281,28,2,311,0.00320512820512821
"140982908","CORDOBA",167,0,130,37,0,167,0
"140980117","CORDOBA",290,2,233,42,7,282,0.00689655172413793
"140980116","CORDOBA",247,0,229,16,0,245,0
"140980115","CORDOBA",244,20,210,12,1,223,0.0819672131147541
"140980114","CORDOBA",213,1,172,31,5,208,0.00469483568075117
"140980113","CORDOBA",245,4,213,25,2,240,0.0163265306122449
"140980112","CORDOBA",205,1,171,31,1,203,0.0048780487804878
"140980111","CORDOBA",214,2,176,34,0,210,0.00934579439252336
"140980110","CORDOBA",256,0,206,41,8,255,0
"140980109","CORDOBA",240,0,220,18,1,239,0
"140980108","CORDOBA",177,1,142,30,2,174,0.00564971751412429
"140980211","CORDOBA",306,1,300,4,0,304,0.00326797385620915
"140980209","CORDOBA",187,16,122,38,7,167,0.0855614973262032
"141330614","CORDOBA",325,2,277,46,0,323,0.00615384615384615
"140911914","CORDOBA",147,2,108,23,8,139,0.0136054421768707
"141610607","CORDOBA",282,2,218,62,0,280,0.00709219858156028
"140981211","CORDOBA",177,176,1,0,0,1,0.994350282485876
"140911711","CORDOBA",170,1,142,27,0,169,0.00588235294117647
"141330511","CORDOBA",287,5,256,22,1,279,0.0174216027874564
"140911809","CORDOBA",171,4,122,11,31,164,0.0233918128654971
"140981209","CORDOBA",187,176,6,4,0,10,0.941176470588235
"140981208","CORDOBA",264,254,7,3,0,10,0.962121212121212
"140981207","CORDOBA",263,252,8,2,0,10,0.958174904942966
"140911709","CORDOBA",224,2,196,23,1,220,0.00892857142857143
"140911708","CORDOBA",196,0,188,7,1,196,0
"140982903","CORDOBA",163,0,118,39,3,160,0
"140981313","CORDOBA",165,0,54,94,9,157,0
"140911710","CORDOBA",149,2,118,29,0,147,0.0134228187919463
"141260517","CORDOBA",170,1,143,19,3,165,0.00588235294117647
"140981312","CORDOBA",329,4,216,98,1,315,0.0121580547112462
"140981311","CORDOBA",233,1,147,76,1,224,0.00429184549356223
"140911610","CORDOBA",84,0,64,13,3,80,0
"140911714","CORDOBA",161,6,139,4,11,154,0.0372670807453416
"140911712","CORDOBA",142,0,117,21,4,142,0
"141190912","CORDOBA",374,21,335,17,0,352,0.0561497326203209
"141330212","CORDOBA",172,1,150,19,1,170,0.00581395348837209
"140911609","CORDOBA",130,1,97,23,5,125,0.00769230769230769
"140911713","CORDOBA",259,7,193,39,20,252,0.027027027027027
"140981012","CORDOBA",219,187,22,7,1,30,0.853881278538813
"140981011","CORDOBA",307,270,18,15,0,33,0.879478827361563
"140981010","CORDOBA",202,181,8,12,0,20,0.896039603960396
"141330613","CORDOBA",347,2,305,36,0,341,0.00576368876080692
"140911510","CORDOBA",243,131,92,18,0,110,0.539094650205761
"140911507","CORDOBA",209,24,131,52,0,183,0.114832535885167
"141330307","CORDOBA",355,1,257,92,1,350,0.0028169014084507
"140911509","CORDOBA",218,147,45,24,0,69,0.674311926605505
"140911508","CORDOBA",213,42,142,25,0,167,0.197183098591549
"140911504","CORDOBA",195,80,84,27,1,112,0.41025641025641
"141330503","CORDOBA",223,1,207,15,0,222,0.00448430493273543
"141330501","CORDOBA",317,10,259,33,5,297,0.0315457413249211
"141330214","CORDOBA",241,0,180,54,4,238,0
"140560319","CORDOBA",353,5,291,55,2,348,0.0141643059490085
"140911505","CORDOBA",169,25,88,46,3,137,0.14792899408284
"141610606","CORDOBA",338,8,280,45,2,327,0.0236686390532544
"141330505","CORDOBA",238,1,157,51,5,213,0.00420168067226891
"141400213","CORDOBA",99,0,93,6,0,99,0
"140911415","CORDOBA",169,0,149,18,2,169,0
"141330504","CORDOBA",238,0,213,23,0,236,0
"141330308","CORDOBA",124,1,68,38,1,107,0.00806451612903226
"141190913","CORDOBA",184,68,114,2,0,116,0.369565217391304
"141190709","CORDOBA",295,2,253,31,5,289,0.00677966101694915
"141330411","CORDOBA",175,0,116,42,0,158,0
"141400211","CORDOBA",176,1,156,13,4,173,0.00568181818181818
"141330515","CORDOBA",379,4,335,31,0,366,0.0105540897097625
"141330514","CORDOBA",129,1,117,10,0,127,0.00775193798449612
"141330112","CORDOBA",261,4,148,96,7,251,0.0153256704980843
"141330512","CORDOBA",336,6,233,79,9,321,0.0178571428571429
"141330309","CORDOBA",215,0,139,53,5,197,0
"141330216","CORDOBA",195,0,149,39,3,191,0
"141330215","CORDOBA",57,0,46,8,1,55,0
"141330213","CORDOBA",348,1,298,36,3,337,0.0028735632183908
"141330110","CORDOBA",271,5,224,36,0,260,0.018450184501845
"141330211","CORDOBA",179,4,156,13,5,174,0.0223463687150838
"141330210","CORDOBA",70,1,55,6,3,64,0.0142857142857143
"141330209","CORDOBA",113,1,104,8,0,112,0.00884955752212389
"141330208","CORDOBA",202,2,162,32,2,196,0.0099009900990099
"141260713","CORDOBA",89,1,82,5,1,88,0.0112359550561798
"141330612","CORDOBA",177,2,148,20,1,169,0.0112994350282486
"141260711","CORDOBA",202,3,191,5,0,196,0.0148514851485149
"141260710","CORDOBA",141,0,117,23,1,141,0
"141190904","CORDOBA",244,6,225,6,6,237,0.0245901639344262
"141260709","CORDOBA",200,2,191,6,0,197,0.01
"141260708","CORDOBA",267,15,231,15,0,246,0.0561797752808989
"141260516","CORDOBA",206,3,172,27,0,199,0.0145631067961165
"141260109","CORDOBA",119,0,74,37,0,111,0
"141260707","CORDOBA",199,0,164,35,0,199,0
"141260706","CORDOBA",216,0,204,11,1,216,0
"141400407","CORDOBA",333,2,321,10,0,331,0.00600600600600601
"141190903","CORDOBA",181,2,166,10,3,179,0.0110497237569061
"141260705","CORDOBA",254,2,242,10,0,252,0.0078740157480315
"141260704","CORDOBA",202,0,161,26,4,191,0
"141260703","CORDOBA",159,2,150,6,1,157,0.0125786163522013
"141190917","CORDOBA",349,3,320,24,1,345,0.00859598853868195
"141260702","CORDOBA",223,4,206,11,0,217,0.0179372197309417
"141190902","CORDOBA",287,19,241,19,1,261,0.0662020905923345
"141190901","CORDOBA",248,9,214,19,3,236,0.0362903225806452
"141190816","CORDOBA",244,4,215,19,1,235,0.0163934426229508
"141190815","CORDOBA",402,4,362,25,0,387,0.00995024875621891
"141260701","CORDOBA",157,0,152,4,1,157,0
"141330601","CORDOBA",291,4,275,11,0,286,0.013745704467354
"141260609","CORDOBA",160,0,151,8,1,160,0
"141330517","CORDOBA",234,1,205,23,2,230,0.00427350427350427
"141260611","CORDOBA",36,0,29,3,1,33,0
"141190814","CORDOBA",298,4,278,13,1,292,0.0134228187919463
"141190813","CORDOBA",298,7,285,6,0,291,0.023489932885906
"141190812","CORDOBA",326,5,273,38,5,316,0.0153374233128834
"141190811","CORDOBA",302,6,266,29,1,296,0.0198675496688742
"141260610","CORDOBA",181,1,128,29,6,163,0.00552486187845304
"141260514","CORDOBA",203,2,168,23,0,191,0.00985221674876847
"141260513","CORDOBA",147,1,118,26,1,145,0.00680272108843537
"141260512","CORDOBA",370,1,308,44,0,352,0.0027027027027027
"141260507","CORDOBA",112,0,41,57,5,103,0
"141400406","CORDOBA",245,3,237,5,0,242,0.0122448979591837
"141260515","CORDOBA",122,1,97,13,3,113,0.00819672131147541
"141260312","CORDOBA",245,0,238,4,2,244,0
"141260309","CORDOBA",165,1,152,11,0,163,0.00606060606060606
"141260311","CORDOBA",260,5,247,7,0,254,0.0192307692307692
"141260310","CORDOBA",125,3,108,12,2,122,0.024
"141260313","CORDOBA",220,1,205,12,0,217,0.00454545454545455
"141330516","CORDOBA",263,12,212,17,0,229,0.0456273764258555
"141260518","CORDOBA",123,1,75,33,8,116,0.00813008130081301
"141190810","CORDOBA",331,2,305,22,1,328,0.00604229607250755
"141190809","CORDOBA",331,5,321,4,0,325,0.0151057401812689
"141190807","CORDOBA",228,11,192,19,1,212,0.0482456140350877
"141190806","CORDOBA",215,0,165,44,2,211,0
"141190805","CORDOBA",237,5,210,19,3,232,0.0210970464135021
"141190804","CORDOBA",241,2,222,15,0,237,0.00829875518672199
"141190803","CORDOBA",193,0,174,17,1,192,0
"141190801","CORDOBA",287,0,225,45,5,275,0
"141190714","CORDOBA",215,3,177,20,8,205,0.013953488372093
"141190713","CORDOBA",271,0,240,18,10,268,0
"141190712","CORDOBA",260,2,232,21,5,258,0.00769230769230769
"141190711","CORDOBA",228,5,206,13,3,222,0.0219298245614035
"141190710","CORDOBA",353,9,318,20,5,343,0.0254957507082153
"141190708","CORDOBA",318,0,255,37,15,307,0
"141190707","CORDOBA",306,3,291,12,0,303,0.00980392156862745
"141190705","CORDOBA",342,9,302,24,3,329,0.0263157894736842
"141190704","CORDOBA",363,8,311,36,4,351,0.0220385674931129
"141190606","CORDOBA",377,3,347,19,1,367,0.00795755968169761
"141190703","CORDOBA",444,2,389,38,4,431,0.0045045045045045
"141190702","CORDOBA",303,19,250,25,2,277,0.0627062706270627
"141190701","CORDOBA",304,11,238,31,6,275,0.0361842105263158
"141190621","CORDOBA",289,4,241,34,3,278,0.013840830449827
"141190112","CORDOBA",324,1,267,49,5,321,0.00308641975308642
"141190620","CORDOBA",287,13,238,27,5,270,0.0452961672473868
"141190619","CORDOBA",295,7,279,6,1,286,0.023728813559322
"141190618","CORDOBA",254,2,227,23,0,250,0.0078740157480315
"141190610","CORDOBA",248,1,223,18,3,244,0.00403225806451613
"141190609","CORDOBA",255,5,234,13,0,247,0.0196078431372549
"141190608","CORDOBA",225,9,203,11,1,215,0.04
"141190607","CORDOBA",308,4,283,17,1,301,0.012987012987013
"141190605","CORDOBA",384,11,348,16,5,369,0.0286458333333333
"141190604","CORDOBA",248,14,213,20,0,233,0.0564516129032258
"141190603","CORDOBA",296,3,286,6,1,293,0.0101351351351351
"141190602","CORDOBA",342,9,276,44,6,326,0.0263157894736842
"141190601","CORDOBA",350,2,298,39,4,341,0.00571428571428571
"141190515","CORDOBA",238,1,235,2,0,237,0.00420168067226891
"141190514","CORDOBA",299,3,261,30,3,294,0.0100334448160535
"141190513","CORDOBA",221,1,199,14,4,217,0.00452488687782805
"141190111","CORDOBA",255,3,239,12,0,251,0.0117647058823529
"141190512","CORDOBA",272,3,236,24,7,267,0.0110294117647059
"141190511","CORDOBA",272,1,244,18,6,268,0.00367647058823529
"141190617","CORDOBA",218,5,195,17,0,212,0.0229357798165138
"141190616","CORDOBA",235,6,213,12,0,225,0.025531914893617
"141190615","CORDOBA",220,5,201,8,2,211,0.0227272727272727
"141190614","CORDOBA",159,0,139,18,1,158,0
"141190420","CORDOBA",271,10,228,30,1,259,0.03690036900369
"141190419","CORDOBA",280,119,153,7,1,161,0.425
"141190418","CORDOBA",389,241,106,40,2,148,0.619537275064267
"141190417","CORDOBA",212,93,101,15,2,118,0.438679245283019
"141190416","CORDOBA",207,105,87,10,1,98,0.507246376811594
"141190415","CORDOBA",233,72,132,27,0,159,0.309012875536481
"141190110","CORDOBA",154,0,145,7,1,153,0
"141190414","CORDOBA",293,58,201,31,1,233,0.197952218430034
"141190413","CORDOBA",349,5,290,40,6,336,0.0143266475644699
"141190412","CORDOBA",251,4,232,12,1,245,0.0159362549800797
"141190411","CORDOBA",392,7,353,30,1,384,0.0178571428571429
"141190612","CORDOBA",283,6,253,19,1,273,0.0212014134275618
"141190316","CORDOBA",337,273,56,7,0,63,0.810089020771513
"141190215","CORDOBA",213,6,188,15,2,205,0.028169014084507
"141190214","CORDOBA",242,9,204,11,9,224,0.0371900826446281
"141190213","CORDOBA",317,7,272,34,3,309,0.0220820189274448
"141190310","CORDOBA",240,197,37,6,0,43,0.820833333333333
"141190315","CORDOBA",318,258,46,11,2,59,0.811320754716981
"141400510","CORDOBA",103,6,84,13,0,97,0.058252427184466
"141190115","CORDOBA",317,0,289,23,3,315,0
"141190114","CORDOBA",282,12,242,23,0,265,0.0425531914893617
"141190109","CORDOBA",376,0,330,35,0,365,0
"141190108","CORDOBA",329,3,287,36,1,324,0.00911854103343465
"141190107","CORDOBA",190,1,177,10,0,187,0.00526315789473684
"141190106","CORDOBA",205,2,182,15,3,200,0.00975609756097561
"141190309","CORDOBA",96,0,89,6,1,96,0
"141190308","CORDOBA",285,2,245,32,3,280,0.00701754385964912
"141050512","CORDOBA",225,14,185,21,2,208,0.0622222222222222
"141050511","CORDOBA",216,3,203,10,0,213,0.0138888888888889
"141050510","CORDOBA",294,5,265,14,0,279,0.0170068027210884
"141120314","CORDOBA",66,0,61,2,1,64,0
"141120312","CORDOBA",257,0,214,34,2,250,0
"141120311","CORDOBA",192,0,132,48,5,185,0
"141050610","CORDOBA",366,19,334,10,1,345,0.0519125683060109
"141050609","CORDOBA",300,3,281,12,3,296,0.01
"140982703","CORDOBA",367,255,98,10,0,108,0.694822888283379
"141050608","CORDOBA",298,1,277,16,0,293,0.00335570469798658
"141050607","CORDOBA",186,1,166,16,0,182,0.00537634408602151
"141050606","CORDOBA",173,2,152,18,0,170,0.0115606936416185
"141190306","CORDOBA",291,2,279,8,1,288,0.00687285223367698
"141120115","CORDOBA",176,0,162,13,0,175,0
"141120114","CORDOBA",113,0,100,10,1,111,0
"141120113","CORDOBA",203,0,191,7,0,198,0
"141120112","CORDOBA",293,0,257,30,1,288,0
"141050513","CORDOBA",141,1,138,1,0,139,0.00709219858156028
"141190314","CORDOBA",403,340,55,8,0,63,0.843672456575682
"141050415","CORDOBA",244,2,216,23,3,242,0.00819672131147541
"141050414","CORDOBA",141,0,118,19,0,137,0
"141190313","CORDOBA",212,176,33,3,0,36,0.830188679245283
"141190312","CORDOBA",199,158,27,8,2,37,0.793969849246231
"141050308","CORDOBA",146,1,107,15,4,126,0.00684931506849315
"141050315","CORDOBA",332,4,280,41,4,325,0.0120481927710843
"140210710","CORDOBA",200,189,3,0,0,3,0.945
"141050314","CORDOBA",315,62,234,11,1,246,0.196825396825397
"141050313","CORDOBA",342,112,185,29,2,216,0.327485380116959
"141050215","CORDOBA",311,4,297,6,3,306,0.0128617363344051
"141050214","CORDOBA",254,6,225,20,1,246,0.0236220472440945
"141050213","CORDOBA",209,2,197,8,2,207,0.00956937799043062
"141050212","CORDOBA",216,7,193,12,0,205,0.0324074074074074
"141050211","CORDOBA",247,5,219,15,0,234,0.0202429149797571
"141050210","CORDOBA",135,8,123,3,0,126,0.0592592592592593
"141190311","CORDOBA",228,161,41,20,3,64,0.706140350877193
"141120111","CORDOBA",134,0,124,8,1,133,0
"140145206","CORDOBA",191,182,7,2,0,9,0.952879581151832
"141050515","CORDOBA",247,3,201,37,2,240,0.0121457489878543
"141050312","CORDOBA",228,3,212,12,0,224,0.0131578947368421
"141610610","CORDOBA",266,3,244,18,0,262,0.0112781954887218
"141050311","CORDOBA",159,0,148,8,0,156,0
"141050310","CORDOBA",293,6,243,40,1,284,0.0204778156996587
"140982702","CORDOBA",381,140,206,31,1,238,0.36745406824147
"141050309","CORDOBA",367,3,325,34,1,360,0.00817438692098093
"140982811","CORDOBA",187,2,112,67,3,182,0.0106951871657754
"140982810","CORDOBA",255,43,136,73,3,212,0.168627450980392
"140982809","CORDOBA",274,152,68,52,1,121,0.554744525547445
"140982808","CORDOBA",182,129,42,9,0,51,0.708791208791209
"140982807","CORDOBA",220,0,64,141,5,210,0
"140982806","CORDOBA",232,1,176,34,11,221,0.00431034482758621
"140982805","CORDOBA",211,20,100,69,10,179,0.0947867298578199
"140982804","CORDOBA",188,23,110,43,10,163,0.122340425531915
"140982803","CORDOBA",196,80,91,24,1,116,0.408163265306122
"140982802","CORDOBA",326,25,221,73,5,299,0.0766871165644172
"140982605","CORDOBA",291,272,9,8,0,17,0.934707903780069
"140982801","CORDOBA",383,11,244,118,4,366,0.0287206266318538
"140982708","CORDOBA",311,217,77,17,0,94,0.697749196141479
"140982707","CORDOBA",335,182,122,28,2,152,0.543283582089552
"140982706","CORDOBA",258,184,51,22,0,73,0.713178294573643
"140982613","CORDOBA",173,98,27,42,5,74,0.566473988439306
"140982612","CORDOBA",292,226,15,44,0,59,0.773972602739726
"140982611","CORDOBA",269,86,67,109,0,176,0.319702602230483
"140982610","CORDOBA",257,148,66,34,0,100,0.575875486381323
"140982609","CORDOBA",260,167,38,43,3,84,0.642307692307692
"140982608","CORDOBA",312,291,4,10,1,15,0.932692307692308
"140982607","CORDOBA",328,309,3,13,1,17,0.942073170731707
"140982606","CORDOBA",251,247,1,2,0,3,0.98406374501992
"141400313","CORDOBA",131,3,120,7,0,127,0.0229007633587786
"140982604","CORDOBA",383,359,13,9,0,22,0.93733681462141
"140982603","CORDOBA",447,427,18,2,0,20,0.955257270693512
"140982602","CORDOBA",299,284,3,9,1,13,0.949832775919732
"141400511","CORDOBA",327,0,246,64,10,320,0
"140982601","CORDOBA",290,268,14,6,0,20,0.924137931034483
"140982512","CORDOBA",417,191,44,152,6,202,0.458033573141487
"141400408","CORDOBA",346,4,319,15,2,336,0.0115606936416185
"140982511","CORDOBA",427,373,17,33,0,50,0.873536299765808
"140982510","CORDOBA",244,231,7,3,1,11,0.94672131147541
"140982509","CORDOBA",233,208,7,14,1,22,0.892703862660944
"140982508","CORDOBA",335,206,46,73,3,122,0.614925373134328
"140982507","CORDOBA",350,17,159,141,4,304,0.0485714285714286
"140982506","CORDOBA",378,323,18,9,4,31,0.854497354497355
"140982505","CORDOBA",376,335,15,24,0,39,0.890957446808511
"140982504","CORDOBA",283,265,11,5,0,16,0.936395759717314
"140982503","CORDOBA",290,278,9,3,0,12,0.958620689655172
"140982502","CORDOBA",378,365,6,3,3,12,0.965608465608466
"140982501","CORDOBA",308,293,4,9,0,13,0.951298701298701
"140982421","CORDOBA",251,247,2,1,0,3,0.98406374501992
"140982420","CORDOBA",356,354,0,0,0,0,0.99438202247191
"140982418","CORDOBA",238,236,2,0,0,2,0.991596638655462
"140982417","CORDOBA",308,292,4,3,0,7,0.948051948051948
"140982416","CORDOBA",290,289,1,0,0,1,0.996551724137931
"140982415","CORDOBA",229,224,5,0,0,5,0.978165938864629
"140982414","CORDOBA",356,356,0,0,0,0,1
"140982413","CORDOBA",327,303,20,2,2,24,0.926605504587156
"140982412","CORDOBA",315,314,1,0,0,1,0.996825396825397
"140145110","CORDOBA",237,207,22,8,0,30,0.873417721518987
"140982411","CORDOBA",365,363,1,1,0,2,0.994520547945206
"140982410","CORDOBA",298,297,1,0,0,1,0.996644295302013
"140982409","CORDOBA",311,311,0,0,0,0,1
"141400512","CORDOBA",222,0,193,26,2,221,0
"141400508","CORDOBA",311,0,253,43,13,309,0
"141400413","CORDOBA",376,3,338,23,2,363,0.00797872340425532
"141400412","CORDOBA",342,10,316,9,2,327,0.0292397660818713
"141400411","CORDOBA",188,2,177,8,1,186,0.0106382978723404
"141400410","CORDOBA",242,3,232,4,0,236,0.012396694214876
"141400409","CORDOBA",356,4,328,16,5,349,0.0112359550561798
"141611015","CORDOBA",200,196,2,2,0,4,0.98
"141400403","CORDOBA",186,8,172,4,0,176,0.043010752688172
"141400402","CORDOBA",236,4,227,4,1,232,0.0169491525423729
"141400401","CORDOBA",219,3,195,19,1,215,0.0136986301369863
"141400311","CORDOBA",232,2,212,16,1,229,0.00862068965517241
"141400310","CORDOBA",273,4,256,9,1,266,0.0146520146520147
"141400309","CORDOBA",213,3,196,12,1,209,0.0140845070422535
"141400308","CORDOBA",335,1,309,18,1,328,0.00298507462686567
"141400307","CORDOBA",296,2,276,16,1,293,0.00675675675675676
"141400306","CORDOBA",278,5,256,16,0,272,0.0179856115107914
"141400305","CORDOBA",311,3,293,15,0,308,0.00964630225080386
"141400304","CORDOBA",217,3,202,10,0,212,0.0138248847926267
"141400303","CORDOBA",215,11,195,8,0,203,0.0511627906976744
"141400302","CORDOBA",396,5,370,18,1,389,0.0126262626262626
"141400301","CORDOBA",350,4,322,17,0,339,0.0114285714285714
"141400112","CORDOBA",246,3,230,8,3,241,0.0121951219512195
"141400111","CORDOBA",239,2,211,12,7,230,0.00836820083682008
"140145311","CORDOBA",251,251,0,0,0,0,1
"141400110","CORDOBA",183,6,165,9,2,176,0.0327868852459016
"141400109","CORDOBA",293,4,273,14,0,287,0.0136518771331058
"141330617","CORDOBA",195,6,182,4,2,188,0.0307692307692308
"141330616","CORDOBA",239,6,211,17,0,228,0.0251046025104603
"141330615","CORDOBA",231,5,210,15,0,225,0.0216450216450216
"141330611","CORDOBA",202,9,187,4,1,192,0.0445544554455446
"141330610","CORDOBA",287,2,272,12,0,284,0.00696864111498258
"141330609","CORDOBA",261,1,239,21,0,260,0.00383141762452107
"141330608","CORDOBA",237,0,220,14,0,234,0
"141330607","CORDOBA",289,3,168,102,3,273,0.0103806228373702
"141330606","CORDOBA",177,0,136,33,3,172,0
"141330605","CORDOBA",275,3,208,49,0,257,0.0109090909090909
"141330604","CORDOBA",241,20,197,22,2,221,0.0829875518672199
"141330603","CORDOBA",285,2,238,40,0,278,0.00701754385964912
"141330602","CORDOBA",406,9,362,30,1,393,0.0221674876847291
"141330510","CORDOBA",355,4,330,19,1,350,0.0112676056338028
"141330509","CORDOBA",236,2,221,12,1,234,0.00847457627118644
"141330506","CORDOBA",316,4,263,48,0,311,0.0126582278481013
"141190916","CORDOBA",308,29,270,7,0,277,0.0941558441558442
"140911407","CORDOBA",301,5,242,37,3,282,0.0166112956810631
"140145109","CORDOBA",312,257,39,16,0,55,0.823717948717949
"140840108","CORDOBA",384,46,286,50,1,337,0.119791666666667
"141820121","CORDOBA",224,1,198,23,2,223,0.00446428571428571
"141330409","CORDOBA",369,0,301,59,1,361,0
"141330508","CORDOBA",250,12,220,6,0,226,0.048
"141330507","CORDOBA",273,1,262,10,0,272,0.00366300366300366
"140911502","CORDOBA",141,33,58,44,1,103,0.234042553191489
"140911413","CORDOBA",281,8,235,37,0,272,0.0284697508896797
"140911412","CORDOBA",209,3,173,26,2,201,0.0143540669856459
"140911410","CORDOBA",364,6,283,66,1,350,0.0164835164835165
"140911409","CORDOBA",283,6,233,33,0,266,0.0212014134275618
"140911406","CORDOBA",139,5,116,17,0,133,0.0359712230215827
"141190915","CORDOBA",231,2,222,4,2,228,0.00865800865800866
"140981009","CORDOBA",168,131,21,14,0,35,0.779761904761905
"141820120","CORDOBA",320,0,306,14,0,320,0
"140911408","CORDOBA",237,2,214,20,1,235,0.00843881856540084
"140981606","CORDOBA",176,128,14,19,0,33,0.727272727272727
"140911323","CORDOBA",183,2,160,15,4,179,0.0109289617486339
"141190914","CORDOBA",319,22,275,21,0,296,0.0689655172413793
"140911318","CORDOBA",120,8,95,12,5,112,0.0666666666666667
"140911317","CORDOBA",126,14,95,1,11,107,0.111111111111111
"140911316","CORDOBA",101,0,89,7,2,98,0
"140911315","CORDOBA",239,7,203,12,14,229,0.0292887029288703
"140911314","CORDOBA",135,4,116,14,0,130,0.0296296296296296
"140631202","CORDOBA",207,200,2,5,0,7,0.966183574879227
"140911313","CORDOBA",243,7,203,14,11,228,0.0288065843621399
"140911312","CORDOBA",170,0,155,8,5,168,0
"140911311","CORDOBA",287,3,247,13,14,274,0.0104529616724739
"140911310","CORDOBA",100,0,83,14,3,100,0
"141190808","CORDOBA",347,4,315,22,3,340,0.0115273775216138
"140911223","CORDOBA",173,2,117,47,1,165,0.0115606936416185
"140911222","CORDOBA",234,1,174,55,2,231,0.00427350427350427
"140911221","CORDOBA",220,17,194,9,0,203,0.0772727272727273
"140911220","CORDOBA",221,24,178,16,0,194,0.108597285067873
"140911219","CORDOBA",275,9,233,31,1,265,0.0327272727272727
"140911218","CORDOBA",194,3,162,25,2,189,0.0154639175257732
"140911217","CORDOBA",184,1,145,10,28,183,0.00543478260869565
"140911216","CORDOBA",136,4,122,9,1,132,0.0294117647058824
"140911215","CORDOBA",283,5,242,34,1,277,0.0176678445229682
"140911214","CORDOBA",273,8,227,35,1,263,0.0293040293040293
"140911213","CORDOBA",223,4,187,25,6,218,0.0179372197309417
"140911212","CORDOBA",175,0,139,21,14,174,0
"140911211","CORDOBA",280,2,237,33,6,276,0.00714285714285714
"140911210","CORDOBA",272,3,249,14,4,267,0.0110294117647059
"140911115","CORDOBA",221,200,19,2,0,21,0.904977375565611
"140911113","CORDOBA",185,113,51,19,1,71,0.610810810810811
"140911209","CORDOBA",218,18,179,19,1,199,0.0825688073394495
"140911206","CORDOBA",192,18,153,20,0,173,0.09375
"140911205","CORDOBA",317,31,257,27,1,285,0.0977917981072555
"140911204","CORDOBA",291,67,216,6,2,224,0.230240549828179
"140911203","CORDOBA",262,158,97,6,1,104,0.603053435114504
"140911201","CORDOBA",315,78,198,36,2,236,0.247619047619048
"140911118","CORDOBA",198,150,35,13,0,48,0.757575757575758
"140911117","CORDOBA",121,120,1,0,0,1,0.991735537190083
"140911116","CORDOBA",174,161,12,1,0,13,0.925287356321839
"140911114","CORDOBA",186,139,40,5,1,46,0.747311827956989
"140911112","CORDOBA",247,23,187,34,0,221,0.0931174089068826
"140911111","CORDOBA",157,138,16,2,0,18,0.878980891719745
"140911110","CORDOBA",322,300,19,1,0,20,0.93167701863354
"140911109","CORDOBA",202,193,8,0,1,9,0.955445544554455
"140911108","CORDOBA",200,185,14,1,0,15,0.925
"140911107","CORDOBA",146,141,5,0,0,5,0.965753424657534
"140911106","CORDOBA",104,91,7,6,0,13,0.875
"140911105","CORDOBA",287,134,140,11,2,153,0.466898954703833
"140911104","CORDOBA",194,109,75,7,3,85,0.561855670103093
"140911208","CORDOBA",345,7,234,83,11,328,0.0202898550724638
"140911103","CORDOBA",191,110,77,4,0,81,0.575916230366492
"140911102","CORDOBA",158,153,4,0,0,4,0.968354430379747
"140911101","CORDOBA",214,201,11,2,0,13,0.939252336448598
"140981509","CORDOBA",330,106,127,95,1,223,0.321212121212121
"140911020","CORDOBA",112,9,92,11,0,103,0.0803571428571429
"140911019","CORDOBA",181,25,118,38,0,156,0.138121546961326
"140911018","CORDOBA",215,144,66,5,0,71,0.669767441860465
"140911017","CORDOBA",199,146,47,6,0,53,0.733668341708543
"140911016","CORDOBA",192,6,131,55,0,186,0.03125
"140911015","CORDOBA",236,8,196,32,0,228,0.0338983050847458
"140911014","CORDOBA",178,142,33,3,0,36,0.797752808988764
"141821009","CORDOBA",287,185,60,38,0,98,0.644599303135889
"140911013","CORDOBA",274,85,184,5,0,189,0.31021897810219
"140911012","CORDOBA",209,181,19,8,0,27,0.866028708133971
"140631201","CORDOBA",227,177,27,21,0,48,0.779735682819383
"140911011","CORDOBA",218,9,192,17,0,209,0.0412844036697248
"140911010","CORDOBA",238,10,160,68,0,228,0.0420168067226891
"140982902","CORDOBA",285,2,135,139,4,278,0.00701754385964912
"140911004","CORDOBA",339,96,217,26,0,243,0.283185840707965
"140911003","CORDOBA",222,35,163,24,0,187,0.157657657657658
"140911002","CORDOBA",212,4,182,25,1,208,0.0188679245283019
"140910917","CORDOBA",241,3,192,40,6,238,0.012448132780083
"140840505","CORDOBA",258,83,98,67,1,166,0.321705426356589
"140911001","CORDOBA",214,20,161,25,7,193,0.0934579439252336
"140910923","CORDOBA",0,0,0,0,0,0,NA
"140910921","CORDOBA",413,3,316,55,19,390,0.00726392251815981
"140910920","CORDOBA",255,7,210,29,6,245,0.0274509803921569
"140631008","CORDOBA",235,202,13,2,0,15,0.859574468085106
"140910919","CORDOBA",217,7,186,15,9,210,0.032258064516129
"140910918","CORDOBA",140,130,10,0,0,10,0.928571428571429
"140910915","CORDOBA",328,14,285,16,6,307,0.0426829268292683
"140910914","CORDOBA",300,2,236,23,8,267,0.00666666666666667
"140910912","CORDOBA",219,10,178,22,8,208,0.045662100456621
"140910911","CORDOBA",129,107,21,1,0,22,0.829457364341085
"140700212","CORDOBA",135,0,128,6,1,135,0
"140910909","CORDOBA",236,190,28,18,0,46,0.805084745762712
"140910908","CORDOBA",257,20,200,21,0,221,0.0778210116731518
"140145108","CORDOBA",268,234,23,10,0,33,0.873134328358209
"140910907","CORDOBA",249,10,183,9,24,216,0.0401606425702811
"140910906","CORDOBA",293,55,214,17,2,233,0.187713310580205
"140911005","CORDOBA",219,13,184,19,3,206,0.0593607305936073
"140910904","CORDOBA",325,27,234,33,30,297,0.0830769230769231
"140910903","CORDOBA",155,50,90,14,1,105,0.32258064516129
"140910902","CORDOBA",163,8,146,8,0,154,0.049079754601227
"140910901","CORDOBA",255,6,198,27,23,248,0.0235294117647059
"140910813","CORDOBA",315,9,245,24,28,297,0.0285714285714286
"140631116","CORDOBA",370,348,13,8,0,21,0.940540540540541
"140910812","CORDOBA",243,8,164,40,27,231,0.0329218106995885
"140910922","CORDOBA",386,3,335,28,3,366,0.0077720207253886
"140910406","CORDOBA",243,217,14,11,0,25,0.893004115226337
"140910811","CORDOBA",171,0,149,17,5,171,0
"140910809","CORDOBA",214,3,202,8,0,210,0.014018691588785
"140911009","CORDOBA",222,190,24,8,0,32,0.855855855855856
"140910722","CORDOBA",332,6,286,36,2,324,0.0180722891566265
"140910808","CORDOBA",134,1,99,22,9,130,0.00746268656716418
"140911207","CORDOBA",277,9,224,38,1,263,0.0324909747292419
"140631115","CORDOBA",224,223,1,0,0,1,0.995535714285714
"140910806","CORDOBA",198,1,176,20,1,197,0.00505050505050505
"140910504","CORDOBA",316,157,106,50,1,157,0.496835443037975
"140631302","CORDOBA",205,0,111,85,3,199,0
"140910805","CORDOBA",166,2,142,20,1,163,0.0120481927710843
"140910720","CORDOBA",399,9,341,36,0,377,0.0225563909774436
"140910913","CORDOBA",215,46,132,25,6,163,0.213953488372093
"140631301","CORDOBA",351,1,226,96,9,331,0.00284900284900285
"140910807","CORDOBA",174,1,150,20,2,172,0.00574712643678161
"140910804","CORDOBA",99,1,70,13,3,86,0.0101010101010101
"140910905","CORDOBA",358,3,288,42,20,350,0.00837988826815642
"140631215","CORDOBA",319,235,25,56,1,82,0.736677115987461
"140910723","CORDOBA",246,6,163,59,3,225,0.024390243902439
"140910719","CORDOBA",189,2,152,34,0,186,0.0105820105820106
"140910413","CORDOBA",357,246,92,16,0,108,0.689075630252101
"140910718","CORDOBA",308,5,285,18,0,303,0.0162337662337662
"140910717","CORDOBA",168,0,117,32,5,154,0
"140982901","CORDOBA",254,5,178,70,0,248,0.0196850393700787
"140982022","CORDOBA",210,209,1,0,0,1,0.995238095238095
"140910716","CORDOBA",288,7,230,50,1,281,0.0243055555555556
"140910505","CORDOBA",281,21,185,64,0,249,0.0747330960854092
"140910419","CORDOBA",202,0,136,56,2,194,0
"140910309","CORDOBA",284,210,63,9,0,72,0.73943661971831
"140910502","CORDOBA",153,39,88,15,4,107,0.254901960784314
"140910714","CORDOBA",251,126,105,19,1,125,0.50199203187251
"140910611","CORDOBA",213,6,183,21,0,204,0.028169014084507
"140982812","CORDOBA",274,14,122,129,6,257,0.0510948905109489
"140910404","CORDOBA",263,141,83,38,1,122,0.536121673003802
"140910418","CORDOBA",252,172,62,17,0,79,0.682539682539683
"141401809","CORDOBA",275,5,247,22,1,270,0.0181818181818182
"140910713","CORDOBA",412,102,258,44,1,303,0.247572815533981
"140910412","CORDOBA",110,76,26,8,0,34,0.690909090909091
"140981910","CORDOBA",232,220,6,6,0,12,0.948275862068966
"140631114","CORDOBA",241,240,1,0,0,1,0.995850622406639
"140910403","CORDOBA",236,163,58,13,0,71,0.690677966101695
"140910510","CORDOBA",200,20,130,48,0,178,0.1
"140910408","CORDOBA",227,82,118,27,0,145,0.361233480176211
"140910407","CORDOBA",322,123,168,29,1,198,0.381987577639752
"140631113","CORDOBA",306,306,0,0,0,0,1
"140910402","CORDOBA",290,210,58,18,1,77,0.724137931034483
"140910401","CORDOBA",265,15,160,78,4,242,0.0566037735849057
"141821008","CORDOBA",178,174,3,1,0,4,0.97752808988764
"140631112","CORDOBA",156,155,1,0,0,1,0.993589743589744
"140910310","CORDOBA",196,79,95,22,0,117,0.403061224489796
"140840506","CORDOBA",245,92,108,40,1,149,0.375510204081633
"140631214","CORDOBA",328,300,14,13,0,27,0.914634146341463
"140910307","CORDOBA",203,30,127,37,7,171,0.147783251231527
"140910306","CORDOBA",179,50,107,21,0,128,0.279329608938547
"140910304","CORDOBA",291,20,188,68,2,258,0.0687285223367698
"140910405","CORDOBA",265,152,65,39,1,105,0.573584905660377
"140631111","CORDOBA",254,250,1,2,0,3,0.984251968503937
"140631213","CORDOBA",264,236,14,13,0,27,0.893939393939394
"140631212","CORDOBA",307,269,15,17,0,32,0.876221498371335
"140910311","CORDOBA",180,20,126,29,0,155,0.111111111111111
"140981909","CORDOBA",217,203,1,9,2,12,0.935483870967742
"140910210","CORDOBA",250,4,175,69,0,244,0.016
"140910209","CORDOBA",267,0,222,38,3,263,0
"140911906","CORDOBA",195,0,132,14,47,193,0
"140770212","CORDOBA",56,0,46,5,0,51,0
"140911913","CORDOBA",196,2,172,18,2,192,0.0102040816326531
"140911910","CORDOBA",195,3,162,23,5,190,0.0153846153846154
"140911909","CORDOBA",200,5,168,7,18,193,0.025
"140982906","CORDOBA",235,1,136,93,1,230,0.00425531914893617
"140840504","CORDOBA",328,21,217,80,4,301,0.0640243902439024
"140840503","CORDOBA",203,4,95,96,2,193,0.0197044334975369
"140911908","CORDOBA",225,0,177,28,18,223,0
"140911907","CORDOBA",126,3,99,11,12,122,0.0238095238095238
"140982907","CORDOBA",138,2,99,37,0,136,0.0144927536231884
"140981210","CORDOBA",193,177,4,11,1,16,0.917098445595855
"140911810","CORDOBA",36,1,32,3,0,35,0.0277777777777778
"140982419","CORDOBA",169,169,0,0,0,0,1
"141401212","CORDOBA",303,114,116,72,0,188,0.376237623762376
"140910211","CORDOBA",99,1,76,22,0,98,0.0101010101010101
"140910119","CORDOBA",145,2,96,43,1,140,0.0137931034482759
"140910118","CORDOBA",232,97,103,29,1,133,0.418103448275862
"140910117","CORDOBA",153,93,38,18,0,56,0.607843137254902
"140910107","CORDOBA",241,227,11,3,0,14,0.941908713692946
"140840502","CORDOBA",197,0,110,71,10,191,0
"140840501","CORDOBA",267,195,54,16,0,70,0.730337078651685
"140910115","CORDOBA",106,23,52,23,3,78,0.216981132075472
"140910114","CORDOBA",247,149,82,11,1,94,0.603238866396761
"140910113","CORDOBA",273,227,15,13,0,28,0.831501831501832
"140910112","CORDOBA",205,174,19,11,0,30,0.848780487804878
"140910111","CORDOBA",175,90,67,17,1,85,0.514285714285714
"140910110","CORDOBA",204,179,17,8,0,25,0.877450980392157
"140910109","CORDOBA",151,132,17,1,1,19,0.874172185430464
"140910108","CORDOBA",247,233,14,0,0,14,0.94331983805668
"140910105","CORDOBA",92,36,36,16,4,56,0.391304347826087
"140981908","CORDOBA",268,155,36,72,2,110,0.578358208955224
"140910104","CORDOBA",233,9,182,29,9,220,0.0386266094420601
"140910103","CORDOBA",222,202,19,1,0,20,0.90990990990991
"140910102","CORDOBA",119,93,17,2,7,26,0.781512605042017
"140840508","CORDOBA",346,235,100,11,0,111,0.679190751445087
"140840507","CORDOBA",249,188,36,23,2,61,0.755020080321285
"140910101","CORDOBA",231,133,70,20,3,93,0.575757575757576
"140840527","CORDOBA",175,118,46,9,0,55,0.674285714285714
"140840526","CORDOBA",209,174,21,11,1,33,0.832535885167464
"140840525","CORDOBA",203,181,19,3,0,22,0.891625615763547
"140840524","CORDOBA",229,123,77,20,7,104,0.537117903930131
"140840523","CORDOBA",260,134,79,45,0,124,0.515384615384615
"140840522","CORDOBA",283,263,12,8,0,20,0.929328621908127
"140840521","CORDOBA",295,105,134,54,1,189,0.355932203389831
"140840520","CORDOBA",189,165,13,6,0,19,0.873015873015873
"140840519","CORDOBA",238,34,158,40,3,201,0.142857142857143
"140840518","CORDOBA",245,130,90,21,3,114,0.530612244897959
"140840517","CORDOBA",214,195,18,1,0,19,0.911214953271028
"140840515","CORDOBA",271,254,9,8,0,17,0.937269372693727
"140840514","CORDOBA",365,236,102,26,0,128,0.646575342465753
"140840513","CORDOBA",257,192,58,6,0,64,0.747081712062257
"140840512","CORDOBA",311,223,65,22,1,88,0.717041800643087
"140840106","CORDOBA",356,2,272,73,3,348,0.00561797752808989
"140770211","CORDOBA",196,0,183,10,3,196,0
"140770210","CORDOBA",230,0,207,19,2,228,0
"140840409","CORDOBA",306,167,78,55,0,133,0.545751633986928
"140840408","CORDOBA",293,112,92,88,1,181,0.382252559726962
"140840407","CORDOBA",231,140,39,52,0,91,0.606060606060606
"140770110","CORDOBA",122,0,62,40,2,104,0
"140770213","CORDOBA",58,0,45,4,0,49,0
"141401211","CORDOBA",374,150,175,47,1,223,0.401069518716578
"141401210","CORDOBA",334,95,184,48,4,236,0.284431137724551
"140700211","CORDOBA",92,0,79,10,1,90,0
"141401209","CORDOBA",261,199,47,15,0,62,0.762452107279693
"140631314","CORDOBA",293,8,255,30,0,285,0.0273037542662116
"140631313","CORDOBA",192,0,151,41,0,192,0
"140631312","CORDOBA",203,13,176,14,0,190,0.0640394088669951
"140631311","CORDOBA",232,12,182,38,0,220,0.0517241379310345
"140631310","CORDOBA",158,0,128,30,0,158,0
"140631309","CORDOBA",343,3,285,54,0,339,0.0087463556851312
"140631308","CORDOBA",266,0,250,16,0,266,0
"140631307","CORDOBA",177,4,140,33,0,173,0.0225988700564972
"140631306","CORDOBA",284,4,259,21,0,280,0.0140845070422535
"140631305","CORDOBA",424,2,366,54,0,420,0.00471698113207547
"140631304","CORDOBA",244,1,173,69,1,243,0.00409836065573771
"140631303","CORDOBA",339,0,234,104,0,338,0
"140631207","CORDOBA",281,265,5,7,1,13,0.943060498220641
"140631206","CORDOBA",319,269,16,34,0,50,0.843260188087774
"140631205","CORDOBA",360,359,0,1,0,1,0.997222222222222
"140631204","CORDOBA",171,168,1,1,1,3,0.982456140350877
"140631203","CORDOBA",260,258,1,1,0,2,0.992307692307692
"140631109","CORDOBA",195,168,7,17,2,26,0.861538461538462
"140631106","CORDOBA",199,179,10,10,0,20,0.899497487437186
"140631105","CORDOBA",374,357,9,1,2,12,0.954545454545455
"140631104","CORDOBA",268,132,25,106,2,133,0.492537313432836
"140631102","CORDOBA",283,226,26,24,2,52,0.798586572438163
"140631101","CORDOBA",366,301,27,31,3,61,0.822404371584699
"140631013","CORDOBA",381,8,203,162,1,366,0.020997375328084
"140631012","CORDOBA",344,5,190,147,2,339,0.0145348837209302
"140631011","CORDOBA",238,203,22,12,1,35,0.852941176470588
"140631010","CORDOBA",223,69,96,58,0,154,0.309417040358744
"140631009","CORDOBA",256,219,26,11,0,37,0.85546875
"140631006","CORDOBA",262,241,13,8,0,21,0.919847328244275
"140631005","CORDOBA",194,172,16,6,0,22,0.88659793814433
"140631004","CORDOBA",229,27,154,48,0,202,0.117903930131004
"140631003","CORDOBA",353,225,93,35,0,128,0.637393767705382
"140631001","CORDOBA",165,2,57,87,8,152,0.0121212121212121
"140630923","CORDOBA",189,0,148,37,3,188,0
"140630916","CORDOBA",312,8,227,75,1,303,0.0256410256410256
"140630915","CORDOBA",332,1,245,82,3,330,0.00301204819277108
"140630914","CORDOBA",290,0,181,82,9,272,0
"140630913","CORDOBA",185,0,62,93,3,158,0
"140630912","CORDOBA",224,5,169,46,1,216,0.0223214285714286
"140630911","CORDOBA",187,5,159,22,1,182,0.0267379679144385
"140630922","CORDOBA",353,1,181,137,17,335,0.0028328611898017
"140630921","CORDOBA",301,0,239,51,7,297,0
"140420811","CORDOBA",228,223,3,1,0,4,0.978070175438597
"140630920","CORDOBA",272,4,219,48,0,267,0.0147058823529412
"140630812","CORDOBA",208,2,160,37,4,201,0.00961538461538462
"140630810","CORDOBA",239,2,211,22,2,235,0.00836820083682008
"140630809","CORDOBA",219,2,205,12,0,217,0.0091324200913242
"140630808","CORDOBA",248,0,220,26,1,247,0
"140630807","CORDOBA",151,0,96,46,6,148,0
"140630711","CORDOBA",217,6,143,42,14,199,0.0276497695852535
"140630710","CORDOBA",120,1,60,49,4,113,0.00833333333333333
"140630613","CORDOBA",293,2,246,34,5,285,0.0068259385665529
"140630612","CORDOBA",228,2,216,9,1,226,0.0087719298245614
"140630611","CORDOBA",306,8,238,59,0,297,0.0261437908496732
"140630610","CORDOBA",252,3,222,26,0,248,0.0119047619047619
"140630609","CORDOBA",296,6,201,75,6,282,0.0202702702702703
"140630608","CORDOBA",219,5,196,17,1,214,0.0228310502283105
"140630607","CORDOBA",291,1,225,58,2,285,0.00343642611683849
"140141604","CORDOBA",204,10,142,45,0,187,0.0490196078431373
"140630517","CORDOBA",131,2,48,79,0,127,0.0152671755725191
"140630504","CORDOBA",185,121,40,24,0,64,0.654054054054054
"140630510","CORDOBA",351,3,209,120,8,337,0.00854700854700855
"141820812","CORDOBA",131,131,0,0,0,0,1
"140630407","CORDOBA",322,1,192,123,2,317,0.0031055900621118
"140630309","CORDOBA",198,178,15,3,2,20,0.898989898989899
"140630308","CORDOBA",256,207,22,27,0,49,0.80859375
"140630307","CORDOBA",247,226,14,6,0,20,0.91497975708502
"140630306","CORDOBA",312,281,18,11,0,29,0.900641025641026
"140630305","CORDOBA",272,235,18,16,1,35,0.863970588235294
"140630304","CORDOBA",249,178,28,40,1,69,0.714859437751004
"140630513","CORDOBA",288,0,183,105,0,288,0
"140630512","CORDOBA",188,1,91,94,2,187,0.00531914893617021
"140630511","CORDOBA",221,1,153,65,2,220,0.00452488687782805
"140630509","CORDOBA",193,0,133,58,0,191,0
"140630508","CORDOBA",282,3,153,120,2,275,0.0106382978723404
"140630507","CORDOBA",231,156,44,28,1,73,0.675324675324675
"140560707","CORDOBA",213,206,4,3,0,7,0.967136150234742
"140630215","CORDOBA",142,1,82,53,1,136,0.00704225352112676
"140630214","CORDOBA",204,64,86,49,0,135,0.313725490196078
"140630506","CORDOBA",276,192,68,15,0,83,0.695652173913043
"140630505","CORDOBA",282,194,71,17,0,88,0.687943262411348
"140910609","CORDOBA",179,9,144,25,0,169,0.0502793296089385
"140910710","CORDOBA",167,1,141,7,0,148,0.00598802395209581
"140910709","CORDOBA",335,17,277,34,0,311,0.0507462686567164
"140910607","CORDOBA",308,5,276,23,1,300,0.0162337662337662
"140910715","CORDOBA",356,2,329,25,0,354,0.00561797752808989
"141821004","CORDOBA",295,175,54,49,17,120,0.593220338983051
"140630109","CORDOBA",278,0,157,119,2,278,0
"140910708","CORDOBA",279,6,258,14,0,272,0.021505376344086
"140910712","CORDOBA",289,2,257,30,0,287,0.0069204152249135
"140910711","CORDOBA",288,7,265,14,1,280,0.0243055555555556
"140910707","CORDOBA",271,5,249,16,0,265,0.018450184501845
"140560706","CORDOBA",340,217,74,40,3,117,0.638235294117647
"140910706","CORDOBA",151,2,131,11,2,144,0.0132450331125828
"140982021","CORDOBA",236,236,0,0,0,0,1
"140911008","CORDOBA",239,175,64,0,0,64,0.732217573221757
"140910705","CORDOBA",200,4,177,18,1,196,0.02
"140910610","CORDOBA",325,4,296,24,1,321,0.0123076923076923
"140560617","CORDOBA",270,2,219,38,10,267,0.00740740740740741
"140910703","CORDOBA",337,14,270,46,4,320,0.0415430267062315
"140910702","CORDOBA",198,3,180,12,1,193,0.0151515151515152
"140910618","CORDOBA",142,1,99,31,4,134,0.00704225352112676
"140911006","CORDOBA",290,25,237,24,4,265,0.0862068965517241
"140560703","CORDOBA",290,166,58,64,1,123,0.572413793103448
"140560702","CORDOBA",218,142,64,12,0,76,0.651376146788991
"140910617","CORDOBA",191,5,159,23,2,184,0.0261780104712042
"140910615","CORDOBA",173,3,140,21,7,168,0.0173410404624277
"140910614","CORDOBA",197,4,178,13,0,191,0.0203045685279188
"140910613","CORDOBA",227,3,177,42,1,220,0.013215859030837
"140982020","CORDOBA",200,199,1,0,0,1,0.995
"140910606","CORDOBA",254,9,207,32,1,240,0.0354330708661417
"140981911","CORDOBA",312,279,17,14,0,31,0.894230769230769
"140560701","CORDOBA",231,182,22,26,0,48,0.787878787878788
"140910612","CORDOBA",180,5,144,26,3,173,0.0277777777777778
"140910721","CORDOBA",401,4,364,25,1,390,0.00997506234413965
"140910509","CORDOBA",191,4,134,51,0,185,0.0209424083769634
"140910508","CORDOBA",101,3,62,30,2,94,0.0297029702970297
"140560616","CORDOBA",229,19,190,16,1,207,0.0829694323144105
"140910507","CORDOBA",161,48,88,21,1,110,0.298136645962733
"140630515","CORDOBA",340,5,182,150,1,333,0.0147058823529412
"140560714","CORDOBA",230,211,8,4,6,18,0.917391304347826
"140560713","CORDOBA",317,5,155,133,4,292,0.0157728706624606
"140560705","CORDOBA",198,153,10,33,0,43,0.772727272727273
"140560704","CORDOBA",247,166,25,54,1,80,0.672064777327935
"140560615","CORDOBA",259,5,195,39,8,242,0.0193050193050193
"140560710","CORDOBA",228,194,24,9,0,33,0.850877192982456
"140630514","CORDOBA",261,0,150,110,0,260,0
"140560509","CORDOBA",201,1,172,27,1,200,0.00497512437810945
"140560508","CORDOBA",205,1,169,30,2,201,0.0048780487804878
"140560709","CORDOBA",400,236,128,32,1,161,0.59
"140560414","CORDOBA",290,2,206,78,2,286,0.00689655172413793
"140560413","CORDOBA",298,6,205,74,6,285,0.0201342281879195
"140560412","CORDOBA",191,5,121,54,7,182,0.0261780104712042
"140560411","CORDOBA",237,5,173,56,3,232,0.0210970464135021
"140560408","CORDOBA",152,3,103,36,10,149,0.0197368421052632
"140560407","CORDOBA",382,1,263,94,20,377,0.00261780104712042
"140560708","CORDOBA",350,304,41,4,0,45,0.868571428571429
"141821311","CORDOBA",245,1,131,102,9,242,0.00408163265306122
"141821101","CORDOBA",149,124,21,4,0,25,0.832214765100671
"140560311","CORDOBA",303,2,260,30,3,293,0.0066006600660066
"140630917","CORDOBA",129,0,86,39,3,128,0
"141820610","CORDOBA",249,116,20,104,2,126,0.465863453815261
"141820608","CORDOBA",205,0,140,58,2,200,0
"141820607","CORDOBA",334,1,264,58,4,326,0.0029940119760479
"140560206","CORDOBA",309,264,37,5,0,42,0.854368932038835
"140560205","CORDOBA",323,263,48,7,0,55,0.814241486068111
"140560204","CORDOBA",214,165,40,7,1,48,0.771028037383178
"141820514","CORDOBA",213,1,131,80,0,211,0.00469483568075117
"141820513","CORDOBA",235,2,130,99,1,230,0.00851063829787234
"141820512","CORDOBA",245,4,157,76,3,236,0.0163265306122449
"141820511","CORDOBA",312,4,230,76,1,307,0.0128205128205128
"141820510","CORDOBA",174,1,89,80,3,172,0.00574712643678161
"140630516","CORDOBA",296,3,143,149,1,293,0.0101351351351351
"141401208","CORDOBA",271,234,16,19,0,35,0.863468634686347
"141820411","CORDOBA",326,0,236,86,3,325,0
"141820410","CORDOBA",221,6,196,19,0,215,0.0271493212669683
"141820409","CORDOBA",242,1,185,55,0,240,0.00413223140495868
"141820408","CORDOBA",116,2,54,51,1,106,0.0172413793103448
"140631107","CORDOBA",248,246,0,2,0,2,0.991935483870968
"140560118","CORDOBA",248,156,66,24,2,92,0.629032258064516
"140560117","CORDOBA",360,213,95,45,5,145,0.591666666666667
"140560116","CORDOBA",239,207,25,4,3,32,0.866108786610879
"140560115","CORDOBA",192,129,54,7,0,61,0.671875
"140560114","CORDOBA",227,181,40,4,1,45,0.797356828193833
"140560112","CORDOBA",244,186,36,19,1,56,0.762295081967213
"141820310","CORDOBA",375,0,257,88,13,358,0
"141820309","CORDOBA",174,2,143,28,1,172,0.0114942528735632
"141820308","CORDOBA",229,3,181,31,8,220,0.0131004366812227
"140560111","CORDOBA",251,23,188,34,6,228,0.0916334661354582
"141820212","CORDOBA",167,0,104,28,16,148,0
"141820211","CORDOBA",271,3,197,46,16,259,0.011070110701107
"141820210","CORDOBA",265,4,176,66,13,255,0.0150943396226415
"141820209","CORDOBA",266,7,210,41,5,256,0.0263157894736842
"140560110","CORDOBA",278,75,144,37,9,190,0.26978417266187
"140560109","CORDOBA",263,39,142,51,14,207,0.14828897338403
"140560108","CORDOBA",345,18,261,45,11,317,0.0521739130434783
"140560107","CORDOBA",285,121,152,9,2,163,0.424561403508772
"141820119","CORDOBA",298,3,261,33,1,295,0.0100671140939597
"141820118","CORDOBA",271,2,236,29,2,267,0.00738007380073801
"141820117","CORDOBA",225,1,172,37,7,216,0.00444444444444444
"141820116","CORDOBA",344,0,245,81,17,343,0
"140560214","CORDOBA",450,330,94,14,0,108,0.733333333333333
"140490325","CORDOBA",272,6,233,22,4,259,0.0220588235294118
"140560213","CORDOBA",476,425,41,5,0,46,0.892857142857143
"140490111","CORDOBA",130,2,107,15,2,124,0.0153846153846154
"140490323","CORDOBA",211,2,169,35,0,204,0.00947867298578199
"140490322","CORDOBA",326,5,283,32,0,315,0.0153374233128834
"140490314","CORDOBA",208,3,167,32,3,202,0.0144230769230769
"140490313","CORDOBA",224,1,204,15,2,221,0.00446428571428571
"140490312","CORDOBA",265,2,229,28,0,257,0.00754716981132075
"140490311","CORDOBA",329,3,288,32,5,325,0.00911854103343465
"140490310","CORDOBA",240,0,234,6,0,240,0
"140490309","CORDOBA",306,4,278,23,0,301,0.0130718954248366
"140490308","CORDOBA",237,7,210,19,0,229,0.029535864978903
"140490307","CORDOBA",267,13,252,1,0,253,0.048689138576779
"140420917","CORDOBA",250,223,18,7,0,25,0.892
"140420916","CORDOBA",288,254,28,6,0,34,0.881944444444444
"140420914","CORDOBA",328,327,1,0,0,1,0.996951219512195
"140420913","CORDOBA",260,258,1,0,0,1,0.992307692307692
"140420912","CORDOBA",123,121,2,0,0,2,0.983739837398374
"140420911","CORDOBA",200,200,0,0,0,0,1
"140420910","CORDOBA",208,173,11,21,0,32,0.831730769230769
"140420909","CORDOBA",380,371,5,1,0,6,0.976315789473684
"140420908","CORDOBA",206,204,1,0,1,2,0.990291262135922
"140420907","CORDOBA",208,203,4,0,0,4,0.975961538461538
"140420906","CORDOBA",320,255,52,11,0,63,0.796875
"140420905","CORDOBA",312,88,193,30,0,223,0.282051282051282
"140420904","CORDOBA",242,0,184,50,1,235,0
"140420901","CORDOBA",238,5,98,133,1,232,0.0210084033613445
"140420823","CORDOBA",242,231,3,6,0,9,0.954545454545455
"140420822","CORDOBA",196,183,8,5,0,13,0.933673469387755
"140420820","CORDOBA",205,205,0,0,0,0,1
"140420819","CORDOBA",416,98,208,97,8,313,0.235576923076923
"140420810","CORDOBA",349,345,3,1,0,4,0.988538681948424
"140630918","CORDOBA",280,2,230,46,0,276,0.00714285714285714
"141680312","CORDOBA",224,4,154,41,6,201,0.0178571428571429
"140560712","CORDOBA",409,126,122,151,1,274,0.308068459657702
"140420818","CORDOBA",278,272,5,1,0,6,0.97841726618705
"140421107","CORDOBA",438,33,192,205,0,397,0.0753424657534247
"140420817","CORDOBA",192,192,0,0,0,0,1
"140420816","CORDOBA",276,11,125,123,2,250,0.0398550724637681
"140420815","CORDOBA",291,3,82,203,0,285,0.0103092783505155
"140420814","CORDOBA",254,251,3,0,0,3,0.988188976377953
"140420813","CORDOBA",177,175,0,1,0,1,0.988700564971751
"140420812","CORDOBA",327,325,1,0,0,1,0.99388379204893
"140420809","CORDOBA",281,281,0,0,0,0,1
"140420808","CORDOBA",214,211,1,2,0,3,0.985981308411215
"140420807","CORDOBA",283,281,1,1,0,2,0.992932862190813
"140420806","CORDOBA",246,245,1,0,0,1,0.995934959349594
"140560711","CORDOBA",355,185,123,44,2,169,0.52112676056338
"140420805","CORDOBA",302,301,1,0,0,1,0.996688741721854
"140420712","CORDOBA",256,202,26,27,1,54,0.7890625
"140420711","CORDOBA",587,491,46,27,1,74,0.836456558773424
"140420710","CORDOBA",344,213,68,55,0,123,0.619186046511628
"140420709","CORDOBA",348,229,64,50,2,116,0.658045977011494
"140420708","CORDOBA",311,285,19,5,0,24,0.916398713826367
"140420707","CORDOBA",313,308,2,3,0,5,0.984025559105431
"140630709","CORDOBA",308,5,280,21,0,301,0.0162337662337662
"140630919","CORDOBA",214,0,180,34,0,214,0
"140630708","CORDOBA",312,7,287,16,1,304,0.0224358974358974
"140630706","CORDOBA",280,5,217,56,1,274,0.0178571428571429
"140630615","CORDOBA",253,2,203,44,2,249,0.00790513833992095
"140420706","CORDOBA",257,255,2,0,0,2,0.992217898832685
"140420704","CORDOBA",294,252,4,6,0,10,0.857142857142857
"140420703","CORDOBA",408,253,95,52,4,151,0.620098039215686
"140420702","CORDOBA",325,179,52,83,1,136,0.550769230769231
"140420621","CORDOBA",416,373,41,1,0,42,0.896634615384615
"140420620","CORDOBA",178,177,0,1,0,1,0.99438202247191
"140420619","CORDOBA",178,176,2,0,0,2,0.98876404494382
"140420618","CORDOBA",204,149,31,21,1,53,0.730392156862745
"140420617","CORDOBA",298,294,3,1,0,4,0.986577181208054
"140420616","CORDOBA",382,326,38,17,0,55,0.853403141361257
"140420615","CORDOBA",317,31,160,121,1,282,0.0977917981072555
"140420614","CORDOBA",297,295,2,0,0,2,0.993265993265993
"140420613","CORDOBA",302,300,1,1,0,2,0.993377483443709
"140420612","CORDOBA",178,177,1,0,0,1,0.99438202247191
"140420608","CORDOBA",424,405,9,9,0,18,0.955188679245283
"140420607","CORDOBA",242,236,4,0,0,4,0.975206611570248
"140420606","CORDOBA",337,336,1,0,0,1,0.997032640949555
"140420605","CORDOBA",295,289,5,1,0,6,0.979661016949153
"140420604","CORDOBA",309,308,1,0,0,1,0.996763754045307
"140420603","CORDOBA",341,211,54,59,0,113,0.618768328445748
"140420602","CORDOBA",243,176,49,15,0,64,0.724279835390947
"140420601","CORDOBA",265,67,92,96,2,190,0.252830188679245
"140420517","CORDOBA",318,4,272,35,3,310,0.0125786163522013
"140420516","CORDOBA",197,3,137,53,1,191,0.0152284263959391
"140420510","CORDOBA",176,3,103,64,0,167,0.0170454545454545
"141680214","CORDOBA",191,1,164,20,4,188,0.00523560209424084
"141680213","CORDOBA",224,4,205,13,1,219,0.0178571428571429
"141680211","CORDOBA",259,15,229,12,0,241,0.0579150579150579
"140420514","CORDOBA",268,4,220,44,0,264,0.0149253731343284
"140420405","CORDOBA",377,329,27,21,0,48,0.872679045092838
"140420419","CORDOBA",200,118,41,36,0,77,0.59
"140420418","CORDOBA",291,235,15,37,0,52,0.807560137457045
"140420409","CORDOBA",271,195,33,37,1,71,0.719557195571956
"140420314","CORDOBA",394,5,331,56,1,388,0.0126903553299492
"140420313","CORDOBA",422,11,353,57,0,410,0.0260663507109005
"140420312","CORDOBA",121,1,103,15,1,119,0.00826446280991736
"140420311","CORDOBA",266,5,243,18,0,261,0.018796992481203
"140420310","CORDOBA",326,0,227,83,7,317,0
"141120313","CORDOBA",235,0,176,48,3,227,0
"141680111","CORDOBA",211,6,176,20,1,197,0.028436018957346
"141680110","CORDOBA",97,0,83,14,0,97,0
"140420408","CORDOBA",325,255,50,18,0,68,0.784615384615385
"140420407","CORDOBA",338,284,18,33,2,53,0.840236686390533
"140420406","CORDOBA",330,309,12,9,0,21,0.936363636363636
"140420404","CORDOBA",389,332,47,9,0,56,0.853470437017995
"140420403","CORDOBA",237,163,37,33,2,72,0.687763713080169
"140420402","CORDOBA",242,205,19,17,0,36,0.847107438016529
"141611006","CORDOBA",287,286,1,0,0,1,0.996515679442509
"141611005","CORDOBA",236,235,1,0,0,1,0.995762711864407
"140350214","CORDOBA",280,6,242,26,2,270,0.0214285714285714
"140420401","CORDOBA",320,282,27,10,0,37,0.88125
"141610913","CORDOBA",276,273,3,0,0,3,0.989130434782609
"140420513","CORDOBA",214,7,172,29,3,204,0.0327102803738318
"141610812","CORDOBA",192,161,29,2,0,31,0.838541666666667
"141610809","CORDOBA",174,97,66,9,1,76,0.557471264367816
"140420512","CORDOBA",222,1,174,42,2,218,0.0045045045045045
"140420112","CORDOBA",133,2,107,22,0,129,0.0150375939849624
"140420111","CORDOBA",288,5,237,37,4,278,0.0173611111111111
"140420110","CORDOBA",233,3,219,8,0,227,0.0128755364806867
"140420109","CORDOBA",354,2,300,37,6,343,0.00564971751412429
"140420511","CORDOBA",175,0,148,25,1,174,0
"140420417","CORDOBA",225,88,64,70,0,134,0.391111111111111
"140420416","CORDOBA",211,134,37,35,0,72,0.635071090047393
"140420415","CORDOBA",388,164,91,116,1,208,0.422680412371134
"140350514","CORDOBA",205,4,143,54,4,201,0.0195121951219512
"140350512","CORDOBA",381,0,254,122,4,380,0
"140350511","CORDOBA",259,1,201,55,2,258,0.00386100386100386
"140350509","CORDOBA",213,2,120,74,12,206,0.00938967136150235
"140350508","CORDOBA",232,3,140,85,0,225,0.0129310344827586
"140350318","CORDOBA",371,4,327,37,1,365,0.0107816711590297
"140350317","CORDOBA",371,0,275,82,11,368,0
"140350316","CORDOBA",272,0,182,83,3,268,0
"140350315","CORDOBA",295,242,39,11,0,50,0.820338983050847
"140350314","CORDOBA",229,185,30,13,1,44,0.807860262008734
"140350313","CORDOBA",256,187,48,18,3,69,0.73046875
"140350312","CORDOBA",281,229,35,8,8,51,0.814946619217082
"140350311","CORDOBA",300,231,57,11,0,68,0.77
"140350310","CORDOBA",164,25,83,47,0,130,0.152439024390244
"141610413","CORDOBA",230,2,206,21,0,227,0.00869565217391304
"141610412","CORDOBA",245,0,204,36,1,241,0
"141610411","CORDOBA",90,0,83,3,0,86,0
"140350406","CORDOBA",340,94,210,32,0,242,0.276470588235294
"140350213","CORDOBA",346,2,290,49,3,342,0.00578034682080925
"140350212","CORDOBA",363,0,302,59,0,361,0
"140350211","CORDOBA",217,0,79,101,11,191,0
"140420413","CORDOBA",349,156,120,48,6,174,0.446991404011461
"141610313","CORDOBA",170,5,148,13,1,162,0.0294117647058824
"141610312","CORDOBA",152,0,109,40,3,152,0
"141610311","CORDOBA",199,4,161,31,1,193,0.0201005025125628
"140350405","CORDOBA",262,100,104,54,0,158,0.381679389312977
"141610213","CORDOBA",214,2,200,8,1,209,0.00934579439252336
"141610117","CORDOBA",330,15,251,55,5,311,0.0454545454545455
"140350107","CORDOBA",120,0,31,77,7,115,0
"140280606","CORDOBA",198,2,162,22,4,188,0.0101010101010101
"140280308","CORDOBA",232,205,20,7,0,27,0.883620689655172
"140280607","CORDOBA",282,6,218,41,3,262,0.0212765957446809
"140420412","CORDOBA",298,232,34,29,0,63,0.778523489932886
"140280511","CORDOBA",218,4,177,25,4,206,0.018348623853211
"140144506","CORDOBA",298,295,3,0,0,3,0.98993288590604
"140280510","CORDOBA",231,4,207,11,0,218,0.0173160173160173
"140280508","CORDOBA",267,11,211,36,2,249,0.0411985018726592
"140280507","CORDOBA",275,1,228,34,3,265,0.00363636363636364
"140280506","CORDOBA",287,4,227,43,9,279,0.0139372822299652
"140280515","CORDOBA",114,1,92,12,2,106,0.0087719298245614
"140280514","CORDOBA",394,2,354,36,1,391,0.0050761421319797
"140280513","CORDOBA",214,0,188,21,2,211,0
"140280512","CORDOBA",217,2,182,22,3,207,0.00921658986175115
"140280408","CORDOBA",211,1,156,31,15,202,0.004739336492891
"140280407","CORDOBA",213,1,139,52,10,201,0.00469483568075117
"140280303","CORDOBA",324,11,254,58,0,312,0.0339506172839506
"140280302","CORDOBA",326,45,241,30,2,273,0.138036809815951
"140211116","CORDOBA",222,10,203,9,0,212,0.045045045045045
"140280409","CORDOBA",268,1,184,57,6,247,0.00373134328358209
"140420411","CORDOBA",339,257,50,24,2,76,0.75811209439528
"141471007","CORDOBA",237,180,53,4,0,57,0.759493670886076
"141470905","CORDOBA",224,54,125,35,4,164,0.241071428571429
"140280312","CORDOBA",175,2,103,50,5,158,0.0114285714285714
"140280311","CORDOBA",304,3,250,38,1,289,0.00986842105263158
"140280310","CORDOBA",294,4,263,22,0,285,0.0136054421768707
"140280309","CORDOBA",303,237,54,11,1,66,0.782178217821782
"140280306","CORDOBA",240,145,84,11,0,95,0.604166666666667
"140280304","CORDOBA",365,110,221,29,0,250,0.301369863013699
"140280301","CORDOBA",296,7,207,56,2,265,0.0236486486486486
"141050316","CORDOBA",287,4,268,14,0,282,0.0139372822299652
"140350415","CORDOBA",291,89,174,24,2,200,0.305841924398625
"140280207","CORDOBA",221,191,24,6,0,30,0.864253393665158
"140280206","CORDOBA",201,139,48,14,0,62,0.691542288557214
"140280205","CORDOBA",223,84,85,42,1,128,0.376681614349776
"141470803","CORDOBA",343,107,162,60,1,223,0.311953352769679
"141470209","CORDOBA",215,2,184,22,2,208,0.00930232558139535
"140280204","CORDOBA",448,56,287,71,1,359,0.125
"140280203","CORDOBA",273,74,144,37,3,184,0.271062271062271
"140280210","CORDOBA",236,30,160,40,1,201,0.127118644067797
"140280209","CORDOBA",304,221,58,22,0,80,0.726973684210526
"140421102","CORDOBA",224,217,5,2,0,7,0.96875
"140280208","CORDOBA",337,51,221,53,4,278,0.1513353115727
"140212120","CORDOBA",190,2,169,17,2,188,0.0105263157894737
"140212119","CORDOBA",182,1,163,9,9,181,0.00549450549450549
"140212118","CORDOBA",369,2,327,37,1,365,0.00542005420054201
"140212117","CORDOBA",173,2,161,8,0,169,0.0115606936416185
"141470112","CORDOBA",246,3,222,18,3,243,0.0121951219512195
"140212107","CORDOBA",219,8,181,23,2,206,0.0365296803652968
"140212111","CORDOBA",92,0,72,15,5,92,0
"141470208","CORDOBA",246,2,193,46,0,239,0.00813008130081301
"141470312","CORDOBA",148,0,109,6,30,145,0
"140212116","CORDOBA",294,4,270,19,1,290,0.0136054421768707
"141470311","CORDOBA",195,0,154,18,17,189,0
"140212108","CORDOBA",213,29,168,15,1,184,0.136150234741784
"141470207","CORDOBA",299,1,244,38,4,286,0.00334448160535117
"140350411","CORDOBA",188,83,80,9,0,89,0.441489361702128
"140212114","CORDOBA",192,0,158,33,1,192,0
"141470111","CORDOBA",302,2,282,16,0,298,0.00662251655629139
"140212106","CORDOBA",292,10,232,45,1,278,0.0342465753424658
"141470307","CORDOBA",151,0,91,38,10,139,0
"141470213","CORDOBA",225,3,170,33,7,210,0.0133333333333333
"141470212","CORDOBA",203,4,163,24,1,188,0.0197044334975369
"141470211","CORDOBA",234,0,198,34,0,232,0
"141470210","CORDOBA",355,7,300,25,18,343,0.0197183098591549
"140212112","CORDOBA",157,1,106,27,18,151,0.00636942675159236
"140212105","CORDOBA",272,2,208,54,0,262,0.00735294117647059
"141470114","CORDOBA",295,0,238,50,4,292,0
"140212018","CORDOBA",273,1,177,77,3,257,0.00366300366300366
"141470109","CORDOBA",376,5,338,16,11,365,0.0132978723404255
"141470108","CORDOBA",166,6,151,7,0,158,0.036144578313253
"140350410","CORDOBA",204,107,83,14,0,97,0.524509803921569
"140212013","CORDOBA",238,101,132,5,0,137,0.42436974789916
"140149109","CORDOBA",196,30,156,1,8,165,0.153061224489796
"140212104","CORDOBA",55,4,27,24,0,51,0.0727272727272727
"140212101","CORDOBA",257,124,111,6,16,133,0.482490272373541
"140212017","CORDOBA",194,5,173,13,0,186,0.0257731958762887
"140212011","CORDOBA",185,156,28,1,0,29,0.843243243243243
"140212010","CORDOBA",215,4,157,48,0,205,0.0186046511627907
"140212009","CORDOBA",207,5,172,23,0,195,0.0241545893719807
"140560207","CORDOBA",158,154,4,0,0,4,0.974683544303797
"140490116","CORDOBA",361,1,242,90,3,335,0.00277008310249307
"140421106","CORDOBA",219,132,56,23,1,80,0.602739726027397
"140421105","CORDOBA",325,245,60,20,0,80,0.753846153846154
"140421104","CORDOBA",252,245,5,2,0,7,0.972222222222222
"140560209","CORDOBA",251,186,52,13,0,65,0.741035856573705
"140421101","CORDOBA",231,209,17,4,0,21,0.904761904761905
"140421016","CORDOBA",350,3,286,55,2,343,0.00857142857142857
"140212008","CORDOBA",233,2,180,35,2,217,0.00858369098712446
"140490304","CORDOBA",174,2,144,17,2,163,0.0114942528735632
"140490303","CORDOBA",314,3,256,48,2,306,0.00955414012738853
"140490302","CORDOBA",175,1,127,40,3,170,0.00571428571428571
"141190706","CORDOBA",361,2,334,22,2,358,0.00554016620498615
"140490301","CORDOBA",172,2,113,50,1,164,0.0116279069767442
"140490215","CORDOBA",86,0,60,20,4,84,0
"140490214","CORDOBA",147,1,74,57,3,134,0.00680272108843537
"140560212","CORDOBA",356,278,41,30,0,71,0.780898876404494
"140560211","CORDOBA",364,294,48,21,0,69,0.807692307692308
"140560210","CORDOBA",335,291,39,5,0,44,0.86865671641791
"140490112","CORDOBA",122,5,93,14,3,110,0.040983606557377
"141750218","CORDOBA",353,0,271,70,5,346,0
"141750217","CORDOBA",207,0,200,1,2,203,0
"141750216","CORDOBA",191,0,183,3,2,188,0
"141750215","CORDOBA",257,0,228,26,2,256,0
"141750214","CORDOBA",253,0,220,27,1,248,0
"141750213","CORDOBA",249,0,221,25,1,247,0
"140421113","CORDOBA",203,191,3,7,0,10,0.940886699507389
"140421112","CORDOBA",294,291,3,0,0,3,0.989795918367347
"140421111","CORDOBA",290,279,6,4,0,10,0.962068965517241
"140421110","CORDOBA",289,275,7,5,0,12,0.951557093425606
"140421109","CORDOBA",364,198,137,21,1,159,0.543956043956044
"140421108","CORDOBA",401,5,285,90,1,376,0.0124688279301746
"140421015","CORDOBA",270,8,231,30,0,261,0.0296296296296296
"141750110","CORDOBA",234,0,84,114,5,203,0
"140421014","CORDOBA",213,2,173,36,2,211,0.00938967136150235
"140421013","CORDOBA",216,3,165,44,4,213,0.0138888888888889
"140421012","CORDOBA",278,1,238,38,0,276,0.00359712230215827
"140421011","CORDOBA",184,3,135,33,2,170,0.016304347826087
"140421010","CORDOBA",236,0,171,44,12,227,0
"140421008","CORDOBA",226,4,179,36,4,219,0.0176991150442478
"140420925","CORDOBA",221,220,1,0,0,1,0.995475113122172
"140420924","CORDOBA",213,213,0,0,0,0,1
"140420923","CORDOBA",189,188,1,0,0,1,0.994708994708995
"140420922","CORDOBA",200,195,5,0,0,5,0.975
"140211507","CORDOBA",226,3,199,15,9,223,0.0132743362831858
"140420921","CORDOBA",268,108,73,79,2,154,0.402985074626866
"140211111","CORDOBA",211,3,196,9,0,205,0.014218009478673
"140420920","CORDOBA",256,219,14,20,3,37,0.85546875
"140420919","CORDOBA",289,237,39,13,0,52,0.820069204152249
"140212007","CORDOBA",293,11,189,82,3,274,0.037542662116041
"140212012","CORDOBA",251,3,231,17,0,248,0.0119521912350598
"140212005","CORDOBA",307,62,161,62,7,230,0.201954397394137
"141401911","CORDOBA",228,1,218,7,0,225,0.0043859649122807
"141401910","CORDOBA",404,8,334,61,0,395,0.0198019801980198
"141401909","CORDOBA",268,10,249,8,0,257,0.0373134328358209
"140211112","CORDOBA",386,6,355,23,1,379,0.0155440414507772
"140211207","CORDOBA",197,2,177,16,1,194,0.0101522842639594
"140212003","CORDOBA",316,39,219,47,4,270,0.123417721518987
"140212001","CORDOBA",182,0,120,50,5,175,0
"140212006","CORDOBA",203,190,7,0,0,7,0.935960591133005
"140211913","CORDOBA",216,7,199,8,2,209,0.0324074074074074
"140211912","CORDOBA",203,1,195,4,2,201,0.00492610837438424
"140211911","CORDOBA",287,57,206,16,4,226,0.198606271777003
"140211910","CORDOBA",316,10,274,27,5,306,0.0316455696202532
"140211909","CORDOBA",254,5,236,13,0,249,0.0196850393700787
"140211907","CORDOBA",170,9,149,10,1,160,0.0529411764705882
"140211906","CORDOBA",200,15,172,13,0,185,0.075
"140350409","CORDOBA",238,86,133,18,0,151,0.361344537815126
"140211903","CORDOBA",178,9,154,15,0,169,0.050561797752809
"141401711","CORDOBA",365,16,309,34,4,347,0.0438356164383562
"140211208","CORDOBA",139,0,126,5,3,134,0
"140211902","CORDOBA",283,4,248,26,2,276,0.0141342756183746
"140211901","CORDOBA",238,4,213,18,3,234,0.0168067226890756
"140211815","CORDOBA",330,9,290,21,7,318,0.0272727272727273
"140211814","CORDOBA",227,4,210,11,2,223,0.0176211453744493
"141401615","CORDOBA",206,9,165,28,1,194,0.0436893203883495
"141401614","CORDOBA",267,8,218,39,2,259,0.0299625468164794
"140350407","CORDOBA",271,82,150,37,2,189,0.302583025830258
"140211813","CORDOBA",392,3,312,71,3,386,0.0076530612244898
"141401515","CORDOBA",101,2,71,25,2,98,0.0198019801980198
"141401514","CORDOBA",111,1,96,6,4,106,0.00900900900900901
"140211905","CORDOBA",200,0,187,9,4,200,0
"140211206","CORDOBA",231,4,190,31,4,225,0.0173160173160173
"140211811","CORDOBA",232,22,183,21,4,208,0.0948275862068965
"140280216","CORDOBA",377,144,187,40,0,227,0.381962864721485
"140211808","CORDOBA",258,2,214,20,9,243,0.00775193798449612
"140211709","CORDOBA",418,3,358,44,6,408,0.00717703349282297
"140211110","CORDOBA",183,9,152,21,0,173,0.0491803278688525
"140211806","CORDOBA",215,5,184,14,2,200,0.0232558139534884
"140211805","CORDOBA",298,13,264,21,0,285,0.0436241610738255
"141401411","CORDOBA",240,195,37,8,0,45,0.8125
"140212014","CORDOBA",341,39,276,22,2,300,0.114369501466276
"140211708","CORDOBA",421,6,332,34,47,413,0.0142517814726841
"140211802","CORDOBA",217,3,194,16,1,211,0.0138248847926267
"140211801","CORDOBA",233,8,186,24,14,224,0.0343347639484979
"140211710","CORDOBA",321,0,272,38,9,319,0
"140211109","CORDOBA",382,7,334,41,0,375,0.0183246073298429
"140211706","CORDOBA",328,2,288,30,6,324,0.00609756097560976
"140211705","CORDOBA",194,3,168,11,10,189,0.0154639175257732
"140350408","CORDOBA",190,94,83,13,0,96,0.494736842105263
"140211607","CORDOBA",265,6,243,9,6,258,0.0226415094339623
"140211603","CORDOBA",218,6,190,17,4,211,0.0275229357798165
"140143409","CORDOBA",250,1,216,32,0,248,0.004
"140211606","CORDOBA",237,3,193,35,5,233,0.0126582278481013
"140211609","CORDOBA",223,8,199,15,1,215,0.0358744394618834
"141400916","CORDOBA",193,1,159,22,6,187,0.00518134715025907
"141400909","CORDOBA",299,2,253,37,5,295,0.00668896321070234
"141400908","CORDOBA",283,1,193,76,7,276,0.00353356890459364
"140211605","CORDOBA",240,2,201,19,6,226,0.00833333333333333
"141400816","CORDOBA",247,213,25,9,0,34,0.862348178137652
"141400814","CORDOBA",213,18,179,14,0,193,0.0845070422535211
"141400813","CORDOBA",281,181,88,8,3,99,0.644128113879004
"141400812","CORDOBA",351,195,129,25,0,154,0.555555555555556
"141400811","CORDOBA",215,26,145,38,2,185,0.12093023255814
"141400810","CORDOBA",259,2,157,54,11,222,0.00772200772200772
"140420410","CORDOBA",292,232,35,22,1,58,0.794520547945205
"140211108","CORDOBA",268,17,239,11,1,251,0.0634328358208955
"140211601","CORDOBA",277,4,221,28,20,269,0.0144404332129964
"140211511","CORDOBA",209,1,186,16,5,207,0.00478468899521531
"140211510","CORDOBA",203,0,197,1,3,201,0
"140211509","CORDOBA",169,2,137,21,2,160,0.0118343195266272
"140211508","CORDOBA",112,0,81,6,21,108,0
"140211503","CORDOBA",210,6,187,16,0,203,0.0285714285714286
"141400701","CORDOBA",245,17,190,29,6,225,0.0693877551020408
"140211502","CORDOBA",256,8,199,34,13,246,0.03125
"140211506","CORDOBA",285,3,254,27,1,282,0.0105263157894737
"140211504","CORDOBA",266,0,251,12,3,266,0
"140211411","CORDOBA",292,2,262,22,5,289,0.00684931506849315
"141400519","CORDOBA",204,3,185,14,1,200,0.0147058823529412
"141400518","CORDOBA",203,1,141,54,3,198,0.00492610837438424
"141400517","CORDOBA",207,1,169,31,3,203,0.00483091787439614
"140211402","CORDOBA",166,2,156,6,2,164,0.0120481927710843
"140211410","CORDOBA",247,1,224,18,1,243,0.00404858299595142
"140211602","CORDOBA",393,4,318,44,23,385,0.0101781170483461
"140211409","CORDOBA",204,1,181,12,7,200,0.00490196078431373
"141400509","CORDOBA",290,2,272,15,0,287,0.00689655172413793
"140211311","CORDOBA",203,2,175,23,2,200,0.00985221674876847
"140211107","CORDOBA",256,1,225,26,2,253,0.00390625
"140211408","CORDOBA",206,1,188,15,1,204,0.00485436893203883
"140211704","CORDOBA",224,0,192,16,16,224,0
"140211404","CORDOBA",290,1,262,24,2,288,0.00344827586206897
"140211403","CORDOBA",209,4,195,10,0,205,0.0191387559808612
"140211205","CORDOBA",245,1,191,34,1,226,0.00408163265306122
"140211401","CORDOBA",213,6,176,28,2,206,0.028169014084507
"140211314","CORDOBA",278,5,260,10,0,270,0.0179856115107914
"140211313","CORDOBA",260,1,231,28,0,259,0.00384615384615385
"140211312","CORDOBA",207,0,194,11,1,206,0
"140211310","CORDOBA",238,3,213,21,0,234,0.0126050420168067
"140211309","CORDOBA",192,2,156,22,5,183,0.0104166666666667
"140211406","CORDOBA",245,1,199,31,7,237,0.00408163265306122
"140211308","CORDOBA",351,0,308,34,4,346,0
"140211307","CORDOBA",173,3,148,9,8,165,0.0173410404624277
"140211302","CORDOBA",157,1,148,6,1,155,0.00636942675159236
"820841916","SANTA FE",197,196,0,0,0,0,0.99492385786802
"140211306","CORDOBA",210,4,179,21,4,204,0.019047619047619
"140211305","CORDOBA",304,1,275,19,7,301,0.00328947368421053
"140211405","CORDOBA",285,0,261,21,2,284,0
"140211115","CORDOBA",216,11,194,11,0,205,0.0509259259259259
"140211114","CORDOBA",223,7,208,6,0,214,0.031390134529148
"141330410","CORDOBA",134,0,117,11,1,129,0
"140211113","CORDOBA",281,5,251,24,0,275,0.0177935943060498
"140211304","CORDOBA",181,3,145,21,10,176,0.0165745856353591
"140211303","CORDOBA",208,4,188,8,5,201,0.0192307692307692
"141400113","CORDOBA",64,0,31,25,8,64,0
"140211407","CORDOBA",374,0,345,21,3,369,0
"140211301","CORDOBA",242,2,199,34,4,237,0.00826446280991736
"140211703","CORDOBA",209,0,176,12,21,209,0
"140211702","CORDOBA",220,0,170,18,19,207,0
"140211701","CORDOBA",227,3,156,43,24,223,0.013215859030837
"140211611","CORDOBA",347,2,299,35,8,342,0.00576368876080692
"140211204","CORDOBA",226,2,195,17,8,220,0.00884955752212389
"140211214","CORDOBA",267,1,237,24,3,264,0.00374531835205993
"140211211","CORDOBA",260,2,221,19,12,252,0.00769230769230769
"140211210","CORDOBA",256,3,228,24,1,253,0.01171875
"140211209","CORDOBA",137,0,130,6,1,137,0
"141330513","CORDOBA",241,9,214,18,0,232,0.037344398340249
"140211202","CORDOBA",164,1,134,20,2,156,0.00609756097560976
"141330502","CORDOBA",210,26,174,8,2,184,0.123809523809524
"140211610","CORDOBA",223,3,172,33,9,214,0.0134529147982063
"140211106","CORDOBA",115,6,99,10,0,109,0.0521739130434783
"140211105","CORDOBA",265,24,238,3,0,241,0.0905660377358491
"140211101","CORDOBA",231,7,173,47,1,221,0.0303030303030303
"140211016","CORDOBA",232,222,7,0,0,7,0.956896551724138
"140211014","CORDOBA",422,328,54,12,0,66,0.777251184834123
"140211013","CORDOBA",370,304,44,10,0,54,0.821621621621622
"140211012","CORDOBA",441,384,42,10,1,53,0.870748299319728
"140211011","CORDOBA",383,316,46,13,1,60,0.825065274151436
"140149116","CORDOBA",246,41,189,16,0,205,0.166666666666667
"140149216","CORDOBA",292,4,277,10,1,288,0.0136986301369863
"140149115","CORDOBA",306,23,261,19,1,281,0.0751633986928105
"140149114","CORDOBA",420,10,394,12,2,408,0.0238095238095238
"140149113","CORDOBA",299,12,238,45,1,284,0.040133779264214
"140149112","CORDOBA",328,14,295,18,0,313,0.0426829268292683
"140149111","CORDOBA",308,58,232,13,2,247,0.188311688311688
"140149110","CORDOBA",323,16,251,56,0,307,0.0495356037151703
"140149108","CORDOBA",295,30,257,8,0,265,0.101694915254237
"140149107","CORDOBA",330,37,285,7,0,292,0.112121212121212
"140149106","CORDOBA",346,341,5,0,0,5,0.985549132947977
"140149105","CORDOBA",278,144,121,13,0,134,0.517985611510791
"140149104","CORDOBA",363,22,325,13,2,340,0.0606060606060606
"140149103","CORDOBA",255,43,199,12,1,212,0.168627450980392
"140149102","CORDOBA",310,6,291,13,0,304,0.0193548387096774
"140149101","CORDOBA",384,6,369,9,0,378,0.015625
"140149015","CORDOBA",271,247,20,4,0,24,0.911439114391144
"140149215","CORDOBA",246,20,208,16,2,226,0.0813008130081301
"140149014","CORDOBA",244,165,72,7,0,79,0.676229508196721
"140149013","CORDOBA",354,6,164,153,16,333,0.0169491525423729
"140149012","CORDOBA",295,11,221,48,2,271,0.0372881355932203
"140147902","CORDOBA",290,271,16,3,0,19,0.93448275862069
"140149011","CORDOBA",218,112,96,8,1,105,0.513761467889908
"140560415","CORDOBA",274,0,195,78,1,274,0
"140149010","CORDOBA",175,147,26,2,0,28,0.84
"140149009","CORDOBA",261,243,14,4,0,18,0.931034482758621
"140149008","CORDOBA",210,190,18,1,0,19,0.904761904761905
"140149007","CORDOBA",348,100,193,43,3,239,0.28735632183908
"140149006","CORDOBA",306,69,212,19,1,232,0.225490196078431
"140149005","CORDOBA",233,87,132,10,0,142,0.373390557939914
"140149004","CORDOBA",197,144,48,5,0,53,0.730964467005076
"140149003","CORDOBA",192,52,71,67,0,138,0.270833333333333
"140148911","CORDOBA",198,9,177,9,1,187,0.0454545454545455
"140149001","CORDOBA",281,200,71,10,0,81,0.711743772241993
"140148906","CORDOBA",322,145,166,10,1,177,0.450310559006211
"140149002","CORDOBA",256,166,18,57,5,80,0.6484375
"140148915","CORDOBA",377,303,72,2,0,74,0.803713527851459
"140148914","CORDOBA",228,122,95,10,0,105,0.535087719298246
"140280201","CORDOBA",411,32,180,133,11,324,0.0778588807785888
"141190307","CORDOBA",284,19,226,24,8,258,0.0669014084507042
"140148916","CORDOBA",456,28,362,33,19,414,0.0614035087719298
"141190410","CORDOBA",374,3,348,20,0,368,0.00802139037433155
"140148803","CORDOBA",286,28,243,11,4,258,0.0979020979020979
"140280110","CORDOBA",386,4,250,76,7,333,0.0103626943005181
"140148713","CORDOBA",177,26,132,18,0,150,0.146892655367232
"140148712","CORDOBA",293,11,196,76,1,273,0.037542662116041
"140147504","CORDOBA",238,0,148,88,0,236,0
"140148913","CORDOBA",263,87,171,4,1,176,0.330798479087452
"140148910","CORDOBA",232,3,213,14,2,229,0.0129310344827586
"140148909","CORDOBA",276,24,241,10,1,252,0.0869565217391304
"140148908","CORDOBA",222,40,170,12,0,182,0.18018018018018
"140148907","CORDOBA",260,6,230,23,1,254,0.0230769230769231
"140148901","CORDOBA",253,12,212,27,2,241,0.0474308300395257
"140280111","CORDOBA",262,23,155,51,3,209,0.0877862595419847
"140350414","CORDOBA",295,35,177,64,3,244,0.11864406779661
"141470712","CORDOBA",62,0,45,2,14,61,0
"141470708","CORDOBA",36,0,26,7,1,34,0
"140280215","CORDOBA",362,228,109,22,0,131,0.629834254143646
"140350413","CORDOBA",248,103,97,46,0,143,0.415322580645161
"140280213","CORDOBA",321,6,280,31,0,311,0.0186915887850467
"140148804","CORDOBA",264,3,234,26,1,261,0.0113636363636364
"140148407","CORDOBA",175,165,8,1,0,9,0.942857142857143
"140280109","CORDOBA",206,2,126,38,9,173,0.00970873786407767
"140280212","CORDOBA",329,110,184,33,1,218,0.334346504559271
"140280211","CORDOBA",359,217,111,28,2,141,0.604456824512535
"141470607","CORDOBA",123,1,81,5,35,121,0.00813008130081301
"141470606","CORDOBA",158,0,143,11,3,157,0
"141470604","CORDOBA",116,0,106,3,7,116,0
"141470508","CORDOBA",196,0,176,16,0,192,0
"140350412","CORDOBA",266,74,140,45,0,185,0.278195488721804
"141470413","CORDOBA",175,5,140,14,2,156,0.0285714285714286
"140148808","CORDOBA",260,2,233,15,9,257,0.00769230769230769
"140148905","CORDOBA",228,86,120,22,0,142,0.37719298245614
"140148904","CORDOBA",367,152,195,19,1,215,0.4141689373297
"140148903","CORDOBA",396,47,327,21,0,348,0.118686868686869
"140148902","CORDOBA",198,2,193,3,0,196,0.0101010101010101
"140148815","CORDOBA",331,6,269,55,1,325,0.0181268882175227
"140148814","CORDOBA",359,281,78,0,0,78,0.782729805013928
"140148813","CORDOBA",301,12,252,29,7,288,0.0398671096345515
"140148812","CORDOBA",288,4,279,4,1,284,0.0138888888888889
"140148811","CORDOBA",381,7,333,39,0,372,0.0183727034120735
"140148810","CORDOBA",281,12,228,39,1,268,0.0427046263345196
"140148809","CORDOBA",267,10,240,15,2,257,0.0374531835205993
"140148807","CORDOBA",302,11,273,11,6,290,0.0364238410596026
"140148806","CORDOBA",288,14,237,32,3,272,0.0486111111111111
"140148805","CORDOBA",130,4,108,18,0,126,0.0307692307692308
"140148406","CORDOBA",187,172,15,0,0,15,0.919786096256685
"140148711","CORDOBA",292,23,210,50,0,260,0.0787671232876712
"140148710","CORDOBA",262,2,230,24,0,254,0.00763358778625954
"140148709","CORDOBA",206,1,142,60,1,203,0.00485436893203883
"140148708","CORDOBA",401,186,140,65,1,206,0.463840399002494
"140148707","CORDOBA",246,24,183,31,2,216,0.0975609756097561
"140148706","CORDOBA",220,0,189,29,0,218,0
"140148705","CORDOBA",408,5,361,37,2,400,0.0122549019607843
"140148704","CORDOBA",228,7,198,18,1,217,0.0307017543859649
"140148703","CORDOBA",191,6,168,12,5,185,0.031413612565445
"140148702","CORDOBA",279,62,190,21,5,216,0.222222222222222
"140148501","CORDOBA",270,220,45,4,0,49,0.814814814814815
"140148701","CORDOBA",314,7,261,43,2,306,0.0222929936305732
"140148612","CORDOBA",254,17,196,35,1,232,0.0669291338582677
"140148611","CORDOBA",236,12,183,40,1,224,0.0508474576271186
"140148608","CORDOBA",264,1,205,51,4,260,0.00378787878787879
"140148607","CORDOBA",349,10,249,75,2,326,0.0286532951289398
"140148606","CORDOBA",313,0,253,57,1,311,0
"140148605","CORDOBA",368,1,239,117,0,356,0.00271739130434783
"140148604","CORDOBA",317,2,143,155,2,300,0.00630914826498423
"140149314","CORDOBA",170,155,12,3,0,15,0.911764705882353
"140148603","CORDOBA",261,4,145,108,1,254,0.0153256704980843
"140148602","CORDOBA",168,5,84,69,1,154,0.0297619047619048
"140148601","CORDOBA",216,0,83,111,11,205,0
"140148516","CORDOBA",291,277,10,2,0,12,0.951890034364261
"140148515","CORDOBA",216,194,17,5,0,22,0.898148148148148
"140148101","CORDOBA",264,264,0,0,0,0,1
"140148514","CORDOBA",353,155,182,15,0,197,0.439093484419263
"140148513","CORDOBA",348,5,238,88,4,330,0.014367816091954
"140148512","CORDOBA",306,12,250,38,2,290,0.0392156862745098
"140148511","CORDOBA",354,25,243,66,4,313,0.0706214689265537
"140148510","CORDOBA",340,22,287,29,2,318,0.0647058823529412
"140148509","CORDOBA",402,6,369,21,1,391,0.0149253731343284
"140148508","CORDOBA",413,327,64,15,0,79,0.791767554479419
"140148507","CORDOBA",240,223,12,5,0,17,0.929166666666667
"140148506","CORDOBA",330,318,11,1,0,12,0.963636363636364
"141190113","CORDOBA",250,3,236,10,0,246,0.012
"140148504","CORDOBA",269,255,13,0,0,13,0.947955390334573
"140148503","CORDOBA",219,209,10,0,0,10,0.954337899543379
"140148502","CORDOBA",230,206,19,5,0,24,0.895652173913044
"140148412","CORDOBA",259,248,8,1,0,9,0.957528957528958
"140148411","CORDOBA",243,215,21,7,0,28,0.88477366255144
"140148410","CORDOBA",233,212,17,4,0,21,0.909871244635193
"140148409","CORDOBA",249,236,12,1,0,13,0.947791164658635
"140148408","CORDOBA",234,203,22,8,0,30,0.867521367521368
"140148405","CORDOBA",293,263,21,8,0,29,0.897610921501707
"140148404","CORDOBA",195,177,16,1,1,18,0.907692307692308
"140148403","CORDOBA",276,249,19,8,0,27,0.902173913043478
"140148401","CORDOBA",298,251,41,4,0,45,0.842281879194631
"140148316","CORDOBA",164,130,31,1,0,32,0.792682926829268
"140148505","CORDOBA",311,291,18,2,0,20,0.935691318327974
"140148314","CORDOBA",260,189,51,19,0,70,0.726923076923077
"140148313","CORDOBA",242,190,33,14,0,47,0.785123966942149
"140148312","CORDOBA",278,172,68,35,0,103,0.618705035971223
"140148311","CORDOBA",236,161,64,10,0,74,0.682203389830508
"140148310","CORDOBA",218,202,15,1,0,16,0.926605504587156
"140148309","CORDOBA",339,309,16,14,0,30,0.911504424778761
"140148308","CORDOBA",181,142,33,5,1,39,0.784530386740331
"140148204","CORDOBA",540,540,0,0,0,0,1
"140148203","CORDOBA",322,322,0,0,0,0,1
"140148307","CORDOBA",316,281,24,10,1,35,0.889240506329114
"140148306","CORDOBA",183,142,32,6,0,38,0.775956284153005
"140148305","CORDOBA",225,201,17,5,1,23,0.893333333333333
"140148304","CORDOBA",230,189,28,12,1,41,0.821739130434783
"140148303","CORDOBA",278,252,14,9,0,23,0.906474820143885
"140148302","CORDOBA",300,266,26,7,0,33,0.886666666666667
"140148301","CORDOBA",278,226,37,13,0,50,0.81294964028777
"140147803","CORDOBA",238,214,14,10,0,24,0.899159663865546
"140148315","CORDOBA",194,147,37,10,0,47,0.757731958762887
"140148211","CORDOBA",219,218,1,0,0,1,0.995433789954338
"140148210","CORDOBA",196,193,1,1,0,2,0.98469387755102
"140148209","CORDOBA",313,311,2,0,0,2,0.993610223642173
"140148208","CORDOBA",619,618,1,0,0,1,0.998384491114701
"140148207","CORDOBA",354,353,1,0,0,1,0.997175141242938
"140148206","CORDOBA",152,152,0,0,0,0,1
"140148205","CORDOBA",213,212,1,0,0,1,0.995305164319249
"140148202","CORDOBA",414,414,0,0,0,0,1
"140148110","CORDOBA",196,150,40,5,1,46,0.76530612244898
"140148109","CORDOBA",249,249,0,0,0,0,1
"140148108","CORDOBA",267,267,0,0,0,0,1
"140148107","CORDOBA",234,233,0,0,0,0,0.995726495726496
"140148106","CORDOBA",680,678,1,1,0,2,0.997058823529412
"140148105","CORDOBA",528,528,0,0,0,0,1
"141120310","CORDOBA",206,0,175,29,1,205,0
"140148104","CORDOBA",550,541,0,0,0,0,0.983636363636364
"140148103","CORDOBA",598,598,0,0,0,0,1
"140148102","CORDOBA",341,341,0,0,0,0,1
"140148014","CORDOBA",141,19,65,52,1,118,0.134751773049645
"140148013","CORDOBA",140,67,51,19,0,70,0.478571428571429
"140147920","CORDOBA",267,20,228,17,2,247,0.0749063670411985
"140147919","CORDOBA",258,79,157,14,7,178,0.306201550387597
"140147916","CORDOBA",278,258,16,4,0,20,0.928057553956835
"140147901","CORDOBA",298,262,23,13,0,36,0.879194630872483
"140148012","CORDOBA",181,167,9,5,0,14,0.922651933701657
"140147912","CORDOBA",187,95,67,25,0,92,0.508021390374332
"140146106","CORDOBA",230,5,190,35,0,225,0.0217391304347826
"140148011","CORDOBA",209,185,16,8,0,24,0.885167464114832
"140148010","CORDOBA",239,239,0,0,0,0,1
"140148009","CORDOBA",211,211,0,0,0,0,1
"140148008","CORDOBA",154,154,0,0,0,0,1
"140148007","CORDOBA",156,154,2,0,0,2,0.987179487179487
"140148006","CORDOBA",380,379,1,0,0,1,0.997368421052632
"140148005","CORDOBA",268,268,0,0,0,0,1
"140148002","CORDOBA",223,221,2,0,0,2,0.991031390134529
"140148001","CORDOBA",247,246,1,0,0,1,0.995951417004049
"140147915","CORDOBA",346,243,40,50,6,96,0.702312138728324
"140147914","CORDOBA",195,162,14,19,0,33,0.830769230769231
"140147913","CORDOBA",271,109,95,53,4,152,0.402214022140221
"140147911","CORDOBA",308,169,126,11,0,137,0.548701298701299
"141120207","CORDOBA",137,0,101,16,17,134,0
"140147910","CORDOBA",244,198,33,10,0,43,0.811475409836066
"140147909","CORDOBA",379,379,0,0,0,0,1
"140147908","CORDOBA",229,192,24,13,0,37,0.838427947598253
"140147907","CORDOBA",329,295,28,5,0,33,0.896656534954407
"140147905","CORDOBA",229,217,10,2,0,12,0.947598253275109
"140147904","CORDOBA",208,204,1,1,0,2,0.980769230769231
"140560312","CORDOBA",289,9,260,19,1,280,0.0311418685121107
"140147816","CORDOBA",196,187,4,5,0,9,0.954081632653061
"140147815","CORDOBA",184,179,3,1,1,5,0.972826086956522
"140147814","CORDOBA",426,418,5,3,0,8,0.981220657276995
"140147813","CORDOBA",207,201,5,0,0,5,0.971014492753623
"140147812","CORDOBA",298,292,1,0,0,1,0.979865771812081
"140147811","CORDOBA",380,368,11,1,0,12,0.968421052631579
"141120110","CORDOBA",197,0,183,12,0,195,0
"141120109","CORDOBA",198,0,179,13,2,194,0
"140147810","CORDOBA",302,278,22,2,0,24,0.920529801324503
"140147809","CORDOBA",311,212,73,25,0,98,0.681672025723473
"140147906","CORDOBA",309,294,13,2,0,15,0.951456310679612
"140147808","CORDOBA",278,246,25,7,0,32,0.884892086330935
"140147807","CORDOBA",300,228,55,15,2,72,0.76
"140147806","CORDOBA",138,124,7,2,0,9,0.898550724637681
"140147805","CORDOBA",242,234,3,5,0,8,0.966942148760331
"140147804","CORDOBA",246,206,30,10,0,40,0.83739837398374
"140146013","CORDOBA",220,215,4,1,0,5,0.977272727272727
"140147802","CORDOBA",186,155,20,9,1,30,0.833333333333333
"140147801","CORDOBA",348,307,35,6,0,41,0.882183908045977
"140147722","CORDOBA",286,9,243,31,0,274,0.0314685314685315
"140147601","CORDOBA",422,6,386,23,5,414,0.014218009478673
"140147519","CORDOBA",444,211,182,41,2,225,0.475225225225225
"140147506","CORDOBA",324,21,158,145,0,303,0.0648148148148148
"140147518","CORDOBA",309,10,194,87,1,282,0.0323624595469256
"140147517","CORDOBA",334,7,290,35,0,325,0.0209580838323353
"140147516","CORDOBA",284,14,232,34,1,267,0.0492957746478873
"140147515","CORDOBA",424,8,342,62,0,404,0.0188679245283019
"140147514","CORDOBA",441,5,312,101,5,418,0.0113378684807256
"140147513","CORDOBA",448,14,305,107,1,413,0.03125
"140147511","CORDOBA",345,8,270,55,5,330,0.0231884057971014
"140147510","CORDOBA",357,7,239,103,5,347,0.0196078431372549
"140147509","CORDOBA",324,24,243,34,7,284,0.0740740740740741
"140147508","CORDOBA",253,5,178,62,4,244,0.0197628458498024
"140147507","CORDOBA",335,2,242,80,0,322,0.00597014925373134
"140147505","CORDOBA",243,14,174,43,7,224,0.0576131687242798
"140147503","CORDOBA",275,13,183,73,0,256,0.0472727272727273
"140147502","CORDOBA",253,20,183,43,2,228,0.0790513833992095
"140147404","CORDOBA",223,194,25,4,0,29,0.869955156950673
"140147403","CORDOBA",217,168,22,23,0,45,0.774193548387097
"140147402","CORDOBA",264,182,30,44,2,76,0.689393939393939
"140147501","CORDOBA",336,119,46,147,0,193,0.354166666666667
"140147417","CORDOBA",261,253,4,4,0,8,0.969348659003831
"140147416","CORDOBA",220,206,10,3,0,13,0.936363636363636
"140147415","CORDOBA",312,127,160,18,3,181,0.407051282051282
"140147414","CORDOBA",285,267,17,1,0,18,0.936842105263158
"140147413","CORDOBA",244,238,4,2,0,6,0.975409836065574
"140147412","CORDOBA",341,306,28,7,0,35,0.897360703812317
"141050514","CORDOBA",392,14,275,60,17,352,0.0357142857142857
"140147411","CORDOBA",340,157,88,87,1,176,0.461764705882353
"140147405","CORDOBA",249,204,34,11,0,45,0.819277108433735
"140147401","CORDOBA",314,237,42,24,1,67,0.754777070063694
"140147310","CORDOBA",193,191,2,0,0,2,0.989637305699482
"140147309","CORDOBA",310,266,27,13,0,40,0.858064516129032
"140147308","CORDOBA",225,174,37,12,0,49,0.773333333333333
"140147307","CORDOBA",187,34,28,97,0,125,0.181818181818182
"140210807","CORDOBA",371,0,318,39,1,358,0
"140147306","CORDOBA",269,229,19,5,0,24,0.851301115241636
"140147305","CORDOBA",223,212,10,1,0,11,0.95067264573991
"140147304","CORDOBA",243,238,5,0,0,5,0.979423868312757
"140147303","CORDOBA",196,164,27,5,0,32,0.836734693877551
"140147302","CORDOBA",215,182,29,2,0,31,0.846511627906977
"140147301","CORDOBA",221,110,80,31,0,111,0.497737556561086
"140147313","CORDOBA",223,205,14,4,0,18,0.919282511210762
"140147312","CORDOBA",208,194,9,4,0,13,0.932692307692308
"140147207","CORDOBA",698,690,4,2,0,6,0.988538681948424
"140147206","CORDOBA",587,584,3,0,0,3,0.99488926746167
"140210613","CORDOBA",259,3,234,20,1,255,0.0115830115830116
"140210410","CORDOBA",266,1,220,30,5,255,0.0037593984962406
"140210409","CORDOBA",369,3,308,51,4,363,0.00813008130081301
"140210612","CORDOBA",371,6,325,29,3,357,0.0161725067385445
"140210608","CORDOBA",252,7,196,34,4,234,0.0277777777777778
"140210611","CORDOBA",417,2,315,90,4,409,0.00479616306954436
"141330207","CORDOBA",126,2,106,16,1,123,0.0158730158730159
"140210610","CORDOBA",175,7,133,23,9,165,0.04
"140210609","CORDOBA",290,5,264,20,1,285,0.0172413793103448
"140560105","CORDOBA",389,26,287,61,6,354,0.0668380462724936
"141330111","CORDOBA",315,2,175,105,9,289,0.00634920634920635
"140210811","CORDOBA",231,1,202,20,1,223,0.00432900432900433
"140210508","CORDOBA",234,3,223,7,0,230,0.0128205128205128
"140210507","CORDOBA",219,9,189,19,2,210,0.0410958904109589
"140210506","CORDOBA",121,3,105,12,1,118,0.0247933884297521
"140210810","CORDOBA",258,3,217,24,6,247,0.0116279069767442
"140210809","CORDOBA",396,12,296,65,3,364,0.0303030303030303
"141260712","CORDOBA",258,5,233,8,10,251,0.0193798449612403
"140210315","CORDOBA",250,4,131,103,5,239,0.016
"140210314","CORDOBA",275,2,217,44,5,266,0.00727272727272727
"141260608","CORDOBA",186,1,165,19,1,185,0.00537634408602151
"140210808","CORDOBA",233,5,181,36,2,219,0.0214592274678112
"140560104","CORDOBA",381,182,164,28,2,194,0.477690288713911
"140210406","CORDOBA",277,3,239,23,4,266,0.0108303249097473
"140149908","CORDOBA",421,25,341,50,1,392,0.0593824228028504
"140146516","CORDOBA",310,288,12,3,4,19,0.929032258064516
"140210213","CORDOBA",146,0,105,31,4,140,0
"140210408","CORDOBA",88,1,60,19,1,80,0.0113636363636364
"140210407","CORDOBA",294,4,251,23,8,282,0.0136054421768707
"140149913","CORDOBA",444,2,376,52,3,431,0.0045045045045045
"140210212","CORDOBA",125,0,113,4,5,122,0
"141260511","CORDOBA",248,2,225,19,0,244,0.00806451612903226
"141260510","CORDOBA",223,2,208,7,0,215,0.00896860986547085
"141260509","CORDOBA",321,4,267,39,3,309,0.0124610591900312
"141260508","CORDOBA",233,11,204,14,0,218,0.0472103004291846
"140421009","CORDOBA",275,7,214,40,8,262,0.0254545454545455
"140149909","CORDOBA",322,11,235,69,1,305,0.0341614906832298
"140210211","CORDOBA",88,1,86,0,1,87,0.0113636363636364
"140210210","CORDOBA",121,2,108,1,9,118,0.0165289256198347
"140210208","CORDOBA",100,1,79,4,15,98,0.01
"141260406","CORDOBA",140,2,109,20,4,133,0.0142857142857143
"141260314","CORDOBA",301,2,250,40,4,294,0.00664451827242525
"140149912","CORDOBA",239,7,182,46,3,231,0.0292887029288703
"140149911","CORDOBA",191,0,156,29,3,188,0
"140149907","CORDOBA",233,3,207,18,4,229,0.0128755364806867
"140147003","CORDOBA",351,350,1,0,0,1,0.997150997150997
"140210206","CORDOBA",87,1,67,6,11,84,0.0114942528735632
"140211104","CORDOBA",243,13,204,25,0,229,0.0534979423868313
"141260308","CORDOBA",251,1,204,41,0,245,0.00398406374501992
"141260307","CORDOBA",191,2,153,24,2,179,0.0104712041884817
"140210806","CORDOBA",118,2,63,51,0,114,0.0169491525423729
"140149910","CORDOBA",333,7,293,31,1,325,0.021021021021021
"140144906","CORDOBA",148,145,2,1,0,3,0.97972972972973
"140210110","CORDOBA",119,0,90,8,19,117,0
"140210109","CORDOBA",179,1,158,7,6,171,0.00558659217877095
"140210108","CORDOBA",156,2,115,27,10,152,0.0128205128205128
"140210105","CORDOBA",74,2,59,11,1,71,0.027027027027027
"140210104","CORDOBA",112,12,81,11,2,94,0.107142857142857
"140149906","CORDOBA",307,46,230,28,2,260,0.149837133550489
"140149905","CORDOBA",230,7,193,19,4,216,0.0304347826086957
"140149903","CORDOBA",347,10,323,11,2,336,0.0288184438040346
"140149902","CORDOBA",337,6,298,28,1,327,0.0178041543026706
"140149901","CORDOBA",329,16,275,35,0,310,0.0486322188449848
"140149813","CORDOBA",422,21,306,77,4,387,0.0497630331753555
"140149812","CORDOBA",240,11,186,37,1,224,0.0458333333333333
"140149811","CORDOBA",239,42,174,18,0,192,0.175732217573222
"140149810","CORDOBA",213,16,163,30,2,195,0.0751173708920188
"140149809","CORDOBA",334,19,269,42,2,313,0.0568862275449102
"140149808","CORDOBA",240,26,159,52,2,213,0.108333333333333
"140147002","CORDOBA",280,280,0,0,0,0,1
"140149803","CORDOBA",233,1,212,18,0,230,0.00429184549356223
"141260208","CORDOBA",165,4,112,43,1,156,0.0242424242424242
"140149802","CORDOBA",370,13,260,83,3,346,0.0351351351351351
"140149801","CORDOBA",282,2,240,37,2,279,0.00709219858156028
"140149717","CORDOBA",469,11,315,125,1,441,0.023454157782516
"140149716","CORDOBA",295,4,271,12,0,283,0.0135593220338983
"140149713","CORDOBA",198,1,156,31,9,196,0.00505050505050505
"140149712","CORDOBA",264,2,213,42,2,257,0.00757575757575758
"140149711","CORDOBA",373,11,277,70,3,350,0.0294906166219839
"140149710","CORDOBA",333,6,259,61,1,321,0.018018018018018
"140149709","CORDOBA",408,17,265,113,4,382,0.0416666666666667
"140149708","CORDOBA",400,7,286,75,7,368,0.0175
"140149707","CORDOBA",331,15,211,67,0,278,0.0453172205438066
"140149706","CORDOBA",411,379,21,7,1,29,0.922141119221411
"140149705","CORDOBA",234,203,23,7,0,30,0.867521367521368
"140149704","CORDOBA",187,152,29,6,0,35,0.812834224598931
"140149703","CORDOBA",234,195,29,7,0,36,0.833333333333333
"140149702","CORDOBA",197,0,181,9,0,190,0
"140149714","CORDOBA",472,415,37,18,0,55,0.879237288135593
"140149701","CORDOBA",448,4,315,104,9,428,0.00892857142857143
"140149617","CORDOBA",448,149,194,71,17,282,0.332589285714286
"140147001","CORDOBA",297,297,0,0,0,0,1
"140149616","CORDOBA",351,31,277,37,3,317,0.0883190883190883
"140149615","CORDOBA",229,10,189,28,2,219,0.0436681222707424
"140149614","CORDOBA",238,10,225,3,0,228,0.0420168067226891
"140149613","CORDOBA",336,11,312,11,2,325,0.0327380952380952
"140149612","CORDOBA",318,25,269,23,0,292,0.0786163522012579
"140149611","CORDOBA",260,1,242,14,2,258,0.00384615384615385
"140149715","CORDOBA",325,282,31,6,0,37,0.867692307692308
"140149607","CORDOBA",217,7,196,12,0,208,0.032258064516129
"140149606","CORDOBA",214,6,197,7,1,205,0.0280373831775701
"140149605","CORDOBA",249,7,206,24,9,239,0.0281124497991968
"140149604","CORDOBA",331,8,307,11,1,319,0.0241691842900302
"140149603","CORDOBA",336,12,282,37,2,321,0.0357142857142857
"140149602","CORDOBA",227,3,210,12,1,223,0.013215859030837
"140149601","CORDOBA",238,10,210,15,3,228,0.0420168067226891
"140149514","CORDOBA",386,3,354,24,3,381,0.0077720207253886
"140149513","CORDOBA",373,13,305,43,0,348,0.0348525469168901
"140149512","CORDOBA",369,4,347,8,0,355,0.010840108401084
"140149511","CORDOBA",252,3,124,75,11,210,0.0119047619047619
"140211103","CORDOBA",200,11,171,11,0,182,0.055
"140149610","CORDOBA",325,14,299,9,1,309,0.0430769230769231
"140149609","CORDOBA",267,21,236,6,3,245,0.0786516853932584
"140149608","CORDOBA",297,34,238,23,0,261,0.114478114478114
"140149510","CORDOBA",344,8,315,18,2,335,0.0232558139534884
"140149509","CORDOBA",274,8,258,6,0,264,0.0291970802919708
"140149508","CORDOBA",360,328,15,2,1,18,0.911111111111111
"140149507","CORDOBA",278,242,30,0,0,30,0.870503597122302
"140149506","CORDOBA",300,26,243,31,0,274,0.0866666666666667
"140149505","CORDOBA",315,17,286,9,0,295,0.053968253968254
"140149504","CORDOBA",309,4,257,40,1,298,0.0129449838187702
"140149503","CORDOBA",205,1,194,9,1,204,0.0048780487804878
"140149501","CORDOBA",233,6,201,26,0,227,0.0257510729613734
"140149414","CORDOBA",207,1,189,11,0,200,0.00483091787439614
"140149413","CORDOBA",262,0,226,27,2,255,0
"140149412","CORDOBA",300,2,233,58,0,291,0.00666666666666667
"141190817","CORDOBA",241,6,186,39,3,228,0.024896265560166
"140149411","CORDOBA",275,6,204,55,2,261,0.0218181818181818
"140149410","CORDOBA",258,35,179,36,0,215,0.135658914728682
"140149409","CORDOBA",312,8,257,37,3,297,0.0256410256410256
"140149408","CORDOBA",430,17,370,40,1,411,0.0395348837209302
"140149407","CORDOBA",416,13,360,32,2,394,0.03125
"140149502","CORDOBA",244,1,237,5,0,242,0.00409836065573771
"140149406","CORDOBA",279,5,245,24,1,270,0.017921146953405
"140149405","CORDOBA",346,127,197,18,2,217,0.367052023121387
"140149404","CORDOBA",435,4,330,79,1,410,0.00919540229885057
"140149403","CORDOBA",224,0,183,38,0,221,0
"140149402","CORDOBA",288,9,257,20,0,277,0.03125
"140149401","CORDOBA",315,15,264,34,0,298,0.0476190476190476
"140149320","CORDOBA",163,103,54,5,0,59,0.631901840490798
"140149319","CORDOBA",324,242,16,48,2,66,0.746913580246914
"140149318","CORDOBA",306,304,2,0,0,2,0.993464052287582
"140149317","CORDOBA",435,16,384,29,2,415,0.0367816091954023
"140149316","CORDOBA",246,11,198,35,2,235,0.0447154471544715
"140149315","CORDOBA",255,9,231,8,6,245,0.0352941176470588
"140149313","CORDOBA",229,192,27,9,0,36,0.838427947598253
"140149312","CORDOBA",413,399,14,0,0,14,0.966101694915254
"140149311","CORDOBA",403,209,179,10,3,192,0.518610421836228
"140149310","CORDOBA",349,18,316,13,1,330,0.0515759312320917
"140149309","CORDOBA",262,41,205,12,3,220,0.156488549618321
"140149307","CORDOBA",281,5,240,33,0,273,0.0177935943060498
"140149306","CORDOBA",361,288,40,31,1,72,0.797783933518006
"140149305","CORDOBA",272,231,32,8,0,40,0.849264705882353
"140149304","CORDOBA",425,338,59,13,2,74,0.795294117647059
"140149303","CORDOBA",351,24,241,86,0,327,0.0683760683760684
"140149302","CORDOBA",250,16,193,39,2,234,0.064
"140146913","CORDOBA",85,85,0,0,0,0,1
"140149201","CORDOBA",315,23,273,16,3,292,0.073015873015873
"140149301","CORDOBA",239,11,184,38,6,228,0.0460251046025105
"140149218","CORDOBA",219,191,24,1,3,28,0.872146118721461
"140149217","CORDOBA",300,18,255,23,2,280,0.06
"140149214","CORDOBA",314,23,271,17,1,289,0.0732484076433121
"140149213","CORDOBA",172,25,133,11,3,147,0.145348837209302
"140149212","CORDOBA",331,19,276,35,0,311,0.0574018126888218
"140149210","CORDOBA",258,16,221,19,1,241,0.062015503875969
"140149209","CORDOBA",297,19,244,33,1,278,0.063973063973064
"140149208","CORDOBA",202,11,151,35,4,190,0.0544554455445545
"141190613","CORDOBA",233,4,210,15,3,228,0.0171673819742489
"141190611","CORDOBA",283,0,212,39,3,254,0
"140149207","CORDOBA",189,18,155,15,1,171,0.0952380952380952
"140149206","CORDOBA",249,13,221,11,3,235,0.0522088353413655
"140149205","CORDOBA",269,25,203,40,1,244,0.0929368029739777
"140146912","CORDOBA",185,185,0,0,0,0,1
"140149204","CORDOBA",254,11,200,38,0,238,0.0433070866141732
"140149203","CORDOBA",178,85,86,7,0,93,0.47752808988764
"140149119","CORDOBA",312,6,284,20,0,304,0.0192307692307692
"140149118","CORDOBA",309,6,258,45,0,303,0.0194174757281553
"140149117","CORDOBA",265,4,249,11,1,261,0.0150943396226415
"140147205","CORDOBA",259,259,0,0,0,0,1
"140147204","CORDOBA",581,580,1,0,0,1,0.998278829604131
"140147109","CORDOBA",446,445,1,0,0,1,0.997757847533632
"140147108","CORDOBA",256,256,0,0,0,0,1
"140147107","CORDOBA",428,428,0,0,0,0,1
"140147106","CORDOBA",367,360,1,1,0,2,0.980926430517711
"140147105","CORDOBA",291,291,0,0,0,0,1
"140147104","CORDOBA",376,375,1,0,0,1,0.997340425531915
"140147103","CORDOBA",286,286,0,0,0,0,1
"140147102","CORDOBA",382,382,0,0,0,0,1
"140147101","CORDOBA",177,177,0,0,0,0,1
"140147011","CORDOBA",217,216,1,0,0,1,0.995391705069124
"140147010","CORDOBA",345,345,0,0,0,0,1
"140147009","CORDOBA",241,240,0,0,0,0,0.995850622406639
"140147008","CORDOBA",277,277,0,0,0,0,1
"140147007","CORDOBA",254,254,0,0,0,0,1
"140147006","CORDOBA",349,348,1,0,0,1,0.997134670487106
"140147005","CORDOBA",340,339,1,0,0,1,0.997058823529412
"140147004","CORDOBA",195,194,1,0,0,1,0.994871794871795
"140146911","CORDOBA",474,394,31,27,0,58,0.831223628691983
"140146910","CORDOBA",188,160,20,8,0,28,0.851063829787234
"140146908","CORDOBA",260,209,26,24,0,50,0.803846153846154
"140146907","CORDOBA",208,196,8,4,0,12,0.942307692307692
"140146906","CORDOBA",230,198,25,6,0,31,0.860869565217391
"140146905","CORDOBA",271,268,2,1,0,3,0.988929889298893
"140146904","CORDOBA",218,218,0,0,0,0,1
"140146903","CORDOBA",215,210,3,1,1,5,0.976744186046512
"140146902","CORDOBA",130,130,0,0,0,0,1
"140146901","CORDOBA",230,230,0,0,0,0,1
"140146814","CORDOBA",311,308,2,1,0,3,0.990353697749196
"140146813","CORDOBA",114,111,1,1,0,2,0.973684210526316
"140146812","CORDOBA",181,157,14,9,0,23,0.867403314917127
"140146811","CORDOBA",118,111,1,5,0,6,0.940677966101695
"140146810","CORDOBA",211,211,0,0,0,0,1
"140146809","CORDOBA",276,268,4,2,1,7,0.971014492753623
"140146808","CORDOBA",89,87,0,1,1,2,0.97752808988764
"140146807","CORDOBA",161,159,1,1,0,2,0.987577639751553
"140146806","CORDOBA",255,255,0,0,0,0,1
"140146001","CORDOBA",291,251,29,9,0,38,0.862542955326461
"140146515","CORDOBA",155,112,13,0,0,13,0.72258064516129
"140146804","CORDOBA",438,438,0,0,0,0,1
"140146803","CORDOBA",318,311,5,2,0,7,0.977987421383648
"140146802","CORDOBA",139,139,0,0,0,0,1
"140146801","CORDOBA",193,192,1,0,0,1,0.994818652849741
"140146711","CORDOBA",472,472,0,0,0,0,1
"140146710","CORDOBA",233,233,0,0,0,0,1
"140146709","CORDOBA",273,272,1,0,0,1,0.996336996336996
"140146708","CORDOBA",257,257,0,0,0,0,1
"140146707","CORDOBA",202,201,1,0,0,1,0.995049504950495
"140146705","CORDOBA",213,213,0,0,0,0,1
"140146704","CORDOBA",170,169,1,0,0,1,0.994117647058824
"140146703","CORDOBA",359,358,1,0,0,1,0.997214484679666
"140146702","CORDOBA",100,100,0,0,0,0,1
"140146701","CORDOBA",214,213,1,0,0,1,0.995327102803738
"140146614","CORDOBA",369,367,2,0,0,2,0.994579945799458
"140146613","CORDOBA",177,177,0,0,0,0,1
"140146612","CORDOBA",217,215,2,0,0,2,0.990783410138249
"140146611","CORDOBA",134,134,0,0,0,0,1
"140146610","CORDOBA",163,163,0,0,0,0,1
"140146609","CORDOBA",222,217,5,0,0,5,0.977477477477477
"140146608","CORDOBA",77,77,0,0,0,0,1
"140146607","CORDOBA",245,245,0,0,0,0,1
"140146514","CORDOBA",408,374,28,5,0,33,0.916666666666667
"140146513","CORDOBA",188,174,8,6,0,14,0.925531914893617
"140146512","CORDOBA",307,304,2,1,0,3,0.990228013029316
"140146511","CORDOBA",286,265,13,2,0,15,0.926573426573427
"140146510","CORDOBA",188,179,4,4,0,8,0.952127659574468
"140146509","CORDOBA",191,190,1,0,0,1,0.994764397905759
"140146508","CORDOBA",153,153,0,0,0,0,1
"140146507","CORDOBA",174,123,14,20,5,39,0.706896551724138
"140146506","CORDOBA",276,264,12,0,0,12,0.956521739130435
"140146505","CORDOBA",212,203,8,1,0,9,0.957547169811321
"140146503","CORDOBA",215,215,0,0,0,0,1
"140146502","CORDOBA",322,316,4,2,0,6,0.981366459627329
"140146501","CORDOBA",215,214,1,0,0,1,0.995348837209302
"140146411","CORDOBA",278,237,19,20,1,40,0.852517985611511
"140146410","CORDOBA",340,310,20,9,0,29,0.911764705882353
"140146409","CORDOBA",326,307,16,3,0,19,0.941717791411043
"140146408","CORDOBA",311,294,13,1,0,14,0.945337620578778
"140146407","CORDOBA",355,331,19,4,0,23,0.932394366197183
"140146406","CORDOBA",216,215,1,0,0,1,0.99537037037037
"140146405","CORDOBA",263,216,8,3,1,12,0.821292775665399
"140146401","CORDOBA",212,208,4,0,0,4,0.981132075471698
"140146313","CORDOBA",227,168,48,9,0,57,0.740088105726872
"140146312","CORDOBA",177,156,17,4,0,21,0.88135593220339
"140146311","CORDOBA",206,203,1,1,0,2,0.985436893203884
"140146310","CORDOBA",219,165,48,6,0,54,0.753424657534247
"140146309","CORDOBA",280,259,17,3,1,21,0.925
"140146308","CORDOBA",289,263,15,11,0,26,0.910034602076125
"140146307","CORDOBA",285,257,22,5,0,27,0.901754385964912
"140146305","CORDOBA",375,360,14,1,0,15,0.96
"140146304","CORDOBA",234,221,4,6,0,10,0.944444444444444
"140146303","CORDOBA",215,210,5,0,0,5,0.976744186046512
"140146301","CORDOBA",215,201,13,0,1,14,0.934883720930233
"140146213","CORDOBA",272,134,112,21,2,135,0.492647058823529
"140146212","CORDOBA",318,10,292,12,0,304,0.0314465408805031
"140146211","CORDOBA",434,6,332,73,6,411,0.0138248847926267
"140146402","CORDOBA",396,385,4,7,0,11,0.972222222222222
"141050217","CORDOBA",312,1,240,43,17,300,0.00320512820512821
"141050216","CORDOBA",356,6,314,27,4,345,0.0168539325842697
"140146210","CORDOBA",320,289,28,2,1,31,0.903125
"140146209","CORDOBA",340,316,20,3,0,23,0.929411764705882
"140146208","CORDOBA",271,9,232,30,0,262,0.033210332103321
"140146207","CORDOBA",243,2,220,15,4,239,0.00823045267489712
"140146206","CORDOBA",258,179,65,14,0,79,0.693798449612403
"140146205","CORDOBA",216,201,11,3,0,14,0.930555555555556
"140146204","CORDOBA",219,198,15,5,0,20,0.904109589041096
"140144606","CORDOBA",281,213,47,21,0,68,0.758007117437722
"140146203","CORDOBA",274,257,14,3,0,17,0.937956204379562
"140146202","CORDOBA",283,259,19,5,0,24,0.915194346289753
"140146201","CORDOBA",278,270,7,1,0,8,0.971223021582734
"140146115","CORDOBA",322,18,168,124,2,294,0.0559006211180124
"140146114","CORDOBA",250,4,119,82,32,233,0.016
"140146112","CORDOBA",460,7,301,122,11,434,0.0152173913043478
"140146111","CORDOBA",274,11,159,85,5,249,0.0401459854014599
"140146110","CORDOBA",231,5,194,31,1,226,0.0216450216450216
"140146109","CORDOBA",239,6,207,21,3,231,0.0251046025104603
"141050209","CORDOBA",49,0,37,8,3,48,0
"140146403","CORDOBA",306,288,11,6,0,17,0.941176470588235
"140146108","CORDOBA",284,35,174,71,1,246,0.123239436619718
"140146107","CORDOBA",254,2,151,88,0,239,0.0078740157480315
"140210711","CORDOBA",248,4,218,23,1,242,0.0161290322580645
"140145901","CORDOBA",305,285,12,7,1,20,0.934426229508197
"140145813","CORDOBA",91,90,1,0,0,1,0.989010989010989
"140146105","CORDOBA",322,15,115,157,5,277,0.046583850931677
"140146104","CORDOBA",226,2,173,43,1,217,0.00884955752212389
"140146103","CORDOBA",243,19,172,49,1,222,0.0781893004115226
"140146101","CORDOBA",311,29,207,62,4,273,0.0932475884244373
"140146018","CORDOBA",317,304,13,0,0,13,0.958990536277603
"140146017","CORDOBA",338,321,15,2,0,17,0.949704142011834
"140146016","CORDOBA",256,236,16,4,0,20,0.921875
"140146015","CORDOBA",335,314,7,1,0,8,0.937313432835821
"140146014","CORDOBA",370,359,4,6,0,10,0.97027027027027
"140145912","CORDOBA",325,325,0,0,0,0,1
"140145911","CORDOBA",182,181,1,0,0,1,0.994505494505495
"140145910","CORDOBA",214,208,4,1,0,5,0.97196261682243
"140144712","CORDOBA",446,420,19,4,1,24,0.94170403587444
"140144711","CORDOBA",250,201,47,1,0,48,0.804
"140144710","CORDOBA",192,185,3,4,0,7,0.963541666666667
"140144709","CORDOBA",204,203,1,0,0,1,0.995098039215686
"140144708","CORDOBA",330,248,61,17,1,79,0.751515151515151
"140144707","CORDOBA",286,272,12,0,0,12,0.951048951048951
"140144702","CORDOBA",203,181,3,0,0,3,0.891625615763547
"140144701","CORDOBA",158,151,7,0,0,7,0.955696202531646
"140144616","CORDOBA",291,250,28,9,0,37,0.859106529209622
"140144614","CORDOBA",359,305,42,11,0,53,0.84958217270195
"140144613","CORDOBA",150,135,11,4,0,15,0.9
"140144612","CORDOBA",342,319,17,4,0,21,0.932748538011696
"140144611","CORDOBA",411,391,10,9,0,19,0.951338199513382
"140210705","CORDOBA",372,11,298,53,1,352,0.0295698924731183
"140144610","CORDOBA",331,289,28,14,0,42,0.873111782477341
"140144609","CORDOBA",313,257,42,13,0,55,0.821086261980831
"140144608","CORDOBA",235,210,22,2,0,24,0.893617021276596
"140144605","CORDOBA",247,215,22,8,1,31,0.870445344129555
"140144604","CORDOBA",214,176,25,12,0,37,0.822429906542056
"140144603","CORDOBA",296,195,88,12,1,101,0.658783783783784
"140144602","CORDOBA",381,275,74,26,2,102,0.721784776902887
"140144601","CORDOBA",276,146,87,36,0,123,0.528985507246377
"140144512","CORDOBA",278,14,210,46,0,256,0.0503597122302158
"140144511","CORDOBA",285,8,248,27,1,276,0.0280701754385965
"140144510","CORDOBA",395,70,274,47,2,323,0.177215189873418
"140144509","CORDOBA",330,322,7,1,0,8,0.975757575757576
"140147715","CORDOBA",305,51,211,40,1,252,0.167213114754098
"140144508","CORDOBA",288,181,101,3,3,107,0.628472222222222
"140144507","CORDOBA",336,67,226,37,2,265,0.199404761904762
"140982008","CORDOBA",373,365,5,3,0,8,0.978552278820375
"140211102","CORDOBA",254,8,188,52,4,244,0.031496062992126
"140144505","CORDOBA",318,289,11,18,0,29,0.908805031446541
"140144504","CORDOBA",331,280,26,22,1,49,0.845921450151057
"140144503","CORDOBA",271,189,34,33,5,72,0.697416974169742
"140144502","CORDOBA",502,330,48,103,4,155,0.657370517928287
"140144501","CORDOBA",373,115,130,112,1,243,0.308310991957105
"140144703","CORDOBA",310,288,17,5,0,22,0.929032258064516
"140210704","CORDOBA",170,8,145,12,1,158,0.0470588235294118
"140144411","CORDOBA",424,5,394,21,3,418,0.0117924528301887
"140144410","CORDOBA",259,13,236,7,1,244,0.0501930501930502
"140144409","CORDOBA",283,3,140,118,9,267,0.0106007067137809
"140981906","CORDOBA",231,86,79,47,7,133,0.372294372294372
"140144408","CORDOBA",208,188,15,5,0,20,0.903846153846154
"140144407","CORDOBA",366,324,40,2,0,42,0.885245901639344
"140144406","CORDOBA",487,163,307,16,1,324,0.334702258726899
"140144405","CORDOBA",225,16,203,4,1,208,0.0711111111111111
"140211010","CORDOBA",318,253,51,11,0,62,0.79559748427673
"140211009","CORDOBA",240,197,32,11,0,43,0.820833333333333
"140211008","CORDOBA",301,244,41,14,0,55,0.81063122923588
"140211007","CORDOBA",173,153,17,3,0,20,0.884393063583815
"140211006","CORDOBA",317,249,59,7,0,66,0.785488958990536
"140147608","CORDOBA",254,8,234,9,1,244,0.031496062992126
"140211005","CORDOBA",240,61,151,20,0,171,0.254166666666667
"140211004","CORDOBA",372,290,56,25,0,81,0.779569892473118
"140211003","CORDOBA",321,263,53,4,0,57,0.819314641744548
"140211002","CORDOBA",274,231,28,6,0,34,0.843065693430657
"140211001","CORDOBA",384,333,41,10,0,51,0.8671875
"140210911","CORDOBA",403,206,158,38,0,196,0.511166253101737
"140210910","CORDOBA",288,201,54,21,1,76,0.697916666666667
"140210909","CORDOBA",204,161,36,5,0,41,0.78921568627451
"140210908","CORDOBA",180,153,23,3,0,26,0.85
"140210906","CORDOBA",275,230,37,8,0,45,0.836363636363636
"140210905","CORDOBA",189,151,28,9,1,38,0.798941798941799
"140210904","CORDOBA",197,168,29,0,0,29,0.852791878172589
"140210903","CORDOBA",216,172,36,5,0,41,0.796296296296296
"140210902","CORDOBA",260,136,92,25,0,117,0.523076923076923
"140210901","CORDOBA",242,97,130,10,0,140,0.400826446280992
"140210814","CORDOBA",269,0,185,74,0,259,0
"140210803","CORDOBA",348,14,266,48,6,320,0.0402298850574713
"140210715","CORDOBA",266,1,133,110,2,245,0.0037593984962406
"140210714","CORDOBA",164,8,88,57,0,145,0.0487804878048781
"140210805","CORDOBA",313,1,251,48,2,301,0.00319488817891374
"140210713","CORDOBA",59,2,41,13,0,54,0.0338983050847458
"140210616","CORDOBA",318,5,277,19,0,296,0.0157232704402516
"140210615","CORDOBA",416,9,348,47,2,397,0.0216346153846154
"140210614","CORDOBA",418,1,377,24,3,404,0.00239234449760766
"140210813","CORDOBA",263,0,204,48,2,254,0
"140210804","CORDOBA",303,12,237,34,2,273,0.0396039603960396
"140210812","CORDOBA",231,0,196,22,0,218,0
"140147721","CORDOBA",202,2,174,22,0,196,0.0099009900990099
"140147719","CORDOBA",281,10,226,32,3,261,0.0355871886120996
"140147718","CORDOBA",241,12,219,10,0,229,0.0497925311203319
"140147717","CORDOBA",322,7,265,35,2,302,0.0217391304347826
"140147716","CORDOBA",241,149,73,18,0,91,0.618257261410788
"140147714","CORDOBA",251,44,169,30,2,201,0.175298804780877
"140147713","CORDOBA",405,201,100,80,8,188,0.496296296296296
"140147712","CORDOBA",273,203,29,27,1,57,0.743589743589744
"140147710","CORDOBA",286,213,69,4,0,73,0.744755244755245
"140147709","CORDOBA",265,35,203,18,9,230,0.132075471698113
"140147708","CORDOBA",274,4,258,10,2,270,0.0145985401459854
"140147707","CORDOBA",360,17,328,14,1,343,0.0472222222222222
"140147706","CORDOBA",275,128,132,12,3,147,0.465454545454545
"140147705","CORDOBA",295,268,24,2,0,26,0.908474576271186
"140147704","CORDOBA",267,248,14,5,0,19,0.928838951310861
"140147703","CORDOBA",241,145,26,7,0,33,0.601659751037344
"140147702","CORDOBA",244,197,37,8,2,47,0.807377049180328
"140147701","CORDOBA",348,320,25,2,0,27,0.919540229885057
"140147617","CORDOBA",350,32,267,48,1,316,0.0914285714285714
"140147616","CORDOBA",380,66,267,33,5,305,0.173684210526316
"141050613","CORDOBA",99,0,76,16,6,98,0
"141050612","CORDOBA",384,7,346,20,6,372,0.0182291666666667
"141050611","CORDOBA",317,6,290,17,1,308,0.0189274447949527
"140147615","CORDOBA",244,15,204,23,1,228,0.0614754098360656
"140147614","CORDOBA",299,20,266,10,0,276,0.0668896321070234
"140147613","CORDOBA",236,6,210,16,0,226,0.0254237288135593
"140147612","CORDOBA",329,6,287,27,3,317,0.0182370820668693
"140147611","CORDOBA",287,12,250,23,1,274,0.0418118466898955
"140147610","CORDOBA",298,3,269,26,0,295,0.0100671140939597
"140147609","CORDOBA",314,3,273,34,2,309,0.00955414012738853
"140981613","CORDOBA",186,186,0,0,0,0,1
"140147607","CORDOBA",279,10,235,29,0,264,0.03584229390681
"140147606","CORDOBA",594,13,558,18,0,576,0.0218855218855219
"140147605","CORDOBA",295,5,246,43,0,289,0.0169491525423729
"140147604","CORDOBA",291,4,273,12,0,285,0.013745704467354
"140147603","CORDOBA",247,5,228,10,2,240,0.0202429149797571
"140147602","CORDOBA",308,6,271,29,0,300,0.0194805194805195
"140148609","CORDOBA",265,4,123,118,5,246,0.0150943396226415
"140144403","CORDOBA",293,12,268,9,4,281,0.0409556313993174
"140144402","CORDOBA",259,5,226,28,0,254,0.0193050193050193
"140144401","CORDOBA",539,523,16,0,0,16,0.970315398886827
"140144309","CORDOBA",353,123,198,27,5,230,0.348441926345609
"140144308","CORDOBA",383,24,203,135,7,345,0.0626631853785901
"140144307","CORDOBA",306,152,97,47,1,145,0.496732026143791
"140143712","CORDOBA",244,235,6,2,0,8,0.963114754098361
"140144306","CORDOBA",451,301,76,64,0,140,0.667405764966741
"140144305","CORDOBA",175,56,76,39,1,116,0.32
"140144303","CORDOBA",336,6,228,80,1,309,0.0178571428571429
"140144220","CORDOBA",327,311,12,3,0,15,0.951070336391437
"140144217","CORDOBA",245,228,12,5,0,17,0.930612244897959
"140144302","CORDOBA",453,152,236,44,2,282,0.335540838852097
"140144210","CORDOBA",195,179,15,1,0,16,0.917948717948718
"140144209","CORDOBA",202,185,16,1,0,17,0.915841584158416
"140145701","CORDOBA",383,383,0,0,0,0,1
"140144301","CORDOBA",330,309,17,4,0,21,0.936363636363636
"140981801","CORDOBA",417,344,46,26,0,72,0.824940047961631
"140981712","CORDOBA",435,299,70,63,0,133,0.68735632183908
"140144706","CORDOBA",229,228,0,1,0,1,0.995633187772926
"140144513","CORDOBA",200,16,174,10,0,184,0.08
"140144216","CORDOBA",321,293,9,1,0,10,0.912772585669782
"140144215","CORDOBA",201,11,179,11,0,190,0.054726368159204
"140144214","CORDOBA",305,275,26,4,0,30,0.901639344262295
"140144213","CORDOBA",226,211,12,3,0,15,0.933628318584071
"140144212","CORDOBA",277,250,23,4,0,27,0.902527075812274
"140144211","CORDOBA",246,233,11,2,0,13,0.947154471544715
"140144208","CORDOBA",380,137,233,10,0,243,0.360526315789474
"140144207","CORDOBA",275,254,20,1,0,21,0.923636363636364
"140144206","CORDOBA",229,200,23,5,1,29,0.873362445414847
"140144205","CORDOBA",189,147,40,2,0,42,0.777777777777778
"140144204","CORDOBA",178,5,162,11,0,173,0.0280898876404494
"140144203","CORDOBA",139,2,114,23,0,137,0.0143884892086331
"140144201","CORDOBA",193,8,158,27,0,185,0.0414507772020725
"140144119","CORDOBA",217,204,11,2,0,13,0.940092165898618
"140144118","CORDOBA",256,247,7,1,0,8,0.96484375
"140144117","CORDOBA",261,248,8,4,0,12,0.950191570881226
"140144116","CORDOBA",198,190,5,2,0,7,0.95959595959596
"140143814","CORDOBA",300,295,5,0,0,5,0.983333333333333
"140144115","CORDOBA",263,250,11,2,0,13,0.950570342205323
"140144114","CORDOBA",310,297,11,2,0,13,0.958064516129032
"140144113","CORDOBA",294,267,16,10,0,26,0.908163265306122
"140144112","CORDOBA",303,286,15,2,0,17,0.943894389438944
"140144111","CORDOBA",210,202,7,1,0,8,0.961904761904762
"140144109","CORDOBA",222,204,18,0,0,18,0.918918918918919
"140144108","CORDOBA",161,150,10,1,0,11,0.93167701863354
"140144107","CORDOBA",222,190,27,5,0,32,0.855855855855856
"140144106","CORDOBA",244,226,18,0,0,18,0.926229508196721
"140981508","CORDOBA",239,220,11,7,0,18,0.920502092050209
"140981505","CORDOBA",241,4,155,74,3,232,0.016597510373444
"140144105","CORDOBA",214,197,15,1,0,16,0.920560747663551
"140144104","CORDOBA",195,184,7,4,0,11,0.943589743589744
"140144103","CORDOBA",320,287,29,4,0,33,0.896875
"140144102","CORDOBA",210,191,16,3,0,19,0.90952380952381
"140144101","CORDOBA",257,242,15,0,0,15,0.941634241245136
"140144012","CORDOBA",258,244,9,2,0,11,0.945736434108527
"140144011","CORDOBA",224,202,16,5,0,21,0.901785714285714
"140144010","CORDOBA",315,295,13,4,1,18,0.936507936507937
"140144008","CORDOBA",322,236,52,30,0,82,0.732919254658385
"140144007","CORDOBA",247,227,11,8,0,19,0.919028340080972
"140143701","CORDOBA",421,369,31,19,0,50,0.876484560570071
"140144005","CORDOBA",158,145,12,1,0,13,0.917721518987342
"140144004","CORDOBA",200,176,23,1,0,24,0.88
"140144003","CORDOBA",231,209,16,6,0,22,0.904761904761905
"140144002","CORDOBA",223,199,17,7,0,24,0.89237668161435
"140144001","CORDOBA",251,237,8,6,0,14,0.944223107569721
"140981409","CORDOBA",132,0,75,53,2,130,0
"140143913","CORDOBA",179,152,8,18,1,27,0.849162011173184
"140143912","CORDOBA",324,321,3,0,0,3,0.990740740740741
"140143910","CORDOBA",260,234,25,1,0,26,0.9
"140143909","CORDOBA",286,263,9,11,3,23,0.91958041958042
"140143908","CORDOBA",261,254,5,2,0,7,0.973180076628352
"140143907","CORDOBA",212,143,37,27,0,64,0.674528301886792
"140143906","CORDOBA",220,215,3,2,0,5,0.977272727272727
"140143905","CORDOBA",191,189,1,1,0,2,0.989528795811518
"140143904","CORDOBA",229,222,5,0,1,6,0.96943231441048
"140981206","CORDOBA",97,0,19,73,1,93,0
"140143902","CORDOBA",377,282,8,62,8,78,0.748010610079576
"140144006","CORDOBA",178,178,0,0,0,0,1
"140143901","CORDOBA",177,164,4,7,1,12,0.926553672316384
"140143816","CORDOBA",231,222,8,1,0,9,0.961038961038961
"140143815","CORDOBA",248,245,2,0,1,3,0.987903225806452
"140143813","CORDOBA",297,290,6,1,0,7,0.976430976430976
"140143812","CORDOBA",225,209,13,3,0,16,0.928888888888889
"140143811","CORDOBA",260,253,7,0,0,7,0.973076923076923
"140143810","CORDOBA",319,314,2,1,0,3,0.984326018808777
"140143809","CORDOBA",254,238,11,2,0,13,0.937007874015748
"140143808","CORDOBA",368,344,15,5,1,21,0.934782608695652
"140143807","CORDOBA",251,238,8,4,0,12,0.948207171314741
"140143806","CORDOBA",254,243,11,0,0,11,0.956692913385827
"140143805","CORDOBA",235,226,9,0,0,9,0.961702127659574
"140143804","CORDOBA",308,297,8,3,0,11,0.964285714285714
"140143803","CORDOBA",346,327,16,3,0,19,0.945086705202312
"140143802","CORDOBA",339,324,13,1,0,14,0.955752212389381
"140143801","CORDOBA",379,346,25,7,0,32,0.912928759894459
"140143721","CORDOBA",163,158,4,1,0,5,0.969325153374233
"140143720","CORDOBA",209,202,3,4,0,7,0.966507177033493
"140143719","CORDOBA",216,214,1,1,0,2,0.990740740740741
"140143718","CORDOBA",166,163,2,0,0,2,0.981927710843373
"140143717","CORDOBA",215,179,1,0,0,1,0.832558139534884
"140143711","CORDOBA",428,368,50,10,0,60,0.85981308411215
"140143710","CORDOBA",233,173,50,10,0,60,0.742489270386266
"140143709","CORDOBA",240,208,20,12,0,32,0.866666666666667
"140143708","CORDOBA",330,273,37,20,0,57,0.827272727272727
"140143707","CORDOBA",303,225,54,24,0,78,0.742574257425743
"140143706","CORDOBA",289,53,187,38,2,227,0.183391003460208
"140143705","CORDOBA",266,223,34,7,0,41,0.838345864661654
"140143704","CORDOBA",260,220,34,4,0,38,0.846153846153846
"140143703","CORDOBA",243,193,27,22,0,49,0.794238683127572
"140143614","CORDOBA",208,207,0,1,0,1,0.995192307692308
"140143613","CORDOBA",234,232,0,1,0,1,0.991452991452991
"140143612","CORDOBA",253,246,6,1,0,7,0.972332015810277
"140143611","CORDOBA",259,24,217,13,2,232,0.0926640926640927
"140143606","CORDOBA",250,230,18,2,0,20,0.92
"140143602","CORDOBA",233,229,4,0,0,4,0.982832618025751
"140143601","CORDOBA",245,235,10,0,0,10,0.959183673469388
"140143514","CORDOBA",385,36,320,28,1,349,0.0935064935064935
"140143512","CORDOBA",305,10,269,24,0,293,0.0327868852459016
"140143511","CORDOBA",328,10,298,15,1,314,0.0304878048780488
"140143510","CORDOBA",238,6,177,55,0,232,0.0252100840336134
"140143509","CORDOBA",240,9,190,40,0,230,0.0375
"140981212","CORDOBA",214,130,68,16,0,84,0.607476635514019
"140143507","CORDOBA",354,24,321,8,0,329,0.0677966101694915
"140143506","CORDOBA",850,8,86,642,26,754,0.00941176470588235
"140146011","CORDOBA",378,369,8,1,0,9,0.976190476190476
"140143605","CORDOBA",313,294,19,0,0,19,0.939297124600639
"140141605","CORDOBA",273,7,165,93,1,259,0.0256410256410256
"140143604","CORDOBA",311,261,41,8,0,49,0.839228295819936
"140143603","CORDOBA",353,308,30,11,0,41,0.872521246458923
"140143505","CORDOBA",186,3,167,16,0,183,0.0161290322580645
"140981109","CORDOBA",252,4,206,40,0,246,0.0158730158730159
"140143504","CORDOBA",403,51,310,37,4,351,0.126550868486352
"140143503","CORDOBA",213,142,54,16,0,70,0.666666666666667
"140143502","CORDOBA",430,140,264,24,1,289,0.325581395348837
"140143501","CORDOBA",261,12,219,29,1,249,0.0459770114942529
"140143419","CORDOBA",202,124,69,9,0,78,0.613861386138614
"140143418","CORDOBA",363,41,305,17,0,322,0.112947658402204
"140143415","CORDOBA",218,3,182,33,0,215,0.0137614678899083
"140143414","CORDOBA",221,7,185,27,0,212,0.0316742081447964
"140143413","CORDOBA",244,0,230,14,0,244,0
"140143412","CORDOBA",236,7,189,40,0,229,0.0296610169491525
"140143411","CORDOBA",198,6,182,8,0,190,0.0303030303030303
"140143410","CORDOBA",208,0,204,3,0,207,0
"140143408","CORDOBA",219,2,172,43,1,216,0.0091324200913242
"140143407","CORDOBA",211,6,192,11,0,203,0.028436018957346
"140143406","CORDOBA",176,10,153,13,0,166,0.0568181818181818
"140143404","CORDOBA",134,7,115,12,0,127,0.0522388059701493
"140143403","CORDOBA",257,5,210,39,3,252,0.0194552529182879
"140143402","CORDOBA",294,5,276,8,0,284,0.0170068027210884
"140143401","CORDOBA",241,0,196,41,2,239,0
"140143320","CORDOBA",227,191,33,3,0,36,0.841409691629956
"140143319","CORDOBA",287,126,145,14,0,159,0.439024390243902
"140143318","CORDOBA",377,276,78,23,0,101,0.73209549071618
"140143317","CORDOBA",336,267,59,8,0,67,0.794642857142857
"140143316","CORDOBA",218,192,17,7,0,24,0.880733944954128
"140143315","CORDOBA",285,237,44,1,0,45,0.831578947368421
"140143313","CORDOBA",292,249,38,5,0,43,0.852739726027397
"140142601","CORDOBA",238,211,22,3,0,25,0.886554621848739
"140142518","CORDOBA",316,311,5,0,0,5,0.984177215189873
"140145313","CORDOBA",190,190,0,0,0,0,1
"140142517","CORDOBA",233,219,9,4,0,13,0.939914163090129
"140142516","CORDOBA",344,337,5,2,0,7,0.979651162790698
"140142515","CORDOBA",369,348,18,2,1,21,0.943089430894309
"140142514","CORDOBA",211,201,7,3,0,10,0.95260663507109
"140142513","CORDOBA",233,226,7,0,0,7,0.969957081545064
"140142512","CORDOBA",239,225,9,5,0,14,0.941422594142259
"140142511","CORDOBA",255,235,17,3,0,20,0.92156862745098
"140142510","CORDOBA",221,211,9,0,0,9,0.95475113122172
"140142509","CORDOBA",226,206,14,5,0,19,0.911504424778761
"140142508","CORDOBA",185,172,6,7,0,13,0.92972972972973
"140142507","CORDOBA",334,307,19,8,0,27,0.919161676646707
"140142506","CORDOBA",347,317,19,10,0,29,0.913544668587896
"140142505","CORDOBA",247,217,25,5,0,30,0.878542510121457
"140142504","CORDOBA",344,313,29,1,0,30,0.909883720930233
"140142503","CORDOBA",89,81,7,1,0,8,0.910112359550562
"140142615","CORDOBA",309,290,17,1,1,19,0.938511326860841
"140142307","CORDOBA",262,3,230,29,0,259,0.0114503816793893
"140142501","CORDOBA",280,277,3,0,0,3,0.989285714285714
"140142414","CORDOBA",199,9,170,20,0,190,0.0452261306532663
"140142413","CORDOBA",220,24,189,7,0,196,0.109090909090909
"140142412","CORDOBA",188,19,166,3,0,169,0.101063829787234
"140142411","CORDOBA",231,7,177,47,0,224,0.0303030303030303
"140142410","CORDOBA",194,10,147,37,0,184,0.0515463917525773
"140142408","CORDOBA",251,218,29,4,0,33,0.868525896414343
"140142407","CORDOBA",260,132,111,15,0,126,0.507692307692308
"140145312","CORDOBA",208,207,1,0,0,1,0.995192307692308
"140142406","CORDOBA",311,103,193,15,0,208,0.331189710610932
"140142405","CORDOBA",268,215,47,6,0,53,0.802238805970149
"140145214","CORDOBA",242,232,9,1,0,10,0.958677685950413
"140142404","CORDOBA",419,14,394,10,0,404,0.0334128878281623
"140142502","CORDOBA",212,194,15,2,1,18,0.915094339622642
"140142403","CORDOBA",301,19,279,3,0,282,0.0631229235880399
"140142402","CORDOBA",341,13,318,10,0,328,0.0381231671554252
"140142401","CORDOBA",336,7,321,8,0,329,0.0208333333333333
"140980608","CORDOBA",93,6,51,36,0,87,0.0645161290322581
"140980607","CORDOBA",75,0,51,24,0,75,0
"140142309","CORDOBA",182,1,172,9,0,181,0.00549450549450549
"140148402","CORDOBA",287,266,12,6,1,19,0.926829268292683
"140142308","CORDOBA",351,7,279,48,0,327,0.0199430199430199
"140145703","CORDOBA",248,248,0,0,0,0,1
"140980606","CORDOBA",50,0,20,28,0,48,0
"140142316","CORDOBA",200,23,162,15,0,177,0.115
"140142314","CORDOBA",254,35,210,7,0,217,0.137795275590551
"140142313","CORDOBA",450,21,392,36,1,429,0.0466666666666667
"140142312","CORDOBA",252,8,218,26,0,244,0.0317460317460317
"140142311","CORDOBA",218,7,201,10,0,211,0.0321100917431193
"140980514","CORDOBA",201,0,144,56,0,200,0
"140980513","CORDOBA",232,3,170,58,0,228,0.0129310344827586
"140143103","CORDOBA",442,10,374,47,0,421,0.0226244343891403
"140142306","CORDOBA",259,10,233,16,0,249,0.0386100386100386
"140142305","CORDOBA",182,15,131,36,0,167,0.0824175824175824
"140142304","CORDOBA",186,12,142,31,0,173,0.0645161290322581
"140145802","CORDOBA",282,275,3,3,0,6,0.975177304964539
"140145801","CORDOBA",138,123,15,0,0,15,0.891304347826087
"140145714","CORDOBA",262,262,0,0,0,0,1
"140145713","CORDOBA",232,232,0,0,0,0,1
"140145712","CORDOBA",135,135,0,0,0,0,1
"140145711","CORDOBA",172,172,0,0,0,0,1
"140145710","CORDOBA",155,152,1,2,0,3,0.980645161290323
"140145709","CORDOBA",140,140,0,0,0,0,1
"140145708","CORDOBA",71,71,0,0,0,0,1
"140145707","CORDOBA",194,194,0,0,0,0,1
"140145706","CORDOBA",113,113,0,0,0,0,1
"140145705","CORDOBA",152,151,1,0,0,1,0.993421052631579
"140145704","CORDOBA",399,399,0,0,0,0,1
"140145702","CORDOBA",227,225,1,0,0,1,0.991189427312775
"140145605","CORDOBA",160,157,3,0,0,3,0.98125
"140145604","CORDOBA",161,161,0,0,0,0,1
"140145603","CORDOBA",226,224,2,0,0,2,0.991150442477876
"140145602","CORDOBA",219,218,1,0,0,1,0.995433789954338
"140145601","CORDOBA",217,217,0,0,0,0,1
"140145508","CORDOBA",57,57,0,0,0,0,1
"140145507","CORDOBA",150,150,0,0,0,0,1
"140145506","CORDOBA",106,105,0,1,0,1,0.990566037735849
"140145505","CORDOBA",144,144,0,0,0,0,1
"140145504","CORDOBA",122,122,0,0,0,0,1
"140145503","CORDOBA",125,121,2,0,0,2,0.968
"141050114","CORDOBA",275,2,216,39,6,261,0.00727272727272727
"141050113","CORDOBA",196,2,160,29,5,194,0.0102040816326531
"141050112","CORDOBA",189,1,178,10,0,188,0.00529100529100529
"140145502","CORDOBA",231,222,1,0,0,1,0.961038961038961
"140145501","CORDOBA",227,224,3,0,0,3,0.986784140969163
"140145416","CORDOBA",197,197,0,0,0,0,1
"140145415","CORDOBA",244,244,0,0,0,0,1
"140145414","CORDOBA",257,257,0,0,0,0,1
"140145413","CORDOBA",428,427,1,0,0,1,0.997663551401869
"140145412","CORDOBA",223,223,0,0,0,0,1
"140145411","CORDOBA",114,114,0,0,0,0,1
"140145410","CORDOBA",173,173,0,0,0,0,1
"140145405","CORDOBA",144,143,0,0,0,0,0.993055555555556
"140145404","CORDOBA",212,212,0,0,0,0,1
"140145403","CORDOBA",216,214,2,0,0,2,0.990740740740741
"140145402","CORDOBA",205,188,0,1,0,1,0.917073170731707
"140145401","CORDOBA",181,180,1,0,0,1,0.994475138121547
"140145320","CORDOBA",141,141,0,0,0,0,1
"140145319","CORDOBA",211,198,13,0,0,13,0.938388625592417
"140145318","CORDOBA",206,206,0,0,0,0,1
"140145317","CORDOBA",174,172,2,0,0,2,0.988505747126437
"140145316","CORDOBA",161,159,1,1,0,2,0.987577639751553
"140145315","CORDOBA",338,338,0,0,0,0,1
"140145314","CORDOBA",193,187,4,2,0,6,0.968911917098446
"140145310","CORDOBA",285,281,3,0,0,3,0.985964912280702
"140145309","CORDOBA",225,224,1,0,0,1,0.995555555555556
"140145308","CORDOBA",302,258,39,2,0,41,0.854304635761589
"140145306","CORDOBA",273,273,0,0,0,0,1
"140982905","CORDOBA",193,1,102,84,0,186,0.00518134715025907
"140982904","CORDOBA",219,0,153,64,1,218,0
"140145305","CORDOBA",182,175,2,1,0,3,0.961538461538462
"140145509","CORDOBA",169,169,0,0,0,0,1
"140145303","CORDOBA",140,134,5,1,0,6,0.957142857142857
"140145302","CORDOBA",222,217,4,1,0,5,0.977477477477477
"140145301","CORDOBA",243,241,1,0,0,1,0.991769547325103
"140145219","CORDOBA",296,224,55,16,0,71,0.756756756756757
"140145213","CORDOBA",248,211,16,21,0,37,0.850806451612903
"140145212","CORDOBA",299,212,56,26,1,83,0.709030100334448
"140145211","CORDOBA",163,133,21,8,1,30,0.815950920245399
"140145210","CORDOBA",182,143,31,6,0,37,0.785714285714286
"140145107","CORDOBA",320,279,31,9,0,40,0.871875
"140145106","CORDOBA",326,293,31,2,0,33,0.898773006134969
"140145218","CORDOBA",315,271,10,22,1,33,0.86031746031746
"140982705","CORDOBA",274,130,115,26,0,141,0.474452554744526
"140145217","CORDOBA",231,143,42,39,0,81,0.619047619047619
"140145216","CORDOBA",253,165,50,36,0,86,0.652173913043478
"140145304","CORDOBA",165,164,0,0,0,0,0.993939393939394
"140145215","CORDOBA",197,157,34,6,0,40,0.796954314720812
"140210709","CORDOBA",243,231,3,0,0,3,0.950617283950617
"140145204","CORDOBA",421,76,68,227,20,315,0.180522565320665
"140145203","CORDOBA",232,219,7,6,0,13,0.943965517241379
"140145202","CORDOBA",340,299,40,1,0,41,0.879411764705882
"140145201","CORDOBA",222,219,3,0,0,3,0.986486486486487
"140145121","CORDOBA",258,4,57,151,24,232,0.0155038759689922
"140145120","CORDOBA",532,84,156,247,5,408,0.157894736842105
"140145119","CORDOBA",359,254,77,20,1,98,0.707520891364902
"140145118","CORDOBA",282,46,223,12,1,236,0.163120567375887
"140145117","CORDOBA",377,153,167,53,0,220,0.405835543766578
"140145116","CORDOBA",164,13,115,31,2,148,0.0792682926829268
"140145115","CORDOBA",204,172,19,11,0,30,0.843137254901961
"140145114","CORDOBA",268,232,30,6,0,36,0.865671641791045
"140145105","CORDOBA",248,201,39,6,2,47,0.810483870967742
"140145104","CORDOBA",277,121,130,25,0,155,0.436823104693141
"140145103","CORDOBA",203,131,51,21,0,72,0.645320197044335
"140145102","CORDOBA",262,172,53,37,0,90,0.656488549618321
"140145101","CORDOBA",269,224,29,16,0,45,0.83271375464684
"140145015","CORDOBA",275,270,3,2,0,5,0.981818181818182
"140145014","CORDOBA",241,240,1,0,0,1,0.995850622406639
"140145013","CORDOBA",196,195,1,0,0,1,0.994897959183674
"140145012","CORDOBA",228,218,10,0,0,10,0.956140350877193
"140145011","CORDOBA",259,204,45,4,0,49,0.787644787644788
"140145010","CORDOBA",258,251,6,1,0,7,0.972868217054264
"140145008","CORDOBA",246,240,2,2,0,4,0.975609756097561
"140145007","CORDOBA",284,281,3,0,0,3,0.98943661971831
"140145006","CORDOBA",211,208,3,0,0,3,0.985781990521327
"140145005","CORDOBA",218,182,32,4,0,36,0.834862385321101
"140145004","CORDOBA",235,118,83,34,0,117,0.502127659574468
"140210907","CORDOBA",205,176,26,3,0,29,0.858536585365854
"140145003","CORDOBA",213,206,6,1,0,7,0.967136150234742
"140145002","CORDOBA",293,263,6,0,0,6,0.897610921501707
"140145001","CORDOBA",290,284,5,0,0,5,0.979310344827586
"140144921","CORDOBA",297,295,2,0,0,2,0.993265993265993
"140144920","CORDOBA",199,197,1,0,1,2,0.989949748743719
"140144919","CORDOBA",218,218,0,0,0,0,1
"140144918","CORDOBA",161,160,1,0,0,1,0.993788819875776
"140144917","CORDOBA",153,152,1,0,0,1,0.993464052287582
"140144916","CORDOBA",347,343,3,1,0,4,0.988472622478386
"140144915","CORDOBA",252,249,1,1,0,2,0.988095238095238
"140144914","CORDOBA",232,231,1,0,0,1,0.995689655172414
"140144913","CORDOBA",343,342,1,0,0,1,0.997084548104956
"140144912","CORDOBA",180,172,0,0,0,0,0.955555555555556
"140144911","CORDOBA",124,124,0,0,0,0,1
"140144909","CORDOBA",322,309,6,0,3,9,0.959627329192547
"140144908","CORDOBA",303,278,16,6,0,22,0.917491749174917
"140144907","CORDOBA",355,325,10,1,1,12,0.915492957746479
"140210712","CORDOBA",200,5,165,23,0,188,0.025
"140144905","CORDOBA",219,211,6,0,0,6,0.963470319634703
"140144904","CORDOBA",205,201,4,0,0,4,0.980487804878049
"140144903","CORDOBA",148,144,4,0,0,4,0.972972972972973
"140144902","CORDOBA",175,172,3,0,0,3,0.982857142857143
"140144901","CORDOBA",148,145,1,0,0,1,0.97972972972973
"140144816","CORDOBA",268,259,5,4,0,9,0.966417910447761
"140144815","CORDOBA",389,361,26,1,0,27,0.928020565552699
"140144814","CORDOBA",238,223,10,4,0,14,0.936974789915966
"140144813","CORDOBA",266,253,10,3,0,13,0.951127819548872
"140144812","CORDOBA",239,235,3,1,0,4,0.98326359832636
"140144811","CORDOBA",257,257,0,0,0,0,1
"140144810","CORDOBA",335,333,1,1,0,2,0.994029850746269
"140144809","CORDOBA",162,159,1,0,0,1,0.981481481481482
"140144808","CORDOBA",228,228,0,0,0,0,1
"140144807","CORDOBA",308,304,4,0,0,4,0.987012987012987
"140144806","CORDOBA",219,213,3,2,0,5,0.972602739726027
"140142303","CORDOBA",217,6,211,0,0,211,0.0276497695852535
"140142302","CORDOBA",332,22,296,14,0,310,0.0662650602409639
"140142301","CORDOBA",245,9,217,18,0,235,0.036734693877551
"140142218","CORDOBA",426,9,204,150,30,384,0.0211267605633803
"140142216","CORDOBA",291,26,251,13,1,265,0.0893470790378007
"140142214","CORDOBA",257,38,171,48,0,219,0.147859922178988
"140142205","CORDOBA",126,4,119,3,0,122,0.0317460317460317
"140141918","CORDOBA",247,26,185,36,0,221,0.105263157894737
"140142213","CORDOBA",3,0,0,2,0,2,0
"140142212","CORDOBA",377,343,33,1,0,34,0.909814323607427
"140142211","CORDOBA",309,277,25,7,0,32,0.896440129449838
"140142208","CORDOBA",355,347,6,2,0,8,0.977464788732394
"140142206","CORDOBA",437,426,8,2,0,10,0.974828375286041
"140142204","CORDOBA",207,8,187,12,0,199,0.0386473429951691
"140142310","CORDOBA",259,5,243,11,0,254,0.0193050193050193
"140142217","CORDOBA",322,3,203,100,9,312,0.0093167701863354
"140142011","CORDOBA",238,0,238,0,0,238,0
"140141807","CORDOBA",229,3,193,26,0,219,0.0131004366812227
"140142203","CORDOBA",217,156,48,10,2,60,0.71889400921659
"140142201","CORDOBA",198,191,7,0,0,7,0.964646464646465
"140142917","CORDOBA",341,231,87,18,0,105,0.67741935483871
"140980304","CORDOBA",245,3,185,52,4,241,0.0122448979591837
"140142010","CORDOBA",267,3,244,19,0,263,0.0112359550561798
"140142105","CORDOBA",213,209,2,1,0,3,0.981220657276995
"140980409","CORDOBA",102,0,59,41,1,101,0
"140980408","CORDOBA",233,1,167,58,2,227,0.00429184549356223
"140980407","CORDOBA",207,1,172,27,6,205,0.00483091787439614
"140142009","CORDOBA",228,3,221,3,0,224,0.0131578947368421
"140142008","CORDOBA",213,3,160,50,0,210,0.0140845070422535
"140142007","CORDOBA",257,12,207,33,2,242,0.0466926070038911
"140142006","CORDOBA",253,5,211,35,0,246,0.0197628458498024
"140142103","CORDOBA",258,67,155,30,5,190,0.25968992248062
"140146010","CORDOBA",226,211,10,5,0,15,0.933628318584071
"140142210","CORDOBA",310,284,25,1,0,26,0.916129032258065
"140142102","CORDOBA",282,248,11,22,1,34,0.879432624113475
"140980305","CORDOBA",299,11,267,16,2,285,0.0367892976588629
"140142101","CORDOBA",274,4,194,46,11,251,0.0145985401459854
"140142015","CORDOBA",188,9,156,23,0,179,0.0478723404255319
"140142014","CORDOBA",310,33,242,35,0,277,0.106451612903226
"140142209","CORDOBA",245,236,6,3,0,9,0.963265306122449
"140142013","CORDOBA",289,8,248,33,0,281,0.027681660899654
"140142012","CORDOBA",299,15,278,6,0,284,0.0501672240802676
"140142005","CORDOBA",396,54,304,35,0,339,0.136363636363636
"140142004","CORDOBA",327,2,311,13,0,324,0.00611620795107034
"140143417","CORDOBA",196,6,181,9,0,190,0.0306122448979592
"140142003","CORDOBA",255,5,243,6,0,249,0.0196078431372549
"140142002","CORDOBA",236,2,225,7,1,233,0.00847457627118644
"140142001","CORDOBA",281,5,249,15,6,270,0.0177935943060498
"140141919","CORDOBA",244,1,22,197,4,223,0.00409836065573771
"140141917","CORDOBA",246,5,215,26,0,241,0.0203252032520325
"140141916","CORDOBA",407,8,302,69,22,393,0.0196560196560197
"140141915","CORDOBA",441,7,376,57,0,433,0.0158730158730159
"140141913","CORDOBA",348,5,313,27,0,340,0.014367816091954
"140141912","CORDOBA",252,5,156,79,3,238,0.0198412698412698
"140141911","CORDOBA",405,12,305,86,0,391,0.0296296296296296
"140141910","CORDOBA",205,17,154,30,1,185,0.0829268292682927
"140141909","CORDOBA",318,4,215,65,7,287,0.0125786163522013
"140141914","CORDOBA",348,16,238,76,0,314,0.0459770114942529
"140141908","CORDOBA",433,3,198,206,2,406,0.0069284064665127
"140141907","CORDOBA",417,14,320,78,2,400,0.0335731414868106
"140141906","CORDOBA",366,22,273,56,0,329,0.0601092896174863
"140141905","CORDOBA",268,3,184,63,3,250,0.0111940298507463
"140141904","CORDOBA",306,2,237,57,1,295,0.0065359477124183
"140141903","CORDOBA",267,5,204,47,1,252,0.0187265917602996
"140141902","CORDOBA",234,6,212,15,0,227,0.0256410256410256
"140141901","CORDOBA",402,6,364,25,1,390,0.0149253731343284
"140141818","CORDOBA",317,47,215,50,0,265,0.148264984227129
"140141817","CORDOBA",306,62,228,15,1,244,0.202614379084967
"140141816","CORDOBA",450,6,325,93,13,431,0.0133333333333333
"140141815","CORDOBA",281,2,211,66,0,277,0.00711743772241993
"140141814","CORDOBA",350,12,317,17,0,334,0.0342857142857143
"140141812","CORDOBA",328,8,271,47,1,319,0.024390243902439
"140141811","CORDOBA",358,20,307,29,0,336,0.0558659217877095
"140141810","CORDOBA",245,6,217,22,0,239,0.0244897959183673
"140141809","CORDOBA",348,16,308,19,0,327,0.0459770114942529
"140141808","CORDOBA",471,4,416,42,1,459,0.00849256900212314
"140141806","CORDOBA",237,3,153,70,4,227,0.0126582278481013
"140141805","CORDOBA",429,47,329,43,2,374,0.10955710955711
"140141804","CORDOBA",237,20,206,9,0,215,0.0843881856540084
"140141803","CORDOBA",282,158,114,7,0,121,0.560283687943262
"140141813","CORDOBA",309,17,256,33,3,292,0.0550161812297735
"140141802","CORDOBA",279,5,232,35,1,268,0.017921146953405
"140141801","CORDOBA",438,21,342,67,3,412,0.0479452054794521
"140141721","CORDOBA",401,1,368,30,0,398,0.00249376558603491
"140141708","CORDOBA",310,4,263,30,1,294,0.0129032258064516
"140141720","CORDOBA",193,4,182,6,0,188,0.0207253886010363
"140141719","CORDOBA",297,18,250,26,1,277,0.0606060606060606
"140141718","CORDOBA",349,10,257,71,2,330,0.0286532951289398
"140141717","CORDOBA",475,3,432,28,2,462,0.00631578947368421
"140141714","CORDOBA",266,0,233,31,0,264,0
"140141713","CORDOBA",466,13,300,133,2,435,0.0278969957081545
"140141712","CORDOBA",276,4,247,20,0,267,0.0144927536231884
"140141711","CORDOBA",336,11,198,123,2,323,0.0327380952380952
"140141710","CORDOBA",344,7,306,25,1,332,0.0203488372093023
"140141709","CORDOBA",236,7,217,10,0,227,0.0296610169491525
"140141707","CORDOBA",240,11,192,26,3,221,0.0458333333333333
"140141706","CORDOBA",446,9,393,40,3,436,0.0201793721973094
"140141705","CORDOBA",307,3,265,35,0,300,0.00977198697068404
"140141704","CORDOBA",389,4,347,28,3,378,0.0102827763496144
"140141703","CORDOBA",280,3,248,23,1,272,0.0107142857142857
"140141702","CORDOBA",323,8,251,58,3,312,0.0247678018575851
"140141616","CORDOBA",544,2,103,287,30,420,0.00367647058823529
"140141615","CORDOBA",232,2,133,81,6,220,0.00862068965517241
"140141614","CORDOBA",253,18,83,140,3,226,0.0711462450592885
"140141613","CORDOBA",268,6,96,151,8,255,0.0223880597014925
"140141608","CORDOBA",187,163,11,9,0,20,0.871657754010695
"140141503","CORDOBA",198,9,181,6,2,189,0.0454545454545455
"140141607","CORDOBA",329,206,94,26,0,120,0.626139817629179
"140141606","CORDOBA",341,9,272,46,3,321,0.0263929618768328
"140141602","CORDOBA",413,379,18,0,0,18,0.917675544794189
"140911912","CORDOBA",42,0,35,4,3,42,0
"140911911","CORDOBA",285,2,239,34,10,283,0.00701754385964912
"140141716","CORDOBA",479,6,406,46,4,456,0.0125260960334029
"140141701","CORDOBA",409,6,379,20,1,400,0.0146699266503667
"140141519","CORDOBA",261,2,194,12,52,258,0.00766283524904215
"140141502","CORDOBA",248,13,216,18,1,235,0.0524193548387097
"140630415","CORDOBA",212,59,96,56,1,153,0.278301886792453
"140141518","CORDOBA",227,7,174,13,33,220,0.0308370044052863
"140143416","CORDOBA",249,33,182,34,0,216,0.132530120481928
"140141715","CORDOBA",390,58,218,95,2,315,0.148717948717949
"140141516","CORDOBA",169,4,112,49,1,162,0.0236686390532544
"140141515","CORDOBA",247,27,195,21,4,220,0.109311740890688
"140141514","CORDOBA",353,32,296,21,3,320,0.0906515580736544
"140070818","CORDOBA",278,1,257,16,3,276,0.00359712230215827
"140141513","CORDOBA",540,29,443,66,1,510,0.0537037037037037
"140141512","CORDOBA",191,3,185,3,0,188,0.0157068062827225
"140141511","CORDOBA",410,402,2,1,0,3,0.980487804878049
"140141510","CORDOBA",324,257,36,27,4,67,0.79320987654321
"140141509","CORDOBA",395,394,1,0,0,1,0.99746835443038
"140141508","CORDOBA",269,230,5,34,0,39,0.855018587360595
"140141507","CORDOBA",199,8,151,39,1,191,0.0402010050251256
"140141506","CORDOBA",451,419,26,5,0,31,0.929046563192905
"140141505","CORDOBA",308,308,0,0,0,0,1
"140630414","CORDOBA",263,175,76,12,0,88,0.665399239543726
"140141501","CORDOBA",203,5,181,14,3,198,0.0246305418719212
"140911808","CORDOBA",194,2,169,11,10,190,0.0103092783505155
"140911807","CORDOBA",90,2,51,10,18,79,0.0222222222222222
"140141110","CORDOBA",270,3,238,24,1,263,0.0111111111111111
"140911715","CORDOBA",98,0,70,19,3,92,0
"140911806","CORDOBA",117,9,91,14,3,108,0.0769230769230769
"140141402","CORDOBA",503,90,310,83,9,402,0.178926441351889
"140141401","CORDOBA",364,12,273,59,2,334,0.032967032967033
"140141309","CORDOBA",445,177,202,58,0,260,0.397752808988764
"140141307","CORDOBA",337,6,252,72,2,326,0.0178041543026706
"140141204","CORDOBA",376,5,332,35,1,368,0.0132978723404255
"140630413","CORDOBA",332,197,98,36,0,134,0.593373493975904
"140141203","CORDOBA",350,15,219,107,0,326,0.0428571428571429
"140141202","CORDOBA",341,4,276,50,6,332,0.0117302052785924
"140141111","CORDOBA",295,6,242,26,3,271,0.0203389830508475
"140143310","CORDOBA",262,227,25,9,0,34,0.866412213740458
"140141109","CORDOBA",406,232,69,79,5,153,0.571428571428571
"140146009","CORDOBA",271,264,4,2,0,6,0.974169741697417
"140141303","CORDOBA",280,2,243,33,1,277,0.00714285714285714
"140141302","CORDOBA",371,15,328,27,0,355,0.0404312668463612
"140141301","CORDOBA",138,1,124,13,0,137,0.0072463768115942
"140140106","CORDOBA",344,5,305,30,2,337,0.0145348837209302
"140146007","CORDOBA",231,223,6,1,0,7,0.965367965367965
"140140203","CORDOBA",346,79,225,42,0,267,0.228323699421965
"140140202","CORDOBA",452,167,268,17,0,285,0.369469026548673
"140143309","CORDOBA",266,220,38,7,0,45,0.827067669172932
"140145307","CORDOBA",220,217,3,0,0,3,0.986363636363636
"140070820","CORDOBA",197,6,155,30,2,187,0.0304568527918782
"140146006","CORDOBA",260,248,11,1,0,12,0.953846153846154
"140070806","CORDOBA",203,52,120,27,1,148,0.25615763546798
"140070805","CORDOBA",352,15,265,50,11,326,0.0426136363636364
"140911007","CORDOBA",155,20,129,6,0,135,0.129032258064516
"140910916","CORDOBA",346,3,288,41,11,340,0.00867052023121387
"140143308","CORDOBA",347,42,294,9,0,303,0.121037463976945
"140143307","CORDOBA",307,15,268,24,0,292,0.0488599348534202
"140143306","CORDOBA",209,14,171,21,0,192,0.0669856459330144
"140070804","CORDOBA",69,0,63,5,1,69,0
"140146005","CORDOBA",366,346,19,1,0,20,0.945355191256831
"140070819","CORDOBA",35,12,19,4,0,23,0.342857142857143
"140141107","CORDOBA",236,4,168,57,1,226,0.0169491525423729
"140070718","CORDOBA",28,0,26,2,0,28,0
"140141010","CORDOBA",357,39,243,65,1,309,0.109243697478992
"140143212","CORDOBA",240,129,88,21,0,109,0.5375
"140070803","CORDOBA",275,127,105,19,21,145,0.461818181818182
"140911202","CORDOBA",233,120,105,8,0,113,0.515021459227468
"140143213","CORDOBA",291,278,11,1,0,12,0.9553264604811
"140070719","CORDOBA",184,0,147,22,0,169,0
"140143312","CORDOBA",257,230,24,0,0,24,0.894941634241245
"140070720","CORDOBA",19,0,14,5,0,19,0
"140141009","CORDOBA",331,26,300,4,1,305,0.0785498489425982
"140143311","CORDOBA",291,255,30,6,0,36,0.876288659793814
"140070616","CORDOBA",109,1,95,13,0,108,0.00917431192660551
"140910910","CORDOBA",170,159,11,0,0,11,0.935294117647059
"140143211","CORDOBA",305,175,67,26,0,93,0.573770491803279
"140070614","CORDOBA",250,0,179,46,21,246,0
"140143201","CORDOBA",245,34,201,9,0,210,0.138775510204082
"140143116","CORDOBA",359,10,275,70,0,345,0.0278551532033426
"140070609","CORDOBA",153,2,136,11,3,150,0.0130718954248366
"140070608","CORDOBA",228,1,202,22,2,226,0.0043859649122807
"821120414","SANTA FE",305,209,40,55,0,95,0.685245901639344
"140143305","CORDOBA",223,13,161,43,1,205,0.0582959641255605
"140143304","CORDOBA",241,39,182,20,0,202,0.161825726141079
"140143303","CORDOBA",271,12,233,23,1,257,0.044280442804428
"140143302","CORDOBA",234,7,184,41,0,225,0.0299145299145299
"140143301","CORDOBA",285,43,221,19,1,241,0.150877192982456
"140143203","CORDOBA",229,173,44,12,0,56,0.755458515283843
"140143202","CORDOBA",417,61,326,27,0,353,0.146282973621103
"140143114","CORDOBA",292,6,238,45,1,284,0.0205479452054795
"140143113","CORDOBA",285,16,212,56,0,268,0.056140350877193
"140143112","CORDOBA",413,9,297,93,0,390,0.0217917675544794
"140143111","CORDOBA",275,11,257,5,1,263,0.04
"140143110","CORDOBA",266,8,210,38,0,248,0.0300751879699248
"140143109","CORDOBA",450,12,393,37,2,432,0.0266666666666667
"140143108","CORDOBA",324,184,129,11,0,140,0.567901234567901
"140143107","CORDOBA",425,13,385,26,0,411,0.0305882352941176
"140143106","CORDOBA",264,222,40,0,0,40,0.840909090909091
"140143105","CORDOBA",367,201,131,33,0,164,0.547683923705722
"140143104","CORDOBA",310,248,53,8,1,62,0.8
"140142910","CORDOBA",299,7,227,59,1,287,0.0234113712374582
"140142909","CORDOBA",325,8,279,27,7,313,0.0246153846153846
"140143102","CORDOBA",478,21,346,101,1,448,0.0439330543933054
"140143101","CORDOBA",296,127,146,15,1,162,0.429054054054054
"140143015","CORDOBA",285,1,243,30,0,273,0.00350877192982456
"140143014","CORDOBA",333,11,278,41,0,319,0.033033033033033
"140143013","CORDOBA",319,24,284,10,1,295,0.0752351097178683
"140143012","CORDOBA",331,7,291,32,0,323,0.0211480362537764
"140143011","CORDOBA",302,5,290,5,0,295,0.0165562913907285
"140143010","CORDOBA",316,24,253,35,1,289,0.0759493670886076
"140143009","CORDOBA",399,13,354,29,0,383,0.0325814536340852
"140981014","CORDOBA",245,95,96,48,6,150,0.387755102040816
"140142908","CORDOBA",283,270,7,3,0,10,0.954063604240283
"140981013","CORDOBA",282,224,26,30,1,57,0.794326241134752
"140143008","CORDOBA",289,5,268,11,1,280,0.0173010380622837
"140143007","CORDOBA",173,13,137,21,1,159,0.0751445086705202
"140142918","CORDOBA",249,86,86,71,1,158,0.345381526104418
"140143006","CORDOBA",309,4,277,23,1,301,0.0129449838187702
"140143005","CORDOBA",239,13,204,16,0,220,0.0543933054393305
"140143004","CORDOBA",373,12,268,85,2,355,0.032171581769437
"140146004","CORDOBA",300,279,13,6,2,21,0.93
"140143003","CORDOBA",275,25,210,36,0,246,0.0909090909090909
"140143002","CORDOBA",404,25,346,32,0,378,0.0618811881188119
"140143001","CORDOBA",269,10,237,10,0,247,0.0371747211895911
"140142919","CORDOBA",237,137,37,59,0,96,0.578059071729958
"140142708","CORDOBA",324,302,17,4,0,21,0.932098765432099
"140142915","CORDOBA",418,383,23,9,2,34,0.916267942583732
"140142914","CORDOBA",290,267,15,6,0,21,0.920689655172414
"140142913","CORDOBA",267,245,20,2,0,22,0.917602996254682
"140142912","CORDOBA",282,3,235,30,7,272,0.0106382978723404
"140142911","CORDOBA",237,16,160,58,0,218,0.0675105485232067
"140142906","CORDOBA",376,373,3,0,0,3,0.992021276595745
"140142905","CORDOBA",371,66,260,36,1,297,0.177897574123989
"140142904","CORDOBA",330,8,253,64,0,317,0.0242424242424242
"140142903","CORDOBA",317,294,18,2,0,20,0.927444794952681
"140142902","CORDOBA",270,267,1,0,0,1,0.988888888888889
"140142901","CORDOBA",315,313,2,0,0,2,0.993650793650794
"140142816","CORDOBA",465,40,241,132,8,381,0.0860215053763441
"140142815","CORDOBA",269,15,250,0,0,250,0.0557620817843866
"140142814","CORDOBA",347,16,263,50,4,317,0.0461095100864553
"140142813","CORDOBA",398,24,275,88,1,364,0.0603015075376884
"140980906","CORDOBA",265,186,53,24,0,77,0.70188679245283
"140142812","CORDOBA",258,2,231,24,0,255,0.00775193798449612
"140142811","CORDOBA",294,2,249,39,0,288,0.00680272108843537
"140142810","CORDOBA",344,10,271,59,1,331,0.0290697674418605
"140142809","CORDOBA",304,3,288,11,1,300,0.00986842105263158
"140142707","CORDOBA",302,269,29,3,0,32,0.890728476821192
"140142808","CORDOBA",394,15,340,39,0,379,0.0380710659898477
"140142807","CORDOBA",238,5,211,20,1,232,0.0210084033613445
"140142806","CORDOBA",261,27,165,15,0,180,0.103448275862069
"140142805","CORDOBA",352,12,310,28,0,338,0.0340909090909091
"140142804","CORDOBA",442,6,418,16,0,434,0.0135746606334842
"140142803","CORDOBA",381,5,343,33,0,376,0.0131233595800525
"140142802","CORDOBA",328,10,285,32,1,318,0.0304878048780488
"140142801","CORDOBA",400,20,365,15,0,380,0.05
"140142712","CORDOBA",214,203,8,3,0,11,0.948598130841122
"140142711","CORDOBA",272,260,10,2,0,12,0.955882352941177
"140142710","CORDOBA",301,279,14,4,1,19,0.926910299003322
"140142709","CORDOBA",225,201,19,4,0,23,0.893333333333333
"140142704","CORDOBA",300,271,22,3,0,25,0.903333333333333
"140142703","CORDOBA",357,297,20,25,5,50,0.831932773109244
"140142613","CORDOBA",215,188,23,4,0,27,0.874418604651163
"140142612","CORDOBA",280,272,4,3,0,7,0.971428571428571
"140142611","CORDOBA",376,343,26,7,0,33,0.912234042553192
"140980809","CORDOBA",205,5,101,89,0,190,0.024390243902439
"140980808","CORDOBA",280,17,192,70,1,263,0.0607142857142857
"140142610","CORDOBA",203,187,14,2,0,16,0.921182266009852
"140420414","CORDOBA",242,127,41,74,0,115,0.524793388429752
"140142609","CORDOBA",275,247,8,8,0,16,0.898181818181818
"140142608","CORDOBA",370,355,8,6,1,15,0.959459459459459
"140142607","CORDOBA",247,239,5,3,0,8,0.967611336032389
"140142606","CORDOBA",252,231,13,6,0,19,0.916666666666667
"140142605","CORDOBA",179,166,6,5,0,11,0.927374301675978
"140142604","CORDOBA",173,157,14,2,0,16,0.907514450867052
"140142603","CORDOBA",267,253,10,4,0,14,0.947565543071161
"140142602","CORDOBA",199,181,6,11,0,17,0.909547738693467
"140070605","CORDOBA",68,0,59,6,1,66,0
"140143210","CORDOBA",433,371,43,17,0,60,0.856812933025404
"140141008","CORDOBA",501,8,472,16,0,488,0.0159680638722555
"140070615","CORDOBA",140,2,107,28,1,136,0.0142857142857143
"140070213","CORDOBA",179,57,108,13,1,122,0.318435754189944
"140070516","CORDOBA",125,0,104,16,1,121,0
"140141208","CORDOBA",329,7,284,34,3,321,0.0212765957446809
"140070514","CORDOBA",179,4,160,14,1,175,0.0223463687150838
"140070513","CORDOBA",259,9,231,18,1,250,0.0347490347490347
"140140313","CORDOBA",409,302,84,16,0,100,0.73838630806846
"140910810","CORDOBA",230,10,191,26,2,219,0.0434782608695652
"140070512","CORDOBA",299,6,253,40,0,293,0.020066889632107
"140140806","CORDOBA",249,20,217,9,1,227,0.0803212851405622
"140070511","CORDOBA",304,3,266,31,3,300,0.00986842105263158
"140070507","CORDOBA",173,2,133,25,7,165,0.0115606936416185
"140910616","CORDOBA",165,2,143,16,2,161,0.0121212121212121
"140146003","CORDOBA",212,196,16,0,0,16,0.924528301886792
"140140810","CORDOBA",380,11,228,126,3,357,0.0289473684210526
"140070506","CORDOBA",227,1,200,13,8,221,0.00440528634361234
"140143209","CORDOBA",243,192,41,6,0,47,0.790123456790123
"140140211","CORDOBA",189,96,89,4,0,93,0.507936507936508
"140070505","CORDOBA",182,7,164,11,0,175,0.0384615384615385
"140070504","CORDOBA",168,5,146,15,2,163,0.0297619047619048
"140070503","CORDOBA",169,2,125,37,1,163,0.0118343195266272
"140070216","CORDOBA",77,1,62,11,3,76,0.012987012987013
"820842702","SANTA FE",277,277,0,0,0,0,1
"140070502","CORDOBA",118,4,100,13,0,113,0.0338983050847458
"140910410","CORDOBA",147,134,12,1,0,13,0.91156462585034
"140070501","CORDOBA",206,0,174,11,14,199,0
"140143208","CORDOBA",285,70,137,59,0,196,0.245614035087719
"140140210","CORDOBA",265,253,11,1,0,12,0.954716981132075
"140070415","CORDOBA",58,2,50,4,0,54,0.0344827586206897
"140140209","CORDOBA",268,251,17,0,0,17,0.936567164179104
"140141106","CORDOBA",239,0,195,41,1,237,0
"140070212","CORDOBA",184,78,98,8,0,106,0.423913043478261
"140141103","CORDOBA",276,228,44,3,0,47,0.826086956521739
"140070416","CORDOBA",133,0,107,22,2,131,0
"140140208","CORDOBA",279,264,15,0,0,15,0.946236559139785
"140140207","CORDOBA",358,322,34,2,0,36,0.899441340782123
"140141007","CORDOBA",157,23,97,36,1,134,0.146496815286624
"140140206","CORDOBA",183,130,53,0,0,53,0.710382513661202
"140140811","CORDOBA",386,1,290,74,2,366,0.00259067357512953
"140910704","CORDOBA",228,1,209,16,1,226,0.0043859649122807
"140070211","CORDOBA",302,21,222,38,11,271,0.0695364238410596
"140140808","CORDOBA",198,3,164,13,12,189,0.0151515151515152
"140140113","CORDOBA",349,10,286,22,1,309,0.0286532951289398
"140070210","CORDOBA",157,120,32,5,0,37,0.764331210191083
"140141105","CORDOBA",278,14,186,68,2,256,0.0503597122302158
"140070209","CORDOBA",206,47,127,31,1,159,0.228155339805825
"140070208","CORDOBA",293,88,183,20,0,203,0.300341296928328
"140143609","CORDOBA",227,211,11,4,0,15,0.929515418502203
"140910506","CORDOBA",202,105,85,6,0,91,0.51980198019802
"140141104","CORDOBA",200,192,5,2,0,7,0.96
"820632110","SANTA FE",101,101,0,0,0,0,1
"140141102","CORDOBA",243,6,214,15,2,231,0.0246913580246914
"140141406","CORDOBA",369,5,298,57,2,357,0.013550135501355
"140070207","CORDOBA",273,144,105,19,3,127,0.527472527472527
"140070206","CORDOBA",321,65,192,49,11,252,0.202492211838006
"140070205","CORDOBA",157,1,136,12,6,154,0.00636942675159236
"140140112","CORDOBA",315,25,248,41,0,289,0.0793650793650794
"140070111","CORDOBA",190,1,142,23,23,188,0.00526315789473684
"140141108","CORDOBA",275,242,14,10,0,24,0.88
"820700111","SANTA FE",478,9,345,108,2,455,0.0188284518828452
"140910503","CORDOBA",244,52,132,56,1,189,0.213114754098361
"140910420","CORDOBA",294,7,201,76,3,280,0.0238095238095238
"140910417","CORDOBA",327,271,37,17,2,56,0.828746177370031
"140910416","CORDOBA",178,88,71,19,0,90,0.49438202247191
"140910415","CORDOBA",247,16,136,68,18,222,0.0647773279352227
"140910414","CORDOBA",230,216,12,2,0,14,0.939130434782609
"140910411","CORDOBA",319,243,60,12,1,73,0.761755485893417
"140141209","CORDOBA",321,22,283,15,1,299,0.0685358255451713
"140910409","CORDOBA",345,294,40,10,0,50,0.852173913043478
"140144704","CORDOBA",158,153,5,0,0,5,0.968354430379747
"140910308","CORDOBA",224,10,166,29,9,204,0.0446428571428571
"140910305","CORDOBA",224,93,120,11,0,131,0.415178571428571
"140910303","CORDOBA",218,36,139,31,9,179,0.165137614678899
"140910116","CORDOBA",215,179,29,7,0,36,0.832558139534884
"140910106","CORDOBA",224,159,53,12,0,65,0.709821428571429
"140145517","CORDOBA",342,342,0,0,0,0,1
"140840516","CORDOBA",312,289,18,5,0,23,0.926282051282051
"140840511","CORDOBA",286,261,16,8,0,24,0.912587412587413
"140840510","CORDOBA",217,196,16,3,0,19,0.903225806451613
"140840509","CORDOBA",256,217,28,11,0,39,0.84765625
"140141017","CORDOBA",225,14,190,11,10,211,0.0622222222222222
"140141015","CORDOBA",221,219,1,1,0,2,0.990950226244344
"140911707","CORDOBA",159,3,114,32,9,155,0.0188679245283019
"140911706","CORDOBA",236,2,196,30,2,228,0.00847457627118644
"140140912","CORDOBA",481,4,348,110,8,466,0.00831600831600832
"140140911","CORDOBA",415,14,373,25,0,398,0.0337349397590361
"140490321","CORDOBA",215,0,180,33,0,213,0
"140140907","CORDOBA",140,6,94,36,1,131,0.0428571428571429
"140141014","CORDOBA",193,2,183,7,1,191,0.0103626943005181
"140146008","CORDOBA",190,178,2,1,0,3,0.936842105263158
"140141002","CORDOBA",449,21,403,20,0,423,0.0467706013363029
"140140914","CORDOBA",268,138,106,20,1,127,0.514925373134328
"140141207","CORDOBA",283,26,198,55,2,255,0.0918727915194346
"140140913","CORDOBA",316,1,267,44,2,313,0.00316455696202532
"140140906","CORDOBA",256,11,182,56,2,240,0.04296875
"140140904","CORDOBA",265,13,193,55,1,249,0.0490566037735849
"140141405","CORDOBA",254,2,221,28,0,249,0.0078740157480315
"140141206","CORDOBA",274,0,226,38,1,265,0
"140141205","CORDOBA",415,21,362,23,5,390,0.0506024096385542
"140140506","CORDOBA",221,3,177,33,2,212,0.0135746606334842
"140140903","CORDOBA",291,1,82,168,12,262,0.00343642611683849
"140140807","CORDOBA",291,16,262,11,1,274,0.0549828178694158
"140140805","CORDOBA",452,32,286,121,9,416,0.0707964601769911
"140140804","CORDOBA",303,6,94,172,2,268,0.0198019801980198
"140140802","CORDOBA",206,202,4,0,0,4,0.980582524271845
"140141013","CORDOBA",300,7,245,37,5,287,0.0233333333333333
"140140704","CORDOBA",260,118,91,43,0,134,0.453846153846154
"140140702","CORDOBA",245,23,217,5,0,222,0.0938775510204082
"140140608","CORDOBA",156,4,107,38,4,149,0.0256410256410256
"140911506","CORDOBA",209,110,80,19,0,99,0.526315789473684
"140141012","CORDOBA",229,22,189,17,0,206,0.0960698689956332
"140140707","CORDOBA",204,1,149,36,0,185,0.00490196078431373
"140630910","CORDOBA",191,0,155,31,0,186,0
"140911503","CORDOBA",201,37,125,33,6,164,0.18407960199005
"140141404","CORDOBA",205,4,138,49,7,194,0.0195121951219512
"140140515","CORDOBA",385,381,2,0,0,2,0.98961038961039
"140140514","CORDOBA",340,7,255,65,1,321,0.0205882352941176
"140140513","CORDOBA",350,3,302,30,0,332,0.00857142857142857
"140140512","CORDOBA",319,10,239,63,4,306,0.0313479623824451
"140140511","CORDOBA",311,3,290,12,2,304,0.00964630225080386
"140140510","CORDOBA",396,5,360,27,0,387,0.0126262626262626
"140140509","CORDOBA",260,3,209,45,3,257,0.0115384615384615
"140140508","CORDOBA",384,9,252,118,1,371,0.0234375
"820844015","SANTA FE",224,222,2,0,0,2,0.991071428571429
"140140505","CORDOBA",442,101,271,57,6,334,0.228506787330317
"140911414","CORDOBA",250,4,220,26,0,246,0.016
"140911411","CORDOBA",191,0,151,37,0,188,0
"140140410","CORDOBA",385,7,287,68,7,362,0.0181818181818182
"140140409","CORDOBA",293,5,247,39,0,286,0.0170648464163823
"140140408","CORDOBA",437,14,369,52,2,423,0.0320366132723112
"140140407","CORDOBA",299,8,273,17,0,290,0.0267558528428094
"140140312","CORDOBA",365,310,44,10,0,54,0.849315068493151
"140140311","CORDOBA",273,164,103,5,0,108,0.600732600732601
"140140310","CORDOBA",270,196,67,7,0,74,0.725925925925926
"140140406","CORDOBA",428,92,229,97,0,326,0.214953271028037
"140140708","CORDOBA",300,103,118,73,1,192,0.343333333333333
"140140405","CORDOBA",473,353,100,12,0,112,0.74630021141649
"140140402","CORDOBA",295,4,249,32,1,282,0.0135593220338983
"140140401","CORDOBA",394,3,320,62,2,384,0.00761421319796954
"140141305","CORDOBA",213,34,156,14,0,170,0.15962441314554
"140140308","CORDOBA",333,3,235,87,7,329,0.00900900900900901
"140140307","CORDOBA",230,4,160,60,2,222,0.0173913043478261
"140140306","CORDOBA",237,13,151,66,1,218,0.0548523206751055
"140140305","CORDOBA",310,13,230,56,0,286,0.0419354838709677
"140140304","CORDOBA",358,6,204,133,0,337,0.0167597765363128
"140143610","CORDOBA",202,132,66,4,0,70,0.653465346534653
"140141011","CORDOBA",432,9,360,55,1,416,0.0208333333333333
"140140303","CORDOBA",421,4,296,77,8,381,0.00950118764845606
"140140302","CORDOBA",547,6,345,177,4,526,0.0109689213893967
"140140215","CORDOBA",381,50,300,27,0,327,0.131233595800525
"140140214","CORDOBA",368,21,249,96,1,346,0.0570652173913043
"140490318","CORDOBA",229,6,207,16,0,223,0.0262008733624454
"140140213","CORDOBA",360,339,18,3,0,21,0.941666666666667
"140140212","CORDOBA",239,229,10,0,0,10,0.9581589958159
"140140107","CORDOBA",248,11,227,10,0,237,0.0443548387096774
"140140105","CORDOBA",302,27,262,13,0,275,0.0894039735099338
"140140104","CORDOBA",212,5,148,34,1,183,0.0235849056603774
"140140103","CORDOBA",362,24,280,54,2,336,0.0662983425414365
"140630707","CORDOBA",263,3,192,62,2,256,0.0114068441064639
"140630614","CORDOBA",142,0,89,44,5,138,0
"140560618","CORDOBA",189,6,141,36,5,182,0.0317460317460317
"140140102","CORDOBA",313,24,213,71,2,286,0.0766773162939297
"140911322","CORDOBA",84,0,72,12,0,84,0
"140911321","CORDOBA",89,1,74,13,1,88,0.0112359550561798
"140911320","CORDOBA",104,2,87,9,6,102,0.0192307692307692
"140911319","CORDOBA",107,0,84,16,5,105,0
"140840313","CORDOBA",212,1,153,52,1,206,0.00471698113207547
"140145516","CORDOBA",202,202,0,0,0,0,1
"140840210","CORDOBA",281,0,262,15,0,277,0
"140840209","CORDOBA",123,3,86,32,0,118,0.024390243902439
"140840107","CORDOBA",264,0,214,50,0,264,0
"140145515","CORDOBA",91,91,0,0,0,0,1
"140145514","CORDOBA",151,151,0,0,0,0,1
"140145513","CORDOBA",128,128,0,0,0,0,1
"140700213","CORDOBA",280,0,264,14,1,279,0
"140631110","CORDOBA",355,322,22,11,0,33,0.907042253521127
"140631103","CORDOBA",214,191,10,9,2,21,0.892523364485981
"140490320","CORDOBA",300,4,276,19,1,296,0.0133333333333333
"140490319","CORDOBA",358,3,332,21,2,355,0.00837988826815642
"140630412","CORDOBA",167,3,116,48,0,164,0.0179640718562874
"140630411","CORDOBA",193,2,154,37,0,191,0.0103626943005181
"140630410","CORDOBA",196,11,144,41,0,185,0.0561224489795918
"140630409","CORDOBA",191,1,116,60,0,176,0.00523560209424084
"140630408","CORDOBA",266,1,215,48,0,263,0.0037593984962406
"140630311","CORDOBA",283,200,48,24,3,75,0.706713780918728
"140630310","CORDOBA",222,183,22,16,0,38,0.824324324324324
"140630213","CORDOBA",268,92,128,41,2,171,0.343283582089552
"820280406","SANTA FE",248,248,0,0,0,0,1
"140630212","CORDOBA",335,188,98,46,1,145,0.561194029850746
"140490115","CORDOBA",182,1,149,22,0,171,0.00549450549450549
"140490114","CORDOBA",231,1,199,20,2,221,0.00432900432900433
"140490113","CORDOBA",315,14,213,69,5,287,0.0444444444444444
"140420915","CORDOBA",253,252,0,1,0,1,0.99604743083004
"140420821","CORDOBA",184,183,1,0,0,1,0.994565217391304
"140420705","CORDOBA",374,367,4,2,0,6,0.981283422459893
"140420309","CORDOBA",277,3,247,25,1,273,0.0108303249097473
"140420210","CORDOBA",225,1,176,29,10,215,0.00444444444444444
"140350510","CORDOBA",221,4,121,68,8,197,0.0180995475113122
"140350404","CORDOBA",218,25,98,85,5,188,0.114678899082569
"140350215","CORDOBA",320,1,273,32,5,310,0.003125
"140350210","CORDOBA",206,1,78,66,27,171,0.00485436893203883
"140350110","CORDOBA",224,0,185,31,2,218,0
"140350109","CORDOBA",299,0,257,38,1,296,0
"140211212","CORDOBA",187,1,140,25,9,174,0.0053475935828877
"140350108","CORDOBA",365,1,196,124,14,334,0.00273972602739726
"140280509","CORDOBA",223,5,209,8,0,217,0.0224215246636771
"140280505","CORDOBA",249,4,185,38,6,229,0.0160642570281124
"140280410","CORDOBA",223,0,142,52,5,199,0
"140280406","CORDOBA",197,1,137,39,17,193,0.0050761421319797
"140280307","CORDOBA",255,220,24,9,1,34,0.862745098039216
"140280305","CORDOBA",343,1,279,58,0,337,0.00291545189504373
"140280214","CORDOBA",314,244,43,26,0,69,0.777070063694268
"140280202","CORDOBA",267,18,188,41,3,232,0.0674157303370786
"140211816","CORDOBA",319,51,244,18,2,264,0.15987460815047
"140211812","CORDOBA",385,2,350,25,7,382,0.00519480519480519
"140211203","CORDOBA",274,0,247,23,3,273,0
"820700414","SANTA FE",318,242,35,37,1,73,0.761006289308176
"140211810","CORDOBA",305,2,277,17,1,295,0.00655737704918033
"140211809","CORDOBA",282,0,199,47,9,255,0
"140143314","CORDOBA",237,190,42,5,0,47,0.80168776371308
"140211807","CORDOBA",245,4,211,20,3,234,0.0163265306122449
"140211804","CORDOBA",292,5,267,18,1,286,0.0171232876712329
"140211803","CORDOBA",195,3,175,13,3,191,0.0153846153846154
"140211707","CORDOBA",299,8,278,8,4,290,0.0267558528428094
"140212113","CORDOBA",274,4,207,51,4,262,0.0145985401459854
"140210708","CORDOBA",277,1,211,51,4,266,0.0036101083032491
"140210707","CORDOBA",289,3,225,56,1,282,0.0103806228373702
"140211608","CORDOBA",245,1,228,12,2,242,0.00408163265306122
"140148801","CORDOBA",242,18,193,30,1,224,0.0743801652892562
"140211604","CORDOBA",249,0,207,32,2,241,0
"140211505","CORDOBA",212,6,187,17,1,205,0.0283018867924528
"140211501","CORDOBA",212,2,185,12,10,207,0.00943396226415094
"140211412","CORDOBA",224,1,202,16,1,219,0.00446428571428571
"140211213","CORDOBA",198,0,167,21,4,192,0
"140212004","CORDOBA",240,139,66,17,5,88,0.579166666666667
"140211201","CORDOBA",188,0,164,19,3,186,0
"140211119","CORDOBA",300,11,273,13,0,286,0.0366666666666667
"140211118","CORDOBA",351,20,295,35,1,331,0.056980056980057
"140211117","CORDOBA",266,11,229,26,0,255,0.0413533834586466
"140211015","CORDOBA",126,110,14,1,0,15,0.873015873015873
"140210316","CORDOBA",214,10,160,28,2,190,0.0467289719626168
"140210209","CORDOBA",201,3,167,17,10,194,0.0149253731343284
"140210207","CORDOBA",152,2,145,0,3,148,0.0131578947368421
"140212115","CORDOBA",192,1,172,17,0,189,0.00520833333333333
"140145111","CORDOBA",250,219,26,5,0,31,0.876
"140212110","CORDOBA",311,9,213,79,7,299,0.0289389067524116
"140212109","CORDOBA",209,3,178,25,0,203,0.0143540669856459
"140212103","CORDOBA",184,1,131,29,14,174,0.00543478260869565
"140212102","CORDOBA",189,2,132,41,5,178,0.0105820105820106
"140212016","CORDOBA",190,3,169,16,1,186,0.0157894736842105
"140212015","CORDOBA",309,7,280,21,1,302,0.0226537216828479
"140148610","CORDOBA",387,9,199,164,1,364,0.0232558139534884
"140212002","CORDOBA",176,1,141,20,2,163,0.00568181818181818
"140211908","CORDOBA",158,0,143,9,0,152,0
"140210107","CORDOBA",156,0,136,14,6,156,0
"140210106","CORDOBA",177,1,165,5,0,170,0.00564971751412429
"140149904","CORDOBA",235,3,210,19,3,232,0.0127659574468085
"140149804","CORDOBA",245,11,206,22,2,230,0.0448979591836735
"140149321","CORDOBA",288,224,58,5,0,63,0.777777777777778
"140149308","CORDOBA",412,269,105,34,1,140,0.652912621359223
"140149211","CORDOBA",295,7,271,16,1,288,0.023728813559322
"140148912","CORDOBA",248,14,193,25,5,223,0.0564516129032258
"140148802","CORDOBA",301,29,257,15,0,272,0.0963455149501661
"140145205","CORDOBA",161,153,6,2,0,8,0.950310559006211
"140145113","CORDOBA",308,265,32,8,0,40,0.86038961038961
"140145112","CORDOBA",340,302,31,5,0,36,0.888235294117647
"140147918","CORDOBA",256,137,112,7,0,119,0.53515625
"140147917","CORDOBA",283,260,19,2,1,22,0.918727915194346
"140147720","CORDOBA",340,10,310,16,2,328,0.0294117647058824
"140147711","CORDOBA",223,212,9,2,0,11,0.95067264573991
"140147512","CORDOBA",301,8,253,34,0,287,0.026578073089701
"140147418","CORDOBA",264,248,11,5,0,16,0.939393939393939
"140147408","CORDOBA",302,225,66,11,0,77,0.745033112582781
"140147407","CORDOBA",286,238,38,9,0,47,0.832167832167832
"140147406","CORDOBA",361,241,83,27,2,112,0.667590027700831
"140147203","CORDOBA",662,661,1,0,0,1,0.998489425981873
"140147202","CORDOBA",717,712,2,0,0,2,0.99302649930265
"140147201","CORDOBA",626,623,0,1,0,1,0.995207667731629
"140147111","CORDOBA",267,266,1,0,0,1,0.99625468164794
"140147110","CORDOBA",409,409,0,0,0,0,1
"140146706","CORDOBA",308,307,0,0,0,0,0.996753246753247
"140146601","CORDOBA",352,351,1,0,0,1,0.997159090909091
"140146504","CORDOBA",162,152,8,2,0,10,0.938271604938272
"140146306","CORDOBA",313,301,11,0,0,11,0.961661341853035
"140146113","CORDOBA",373,17,252,87,7,346,0.0455764075067024
"140146102","CORDOBA",280,4,229,35,3,267,0.0142857142857143
"140142907","CORDOBA",232,214,11,7,0,18,0.922413793103448
"140142614","CORDOBA",259,233,25,1,0,26,0.8996138996139
"140142409","CORDOBA",314,13,284,16,0,300,0.0414012738853503
"140142315","CORDOBA",271,4,250,16,1,267,0.014760147601476
"140142215","CORDOBA",322,226,92,4,0,96,0.701863354037267
"140140910","CORDOBA",346,7,287,47,1,335,0.0202312138728324
"140142207","CORDOBA",204,192,11,0,0,11,0.941176470588235
"140141618","CORDOBA",403,360,14,17,0,31,0.893300248138958
"140141612","CORDOBA",267,18,72,135,1,208,0.0674157303370786
"140141609","CORDOBA",261,134,104,23,0,127,0.513409961685824
"140143513","CORDOBA",268,9,197,58,0,255,0.0335820895522388
"140143508","CORDOBA",278,11,249,17,0,266,0.039568345323741
"140141517","CORDOBA",323,27,151,119,14,284,0.0835913312693498
"140141504","CORDOBA",292,289,2,0,0,2,0.98972602739726
"140144311","CORDOBA",280,176,95,9,0,104,0.628571428571429
"140144310","CORDOBA",226,211,11,4,0,15,0.933628318584071
"140144304","CORDOBA",353,60,187,88,3,278,0.169971671388102
"140144219","CORDOBA",321,315,4,2,0,6,0.981308411214953
"140210601","CORDOBA",66,0,55,6,4,65,0
"140070902","CORDOBA",25,1,3,5,9,17,0.04
"820631504","SANTA FE",239,235,3,1,0,4,0.98326359832636
"140144218","CORDOBA",282,9,229,26,3,258,0.0319148936170213
"140144110","CORDOBA",291,274,15,2,0,17,0.941580756013746
"140144009","CORDOBA",237,224,7,6,0,13,0.945147679324895
"140143911","CORDOBA",243,242,0,0,0,0,0.995884773662551
"140143702","CORDOBA",193,164,20,7,1,28,0.849740932642487
"140141308","CORDOBA",312,289,14,1,0,15,0.926282051282051
"140141101","CORDOBA",110,1,81,25,0,106,0.00909090909090909
"140141016","CORDOBA",271,238,24,7,1,32,0.878228782287823
"140141006","CORDOBA",373,26,321,26,0,347,0.0697050938337802
"140141005","CORDOBA",205,4,188,10,2,200,0.0195121951219512
"140141004","CORDOBA",259,5,241,13,0,254,0.0193050193050193
"140141003","CORDOBA",220,4,193,21,2,216,0.0181818181818182
"820632708","SANTA FE",258,256,1,0,0,1,0.992248062015504
"140140909","CORDOBA",389,58,259,68,2,329,0.149100257069409
"140140908","CORDOBA",387,295,85,7,0,92,0.762273901808786
"140140905","CORDOBA",401,1,338,57,1,396,0.00249376558603491
"140140902","CORDOBA",330,8,232,58,28,318,0.0242424242424242
"140140809","CORDOBA",466,4,308,137,4,449,0.00858369098712446
"140140803","CORDOBA",114,3,109,2,0,111,0.0263157894736842
"140140715","CORDOBA",240,192,29,13,0,42,0.8
"140140714","CORDOBA",287,259,11,9,1,21,0.902439024390244
"140140713","CORDOBA",251,242,3,0,0,3,0.964143426294821
"140140711","CORDOBA",171,4,116,41,4,161,0.0233918128654971
"140140709","CORDOBA",359,246,97,13,0,110,0.685236768802228
"140140703","CORDOBA",179,4,141,32,0,173,0.0223463687150838
"140140701","CORDOBA",359,6,319,28,0,347,0.0167130919220056
"140140610","CORDOBA",313,0,273,29,5,307,0
"140140609","CORDOBA",309,1,272,33,2,307,0.00323624595469256
"140140507","CORDOBA",257,4,175,66,0,241,0.0155642023346304
"140070607","CORDOBA",260,4,221,32,1,254,0.0153846153846154
"140140411","CORDOBA",417,8,327,66,2,395,0.0191846522781775
"140070908","CORDOBA",100,3,88,9,0,97,0.03
"140142202","CORDOBA",322,319,2,0,1,3,0.990683229813665
"140142104","CORDOBA",383,381,2,0,0,2,0.994778067885117
"140142016","CORDOBA",385,10,345,22,2,369,0.025974025974026
"140070312","CORDOBA",253,0,213,35,0,248,0
"140070904","CORDOBA",249,1,197,47,2,246,0.00401606425702811
"140070817","CORDOBA",340,82,232,16,0,248,0.241176470588235
"140070816","CORDOBA",210,3,179,26,2,207,0.0142857142857143
"140070815","CORDOBA",337,4,306,16,3,325,0.0118694362017804
"140070814","CORDOBA",334,1,283,32,12,327,0.0029940119760479
"140070809","CORDOBA",254,98,130,21,4,155,0.385826771653543
"140070808","CORDOBA",295,205,76,12,1,89,0.694915254237288
"140070807","CORDOBA",281,6,234,34,5,273,0.0213523131672598
"140070706","CORDOBA",288,2,241,39,4,284,0.00694444444444444
"140070613","CORDOBA",126,2,111,7,6,124,0.0158730158730159
"140070612","CORDOBA",167,1,145,14,6,165,0.00598802395209581
"820843913","SANTA FE",310,301,8,0,0,8,0.970967741935484
"140070611","CORDOBA",219,2,199,16,2,217,0.0091324200913242
"140070610","CORDOBA",137,0,115,16,5,136,0
"140070606","CORDOBA",63,1,53,9,0,62,0.0158730158730159
"140070518","CORDOBA",248,2,151,56,22,229,0.00806451612903226
"140070517","CORDOBA",284,1,253,17,0,270,0.00352112676056338
"140070515","CORDOBA",195,1,180,13,1,194,0.00512820512820513
"140070510","CORDOBA",328,1,291,34,1,326,0.00304878048780488
"140070509","CORDOBA",267,5,240,22,0,262,0.0187265917602996
"141050408","CORDOBA",27,0,19,5,1,25,0
"140070508","CORDOBA",153,0,138,10,4,152,0
"140070414","CORDOBA",280,2,180,34,50,264,0.00714285714285714
"140070311","CORDOBA",248,0,205,35,6,246,0
"140070310","CORDOBA",202,0,182,14,0,196,0
"140070309","CORDOBA",270,3,227,35,0,262,0.0111111111111111
"140070308","CORDOBA",74,1,70,2,1,73,0.0135135135135135
"140070215","CORDOBA",184,85,85,14,0,99,0.46195652173913
"141050412","CORDOBA",42,0,31,7,2,40,0
"140070214","CORDOBA",198,135,50,10,3,63,0.681818181818182
"820280407","SANTA FE",343,341,1,1,0,2,0.994169096209913
"140070112","CORDOBA",170,0,129,18,8,155,0
"140070110","CORDOBA",134,0,106,10,17,133,0
"141401207","CORDOBA",290,250,33,7,0,40,0.862068965517241
"140420515","CORDOBA",187,3,160,21,0,181,0.0160427807486631
"140147311","CORDOBA",229,226,3,0,0,3,0.986899563318777
"141611014","CORDOBA",211,211,0,0,0,0,1
"140146909","CORDOBA",170,170,0,0,0,0,1
"140146404","CORDOBA",327,292,6,2,0,8,0.892966360856269
"140146012","CORDOBA",163,156,7,0,0,7,0.957055214723926
"141611013","CORDOBA",207,206,1,0,0,1,0.995169082125604
"140145512","CORDOBA",155,155,0,0,0,0,1
"140145511","CORDOBA",217,216,1,0,0,1,0.995391705069124
"140145510","CORDOBA",158,158,0,0,0,0,1
"141820304","CORDOBA",41,0,24,12,2,38,0
"141820303","CORDOBA",69,1,39,25,3,67,0.0144927536231884
"141820302","CORDOBA",18,0,7,8,0,15,0
"141750201","CORDOBA",158,0,31,79,12,122,0
"141540104","CORDOBA",89,0,67,15,2,84,0
"141540103","CORDOBA",102,0,58,31,1,90,0
"141470301","CORDOBA",33,0,15,15,2,32,0
"141120206","CORDOBA",52,0,7,5,5,17,0
"140700204","CORDOBA",30,0,8,11,5,24,0
"140700203","CORDOBA",92,0,29,20,12,61,0
"140280705","CORDOBA",24,0,9,5,0,14,0
"140280704","CORDOBA",13,0,5,3,2,10,0
"140210602","CORDOBA",26,0,22,2,2,26,0
"141050301","CORDOBA",17,0,13,3,1,17,0
"820844524","SANTA FE",293,286,5,2,0,7,0.976109215017065
"820280203","SANTA FE",140,1,47,87,1,135,0.00714285714285714
"141050605","CORDOBA",90,1,52,20,9,81,0.0111111111111111
"141120308","CORDOBA",36,0,3,20,3,26,0
"141050411","CORDOBA",23,0,19,4,0,23,0
"820842814","SANTA FE",160,160,0,0,0,0,1
"141050602","CORDOBA",80,0,34,34,5,73,0
"141050601","CORDOBA",68,0,51,12,2,65,0
"141050409","CORDOBA",40,0,11,21,7,39,0
"820843912","SANTA FE",357,355,2,0,0,2,0.994397759103641
"141050504","CORDOBA",166,1,77,45,29,151,0.00602409638554217
"141050503","CORDOBA",248,1,81,81,50,212,0.00403225806451613
"141050502","CORDOBA",102,3,38,42,11,91,0.0294117647058824
"141050501","CORDOBA",43,0,25,15,2,42,0
"141050413","CORDOBA",31,0,21,7,2,30,0
"141050407","CORDOBA",64,0,41,13,3,57,0
"141050406","CORDOBA",52,0,38,9,3,50,0
"141050405","CORDOBA",44,0,27,11,1,39,0
"140560404","CORDOBA",12,0,10,1,0,11,0
"141050403","CORDOBA",21,0,16,3,0,19,0
"141050402","CORDOBA",50,0,33,13,1,47,0
"141050304","CORDOBA",23,0,18,2,3,23,0
"141610205","CORDOBA",19,1,12,4,1,17,0.0526315789473684
"141050307","CORDOBA",38,0,26,10,0,36,0
"141050302","CORDOBA",44,0,17,22,4,43,0
"141050205","CORDOBA",71,0,38,24,2,64,0
"141050207","CORDOBA",27,0,15,7,3,25,0
"141050107","CORDOBA",56,1,26,18,9,53,0.0178571428571429
"141050104","CORDOBA",34,0,21,6,3,30,0
"821190602","SANTA FE",269,8,115,146,0,261,0.0297397769516729
"820844003","SANTA FE",372,371,1,0,0,1,0.997311827956989
"820631503","SANTA FE",297,291,2,4,0,6,0.97979797979798
"141050204","CORDOBA",33,0,22,3,5,30,0
"141050206","CORDOBA",64,0,39,17,2,58,0
"141050102","CORDOBA",35,0,14,15,2,31,0
"141050203","CORDOBA",63,0,49,6,5,60,0
"141050105","CORDOBA",20,0,16,2,2,20,0
"141050401","CORDOBA",13,0,9,4,0,13,0
"141050202","CORDOBA",16,0,13,2,0,15,0
"820140129","SANTA FE",46,0,5,40,1,46,0
"140981408","CORDOBA",31,0,16,10,5,31,0
"140981307","CORDOBA",14,0,2,11,0,13,0
"140981306","CORDOBA",29,0,4,23,1,28,0
"140981203","CORDOBA",113,4,34,65,8,107,0.0353982300884956
"140981202","CORDOBA",87,1,50,25,5,80,0.0114942528735632
"820842602","SANTA FE",220,220,0,0,0,0,1
"140981406","CORDOBA",40,0,21,18,0,39,0
"140981107","CORDOBA",66,0,51,13,0,64,0
"140981104","CORDOBA",22,0,6,14,0,20,0
"820842516","SANTA FE",78,76,2,0,0,2,0.974358974358974
"140981103","CORDOBA",22,0,15,7,0,22,0
"140560403","CORDOBA",11,0,7,3,0,10,0
"140981102","CORDOBA",93,1,40,48,0,88,0.010752688172043
"140981305","CORDOBA",35,0,10,20,1,31,0
"820842116","SANTA FE",266,266,0,0,0,0,1
"140981201","CORDOBA",74,0,24,48,0,72,0
"140981101","CORDOBA",86,0,61,23,2,86,0
"140981007","CORDOBA",56,0,27,25,1,53,0
"141470506","CORDOBA",11,0,11,0,0,11,0
"140981003","CORDOBA",178,0,11,146,5,162,0
"140981002","CORDOBA",19,0,10,9,0,19,0
"140981001","CORDOBA",12,0,3,8,1,12,0
"140980903","CORDOBA",61,7,20,32,1,53,0.114754098360656
"140981008","CORDOBA",64,1,28,32,1,61,0.015625
"140980901","CORDOBA",46,0,26,17,3,46,0
"140911901","CORDOBA",41,0,25,3,10,38,0
"140981108","CORDOBA",38,0,15,21,1,37,0
"140980805","CORDOBA",20,0,0,18,0,18,0
"140980804","CORDOBA",72,0,22,41,5,68,0
"140560101","CORDOBA",70,0,48,11,2,61,0
"820631508","SANTA FE",257,248,3,5,0,8,0.964980544747082
"140980803","CORDOBA",68,1,29,32,2,63,0.0147058823529412
"140980802","CORDOBA",49,0,31,15,3,49,0
"820631513","SANTA FE",252,244,7,1,0,8,0.968253968253968
"140980703","CORDOBA",49,1,24,21,0,45,0.0204081632653061
"141401703","CORDOBA",38,0,11,18,0,29,0
"140980603","CORDOBA",45,0,25,18,0,43,0
"140981304","CORDOBA",42,0,11,24,1,36,0
"140980806","CORDOBA",71,0,27,43,1,71,0
"141401702","CORDOBA",66,0,39,22,2,63,0
"140980508","CORDOBA",20,0,9,10,0,19,0
"140980402","CORDOBA",49,0,35,13,0,48,0
"141401701","CORDOBA",59,0,43,9,1,53,0
"820842318","SANTA FE",234,208,1,0,0,1,0.888888888888889
"140980507","CORDOBA",39,0,26,9,2,37,0
"140980504","CORDOBA",12,0,7,5,0,12,0
"140980503","CORDOBA",23,0,4,18,1,23,0
"140980502","CORDOBA",63,0,25,29,1,55,0
"140981303","CORDOBA",41,0,4,31,2,37,0
"140980501","CORDOBA",17,0,12,5,0,17,0
"140981302","CORDOBA",48,0,10,36,0,46,0
"141470505","CORDOBA",21,0,13,7,1,21,0
"140980406","CORDOBA",46,0,32,13,0,45,0
"140980302","CORDOBA",26,0,19,6,0,25,0
"141401606","CORDOBA",77,0,36,38,1,75,0
"140980404","CORDOBA",20,0,14,5,1,20,0
"140980403","CORDOBA",24,0,6,18,0,24,0
"141401605","CORDOBA",86,0,51,29,0,80,0
"140980401","CORDOBA",22,0,19,3,0,22,0
"140980104","CORDOBA",25,0,12,10,1,23,0
"141401604","CORDOBA",11,0,3,8,0,11,0
"140980301","CORDOBA",19,0,14,4,0,18,0
"141401603","CORDOBA",51,0,9,40,1,50,0
"140980207","CORDOBA",19,0,9,9,0,18,0
"820844001","SANTA FE",345,328,3,9,0,12,0.950724637681159
"140980205","CORDOBA",37,0,31,5,0,36,0
"141401602","CORDOBA",59,0,24,31,2,57,0
"140980204","CORDOBA",45,1,32,12,0,44,0.0222222222222222
"140980202","CORDOBA",36,0,15,17,2,34,0
"141401506","CORDOBA",49,0,30,12,5,47,0
"140980107","CORDOBA",17,0,8,7,1,16,0
"140981301","CORDOBA",49,0,28,13,0,41,0
"140980106","CORDOBA",18,0,13,5,0,18,0
"141401505","CORDOBA",84,0,17,53,10,80,0
"141401003","CORDOBA",71,0,37,28,5,70,0
"140980105","CORDOBA",13,0,10,1,0,11,0
"140980103","CORDOBA",33,0,30,1,0,31,0
"140980102","CORDOBA",18,0,18,0,0,18,0
"140980101","CORDOBA",6,0,3,3,0,6,0
"821260302","SANTA FE",366,315,24,24,0,48,0.860655737704918
"140911904","CORDOBA",14,0,10,2,1,13,0
"140911903","CORDOBA",1,0,0,1,0,1,0
"140911902","CORDOBA",34,0,27,3,1,31,0
"140911805","CORDOBA",54,1,36,7,2,45,0.0185185185185185
"140981205","CORDOBA",35,0,20,14,0,34,0
"140911607","CORDOBA",5,0,4,1,0,5,0
"821260104","SANTA FE",321,0,239,72,7,318,0
"140911803","CORDOBA",11,0,8,2,1,11,0
"140911704","CORDOBA",2,0,2,0,0,2,0
"140981204","CORDOBA",134,0,79,49,3,131,0
"140981401","CORDOBA",58,0,23,28,1,52,0
"820848204","SANTA FE",371,70,120,174,0,294,0.188679245283019
"140911702","CORDOBA",2,0,0,2,0,2,0
"141401504","CORDOBA",79,0,46,27,4,77,0
"140911603","CORDOBA",3,0,1,1,1,3,0
"140981308","CORDOBA",32,0,0,31,0,31,0
"141401503","CORDOBA",67,4,21,37,0,58,0.0597014925373134
"140911602","CORDOBA",18,0,3,11,2,16,0
"141401502","CORDOBA",56,0,36,15,3,54,0
"141401501","CORDOBA",74,0,47,19,3,69,0
"140911501","CORDOBA",5,0,5,0,0,5,0
"140911305","CORDOBA",7,0,5,0,2,7,0
"140910205","CORDOBA",4,0,2,2,0,4,0
"820848011","SANTA FE",176,161,0,0,0,0,0.914772727272727
"140911405","CORDOBA",32,0,19,11,1,31,0
"140911403","CORDOBA",10,0,7,2,1,10,0
"140981403","CORDOBA",50,0,24,22,0,46,0
"140911402","CORDOBA",22,0,9,8,2,19,0
"140840305","CORDOBA",42,0,23,18,0,41,0
"140840304","CORDOBA",26,1,8,16,0,24,0.0384615384615385
"140840303","CORDOBA",27,1,5,18,0,23,0.037037037037037
"140911401","CORDOBA",14,0,1,1,1,3,0
"140840302","CORDOBA",48,0,34,14,0,48,0
"140840208","CORDOBA",38,0,23,14,0,37,0
"820842113","SANTA FE",64,64,0,0,0,0,1
"140911307","CORDOBA",6,0,6,0,0,6,0
"820140211","SANTA FE",240,237,1,2,0,3,0.9875
"140911304","CORDOBA",5,0,3,1,0,4,0
"140981402","CORDOBA",46,0,19,25,1,45,0
"140840206","CORDOBA",58,0,34,19,1,54,0
"140840205","CORDOBA",28,0,7,20,0,27,0
"140911306","CORDOBA",9,0,8,0,0,8,0
"140910803","CORDOBA",4,0,3,1,0,4,0
"140840204","CORDOBA",46,1,27,17,0,44,0.0217391304347826
"140910602","CORDOBA",103,1,57,33,3,93,0.00970873786407767
"140840203","CORDOBA",24,0,6,18,0,24,0
"140840202","CORDOBA",27,0,12,13,0,25,0
"820843905","SANTA FE",410,407,3,0,0,3,0.992682926829268
"140910501","CORDOBA",5,1,0,2,0,2,0.2
"140910302","CORDOBA",15,0,8,4,3,15,0
"820847504","SANTA FE",154,1,104,48,0,152,0.00649350649350649
"140910212","CORDOBA",4,0,1,3,0,4,0
"140910208","CORDOBA",6,0,6,0,0,6,0
"140560405","CORDOBA",38,0,16,16,2,34,0
"141401601","CORDOBA",40,0,15,21,3,39,0
"140910202","CORDOBA",39,0,15,10,0,25,0
"140840405","CORDOBA",88,0,48,40,0,88,0
"140840403","CORDOBA",14,0,14,0,0,14,0
"140840402","CORDOBA",54,0,44,4,4,52,0
"141820603","CORDOBA",28,1,13,14,0,27,0.0357142857142857
"141820602","CORDOBA",47,0,35,10,2,47,0
"141820601","CORDOBA",27,0,5,22,0,27,0
"141401005","CORDOBA",39,0,27,8,1,36,0
"141401004","CORDOBA",47,0,17,24,2,43,0
"140840401","CORDOBA",41,0,26,9,0,35,0
"140840312","CORDOBA",33,0,27,5,0,32,0
"140840311","CORDOBA",18,0,3,15,0,18,0
"140840310","CORDOBA",22,0,10,8,3,21,0
"140840309","CORDOBA",29,0,10,17,0,27,0
"140840308","CORDOBA",30,0,4,24,1,29,0
"140840306","CORDOBA",22,0,9,11,0,20,0
"141820501","CORDOBA",26,0,8,18,0,26,0
"141820407","CORDOBA",40,0,30,8,1,39,0
"141820406","CORDOBA",58,1,28,28,0,56,0.0172413793103448
"140560304","CORDOBA",59,2,27,21,2,50,0.0338983050847458
"140560201","CORDOBA",38,0,12,21,0,33,0
"141400805","CORDOBA",73,0,36,32,4,72,0
"141400803","CORDOBA",144,0,78,42,11,131,0
"820490704","SANTA FE",265,258,2,3,0,5,0.973584905660377
"820846404","SANTA FE",390,5,118,262,0,380,0.0128205128205128
"140560309","CORDOBA",42,0,28,10,0,38,0
"141820706","CORDOBA",35,0,23,11,1,35,0
"141820704","CORDOBA",26,0,14,11,0,25,0
"141820703","CORDOBA",47,0,11,32,2,45,0
"140560303","CORDOBA",64,0,46,15,0,61,0
"141400802","CORDOBA",98,1,51,40,3,94,0.0102040816326531
"141400903","CORDOBA",75,1,34,30,3,67,0.0133333333333333
"140560301","CORDOBA",6,0,3,3,0,6,0
"141820701","CORDOBA",25,0,13,12,0,25,0
"820843902","SANTA FE",213,208,4,0,0,4,0.976525821596244
"141400907","CORDOBA",38,0,23,15,0,38,0
"141400906","CORDOBA",84,0,47,32,1,80,0
"140560203","CORDOBA",9,0,6,3,0,9,0
"141820606","CORDOBA",6,0,3,3,0,6,0
"141820605","CORDOBA",41,0,24,17,0,41,0
"140560202","CORDOBA",20,0,9,11,0,20,0
"140560102","CORDOBA",67,3,45,16,1,62,0.0447761194029851
"141400905","CORDOBA",59,0,32,26,1,59,0
"820490708","SANTA FE",435,426,6,2,0,8,0.979310344827586
"140490212","CORDOBA",28,0,22,5,0,27,0
"141820507","CORDOBA",17,0,0,16,0,16,0
"141820505","CORDOBA",66,0,25,37,0,62,0
"141820504","CORDOBA",20,0,8,11,0,19,0
"141820502","CORDOBA",27,1,17,7,0,24,0.037037037037037
"140490208","CORDOBA",9,0,6,3,0,9,0
"141820404","CORDOBA",31,0,27,4,0,31,0
"141400608","CORDOBA",46,1,29,13,3,45,0.0217391304347826
"820842507","SANTA FE",263,262,0,1,0,1,0.996197718631179
"140490206","CORDOBA",26,0,15,5,0,20,0
"141820401","CORDOBA",37,0,19,17,0,36,0
"140560103","CORDOBA",56,1,30,24,1,55,0.0178571428571429
"140490205","CORDOBA",24,0,20,3,1,24,0
"141820306","CORDOBA",57,0,41,15,1,57,0
"141820301","CORDOBA",58,0,20,36,1,57,0
"140490203","CORDOBA",34,0,25,6,0,31,0
"141820204","CORDOBA",39,0,26,11,0,37,0
"141820203","CORDOBA",89,3,59,24,2,85,0.0337078651685393
"141820201","CORDOBA",64,0,31,29,2,62,0
"140630207","CORDOBA",29,0,4,25,0,29,0
"820842505","SANTA FE",244,244,0,0,0,0,1
"820420115","SANTA FE",272,0,130,139,1,270,0
"141400607","CORDOBA",44,0,26,15,3,44,0
"820845309","SANTA FE",358,195,31,128,0,159,0.544692737430168
"141400902","CORDOBA",29,0,12,15,2,29,0
"141400901","CORDOBA",64,0,30,23,0,53,0
"141400808","CORDOBA",80,0,38,34,3,75,0
"140560507","CORDOBA",58,0,18,28,6,52,0
"141400807","CORDOBA",81,0,35,39,5,79,0
"141400806","CORDOBA",38,0,28,9,0,37,0
"141400606","CORDOBA",47,0,21,15,7,43,0
"141400605","CORDOBA",68,1,53,9,1,63,0.0147058823529412
"141400604","CORDOBA",89,0,42,35,7,84,0
"141190404","CORDOBA",29,0,23,4,2,29,0
"141400603","CORDOBA",20,0,9,11,0,20,0
"141400602","CORDOBA",28,0,19,6,1,26,0
"141400601","CORDOBA",16,1,12,1,2,15,0.0625
"141400102","CORDOBA",40,0,33,5,1,39,0
"141400507","CORDOBA",10,0,2,7,0,9,0
"820845407","SANTA FE",192,48,48,73,14,135,0.25
"140560506","CORDOBA",66,0,49,13,0,62,0
"141400506","CORDOBA",51,0,22,28,0,50,0
"141400505","CORDOBA",60,0,29,29,0,58,0
"141400504","CORDOBA",43,0,27,15,0,42,0
"141400101","CORDOBA",41,0,25,8,3,36,0
"820842502","SANTA FE",230,230,0,0,0,0,1
"141400207","CORDOBA",24,0,10,7,3,20,0
"820140114","SANTA FE",374,225,82,65,1,148,0.601604278074866
"141400503","CORDOBA",35,0,31,3,0,34,0
"141400502","CORDOBA",89,0,54,32,2,88,0
"141400209","CORDOBA",48,0,32,9,1,42,0
"141400208","CORDOBA",60,0,45,10,5,60,0
"820210304","SANTA FE",103,0,48,44,9,101,0
"141400206","CORDOBA",84,0,61,19,3,83,0
"141400205","CORDOBA",30,0,15,10,5,30,0
"141400203","CORDOBA",55,0,38,10,2,50,0
"141400108","CORDOBA",47,0,22,21,2,45,0
"141400107","CORDOBA",28,0,16,7,3,26,0
"141400106","CORDOBA",17,0,9,7,1,17,0
"141400105","CORDOBA",29,0,24,2,2,28,0
"141400104","CORDOBA",39,0,32,3,2,37,0
"141400201","CORDOBA",46,2,31,5,2,38,0.0434782608695652
"141400103","CORDOBA",115,4,84,23,3,110,0.0347826086956522
"421050405","LA PAMPA",306,301,0,1,0,1,0.983660130718954
"820421007","SANTA FE",339,221,79,35,0,114,0.651917404129793
"140420506","CORDOBA",33,0,20,12,1,33,0
"140560505","CORDOBA",10,0,1,9,0,10,0
"141330406","CORDOBA",55,0,27,22,1,50,0
"141330107","CORDOBA",40,0,32,8,0,40,0
"141330103","CORDOBA",132,0,75,42,5,122,0
"141330404","CORDOBA",62,0,32,24,5,61,0
"141330402","CORDOBA",44,0,9,22,2,33,0
"141330102","CORDOBA",99,0,61,26,2,89,0
"141330401","CORDOBA",24,0,6,15,1,22,0
"141330101","CORDOBA",21,0,5,9,2,16,0
"421050306","LA PAMPA",203,203,0,0,0,0,1
"141330304","CORDOBA",147,1,64,55,4,123,0.00680272108843537
"141330403","CORDOBA",49,0,11,30,2,43,0
"141190504","CORDOBA",71,0,59,9,1,69,0
"141330302","CORDOBA",125,2,75,30,2,107,0.016
"141400210","CORDOBA",25,0,12,12,1,25,0
"141260503","CORDOBA",6,0,3,1,0,4,0
"820845308","SANTA FE",444,400,18,21,0,39,0.900900900900901
"141330203","CORDOBA",63,0,43,11,2,56,0
"141330206","CORDOBA",74,0,42,20,2,64,0
"141190503","CORDOBA",65,0,53,9,0,62,0
"141330202","CORDOBA",76,0,38,18,11,67,0
"141330205","CORDOBA",86,2,26,39,13,78,0.0232558139534884
"421050305","LA PAMPA",224,223,1,0,0,1,0.995535714285714
"141260605","CORDOBA",125,0,80,13,13,106,0
"141190502","CORDOBA",15,0,15,0,0,15,0
"820845301","SANTA FE",256,219,25,12,0,37,0.85546875
"141260603","CORDOBA",116,1,95,15,1,111,0.00862068965517241
"141260506","CORDOBA",63,1,40,18,0,58,0.0158730158730159
"141190201","CORDOBA",14,0,9,3,0,12,0
"141260601","CORDOBA",68,0,36,23,6,65,0
"141260505","CORDOBA",94,0,38,37,3,78,0
"820845312","SANTA FE",314,298,9,7,0,16,0.949044585987261
"141260502","CORDOBA",98,2,32,32,7,71,0.0204081632653061
"141260404","CORDOBA",103,0,81,7,1,89,0
"141260504","CORDOBA",106,1,49,36,5,90,0.00943396226415094
"141260405","CORDOBA",42,0,28,11,0,39,0
"141190505","CORDOBA",38,0,30,6,1,37,0
"141260306","CORDOBA",40,0,24,9,2,35,0
"141260204","CORDOBA",60,0,9,12,5,26,0
"820770312","SANTA FE",255,117,102,35,1,138,0.458823529411765
"141260305","CORDOBA",46,0,22,11,3,36,0
"141260301","CORDOBA",16,0,6,2,2,10,0
"141260205","CORDOBA",24,0,1,14,4,19,0
"141260203","CORDOBA",33,0,12,2,1,15,0
"141260202","CORDOBA",9,0,1,6,0,7,0
"141190509","CORDOBA",16,0,9,7,0,16,0
"141190508","CORDOBA",37,0,29,3,2,34,0
"820420926","SANTA FE",258,214,22,20,0,42,0.829457364341085
"141260106","CORDOBA",32,0,9,12,2,23,0
"141190507","CORDOBA",11,0,10,1,0,11,0
"141260201","CORDOBA",47,0,4,11,3,18,0
"141260108","CORDOBA",53,0,24,15,2,41,0
"141260101","CORDOBA",44,0,20,22,1,43,0
"141190510","CORDOBA",16,0,9,6,1,16,0
"141190409","CORDOBA",120,1,73,27,3,103,0.00833333333333333
"141190408","CORDOBA",55,0,33,18,0,51,0
"141190407","CORDOBA",62,2,34,19,2,55,0.032258064516129
"141190406","CORDOBA",39,0,29,8,1,38,0
"141190405","CORDOBA",20,0,6,12,1,19,0
"141190403","CORDOBA",18,0,16,0,0,16,0
"141190402","CORDOBA",30,0,28,2,0,30,0
"141190401","CORDOBA",13,0,4,8,1,13,0
"141190304","CORDOBA",40,3,21,16,0,37,0.075
"141190105","CORDOBA",26,1,7,18,0,25,0.0384615384615385
"820844505","SANTA FE",209,190,7,12,0,19,0.909090909090909
"140560501","CORDOBA",26,0,19,6,1,26,0
"141190303","CORDOBA",71,0,46,21,1,68,0
"141190302","CORDOBA",89,0,69,11,2,82,0
"141190104","CORDOBA",17,2,15,0,0,15,0.117647058823529
"820700704","SANTA FE",239,162,43,34,0,77,0.677824267782427
"141190305","CORDOBA",32,6,16,10,0,26,0.1875
"141190211","CORDOBA",27,1,20,5,0,25,0.037037037037037
"141190210","CORDOBA",15,0,13,1,0,14,0
"140420207","CORDOBA",44,1,22,20,0,42,0.0227272727272727
"141190209","CORDOBA",23,0,15,7,0,22,0
"141190208","CORDOBA",4,0,2,2,0,4,0
"141190207","CORDOBA",4,0,3,1,0,4,0
"141190205","CORDOBA",55,0,38,9,3,50,0
"141190103","CORDOBA",52,0,33,18,0,51,0
"141190204","CORDOBA",16,0,8,7,1,16,0
"141190203","CORDOBA",14,0,11,2,0,13,0
"141190202","CORDOBA",21,1,15,4,1,20,0.0476190476190476
"820631301","SANTA FE",272,5,113,153,0,266,0.0183823529411765
"141190101","CORDOBA",272,0,169,59,11,239,0
"141120305","CORDOBA",72,0,19,34,3,56,0
"141190102","CORDOBA",73,0,52,16,2,70,0
"141120307","CORDOBA",68,0,20,18,14,52,0
"820844523","SANTA FE",360,340,15,4,0,19,0.944444444444444
"141120303","CORDOBA",39,0,6,17,6,29,0
"141120107","CORDOBA",24,0,6,4,13,23,0
"140490101","CORDOBA",40,0,29,7,0,36,0
"820844520","SANTA FE",276,144,18,104,7,129,0.521739130434783
"141120105","CORDOBA",44,0,29,11,2,42,0
"141120205","CORDOBA",20,0,0,7,1,8,0
"141750207","CORDOBA",35,0,20,8,1,29,0
"141120103","CORDOBA",46,0,20,16,2,38,0
"141120204","CORDOBA",19,0,9,5,1,15,0
"140421007","CORDOBA",27,0,19,7,1,27,0
"820844518","SANTA FE",371,334,15,21,0,36,0.900269541778976
"141120102","CORDOBA",40,0,19,11,5,35,0
"141820109","CORDOBA",46,0,27,19,0,46,0
"141820108","CORDOBA",79,1,42,35,1,78,0.0126582278481013
"141820107","CORDOBA",70,0,36,32,1,69,0
"140421006","CORDOBA",26,1,16,8,0,24,0.0384615384615385
"140350506","CORDOBA",36,0,21,12,3,36,0
"820490706","SANTA FE",430,430,0,0,0,0,1
"140490108","CORDOBA",59,0,38,13,1,52,0
"140421005","CORDOBA",39,0,16,19,1,36,0
"140421004","CORDOBA",27,0,6,18,3,27,0
"140490107","CORDOBA",25,0,11,10,1,22,0
"141820103","CORDOBA",45,0,24,18,2,44,0
"140421003","CORDOBA",3,0,3,0,0,3,0
"140421002","CORDOBA",46,0,20,24,1,45,0
"140421001","CORDOBA",52,0,8,37,1,46,0
"141750107","CORDOBA",76,0,20,30,8,58,0
"141750105","CORDOBA",55,0,24,17,1,42,0
"141750104","CORDOBA",29,0,20,2,2,24,0
"820490301","SANTA FE",344,1,150,165,2,317,0.00290697674418605
"140490106","CORDOBA",23,0,0,13,0,13,0
"141750219","CORDOBA",1,0,0,0,0,0,0
"140420507","CORDOBA",40,1,35,4,0,39,0.025
"141680304","CORDOBA",37,1,19,12,1,32,0.027027027027027
"141680303","CORDOBA",94,0,43,37,2,82,0
"141680302","CORDOBA",61,0,34,19,1,54,0
"141400501","CORDOBA",70,0,48,21,0,69,0
"820631807","SANTA FE",474,468,0,0,0,0,0.987341772151899
"140490103","CORDOBA",62,0,35,18,4,57,0
"140490102","CORDOBA",46,0,14,25,2,41,0
"141750102","CORDOBA",27,0,6,13,1,20,0
"141680310","CORDOBA",53,0,29,13,6,48,0
"140420509","CORDOBA",55,3,25,26,1,52,0.0545454545454545
"140420508","CORDOBA",80,0,38,33,2,73,0
"820844509","SANTA FE",353,342,6,5,0,11,0.968838526912181
"140420505","CORDOBA",30,0,14,14,2,30,0
"140420504","CORDOBA",43,0,17,23,2,42,0
"140420502","CORDOBA",24,0,8,16,0,24,0
"140350402","CORDOBA",58,1,17,34,4,55,0.0172413793103448
"140420501","CORDOBA",26,0,17,8,1,26,0
"140420304","CORDOBA",53,0,21,30,1,52,0
"140420302","CORDOBA",80,0,57,19,1,77,0
"141610108","CORDOBA",31,0,29,2,0,31,0
"140350102","CORDOBA",14,0,7,6,0,13,0
"140350101","CORDOBA",19,0,6,12,0,18,0
"140420307","CORDOBA",165,29,67,67,0,134,0.175757575757576
"140420303","CORDOBA",58,0,20,36,0,56,0
"141680104","CORDOBA",15,0,9,4,1,14,0
"141680101","CORDOBA",46,0,16,19,4,39,0
"140420301","CORDOBA",97,0,47,39,3,89,0
"140350401","CORDOBA",28,0,16,11,1,28,0
"140420204","CORDOBA",31,0,15,13,1,29,0
"140420306","CORDOBA",10,0,1,9,0,10,0
"140350505","CORDOBA",38,0,20,14,1,35,0
"820844703","SANTA FE",288,46,25,201,9,235,0.159722222222222
"140420203","CORDOBA",48,0,22,23,2,47,0
"140420202","CORDOBA",64,2,45,16,1,62,0.03125
"140420201","CORDOBA",35,0,9,26,0,35,0
"140420108","CORDOBA",85,0,44,27,7,78,0
"140420105","CORDOBA",96,1,43,44,6,93,0.0104166666666667
"140420104","CORDOBA",36,1,29,6,0,35,0.0277777777777778
"141610408","CORDOBA",18,0,9,9,0,18,0
"140350303","CORDOBA",84,2,59,16,1,76,0.0238095238095238
"140420103","CORDOBA",59,0,39,19,0,58,0
"140420107","CORDOBA",64,1,46,13,1,60,0.015625
"140350507","CORDOBA",17,0,16,0,0,16,0
"140350305","CORDOBA",79,0,40,35,2,77,0
"140350209","CORDOBA",22,0,18,1,0,19,0
"140350208","CORDOBA",35,0,19,11,2,32,0
"140350207","CORDOBA",23,0,10,13,0,23,0
"140350205","CORDOBA",20,0,18,0,0,18,0
"140350304","CORDOBA",74,0,47,27,0,74,0
"140350203","CORDOBA",21,0,14,3,3,20,0
"140350403","CORDOBA",73,0,41,29,3,73,0
"140350301","CORDOBA",38,0,18,16,2,36,0
"141610301","CORDOBA",92,2,74,14,1,89,0.0217391304347826
"140350202","CORDOBA",34,0,10,21,2,33,0
"140350302","CORDOBA",18,0,15,3,0,18,0
"140350201","CORDOBA",28,0,17,10,0,27,0
"140350104","CORDOBA",31,0,8,18,1,27,0
"140280605","CORDOBA",19,0,11,3,1,15,0
"140350204","CORDOBA",18,1,5,10,0,15,0.0555555555555556
"141610201","CORDOBA",50,0,37,13,0,50,0
"140350105","CORDOBA",24,0,20,0,1,21,0
"820844701","SANTA FE",295,180,17,84,1,102,0.610169491525424
"140280603","CORDOBA",145,0,109,11,8,128,0
"141610103","CORDOBA",48,0,30,14,1,45,0
"141610102","CORDOBA",35,0,18,15,2,35,0
"140350103","CORDOBA",50,0,20,25,2,47,0
"141330407","CORDOBA",72,0,40,27,1,68,0
"140210801","CORDOBA",43,0,32,9,0,41,0
"140280601","CORDOBA",21,0,13,6,0,19,0
"140210703","CORDOBA",89,2,43,35,3,81,0.0224719101123595
"140210702","CORDOBA",178,15,121,32,3,156,0.0842696629213483
"820841909","SANTA FE",354,352,2,0,0,2,0.994350282485876
"140280405","CORDOBA",78,0,34,15,8,57,0
"141540205","CORDOBA",28,0,19,9,0,28,0
"141540204","CORDOBA",55,0,42,11,0,53,0
"140350502","CORDOBA",46,0,30,9,1,40,0
"140210701","CORDOBA",62,0,36,23,1,60,0
"141330306","CORDOBA",92,4,44,28,0,72,0.0434782608695652
"820631201","SANTA FE",356,19,96,236,2,334,0.0533707865168539
"140280404","CORDOBA",119,0,48,39,3,90,0
"141330104","CORDOBA",120,1,57,48,1,106,0.00833333333333333
"141610410","CORDOBA",55,0,32,18,3,53,0
"140280403","CORDOBA",110,2,24,30,17,71,0.0181818181818182
"140350501","CORDOBA",13,0,4,9,0,13,0
"140280402","CORDOBA",101,0,24,38,4,66,0
"140280401","CORDOBA",24,0,2,4,0,6,0
"820490608","SANTA FE",578,61,154,298,16,468,0.105536332179931
"140280108","CORDOBA",103,1,34,25,2,61,0.00970873786407767
"141470707","CORDOBA",30,0,12,9,2,23,0
"141470706","CORDOBA",28,1,16,2,4,22,0.0357142857142857
"141470704","CORDOBA",47,1,27,4,11,42,0.0212765957446809
"141470703","CORDOBA",17,1,5,0,4,9,0.0588235294117647
"141470702","CORDOBA",12,0,7,3,2,12,0
"141470701","CORDOBA",27,0,21,0,5,26,0
"820848013","SANTA FE",315,311,3,0,0,3,0.987301587301587
"140280106","CORDOBA",71,0,30,26,2,58,0
"140280105","CORDOBA",166,0,64,43,7,114,0
"141470602","CORDOBA",72,0,59,9,1,69,0
"141470501","CORDOBA",30,0,19,10,0,29,0
"141470403","CORDOBA",62,0,33,15,3,51,0
"141470402","CORDOBA",39,2,28,6,0,34,0.0512820512820513
"141400609","CORDOBA",26,0,2,22,0,24,0
"141330303","CORDOBA",66,0,21,22,1,44,0
"141330301","CORDOBA",79,0,43,24,3,70,0
"140210605","CORDOBA",90,1,77,12,0,89,0.0111111111111111
"820631409","SANTA FE",359,356,3,0,0,3,0.991643454038997
"140210606","CORDOBA",18,0,14,3,0,17,0
"140210505","CORDOBA",55,0,39,10,3,52,0
"820844610","SANTA FE",314,277,14,20,0,34,0.882165605095541
"140210604","CORDOBA",49,1,34,10,2,46,0.0204081632653061
"140210312","CORDOBA",116,0,89,26,1,116,0
"140210311","CORDOBA",125,1,108,6,6,120,0.008
"140210310","CORDOBA",108,0,72,25,3,100,0
"140210309","CORDOBA",174,2,142,20,6,168,0.0114942528735632
"820844415","SANTA FE",263,249,12,2,0,14,0.946768060836502
"140210603","CORDOBA",24,0,21,3,0,24,0
"141330109","CORDOBA",90,0,59,21,4,84,0
"141330106","CORDOBA",23,0,16,2,1,19,0
"141330105","CORDOBA",268,1,168,72,7,247,0.00373134328358209
"140210501","CORDOBA",45,0,30,10,2,42,0
"140210307","CORDOBA",44,6,26,8,0,34,0.136363636363636
"141260606","CORDOBA",7,0,0,1,1,2,0
"140210405","CORDOBA",86,0,53,20,10,83,0
"140210305","CORDOBA",126,1,108,16,1,125,0.00793650793650794
"141260602","CORDOBA",27,0,12,5,1,18,0
"140141408","CORDOBA",50,2,33,13,1,47,0.04
"140911802","CORDOBA",5,0,4,1,0,5,0
"140911801","CORDOBA",7,0,2,4,1,7,0
"140911705","CORDOBA",4,0,1,1,0,2,0
"140210301","CORDOBA",48,2,33,11,2,46,0.0416666666666667
"141260501","CORDOBA",17,0,7,4,0,11,0
"141260403","CORDOBA",34,0,17,7,2,26,0
"141260402","CORDOBA",35,0,12,4,2,18,0
"141260401","CORDOBA",96,1,70,7,6,83,0.0104166666666667
"140210404","CORDOBA",97,2,71,22,1,94,0.0206185567010309
"820630403","SANTA FE",135,134,1,0,0,1,0.992592592592593
"140140915","CORDOBA",13,1,1,3,2,6,0.0769230769230769
"140911701","CORDOBA",2,0,0,0,2,2,0
"140140901","CORDOBA",11,0,3,1,4,8,0
"140140801","CORDOBA",3,1,1,1,0,2,0.333333333333333
"141610404","CORDOBA",34,0,25,8,0,33,0
"820846218","SANTA FE",499,38,108,343,0,451,0.0761523046092184
"140140712","CORDOBA",130,0,77,36,6,119,0
"140911606","CORDOBA",25,0,16,5,2,23,0
"140911605","CORDOBA",62,0,21,32,3,56,0
"140911604","CORDOBA",8,0,2,4,0,6,0
"140140603","CORDOBA",66,0,47,17,0,64,0
"140140706","CORDOBA",15,0,4,6,1,11,0
"141470404","CORDOBA",12,0,9,2,1,12,0
"140140710","CORDOBA",59,0,38,15,3,56,0
"140911601","CORDOBA",7,0,3,1,1,5,0
"140140605","CORDOBA",252,3,166,49,6,221,0.0119047619047619
"140070303","CORDOBA",5,0,3,1,0,4,0
"140070302","CORDOBA",17,0,14,0,0,14,0
"140140604","CORDOBA",221,0,111,82,11,204,0
"140140602","CORDOBA",43,3,33,7,0,40,0.0697674418604651
"140140601","CORDOBA",225,1,165,52,2,219,0.00444444444444444
"140560504","CORDOBA",47,0,27,12,4,43,0
"140070204","CORDOBA",151,4,110,22,2,134,0.0264900662251656
"140070811","CORDOBA",14,0,8,4,2,14,0
"140911308","CORDOBA",7,0,2,1,2,5,0
"820631205","SANTA FE",229,5,7,209,0,216,0.0218340611353712
"140140501","CORDOBA",248,1,165,65,4,234,0.00403225806451613
"140140403","CORDOBA",101,1,86,13,0,99,0.0099009900990099
"141610406","CORDOBA",51,0,35,15,1,51,0
"140070108","CORDOBA",114,0,89,23,1,113,0
"820421120","SANTA FE",262,0,82,178,1,261,0
"140911404","CORDOBA",17,0,11,4,0,15,0
"820844413","SANTA FE",316,315,1,0,0,1,0.996835443037975
"820846215","SANTA FE",253,19,109,125,0,234,0.075098814229249
"140070813","CORDOBA",16,0,12,3,1,16,0
"820490334","SANTA FE",310,243,19,32,9,60,0.783870967741935
"140070905","CORDOBA",14,0,8,5,0,13,0
"140560607","CORDOBA",28,0,21,7,0,28,0
"140070812","CORDOBA",15,0,9,3,3,15,0
"820632009","SANTA FE",237,200,16,21,0,37,0.843881856540084
"140070717","CORDOBA",8,0,4,2,2,8,0
"140070810","CORDOBA",34,0,17,13,2,32,0
"140911303","CORDOBA",28,0,25,1,0,26,0
"140911302","CORDOBA",9,0,8,0,1,9,0
"140911301","CORDOBA",5,0,1,2,0,3,0
"140560606","CORDOBA",24,0,19,4,0,23,0
"140070801","CORDOBA",12,0,8,2,1,11,0
"141680103","CORDOBA",29,0,23,5,1,29,0
"820844406","SANTA FE",228,228,0,0,0,0,1
"140070716","CORDOBA",13,0,8,4,0,12,0
"141610505","CORDOBA",47,0,17,29,0,46,0
"141610409","CORDOBA",52,0,36,14,1,51,0
"140560503","CORDOBA",17,0,10,7,0,17,0
"140070709","CORDOBA",6,0,4,0,2,6,0
"141610504","CORDOBA",24,0,11,12,0,23,0
"140070601","CORDOBA",13,0,8,3,0,11,0
"140070410","CORDOBA",9,0,5,3,1,9,0
"140070408","CORDOBA",20,0,10,7,2,19,0
"140910801","CORDOBA",11,0,6,3,1,10,0
"140070306","CORDOBA",28,0,21,5,0,26,0
"140070304","CORDOBA",17,0,11,6,0,17,0
"140070405","CORDOBA",47,1,33,9,0,42,0.0212765957446809
"140560605","CORDOBA",30,0,20,10,0,30,0
"140070404","CORDOBA",2,0,2,0,0,2,0
"141680102","CORDOBA",52,0,9,27,2,38,0
"141680105","CORDOBA",18,0,10,4,0,14,0
"820844404","SANTA FE",268,259,8,0,0,8,0.966417910447761
"141610502","CORDOBA",25,0,19,5,1,25,0
"141610501","CORDOBA",24,0,18,6,0,24,0
"140560604","CORDOBA",20,0,10,10,0,20,0
"141610405","CORDOBA",71,5,45,15,2,62,0.0704225352112676
"141610206","CORDOBA",35,1,17,16,1,34,0.0285714285714286
"141470504","CORDOBA",49,0,35,11,1,47,0
"140560601","CORDOBA",65,0,22,42,1,65,0
"141610403","CORDOBA",24,0,16,6,2,24,0
"141610402","CORDOBA",34,0,19,13,0,32,0
"141610305","CORDOBA",122,0,79,36,0,115,0
"141610304","CORDOBA",63,0,36,22,0,58,0
"141610303","CORDOBA",43,0,28,13,1,42,0
"141610302","CORDOBA",41,0,31,8,0,39,0
"141610204","CORDOBA",21,0,17,3,1,21,0
"141610203","CORDOBA",21,0,3,18,0,21,0
"820844208","SANTA FE",297,93,41,148,2,191,0.313131313131313
"141610202","CORDOBA",44,1,19,23,0,42,0.0227272727272727
"141610111","CORDOBA",37,0,22,14,0,36,0
"141610106","CORDOBA",25,4,9,12,0,21,0.16
"820842002","SANTA FE",249,249,0,0,0,0,1
"141610110","CORDOBA",61,0,28,23,2,53,0
"141610109","CORDOBA",37,1,26,8,1,35,0.027027027027027
"141610107","CORDOBA",31,0,24,6,0,30,0
"141540207","CORDOBA",36,0,18,9,4,31,0
"141540206","CORDOBA",24,0,17,3,0,20,0
"820844109","SANTA FE",342,303,13,24,0,37,0.885964912280702
"141540208","CORDOBA",36,0,16,14,1,31,0
"141540106","CORDOBA",7,0,6,0,0,6,0
"141540105","CORDOBA",21,0,8,3,0,11,0
"141610105","CORDOBA",64,0,28,25,4,57,0
"141540203","CORDOBA",28,0,14,12,0,26,0
"141610104","CORDOBA",70,13,36,14,5,55,0.185714285714286
"141610101","CORDOBA",28,0,10,16,2,28,0
"141540101","CORDOBA",31,0,6,15,0,21,0
"820844108","SANTA FE",336,297,23,14,0,37,0.883928571428571
"141540202","CORDOBA",5,0,4,1,0,5,0
"141540201","CORDOBA",47,0,13,24,7,44,0
"820844105","SANTA FE",0,0,0,0,0,0,NA
"141470705","CORDOBA",2,0,1,0,0,1,0
"821330414","SANTA FE",265,17,165,72,0,237,0.0641509433962264
"141470503","CORDOBA",44,0,25,13,5,43,0
"141401706","CORDOBA",49,1,25,21,1,47,0.0204081632653061
"141401704","CORDOBA",23,0,16,4,3,23,0
"140630801","CORDOBA",24,0,11,13,0,24,0
"141470502","CORDOBA",28,0,20,7,0,27,0
"141470401","CORDOBA",54,5,27,16,1,44,0.0925925925925926
"820843504","SANTA FE",329,308,14,7,0,21,0.936170212765957
"141470306","CORDOBA",23,0,19,4,0,23,0
"140840201","CORDOBA",24,0,15,6,2,23,0
"140840207","CORDOBA",45,0,29,16,0,45,0
"141470206","CORDOBA",58,1,25,30,0,55,0.0172413793103448
"141470203","CORDOBA",51,0,7,31,6,44,0
"140770109","CORDOBA",31,0,12,6,0,18,0
"820980121","SANTA FE",416,17,132,249,7,388,0.0408653846153846
"141470101","CORDOBA",29,1,24,4,0,28,0.0344827586206897
"141401710","CORDOBA",73,0,55,13,0,68,0
"141401709","CORDOBA",107,1,74,28,1,103,0.00934579439252336
"141401708","CORDOBA",73,2,51,17,0,68,0.0273972602739726
"141401707","CORDOBA",21,0,11,8,2,21,0
"820843804","SANTA FE",358,357,1,0,0,1,0.997206703910615
"140770209","CORDOBA",34,0,21,5,2,28,0
"140840105","CORDOBA",22,1,14,6,0,20,0.0454545454545455
"140840104","CORDOBA",19,1,14,4,0,18,0.0526315789473684
"140630404","CORDOBA",23,1,10,9,0,19,0.0434782608695652
"140770108","CORDOBA",26,0,11,8,0,19,0
"140770205","CORDOBA",55,0,30,18,1,49,0
"140770107","CORDOBA",44,0,5,7,2,14,0
"140560609","CORDOBA",82,0,48,32,2,82,0
"820910211","SANTA FE",205,1,130,56,15,201,0.0048780487804878
"140770106","CORDOBA",46,0,3,25,4,32,0
"140770103","CORDOBA",44,0,3,17,1,21,0
"140840101","CORDOBA",50,0,23,23,2,48,0
"140770101","CORDOBA",13,0,4,1,3,8,0
"140630903","CORDOBA",73,0,36,36,0,72,0
"140700207","CORDOBA",63,0,48,8,1,57,0
"140630902","CORDOBA",38,0,24,12,2,38,0
"140630901","CORDOBA",21,0,7,13,1,21,0
"140770206","CORDOBA",18,0,12,3,1,16,0
"140770104","CORDOBA",24,0,4,0,7,11,0
"140630909","CORDOBA",56,0,35,21,0,56,0
"820700524","SANTA FE",419,320,35,60,1,96,0.763723150357995
"140700205","CORDOBA",80,0,35,14,8,57,0
"140630904","CORDOBA",66,0,50,14,1,65,0
"820700305","SANTA FE",377,324,19,32,1,52,0.859416445623342
"140560502","CORDOBA",21,0,7,12,2,21,0
"140700105","CORDOBA",106,0,38,33,4,75,0
"140630705","CORDOBA",41,0,32,8,1,41,0
"140630703","CORDOBA",35,0,25,10,0,35,0
"140700104","CORDOBA",39,0,15,9,1,25,0
"140840301","CORDOBA",31,0,12,18,1,31,0
"140630702","CORDOBA",50,0,41,5,1,47,0
"820848015","SANTA FE",250,231,0,0,0,0,0.924
"140630908","CORDOBA",37,0,34,1,0,35,0
"140630907","CORDOBA",32,0,21,10,1,32,0
"140630906","CORDOBA",21,0,0,21,0,21,0
"140630905","CORDOBA",30,0,11,19,0,30,0
"820700213","SANTA FE",393,216,124,53,0,177,0.549618320610687
"140630806","CORDOBA",21,0,12,9,0,21,0
"140630805","CORDOBA",20,0,14,4,1,19,0
"140630804","CORDOBA",55,0,44,11,0,55,0
"140630803","CORDOBA",44,0,23,18,1,42,0
"140630802","CORDOBA",31,0,9,22,0,31,0
"140630606","CORDOBA",31,0,21,8,2,31,0
"140630605","CORDOBA",20,0,11,7,2,20,0
"140630604","CORDOBA",38,0,19,17,1,37,0
"140630603","CORDOBA",44,0,23,21,0,44,0
"140630602","CORDOBA",4,0,2,2,0,4,0
"140630601","CORDOBA",5,0,5,0,0,5,0
"820843704","SANTA FE",195,193,1,0,0,1,0.98974358974359
"140630502","CORDOBA",52,0,18,34,0,52,0
"140630503","CORDOBA",27,0,19,7,0,26,0
"140630501","CORDOBA",66,2,23,39,2,64,0.0303030303030303
"820843701","SANTA FE",364,362,1,1,0,2,0.994505494505495
"140630406","CORDOBA",9,0,3,6,0,9,0
"140630405","CORDOBA",30,0,10,18,2,30,0
"140560602","CORDOBA",38,2,19,15,2,36,0.0526315789473684
"821190312","SANTA FE",304,21,87,183,1,271,0.0690789473684211
"140630403","CORDOBA",14,0,3,11,0,14,0
"140630402","CORDOBA",23,0,8,15,0,23,0
"140630301","CORDOBA",14,0,9,5,0,14,0
"140630302","CORDOBA",37,13,12,12,0,24,0.351351351351351
"140630401","CORDOBA",12,0,8,4,0,12,0
"820490614","SANTA FE",192,189,3,0,0,3,0.984375
"820842310","SANTA FE",222,222,0,0,0,0,1
"140630210","CORDOBA",37,0,30,7,0,37,0
"140630208","CORDOBA",33,0,8,24,1,33,0
"140630203","CORDOBA",30,3,10,16,0,26,0.1
"140560608","CORDOBA",51,0,24,25,1,50,0
"140630201","CORDOBA",31,0,6,25,0,31,0
"140630108","CORDOBA",19,0,16,3,0,19,0
"820280212","SANTA FE",266,1,85,165,11,261,0.0037593984962406
"140630107","CORDOBA",17,0,14,3,0,17,0
"820070215","SANTA FE",217,129,16,69,3,88,0.594470046082949
"820847602","SANTA FE",81,0,33,47,0,80,0
"140630204","CORDOBA",30,2,9,19,0,28,0.0666666666666667
"140630106","CORDOBA",37,0,11,23,1,35,0
"140630105","CORDOBA",18,0,7,10,0,17,0
"140630103","CORDOBA",23,0,9,14,0,23,0
"140560614","CORDOBA",22,0,16,6,0,22,0
"140560610","CORDOBA",42,0,24,16,1,41,0
"820980409","SANTA FE",211,3,137,65,0,202,0.014218009478673
"140560406","CORDOBA",24,0,16,4,0,20,0
"140560307","CORDOBA",11,0,7,4,0,11,0
"140560306","CORDOBA",12,0,9,3,0,12,0
"140630704","CORDOBA",28,0,15,12,1,28,0
"140630206","CORDOBA",33,0,23,10,0,33,0
"820841411","SANTA FE",165,161,3,1,0,4,0.975757575757576
"140070202","CORDOBA",31,0,16,7,8,31,0
"140910601","CORDOBA",1,0,1,0,0,1,0
"820910607","SANTA FE",192,0,183,8,1,192,0
"820910601","SANTA FE",486,111,234,101,10,345,0.228395061728395
"140560305","CORDOBA",38,0,32,6,0,38,0
"140420106","CORDOBA",41,1,9,31,0,40,0.024390243902439
"140560402","CORDOBA",46,0,22,22,1,45,0
"820910504","SANTA FE",361,208,125,24,3,152,0.57617728531856
"140560308","CORDOBA",29,0,22,7,0,29,0
"820910112","SANTA FE",262,1,213,29,7,249,0.00381679389312977
"140981309","CORDOBA",65,0,30,25,7,62,0
"140070203","CORDOBA",35,0,20,14,0,34,0
"820910213","SANTA FE",50,0,7,37,3,47,0
"140770105","CORDOBA",45,0,3,32,0,35,0
"140770102","CORDOBA",8,0,0,1,0,1,0
"140700209","CORDOBA",48,0,22,10,3,35,0
"140700208","CORDOBA",37,0,8,4,3,15,0
"140700202","CORDOBA",38,0,9,18,2,29,0
"140700102","CORDOBA",35,0,7,7,10,24,0
"820631501","SANTA FE",357,333,9,13,0,22,0.932773109243697
"140070301","CORDOBA",18,0,9,5,2,16,0
"140910701","CORDOBA",13,0,6,6,1,13,0
"140910604","CORDOBA",18,0,14,2,2,18,0
"140910603","CORDOBA",23,0,22,1,0,23,0
"140981404","CORDOBA",55,0,26,29,0,55,0
"140981310","CORDOBA",67,0,19,43,1,63,0
"140070105","CORDOBA",72,1,55,10,1,66,0.0138888888888889
"140910301","CORDOBA",6,0,5,0,0,5,0
"140910207","CORDOBA",4,0,2,0,1,3,0
"140910206","CORDOBA",24,0,11,5,4,20,0
"140840102","CORDOBA",49,0,24,25,0,49,0
"140770208","CORDOBA",58,0,26,0,2,28,0
"140770204","CORDOBA",190,0,55,53,22,130,0
"140770201","CORDOBA",50,0,32,10,0,42,0
"140981105","CORDOBA",32,0,24,7,0,31,0
"140981006","CORDOBA",38,0,10,25,2,37,0
"140981005","CORDOBA",47,0,29,14,1,44,0
"140981004","CORDOBA",51,0,26,23,1,50,0
"140630205","CORDOBA",16,0,7,8,1,16,0
"140980801","CORDOBA",49,0,33,13,0,46,0
"140980705","CORDOBA",20,3,11,4,1,16,0.15
"140980704","CORDOBA",70,1,34,33,2,69,0.0142857142857143
"140980702","CORDOBA",50,0,10,22,0,32,0
"140980701","CORDOBA",27,0,10,15,1,26,0
"140980604","CORDOBA",45,0,12,25,1,38,0
"140980602","CORDOBA",72,0,31,24,5,60,0
"140980601","CORDOBA",25,0,14,7,1,22,0
"140630202","CORDOBA",70,0,26,41,3,70,0
"140630102","CORDOBA",29,0,6,23,0,29,0
"140630101","CORDOBA",30,0,14,13,1,28,0
"420210514","LA PAMPA",207,203,3,1,0,4,0.980676328502415
"820842009","SANTA FE",295,293,2,0,0,2,0.993220338983051
"140560603","CORDOBA",29,0,28,1,0,29,0
"140560310","CORDOBA",48,0,19,29,0,48,0
"140560302","CORDOBA",34,0,23,6,2,31,0
"140490210","CORDOBA",50,1,21,20,1,42,0.02
"140490209","CORDOBA",25,0,8,14,0,22,0
"140490110","CORDOBA",18,0,13,3,0,16,0
"140490105","CORDOBA",51,1,7,17,2,26,0.0196078431372549
"140980505","CORDOBA",109,1,76,29,0,105,0.00917431192660551
"820700515","SANTA FE",104,1,41,61,1,103,0.00961538461538462
"820700317","SANTA FE",293,284,5,4,0,9,0.969283276450512
"140490104","CORDOBA",37,1,27,3,0,30,0.027027027027027
"140420206","CORDOBA",30,0,13,16,0,29,0
"140420205","CORDOBA",90,0,18,67,1,86,0
"820210601","SANTA FE",334,318,5,8,0,13,0.952095808383233
"140420102","CORDOBA",30,0,24,5,0,29,0
"141750210","CORDOBA",65,0,20,19,16,55,0
"140420101","CORDOBA",42,0,29,11,0,40,0
"140350504","CORDOBA",47,0,30,10,1,41,0
"140350503","CORDOBA",34,0,22,5,1,28,0
"820420807","SANTA FE",266,266,0,0,0,0,1
"140350308","CORDOBA",43,0,35,6,0,41,0
"140280703","CORDOBA",32,0,7,9,0,16,0
"140280504","CORDOBA",116,0,58,34,8,100,0
"140280503","CORDOBA",48,0,19,13,1,33,0
"140280502","CORDOBA",134,5,71,36,3,110,0.0373134328358209
"141750208","CORDOBA",66,0,18,24,3,45,0
"141750204","CORDOBA",88,0,20,42,8,70,0
"141750203","CORDOBA",65,0,38,17,4,59,0
"820700312","SANTA FE",255,215,25,15,0,40,0.843137254901961
"141680107","CORDOBA",37,0,30,4,0,34,0
"141260207","CORDOBA",34,0,6,20,1,27,0
"141820710","CORDOBA",42,0,13,29,0,42,0
"140210302","CORDOBA",122,13,95,13,0,108,0.10655737704918
"140210201","CORDOBA",16,0,14,1,1,16,0
"140210102","CORDOBA",28,2,15,6,3,24,0.0714285714285714
"140210101","CORDOBA",25,1,20,2,0,22,0.04
"820846307","SANTA FE",346,8,157,175,0,332,0.023121387283237
"141820709","CORDOBA",45,0,16,29,0,45,0
"141820708","CORDOBA",53,1,23,15,3,41,0.0188679245283019
"141680307","CORDOBA",56,0,37,15,2,54,0
"820842810","SANTA FE",386,373,0,0,0,0,0.966321243523316
"141820604","CORDOBA",36,7,13,15,1,29,0.194444444444444
"820843916","SANTA FE",162,158,4,0,0,4,0.975308641975309
"140070901","CORDOBA",10,0,1,3,1,5,0
"141820508","CORDOBA",32,0,18,13,1,32,0
"820632114","SANTA FE",340,340,0,0,0,0,1
"141820506","CORDOBA",24,0,8,14,1,23,0
"140420503","CORDOBA",22,0,16,6,0,22,0
"820848908","SANTA FE",155,5,37,105,4,146,0.032258064516129
"820843910","SANTA FE",177,176,0,1,0,1,0.994350282485876
"141820503","CORDOBA",9,0,5,3,0,8,0
"140420305","CORDOBA",56,0,29,24,1,54,0
"140070907","CORDOBA",12,0,4,5,0,9,0
"140070906","CORDOBA",27,0,7,15,0,22,0
"140070710","CORDOBA",12,0,9,0,1,10,0
"141820405","CORDOBA",34,0,15,18,0,33,0
"820841915","SANTA FE",245,236,1,0,0,1,0.963265306122449
"141820403","CORDOBA",83,4,50,23,2,75,0.0481927710843374
"820848508","SANTA FE",274,260,10,3,0,13,0.948905109489051
"820848501","SANTA FE",551,23,184,316,3,503,0.0417422867513612
"141820402","CORDOBA",111,18,38,42,2,82,0.162162162162162
"141820305","CORDOBA",33,0,18,12,3,33,0
"820632909","SANTA FE",348,9,173,165,1,339,0.0258620689655172
"141820205","CORDOBA",31,1,14,15,0,29,0.032258064516129
"821050206","SANTA FE",58,1,21,30,2,53,0.0172413793103448
"141820106","CORDOBA",90,0,33,48,5,86,0
"820632705","SANTA FE",283,264,0,1,0,1,0.932862190812721
"141820105","CORDOBA",64,0,51,4,0,55,0
"820910314","SANTA FE",337,35,190,82,10,282,0.103857566765579
"820844711","SANTA FE",223,196,16,9,0,25,0.878923766816143
"141820104","CORDOBA",47,0,25,21,1,47,0
"820560208","SANTA FE",185,1,95,83,2,180,0.00540540540540541
"820848415","SANTA FE",260,44,136,80,0,216,0.169230769230769
"141820102","CORDOBA",60,0,35,23,1,59,0
"820842311","SANTA FE",405,404,1,0,0,1,0.997530864197531
"141820101","CORDOBA",53,0,32,16,3,51,0
"820700505","SANTA FE",193,50,61,79,0,140,0.259067357512953
"141820110","CORDOBA",125,0,86,29,6,121,0
"141750211","CORDOBA",65,0,37,21,1,59,0
"820630213","SANTA FE",459,3,193,249,4,446,0.0065359477124183
"141750109","CORDOBA",51,0,15,15,7,37,0
"141750205","CORDOBA",45,0,22,14,2,38,0
"820630118","SANTA FE",270,4,88,163,1,252,0.0148148148148148
"141750108","CORDOBA",42,0,24,11,2,37,0
"140210202","CORDOBA",26,0,20,4,2,26,0
"141750106","CORDOBA",22,0,15,6,0,21,0
"820846109","SANTA FE",474,13,133,313,1,447,0.0274261603375527
"820846107","SANTA FE",420,15,92,299,2,393,0.0357142857142857
"141750103","CORDOBA",53,0,19,19,0,38,0
"141680106","CORDOBA",48,0,34,7,2,43,0
"141680306","CORDOBA",27,0,21,4,0,25,0
"140210403","CORDOBA",112,0,48,38,17,103,0
"140070903","CORDOBA",14,0,4,8,2,14,0
"141680305","CORDOBA",57,1,37,14,2,53,0.0175438596491228
"141190206","CORDOBA",8,0,5,2,1,8,0
"141120301","CORDOBA",34,0,21,7,5,33,0
"140070802","CORDOBA",62,19,20,13,7,40,0.306451612903226
"140070714","CORDOBA",6,0,2,2,1,5,0
"140070713","CORDOBA",29,0,10,12,1,23,0
"140070712","CORDOBA",14,0,11,1,0,12,0
"140070711","CORDOBA",12,0,2,0,8,10,0
"141680301","CORDOBA",27,0,16,8,1,25,0
"140070708","CORDOBA",14,0,6,4,1,11,0
"141680308","CORDOBA",20,0,9,11,0,20,0
"141750206","CORDOBA",61,0,36,10,8,54,0
"141120203","CORDOBA",20,0,5,6,4,15,0
"141120202","CORDOBA",23,0,14,6,3,23,0
"141680203","CORDOBA",27,0,20,5,0,25,0
"141120108","CORDOBA",48,0,29,10,6,45,0
"821330312","SANTA FE",76,0,19,40,8,67,0
"821120203","SANTA FE",276,75,102,96,0,198,0.271739130434783
"820846105","SANTA FE",247,9,133,105,0,238,0.0364372469635627
"141680201","CORDOBA",47,0,34,9,2,45,0
"140981405","CORDOBA",55,0,38,10,1,49,0
"065682108","BUENOS AIRES",134,133,1,0,0,1,0.992537313432836
"141680109","CORDOBA",27,1,18,7,1,26,0.037037037037037
"141680202","CORDOBA",82,1,71,7,1,79,0.0121951219512195
"821330631","SANTA FE",274,67,87,116,2,205,0.244525547445255
"140210204","CORDOBA",51,0,24,26,1,51,0
"140210401","CORDOBA",93,2,59,25,2,86,0.021505376344086
"140210203","CORDOBA",16,0,12,3,1,16,0
"065682206","BUENOS AIRES",240,153,80,7,0,87,0.6375
"141260107","CORDOBA",44,0,19,16,2,37,0
"141260105","CORDOBA",12,0,5,3,1,9,0
"141260104","CORDOBA",52,0,11,10,5,26,0
"141260102","CORDOBA",47,0,32,12,1,45,0
"820848209","SANTA FE",579,108,100,350,9,459,0.186528497409326
"141120101","CORDOBA",16,0,8,1,5,14,0
"821190117","SANTA FE",437,19,251,162,1,414,0.0434782608695652
"141050603","CORDOBA",57,0,27,25,3,55,0
"141050201","CORDOBA",26,0,9,8,6,23,0
"140981407","CORDOBA",38,0,13,22,3,38,0
"820560415","SANTA FE",241,238,2,1,0,3,0.987551867219917
"140070707","CORDOBA",14,0,9,4,1,14,0
"140980405","CORDOBA",21,0,13,8,0,21,0
"140980303","CORDOBA",16,0,14,0,0,14,0
"140980206","CORDOBA",18,0,5,9,1,15,0
"140980201","CORDOBA",10,0,10,0,0,10,0
"140911905","CORDOBA",11,0,5,0,6,11,0
"140911804","CORDOBA",69,0,45,15,3,63,0
"140280107","CORDOBA",26,0,22,2,1,25,0
"140210503","CORDOBA",13,0,8,4,1,13,0
"140210402","CORDOBA",83,0,38,29,7,74,0
"140210306","CORDOBA",110,0,79,25,1,105,0
"140210304","CORDOBA",225,7,194,19,0,213,0.0311111111111111
"140210303","CORDOBA",191,3,150,33,1,184,0.0157068062827225
"140070705","CORDOBA",29,0,15,6,1,22,0
"140070106","CORDOBA",33,0,15,13,3,31,0
"140070104","CORDOBA",24,0,17,2,5,24,0
"140070101","CORDOBA",17,0,11,2,3,16,0
"140070412","CORDOBA",33,0,11,5,11,27,0
"140070411","CORDOBA",19,0,14,2,3,19,0
"140070409","CORDOBA",13,0,3,4,1,8,0
"140070406","CORDOBA",67,1,49,10,4,63,0.0149253731343284
"821330608","SANTA FE",101,49,11,35,5,51,0.485148514851485
"065682809","BUENOS AIRES",373,1,258,108,0,366,0.00268096514745308
"820910615","SANTA FE",177,2,75,73,10,158,0.0112994350282486
"820210322","SANTA FE",98,1,34,59,2,95,0.0102040816326531
"821050108","SANTA FE",255,0,33,128,68,229,0
"821050101","SANTA FE",113,1,16,78,9,103,0.00884955752212389
"820846801","SANTA FE",202,0,57,137,6,200,0
"820848208","SANTA FE",468,244,109,107,0,216,0.521367521367521
"820280208","SANTA FE",84,1,47,35,1,83,0.0119047619047619
"820770309","SANTA FE",247,2,126,89,6,221,0.00809716599190283
"821120305","SANTA FE",31,0,10,19,2,31,0
"821330629","SANTA FE",475,122,126,200,15,341,0.256842105263158
"821330604","SANTA FE",538,239,192,97,3,292,0.444237918215613
"821330212","SANTA FE",429,110,51,200,41,292,0.256410256410256
"820840301","SANTA FE",136,0,3,101,7,111,0
"820770202","SANTA FE",203,0,99,44,40,183,0
"820700714","SANTA FE",54,0,13,38,3,54,0
"820845214","SANTA FE",451,13,176,228,3,407,0.0288248337028825
"820843307","SANTA FE",314,25,98,188,0,286,0.0796178343949045
"820910308","SANTA FE",283,125,127,23,8,158,0.441696113074205
"821190109","SANTA FE",195,2,136,56,0,192,0.0102564102564103
"820630406","SANTA FE",5,0,2,1,1,4,0
"820630307","SANTA FE",365,8,98,258,1,357,0.0219178082191781
"820560401","SANTA FE",436,284,46,91,1,138,0.651376146788991
"820560218","SANTA FE",338,295,10,8,0,18,0.872781065088757
"821190611","SANTA FE",331,177,70,83,0,153,0.534743202416918
"821190308","SANTA FE",666,96,117,437,4,558,0.144144144144144
"821190306","SANTA FE",313,189,32,89,0,121,0.603833865814696
"820420714","SANTA FE",376,376,0,0,0,0,1
"820840421","SANTA FE",542,257,68,173,15,256,0.474169741697417
"820420705","SANTA FE",440,439,0,0,0,0,0.997727272727273
"821190107","SANTA FE",183,119,11,48,2,61,0.650273224043716
"821120401","SANTA FE",446,123,190,133,0,323,0.275784753363229
"821120312","SANTA FE",104,0,32,65,4,101,0
"821050516","SANTA FE",228,2,150,74,1,225,0.0087719298245614
"821050515","SANTA FE",224,1,77,144,0,221,0.00446428571428571
"821050506","SANTA FE",338,1,191,139,4,334,0.0029585798816568
"821050215","SANTA FE",78,2,46,30,0,76,0.0256410256410256
"821050119","SANTA FE",288,1,135,150,2,287,0.00347222222222222
"820490615","SANTA FE",243,235,4,3,0,7,0.967078189300412
"820843006","SANTA FE",248,86,30,128,0,158,0.346774193548387
"820633504","SANTA FE",230,224,4,2,0,6,0.973913043478261
"820843120","SANTA FE",233,198,27,8,0,35,0.849785407725322
"820845516","SANTA FE",272,158,16,77,0,93,0.580882352941177
"820845515","SANTA FE",227,160,53,12,0,65,0.704845814977974
"820842104","SANTA FE",367,363,0,0,0,0,0.989100817438692
"820632614","SANTA FE",309,284,13,6,0,19,0.919093851132686
"820770206","SANTA FE",454,1,229,177,12,418,0.00220264317180617
"820700415","SANTA FE",457,15,229,210,2,441,0.0328227571115974
"820842919","SANTA FE",240,228,0,0,0,0,0.95
"820842917","SANTA FE",251,251,0,0,0,0,1
"820842013","SANTA FE",307,305,2,0,0,2,0.993485342019544
"820842012","SANTA FE",217,217,0,0,0,0,1
"820490409","SANTA FE",80,3,32,40,2,74,0.0375
"820842511","SANTA FE",258,258,0,0,0,0,1
"820421114","SANTA FE",283,7,167,108,0,275,0.0247349823321555
"820842509","SANTA FE",266,260,6,0,0,6,0.977443609022556
"820630323","SANTA FE",246,2,74,164,1,239,0.00813008130081301
"820842806","SANTA FE",29,29,0,0,0,0,1
"820842804","SANTA FE",251,250,1,0,0,1,0.99601593625498
"820842716","SANTA FE",257,256,1,0,0,1,0.996108949416342
"820630102","SANTA FE",23,3,4,14,0,18,0.130434782608696
"820560212","SANTA FE",127,1,43,71,8,122,0.0078740157480315
"820842201","SANTA FE",249,249,0,0,0,0,1
"820841809","SANTA FE",264,264,0,0,0,0,1
"820841807","SANTA FE",437,437,0,0,0,0,1
"820210106","SANTA FE",332,222,46,62,0,108,0.668674698795181
"820841603","SANTA FE",377,373,4,0,0,4,0.989389920424403
"820841508","SANTA FE",245,220,18,4,0,22,0.897959183673469
"820842003","SANTA FE",350,350,0,0,0,0,1
"820841715","SANTA FE",375,375,0,0,0,0,1
"820841301","SANTA FE",315,240,40,33,1,74,0.761904761904762
"820841221","SANTA FE",342,247,20,69,1,90,0.722222222222222
"820843508","SANTA FE",244,140,20,80,1,101,0.573770491803279
"820841118","SANTA FE",325,41,165,119,0,284,0.126153846153846
"820843417","SANTA FE",255,60,107,76,0,183,0.235294117647059
"820843416","SANTA FE",418,40,76,264,8,348,0.0956937799043062
"820843410","SANTA FE",304,285,9,10,0,19,0.9375
"820843408","SANTA FE",392,376,9,0,0,9,0.959183673469388
"820843407","SANTA FE",330,326,4,0,0,4,0.987878787878788
"820841110","SANTA FE",495,15,332,146,2,480,0.0303030303030303
"820845202","SANTA FE",310,188,24,94,1,119,0.606451612903226
"820845112","SANTA FE",262,225,23,14,0,37,0.858778625954199
"820845110","SANTA FE",274,230,19,25,0,44,0.839416058394161
"820845001","SANTA FE",311,213,34,63,1,98,0.684887459807074
"820844911","SANTA FE",746,234,58,354,17,429,0.313672922252011
"820844908","SANTA FE",579,465,24,87,0,111,0.803108808290155
"820843404","SANTA FE",384,173,57,147,0,204,0.450520833333333
"820845104","SANTA FE",309,297,9,3,0,12,0.961165048543689
"820845111","SANTA FE",356,297,34,25,0,59,0.834269662921348
"820210604","SANTA FE",288,284,1,2,0,3,0.986111111111111
"820210603","SANTA FE",292,288,4,0,0,4,0.986301369863014
"820210514","SANTA FE",446,293,46,88,7,141,0.65695067264574
"820210512","SANTA FE",399,187,31,175,1,207,0.468671679197995
"820210505","SANTA FE",507,399,49,42,0,91,0.78698224852071
"820844815","SANTA FE",264,245,4,5,0,9,0.928030303030303
"820844810","SANTA FE",315,5,78,226,0,304,0.0158730158730159
"820210404","SANTA FE",346,316,11,17,1,29,0.913294797687861
"820210320","SANTA FE",107,0,64,37,6,107,0
"066581111","BUENOS AIRES",234,232,2,0,0,2,0.991452991452991
"820210215","SANTA FE",600,462,73,59,3,135,0.77
"820210503","SANTA FE",391,278,57,54,0,111,0.710997442455243
"820210408","SANTA FE",362,337,15,9,0,24,0.930939226519337
"820210401","SANTA FE",510,31,182,288,2,472,0.0607843137254902
"820210316","SANTA FE",31,0,20,11,0,31,0
"821190418","SANTA FE",234,3,186,44,1,231,0.0128205128205128
"821190402","SANTA FE",308,3,148,148,2,298,0.00974025974025974
"820848816","SANTA FE",388,7,154,224,1,379,0.0180412371134021
"820210105","SANTA FE",238,149,34,55,0,89,0.626050420168067
"820140608","SANTA FE",357,321,13,16,2,31,0.899159663865546
"820140503","SANTA FE",403,0,196,201,4,401,0
"820842407","SANTA FE",273,272,1,0,0,1,0.996336996336996
"820848806","SANTA FE",409,2,132,264,0,396,0.00488997555012225
"820845912","SANTA FE",394,6,308,79,0,387,0.0152284263959391
"820140420","SANTA FE",276,151,61,64,0,125,0.547101449275362
"820845805","SANTA FE",476,2,211,258,0,469,0.00420168067226891
"820845803","SANTA FE",380,5,123,249,1,373,0.0131578947368421
"820420622","SANTA FE",229,223,3,0,0,3,0.973799126637555
"820421106","SANTA FE",355,0,90,258,2,350,0
"820421015","SANTA FE",363,127,128,93,2,223,0.349862258953168
"820421010","SANTA FE",422,2,118,284,6,408,0.004739336492891
"820140506","SANTA FE",367,166,115,85,0,200,0.452316076294278
"820070410","SANTA FE",242,146,33,51,5,89,0.603305785123967
"820140215","SANTA FE",186,186,0,0,0,0,1
"820140212","SANTA FE",177,175,2,0,0,2,0.988700564971751
"820140203","SANTA FE",304,288,1,11,0,12,0.947368421052632
"820420915","SANTA FE",226,226,0,0,0,0,1
"820420921","SANTA FE",481,158,162,153,2,317,0.328482328482329
"820420904","SANTA FE",229,198,10,19,0,29,0.864628820960699
"820842617","SANTA FE",194,191,2,0,0,2,0.984536082474227
"820420811","SANTA FE",296,244,36,15,0,51,0.824324324324324
"820420810","SANTA FE",344,340,3,1,0,4,0.988372093023256
"820420808","SANTA FE",302,301,1,0,0,1,0.996688741721854
"820420620","SANTA FE",352,222,54,74,0,128,0.630681818181818
"820420619","SANTA FE",314,16,80,199,4,283,0.0509554140127389
"820420617","SANTA FE",233,149,8,71,3,82,0.639484978540773
"820420606","SANTA FE",400,286,34,78,1,113,0.715
"820420918","SANTA FE",304,298,6,0,0,6,0.980263157894737
"820140303","SANTA FE",434,428,1,4,0,5,0.986175115207373
"820420411","SANTA FE",159,146,7,6,0,13,0.918238993710692
"820420408","SANTA FE",390,156,166,63,3,232,0.4
"820420406","SANTA FE",337,315,13,9,0,22,0.934718100890208
"820842615","SANTA FE",299,299,0,0,0,0,1
"820848608","SANTA FE",309,128,38,141,0,179,0.414239482200647
"820420323","SANTA FE",287,0,179,91,8,278,0
"820420317","SANTA FE",251,2,152,94,3,249,0.00796812749003984
"820848602","SANTA FE",461,273,85,102,0,187,0.592190889370933
"821050410","SANTA FE",397,359,9,28,0,37,0.904282115869018
"820070305","SANTA FE",400,26,154,216,3,373,0.065
"820631204","SANTA FE",398,22,121,245,1,367,0.0552763819095477
"820631114","SANTA FE",276,8,130,127,1,258,0.0289855072463768
"820140108","SANTA FE",277,2,128,144,1,273,0.0072202166064982
"820070312","SANTA FE",409,283,63,63,0,126,0.691931540342298
"821050411","SANTA FE",270,268,1,1,0,2,0.992592592592593
"820420108","SANTA FE",439,4,351,83,0,434,0.00911161731207289
"820350210","SANTA FE",375,0,186,180,4,370,0
"820630802","SANTA FE",325,307,5,12,0,17,0.944615384615385
"820840602","SANTA FE",347,347,0,0,0,0,1
"820631306","SANTA FE",234,8,86,140,0,226,0.0341880341880342
"820631112","SANTA FE",234,3,30,191,1,222,0.0128205128205128
"820631203","SANTA FE",170,4,69,96,1,166,0.0235294117647059
"820070306","SANTA FE",353,4,114,225,1,340,0.0113314447592068
"820842410","SANTA FE",189,189,0,0,0,0,1
"820420222","SANTA FE",310,12,195,98,0,293,0.0387096774193548
"820842402","SANTA FE",275,275,0,0,0,0,1
"820560116","SANTA FE",215,1,147,63,0,210,0.00465116279069767
"820631012","SANTA FE",210,12,55,141,2,198,0.0571428571428571
"820631005","SANTA FE",234,6,51,175,0,226,0.0256410256410256
"820630903","SANTA FE",385,340,11,10,0,21,0.883116883116883
"820842401","SANTA FE",195,195,0,0,0,0,1
"820842323","SANTA FE",225,225,0,0,0,0,1
"820630809","SANTA FE",266,258,5,3,0,8,0.969924812030075
"820630702","SANTA FE",248,223,10,13,0,23,0.899193548387097
"820630603","SANTA FE",419,411,3,4,0,7,0.98090692124105
"820630601","SANTA FE",405,14,51,333,2,386,0.0345679012345679
"820840412","SANTA FE",309,223,54,30,1,85,0.72168284789644
"820631004","SANTA FE",222,5,93,124,0,217,0.0225225225225225
"820840308","SANTA FE",479,9,78,326,15,419,0.0187891440501044
"820840505","SANTA FE",662,473,112,69,0,181,0.714501510574018
"821050311","SANTA FE",234,168,29,32,1,62,0.717948717948718
"820770314","SANTA FE",248,82,88,48,4,140,0.330645161290323
"820770304","SANTA FE",525,8,266,218,20,504,0.0152380952380952
"820280415","SANTA FE",315,304,5,5,0,10,0.965079365079365
"820490817","SANTA FE",48,46,1,0,0,1,0.958333333333333
"820280414","SANTA FE",396,387,5,1,0,6,0.977272727272727
"821330201","SANTA FE",289,2,104,143,10,257,0.0069204152249135
"821260515","SANTA FE",312,281,24,1,0,25,0.900641025641026
"820630231","SANTA FE",306,65,146,87,3,236,0.212418300653595
"820491013","SANTA FE",271,1,181,87,1,269,0.003690036900369
"820491012","SANTA FE",325,0,175,148,0,323,0
"821050308","SANTA FE",409,298,55,50,1,106,0.728606356968215
"820630410","SANTA FE",1221,10,199,941,28,1168,0.00819000819000819
"821330416","SANTA FE",281,4,62,178,15,255,0.0142348754448399
"821260504","SANTA FE",320,288,26,4,0,30,0.9
"820910402","SANTA FE",80,2,13,51,7,71,0.025
"820700607","SANTA FE",220,4,102,111,0,213,0.0181818181818182
"821260508","SANTA FE",297,274,21,2,0,23,0.922558922558923
"820910616","SANTA FE",175,35,127,13,0,140,0.2
"820841705","SANTA FE",226,203,1,0,0,1,0.898230088495575
"820700104","SANTA FE",329,1,158,152,9,319,0.00303951367781155
"820633412","SANTA FE",445,4,176,260,2,438,0.00898876404494382
"820633405","SANTA FE",1517,32,896,573,2,1471,0.021094264996704
"820140412","SANTA FE",340,224,58,58,0,116,0.658823529411765
"820633402","SANTA FE",383,3,85,285,4,374,0.00783289817232376
"820633303","SANTA FE",324,239,28,48,1,77,0.737654320987654
"820700408","SANTA FE",215,214,0,1,0,1,0.995348837209302
"820700404","SANTA FE",354,301,35,18,0,53,0.850282485875706
"820633205","SANTA FE",335,4,54,266,2,322,0.0119402985074627
"820633114","SANTA FE",371,8,226,135,1,362,0.0215633423180593
"820848301","SANTA FE",352,333,17,2,0,19,0.946022727272727
"820630204","SANTA FE",333,3,178,145,6,329,0.00900900900900901
"820848305","SANTA FE",320,279,19,22,0,41,0.871875
"820633004","SANTA FE",198,180,11,7,0,18,0.909090909090909
"820633003","SANTA FE",219,219,0,0,0,0,1
"821260201","SANTA FE",392,0,292,98,1,391,0
"820490329","SANTA FE",348,19,250,67,10,327,0.0545977011494253
"820632813","SANTA FE",7,7,0,0,0,0,1
"820632812","SANTA FE",4,1,2,1,0,3,0.25
"820632510","SANTA FE",295,293,2,0,0,2,0.993220338983051
"820632507","SANTA FE",183,155,20,8,0,28,0.846994535519126
"820632413","SANTA FE",179,175,0,2,0,2,0.977653631284916
"820840903","SANTA FE",226,224,2,0,0,2,0.991150442477876
"820632313","SANTA FE",147,147,0,0,0,0,1
"820632312","SANTA FE",283,271,7,4,0,11,0.957597173144876
"820840807","SANTA FE",359,346,2,8,0,10,0.963788300835655
"820700715","SANTA FE",376,212,90,70,3,163,0.563829787234043
"820632307","SANTA FE",156,156,0,0,0,0,1
"820632205","SANTA FE",152,149,3,0,0,3,0.980263157894737
"820632109","SANTA FE",354,354,0,0,0,0,1
"820632012","SANTA FE",306,202,55,46,1,102,0.660130718954248
"820631905","SANTA FE",238,235,2,0,0,2,0.987394957983193
"820631903","SANTA FE",374,355,8,11,0,19,0.949197860962567
"820631808","SANTA FE",347,345,2,0,0,2,0.994236311239193
"820631711","SANTA FE",311,308,3,0,0,3,0.990353697749196
"820631506","SANTA FE",189,184,3,2,0,5,0.973544973544973
"820631702","SANTA FE",457,425,11,16,0,27,0.929978118161926
"820631701","SANTA FE",355,351,3,1,0,4,0.988732394366197
"820631610","SANTA FE",378,364,9,4,0,13,0.962962962962963
"820631401","SANTA FE",301,287,8,6,0,14,0.953488372093023
"820631317","SANTA FE",371,319,31,19,0,50,0.859838274932615
"820631215","SANTA FE",251,16,37,196,2,235,0.0637450199203187
"820490124","SANTA FE",394,243,96,53,0,149,0.616751269035533
"820840724","SANTA FE",266,210,16,34,0,50,0.789473684210526
"820700710","SANTA FE",233,4,91,116,1,208,0.0171673819742489
"820848211","SANTA FE",411,13,131,259,1,391,0.0316301703163017
"820840710","SANTA FE",215,210,2,2,1,5,0.976744186046512
"820840702","SANTA FE",330,51,65,209,0,274,0.154545454545455
"820840623","SANTA FE",322,25,77,205,1,283,0.077639751552795
"820840612","SANTA FE",372,44,235,93,0,328,0.118279569892473
"820848112","SANTA FE",301,272,18,11,0,29,0.903654485049834
"820560513","SANTA FE",270,169,45,51,0,96,0.625925925925926
"820630125","SANTA FE",317,1,133,181,0,314,0.00315457413249211
"820848107","SANTA FE",260,248,8,4,0,12,0.953846153846154
"820848102","SANTA FE",249,228,15,6,0,21,0.91566265060241
"820560507","SANTA FE",495,418,31,32,0,63,0.844444444444444
"820560502","SANTA FE",510,467,18,20,0,38,0.915686274509804
"820560306","SANTA FE",258,144,22,88,0,110,0.558139534883721
"820848019","SANTA FE",267,255,7,0,0,7,0.955056179775281
"820847803","SANTA FE",284,210,39,34,0,73,0.73943661971831
"820845710","SANTA FE",408,0,261,135,0,396,0
"820845701","SANTA FE",64,0,48,15,0,63,0
"820845509","SANTA FE",279,145,62,72,0,134,0.519713261648746
"820560118","SANTA FE",137,1,81,50,2,133,0.0072992700729927
"820845408","SANTA FE",300,47,105,124,16,245,0.156666666666667
"820845319","SANTA FE",292,284,3,5,0,8,0.972602739726027
"820845313","SANTA FE",174,172,2,0,0,2,0.988505747126437
"820845213","SANTA FE",337,25,101,207,0,308,0.0741839762611276
"821190813","SANTA FE",329,22,178,128,0,306,0.0668693009118541
"821190809","SANTA FE",287,118,112,57,0,169,0.411149825783972
"820421211","SANTA FE",342,4,241,95,1,337,0.0116959064327485
"820841107","SANTA FE",475,5,284,156,1,441,0.0105263157894737
"821190807","SANTA FE",337,1,240,96,0,336,0.0029673590504451
"821190806","SANTA FE",203,63,101,39,0,140,0.310344827586207
"821190805","SANTA FE",531,4,225,264,18,507,0.00753295668549906
"820490108","SANTA FE",438,42,290,97,2,389,0.0958904109589041
"820841016","SANTA FE",160,9,86,65,0,151,0.05625
"820910102","SANTA FE",383,284,47,38,3,88,0.741514360313316
"821190708","SANTA FE",297,14,139,142,0,281,0.0471380471380471
"821190707","SANTA FE",188,96,50,42,0,92,0.51063829787234
"821190702","SANTA FE",419,131,84,195,0,279,0.312649164677804
"820421213","SANTA FE",316,2,224,87,2,313,0.00632911392405063
"820847719","SANTA FE",328,322,3,2,0,5,0.981707317073171
"820846302","SANTA FE",416,5,134,267,1,402,0.0120192307692308
"820421115","SANTA FE",317,4,145,167,0,312,0.0126182965299685
"820849010","SANTA FE",313,5,207,100,0,307,0.0159744408945687
"820211016","SANTA FE",280,0,191,89,0,280,0
"820846208","SANTA FE",399,256,48,91,1,140,0.641604010025063
"820846206","SANTA FE",422,67,106,203,7,316,0.158767772511848
"820280105","SANTA FE",595,10,174,392,3,569,0.0168067226890756
"821190424","SANTA FE",328,13,153,160,0,313,0.0396341463414634
"820210910","SANTA FE",191,185,2,4,0,6,0.968586387434555
"820210909","SANTA FE",264,259,3,2,0,5,0.981060606060606
"820210912","SANTA FE",425,411,8,4,0,12,0.967058823529412
"820210805","SANTA FE",305,298,5,1,0,6,0.977049180327869
"820210802","SANTA FE",342,339,2,1,0,3,0.991228070175439
"820210725","SANTA FE",213,0,163,39,5,207,0
"820210719","SANTA FE",239,3,172,56,5,233,0.0125523012552301
"820210716","SANTA FE",29,0,12,10,3,25,0
"821330523","SANTA FE",26,0,0,15,8,23,0
"821330513","SANTA FE",8,0,0,7,0,7,0
"821330508","SANTA FE",7,0,2,4,1,7,0
"821330504","SANTA FE",109,0,7,59,22,88,0
"821330304","SANTA FE",13,0,2,7,2,11,0
"821190914","SANTA FE",47,1,8,37,0,45,0.0212765957446809
"821330217","SANTA FE",18,0,1,7,5,13,0
"821260215","SANTA FE",99,0,48,50,0,98,0
"821260211","SANTA FE",36,0,18,16,0,34,0
"821260111","SANTA FE",53,0,19,29,3,51,0
"820632908","SANTA FE",295,39,113,139,0,252,0.132203389830508
"821190501","SANTA FE",45,0,13,31,1,45,0
"821120106","SANTA FE",49,0,6,41,1,48,0
"821050207","SANTA FE",20,0,11,8,1,20,0
"821050113","SANTA FE",38,0,26,5,4,35,0
"820980105","SANTA FE",41,0,9,20,10,39,0
"821120307","SANTA FE",77,0,18,58,1,77,0
"821050109","SANTA FE",199,0,17,137,25,179,0
"821120216","SANTA FE",98,1,25,68,0,93,0.0102040816326531
"820980110","SANTA FE",30,0,11,16,3,30,0
"821120313","SANTA FE",83,1,17,57,3,77,0.0120481927710843
"821330622","SANTA FE",20,0,3,17,0,20,0
"821120212","SANTA FE",38,0,2,35,0,37,0
"820630710","SANTA FE",275,267,1,7,0,8,0.970909090909091
"820980308","SANTA FE",43,0,18,22,2,42,0
"820980111","SANTA FE",39,0,7,27,1,35,0
"820910412","SANTA FE",35,0,6,24,4,34,0
"820910111","SANTA FE",88,0,38,34,9,81,0
"820847707","SANTA FE",4,0,4,0,0,4,0
"820847502","SANTA FE",12,0,1,10,0,11,0
"820490328","SANTA FE",113,6,40,40,12,92,0.0530973451327434
"820630309","SANTA FE",325,3,186,122,7,315,0.00923076923076923
"821330515","SANTA FE",22,0,5,10,2,17,0
"821330503","SANTA FE",9,0,1,4,0,5,0
"820845804","SANTA FE",31,0,14,17,0,31,0
"820700606","SANTA FE",74,0,17,56,1,74,0
"821330317","SANTA FE",20,0,6,7,0,13,0
"820910204","SANTA FE",61,0,23,34,1,58,0
"821330527","SANTA FE",19,0,0,17,0,17,0
"821330526","SANTA FE",13,0,6,5,1,12,0
"820210323","SANTA FE",37,0,19,16,0,35,0
"820350102","SANTA FE",249,0,135,92,10,237,0
"820140414","SANTA FE",5,0,3,2,0,5,0
"820630612","SANTA FE",250,28,130,90,0,220,0.112
"820421102","SANTA FE",20,0,8,11,0,19,0
"820210132","SANTA FE",84,1,23,52,7,82,0.0119047619047619
"820420321","SANTA FE",29,0,11,18,0,29,0
"820210117","SANTA FE",82,0,37,41,2,80,0
"820210111","SANTA FE",88,0,31,55,2,88,0
"820210701","SANTA FE",234,0,181,45,6,232,0
"820840213","SANTA FE",14,0,2,11,1,14,0
"820630611","SANTA FE",263,4,120,135,0,255,0.0152091254752852
"820280213","SANTA FE",15,0,7,8,0,15,0
"820350204","SANTA FE",18,0,1,11,2,14,0
"820350104","SANTA FE",9,0,0,9,0,9,0
"820845207","SANTA FE",444,215,28,159,10,197,0.484234234234234
"820560102","SANTA FE",61,1,26,32,1,59,0.0163934426229508
"821330106","SANTA FE",3,0,0,1,2,3,0
"821050106","SANTA FE",24,0,6,17,0,23,0
"820700217","SANTA FE",62,0,36,26,0,62,0
"820490805","SANTA FE",10,0,4,6,0,10,0
"821260214","SANTA FE",38,0,19,17,0,36,0
"820700506","SANTA FE",48,0,21,27,0,48,0
"820210706","SANTA FE",226,1,131,81,5,217,0.00442477876106195
"821120416","SANTA FE",299,161,84,52,0,136,0.538461538461538
"821330533","SANTA FE",341,113,68,150,6,224,0.331378299120235
"820490819","SANTA FE",80,11,17,31,2,50,0.1375
"821260113","SANTA FE",64,0,18,36,5,59,0
"820770405","SANTA FE",5,0,3,1,1,5,0
"820630106","SANTA FE",102,0,24,74,3,101,0
"820700518","SANTA FE",120,6,18,94,1,113,0.05
"820980103","SANTA FE",7,0,1,3,1,5,0
"821120408","SANTA FE",342,233,52,54,1,107,0.681286549707602
"820490401","SANTA FE",42,2,12,18,9,39,0.0476190476190476
"820280115","SANTA FE",13,0,5,8,0,13,0
"820849501","SANTA FE",3,0,3,0,0,3,0
"820845206","SANTA FE",371,227,20,101,22,143,0.611859838274933
"820429101","SANTA FE",15,0,3,12,0,15,0
"820490315","SANTA FE",107,0,16,59,12,87,0
"821050209","SANTA FE",73,4,20,46,1,67,0.0547945205479452
"820847201","SANTA FE",48,16,6,25,1,32,0.333333333333333
"820846901","SANTA FE",64,2,18,42,0,60,0.03125
"820846504","SANTA FE",244,6,122,113,3,238,0.0245901639344262
"820630322","SANTA FE",333,4,105,206,7,318,0.012012012012012
"821190110","SANTA FE",435,6,282,145,0,427,0.0137931034482759
"820560112","SANTA FE",141,0,94,45,0,139,0
"820140516","SANTA FE",23,0,11,11,1,23,0
"820490308","SANTA FE",750,27,162,418,52,632,0.036
"820490803","SANTA FE",126,63,4,32,23,59,0.5
"820210212","SANTA FE",428,83,133,201,3,337,0.19392523364486
"820980117","SANTA FE",55,0,25,25,1,51,0
"820350108","SANTA FE",100,0,15,54,12,81,0
"820840201","SANTA FE",223,2,43,165,1,209,0.00896860986547085
"820630214","SANTA FE",76,0,44,29,2,75,0
"820700512","SANTA FE",256,133,40,79,3,122,0.51953125
"820070209","SANTA FE",98,1,38,57,1,96,0.0102040816326531
"820350209","SANTA FE",325,0,77,215,11,303,0
"820490120","SANTA FE",16,0,3,7,0,10,0
"820700102","SANTA FE",92,0,22,68,1,91,0
"820632825","SANTA FE",163,2,103,57,0,160,0.0122699386503067
"821330619","SANTA FE",610,509,54,45,0,99,0.834426229508197
"821330620","SANTA FE",510,112,94,255,14,363,0.219607843137255
"821330413","SANTA FE",307,37,101,155,2,258,0.120521172638436
"821330219","SANTA FE",264,0,46,174,29,249,0
"821260208","SANTA FE",490,320,97,71,1,169,0.653061224489796
"821260207","SANTA FE",400,267,83,48,0,131,0.6675
"821260202","SANTA FE",331,3,206,122,0,328,0.00906344410876133
"821191007","SANTA FE",399,305,31,60,0,91,0.764411027568922
"821191002","SANTA FE",221,221,0,0,0,0,1
"821190906","SANTA FE",518,144,167,201,0,368,0.277992277992278
"821190905","SANTA FE",216,9,66,137,2,205,0.0416666666666667
"820980118","SANTA FE",422,53,203,159,2,364,0.125592417061611
"820910605","SANTA FE",273,5,233,32,1,266,0.0183150183150183
"820910302","SANTA FE",303,161,108,21,7,136,0.531353135313531
"820849002","SANTA FE",523,1,294,214,3,511,0.00191204588910134
"820848909","SANTA FE",432,353,5,35,2,42,0.81712962962963
"820848503","SANTA FE",317,22,59,233,0,292,0.0694006309148265
"820848416","SANTA FE",78,2,4,53,3,60,0.0256410256410256
"820848006","SANTA FE",214,214,0,0,0,0,1
"820848002","SANTA FE",361,330,23,8,0,31,0.914127423822715
"820848014","SANTA FE",249,201,1,0,0,1,0.807228915662651
"820847714","SANTA FE",234,223,7,2,0,9,0.952991452991453
"820847503","SANTA FE",135,0,62,72,0,134,0
"820847204","SANTA FE",199,157,20,20,0,40,0.78894472361809
"820846503","SANTA FE",576,13,264,295,1,560,0.0225694444444444
"820846904","SANTA FE",585,12,223,338,5,566,0.0205128205128205
"820845311","SANTA FE",223,219,4,0,0,4,0.982062780269058
"820843605","SANTA FE",164,163,1,0,0,1,0.99390243902439
"820840208","SANTA FE",454,13,315,124,2,441,0.0286343612334802
"820840501","SANTA FE",420,304,45,71,0,116,0.723809523809524
"820700706","SANTA FE",240,139,68,33,0,101,0.579166666666667
"820700601","SANTA FE",515,3,302,204,0,506,0.0058252427184466
"820840205","SANTA FE",265,3,107,153,0,260,0.0113207547169811
"820700307","SANTA FE",252,240,8,4,0,12,0.952380952380952
"820632616","SANTA FE",292,9,30,236,5,271,0.0308219178082192
"820630405","SANTA FE",99,1,2,80,9,91,0.0101010101010101
"820630407","SANTA FE",331,23,83,197,15,295,0.0694864048338369
"820633112","SANTA FE",358,112,125,115,2,242,0.312849162011173
"820560311","SANTA FE",541,337,66,133,1,200,0.622920517560074
"820560214","SANTA FE",147,2,65,79,0,144,0.0136054421768707
"820490914","SANTA FE",303,197,64,33,8,105,0.65016501650165
"820491002","SANTA FE",260,256,2,2,0,4,0.984615384615385
"821190902","SANTA FE",260,9,57,177,8,242,0.0346153846153846
"821190515","SANTA FE",540,5,187,323,10,520,0.00925925925925926
"821120402","SANTA FE",253,88,65,100,0,165,0.347826086956522
"821120217","SANTA FE",270,0,74,182,13,269,0
"821120205","SANTA FE",169,2,55,74,26,155,0.0118343195266272
"821050513","SANTA FE",417,1,214,198,3,415,0.00239808153477218
"820842905","SANTA FE",379,378,1,0,0,1,0.997361477572559
"821050508","SANTA FE",306,0,132,164,4,300,0
"821050502","SANTA FE",356,4,202,145,4,351,0.0112359550561798
"821050229","SANTA FE",223,180,17,26,0,43,0.807174887892377
"821050222","SANTA FE",380,174,65,136,5,206,0.457894736842105
"821050116","SANTA FE",278,1,149,125,1,275,0.00359712230215827
"820490512","SANTA FE",309,266,15,27,0,42,0.86084142394822
"820490515","SANTA FE",293,239,25,27,1,53,0.815699658703072
"820280207","SANTA FE",287,1,98,186,0,284,0.00348432055749129
"820490611","SANTA FE",290,269,0,0,0,0,0.927586206896552
"820844805","SANTA FE",280,243,17,17,1,35,0.867857142857143
"820844802","SANTA FE",392,340,7,33,2,42,0.86734693877551
"820844801","SANTA FE",539,479,10,40,2,52,0.888682745825603
"820844715","SANTA FE",255,207,9,35,0,44,0.811764705882353
"820844710","SANTA FE",428,271,44,100,0,144,0.633177570093458
"820844521","SANTA FE",191,167,17,6,0,23,0.87434554973822
"820844508","SANTA FE",241,231,4,5,0,9,0.95850622406639
"820841818","SANTA FE",280,280,0,0,0,0,1
"820844501","SANTA FE",263,219,14,30,0,44,0.832699619771863
"820844306","SANTA FE",256,250,5,1,0,6,0.9765625
"820844207","SANTA FE",374,288,25,54,3,82,0.770053475935829
"820844112","SANTA FE",295,168,22,98,2,122,0.569491525423729
"820844103","SANTA FE",263,246,5,8,0,13,0.935361216730038
"820844101","SANTA FE",295,275,3,15,0,18,0.932203389830508
"820844010","SANTA FE",301,294,5,1,0,6,0.976744186046512
"820844005","SANTA FE",381,124,17,206,7,230,0.325459317585302
"820844002","SANTA FE",323,322,1,0,0,1,0.996904024767802
"821260206","SANTA FE",225,0,169,36,14,219,0
"820980120","SANTA FE",252,44,155,53,0,208,0.174603174603175
"820980119","SANTA FE",280,7,81,171,11,263,0.025
"820843806","SANTA FE",298,298,0,0,0,0,1
"820843711","SANTA FE",242,241,1,0,0,1,0.995867768595041
"820843706","SANTA FE",352,351,1,0,0,1,0.997159090909091
"820843204","SANTA FE",327,301,12,13,1,26,0.920489296636086
"820847402","SANTA FE",267,0,135,129,3,267,0
"820846704","SANTA FE",273,0,152,121,0,273,0
"820842307","SANTA FE",319,319,0,0,0,0,1
"820844803","SANTA FE",363,323,14,22,1,37,0.889807162534435
"820843115","SANTA FE",257,216,23,18,0,41,0.840466926070039
"821190105","SANTA FE",456,359,43,49,1,93,0.787280701754386
"820843812","SANTA FE",243,234,6,1,0,7,0.962962962962963
"820842920","SANTA FE",222,220,2,0,0,2,0.990990990990991
"820843007","SANTA FE",438,241,53,137,0,190,0.550228310502283
"820841307","SANTA FE",196,159,5,29,0,34,0.811224489795918
"820840601","SANTA FE",245,238,1,6,0,7,0.971428571428571
"820842017","SANTA FE",118,115,0,0,0,0,0.974576271186441
"820840211","SANTA FE",309,4,135,157,4,296,0.0129449838187702
"820770402","SANTA FE",193,2,127,54,8,189,0.0103626943005181
"820633508","SANTA FE",318,317,1,0,0,1,0.99685534591195
"820633503","SANTA FE",236,180,14,39,1,54,0.76271186440678
"820842912","SANTA FE",269,268,1,0,0,1,0.996282527881041
"820842908","SANTA FE",305,303,2,0,0,2,0.99344262295082
"820842907","SANTA FE",303,303,0,0,0,0,1
"820700207","SANTA FE",192,0,109,83,0,192,0
"820700203","SANTA FE",89,4,64,18,1,83,0.0449438202247191
"820700101","SANTA FE",288,0,151,129,1,281,0
"820842609","SANTA FE",146,146,0,0,0,0,1
"820490201","SANTA FE",261,98,80,63,12,155,0.375478927203065
"820421103","SANTA FE",115,3,51,58,0,109,0.0260869565217391
"820842506","SANTA FE",343,343,0,0,0,0,1
"820842504","SANTA FE",172,107,18,42,2,62,0.622093023255814
"820842008","SANTA FE",227,227,0,0,0,0,1
"820842015","SANTA FE",128,128,0,0,0,0,1
"820630319","SANTA FE",474,0,212,254,1,467,0
"820842803","SANTA FE",187,183,1,0,0,1,0.978609625668449
"820630215","SANTA FE",78,1,33,43,1,77,0.0128205128205128
"820842714","SANTA FE",231,229,2,0,0,2,0.991341991341991
"820560206","SANTA FE",339,290,11,29,7,47,0.855457227138643
"820842202","SANTA FE",260,230,0,0,0,0,0.884615384615385
"820842115","SANTA FE",197,197,0,0,0,0,1
"820842112","SANTA FE",149,135,0,0,0,0,0.906040268456376
"820280316","SANTA FE",229,0,120,108,1,229,0
"820211004","SANTA FE",44,0,20,21,2,43,0
"820210801","SANTA FE",202,201,1,0,0,1,0.995049504950495
"820210703","SANTA FE",45,0,35,9,1,45,0
"820842207","SANTA FE",334,334,0,0,0,0,1
"820841408","SANTA FE",306,297,6,2,0,8,0.970588235294118
"820841205","SANTA FE",308,18,87,192,0,279,0.0584415584415584
"820841114","SANTA FE",339,86,74,148,0,222,0.253687315634218
"820843612","SANTA FE",626,620,2,0,0,2,0.990415335463259
"820140404","SANTA FE",328,28,71,227,0,298,0.0853658536585366
"820843502","SANTA FE",151,42,6,99,0,105,0.278145695364238
"820841204","SANTA FE",381,206,71,98,1,170,0.540682414698163
"820841201","SANTA FE",433,51,111,263,2,376,0.117782909930716
"820843415","SANTA FE",316,85,59,167,4,230,0.268987341772152
"820843413","SANTA FE",174,165,6,2,1,9,0.948275862068966
"820843401","SANTA FE",306,99,30,157,1,188,0.323529411764706
"820841923","SANTA FE",157,157,0,0,0,0,1
"820843606","SANTA FE",163,163,0,0,0,0,1
"820843317","SANTA FE",423,12,32,368,3,403,0.0283687943262411
"820845004","SANTA FE",388,277,60,49,1,110,0.713917525773196
"820631608","SANTA FE",373,330,8,34,0,42,0.884718498659517
"820844915","SANTA FE",306,8,93,171,2,266,0.0261437908496732
"820843402","SANTA FE",381,51,48,265,1,314,0.133858267716535
"820844906","SANTA FE",204,25,45,131,2,178,0.122549019607843
"820842404","SANTA FE",320,319,1,0,0,1,0.996875
"820845108","SANTA FE",380,285,15,78,0,93,0.75
"820845101","SANTA FE",380,346,11,19,1,31,0.910526315789474
"820844806","SANTA FE",269,207,25,33,1,59,0.769516728624535
"820210510","SANTA FE",207,205,2,0,0,2,0.990338164251208
"820210509","SANTA FE",251,251,0,0,0,0,1
"820210504","SANTA FE",277,243,13,10,5,28,0.877256317689531
"820210317","SANTA FE",373,0,230,136,4,370,0
"820210309","SANTA FE",10,0,7,3,0,10,0
"820210211","SANTA FE",309,277,14,17,0,31,0.896440129449838
"820210203","SANTA FE",389,382,4,3,0,7,0.982005141388175
"820848815","SANTA FE",262,3,112,146,0,258,0.0114503816793893
"820140408","SANTA FE",377,24,120,223,2,345,0.0636604774535809
"820848814","SANTA FE",269,4,139,126,0,265,0.0148698884758364
"820210419","SANTA FE",404,3,113,267,12,392,0.00742574257425743
"820210411","SANTA FE",315,304,9,2,0,11,0.965079365079365
"820210410","SANTA FE",160,159,1,0,0,1,0.99375
"820848804","SANTA FE",304,257,29,17,0,46,0.845394736842105
"820842313","SANTA FE",322,316,2,0,0,2,0.981366459627329
"821050420","SANTA FE",272,259,6,7,0,13,0.952205882352941
"820848801","SANTA FE",394,0,112,280,2,394,0
"820848712","SANTA FE",246,139,34,70,0,104,0.565040650406504
"820140524","SANTA FE",174,0,68,103,2,173,0
"820845911","SANTA FE",410,3,238,157,1,396,0.00731707317073171
"820845802","SANTA FE",453,4,205,237,2,444,0.00883002207505519
"820848704","SANTA FE",395,392,1,2,0,3,0.992405063291139
"820421016","SANTA FE",443,32,165,205,10,380,0.072234762979684
"820421014","SANTA FE",228,158,21,46,1,68,0.692982456140351
"820140510","SANTA FE",358,204,100,53,0,153,0.569832402234637
"820140208","SANTA FE",263,255,2,1,0,3,0.96958174904943
"820420910","SANTA FE",194,194,0,0,0,0,1
"820420925","SANTA FE",293,275,5,13,0,18,0.938566552901024
"820420907","SANTA FE",400,363,10,22,1,33,0.9075
"820420806","SANTA FE",364,362,2,0,0,2,0.994505494505495
"820420805","SANTA FE",410,407,2,1,0,3,0.992682926829268
"820420803","SANTA FE",241,241,0,0,0,0,1
"820420802","SANTA FE",364,363,1,0,0,1,0.997252747252747
"820420801","SANTA FE",297,268,20,7,2,29,0.902356902356902
"820420716","SANTA FE",441,172,167,96,0,263,0.390022675736961
"820420713","SANTA FE",247,247,0,0,0,0,1
"820420706","SANTA FE",387,357,21,3,0,24,0.922480620155039
"820140410","SANTA FE",285,117,24,143,0,167,0.410526315789474
"820140403","SANTA FE",346,44,83,219,0,302,0.127167630057803
"820140307","SANTA FE",473,400,10,61,0,71,0.845665961945032
"820140304","SANTA FE",213,212,0,0,0,0,0.995305164319249
"820140219","SANTA FE",261,239,8,11,0,19,0.915708812260536
"820420416","SANTA FE",200,155,29,14,0,43,0.775
"820420407","SANTA FE",238,193,30,15,0,45,0.810924369747899
"820420403","SANTA FE",473,147,104,210,3,317,0.310782241014799
"820848811","SANTA FE",467,206,142,118,0,260,0.441113490364026
"820848606","SANTA FE",484,418,33,32,0,65,0.863636363636364
"820848603","SANTA FE",335,286,33,16,0,49,0.853731343283582
"820630709","SANTA FE",249,238,11,0,0,11,0.955823293172691
"820420314","SANTA FE",315,6,193,107,4,304,0.019047619047619
"820420313","SANTA FE",552,0,269,251,4,524,0
"820420309","SANTA FE",157,0,67,82,4,153,0
"821050409","SANTA FE",351,350,0,1,0,1,0.997150997150997
"821050408","SANTA FE",250,239,0,0,0,0,0.956
"820070304","SANTA FE",353,320,18,15,0,33,0.906515580736544
"820070303","SANTA FE",376,267,62,46,0,108,0.710106382978723
"820070203","SANTA FE",304,276,11,17,0,28,0.907894736842105
"820070202","SANTA FE",379,269,45,61,1,107,0.70976253298153
"820420215","SANTA FE",448,2,212,224,6,442,0.00446428571428571
"820842612","SANTA FE",173,171,0,0,0,0,0.988439306358382
"820842409","SANTA FE",330,329,1,0,0,1,0.996969696969697
"820070406","SANTA FE",297,222,32,40,1,73,0.747474747474748
"820630706","SANTA FE",470,464,3,3,0,6,0.987234042553191
"820848510","SANTA FE",421,326,17,49,0,66,0.774346793349169
"820140112","SANTA FE",410,2,144,262,0,406,0.0048780487804878
"820140106","SANTA FE",371,1,200,169,0,369,0.00269541778975741
"820140101","SANTA FE",428,9,224,189,5,418,0.0210280373831776
"820070414","SANTA FE",315,260,28,22,1,51,0.825396825396825
"820070308","SANTA FE",262,106,86,61,6,153,0.404580152671756
"820420121","SANTA FE",98,0,46,34,9,89,0
"820420112","SANTA FE",309,8,206,95,0,301,0.0258899676375405
"820420109","SANTA FE",411,5,294,112,0,406,0.0121654501216545
"820420107","SANTA FE",322,3,194,96,0,290,0.0093167701863354
"820420102","SANTA FE",226,0,109,106,1,216,0
"820630704","SANTA FE",427,411,5,11,0,16,0.962529274004684
"820848410","SANTA FE",557,409,12,134,0,146,0.734290843806104
"820280408","SANTA FE",253,234,0,1,0,1,0.924901185770751
"820840517","SANTA FE",355,326,17,11,0,28,0.91830985915493
"820631307","SANTA FE",261,5,76,179,1,256,0.0191570881226054
"820420206","SANTA FE",338,0,90,206,16,312,0
"821050316","SANTA FE",322,112,104,102,2,208,0.347826086956522
"820631101","SANTA FE",397,19,46,316,8,370,0.0478589420654912
"820631011","SANTA FE",381,251,94,36,0,130,0.658792650918635
"820631006","SANTA FE",257,9,119,127,1,247,0.0350194552529183
"820630908","SANTA FE",366,349,11,5,0,16,0.953551912568306
"820630814","SANTA FE",225,214,5,4,0,9,0.951111111111111
"820630813","SANTA FE",219,195,7,9,0,16,0.89041095890411
"820631009","SANTA FE",347,16,73,255,0,328,0.0461095100864553
"820630807","SANTA FE",229,222,6,1,0,7,0.96943231441048
"820630713","SANTA FE",324,311,10,3,0,13,0.959876543209877
"820350112","SANTA FE",240,0,74,141,8,223,0
"820630602","SANTA FE",319,5,97,215,0,312,0.0156739811912226
"820630509","SANTA FE",581,11,49,499,9,557,0.0189328743545611
"820840512","SANTA FE",181,139,25,14,0,39,0.767955801104972
"820840418","SANTA FE",136,115,16,5,0,21,0.845588235294118
"820841812","SANTA FE",226,226,0,0,0,0,1
"820630504","SANTA FE",321,6,80,224,4,308,0.0186915887850467
"820840502","SANTA FE",876,742,79,45,0,124,0.84703196347032
"821050313","SANTA FE",210,154,31,24,0,55,0.733333333333333
"820560105","SANTA FE",373,2,208,154,2,364,0.00536193029490617
"820280514","SANTA FE",347,316,7,17,0,24,0.910662824207493
"820280201","SANTA FE",592,5,268,313,2,583,0.00844594594594595
"820280412","SANTA FE",357,351,2,3,0,5,0.983193277310924
"821050309","SANTA FE",17,11,3,3,0,6,0.647058823529412
"820630412","SANTA FE",560,559,1,0,0,1,0.998214285714286
"821190301","SANTA FE",68,2,22,42,0,64,0.0294117647058824
"820630221","SANTA FE",491,133,161,188,0,349,0.270875763747454
"820280319","SANTA FE",152,1,134,17,0,151,0.00657894736842105
"821260503","SANTA FE",384,311,47,9,0,56,0.809895833333333
"821260319","SANTA FE",358,214,87,54,2,143,0.597765363128492
"820910319","SANTA FE",279,106,142,30,0,172,0.379928315412186
"821260410","SANTA FE",278,264,9,5,0,14,0.949640287769784
"820633410","SANTA FE",250,5,81,153,3,237,0.02
"820848306","SANTA FE",294,260,25,9,0,34,0.884353741496599
"820490907","SANTA FE",239,169,54,14,0,68,0.707112970711297
"820700504","SANTA FE",200,151,25,19,2,46,0.755
"820700416","SANTA FE",440,303,81,54,0,135,0.688636363636364
"820700410","SANTA FE",550,199,178,170,0,348,0.361818181818182
"820700409","SANTA FE",255,253,0,2,0,2,0.992156862745098
"820700406","SANTA FE",312,5,197,108,0,305,0.016025641025641
"820700403","SANTA FE",393,93,158,142,0,300,0.236641221374046
"820633215","SANTA FE",225,207,18,0,0,18,0.92
"820633214","SANTA FE",287,230,0,27,0,27,0.801393728222996
"820633211","SANTA FE",396,12,125,247,3,375,0.0303030303030303
"820490713","SANTA FE",209,209,0,0,0,0,1
"820490709","SANTA FE",419,416,2,1,0,3,0.992840095465394
"820848307","SANTA FE",290,255,22,13,0,35,0.879310344827586
"820630212","SANTA FE",394,0,305,88,0,393,0
"820490715","SANTA FE",486,248,60,170,2,232,0.510288065843621
"820490714","SANTA FE",235,183,46,5,0,51,0.778723404255319
"820633011","SANTA FE",357,335,14,8,0,22,0.938375350140056
"820633008","SANTA FE",468,461,2,4,0,6,0.985042735042735
"820630126","SANTA FE",515,2,241,260,7,508,0.00388349514563107
"820280301","SANTA FE",601,118,76,333,22,431,0.196339434276206
"820632818","SANTA FE",263,1,83,168,5,256,0.00380228136882129
"820070402","SANTA FE",198,188,0,9,1,10,0.94949494949495
"820632815","SANTA FE",164,1,47,108,0,155,0.00609756097560976
"820490331","SANTA FE",327,296,19,12,0,31,0.90519877675841
"820632710","SANTA FE",469,284,69,115,0,184,0.605543710021322
"820632601","SANTA FE",572,25,59,457,10,526,0.0437062937062937
"820632508","SANTA FE",199,198,1,0,0,1,0.994974874371859
"820632506","SANTA FE",278,111,44,116,1,161,0.399280575539568
"820632505","SANTA FE",177,176,0,1,0,1,0.994350282485876
"820632501","SANTA FE",206,128,32,44,1,77,0.621359223300971
"820632414","SANTA FE",231,231,0,0,0,0,1
"820840906","SANTA FE",284,279,5,0,0,5,0.982394366197183
"820840905","SANTA FE",327,326,1,0,0,1,0.996941896024465
"820632513","SANTA FE",228,221,5,2,0,7,0.969298245614035
"820632403","SANTA FE",299,298,1,0,0,1,0.996655518394649
"820632314","SANTA FE",305,287,7,0,0,7,0.940983606557377
"820840911","SANTA FE",207,203,4,0,0,4,0.980676328502415
"820841312","SANTA FE",246,222,16,7,1,24,0.902439024390244
"820490302","SANTA FE",354,195,87,62,3,152,0.550847457627119
"820632305","SANTA FE",251,249,2,0,0,2,0.99203187250996
"820632213","SANTA FE",240,240,0,0,0,0,1
"820632202","SANTA FE",241,241,0,0,0,0,1
"820632104","SANTA FE",462,459,1,1,0,2,0.993506493506494
"820632103","SANTA FE",289,288,0,0,0,0,0.996539792387543
"820630615","SANTA FE",282,267,6,6,0,12,0.946808510638298
"820631912","SANTA FE",282,281,0,1,0,1,0.99645390070922
"820631910","SANTA FE",420,5,67,335,5,407,0.0119047619047619
"820631901","SANTA FE",330,37,95,194,3,292,0.112121212121212
"820631811","SANTA FE",369,365,3,1,0,4,0.989159891598916
"820631806","SANTA FE",261,259,2,0,0,2,0.992337164750958
"820631804","SANTA FE",283,279,2,2,0,4,0.985865724381625
"820631803","SANTA FE",324,323,1,0,0,1,0.996913580246914
"820631710","SANTA FE",291,289,0,1,0,1,0.993127147766323
"820631709","SANTA FE",281,280,1,0,0,1,0.99644128113879
"820631813","SANTA FE",178,178,0,0,0,0,1
"820631316","SANTA FE",398,237,55,106,0,161,0.595477386934673
"820631315","SANTA FE",362,329,23,9,1,33,0.908839779005525
"820631302","SANTA FE",356,9,131,216,0,347,0.0252808988764045
"820631311","SANTA FE",266,200,36,30,0,66,0.75187969924812
"820631211","SANTA FE",316,143,107,57,0,164,0.45253164556962
"820840723","SANTA FE",289,239,26,24,0,50,0.826989619377163
"820700712","SANTA FE",348,111,111,122,1,234,0.318965517241379
"820840718","SANTA FE",382,274,16,87,0,103,0.717277486910995
"820840709","SANTA FE",525,493,21,10,0,31,0.939047619047619
"820630105","SANTA FE",386,1,258,122,1,381,0.00259067357512953
"820848109","SANTA FE",329,291,28,8,0,36,0.884498480243161
"820560408","SANTA FE",268,265,2,0,0,2,0.988805970149254
"820560405","SANTA FE",412,405,5,1,1,7,0.983009708737864
"820848022","SANTA FE",340,320,2,0,0,2,0.941176470588235
"820845702","SANTA FE",273,4,146,121,1,268,0.0146520146520147
"820845706","SANTA FE",112,1,47,64,0,111,0.00892857142857143
"820845705","SANTA FE",334,4,214,116,0,330,0.0119760479041916
"820845505","SANTA FE",420,142,92,169,0,261,0.338095238095238
"820560202","SANTA FE",339,299,12,24,4,40,0.882005899705015
"820845413","SANTA FE",197,192,3,2,0,5,0.974619289340102
"820845412","SANTA FE",329,293,27,9,0,36,0.890577507598784
"820845411","SANTA FE",356,313,20,23,0,43,0.879213483146067
"820845320","SANTA FE",209,209,0,0,0,0,1
"821190909","SANTA FE",248,233,8,6,0,14,0.939516129032258
"821190814","SANTA FE",392,4,202,173,7,382,0.0102040816326531
"821190811","SANTA FE",239,133,52,50,1,103,0.556485355648536
"820841102","SANTA FE",195,17,142,35,0,177,0.0871794871794872
"820841017","SANTA FE",425,42,165,207,0,372,0.0988235294117647
"820841816","SANTA FE",153,148,5,0,0,5,0.967320261437909
"820841011","SANTA FE",572,16,163,364,2,529,0.027972027972028
"820841010","SANTA FE",470,25,146,288,5,439,0.0531914893617021
"820841008","SANTA FE",479,87,162,209,0,371,0.181628392484342
"820421208","SANTA FE",415,6,231,162,9,402,0.0144578313253012
"820847720","SANTA FE",377,372,4,1,0,5,0.986737400530504
"820849012","SANTA FE",325,7,208,110,0,318,0.0215384615384615
"820846311","SANTA FE",565,8,115,392,20,527,0.0141592920353982
"820421113","SANTA FE",265,9,116,140,0,256,0.0339622641509434
"820280102","SANTA FE",238,211,11,16,0,27,0.886554621848739
"820211018","SANTA FE",320,0,180,139,0,319,0
"820846212","SANTA FE",323,21,96,201,0,297,0.065015479876161
"820846204","SANTA FE",280,12,126,126,3,255,0.0428571428571429
"820846203","SANTA FE",192,5,33,149,2,184,0.0260416666666667
"820210812","SANTA FE",198,197,1,0,0,1,0.994949494949495
"820210808","SANTA FE",271,225,23,6,0,29,0.830258302583026
"820210804","SANTA FE",321,313,8,0,0,8,0.975077881619938
"821190415","SANTA FE",419,7,206,164,1,371,0.0167064439140811
"820210721","SANTA FE",248,0,184,58,3,245,0
"820210724","SANTA FE",255,1,191,60,0,251,0.00392156862745098
"820846702","SANTA FE",17,1,7,7,0,14,0.0588235294117647
"821330210","SANTA FE",5,0,2,3,0,5,0
"821330207","SANTA FE",37,0,0,32,1,33,0
"820210319","SANTA FE",68,0,41,22,1,64,0
"821330613","SANTA FE",16,0,13,2,0,15,0
"821330520","SANTA FE",15,0,6,9,0,15,0
"821330316","SANTA FE",17,0,0,15,1,16,0
"821330315","SANTA FE",22,0,2,12,1,15,0
"821330305","SANTA FE",12,0,1,9,0,10,0
"821330214","SANTA FE",40,1,2,29,5,36,0.025
"821330308","SANTA FE",61,0,5,37,5,47,0
"821191005","SANTA FE",281,266,5,9,0,14,0.94661921708185
"821260305","SANTA FE",131,6,50,73,1,124,0.0458015267175573
"821190505","SANTA FE",1,0,1,0,0,1,0
"821120306","SANTA FE",47,0,7,34,5,46,0
"821050228","SANTA FE",379,178,60,124,5,189,0.469656992084433
"821120102","SANTA FE",64,0,24,37,0,61,0
"820980305","SANTA FE",73,0,11,47,4,62,0
"820980112","SANTA FE",48,0,25,20,1,46,0
"820980107","SANTA FE",15,0,8,6,0,14,0
"820847001","SANTA FE",16,8,3,5,0,8,0.5
"820841922","SANTA FE",93,92,1,0,0,1,0.989247311827957
"820980116","SANTA FE",40,0,13,10,5,28,0
"820910105","SANTA FE",131,0,73,42,9,124,0
"820980302","SANTA FE",161,0,41,75,29,145,0
"820700702","SANTA FE",288,178,55,54,0,109,0.618055555555556
"820840101","SANTA FE",186,18,78,86,1,165,0.0967741935483871
"820560314","SANTA FE",89,2,35,46,2,83,0.0224719101123595
"820630308","SANTA FE",275,0,87,178,2,267,0
"820700109","SANTA FE",61,0,9,51,1,61,0
"820420118","SANTA FE",62,1,31,29,0,60,0.0161290322580645
"820630224","SANTA FE",98,0,18,74,1,93,0
"820700105","SANTA FE",104,0,46,50,3,99,0
"820770407","SANTA FE",49,1,25,22,0,47,0.0204081632653061
"820700115","SANTA FE",84,0,30,51,0,81,0
"820700216","SANTA FE",60,0,13,47,0,60,0
"820980204","SANTA FE",23,0,4,18,1,23,0
"820420217","SANTA FE",100,3,34,62,0,96,0.03
"820420120","SANTA FE",52,0,18,30,1,49,0
"820560217","SANTA FE",267,243,5,16,0,21,0.910112359550562
"820490319","SANTA FE",51,0,21,18,4,43,0
"820490913","SANTA FE",222,1,44,134,28,206,0.0045045045045045
"820490316","SANTA FE",12,0,3,6,2,11,0
"821330607","SANTA FE",6,0,4,1,1,6,0
"820844522","SANTA FE",244,234,6,4,0,10,0.959016393442623
"820280116","SANTA FE",21,0,1,16,0,17,0
"820210128","SANTA FE",104,1,46,51,6,103,0.00961538461538462
"820140118","SANTA FE",7,0,3,4,0,7,0
"820490502","SANTA FE",76,0,25,47,3,75,0
"820490321","SANTA FE",31,0,10,11,1,22,0
"820210326","SANTA FE",35,0,13,22,0,35,0
"820490320","SANTA FE",23,0,2,4,6,12,0
"820140124","SANTA FE",29,1,5,22,0,27,0.0344827586206897
"820140121","SANTA FE",45,0,23,22,0,45,0
"820140119","SANTA FE",23,0,10,13,0,23,0
"820350205","SANTA FE",50,0,14,35,1,50,0
"820350101","SANTA FE",101,0,23,52,6,81,0
"820770204","SANTA FE",179,0,52,99,15,166,0
"820700513","SANTA FE",44,1,19,22,0,41,0.0227272727272727
"820490808","SANTA FE",88,0,26,45,2,73,0
"820490416","SANTA FE",196,0,50,89,18,157,0
"820490418","SANTA FE",108,1,31,59,14,104,0.00925925925925926
"820490413","SANTA FE",80,0,17,44,10,71,0
"820490902","SANTA FE",28,0,12,13,2,27,0
