"link","varon","mujer","totalpobl","hogares","viviendasp","viv_part_h"
"068821704",997,1006,2003,485,483,460
"060141201",31,25,56,17,32,17
"060210206",98,79,177,58,76,58
"060070107",104,112,216,64,97,63
"060210609",39,41,80,26,49,26
"060420501",163,134,297,99,163,99
"060421102",259,205,464,158,232,148
"060562708",257,267,524,155,179,149
"060630706",635,660,1295,366,449,357
"060630802",89,73,162,60,85,60
"060700302",126,121,247,81,145,76
"060980403",288,286,574,179,274,172
"060980612",344,351,695,192,207,185
"061051002",75,67,142,52,126,52
"061051201",96,65,161,40,101,38
"061190206",18,23,41,17,41,17
"061190406",59,51,110,39,79,39
"061260917",122,119,241,74,130,61
"061260919",138,126,264,81,122,75
"061340109",344,304,648,163,206,162
"062031601",673,706,1379,428,810,418
"062100501",190,159,349,123,165,112
"062100808",1460,1456,2916,818,730,576
"062100810",682,642,1324,352,395,345
"062310803",330,318,648,229,261,225
"064480101",163,146,309,112,159,110
"062240908",475,540,1015,281,317,270
"062241301",124,93,217,71,112,69
"062310302",37,43,80,25,33,25
"062380702",63,52,115,45,81,45
"062600301",1120,1172,2292,703,752,679
"062660506",154,117,271,76,184,74
"062660601",247,230,477,142,179,129
"062700103",2153,1007,3160,144,189,140
"062701104",185,175,360,111,219,107
"064760705",72,73,145,51,65,51
"063290402",124,95,219,72,121,68
"063360701",88,97,185,62,109,57
"063640205",525,506,1031,318,433,273
"063640504",164,183,347,103,108,99
"064131202",NA,NA,NA,NA,NA,NA
"064131506",26,32,58,7,45,7
"065250303",988,966,1954,449,423,390
"064415703",359,382,741,192,209,188
"064830401",862,920,1782,512,257,177
"064551301",196,183,379,147,260,147
"064620203",12,11,23,7,23,7
"066382102",110,103,213,56,84,55
"064761105",27,25,52,19,40,19
"064830602",213,188,401,119,222,119
"064830906",49,44,93,28,47,28
"067420409",61,53,114,33,40,33
"065250501",1266,934,2200,516,598,498
"065320901",848,886,1734,490,557,448
"065393107",941,913,1854,462,474,438
"065470501",39,37,76,27,36,27
"065952201",116,107,223,71,101,71
"066020304",327,319,646,179,327,175
"066091005",45,30,75,29,50,29
"066382106",29,22,51,16,30,16
"066480316",250,222,472,111,135,110
"066650402",80,85,165,47,109,44
"066791102",68,52,120,41,56,41
"067630703",709,754,1463,353,347,335
"067780301",100,65,165,52,91,52
"067780603",251,228,479,135,159,127
"067980707",294,318,612,178,212,178
"068260706",602,613,1215,383,458,370
"068330802",44,32,76,32,52,31
"068331405",48,55,103,35,50,35
"068680502",684,630,1314,352,393,338
"068680504",301,267,568,194,616,192
"068820702",257,226,483,148,173,141
"060980406",295,241,536,169,253,168
"065681607",334,390,724,254,264,247
"065681608",288,338,626,228,237,217
"065681703",380,411,791,251,250,236
"065681801",238,289,527,229,309,228
"065682010",387,497,884,305,359,297
"065682102",159,163,322,147,303,143
"065682103",153,168,321,150,228,148
"065682108",121,156,277,134,285,134
"065682206",328,337,665,240,291,240
"068050108",285,296,581,163,218,162
"065682302",308,367,675,231,283,226
"065682408",591,708,1299,399,419,379
"065682501",235,268,503,177,183,168
"065682506",712,782,1494,463,431,401
"065682507",748,778,1526,434,406,378
"065682611",558,611,1169,365,380,347
"065682701",26,27,53,15,12,11
"065682706",477,506,983,292,313,279
"066583712",972,979,1951,512,543,508
"065682802",551,635,1186,367,390,348
"065682803",856,882,1738,500,523,481
"065682809",638,658,1296,373,376,344
"065682901",534,606,1140,338,349,325
"065683001",637,650,1287,376,366,351
"065683105",622,655,1277,344,347,327
"065683106",589,658,1247,322,310,280
"065683108",337,360,697,225,239,218
"065683109",563,585,1148,328,323,291
"065683112",649,691,1340,384,326,298
"065740412",395,410,805,275,316,269
"065810105",566,658,1224,420,460,399
"065810106",275,327,602,243,283,228
"065810303",413,440,853,294,355,293
"065810407",297,336,633,214,269,208
"068051605",426,437,863,281,301,272
"065811707",285,389,674,216,339,214
"065811711",370,390,760,264,350,262
"065811304",478,525,1003,275,292,269
"065811501",224,251,475,126,121,116
"065811511",319,382,701,281,341,266
"065811704",204,275,479,189,229,187
"065880114",329,339,668,247,270,232
"065880201",460,535,995,342,393,340
"065880901",397,451,848,266,328,262
"065880902",492,556,1048,342,377,333
"065880906",177,175,352,122,192,122
"065880907",323,308,631,190,219,180
"065950603",151,150,301,109,147,81
"065951605",59,56,115,38,122,38
"065881705",355,471,826,322,377,311
"065950212",283,367,650,255,348,248
"065950303",319,409,728,300,420,299
"065950311",430,472,902,341,394,331
"065950404",536,556,1092,338,377,330
"065951603",724,688,1412,391,419,385
"065951608",805,838,1643,468,490,458
"065951908",281,268,549,205,230,204
"065951914",457,445,902,350,381,337
"065952501",508,568,1076,367,377,340
"065952712",255,272,527,186,218,184
"066021107",353,425,778,261,291,245
"066021109",615,727,1342,437,471,426
"066090106",285,315,600,217,259,214
"068400508",568,681,1249,433,482,412
"066090902",320,334,654,242,289,242
"066091501",102,93,195,73,125,73
"066091909",403,461,864,255,279,252
"066160305",333,378,711,227,277,226
"066230101",411,428,839,257,272,244
"066230201",326,369,695,258,284,245
"066230203",344,434,778,309,391,305
"066230301",233,267,500,184,238,184
"066230403",333,461,794,301,346,293
"066380214",481,455,936,255,271,247
"066230507",563,725,1288,393,387,373
"067491407",665,678,1343,365,366,356
"066230801",82,86,168,58,100,57
"067491408",626,623,1249,325,332,320
"066231802",187,207,394,125,138,121
"066232003",472,479,951,299,317,294
"066232006",481,489,970,258,272,254
"066232009",612,629,1241,364,369,339
"066232012",286,277,563,158,172,153
"068540102",310,401,711,295,356,289
"066232506",181,156,337,102,139,99
"066232805",400,497,897,341,381,328
"066232809",558,626,1184,371,393,346
"066380211",735,783,1518,472,477,422
"066232812",592,619,1211,379,414,355
"066232813",737,813,1550,449,459,430
"066380212",426,401,827,254,301,244
"066380111",1221,1207,2428,645,735,575
"066380508",540,523,1063,280,258,248
"066380703",635,589,1224,314,304,275
"066380713",563,558,1121,281,316,279
"066380801",344,368,712,227,349,225
"066381002",559,613,1172,331,321,313
"066381005",395,419,814,270,277,256
"066381006",813,846,1659,440,396,374
"066381803",779,778,1557,395,366,360
"066381110",923,913,1836,461,473,440
"066381303",504,511,1015,264,294,249
"066381403",903,874,1777,429,431,398
"066510111",197,219,416,182,223,181
"066381511",549,586,1135,275,418,270
"066381611",551,620,1171,357,394,349
"066381713",490,575,1065,413,522,403
"066440106",72,73,145,52,268,52
"066382304",399,370,769,205,308,202
"066440105",39,44,83,33,375,32
"066440107",78,75,153,48,274,47
"066440111",48,53,101,29,265,26
"066440208",93,104,197,80,390,79
"066440301",392,360,752,234,292,226
"066440408",39,39,78,35,353,35
"066440612",547,517,1064,294,317,274
"066480114",865,928,1793,458,473,433
"066480210",800,762,1562,407,412,385
"066480212",651,648,1299,364,397,352
"066480305",458,508,966,257,236,221
"066480306",550,542,1092,291,305,271
"066480313",294,294,588,178,318,176
"066480403",690,645,1335,309,328,294
"066480410",63,55,118,43,72,43
"066480513",822,892,1714,445,443,417
"066480514",464,514,978,296,306,291
"066510110",285,341,626,277,349,273
"066580108",330,360,690,252,284,249
"066550303",74,51,125,43,143,43
"066580101",3,2,5,2,2,2
"066580105",380,469,849,307,330,305
"066580106",421,509,930,319,344,307
"066580110",887,889,1776,508,474,436
"066580205",410,383,793,231,216,205
"066580311",350,396,746,259,284,252
"066580401",274,277,551,187,221,177
"066580409",406,511,917,345,349,315
"066580410",406,480,886,326,346,300
"066580505",353,396,749,229,246,226
"066580612",362,422,784,282,304,277
"066580510",233,274,507,180,184,171
"066580602",344,371,715,275,347,269
"066580611",464,556,1020,346,365,323
"066580701",327,391,718,263,312,250
"066580806",215,254,469,205,295,204
"066580807",232,288,520,208,276,193
"066580812",154,236,390,218,378,217
"066580904",67,69,136,53,85,53
"066581010",357,445,802,288,332,275
"066581109",363,430,793,301,339,283
"066581111",359,336,695,234,262,226
"066581112",363,399,762,286,336,276
"066581509",496,550,1046,348,387,337
"066581607",318,327,645,231,266,225
"066581802",227,263,490,150,167,146
"066581809",385,442,827,310,371,288
"066581810",340,408,748,211,263,209
"066581905",294,301,595,207,253,205
"066581909",304,350,654,241,265,233
"066582305",468,522,990,329,375,324
"066582306",320,345,665,213,232,198
"066582409",365,371,736,270,305,261
"066582510",455,552,1007,354,364,324
"066582716",379,403,782,217,197,178
"066582902",374,403,777,273,250,214
"066582912",768,845,1613,452,459,429
"066583010",630,650,1280,351,302,283
"066583011",679,729,1408,397,379,362
"066583209",241,243,484,148,148,139
"066583206",194,189,383,107,97,94
"066583211",328,394,722,195,182,178
"066583212",815,874,1689,516,535,502
"066583213",547,572,1119,315,315,309
"066583309",641,720,1361,430,386,372
"066583313",520,484,1004,276,315,265
"066583510",902,886,1788,468,413,393
"066583605",518,619,1137,345,311,290
"066583611",792,867,1659,466,459,445
"066583701",972,975,1947,491,486,456
"066583713",1013,982,1995,524,475,455
"066583804",708,710,1418,367,319,296
"066583809",429,427,856,221,206,196
"066583909",426,421,847,240,248,237
"066584104",815,864,1679,466,420,401
"066584114",577,575,1152,320,286,270
"066584211",397,455,852,276,260,231
"066584408",707,729,1436,432,427,397
"066650311",63,57,120,33,33,32
"066651007",534,520,1054,328,350,317
"066721205",416,484,900,347,413,344
"066860107",288,363,651,237,297,234
"066860110",483,521,1004,347,386,341
"066861101",440,461,901,321,377,320
"066930311",628,642,1270,396,422,390
"066930319",537,553,1090,281,306,279
"067001004",4,5,9,4,76,3
"067070107",319,397,716,278,341,272
"067070109",349,408,757,303,370,300
"067070113",454,441,895,244,275,238
"067070604",192,223,415,157,205,155
"067071103",383,393,776,248,298,243
"067140603",193,199,392,136,142,124
"067210101",317,336,653,227,264,205
"067210207",397,432,829,272,303,271
"067280101",493,508,1001,305,344,293
"067281009",268,277,545,182,203,177
"067281016",248,312,560,207,240,202
"067490301",465,546,1011,319,391,310
"067350103",405,409,814,256,282,242
"067350108",268,361,629,234,279,226
"067350702",668,638,1306,345,399,333
"067350709",474,522,996,316,350,309
"067420701",24,27,51,19,27,18
"067490102",767,733,1500,378,317,310
"067490204",448,543,991,354,379,346
"067490208",492,531,1023,297,374,294
"067490402",183,177,360,98,50,38
"067490403",241,350,591,228,269,222
"067490404",328,541,869,317,426,314
"067490504",321,404,725,309,391,293
"067490506",235,350,585,303,376,281
"067490509",278,316,594,240,295,233
"067490513",147,198,345,125,188,111
"067490604",310,294,604,216,237,177
"067490803",366,389,755,236,233,209
"067490806",522,502,1024,310,263,237
"067490809",499,542,1041,331,270,245
"067490908",498,563,1061,320,338,296
"067491008",319,353,672,174,190,163
"067491010",359,383,742,227,241,211
"067491104",302,374,676,206,119,109
"067491202",532,583,1115,342,350,321
"067491209",435,434,869,246,236,229
"067491301",739,765,1504,333,272,265
"067491305",816,844,1660,418,388,372
"067491413",609,678,1287,410,420,378
"067491418",240,243,483,156,215,153
"067560507",320,377,697,248,322,246
"067560104",475,520,995,307,316,298
"067560105",453,473,926,275,287,271
"067560110",551,653,1204,404,424,387
"067560113",444,487,931,308,363,302
"067560205",497,521,1018,296,297,248
"067560302",115,162,277,133,314,133
"067560307",349,420,769,400,532,400
"067560801",420,504,924,316,368,314
"067560802",409,480,889,309,316,279
"067560904",480,543,1023,367,404,357
"067560916",423,459,882,287,308,265
"067561007",269,318,587,246,313,245
"067561009",98,153,251,139,208,139
"067600315",299,329,628,278,360,261
"067561101",241,289,530,204,261,203
"067561302",225,282,507,193,221,191
"067561404",346,369,715,238,234,221
"067561409",761,842,1603,405,370,346
"067561411",653,666,1319,319,266,262
"067561609",456,463,919,304,301,278
"067561510",484,525,1009,303,354,294
"067561511",600,649,1249,331,387,323
"067561707",507,526,1033,357,377,332
"067561709",581,633,1214,398,454,371
"067561801",370,401,771,269,290,257
"067561809",257,308,565,229,279,227
"067561904",312,332,644,224,244,221
"067561905",648,690,1338,431,449,412
"067561910",401,452,853,288,301,278
"067562111",421,545,966,290,335,283
"067562006",274,318,592,194,199,176
"067562108",602,647,1249,332,396,329
"067562208",377,419,796,230,227,206
"067562211",553,545,1098,351,388,333
"067562412",576,682,1258,423,428,398
"067562503",254,291,545,208,226,201
"067562514",367,449,816,295,327,273
"067562517",335,413,748,261,296,258
"067562518",559,606,1165,396,428,381
"067562609",334,357,691,229,234,212
"060210601",185,170,355,123,155,121
"067600112",332,405,737,225,258,222
"067600113",457,517,974,311,376,300
"067600117",302,356,658,220,262,213
"067600202",541,592,1133,410,439,394
"067600209",192,239,431,166,247,165
"067600214",222,269,491,231,318,226
"067600217",170,235,405,219,275,194
"067600301",290,313,603,214,209,198
"067600305",558,617,1175,368,404,332
"067600307",126,135,261,97,122,84
"067600308",340,407,747,266,330,261
"067600401",424,423,847,223,233,202
"067600808",334,381,715,214,238,206
"067600802",689,757,1446,465,487,419
"067600807",854,925,1779,495,554,480
"067600809",543,574,1117,368,393,337
"067600904",361,413,774,265,292,253
"067600906",251,318,569,219,287,213
"067600915",318,342,660,184,204,172
"067600916",430,445,875,263,259,238
"067601003",321,316,637,185,177,173
"067601011",220,223,443,120,128,117
"067601208",506,506,1012,234,262,228
"067601211",569,581,1150,295,335,293
"067601213",9,8,17,7,251,4
"067601217",842,813,1655,401,352,343
"067601303",252,312,564,164,179,157
"067601304",399,395,794,230,211,200
"067601405",635,638,1273,295,303,290
"067601408",540,542,1082,297,304,257
"067601504",456,473,929,250,219,208
"067601506",474,458,932,223,198,191
"067601507",561,613,1174,314,310,301
"067601508",675,658,1333,364,323,311
"067601510",428,408,836,202,179,178
"067601801",589,633,1222,292,285,274
"067601804",857,835,1692,439,329,314
"067601810",547,550,1097,291,292,276
"067630102",408,459,867,328,353,312
"067630113",409,444,853,286,328,275
"067630114",368,417,785,269,295,266
"067630303",227,299,526,228,280,226
"067630309",539,626,1165,405,462,396
"067630502",564,544,1108,302,273,259
"067630516",299,366,665,224,256,223
"067630605",536,523,1059,314,337,299
"067630612",483,468,951,257,254,240
"067630704",508,550,1058,309,311,290
"067630710",812,922,1734,418,388,376
"067630810",457,483,940,248,252,237
"067631702",350,415,765,289,302,285
"067631806",345,332,677,201,140,117
"067631809",300,303,603,212,234,211
"067631811",426,435,861,305,313,299
"067700901",317,327,644,197,213,179
"067701009",508,540,1048,335,380,319
"067702212",552,630,1182,326,348,319
"067702102",374,455,829,301,370,301
"067702109",287,366,653,257,331,253
"067702201",567,525,1092,291,286,262
"067780111",88,77,165,53,53,20
"067780208",318,349,667,239,262,233
"067780902",216,211,427,127,199,120
"067780903",480,496,976,262,295,225
"067780908",215,202,417,113,137,111
"067781014",589,575,1164,283,291,275
"067840802",145,150,295,85,108,84
"067840811",548,549,1097,333,359,326
"067910102",209,251,460,178,228,175
"067910103",261,315,576,232,261,228
"067910104",173,227,400,172,232,165
"067910202",400,417,817,304,357,289
"067910407",200,249,449,209,297,204
"067911203",742,729,1471,433,471,428
"067911210",400,501,901,334,369,329
"067911301",887,858,1745,499,555,492
"067911809",358,408,766,265,262,243
"067911902",277,326,603,234,260,230
"067911911",264,345,609,243,337,235
"067912008",279,274,553,171,244,168
"067912203",391,406,797,207,257,206
"067912115",205,196,401,119,192,116
"067912202",282,224,506,148,196,147
"067912208",608,609,1217,403,413,364
"067912216",561,547,1108,311,361,303
"067980701",289,319,608,198,258,198
"068050201",188,183,371,112,139,107
"068050301",123,121,244,88,351,87
"068050402",421,421,842,246,242,230
"068050406",557,573,1130,347,314,310
"068050411",764,799,1563,429,580,426
"068050508",533,579,1112,381,395,371
"068050511",790,895,1685,510,465,447
"068050704",430,438,868,275,384,242
"068050705",494,514,1008,295,370,262
"068050801",186,213,399,137,518,134
"068050802",117,110,227,91,423,85
"068050813",1086,1008,2094,562,512,500
"068051001",788,881,1669,501,529,484
"068051005",423,443,866,277,275,251
"068051013",485,516,1001,228,251,225
"068051101",639,699,1338,367,339,331
"068051107",786,808,1594,386,390,380
"068051201",372,407,779,252,283,245
"068051204",430,494,924,266,296,266
"068051209",292,299,591,213,232,208
"068051301",771,781,1552,392,475,388
"068051305",561,599,1160,362,385,336
"068051308",1035,1052,2087,597,595,568
"068051309",555,577,1132,304,255,248
"068051317",409,447,856,269,277,245
"068051402",480,520,1000,278,236,225
"068051403",637,614,1251,373,362,347
"068051410",486,513,999,304,309,286
"068051511",530,628,1158,299,306,288
"068051512",383,389,772,244,251,225
"068051704",396,455,851,267,285,250
"068051906",817,829,1646,491,454,426
"068051912",647,688,1335,403,447,394
"068052002",475,471,946,278,259,230
"068052006",724,778,1502,329,303,289
"068052101",605,576,1181,334,300,287
"068052105",609,628,1237,353,360,338
"068052307",946,891,1837,456,392,373
"068052309",424,422,846,204,211,203
"068052502",532,565,1097,307,325,281
"068052505",728,772,1500,420,432,399
"060280207",565,604,1169,310,295,279
"068120502",297,283,580,174,250,172
"068190402",629,663,1292,428,513,419
"068190910",201,234,435,157,203,157
"068260108",484,501,985,321,325,301
"068260120",352,406,758,276,307,265
"068260202",647,644,1291,404,471,394
"068260212",273,369,642,291,376,283
"068261610",270,290,560,207,247,204
"068261902",366,428,794,308,372,305
"068330103",266,363,629,266,426,261
"068330115",107,110,217,78,79,78
"068330208",316,392,708,333,464,324
"068331012",866,883,1749,523,575,504
"068331701",212,238,450,141,163,138
"068331806",52,60,112,52,405,50
"068331908",451,474,925,296,368,283
"068400206",456,471,927,329,374,324
"068400106",740,776,1516,409,367,349
"068400201",672,722,1394,398,344,329
"068400202",737,760,1497,437,387,347
"068400311",766,812,1578,475,498,460
"068400402",995,959,1954,459,383,371
"068400412",315,375,690,212,187,168
"068400501",626,653,1279,346,277,257
"068400503",474,528,1002,318,340,314
"068400608",276,308,584,211,232,210
"068400611",278,323,601,204,235,204
"068400614",574,595,1169,369,376,342
"068400615",446,518,964,309,333,296
"068400710",515,581,1096,391,478,379
"068400803",256,308,564,177,191,166
"068401209",364,447,811,273,293,265
"068401408",235,243,478,159,174,155
"068401409",414,456,870,291,341,283
"068401702",525,610,1135,438,485,434
"068401704",339,391,730,266,337,243
"068401707",304,348,652,237,267,237
"068401901",209,270,479,203,263,198
"068401902",277,362,639,228,320,224
"068401911",471,547,1018,332,315,268
"068402010",354,388,742,245,262,231
"068402306",285,302,587,191,206,188
"068402308",764,775,1539,444,417,392
"068402309",348,361,709,238,281,228
"068402401",503,537,1040,346,352,326
"068402405",484,476,960,269,208,200
"068402410",235,290,525,189,233,188
"068402502",112,107,219,59,59,50
"068402503",318,307,625,170,159,147
"068402509",290,313,603,160,174,141
"068402707",369,402,771,275,258,215
"068402811",514,579,1093,344,286,278
"068402908",383,453,836,302,319,273
"068403006",313,362,675,230,253,215
"068403011",364,443,807,296,359,289
"068403104",354,394,748,227,244,193
"068403107",382,442,824,303,365,302
"068403204",407,483,890,321,368,307
"068470115",291,276,567,164,175,161
"068120201",15,10,25,8,9,8
"068540106",298,398,696,257,323,252
"068190408",100,77,177,59,103,59
"068190502",56,51,107,24,58,24
"068540114",333,364,697,210,227,201
"068260302",7,2,9,6,14,5
"068260602",37,21,58,26,47,24
"068260801",109,83,192,65,83,55
"068260901",32,36,68,20,32,19
"068261001",83,76,159,47,80,47
"068261002",47,31,78,33,42,33
"068261502",36,33,69,25,37,25
"068261804",80,67,147,42,68,41
"068330704",24,24,48,18,30,18
"068330901",20,14,34,11,21,10
"068330902",22,10,32,14,39,14
"068331707",18,22,40,13,31,12
"068331810",16,7,23,11,37,11
"068540601",87,91,178,64,116,64
"068540702",53,46,99,31,71,31
"068750607",34,37,71,24,34,24
"068540802",112,110,222,79,117,79
"068820701",111,92,203,59,60,58
"068821401",365,252,617,160,195,155
"068541001",267,267,534,172,198,168
"068610107",237,329,566,253,329,250
"068610109",334,378,712,245,295,241
"068610204",437,490,927,340,388,318
"068610410",324,378,702,258,295,254
"068610608",172,163,335,164,250,164
"068610605",127,162,289,133,171,133
"068610611",161,183,344,150,192,150
"068610803",270,308,578,200,226,199
"068611003",504,579,1083,366,425,346
"068611005",448,500,948,324,347,316
"068611307",324,369,693,251,298,247
"068611412",210,236,446,229,336,228
"068611601",257,324,581,211,243,207
"068611605",389,478,867,292,317,282
"068611706",378,391,769,257,279,253
"068611805",272,291,563,205,240,195
"068611808",398,460,858,305,349,299
"068611906",404,445,849,296,316,284
"068611912",512,533,1045,360,412,356
"068612001",436,521,957,362,432,353
"068612002",299,403,702,270,343,264
"068612006",418,494,912,368,421,366
"068612204",394,443,837,309,356,306
"068612206",430,466,896,319,358,307
"068612305",752,738,1490,404,331,311
"068612411",593,670,1263,429,491,420
"068612610",424,474,898,309,337,292
"068612808",237,290,527,190,215,185
"068612912",226,265,491,193,213,192
"068613106",502,514,1016,341,367,322
"068613205",147,206,353,163,203,161
"068613208",289,344,633,254,339,233
"068613310",468,554,1022,392,439,385
"068680104",264,276,540,204,315,200
"068680202",75,92,167,50,495,49
"068680203",109,102,211,78,380,77
"068680210",81,75,156,71,450,71
"068680303",280,282,562,196,275,193
"068680304",274,282,556,182,280,176
"068680610",24,25,49,24,307,24
"068680710",22,24,46,21,423,21
"068680804",233,235,468,177,477,167
"068750604",563,614,1177,417,491,411
"068750609",197,235,432,176,214,174
"068750802",223,222,445,159,208,157
"068751603",950,978,1928,525,572,516
"068820103",612,590,1202,403,415,373
"068820108",450,503,953,333,355,303
"068820209",419,495,914,308,371,296
"068820507",264,274,538,166,193,159
"068820508",666,672,1338,352,364,325
"068820901",897,901,1798,465,451,427
"068821001",431,475,906,277,313,269
"068821008",458,481,939,272,271,261
"065601402",817,788,1605,413,412,382
"065601403",644,576,1220,341,352,324
"065601409",498,476,974,236,235,220
"065601503",606,578,1184,293,275,260
"065601511",758,760,1518,395,375,365
"065601515",832,837,1669,408,399,370
"065601601",594,603,1197,334,384,325
"065601614",776,767,1543,417,411,362
"065601814",775,801,1576,448,429,394
"067702207",450,432,882,280,293,266
"067702210",402,453,855,288,317,277
"065601711",287,283,570,176,338,176
"065601715",324,316,640,180,181,157
"065601815",668,699,1367,364,398,349
"065601919",381,318,699,182,225,179
"065602104",372,379,751,199,259,194
"067780905",719,710,1429,393,436,379
"065602106",489,486,975,264,354,259
"065602102",354,325,679,211,267,204
"065602205",691,704,1395,404,422,380
"065602208",550,631,1181,399,428,384
"065602312",350,344,694,189,242,183
"065602314",281,315,596,219,240,210
"065602412",218,257,475,191,221,180
"065680208",504,599,1103,351,367,347
"065680201",518,400,918,299,363,295
"065680202",282,331,613,204,241,187
"065680304",407,437,844,259,248,227
"065680508",476,589,1065,359,413,346
"065680510",300,331,631,210,258,206
"067911314",411,463,874,287,320,282
"065680701",388,475,863,310,364,304
"065681005",444,422,866,299,326,282
"065681009",424,495,919,309,348,297
"065681014",306,373,679,277,337,271
"065681108",471,523,994,343,378,336
"065681206",531,581,1112,398,421,385
"060070516",7,3,10,3,13,3
"062170903",44,25,69,24,40,24
"067000109",3,1,4,2,11,2
"064904902",459,585,1044,336,342,307
"064905005",372,384,756,221,229,214
"064905104",279,314,593,192,197,168
"064905106",484,555,1039,358,369,330
"066583411",633,626,1259,391,388,362
"064970303",321,350,671,231,281,220
"064970311",416,461,877,283,319,276
"065151911",893,958,1851,502,493,465
"064970312",624,612,1236,371,397,333
"064970510",714,779,1493,429,446,401
"067070111",213,213,426,145,156,142
"064970501",333,358,691,230,262,229
"064970506",675,726,1401,374,408,366
"064970509",547,631,1178,409,448,396
"064970611",285,269,554,189,342,187
"064970701",340,420,760,297,346,288
"064970809",492,525,1017,297,320,276
"064971101",470,547,1017,359,410,344
"064971105",446,489,935,356,397,329
"065152007",434,455,889,249,249,237
"065152011",370,408,778,232,234,220
"065050321",258,277,535,162,188,157
"066721216",449,488,937,286,304,278
"065110506",291,343,634,238,330,236
"067070801",104,109,213,81,124,80
"065180710",144,152,296,103,275,102
"065150103",950,949,1899,468,431,414
"065150111",893,887,1780,426,429,406
"065150113",1143,1144,2287,579,527,508
"065150211",645,645,1290,351,400,343
"065150303",760,703,1463,368,328,311
"065150308",433,450,883,277,273,258
"065150309",500,495,995,253,251,241
"065150313",378,384,762,229,249,228
"065150410",534,504,1038,289,276,269
"065150508",330,413,743,214,214,206
"065150512",739,772,1511,479,477,442
"065150612",379,383,762,227,239,214
"065150903",492,464,956,267,279,254
"065150913",755,798,1553,434,420,407
"060351206",239,276,515,227,324,224
"060492002",504,544,1048,357,381,346
"060492501",509,470,979,272,302,248
"065151007",160,139,299,80,186,77
"060560711",595,590,1185,374,414,370
"065151008",681,700,1381,413,415,354
"060562001",486,536,1022,414,444,397
"060563006",88,107,195,73,86,72
"065151108",465,487,952,261,237,216
"065151201",436,458,894,237,225,210
"060910205",349,380,729,269,337,266
"060910206",258,335,593,202,230,199
"060912206",805,816,1621,414,462,402
"061260914",533,464,997,245,254,226
"060070805",237,252,489,176,218,176
"060070801",50,49,99,32,32,24
"060210603",322,407,729,296,352,294
"061821001",255,311,566,195,226,193
"061821002",207,241,448,158,184,143
"060210602",590,653,1243,422,481,406
"060280201",824,861,1685,456,381,369
"060280302",798,815,1613,430,407,393
"060280407",830,830,1660,422,337,329
"060280408",806,814,1620,401,379,374
"060280411",734,737,1471,380,349,339
"060280506",369,349,718,198,196,186
"060280604",2139,2151,4290,1165,1059,1030
"060280709",661,690,1351,361,355,314
"060280804",113,125,238,60,57,54
"060280808",527,572,1099,337,346,328
"060280907",607,638,1245,316,264,256
"060281008",743,766,1509,442,428,406
"060281110",682,771,1453,475,511,458
"060281112",417,459,876,254,259,238
"060281310",545,632,1177,392,395,372
"060281408",512,556,1068,306,250,245
"060281506",403,487,890,259,273,248
"061961201",8,4,12,4,12,4
"060281706",748,840,1588,456,468,427
"060281808",885,872,1757,438,416,392
"060281809",622,600,1222,295,300,278
"060281908",613,650,1263,361,425,327
"060281909",693,776,1469,407,416,387
"060281910",325,357,682,255,377,252
"060282014",650,710,1360,352,334,308
"060282101",325,355,680,213,202,181
"060282204",468,465,933,263,262,243
"060282305",314,392,706,241,259,231
"060282601",205,242,447,157,190,157
"060282611",241,257,498,149,165,144
"060282704",448,505,953,316,332,296
"060282806",979,976,1955,523,488,449
"060282809",660,631,1291,339,313,298
"060282911",549,579,1128,308,308,294
"060282913",449,499,948,274,281,262
"060283003",412,407,819,236,296,191
"060283005",455,514,969,284,255,236
"060283101",399,455,854,288,321,269
"060283105",371,369,740,258,275,252
"060283304",391,450,841,270,275,254
"060283307",743,756,1499,403,338,316
"060283402",637,713,1350,389,402,361
"060283405",504,512,1016,275,282,254
"060283407",344,364,708,223,243,217
"060283408",467,481,948,335,340,323
"060283603",371,396,767,280,359,278
"060283610",580,588,1168,316,330,304
"060283612",759,691,1450,381,443,372
"060351301",471,508,979,306,355,282
"060283712",756,796,1552,394,385,359
"060283809",531,491,1022,287,320,280
"060283901",659,652,1311,317,280,237
"060283903",603,626,1229,299,269,255
"060283914",408,423,831,227,221,210
"060350402",435,437,872,273,219,210
"060350411",657,696,1353,430,442,414
"060350506",850,829,1679,445,369,356
"060350508",467,518,985,343,373,319
"060350601",520,566,1086,336,348,309
"060350702",560,591,1151,347,362,319
"060350707",292,306,598,199,387,193
"060350712",134,151,285,98,266,92
"060350803",558,574,1132,344,355,335
"060350914",369,407,776,254,229,212
"060351006",337,414,751,310,370,306
"060351009",135,177,312,140,172,140
"060351106",388,484,872,350,401,341
"060351110",373,463,836,350,442,344
"060351207",153,209,362,160,201,158
"060351208",500,619,1119,342,473,336
"060351209",104,149,253,106,131,106
"062171211",286,301,587,195,231,190
"060351306",294,339,633,235,256,214
"060351401",325,397,722,262,314,255
"060351404",403,449,852,302,364,297
"060351406",248,298,546,225,288,221
"060351410",392,438,830,333,383,316
"060351507",471,521,992,291,325,279
"060351510",325,353,678,240,280,239
"060351607",266,315,581,206,235,201
"060351802",421,494,915,309,340,296
"060352010",442,500,942,314,311,277
"060352011",390,449,839,281,288,253
"060352105",168,213,381,184,149,94
"060352208",204,272,476,215,291,215
"060352301",230,243,473,165,385,142
"060352307",568,598,1166,326,295,283
"060352310",443,475,918,325,370,314
"060352408",542,571,1113,350,372,343
"060352503",675,767,1442,447,423,397
"060352506",479,533,1012,330,364,329
"060352510",910,935,1845,555,571,514
"060352602",770,760,1530,414,393,379
"060352711",887,912,1799,469,441,412
"060352807",366,411,777,261,272,247
"060352901",298,350,648,223,239,211
"060352905",342,384,726,254,285,240
"060353003",429,479,908,301,320,277
"060353005",373,425,798,262,298,261
"060353103",355,380,735,271,316,249
"060353107",203,243,446,152,172,149
"060353108",338,384,722,251,299,241
"060353304",402,411,813,289,328,284
"060353307",387,428,815,295,361,290
"065151302",614,585,1199,333,334,320
"060490109",244,340,584,274,330,272
"060490208",369,446,815,304,354,297
"060490213",382,398,780,235,259,225
"060490406",240,243,483,154,171,154
"060490507",381,454,835,315,330,291
"060490604",351,413,764,289,311,279
"060490610",236,238,474,156,199,155
"060490701",6,10,16,4,14,3
"060491006",152,172,324,117,142,101
"062450408",221,209,430,139,233,138
"060560103",360,387,747,391,556,385
"060560108",487,530,1017,479,551,461
"060560117",209,258,467,220,298,215
"060560201",543,539,1082,302,307,292
"060560307",279,340,619,221,268,217
"060560308",228,262,490,184,196,175
"060560408",296,364,660,258,306,252
"060560503",719,695,1414,407,415,389
"060560605",657,680,1337,412,433,395
"060560809",979,953,1932,509,526,475
"060560810",363,366,729,218,253,210
"060560907",298,320,618,226,269,224
"060561003",197,315,512,288,428,282
"060561208",196,293,489,233,293,232
"060561303",284,328,612,313,392,301
"060561306",284,315,599,260,344,258
"060561310",229,279,508,242,299,240
"060561411",244,312,556,206,267,203
"060561506",507,562,1069,319,366,312
"060561510",302,334,636,212,237,210
"060561804",392,437,829,233,258,228
"060561809",395,471,866,309,363,294
"060561903",631,651,1282,440,477,432
"060561909",399,426,825,248,261,236
"060562306",496,543,1039,309,320,306
"060562307",445,464,909,272,282,270
"060562503",531,472,1003,278,425,274
"060562504",690,695,1385,405,459,399
"060562511",466,495,961,343,395,337
"060562615",482,487,969,257,310,252
"060562704",504,499,1003,290,445,284
"060562705",194,213,407,126,346,123
"060630116",372,424,796,241,251,231
"060563005",156,163,319,106,122,105
"060563205",516,520,1036,342,371,330
"060563209",572,625,1197,375,412,360
"060563211",458,509,967,320,349,311
"060630113",315,347,662,272,312,246
"060630205",480,541,1021,361,416,349
"060630401",10,17,27,7,15,6
"060630709",463,441,904,265,332,259
"060631305",377,449,826,333,395,324
"060700105",256,346,602,217,244,209
"060700109",379,479,858,301,365,296
"060700112",153,181,334,125,161,121
"060700218",253,233,486,143,221,143
"060770103",288,388,676,229,277,224
"060770105",355,419,774,304,340,292
"060770108",272,334,606,210,247,207
"060770501",542,577,1119,398,422,366
"060771404",430,520,950,358,409,354
"060771408",742,798,1540,432,436,417
"060771409",569,623,1192,343,361,338
"060840704",373,431,804,320,372,314
"060840705",248,249,497,170,191,168
"060840709",260,338,598,245,338,244
"062741004",567,535,1102,272,275,262
"060840801",73,65,138,43,64,43
"060840902",349,346,695,238,285,234
"060910302",694,754,1448,414,431,407
"060841209",321,296,617,199,230,196
"060841210",497,522,1019,306,332,268
"060910102",856,879,1735,433,413,393
"060910105",351,376,727,233,247,228
"060910107",582,643,1225,391,395,374
"060910201",615,601,1216,375,426,361
"060910405",722,785,1507,465,508,459
"060910406",831,845,1676,402,387,360
"060910505",553,615,1168,407,438,394
"060910508",445,416,861,223,226,196
"065151401",631,595,1226,284,286,273
"060910602",438,512,950,318,319,294
"060910806",488,516,1004,299,293,282
"060910903",652,687,1339,418,438,402
"060911011",738,753,1491,419,455,411
"060911101",631,691,1322,454,432,421
"060911204",612,606,1218,381,394,360
"060911401",941,1072,2013,480,374,363
"060911403",485,562,1047,277,285,259
"060911413",533,553,1086,290,293,276
"060911503",472,491,963,299,317,282
"062742209",285,270,555,148,169,142
"060911507",395,439,834,245,246,224
"060911509",329,383,712,238,260,233
"060911609",432,448,880,258,260,239
"060911702",737,772,1509,434,412,387
"065151403",715,705,1420,345,337,327
"060911811",829,841,1670,485,480,454
"060911902",786,768,1554,440,430,398
"060911910",512,522,1034,302,309,282
"060912002",693,709,1402,370,373,315
"060912007",564,547,1111,356,426,354
"060912008",301,338,639,215,253,205
"060912009",403,410,813,228,271,222
"060912106",506,496,1002,254,232,219
"060912108",392,448,840,243,248,225
"060912109",342,439,781,291,348,290
"060912216",769,769,1538,415,436,394
"060912217",385,378,763,211,328,209
"060912406",439,455,894,285,342,277
"060980109",329,387,716,254,285,232
"060912410",405,441,846,241,333,237
"060980102",449,500,949,293,324,285
"062801003",105,121,226,79,270,78
"060980213",305,296,601,214,240,209
"060980302",163,218,381,128,98,86
"060980310",853,933,1786,492,435,413
"060980311",340,348,688,234,251,228
"060980814",461,487,948,306,284,255
"060980509",491,512,1003,279,310,271
"060980614",431,442,873,261,281,255
"061050107",340,412,752,302,347,287
"061050202",403,464,867,340,393,335
"061050403",110,101,211,79,126,79
"061050802",309,303,612,179,202,163
"061051106",128,137,265,100,136,95
"061051107",168,140,308,113,138,107
"061051411",290,304,594,165,197,162
"061120112",703,675,1378,440,487,425
"061120205",422,474,896,342,384,330
"061120211",656,711,1367,470,444,421
"061120710",122,117,239,79,82,78
"061121101",254,266,520,195,240,193
"061121102",105,105,210,74,86,67
"061121404",375,426,801,317,378,313
"061121406",287,364,651,276,349,274
"063220603",180,245,425,191,231,188
"061190307",428,464,892,284,306,276
"061190702",600,602,1202,364,408,347
"061191003",589,595,1184,340,357,311
"061191007",348,412,760,275,308,270
"061260103",446,469,915,299,295,269
"061260309",416,432,848,301,365,299
"061260513",461,444,905,257,274,211
"061260503",491,513,1004,317,351,310
"061260507",466,531,997,263,251,237
"061260509",1043,1062,2105,502,486,458
"061260515",603,625,1228,321,350,307
"061260704",622,582,1204,298,305,273
"063574904",273,331,604,232,295,221
"061260910",790,795,1585,420,428,405
"061400304",368,418,786,275,292,267
"065151408",901,886,1787,488,435,412
"061340104",161,168,329,94,108,88
"061340106",480,453,933,248,280,238
"061340204",654,727,1381,438,481,421
"061340306",376,456,832,308,370,303
"061340401",89,66,155,43,46,40
"061470701",347,354,701,228,303,224
"061471201",428,448,876,349,397,335
"061471206",279,334,613,252,323,248
"061471207",338,377,715,285,331,279
"061540402",198,204,402,141,207,141
"061610101",309,313,622,184,198,175
"061610106",403,416,819,266,293,262
"063576002",281,326,607,226,272,223
"065151411",577,530,1107,310,264,251
"061680903",297,357,654,220,262,214
"061680906",356,385,741,223,262,221
"061750101",122,116,238,79,94,76
"061750606",254,297,551,185,202,179
"061820101",404,422,826,251,273,248
"061820110",560,556,1116,313,321,307
"061820113",411,434,845,250,270,246
"061820203",358,387,745,278,319,277
"061820206",340,378,718,260,311,260
"061820211",301,331,632,218,223,214
"061820503",243,264,507,149,158,140
"061820607",659,679,1338,408,450,402
"063577701",373,353,726,195,217,193
"061820904",96,100,196,71,337,70
"061820905",62,46,108,39,317,37
"061821009",460,501,961,378,415,371
"061821010",440,509,949,320,376,309
"061821106",341,382,723,253,280,243
"061821109",554,568,1122,308,333,296
"061890301",30,35,65,24,31,24
"061891401",8,5,13,5,18,5
"061891702",280,274,554,173,201,170
"061891707",369,481,850,328,398,326
"061960107",192,205,397,117,121,105
"061960113",307,322,629,233,255,226
"061960201",121,133,254,77,96,76
"061960207",266,332,598,237,308,237
"061961508",126,134,260,98,123,94
"062030102",265,333,598,256,320,252
"062030105",301,369,670,269,297,265
"062030111",456,434,890,293,318,283
"062030809",415,471,886,333,367,327
"062100118",383,404,787,274,311,266
"062100202",579,626,1205,392,436,383
"062100604",92,80,172,51,63,51
"062100607",163,180,343,126,147,121
"062170105",405,451,856,302,339,290
"062170106",215,252,467,171,252,171
"062170110",281,325,606,237,299,227
"063572207",132,212,344,193,334,193
"063712308",382,493,875,296,340,295
"062170413",772,722,1494,418,458,405
"063572209",190,282,472,247,418,245
"062171206",311,340,651,249,294,247
"063990304",269,306,575,226,262,222
"062240105",473,502,975,335,368,310
"062240107",384,441,825,320,368,314
"062240115",335,318,653,178,201,166
"062240116",267,305,572,173,205,170
"062240302",478,479,957,304,337,288
"062310102",235,251,486,167,193,166
"062241201",56,62,118,47,92,45
"062242206",395,514,909,354,416,345
"062242209",324,330,654,219,238,208
"062242210",409,452,861,227,261,218
"062311212",308,289,597,176,196,173
"062380105",813,558,1371,362,406,350
"062380212",573,563,1136,336,387,327
"062380301",130,156,286,100,113,98
"062450101",587,644,1231,404,417,382
"062450210",258,276,534,186,210,186
"062450311",556,643,1199,317,332,308
"062520403",288,306,594,177,186,168
"062520504",537,569,1106,434,587,427
"062520112",647,661,1308,413,402,361
"062520204",336,339,675,231,364,227
"065151504",683,654,1337,356,386,342
"062520215",816,810,1626,430,432,406
"062520307",144,132,276,83,77,64
"062520407",317,356,673,225,234,214
"062520408",746,802,1548,475,562,453
"062520610",58,48,106,36,42,35
"064120904",785,718,1503,357,404,344
"062520613",366,348,714,185,287,141
"062520807",496,523,1019,313,336,291
"062521312",577,612,1189,332,346,318
"062521403",1044,1035,2079,501,497,476
"062521501",6,5,11,4,5,4
"062521502",2,1,3,2,2,2
"062521506",772,757,1529,392,378,353
"062521509",752,779,1531,411,380,298
"062521511",718,747,1465,380,410,372
"062521515",948,1100,2048,579,532,498
"062600119",753,762,1515,406,408,388
"062600205",1047,1007,2054,468,438,415
"062600210",698,717,1415,390,383,370
"062600216",704,681,1385,364,358,343
"062600306",551,576,1127,293,235,227
"062600315",524,501,1025,286,287,276
"062600402",655,698,1353,364,312,310
"062600406",592,598,1190,331,319,311
"062600507",593,631,1224,321,334,314
"062600510",516,509,1025,297,302,287
"062600607",429,446,875,247,252,231
"062600609",356,396,752,247,282,236
"062600610",302,315,617,193,203,179
"062600613",484,549,1033,341,339,300
"062600701",681,769,1450,488,464,389
"062600703",566,665,1231,417,506,412
"062600704",471,500,971,319,350,298
"062600707",561,602,1163,351,374,332
"062600804",889,881,1770,433,416,398
"062600808",616,670,1286,369,364,320
"064132202",203,199,402,117,126,87
"062600905",625,615,1240,304,307,283
"062601010",436,449,885,260,260,243
"062601012",536,544,1080,291,273,258
"062601103",438,514,952,366,469,362
"062601105",419,443,862,292,335,280
"062601108",505,562,1067,365,407,348
"062601212",633,628,1261,341,374,332
"062601309",517,561,1078,329,368,324
"062601313",276,312,588,228,289,219
"062601406",590,673,1263,453,510,428
"062601509",799,803,1602,368,376,356
"062601517",933,938,1871,483,476,449
"062601612",697,678,1375,345,346,328
"063572906",204,264,468,280,770,273
"062660502",306,318,624,177,191,162
"064201508",204,241,445,156,476,156
"062660708",605,625,1230,340,353,313
"062700215",553,504,1057,277,284,265
"062700201",955,1026,1981,501,489,454
"062700202",482,516,998,251,238,228
"062700206",712,744,1456,472,491,451
"062700309",754,754,1508,412,427,397
"062700314",408,466,874,305,354,286
"062700316",392,412,804,262,308,248
"062700406",832,866,1698,480,509,457
"062700412",577,651,1228,370,400,352
"062700414",647,637,1284,335,334,308
"062700601",527,496,1023,291,298,271
"062700604",234,243,477,145,257,138
"062700605",625,601,1226,361,444,356
"062700611",785,769,1554,420,483,403
"062700612",184,214,398,117,214,114
"062700615",360,371,731,201,227,194
"062700712",953,964,1917,476,438,413
"062700811",548,580,1128,334,753,322
"062700904",428,479,907,296,329,292
"062700908",372,377,749,208,213,195
"062740213",564,607,1171,323,319,305
"062740215",611,665,1276,408,404,375
"062740304",899,869,1768,452,437,416
"062740305",718,787,1505,399,374,354
"062740312",813,834,1647,394,378,366
"062740313",713,759,1472,377,392,368
"062740405",585,542,1127,329,312,293
"062740407",492,506,998,266,260,241
"062740502",448,489,937,269,261,229
"064273002",509,593,1102,423,562,376
"062740511",609,638,1247,366,364,343
"062740608",471,464,935,245,259,236
"062740612",506,498,1004,274,257,248
"062740702",489,489,978,252,264,240
"062740711",473,421,894,239,231,217
"062740808",431,480,911,261,296,258
"062740911",434,458,892,226,218,204
"062740817",502,490,992,247,261,228
"062740907",446,455,901,231,241,228
"062741001",685,610,1295,336,352,299
"062741006",494,494,988,229,230,217
"062741008",698,730,1428,349,366,341
"062741101",488,491,979,293,303,273
"062741107",625,607,1232,324,283,272
"062741109",982,1022,2004,525,510,483
"062741113",574,581,1155,274,284,265
"062741206",333,360,693,222,212,189
"062741208",780,818,1598,447,452,398
"062741311",421,472,893,273,288,263
"062741515",407,451,858,254,259,245
"062741808",564,562,1126,236,240,229
"062741811",830,820,1650,411,414,387
"062741813",628,594,1222,303,307,289
"062741816",789,804,1593,405,393,371
"062741901",556,602,1158,317,332,311
"062741902",770,797,1567,414,387,375
"062741912",790,808,1598,396,415,391
"062742003",664,625,1289,346,342,320
"062742112",433,451,884,234,230,224
"062742205",505,488,993,259,266,255
"063573101",172,280,452,272,560,270
"062800208",153,221,374,169,315,169
"062800302",75,81,156,50,436,50
"062800615",80,77,157,44,90,44
"062800801",129,123,252,97,106,96
"062800902",15,10,25,12,125,12
"062800911",10,10,20,11,103,9
"062870403",142,136,278,91,106,91
"062940603",251,296,547,216,264,215
"064278801",679,724,1403,373,343,315
"062940808",331,382,713,248,286,243
"063010509",352,387,739,259,308,252
"063010803",84,76,160,57,123,51
"063150111",650,680,1330,453,522,450
"063150113",508,575,1083,333,388,327
"063150116",310,332,642,199,225,191
"063220606",164,207,371,140,162,132
"063360203",155,162,317,89,121,88
"063360204",25,21,46,14,26,14
"063430602",134,126,260,97,385,95
"063430101",322,335,657,234,273,198
"063430710",477,528,1005,340,469,323
"063573507",190,281,471,231,448,229
"063510901",553,575,1128,412,509,409
"063570104",580,625,1205,375,452,371
"064343303",467,518,985,345,379,331
"063570105",505,544,1049,344,392,329
"063570107",314,414,728,255,297,252
"063570304",352,351,703,209,248,200
"063570308",494,509,1003,343,423,331
"063570410",277,301,578,223,454,215
"063570512",243,276,519,191,320,189
"063570514",194,214,408,116,267,115
"063570603",361,378,739,247,277,240
"063570609",524,610,1134,373,422,359
"063573508",196,250,446,273,656,268
"063570711",411,423,834,241,258,224
"063570811",521,572,1093,371,414,368
"063573605",42,61,103,57,247,55
"063571012",495,476,971,302,316,283
"063571015",438,402,840,235,249,210
"063571111",424,460,884,289,347,289
"063571112",591,620,1211,342,338,302
"063571212",564,598,1162,305,313,292
"063571301",420,448,868,281,316,266
"063571406",319,431,750,302,393,297
"063571909",120,153,273,123,252,121
"063572302",185,242,427,199,483,188
"063572305",95,122,217,93,275,93
"063572401",81,89,170,68,330,67
"063572402",55,58,113,52,339,52
"063572404",160,188,348,144,512,141
"063572601",176,249,425,243,887,242
"063572704",142,202,344,163,515,162
"063573202",283,367,650,260,395,253
"063573203",279,413,692,245,345,235
"063573308",236,317,553,240,427,240
"063573310",140,178,318,137,244,136
"063573402",171,246,417,197,283,196
"063574103",232,285,517,261,1172,260
"063574202",117,163,280,128,359,128
"063574309",119,113,232,103,345,102
"063574503",230,324,554,222,333,222
"063574505",175,230,405,151,242,147
"063574514",91,106,197,97,186,97
"063574605",289,354,643,282,407,280
"063710408",265,286,551,209,211,198
"063574702",341,370,711,279,345,276
"063574707",172,223,395,173,230,168
"063574906",285,382,667,245,343,241
"063575005",512,551,1063,349,398,344
"063575006",437,502,939,348,403,342
"064413103",292,324,616,216,242,215
"063575202",702,706,1408,398,390,365
"063575210",880,857,1737,478,477,452
"063575310",609,622,1231,368,413,362
"063575503",455,526,981,365,465,355
"063575601",434,472,906,340,359,315
"063575801",340,362,702,272,321,268
"063575906",549,653,1202,414,494,401
"063576103",209,227,436,162,215,158
"063576108",18,22,40,11,13,11
"063576210",117,142,259,102,184,101
"063576211",299,309,608,216,323,211
"063576308",127,124,251,83,424,79
"063576402",635,614,1249,358,419,344
"063576502",369,335,704,226,297,221
"063576512",295,298,593,202,407,200
"063576705",502,544,1046,324,338,308
"063576802",612,646,1258,382,414,379
"063576906",459,473,932,284,299,276
"063577101",393,393,786,234,244,213
"063577102",405,496,901,306,299,262
"063577205",602,653,1255,369,354,320
"063577208",330,346,676,211,219,172
"063577301",150,143,293,67,96,67
"063577304",120,106,226,63,67,60
"063577309",299,289,588,160,185,153
"063577402",644,597,1241,318,336,294
"064415203",265,308,573,204,228,197
"063577404",593,523,1116,279,296,269
"063577408",483,480,963,257,321,247
"063577409",287,292,579,178,244,171
"063577410",294,297,591,182,230,177
"063577417",306,300,606,193,308,189
"063577502",93,103,196,71,296,68
"063577504",175,177,352,115,239,115
"063577605",121,123,244,93,260,90
"063577714",269,414,683,63,198,63
"063577717",45,44,89,34,238,34
"063577811",756,752,1508,355,350,316
"063577815",368,349,717,194,200,180
"063578001",646,636,1282,353,397,316
"064416512",165,158,323,99,197,97
"063578106",220,197,417,139,175,137
"063578113",279,256,535,154,158,126
"063640116",240,311,551,207,260,197
"063640304",434,377,811,202,221,196
"063640306",482,505,987,301,401,294
"063640308",577,571,1148,305,328,286
"063640309",287,273,560,156,153,131
"063640411",309,313,622,163,183,161
"063640405",631,617,1248,337,357,323
"063640412",429,407,836,217,256,211
"064620705",328,418,746,312,358,304
"063640706",361,421,782,309,404,298
"063640712",592,677,1269,420,473,415
"063640714",440,482,922,274,295,266
"063640802",272,287,559,148,186,147
"063640803",354,328,682,190,201,153
"063640815",344,305,649,188,228,185
"065151701",644,615,1259,363,408,351
"063710109",626,687,1313,323,235,225
"063710204",690,735,1425,387,381,366
"063710302",387,446,833,265,243,232
"063710311",544,620,1164,349,351,347
"063710315",474,556,1030,360,351,324
"064760501",42,34,76,21,34,21
"063710407",494,575,1069,384,367,332
"063710602",375,396,771,260,219,200
"063710709",557,604,1161,402,379,327
"063710801",736,756,1492,440,445,413
"063710807",358,416,774,276,301,254
"063710902",524,612,1136,398,421,389
"063710914",478,549,1027,345,389,334
"063710916",296,331,627,223,218,187
"063710917",475,549,1024,332,348,310
"063711007",588,651,1239,453,422,374
"063711009",409,448,857,309,349,287
"063711010",471,510,981,357,421,347
"063711013",651,691,1342,416,374,341
"063711107",457,550,1007,356,410,347
"063711206",241,280,521,196,266,193
"063711305",436,523,959,321,372,298
"063711306",528,613,1141,370,394,349
"063711405",383,374,757,202,178,171
"063711501",162,142,304,70,49,48
"063711503",767,764,1531,382,345,340
"063711506",789,792,1581,460,471,454
"063711507",421,403,824,203,203,195
"063711513",404,500,904,251,241,211
"063711514",474,542,1016,289,282,249
"063711602",408,359,767,185,158,155
"063711609",540,546,1086,374,415,359
"063711710",616,696,1312,412,411,380
"063711809",380,419,799,279,283,265
"063711902",286,393,679,323,381,298
"063711904",396,458,854,308,371,304
"063712204",365,443,808,328,445,326
"063712206",212,239,451,190,229,168
"063712213",261,297,558,213,274,210
"063712309",241,334,575,271,478,269
"063712314",409,485,894,314,335,294
"063712603",443,526,969,322,323,295
"063712402",346,355,701,227,245,209
"063712503",260,285,545,200,239,197
"063712704",526,575,1101,379,366,321
"063712707",255,299,554,197,221,190
"063712802",64,62,126,47,54,47
"063712901",386,401,787,307,337,266
"063712907",711,799,1510,501,459,405
"063713102",293,348,641,218,234,207
"063713202",689,750,1439,442,429,407
"063713204",631,624,1255,358,335,298
"063713212",592,627,1219,370,314,298
"063713214",784,826,1610,463,465,453
"063713215",458,471,929,290,267,244
"064900501",490,546,1036,264,243,236
"063713501",561,641,1202,373,400,364
"063713509",96,76,172,40,44,40
"063713514",351,404,755,227,196,184
"063713602",585,626,1211,345,251,231
"063713605",493,511,1004,296,309,287
"063713701",518,507,1025,302,262,248
"063713710",827,824,1651,448,450,414
"063713712",689,668,1357,371,349,337
"063850713",372,345,717,241,283,239
"063920110",451,468,919,308,363,298
"063920706",153,166,319,120,131,118
"063920707",138,156,294,113,132,111
"063990501",569,599,1168,417,494,412
"064060201",453,491,944,280,317,279
"064060205",410,473,883,349,415,346
"064080116",262,326,588,195,240,194
"064080117",437,570,1007,305,338,292
"064080209",746,865,1611,510,518,476
"064080307",879,934,1813,505,476,429
"064080407",725,758,1483,388,386,364
"064080411",530,595,1125,322,304,292
"064080502",581,577,1158,312,283,273
"064200707",83,86,169,68,427,67
"064080701",484,517,1001,333,361,318
"064080702",454,487,941,267,237,216
"064080706",431,460,891,323,360,312
"064080710",422,417,839,260,269,249
"064080812",340,381,721,202,185,170
"064080902",357,374,731,225,254,214
"064080905",506,531,1037,351,409,343
"064081008",378,376,754,244,268,239
"064081107",127,128,255,83,82,80
"064970201",287,270,557,167,245,163
"064081202",505,521,1026,250,318,250
"064081206",1055,1142,2197,623,599,552
"064081503",80,95,175,51,59,51
"064100108",746,680,1426,421,477,404
"064270103",436,595,1031,558,786,535
"064970704",153,191,344,142,192,138
"064100301",832,930,1762,385,413,356
"064100303",400,412,812,251,332,242
"064100311",441,419,860,244,259,228
"064100401",647,668,1315,381,391,353
"064100404",382,433,815,254,286,249
"064100602",599,668,1267,331,354,326
"064101101",461,527,988,360,423,355
"064100716",719,790,1509,457,469,434
"064100802",393,408,801,252,276,247
"065050311",344,384,728,256,327,254
"064101008",475,491,966,308,321,292
"064101109",514,569,1083,393,445,386
"064101204",328,374,702,242,260,236
"064101207",350,396,746,271,319,270
"064101308",433,468,901,273,303,262
"064120107",161,182,343,103,133,88
"064120109",561,638,1199,329,425,324
"064120111",410,380,790,206,237,198
"064120115",525,594,1119,313,305,283
"064120205",729,746,1475,421,446,412
"064120206",514,486,1000,272,282,257
"064120301",704,694,1398,380,340,322
"065150209",634,645,1279,355,360,338
"064120311",568,635,1203,348,376,342
"064120501",355,395,750,238,258,231
"064120509",757,777,1534,401,406,373
"064120604",421,526,947,265,351,256
"064120612",575,640,1215,382,395,363
"064120711",698,698,1396,396,394,362
"064120807",544,559,1103,275,283,260
"064120809",599,617,1216,347,351,330
"064120813",756,769,1525,372,355,328
"064120905",721,733,1454,349,387,320
"064121010",605,610,1215,302,280,263
"064121011",608,643,1251,331,310,281
"064121018",704,778,1482,372,376,364
"064121112",469,464,933,236,234,221
"064121117",430,417,847,211,198,191
"064121205",893,890,1783,441,424,398
"064121403",896,914,1810,485,444,418
"064130101",479,484,963,279,281,269
"064130202",476,468,944,291,303,277
"064130306",293,392,685,274,329,271
"064130406",273,384,657,292,459,288
"064130509",361,473,834,327,374,319
"064130602",398,389,787,277,289,259
"064130605",393,482,875,340,424,332
"065180209",144,149,293,79,87,76
"064131308",266,239,505,140,187,132
"064131403",196,195,391,85,95,84
"064131501",181,162,343,108,123,107
"064132108",660,686,1346,438,477,422
"064132206",169,164,333,108,160,106
"064132211",266,301,567,204,256,200
"064200102",295,282,577,155,219,152
"064200201",37,40,77,29,244,29
"064200112",73,82,155,58,259,58
"064270308",339,384,723,257,280,249
"064200204",59,69,128,47,278,47
"064200405",113,114,227,79,396,79
"064200311",205,206,411,135,208,128
"065250107",423,429,852,322,380,317
"064200314",68,51,119,49,210,48
"064200410",158,169,327,117,255,108
"064200703",15,13,28,13,200,12
"064200801",438,435,873,267,347,254
"064200806",115,142,257,92,316,92
"064200911",85,89,174,64,322,63
"064201101",112,94,206,67,227,67
"064201105",87,100,187,59,325,57
"064201109",43,47,90,39,384,39
"064201202",22,24,46,14,58,14
"064201204",60,67,127,45,442,45
"064201309",57,76,133,47,376,46
"064201501",17,11,28,12,276,12
"064201506",69,80,149,56,552,54
"064201611",295,295,590,171,302,157
"064201704",35,43,78,33,431,33
"064201710",188,196,384,117,142,107
"064201805",27,32,59,23,322,21
"064201808",161,156,317,114,339,112
"064201811",9,7,16,10,186,10
"064201901",8,6,14,10,169,10
"064202001",309,323,632,207,380,193
"064202007",27,33,60,32,235,32
"064202104",203,207,410,145,296,144
"064202210",91,64,155,63,273,61
"064270201",314,428,742,222,278,195
"064270502",419,459,878,276,251,239
"064270504",661,718,1379,417,413,376
"064270611",336,363,699,230,249,223
"064270613",370,453,823,302,242,232
"064270702",589,670,1259,413,468,376
"064270704",503,575,1078,362,406,335
"064270706",412,427,839,283,306,249
"064270708",400,435,835,289,319,282
"064270711",517,568,1085,340,304,265
"064270809",327,345,672,218,250,209
"064270904",987,1048,2035,585,572,545
"065390902",304,292,596,154,153,148
"064270906",970,969,1939,525,411,390
"064270910",577,598,1175,302,276,269
"064271007",639,691,1330,414,426,377
"064271010",351,366,717,230,276,230
"064271207",392,372,764,246,237,211
"064271301",672,693,1365,429,425,362
"064271303",491,500,991,332,377,315
"064271401",588,629,1217,355,299,260
"064271404",678,660,1338,312,232,220
"064271414",285,284,569,179,188,162
"064271415",432,500,932,301,280,241
"064271418",382,401,783,257,295,224
"064271505",384,440,824,254,265,231
"064271610",388,389,777,236,219,206
"064271611",502,594,1096,411,484,401
"064271708",980,1116,2096,516,360,343
"064271813",2486,2571,5057,1166,935,882
"064271908",613,706,1319,422,374,350
"064272005",258,276,534,184,190,159
"064272009",421,530,951,350,386,332
"064272013",296,361,657,200,307,190
"064272104",773,846,1619,483,391,344
"064272309",931,995,1926,602,573,511
"065321510",345,376,721,244,271,239
"064272604",651,712,1363,419,421,384
"064272703",366,412,778,264,254,236
"064272704",369,410,779,267,266,245
"064272708",569,596,1165,393,444,382
"064272802",319,397,716,259,296,257
"064272803",382,422,804,274,287,261
"064273001",311,407,718,322,448,318
"064273005",194,228,422,181,226,153
"064273012",278,334,612,241,324,233
"064273204",341,395,736,249,262,233
"064273210",289,341,630,222,239,214
"064273308",409,436,845,288,283,265
"064273310",455,505,960,316,328,292
"064273314",563,663,1226,391,390,350
"064273406",933,964,1897,569,603,556
"064273415",617,711,1328,433,457,398
"064273601",340,369,709,237,266,223
"064273603",363,408,771,283,367,275
"064273605",339,377,716,247,478,226
"064273608",214,199,413,92,91,84
"064273612",252,278,530,179,232,174
"064273707",690,763,1453,414,427,378
"064273806",515,557,1072,304,284,264
"064273810",651,677,1328,410,439,385
"064274007",1706,1716,3422,741,643,609
"064274301",687,673,1360,430,464,404
"064274305",661,779,1440,460,459,400
"064274306",810,812,1622,500,519,473
"064274409",330,393,723,237,277,227
"064274506",420,460,880,268,266,245
"064274603",1036,1075,2111,579,542,502
"064274607",643,669,1312,378,362,343
"064274702",671,716,1387,242,73,71
"064274802",1031,1074,2105,578,538,517
"064275009",477,557,1034,302,308,271
"064275101",559,577,1136,313,300,293
"064275113",716,777,1493,392,458,376
"064275114",798,856,1654,500,486,478
"064275209",998,1104,2102,450,350,341
"064275211",591,632,1223,294,229,226
"064275302",593,594,1187,256,222,208
"064275310",956,1009,1965,468,454,437
"064275408",745,700,1445,401,378,367
"064275607",339,367,706,221,235,201
"064275902",323,346,669,182,130,122
"064275904",486,537,1023,257,218,208
"064275911",626,636,1262,355,336,317
"064276015",465,460,925,272,225,201
"064276016",758,806,1564,460,489,436
"064276102",1056,1134,2190,555,337,319
"064276109",1046,1052,2098,507,389,377
"064276303",618,653,1271,325,268,249
"064276312",745,782,1527,375,320,306
"065600714",849,825,1674,445,366,345
"064276406",576,603,1179,319,238,226
"064276411",440,484,924,261,254,229
"064276417",437,509,946,290,325,275
"064276503",706,725,1431,405,294,283
"064276601",661,768,1429,341,248,244
"064276701",682,741,1423,358,323,293
"064276707",677,690,1367,355,280,262
"064276712",801,870,1671,428,307,293
"064276717",748,694,1442,353,309,292
"064276903",722,706,1428,354,299,272
"064276908",548,638,1186,325,283,272
"064277001",1046,1052,2098,362,192,176
"064277012",820,809,1629,390,326,312
"064277016",471,484,955,269,212,199
"064277103",506,506,1012,277,222,213
"064277108",437,438,875,237,216,206
"064277111",556,530,1086,291,290,284
"064277301",885,942,1827,441,379,370
"064277312",607,625,1232,325,251,240
"064277313",879,907,1786,410,353,343
"064277401",931,985,1916,421,366,356
"064277415",771,804,1575,342,237,229
"064277603",1294,1290,2584,637,476,460
"064277605",918,953,1871,512,416,392
"064277609",981,951,1932,452,400,370
"064277618",561,517,1078,298,282,250
"064277701",707,734,1441,388,350,334
"065601717",456,507,963,237,247,228
"064277709",460,540,1000,268,240,226
"064277710",862,855,1717,448,395,377
"064277712",950,959,1909,506,446,414
"064277904",701,678,1379,343,318,305
"064277907",472,481,953,246,208,200
"064278013",453,453,906,209,210,202
"064278110",264,256,520,117,95,88
"064278111",577,574,1151,280,283,249
"064278210",715,730,1445,360,291,277
"064278302",739,762,1501,367,341,330
"064278307",595,583,1178,302,283,272
"064278312",730,679,1409,367,310,298
"064278407",807,743,1550,385,376,357
"064278409",1182,1139,2321,550,491,476
"064278503",823,775,1598,403,365,351
"064278510",458,474,932,282,285,254
"064278604",660,663,1323,373,312,295
"064278607",797,828,1625,436,387,340
"064278813",735,749,1484,399,392,363
"064278804",962,1102,2064,561,348,329
"064278806",510,533,1043,292,281,257
"064278903",1152,1141,2293,549,487,465
"064279007",486,501,987,300,302,293
"064278909",521,550,1071,262,231,223
"064278911",1057,1031,2088,545,505,481
"064279001",807,849,1656,492,454,422
"064279005",547,515,1062,276,264,260
"064279101",1152,1122,2274,531,299,288
"064340211",462,530,992,359,429,347
"064279215",502,497,999,249,252,223
"064279202",889,888,1777,416,381,351
"064279211",848,898,1746,397,391,368
"064279302",974,846,1820,406,364,348
"064279305",800,760,1560,391,379,298
"064279307",890,953,1843,448,435,407
"064340212",396,438,834,299,370,297
"064279311",985,980,1965,486,481,465
"064279413",788,765,1553,399,383,361
"064279601",973,951,1924,452,404,377
"064279603",873,821,1694,409,349,322
"064279611",609,666,1275,312,313,289
"064279704",917,940,1857,447,483,390
"064279706",1042,1078,2120,492,501,449
"064279708",778,843,1621,387,408,343
"064279709",552,537,1089,278,318,264
"064340210",250,293,543,211,248,194
"064340101",942,924,1866,531,418,397
"064340107",383,404,787,263,269,216
"064340201",364,398,762,260,275,233
"064340203",373,452,825,291,313,278
"064340204",313,334,647,217,269,213
"064340305",434,490,924,324,400,320
"064340308",684,701,1385,454,541,441
"064340501",598,656,1254,427,457,405
"064340702",431,463,894,270,227,213
"064340801",319,316,635,209,222,200
"064340802",655,743,1398,443,426,396
"064340804",503,554,1057,341,297,286
"064340809",537,528,1065,259,232,226
"064340810",713,721,1434,352,333,323
"064340812",880,826,1706,463,413,410
"064340814",362,375,737,223,250,223
"064340903",676,701,1377,353,303,297
"064340904",427,455,882,228,199,191
"064340907",511,540,1051,270,239,234
"064341003",270,330,600,196,216,196
"064341104",430,492,922,269,286,267
"064341106",420,464,884,239,215,189
"064341301",453,527,980,342,385,328
"064341303",391,407,798,285,321,273
"064341304",253,303,556,190,211,184
"064341307",371,454,825,298,337,289
"064341403",309,339,648,237,286,229
"064341407",444,506,950,337,341,300
"064341507",280,309,589,246,338,243
"064341515",370,438,808,297,373,296
"064341604",229,310,539,224,245,224
"064341705",353,434,787,298,344,294
"064341801",559,626,1185,357,387,346
"065810202",262,328,590,239,338,231
"064341805",395,458,853,317,396,314
"064341903",502,548,1050,357,412,347
"064342111",264,326,590,210,218,202
"064342202",502,499,1001,303,211,210
"064342203",312,334,646,190,199,188
"064342208",526,565,1091,313,225,211
"064342209",678,654,1332,340,285,282
"064342314",484,484,968,235,217,211
"064342517",383,418,801,253,268,234
"064342602",353,328,681,193,180,180
"064342610",641,677,1318,343,322,306
"064342709",553,571,1124,372,384,341
"064342802",653,674,1327,392,358,330
"064342903",433,467,900,315,347,294
"064342904",391,470,861,305,332,290
"064343001",366,374,740,252,266,226
"064343004",461,472,933,326,358,311
"064343007",453,535,988,347,412,343
"064343105",432,504,936,378,487,366
"064343109",222,271,493,237,348,216
"064343111",190,249,439,191,243,188
"064343207",399,465,864,323,361,301
"064343304",313,363,676,237,273,234
"064343406",377,426,803,260,273,252
"064343511",529,572,1101,334,299,274
"064343909",465,483,948,240,224,206
"064344203",276,321,597,206,228,191
"064344304",372,461,833,306,359,296
"064344306",389,464,853,290,294,265
"064344401",259,290,549,156,161,152
"064344506",406,416,822,226,235,220
"064344509",422,450,872,246,252,239
"064344510",435,441,876,249,239,224
"064410113",368,417,785,181,233,175
"064410201",246,190,436,212,244,174
"064410203",286,315,601,281,313,271
"064410205",196,263,459,242,257,233
"064410208",57,42,99,45,51,45
"064410304",265,304,569,247,257,239
"064410405",237,252,489,199,239,186
"064410406",248,288,536,252,353,249
"064410501",338,334,672,303,404,292
"064410913",256,322,578,234,347,233
"064411010",233,247,480,195,233,191
"064411014",186,212,398,191,240,185
"064411110",176,200,376,183,258,174
"064411208",95,130,225,131,230,130
"064411403",146,219,365,190,291,184
"064411408",199,272,471,231,342,226
"064411506",178,236,414,212,294,207
"064411509",263,352,615,329,431,303
"064411510",292,322,614,270,362,263
"064411605",232,238,470,181,224,171
"064411611",420,468,888,356,460,337
"064411612",283,346,629,268,367,263
"064411709",205,253,458,196,229,188
"064411713",287,310,597,211,215,181
"064411803",135,191,326,172,247,171
"064411901",266,387,653,275,399,273
"064411902",312,402,714,317,438,314
"064411904",207,279,486,226,334,219
"064412005",204,236,440,214,286,213
"064412104",403,479,882,371,437,361
"064412110",242,290,532,225,266,215
"064412114",242,261,503,203,258,197
"064412204",434,464,898,378,483,362
"064412301",270,327,597,256,320,250
"064412309",178,216,394,165,194,157
"064412404",246,317,563,212,239,196
"064412408",211,243,454,193,266,191
"064412507",228,274,502,215,280,208
"064412608",179,216,395,170,206,166
"064412611",258,297,555,219,272,217
"064412612",276,301,577,249,318,243
"064412701",366,479,845,331,415,321
"064412804",174,226,400,171,231,161
"064412807",195,254,449,171,215,170
"064412808",274,288,562,217,263,214
"064412810",282,352,634,274,321,263
"064412812",475,534,1009,371,435,355
"064412904",250,280,530,189,247,188
"064412912",228,262,490,180,214,175
"064413206",440,451,891,309,336,301
"064413305",382,443,825,268,291,261
"064413406",376,401,777,247,266,242
"064413407",351,399,750,248,274,239
"064413410",361,387,748,239,262,232
"064413502",526,663,1189,388,421,378
"064413602",1674,474,2148,271,284,257
"064413706",600,635,1235,358,371,339
"064413711",730,736,1466,388,393,359
"064413714",597,620,1217,353,381,341
"064413802",452,468,920,250,237,223
"064413804",408,393,801,224,223,190
"064413903",338,368,706,232,229,219
"064413905",381,430,811,280,297,269
"064414112",399,325,724,184,201,165
"064414202",404,414,818,206,223,195
"064414203",691,668,1359,357,380,350
"064414205",730,677,1407,360,347,323
"064414215",1032,977,2009,447,446,406
"064414303",356,373,729,241,267,227
"064414310",728,757,1485,423,427,393
"064414312",357,381,738,216,241,196
"064414403",685,731,1416,368,386,360
"064414405",494,538,1032,300,339,293
"064414407",689,689,1378,387,415,370
"064414511",750,732,1482,382,389,356
"064414605",409,427,836,253,265,238
"064414609",598,569,1167,322,341,301
"064414709",1062,1064,2126,590,555,519
"064414907",337,395,732,282,328,265
"064415002",263,295,558,204,224,186
"064415101",1209,1174,2383,596,440,416
"064415111",299,350,649,247,317,242
"064415113",296,320,616,213,251,204
"064415208",381,449,830,283,305,267
"064415301",291,311,602,214,234,208
"064415403",422,480,902,288,305,276
"064415416",384,388,772,240,237,214
"064415505",539,565,1104,321,348,306
"064415507",367,370,737,243,276,229
"064415511",396,359,755,205,235,199
"064415710",441,444,885,240,281,234
"064416002",325,341,666,225,287,221
"064416004",617,647,1264,382,398,355
"064416005",776,764,1540,401,377,347
"064416010",470,459,929,291,341,280
"064416309",262,240,502,140,210,135
"064416411",298,306,604,185,218,176
"066232906",553,564,1117,337,344,317
"064416507",110,93,203,64,117,61
"064416611",558,625,1183,372,450,355
"064416615",786,732,1518,399,416,380
"064416616",469,482,951,266,328,257
"064416617",617,612,1229,353,410,332
"064416805",543,582,1125,356,405,344
"064416806",327,313,640,162,186,154
"064416808",228,208,436,146,275,145
"064416810",112,85,197,72,168,72
"064416904",645,697,1342,402,416,380
"064550101",439,461,900,314,348,308
"066381109",697,729,1426,342,350,311
"064551409",114,113,227,77,87,75
"064551411",306,342,648,216,240,214
"064690112",245,296,541,218,252,212
"064690208",511,556,1067,394,458,388
"064760106",441,453,894,260,286,256
"064830104",289,370,659,253,291,249
"064830101",687,779,1466,456,499,437
"064830114",482,559,1041,300,320,287
"064830118",369,372,741,239,263,235
"066480211",433,409,842,234,253,225
"064830405",409,456,865,274,308,263
"064830417",191,222,413,118,158,114
"064830501",521,553,1074,341,366,319
"064900109",421,457,878,243,178,160
"064900114",406,462,868,214,166,150
"064900201",855,909,1764,458,392,368
"064900207",888,907,1795,441,388,379
"064900506",514,540,1054,300,223,209
"064900511",519,579,1098,329,274,259
"064900602",497,576,1073,368,413,354
"064900604",517,519,1036,343,397,338
"064900701",406,400,806,242,203,198
"064900908",360,404,764,262,303,255
"064900909",253,320,573,215,260,211
"064901010",448,478,926,317,365,313
"064901108",146,182,328,169,253,169
"064901110",206,251,457,216,299,213
"064901113",372,415,787,296,372,290
"064901114",393,486,879,315,357,303
"064901201",339,423,762,284,318,267
"064901305",328,377,705,229,216,210
"064901310",610,675,1285,393,403,367
"064901311",593,626,1219,379,359,327
"064901601",711,765,1476,420,433,407
"064901607",395,435,830,268,299,266
"064901803",490,567,1057,365,371,338
"064901812",635,702,1337,413,429,402
"064901902",391,450,841,298,326,278
"064901904",292,330,622,217,250,212
"064901911",315,388,703,235,239,221
"064902101",503,531,1034,390,485,383
"064902107",353,435,788,313,413,312
"064902207",135,183,318,173,363,173
"064902211",200,281,481,237,369,237
"064902212",31,59,90,46,120,46
"064902310",218,249,467,169,201,141
"064902312",184,236,420,209,294,208
"064902406",344,361,705,259,335,257
"064902501",451,511,962,323,360,316
"064902503",372,413,785,278,310,266
"064902703",422,519,941,334,342,309
"064902706",456,542,998,319,320,299
"064902807",324,380,704,241,251,227
"064902901",668,670,1338,372,367,333
"064902910",548,648,1196,361,353,326
"064902911",700,753,1453,452,449,405
"064903306",620,628,1248,347,352,334
"064903308",573,569,1142,304,260,243
"064903309",688,740,1428,351,267,263
"064903402",740,802,1542,427,315,309
"064903409",508,551,1059,267,188,181
"064903505",652,644,1296,408,418,346
"064903516",369,381,750,224,210,188
"064903604",661,674,1335,337,223,218
"066581807",274,326,600,225,265,218
"064903710",690,728,1418,424,277,259
"064903711",921,976,1897,548,473,444
"064903712",601,645,1246,338,272,255
"064903801",387,394,781,216,171,167
"064904606",219,266,485,186,220,175
"064903804",419,460,879,222,190,178
"064903809",531,585,1116,286,200,188
"064903911",870,897,1767,465,377,366
"064903912",585,576,1161,287,222,218
"064903916",686,661,1347,405,392,349
"064904010",849,772,1621,402,349,332
"064904207",512,558,1070,354,324,294
"064904208",427,406,833,285,303,268
"064904307",474,472,946,250,256,242
"064904310",505,584,1089,357,379,346
"064904314",318,365,683,226,262,211
"064904410",419,425,844,256,229,215
"064904506",509,579,1088,364,364,342
"064904602",304,346,650,262,320,260
"064904608",352,402,754,251,284,245
"064904709",318,355,673,238,265,222
"064904710",363,391,754,247,266,237
"064904803",353,390,743,248,321,241
"065391209",738,747,1485,340,323,297
"067561102",243,288,531,211,275,207
"067561108",206,285,491,234,285,229
"065391309",449,468,917,212,211,201
"065391402",305,331,636,203,214,187
"065391405",364,358,722,234,252,218
"065391409",792,858,1650,470,470,433
"065810501",67,91,158,77,194,75
"060771202",27,17,44,13,16,12
"065391508",319,364,683,246,298,241
"061120606",13,10,23,8,21,8
"061400502",24,21,45,14,23,14
"061680102",23,14,37,10,15,10
"060070201",19,16,35,8,8,8
"065391602",654,711,1365,429,434,397
"060070308",14,9,23,11,16,10
"060070511",5,7,12,4,7,4
"060070611",9,7,16,7,10,7
"060071107",9,3,12,5,10,5
"065391604",237,284,521,191,243,186
"060071004",7,4,11,4,15,4
"060071012",6,2,8,5,20,5
"060071104",15,11,26,9,16,9
"060140502",69,65,134,37,51,36
"060141401",11,5,16,7,23,5
"060210701",9,9,18,6,27,6
"061891203",11,9,20,7,14,6
"061960403",9,10,19,6,10,6
"062170905",15,19,34,11,18,11
"065391611",420,501,921,351,420,338
"062241702",32,18,50,17,34,13
"060421001",83,71,154,52,75,52
"060420301",107,66,173,68,86,68
"060490301",68,60,128,54,73,42
"067561403",274,345,619,221,236,215
"060490302",40,35,75,31,42,28
"060491801",164,91,255,92,130,90
"060492005",25,27,52,16,36,16
"060630301",19,13,32,14,18,11
"060630306",39,26,65,22,34,21
"065391704",546,556,1102,307,254,222
"060630707",364,351,715,240,330,233
"060631001",34,24,58,20,28,20
"060700602",65,53,118,43,65,42
"060700803",15,10,25,9,13,9
"065391705",601,623,1224,355,369,342
"060701004",13,9,22,9,16,9
"065391707",453,438,891,234,226,224
"065391708",404,420,824,247,263,236
"060701202",39,21,60,21,53,19
"060771001",4,1,5,4,15,4
"060771002",16,9,25,10,14,10
"060771101",9,4,13,5,10,5
"060771302",27,16,43,19,21,17
"060840302",35,31,66,18,35,17
"060840305",21,14,35,13,19,13
"060840501",49,39,88,34,46,32
"065391803",715,792,1507,416,369,351
"061050401",75,61,136,46,100,45
"061050806",65,56,121,31,58,31
"061051409",49,47,96,30,41,30
"061120402",8,4,12,6,9,4
"061120505",14,13,27,9,11,3
"061120707",13,8,21,6,28,6
"061121201",14,7,21,10,23,10
"061121205",6,7,13,5,14,5
"061190310",100,79,179,64,95,64
"061190802",26,16,42,12,18,12
"063221202",8,4,12,4,12,3
"063430501",28,25,53,16,46,16
"061261005",72,27,99,42,88,30
"065391908",484,503,987,282,281,272
"065391909",512,516,1028,290,300,280
"068052608",109,105,214,82,295,78
"061261002",80,60,140,46,72,28
"067561605",308,412,720,209,263,205
"065392003",460,502,962,282,291,275
"061340912",92,46,138,44,53,44
"065392005",522,561,1083,291,287,283
"061400103",50,44,94,29,41,29
"061400201",13,11,24,9,21,9
"061400503",20,15,35,14,20,14
"061400601",9,7,16,6,6,6
"061470401",12,9,21,8,22,6
"061470402",24,15,39,15,26,15
"061470703",143,86,229,76,70,70
"061470802",17,12,29,12,17,12
"061470804",22,22,44,15,17,15
"061540501",22,17,39,14,42,13
"061540701",33,24,57,22,51,22
"061540901",45,30,75,27,35,27
"061610302",12,6,18,8,20,8
"061610602",17,9,26,10,21,10
"061610702",37,26,63,20,25,20
"061680101",24,29,53,12,15,12
"061680301",25,16,41,16,30,16
"061680601",6,5,11,4,11,3
"061680604",14,8,22,7,13,7
"061680805",62,57,119,38,50,34
"061680806",16,13,29,9,11,9
"061681101",36,29,65,25,33,23
"061890102",13,10,23,10,17,9
"061890402",9,3,12,5,13,5
"061890603",15,6,21,5,8,5
"061890608",12,9,21,7,7,6
"061891010",25,17,42,17,30,16
"061891103",6,3,9,5,11,5
"061891107",3,4,7,3,8,3
"061891205",8,11,19,6,15,6
"061891210",16,11,27,9,13,8
"061891302",10,5,15,7,15,7
"061891303",18,16,34,12,27,12
"061891304",7,5,12,6,15,6
"061960603",7,6,13,7,16,7
"061960705",17,11,28,12,19,12
"061960707",31,19,50,21,35,20
"061960803",15,12,27,11,23,11
"061960805",1,1,2,1,3,1
"061960904",16,23,39,15,17,14
"065392107",424,458,882,281,312,278
"065392201",808,793,1601,478,489,447
"061961104",8,6,14,7,17,6
"061961107",6,3,9,6,23,6
"061961303",20,17,37,10,30,10
"061961502",13,16,29,9,18,9
"062030603",8,6,14,5,13,5
"062030702",5,5,10,5,14,5
"062030706",4,3,7,3,7,3
"065392208",805,858,1663,481,458,430
"062031001",1,1,2,1,9,1
"062031103",0,0,0,0,12,0
"062031403",11,6,17,7,11,7
"062031204",18,10,28,12,14,12
"062031405",38,22,60,22,31,22
"062031504",9,8,17,8,19,8
"062100602",28,18,46,20,34,20
"062100807",140,117,257,76,98,70
"062101001",85,65,150,49,86,47
"062170202",32,26,58,24,32,18
"062170901",29,25,54,18,35,18
"062170904",37,35,72,24,27,22
"065392413",542,551,1093,260,247,242
"065392503",854,928,1782,481,453,434
"065392504",431,422,853,250,266,242
"062170907",31,24,55,18,29,18
"062171010",119,88,207,74,110,69
"065392602",925,827,1752,450,489,446
"065392603",599,547,1146,279,271,257
"062240909",149,130,279,83,108,80
"062241401",21,14,35,12,22,12
"062241402",37,29,66,24,41,24
"062241601",12,11,23,9,33,9
"062242007",23,13,36,11,27,11
"065392608",742,757,1499,395,406,391
"062310203",17,13,30,13,24,13
"062310702",15,12,27,10,17,10
"065392701",854,897,1751,471,391,377
"062660202",68,32,100,38,45,38
"062701102",20,17,37,11,12,9
"062770105",9,10,19,7,16,7
"062770206",54,35,89,34,68,33
"062800507",19,14,33,8,13,8
"062800601",7,8,15,5,11,5
"062800709",32,23,55,19,37,19
"062800905",30,18,48,17,32,17
"062800906",40,29,69,22,28,22
"062870302",23,18,41,14,30,14
"062870201",83,56,139,57,89,53
"062940210",21,9,30,10,31,10
"062940103",0,0,0,0,17,0
"062940207",14,8,22,8,11,8
"065392704",606,632,1238,348,321,314
"062940704",18,10,28,8,26,8
"062940813",2,1,3,1,1,1
"063010401",100,65,165,60,95,60
"063010815",13,8,21,9,18,9
"063080801",21,10,31,12,28,12
"063081003",36,40,76,27,43,27
"063150501",100,98,198,78,139,77
"063220101",4,2,6,2,7,2
"063220302",28,17,45,19,31,19
"063221006",17,8,25,9,20,9
"063221007",71,44,115,44,66,43
"063221201",16,11,27,10,14,8
"063221303",21,13,34,12,17,12
"063290403",129,124,253,80,107,80
"063290503",60,57,117,36,37,36
"063430104",37,26,63,21,29,18
"063430201",79,53,132,44,76,44
"063430604",20,15,35,11,28,11
"063510501",26,26,52,15,30,15
"063511002",16,9,25,9,22,9
"063511003",16,16,32,12,22,12
"065392810",799,786,1585,434,401,397
"063577916",105,105,210,64,58,40
"063578102",25,17,42,18,33,18
"065600903",115,99,214,49,57,47
"063578301",160,131,291,87,125,86
"064550802",47,24,71,26,85,26
"065600806",556,524,1080,321,347,289
"063640604",33,41,74,19,35,17
"064761003",17,11,28,10,17,9
"063850405",9,5,14,5,25,5
"063920302",19,17,36,10,26,9
"063920604",45,54,99,27,36,26
"063920704",30,29,59,17,37,17
"063921204",73,59,132,42,55,42
"063921205",22,16,38,16,31,16
"063990401",30,38,68,21,38,20
"063990802",38,27,65,27,44,27
"064060107",2,0,2,1,5,1
"064060212",11,4,15,6,23,6
"064060301",14,13,27,10,18,10
"065110202",40,35,75,26,41,25
"064130902",14,12,26,9,10,9
"065320501",18,13,31,11,16,11
"066160106",2,1,3,1,5,1
"064480202",7,3,10,6,14,6
"064480403",0,0,0,0,18,0
"064480502",18,12,30,8,11,8
"064480801",9,5,14,5,15,5
"064481206",7,2,9,4,13,4
"064550201",48,32,80,32,52,30
"064550603",59,48,107,40,66,38
"064550605",30,23,53,22,27,19
"064690802",86,70,156,49,74,48
"064690902",14,10,24,10,27,10
"064690907",23,19,42,14,25,14
"064691102",20,13,33,10,13,10
"064691306",40,25,65,17,21,17
"064691502",16,11,27,13,25,13
"064760202",79,70,149,55,76,54
"064760203",63,48,111,42,69,42
"064760602",20,16,36,12,36,12
"064760603",56,47,103,37,81,37
"064760804",27,15,42,17,32,17
"064761204",55,43,98,21,43,21
"064830705",33,25,58,17,27,17
"064970202",35,28,63,22,46,20
"064970304",41,30,71,24,38,23
"064970401",77,56,133,34,33,28
"064970612",121,113,234,64,87,64
"064971003",32,27,59,17,21,17
"065050105",48,33,81,33,52,33
"065050202",48,27,75,24,50,24
"065050407",87,72,159,46,52,43
"065110701",31,35,66,25,41,24
"066860706",19,10,29,7,15,7
"067070701",3,4,7,1,5,1
"065180207",32,31,63,18,29,16
"065180304",64,53,117,42,55,41
"067140304",13,7,20,6,12,6
"065180411",9,4,13,3,4,3
"067210103",22,19,41,17,40,17
"065250410",24,31,55,14,27,13
"065320401",120,118,238,81,122,79
"065320502",54,43,97,30,32,30
"065320603",20,18,38,13,28,13
"065321301",26,9,35,13,12,10
"065600901",425,382,807,228,221,180
"067491503",69,40,109,34,104,34
"065470102",36,24,60,22,38,22
"065470202",61,38,99,30,41,20
"065470203",67,65,132,44,62,43
"065470313",102,109,211,63,87,57
"065600902",193,174,367,93,100,85
"065470502",63,49,112,32,48,32
"065470702",31,23,54,20,23,20
"067840204",9,6,15,5,9,5
"065740602",35,22,57,25,52,25
"065810603",39,44,83,31,42,31
"065810604",16,11,27,11,33,11
"065810705",28,13,41,14,23,14
"065600911",104,88,192,57,50,43
"065601001",271,258,529,163,221,160
"065601006",726,704,1430,387,386,353
"065601007",857,834,1691,448,490,429
"065601011",654,652,1306,377,368,318
"065601105",468,478,946,236,226,218
"065392912",168,153,321,73,90,66
"065392915",301,287,588,150,138,128
"065392916",760,748,1508,385,420,375
"065393003",541,570,1111,300,312,289
"065601110",825,777,1602,453,444,419
"065880503",19,8,27,12,28,12
"065881102",26,14,40,14,25,14
"065881203",66,59,125,34,37,34
"065951804",4,8,12,3,9,3
"065952601",204,134,338,107,168,105
"066510703",11,8,19,8,14,8
"066020701",13,2,15,10,69,9
"066090301",12,3,15,5,23,5
"066090602",7,4,11,6,21,6
"066091604",0,0,0,0,1,0
"066091708",21,22,43,13,27,13
"066160110",41,37,78,28,44,28
"065393109",692,690,1382,335,342,323
"066231202",13,9,22,9,34,9
"066231702",10,6,16,6,24,6
"066231703",18,11,29,12,22,12
"066231901",9,8,17,6,17,6
"066232403",25,26,51,16,26,16
"066440303",4,7,11,5,19,5
"066510404",15,8,23,10,17,10
"066510407",19,13,32,14,26,12
"066510711",7,4,11,5,17,5
"066510804",8,5,13,7,14,7
"066510806",4,2,6,3,9,2
"066510811",4,4,8,4,11,4
"066510814",6,7,13,4,4,4
"066511003",14,7,21,11,28,11
"066511304",21,18,39,11,19,11
"067700502",1,0,1,1,2,1
"066650403",35,26,61,26,38,26
"066651005",13,9,22,7,21,7
"066720601",11,9,20,7,11,7
"066721002",29,19,48,20,44,20
"065393205",828,864,1692,386,348,327
"066790102",34,26,60,21,47,21
"066790201",25,16,41,18,18,18
"066790301",42,22,64,21,25,21
"066791206",48,28,76,28,48,28
"066860208",5,4,9,5,17,5
"066860209",19,13,32,10,22,10
"066860303",21,22,43,13,30,12
"066860402",17,15,32,7,20,7
"066860501",18,18,36,10,14,10
"066861201",14,6,20,10,24,10
"066860903",17,18,35,9,29,9
"066930102",30,28,58,23,34,23
"066930201",49,36,85,32,59,32
"066930315",6,4,10,4,4,4
"066930402",70,47,117,46,76,46
"065393301",552,582,1134,332,348,320
"066930604",29,30,59,19,45,19
"067000703",17,11,28,10,13,7
"067000904",12,7,19,9,17,7
"067070202",61,36,97,34,52,31
"065393306",588,574,1162,295,285,245
"067140303",4,3,7,3,7,3
"067140401",21,16,37,13,23,12
"067140402",23,23,46,17,33,17
"067140502",21,17,38,14,24,13
"067140703",19,12,31,10,18,10
"067210211",18,21,39,12,28,12
"067280202",119,107,226,74,113,74
"067280203",41,32,73,22,32,22
"067280501",30,22,52,17,27,16
"067280701",21,19,40,12,19,11
"067281103",47,25,72,25,33,25
"067281404",52,35,87,26,26,21
"067281603",24,18,42,18,33,18
"065393311",341,289,630,150,162,142
"067350402",98,76,174,53,64,45
"067421002",99,77,176,63,100,61
"065393410",605,598,1203,322,325,296
"065393412",597,570,1167,304,302,275
"065393413",621,644,1265,379,398,343
"067491511",213,184,397,131,355,130
"060140601",28,17,45,19,50,17
"065470306",665,684,1349,410,464,395
"067700201",15,10,25,8,8,8
"067700303",14,5,19,7,12,7
"067700702",3,1,4,2,6,2
"067700703",1,1,2,1,4,1
"067700804",10,8,18,7,14,7
"067700904",2,2,4,3,6,3
"067700907",24,15,39,13,13,12
"067701104",20,20,40,15,15,15
"067701105",55,44,99,28,32,28
"067701202",69,62,131,38,49,37
"067701205",27,19,46,12,13,12
"067701303",29,27,56,19,34,19
"067701502",8,6,14,7,14,6
"067701704",11,8,19,6,19,5
"067702001",21,10,31,10,18,10
"067780505",39,26,65,27,43,27
"067840102",15,13,28,12,29,12
"067840503",15,14,29,9,14,9
"067840701",17,19,36,11,15,11
"067910501",63,37,100,35,47,35
"067910702",67,41,108,38,62,37
"067911001",53,49,102,34,67,31
"067911501",143,132,275,63,110,63
"067911505",30,27,57,20,27,20
"067911602",56,39,95,43,44,42
"067980203",43,37,80,30,34,30
"067980505",17,18,35,22,16,11
"068120303",3,3,6,2,12,2
"068052602",116,78,194,75,325,73
"065470910",365,419,784,283,358,281
"065530110",36,55,91,37,411,37
"065530305",153,135,288,100,263,99
"065600104",681,675,1356,322,331,313
"065600113",576,593,1169,299,296,271
"065600206",904,880,1784,433,410,380
"065600207",722,757,1479,372,370,341
"067630206",444,514,958,362,432,358
"065600210",821,781,1602,412,409,381
"065600404",900,905,1805,455,437,425
"065600215",823,809,1632,408,446,379
"065601202",580,631,1211,307,296,268
"065600216",1239,1071,2310,691,845,674
"065600407",513,475,988,216,238,215
"065600416",456,530,986,301,313,291
"065600503",347,362,709,187,180,172
"065600603",771,805,1576,446,433,398
"065180614",137,145,282,96,199,93
"065180810",68,65,133,54,170,53
"065250411",167,176,343,81,94,77
"065250610",622,644,1266,360,410,344
"065320304",381,368,749,225,257,219
"065320309",694,710,1404,422,462,399
"065320912",186,171,357,104,222,104
"065321101",94,97,191,62,101,62
"065390105",652,692,1344,401,416,374
"065390108",626,646,1272,335,317,286
"065390305",451,532,983,366,395,316
"065390307",420,509,929,342,404,331
"067560303",221,271,492,200,307,197
"065390609",461,467,928,284,294,278
"065390707",347,366,713,207,202,187
"065390809",692,685,1377,384,340,330
"065390904",702,716,1418,382,342,332
"065391001",684,727,1411,370,339,323
"065391005",372,352,724,231,232,213
"065391012",943,939,1882,508,494,461
"065391203",624,669,1293,356,318,301
"063573008",82,115,197,111,188,110
"063711104",303,405,708,337,460,335
"064410414",214,280,494,245,321,237
"064621202",566,595,1161,444,485,425
"060980705",460,471,931,309,354,293
"060420701",97,73,170,64,109,64
"060700404",194,183,377,111,162,111
"060770510",1049,1170,2219,587,617,573
"061260602",23,14,37,17,32,17
"061260603",48,55,103,32,53,32
"061260606",205,181,386,116,237,116
"062311201",563,579,1142,315,304,233
"061400309",389,404,793,251,279,246
"061610604",28,13,41,13,25,12
"061821110",143,144,287,76,78,74
"062310603",50,37,87,33,42,33
"064480612",29,43,72,32,38,32
"062601714",96,73,169,52,91,51
"064690304",51,43,94,27,49,27
"062601705",124,95,219,62,175,62
"062660403",171,137,308,90,187,87
"062660501",766,683,1449,412,497,380
"062660706",121,136,257,80,116,74
"062701101",712,739,1451,402,463,371
"062940606",27,26,53,17,33,17
"062800816",69,51,120,38,59,38
"062940608",107,115,222,71,102,70
"063081002",392,421,813,283,376,283
"063150303",251,209,460,143,203,139
"063577909",654,607,1261,377,445,363
"063640204",404,381,785,223,127,79
"063920605",95,71,166,54,98,54
"064550701",97,79,176,66,107,66
"063850101",341,346,687,251,307,247
"063921503",88,69,157,58,71,58
"063990503",65,51,116,46,72,40
"063990703",399,419,818,275,312,263
"064131803",19,21,40,14,27,14
"064690301",63,52,115,39,52,38
"064690606",654,622,1276,362,411,329
"064830413",732,690,1422,397,431,368
"064830706",50,37,87,30,37,28
"064970803",403,401,804,232,275,222
"064971210",237,197,434,127,229,125
"064971305",130,115,245,77,112,76
"065050306",574,601,1175,337,412,329
"066860302",42,20,62,24,41,24
"065250203",566,539,1105,305,409,302
"065250302",101,59,160,35,39,34
"065250413",159,141,300,73,196,70
"065320908",368,217,585,131,182,125
"065391015",592,589,1181,283,267,256
"065952707",354,328,682,214,262,205
"066090608",98,112,210,80,97,66
"066232102",143,117,260,82,202,77
"066232208",544,695,1239,390,384,368
"066232903",578,564,1142,292,310,276
"066232908",424,430,854,198,152,138
"066380101",91,70,161,49,71,43
"066550204",387,428,815,306,389,305
"067001003",67,53,120,55,99,52
"067630601",849,823,1672,420,441,410
"067630809",715,706,1421,358,370,338
"067701013",990,901,1891,513,434,383
"067780502",125,110,235,76,104,75
"067780704",18,20,38,14,33,14
"060980407",107,118,225,76,200,74
"065681408",311,366,677,242,257,207
"065681501",376,415,791,272,284,260
"065681504",606,694,1300,410,423,393
"065681506",449,451,900,332,308,290
"065681509",267,327,594,220,229,216
"065681601",544,601,1145,372,329,307
"065681702",565,616,1181,321,326,307
"065681705",571,624,1195,388,433,379
"065681708",512,567,1079,369,384,335
"065681709",335,396,731,268,270,230
"065681901",339,379,718,255,264,230
"065681903",558,643,1201,427,459,406
"065682005",274,322,596,274,367,271
"065682012",515,596,1111,333,356,308
"065682104",244,287,531,266,382,262
"065682107",28,39,67,41,158,41
"065682109",178,185,363,167,417,161
"065682208",280,275,555,197,233,197
"065682212",244,252,496,172,227,170
"065682215",234,222,456,160,193,159
"065682301",337,368,705,201,211,184
"065682603",535,528,1063,356,345,314
"065682604",304,322,626,212,222,203
"065682605",237,268,505,175,184,164
"065682610",576,603,1179,379,396,358
"065682708",437,434,871,273,292,265
"065682810",708,737,1445,398,399,380
"065682912",652,640,1292,352,304,286
"065682913",537,537,1074,280,266,257
"065683006",464,499,963,289,303,278
"065683008",600,659,1259,380,348,319
"065740403",639,633,1272,356,394,347
"065740409",361,402,763,259,322,258
"065740414",520,512,1032,318,382,311
"065810102",634,712,1346,374,401,369
"065810103",666,665,1331,393,422,391
"065810206",260,393,653,298,389,297
"065810208",342,418,760,289,338,277
"065810211",441,469,910,261,280,260
"065810301",350,464,814,304,349,299
"065810302",381,459,840,325,376,310
"065810402",250,275,525,209,268,207
"065810708",284,280,564,186,220,183
"065811708",161,212,373,142,194,141
"065811709",84,142,226,82,164,81
"065811401",162,184,346,96,122,92
"065811403",588,609,1197,333,350,317
"065811502",545,563,1108,332,335,318
"065811912",371,387,758,256,348,248
"065880102",356,382,738,294,382,289
"065880105",314,413,727,314,417,301
"065880112",371,375,746,240,227,194
"065880802",43,33,76,29,41,29
"065880910",426,471,897,277,315,275
"068190401",438,468,906,320,370,318
"068190601",42,40,82,30,47,30
"065950105",447,508,955,359,431,352
"065950214",268,357,625,205,216,189
"065950215",215,280,495,201,217,198
"065950401",342,355,697,227,252,222
"067490307",309,349,658,216,248,211
"065951610",245,296,541,194,209,192
"065951613",246,307,553,189,211,187
"065951801",9,1,10,6,26,6
"068260213",101,118,219,101,150,98
"065951902",306,306,612,196,238,190
"065951903",600,584,1184,317,342,311
"065951906",164,145,309,94,102,93
"065952105",403,444,847,285,316,276
"067490308",313,391,704,255,305,238
"066090207",288,341,629,209,234,209
"065952412",418,421,839,272,315,269
"065952508",417,416,833,299,337,296
"065952509",302,363,665,255,302,249
"065952510",397,418,815,267,312,262
"065952512",359,362,721,213,246,210
"065952603",492,451,943,239,291,231
"065952610",603,636,1239,325,356,319
"065952612",642,636,1278,391,438,362
"065952703",363,359,722,198,293,194
"066020302",368,312,680,207,215,199
"066020803",129,153,282,117,152,115
"066021603",760,762,1522,411,462,396
"066090104",300,410,710,272,348,265
"066090607",141,115,256,87,188,86
"066091001",274,278,552,178,230,177
"066091002",176,207,383,138,168,136
"068400706",379,436,815,292,325,284
"066091702",413,431,844,284,340,281
"066091906",372,461,833,338,437,333
"066230112",331,376,707,242,261,233
"066230208",319,371,690,291,313,283
"066230304",168,299,467,215,275,212
"066230306",254,378,632,287,428,284
"066230410",419,480,899,282,293,273
"066230508",446,584,1030,327,332,309
"068402205",420,461,881,284,285,265
"066380605",802,848,1650,423,400,370
"066231501",110,101,211,79,96,72
"066480506",965,1015,1980,474,483,454
"066232007",635,708,1343,446,458,426
"066232011",999,1025,2024,538,551,510
"066232104",404,430,834,239,305,239
"066232201",324,412,736,267,286,262
"066232206",376,483,859,298,308,288
"066232701",192,201,393,143,199,143
"066232802",644,622,1266,378,419,366
"066232804",418,511,929,330,344,317
"066380112",1347,1332,2679,729,937,716
"066380208",460,464,924,253,269,236
"066381007",846,841,1687,441,443,416
"066380401",650,659,1309,366,355,333
"066380403",717,664,1381,318,270,248
"066380407",628,605,1233,335,358,302
"066380501",147,165,312,90,122,88
"066380607",766,720,1486,384,388,351
"066380610",837,872,1709,429,438,405
"066380613",736,712,1448,387,312,300
"066380706",259,255,514,158,229,148
"066380712",569,559,1128,313,354,292
"066380806",324,324,648,197,215,188
"066380913",924,902,1826,436,378,370
"066381101",340,320,660,163,169,142
"066381202",158,121,279,52,281,52
"066381205",921,923,1844,497,695,483
"066381207",11,12,23,11,283,11
"066381311",683,644,1327,309,328,307
"068612804",384,423,807,311,349,302
"066381501",252,220,472,129,142,126
"068612910",434,486,920,351,364,320
"066381608",420,446,866,283,305,282
"066381704",483,474,957,293,288,256
"066381801",1745,1664,3409,925,463,378
"066381804",672,664,1336,413,548,399
"066381904",371,339,710,178,169,142
"068680609",87,88,175,76,384,76
"066382105",112,107,219,60,122,60
"066382214",788,812,1600,410,424,387
"066440110",33,39,72,34,444,34
"068751401",73,72,145,53,100,53
"066440201",274,295,569,201,360,195
"066440304",271,262,533,171,395,169
"066440309",57,46,103,40,318,39
"066440310",40,43,83,30,292,30
"066440503",381,339,720,206,239,202
"066440506",572,605,1177,398,526,379
"066440618",92,89,181,69,319,69
"066440621",142,132,274,96,234,93
"066480104",502,600,1102,336,378,329
"066510508",379,447,826,363,451,354
"066510715",320,332,652,255,337,254
"066550310",395,426,821,272,316,265
"066580111",4,5,9,3,3,3
"066580208",569,616,1185,326,297,279
"066580211",787,828,1615,385,376,344
"066580212",438,484,922,287,297,274
"066580303",574,603,1177,362,370,338
"066580504",318,312,630,203,201,190
"066580513",421,457,878,281,275,247
"066580710",949,962,1911,464,431,416
"066580801",196,232,428,163,204,161
"066580802",155,225,380,205,262,203
"066580811",238,337,575,292,392,292
"066580814",161,215,376,199,268,178
"066580906",247,335,582,263,396,259
"066581002",713,746,1459,363,339,333
"066581007",477,539,1016,379,420,372
"066581101",410,461,871,315,321,288
"066581103",284,324,608,232,260,230
"066581108",365,429,794,276,312,271
"066581113",281,314,595,215,243,211
"066581201",632,716,1348,440,480,425
"066581301",341,311,652,170,164,157
"066581508",383,384,767,277,309,275
"066581511",280,312,592,207,246,206
"066581609",381,409,790,292,325,291
"066581611",300,345,645,227,261,217
"066581706",544,594,1138,345,390,345
"066581804",337,420,757,279,290,256
"066581808",312,353,665,269,303,263
"066582104",669,682,1351,353,340,324
"066582301",372,415,787,262,261,247
"066582410",300,382,682,236,257,229
"066582307",253,283,536,198,201,180
"066582312",395,458,853,278,295,253
"066582403",614,706,1320,439,468,422
"066582801",321,323,644,218,260,218
"066582806",679,721,1400,368,360,340
"066582810",529,608,1137,388,406,370
"066583001",537,601,1138,389,418,381
"066583003",476,505,981,311,318,300
"066583105",497,535,1032,323,330,310
"066583107",386,476,862,314,317,306
"066583302",827,780,1607,360,293,288
"066583303",758,669,1427,343,281,276
"066583306",844,900,1744,447,470,439
"066583412",603,636,1239,376,390,355
"066583509",522,597,1119,332,338,320
"066583805",878,810,1688,447,360,343
"066583806",899,879,1778,438,443,433
"066583815",775,801,1576,451,404,368
"066583905",736,742,1478,411,361,349
"066583908",528,509,1037,292,297,287
"066584002",725,714,1439,329,344,311
"066584007",785,775,1560,429,413,402
"066584014",547,561,1108,296,264,257
"066584206",463,491,954,273,268,257
"066584301",478,503,981,290,301,285
"066584302",709,739,1448,420,418,393
"066584305",653,619,1272,315,273,268
"066584306",738,718,1456,370,323,315
"066584404",1059,1056,2115,558,516,497
"066584405",646,684,1330,361,336,317
"066650204",399,472,871,339,376,330
"066650501",18,13,31,11,18,11
"066651002",583,577,1160,338,362,333
"066651306",711,702,1413,425,455,396
"066721215",390,412,802,294,326,286
"066790105",138,135,273,91,112,91
"066790601",643,618,1261,365,390,349
"066790613",318,312,630,239,309,235
"066791201",132,107,239,94,124,92
"066860101",299,332,631,199,208,191
"066861309",383,450,833,301,336,290
"066930312",280,331,611,241,317,239
"066930305",234,209,443,154,183,151
"066930318",363,358,721,239,263,238
"067490305",378,418,796,292,334,281
"067000205",286,272,558,194,248,193
"067000501",86,96,182,66,103,66
"067001204",315,340,655,234,248,217
"067001207",354,416,770,307,354,301
"067070106",525,576,1101,403,464,387
"067070605",231,231,462,147,180,142
"067070405",511,502,1013,278,301,266
"067070607",193,199,392,158,209,156
"067140103",410,441,851,311,363,298
"067140105",442,532,974,369,393,351
"067140501",339,309,648,217,257,216
"067140609",463,463,926,265,284,250
"067140614",18,11,29,7,12,7
"067140617",542,524,1066,293,321,275
"067210203",221,275,496,223,275,220
"067210204",514,539,1053,409,491,405
"067210217",309,315,624,247,291,243
"067280201",156,156,312,102,123,95
"067281001",395,407,802,216,219,204
"067281002",237,254,491,162,183,158
"067281006",192,212,404,141,163,138
"067281020",421,452,873,257,276,253
"067350102",253,251,504,172,192,163
"067350105",493,606,1099,387,427,365
"067350710",513,513,1026,249,266,236
"067420401",446,450,896,339,382,329
"067420405",298,349,647,229,260,227
"067420408",251,287,538,194,225,191
"067490304",418,484,902,344,386,322
"067490103",592,511,1103,335,340,316
"067490202",562,586,1148,362,369,343
"067490206",163,179,342,121,177,118
"067490211",386,422,808,263,299,260
"067490310",290,358,648,257,350,248
"067490312",433,506,939,364,445,360
"067490405",225,246,471,100,54,43
"067490501",210,258,468,157,185,143
"067490601",271,274,545,204,285,188
"067490901",432,501,933,322,331,283
"067491012",585,596,1181,300,385,278
"067491105",466,520,986,289,264,240
"067491113",626,685,1311,408,442,381
"067491201",544,581,1125,327,288,276
"067491310",405,483,888,272,285,268
"067560108",222,272,494,197,222,194
"067560114",547,657,1204,390,428,375
"067560116",453,530,983,356,399,351
"067560208",338,366,704,225,256,212
"067560504",496,516,1012,301,407,297
"067560603",185,241,426,188,254,188
"067560606",201,290,491,248,373,246
"067560607",252,379,631,341,457,337
"067560610",292,400,692,346,441,341
"067560612",307,342,649,219,269,215
"067560808",465,533,998,362,397,355
"067560809",433,509,942,313,375,309
"067560909",462,526,988,337,369,332
"067560915",497,546,1043,339,383,332
"067561113",364,397,761,254,285,250
"067561202",280,336,616,234,289,215
"067561205",431,472,903,310,332,274
"067561210",408,464,872,281,294,254
"067561303",670,773,1443,409,419,388
"067561401",1142,1187,2329,617,540,523
"067561601",494,545,1039,345,357,306
"067561604",442,485,927,309,330,284
"067561703",476,531,1007,338,340,300
"067562004",281,322,603,187,188,182
"067562308",482,578,1060,352,388,322
"067562403",330,361,691,214,197,186
"067562404",340,359,699,227,237,225
"067562406",462,551,1013,325,325,303
"067562519",516,560,1076,369,412,349
"067562603",250,289,539,189,201,175
"067562706",808,881,1689,498,476,463
"067562709",339,352,691,220,226,214
"067600101",531,560,1091,338,298,290
"067600105",739,748,1487,485,492,446
"067600106",387,450,837,287,280,243
"067600115",395,435,830,296,297,263
"067600210",575,666,1241,414,453,389
"067600310",117,121,238,74,88,71
"067600512",522,594,1116,364,426,353
"067600703",653,714,1367,472,524,423
"067600708",499,509,1008,319,350,302
"067600811",392,452,844,266,254,218
"067600907",555,639,1194,421,489,386
"067601004",399,466,865,250,238,230
"067601101",349,384,733,237,256,222
"067601105",295,382,677,197,207,184
"067601201",353,400,753,216,254,212
"067601202",403,415,818,232,249,227
"067601205",492,499,991,266,293,253
"067601212",642,612,1254,311,330,291
"067601307",473,460,933,259,241,222
"067601309",784,789,1573,431,379,341
"067601314",826,776,1602,446,420,394
"067630105",473,492,965,318,332,297
"067601316",374,352,726,207,199,181
"067601414",475,477,952,248,236,222
"067601503",293,353,646,187,180,154
"067601603",638,694,1332,359,360,330
"067601604",587,609,1196,324,323,296
"067601606",786,770,1556,383,403,380
"067601612",263,295,558,183,198,178
"067601703",504,509,1013,295,291,263
"067601704",555,565,1120,305,310,291
"067601803",698,734,1432,370,336,327
"067601811",587,653,1240,312,284,275
"067601812",785,747,1532,411,359,337
"067601814",583,591,1174,317,288,274
"067630209",396,468,864,322,370,314
"067630504",683,265,948,164,179,163
"067630602",471,496,967,264,288,260
"067630706",773,789,1562,445,472,421
"067630801",415,374,789,240,236,219
"067630902",396,336,732,189,193,179
"067631808",312,328,640,169,178,166
"067632002",153,140,293,85,106,85
"067701001",474,448,922,255,271,238
"067702211",390,454,844,286,324,280
"067702213",273,273,546,199,230,197
"067702203",770,805,1575,428,428,402
"067702204",1114,1126,2240,490,486,461
"067780101",432,485,917,279,319,275
"067780105",572,649,1221,368,454,359
"067780216",334,314,648,172,184,170
"067910214",389,439,828,279,303,273
"067781009",713,764,1477,419,461,394
"067840804",590,607,1197,332,359,302
"067840807",368,437,805,290,352,287
"067910108",196,262,458,203,284,199
"067910111",227,272,499,210,263,205
"067910204",366,364,730,268,299,259
"067910208",360,441,801,309,371,307
"067910211",434,490,924,333,397,327
"067910302",275,290,565,206,238,200
"067910305",172,188,360,161,196,158
"067910404",267,294,561,215,269,210
"067910405",159,180,339,159,229,157
"067910411",260,269,529,224,299,221
"067911002",137,113,250,84,104,83
"067911008",224,240,464,147,171,142
"067911302",491,484,975,270,274,261
"067911309",382,375,757,246,254,237
"067911310",462,478,940,264,290,254
"067911910",220,240,460,202,315,200
"067912001",421,481,902,301,325,286
"067912006",470,486,956,388,492,383
"067912214",320,351,671,229,255,228
"067912217",295,309,604,159,222,158
"067980502",47,42,89,28,38,26
"068050608",371,425,796,340,481,328
"068050306",484,476,960,402,835,388
"068050607",155,143,298,122,168,117
"068050410",872,862,1734,519,454,449
"068050505",429,461,890,266,276,265
"068050509",390,411,801,271,280,254
"068050602",399,393,792,300,248,184
"068050604",527,583,1110,401,434,368
"068050707",213,235,448,148,337,124
"068050710",45,59,104,28,327,28
"068050808",910,956,1866,575,353,287
"068050903",513,518,1031,301,321,298
"068051106",629,617,1246,347,344,337
"068051311",823,834,1657,438,411,389
"068051312",672,750,1422,405,422,380
"068051909",518,573,1091,325,309,287
"068051315",441,442,883,278,290,269
"068051318",750,808,1558,488,502,476
"068051406",529,576,1105,313,317,297
"068051505",548,592,1140,340,347,313
"068051701",724,745,1469,393,360,345
"068051804",622,684,1306,430,430,380
"068051809",651,716,1367,404,393,359
"068051904",376,399,775,229,251,216
"068051905",516,521,1037,300,294,276
"068051914",399,444,843,287,321,279
"068052001",250,252,502,170,178,168
"068052004",927,975,1902,550,557,518
"068052009",604,674,1278,351,349,329
"068052205",991,963,1954,543,555,520
"068052206",768,754,1522,412,401,355
"068052303",871,849,1720,479,521,465
"068052407",366,339,705,186,226,183
"068190405",429,437,866,293,345,290
"068260102",459,492,951,283,308,270
"068260116",219,241,460,159,174,144
"068260203",450,467,917,231,246,227
"068260207",166,199,365,154,205,150
"068261605",229,216,445,113,86,59
"068330107",394,491,885,364,465,361
"068330108",398,514,912,317,402,312
"068330701",9,8,17,9,12,9
"068331008",958,904,1862,488,399,358
"068331101",291,276,567,192,261,190
"068331408",178,179,357,137,161,134
"068331703",246,245,491,185,214,181
"068400105",931,951,1882,503,510,490
"068400112",601,633,1234,357,319,286
"068400212",645,644,1289,399,398,366
"068400307",671,709,1380,415,383,361
"068400401",872,881,1753,489,495,469
"068400604",502,502,1004,306,288,276
"068401604",400,393,793,311,351,304
"068400704",411,458,869,316,363,304
"068400707",439,493,932,316,348,306
"068400901",461,495,956,302,330,295
"068401004",320,401,721,320,353,315
"068401013",263,298,561,232,260,229
"068401101",377,412,789,282,315,282
"068401102",359,377,736,236,249,225
"068401204",251,305,556,200,195,178
"068401403",353,366,719,251,271,240
"068401301",456,494,950,333,346,307
"068401304",452,498,950,347,384,337
"068401308",280,322,602,222,243,214
"068401310",568,648,1216,431,457,403
"068401510",454,521,975,376,503,368
"068401601",344,379,723,254,292,250
"068401803",206,286,492,190,228,162
"068401806",421,517,938,390,532,363
"068401811",299,343,642,229,260,225
"068401912",438,471,909,304,279,246
"068402005",453,512,965,334,359,323
"068402108",502,564,1066,305,278,262
"068402202",459,512,971,327,337,292
"068402404",363,397,760,241,245,224
"068402605",494,549,1043,319,323,301
"068402809",438,501,939,297,289,260
"068403009",278,350,628,241,294,225
"068403013",222,269,491,216,296,213
"068403208",437,501,938,314,344,280
"068470102",483,511,994,350,380,346
"068052618",123,113,236,74,230,74
"068120101",38,35,73,20,29,20
"068120601",7,2,9,4,13,4
"068540101",274,266,540,177,221,173
"068540108",334,411,745,297,351,291
"068540110",485,539,1024,393,460,386
"068190602",64,47,111,44,98,43
"068260301",23,11,34,14,20,14
"068260902",51,33,84,24,37,24
"068261301",57,22,79,33,40,29
"068261601",95,55,150,49,64,36
"068330305",10,7,17,5,12,5
"068330401",35,33,68,31,56,31
"068330604",10,10,20,8,13,8
"068330702",12,11,23,13,20,13
"068331403",5,3,8,5,29,5
"068330706",35,19,54,20,36,20
"068331013",81,58,139,49,67,48
"068331103",9,7,16,9,23,9
"068331201",15,13,28,12,19,12
"068331202",16,18,34,10,24,10
"068331503",21,10,31,11,17,11
"068331604",2,1,3,2,8,2
"068331808",36,33,69,26,61,26
"068470202",8,11,19,7,35,7
"068540701",48,40,88,26,42,26
"068541011",72,57,129,46,81,46
"068541103",39,33,72,23,46,23
"068750701",53,40,93,42,91,37
"068820402",44,45,89,28,152,27
"068541003",327,423,750,287,345,280
"068541005",320,351,671,270,321,266
"068541009",73,72,145,62,102,62
"068541014",250,244,494,179,207,175
"068610205",211,267,478,222,286,222
"068610304",321,464,785,363,396,362
"068610404",142,180,322,167,249,165
"068610503",266,291,557,228,286,224
"068610507",244,279,523,240,318,235
"068610601",114,133,247,104,219,103
"068610606",269,331,600,258,333,254
"068610706",215,257,472,180,215,177
"068610805",202,231,433,186,270,183
"068610901",396,448,844,346,419,341
"068611004",468,520,988,337,405,334
"068611101",444,515,959,335,372,329
"068611106",441,503,944,333,355,297
"068611110",269,348,617,249,308,248
"068611301",188,229,417,167,221,167
"068611304",300,400,700,282,334,281
"068611401",263,337,600,260,355,258
"068611404",386,452,838,290,328,280
"068611501",209,307,516,274,371,273
"068611506",320,392,712,278,333,272
"068611508",377,479,856,417,513,399
"068611604",399,488,887,332,380,321
"068611606",398,417,815,312,351,287
"068611701",450,490,940,326,356,321
"068611702",453,452,905,308,338,308
"068611707",495,539,1034,344,365,329
"068611902",124,161,285,119,149,119
"068611907",440,481,921,325,367,317
"068611910",351,421,772,274,311,267
"068612004",352,443,795,329,400,325
"068612105",386,418,804,306,336,288
"068612201",408,477,885,322,386,316
"068612209",301,335,636,212,219,190
"068612301",670,684,1354,424,424,384
"068612408",520,580,1100,383,388,357
"068612502",598,701,1299,441,459,422
"068612503",526,582,1108,382,409,365
"068612506",409,452,861,288,333,269
"068612508",531,551,1082,390,424,362
"068612606",390,483,873,337,413,327
"068612709",337,394,731,270,275,241
"068612802",452,511,963,351,405,348
"068612805",316,372,688,255,276,236
"068612806",348,393,741,285,350,280
"068612901",752,840,1592,515,578,493
"068612902",374,411,785,288,306,281
"068612905",410,458,868,296,307,267
"068612906",290,286,576,184,201,165
"068613107",607,671,1278,441,458,405
"068613204",101,131,232,107,137,107
"068680213",778,784,1562,460,541,446
"068680307",227,243,470,168,511,168
"068680410",42,33,75,29,158,28
"068680507",113,92,205,94,590,94
"068680606",22,18,40,19,295,19
"068680702",340,381,721,245,479,241
"068820101",507,557,1064,360,362,329
"068680803",205,193,398,119,169,114
"068680807",42,33,75,25,245,24
"068750605",479,482,961,270,347,266
"068750601",370,404,774,258,322,256
"068751608",345,364,709,255,276,246
"068751503",178,189,367,112,118,96
"068820202",408,423,831,275,304,250
"068820211",547,613,1160,391,425,368
"068820503",815,745,1560,456,435,414
"068820806",460,494,954,336,382,326
"068820907",875,906,1781,487,441,388
"068820914",569,558,1127,305,297,284
"068821010",1110,1097,2207,555,491,457
"068821602",584,641,1225,398,376,342
"065601401",1080,988,2068,476,400,361
"065601404",682,711,1393,326,341,309
"065601509",1008,970,1978,499,452,432
"065601610",659,668,1327,353,379,334
"065601613",751,711,1462,385,411,371
"067702205",604,636,1240,353,353,329
"065601801",411,402,813,215,260,198
"065601803",410,421,831,222,256,211
"065601808",295,289,584,185,278,182
"065601809",802,777,1579,405,432,388
"067780406",170,172,342,105,146,103
"065601910",720,726,1446,379,453,371
"065601916",394,369,763,201,227,196
"065602012",487,543,1030,297,293,276
"065602109",677,701,1378,395,433,379
"065602203",590,584,1174,357,455,330
"065602207",395,414,809,249,282,239
"065602302",536,560,1096,295,295,279
"065602305",541,566,1107,345,350,317
"065602315",300,382,682,258,280,239
"065602505",349,357,706,217,246,209
"065602512",435,477,912,261,273,243
"065680101",322,227,549,134,141,116
"067911007",213,234,447,137,166,135
"065680210",316,358,674,230,250,223
"065680301",473,509,982,339,358,312
"065680403",295,372,667,231,259,215
"065680405",456,499,955,341,376,331
"065680504",299,348,647,229,254,225
"065680605",417,447,864,316,370,311
"065680610",236,243,479,227,304,225
"065680702",407,455,862,302,331,301
"065680704",335,390,725,244,277,240
"065680802",468,486,954,327,351,320
"065680806",493,612,1105,355,374,332
"065680903",566,618,1184,408,432,389
"065680904",318,371,689,233,245,214
"065681008",498,558,1056,339,353,327
"065681202",435,462,897,334,400,329
"065681208",297,333,630,232,260,218
"065681305",423,481,904,330,370,325
"067702301",48,29,77,25,45,25
"064904901",365,384,749,263,297,257
"064904907",398,419,817,275,294,273
"064904910",426,473,899,333,337,299
"064905004",171,185,356,101,90,87
"064905101",353,404,757,251,278,246
"064905102",430,473,903,280,285,265
"064905103",328,358,686,203,221,200
"064905108",479,557,1036,363,385,342
"064905110",240,284,524,189,209,180
"064970108",337,376,713,229,219,189
"065680314",1436,1529,2965,602,578,554
"064970309",319,330,649,165,181,160
"064970406",295,290,585,182,206,173
"064970409",434,391,825,218,245,210
"064970604",421,444,865,295,330,282
"064970613",331,321,652,199,224,186
"064970802",726,604,1330,275,278,256
"064971107",422,469,891,308,340,301
"064971108",373,416,789,265,292,261
"064971205",545,608,1153,370,391,347
"064971212",144,138,282,91,168,87
"065050212",200,217,417,147,170,134
"065050302",78,82,160,63,162,60
"065050309",344,376,720,235,269,229
"065050315",478,458,936,281,302,264
"065110504",335,414,749,277,330,276
"065152113",456,577,1033,298,326,290
"065180202",299,342,641,194,203,188
"065180205",556,597,1153,359,385,351
"065180212",258,268,526,164,220,159
"065150108",990,1022,2012,498,493,472
"065150109",511,535,1046,276,238,233
"065180504",377,374,751,237,273,228
"065180706",72,53,125,52,243,47
"065150201",150,125,275,90,97,85
"065150406",782,823,1605,416,328,311
"060070513",2,1,3,2,15,2
"065150411",421,382,803,187,167,156
"065150504",801,829,1630,458,392,382
"065150609",714,786,1500,436,410,383
"065150702",605,596,1201,323,337,315
"065150708",739,767,1506,394,338,318
"060283308",691,718,1409,405,416,370
"065150905",679,749,1428,424,426,403
"060283908",535,503,1038,269,250,235
"060351203",178,229,407,166,192,164
"060353301",469,496,965,320,352,269
"065151106",396,410,806,241,249,223
"060562313",326,359,685,250,289,236
"060562609",306,334,640,196,238,187
"060700104",175,208,383,145,175,139
"065151105",344,380,724,229,231,213
"065151107",379,413,792,248,270,245
"060911607",267,289,556,174,201,173
"060912403",558,569,1127,273,298,262
"065151206",468,512,980,287,288,269
"065151209",729,811,1540,420,428,400
"061260705",675,652,1327,340,334,301
"061260706",403,418,821,233,253,224
"061470108",326,384,710,285,314,280
"065151212",567,594,1161,344,303,293
"060070402",98,90,188,56,74,56
"060070502",0,0,0,0,2,0
"060070802",192,161,353,110,133,105
"060070811",307,315,622,222,237,198
"060070812",240,277,517,187,214,183
"060141010",427,492,919,354,413,354
"061891006",337,426,763,308,385,299
"060211002",66,46,112,49,107,47
"060280104",485,500,985,295,340,293
"060280106",445,439,884,266,259,241
"060280204",875,879,1754,429,393,382
"060280312",508,534,1042,266,234,226
"060280602",1156,1154,2310,667,654,611
"060280612",512,499,1011,256,255,242
"060280701",1181,1263,2444,608,538,521
"060280708",556,560,1116,307,281,262
"060280710",537,572,1109,342,358,318
"060280813",474,554,1028,377,394,361
"060280904",947,1003,1950,533,502,490
"060281014",617,666,1283,347,348,323
"060281016",508,508,1016,309,316,303
"060281109",689,771,1460,472,499,443
"060281205",437,523,960,314,373,309
"060281206",245,312,557,190,248,189
"060281405",748,705,1453,372,380,352
"060281406",824,876,1700,465,425,403
"060281501",481,480,961,250,243,228
"060281502",436,446,882,256,226,209
"060281509",877,936,1813,546,486,430
"060281510",646,690,1336,353,351,317
"060281607",392,445,837,234,227,217
"060281702",563,598,1161,341,332,310
"060281709",433,464,897,288,298,282
"060281903",716,818,1534,377,398,367
"060281904",727,748,1475,378,363,343
"060281905",316,331,647,170,182,166
"060282005",810,785,1595,418,311,276
"060282006",695,750,1445,382,378,345
"060282103",640,681,1321,408,394,366
"060282110",478,485,963,247,210,192
"060282112",527,556,1083,292,300,264
"063573706",145,195,340,170,601,168
"060282217",360,366,726,208,181,167
"060282307",412,504,916,333,380,331
"060282404",376,525,901,397,403,384
"060282503",129,204,333,189,326,188
"060282705",411,426,837,248,267,241
"060282708",724,796,1520,443,453,421
"060282711",328,376,704,238,268,234
"060282802",400,430,830,266,243,213
"060282902",326,383,709,229,253,220
"060283001",426,465,891,263,242,230
"060283015",560,535,1095,295,283,255
"062100108",295,311,606,224,244,216
"060283102",359,431,790,254,296,236
"060283108",410,444,854,215,203,191
"060283110",689,777,1466,420,422,383
"060283111",546,602,1148,359,391,347
"060283313",767,725,1492,396,382,354
"060283403",636,683,1319,416,439,389
"060283409",628,634,1262,392,430,376
"060283503",648,674,1322,348,340,300
"060351212",261,297,558,218,271,217
"060283614",852,833,1685,422,440,405
"060283704",563,601,1164,317,317,290
"060283707",434,463,897,245,256,235
"060283812",493,553,1046,304,324,290
"060283913",917,969,1886,495,507,466
"060350102",811,837,1648,418,195,185
"060350203",581,600,1181,299,296,287
"060350307",439,461,900,317,326,315
"060350315",447,500,947,330,352,318
"060350410",356,376,732,248,264,230
"060350415",331,361,692,253,245,224
"060350501",292,304,596,193,211,184
"060350612",457,490,947,299,342,263
"060350703",433,486,919,264,276,244
"060350706",536,567,1103,363,379,340
"060351102",485,487,972,259,261,229
"060351103",260,250,510,157,159,154
"060351104",372,458,830,320,490,306
"060351108",447,481,928,365,442,354
"060351205",423,413,836,261,282,229
"063573708",122,138,260,127,265,125
"060351308",332,351,683,245,314,242
"060351502",346,466,812,312,363,305
"060351503",398,463,861,340,367,337
"060351506",702,758,1460,480,472,419
"060351512",292,348,640,239,275,229
"060351603",382,489,871,288,322,279
"060351611",353,368,721,245,253,224
"060351705",478,570,1048,352,362,333
"060351804",325,424,749,268,278,246
"060351805",341,420,761,277,313,265
"060351806",410,478,888,321,340,299
"060351810",341,348,689,254,295,252
"060351903",403,449,852,325,400,323
"060352004",333,378,711,242,274,235
"060352612",381,404,785,228,214,203
"060352108",245,313,558,280,331,234
"060352203",213,249,462,200,259,198
"060352211",225,252,477,186,249,184
"060352306",478,570,1048,363,382,346
"060352405",352,391,743,248,287,248
"060352409",576,567,1143,352,350,318
"060352604",145,148,293,90,90,83
"060352703",436,449,885,285,293,264
"060352705",369,410,779,246,224,191
"060352710",472,505,977,282,289,271
"060353002",534,553,1087,311,317,298
"060353004",544,627,1171,359,393,331
"060353105",551,606,1157,373,369,331
"060353106",255,299,554,207,203,176
"060353206",452,466,918,310,405,299
"060353207",476,524,1000,343,406,333
"060353303",503,634,1137,405,449,386
"060353305",224,268,492,183,238,182
"060353503",378,420,798,273,301,258
"060421901",512,541,1053,329,387,319
"060490206",358,420,778,301,343,293
"060490209",453,505,958,318,334,300
"060490403",141,155,296,92,130,91
"060490405",245,215,460,142,161,133
"060490505",412,447,859,329,372,315
"060490613",724,764,1488,423,480,418
"060491004",141,139,280,111,147,110
"060491005",141,182,323,97,114,84
"060491008",246,261,507,177,218,177
"062520106",960,931,1891,493,485,443
"060492505",508,498,1006,240,225,210
"060560210",373,403,776,294,329,286
"060560304",330,361,691,273,308,266
"060560407",380,448,828,315,387,308
"060560508",309,319,628,216,226,202
"060560701",562,583,1145,394,435,387
"060560806",407,443,850,252,269,243
"060561102",145,200,345,146,223,142
"060561109",136,212,348,187,270,187
"060561111",191,269,460,236,353,235
"060561112",262,335,597,279,374,271
"060561402",269,300,569,221,254,218
"060561405",212,236,448,217,251,215
"060561406",439,517,956,409,525,405
"062521419",764,783,1547,412,410,387
"060561602",283,286,569,202,256,201
"060561607",207,253,460,190,214,182
"060561608",388,474,862,315,383,305
"060561614",247,346,593,251,351,243
"060561704",257,313,570,214,259,211
"060561805",412,424,836,311,332,300
"060561905",709,734,1443,383,389,361
"060561908",505,439,944,240,249,226
"063573804",94,125,219,111,387,111
"060561912",604,648,1252,397,415,370
"060562002",440,519,959,387,462,386
"060562103",286,317,603,209,234,199
"060562105",438,507,945,351,397,347
"060562107",571,594,1165,352,298,250
"060562111",550,523,1073,341,383,330
"060562214",503,519,1022,309,351,295
"060562309",624,654,1278,378,407,357
"060562310",379,405,784,284,319,271
"060562412",773,793,1566,413,426,394
"060562416",656,604,1260,356,352,324
"060562501",609,619,1228,389,521,374
"060562502",1276,808,2084,487,537,469
"060562616",514,511,1025,256,253,244
"060562512",505,563,1068,348,416,336
"060562603",528,524,1052,313,394,300
"060562604",214,192,406,128,180,126
"065151314",464,491,955,263,274,258
"060562617",855,832,1687,468,615,461
"060563003",268,288,556,207,239,203
"060630208",461,482,943,330,356,302
"062700102",290,339,629,185,216,180
"060631301",304,356,660,282,388,275
"060700202",501,502,1003,314,327,294
"060700204",494,595,1089,355,410,342
"060700205",576,598,1174,357,382,338
"060700208",541,515,1056,286,282,245
"060700215",489,456,945,296,331,281
"060701001",104,99,203,58,89,56
"062740805",391,435,826,243,249,240
"060771401",646,687,1333,354,340,319
"060840301",82,75,157,57,90,56
"060840710",317,360,677,285,332,271
"060910305",356,394,750,236,245,222
"060841206",664,702,1366,413,459,399
"060841207",221,273,494,200,246,199
"060910307",656,682,1338,403,407,384
"060910104",303,360,663,255,282,254
"060910109",659,677,1336,449,464,419
"060910202",471,488,959,297,330,268
"060910204",365,437,802,327,408,318
"060910310",481,581,1062,402,440,367
"060910410",1055,1003,2058,520,502,486
"060910412",687,686,1373,398,385,361
"062741711",433,411,844,238,252,233
"060910604",419,396,815,267,292,263
"060910608",929,944,1873,473,471,450
"060910704",518,531,1049,305,308,292
"060910707",802,784,1586,424,427,392
"060910802",298,305,603,213,209,194
"060910803",426,451,877,248,247,223
"060910804",529,587,1116,308,277,258
"060910805",392,424,816,244,257,232
"060910905",270,318,588,210,217,199
"060911004",328,388,716,242,255,229
"060911005",653,689,1342,453,467,445
"060911108",651,716,1367,426,448,413
"060911109",643,719,1362,428,446,400
"060911205",543,593,1136,335,339,324
"060911301",675,706,1381,363,349,315
"060911306",599,687,1286,362,317,289
"060911309",752,818,1570,469,476,427
"062742118",693,679,1372,355,350,330
"060911405",779,758,1537,364,340,326
"060911410",919,948,1867,522,443,411
"060911504",611,728,1339,446,529,429
"060911510",517,507,1024,285,295,281
"060911602",724,757,1481,436,453,390
"060911614",619,664,1283,373,357,338
"060911703",800,868,1668,470,472,432
"060911802",410,412,822,244,267,239
"060911804",640,748,1388,414,465,396
"060911807",715,759,1474,417,433,401
"060911907",311,389,700,236,260,221
"060911911",481,490,971,280,257,241
"060912010",588,591,1179,317,301,255
"060912011",562,637,1199,373,443,362
"060912116",661,677,1338,314,310,298
"060912202",497,536,1033,317,351,293
"060912210",893,935,1828,493,479,406
"060912301",479,500,979,266,288,256
"060912302",529,578,1107,301,314,286
"060912304",649,694,1343,400,431,390
"060912315",464,409,873,232,123,65
"060912401",361,347,708,204,209,187
"060912402",378,390,768,223,267,220
"060912408",220,208,428,136,207,129
"062801006",29,41,70,30,174,30
"060980212",907,877,1784,449,466,433
"062801205",696,692,1388,438,446,399
"060980306",607,604,1211,364,369,340
"060980603",743,831,1574,491,511,452
"060980607",389,427,816,300,338,288
"060980503",501,547,1048,311,319,291
"060980703",233,281,514,165,183,163
"060980811",394,440,834,260,268,226
"061050205",304,417,721,304,371,297
"062940501",49,41,90,27,32,25
"061120105",266,304,570,229,282,225
"065151407",431,468,899,235,207,193
"061120110",786,743,1529,492,527,477
"061120204",268,257,525,178,206,177
"061120210",386,402,788,297,334,292
"061120703",122,139,261,78,94,76
"061121002",217,249,466,162,211,162
"061121104",78,87,165,53,54,41
"061121407",268,377,645,274,336,272
"061190303",486,549,1035,368,406,362
"061190304",718,749,1467,447,483,423
"061190707",317,336,653,238,272,234
"061191002",598,616,1214,357,368,343
"061191005",505,511,1016,294,327,288
"061191009",433,451,884,267,294,264
"061260111",336,369,705,253,320,250
"061260208",450,495,945,286,284,263
"061260307",428,455,883,319,379,306
"061340911",512,497,1009,272,295,263
"061260803",274,311,585,219,307,209
"061260807",401,458,859,269,328,261
"061260911",670,656,1326,343,358,335
"063571604",312,455,767,321,426,315
"061340103",439,418,857,224,302,216
"061340304",530,574,1104,385,437,376
"061340402",347,322,669,185,261,180
"063571305",395,406,801,255,292,249
"061340904",255,247,502,141,146,138
"061341006",395,471,866,297,343,276
"061341007",308,321,629,193,205,192
"061341009",862,885,1747,502,529,471
"061400303",439,448,887,284,288,243
"061400307",407,445,852,299,320,277
"061400315",522,573,1095,350,398,343
"061400318",403,424,827,251,264,240
"063574102",245,355,600,267,952,242
"061471203",508,529,1037,330,326,290
"061471209",424,468,892,305,337,302
"061540102",172,174,346,108,139,108
"061610107",224,231,455,164,195,162
"063572107",202,326,528,196,373,195
"061750404",263,261,524,187,205,168
"061750607",341,341,682,203,211,196
"061820102",649,681,1330,375,476,366
"061820105",518,557,1075,359,385,353
"061820107",410,444,854,305,354,297
"061820112",561,582,1143,324,348,319
"061820114",580,624,1204,326,348,326
"061820201",281,345,626,218,232,215
"061820309",306,344,650,193,208,192
"061820604",591,622,1213,342,326,292
"061820605",841,817,1658,442,476,432
"061820704",369,394,763,238,263,238
"061821011",354,415,769,288,341,286
"061821101",320,323,643,216,248,214
"061821102",442,473,915,322,381,318
"061821105",288,286,574,199,235,194
"061891001",283,332,615,209,253,204
"061891202",15,5,20,7,12,7
"063572205",150,182,332,180,380,180
"061891501",208,210,418,156,187,155
"061891503",88,70,158,63,302,62
"061891509",183,221,404,179,227,176
"061891703",361,435,796,314,360,309
"061891706",235,298,533,225,300,224
"061960103",348,429,777,266,298,259
"061960114",244,270,514,202,238,200
"061960116",361,467,828,339,381,326
"061960204",361,346,707,243,269,235
"061961102",23,23,46,19,27,14
"062030109",259,293,552,220,256,216
"062030204",274,270,544,181,217,178
"062030213",159,166,325,127,144,124
"062030215",250,275,525,195,231,195
"062030402",7,4,11,5,21,5
"062030806",487,524,1011,392,440,384
"062100105",223,247,470,178,193,173
"062100109",200,247,447,174,219,173
"062100112",206,228,434,161,187,156
"062100114",243,229,472,150,181,149
"062380206",323,417,740,274,336,271
"062100613",100,84,184,68,91,68
"062101301",393,470,863,355,402,343
"062101309",528,549,1077,332,359,326
"062170416",391,407,798,255,286,245
"062170504",4,5,9,5,21,5
"062171212",534,561,1095,299,357,292
"062171214",226,261,487,178,251,176
"062171205",513,528,1041,325,355,310
"062171210",639,719,1358,432,505,424
"062240110",353,409,762,294,396,282
"062240201",334,349,683,222,263,219
"062240202",375,396,771,248,271,240
"062240204",672,652,1324,408,448,388
"062240214",371,388,759,238,263,234
"062240305",302,329,631,214,247,209
"062240306",347,369,716,237,266,236
"062240401",479,464,943,248,236,212
"062240403",528,553,1081,383,438,373
"062240412",246,246,492,150,197,141
"062240416",223,257,480,168,201,165
"062240505",29,25,54,16,23,16
"062240915",258,289,547,176,211,173
"062241901",80,86,166,48,93,48
"062242205",357,379,736,296,345,291
"062242208",320,397,717,278,336,270
"063572213",116,178,294,136,296,136
"062311203",316,320,636,223,248,221
"062311205",331,409,740,297,354,289
"062311211",648,623,1271,356,393,346
"062380106",303,426,729,247,317,243
"062380108",289,334,623,236,288,231
"062380205",282,338,620,242,309,238
"062380208",466,495,961,336,363,316
"062380210",364,407,771,228,263,227
"062380608",7,4,11,4,26,4
"062450111",421,450,871,301,372,294
"062450307",391,395,786,272,314,267
"062450206",855,860,1715,494,510,468
"062450310",529,566,1095,317,300,287
"062450401",322,348,670,210,346,208
"062450403",441,405,846,256,398,244
"062520503",419,490,909,357,402,351
"062450502",288,320,608,206,236,190
"062520103",360,314,674,176,171,160
"064101311",508,523,1031,304,279,257
"062520108",858,876,1734,524,525,484
"062520109",315,369,684,251,295,246
"062520201",145,136,281,104,258,104
"062520202",223,203,426,141,472,139
"062520205",207,199,406,133,235,132
"062520208",107,101,208,69,96,62
"064120405",462,483,945,274,277,260
"062520306",686,684,1370,379,414,358
"062520402",729,714,1443,410,419,358
"065151507",736,749,1485,409,375,356
"062520611",198,176,374,112,222,99
"062520612",289,233,522,154,215,151
"062520701",549,592,1141,335,332,320
"062520705",1026,978,2004,482,444,425
"062520707",726,680,1406,352,375,336
"062520709",405,468,873,288,291,255
"062600214",626,688,1314,359,346,319
"062520806",623,659,1282,415,480,405
"062520909",555,546,1101,310,288,265
"062520911",910,934,1844,493,435,419
"062521001",277,271,548,172,323,170
"062521009",544,581,1125,317,336,310
"062521109",282,261,543,166,228,166
"062521201",713,747,1460,350,352,329
"062521308",400,446,846,251,275,242
"062521407",576,609,1185,310,321,297
"062521508",871,856,1727,419,368,348
"062600101",865,827,1692,446,419,390
"062600106",992,988,1980,520,514,486
"062600114",666,684,1350,352,322,283
"062600211",738,750,1488,385,383,366
"062600309",431,410,841,222,218,198
"064131407",714,746,1460,371,366,347
"062600409",527,545,1072,311,308,293
"062600505",725,709,1434,372,373,352
"062600806",639,641,1280,320,303,287
"062600809",581,587,1168,352,374,325
"062600908",799,803,1602,438,436,400
"062600909",417,443,860,249,254,239
"062600912",611,588,1199,309,295,274
"063572901",117,160,277,149,435,148
"062601101",117,156,273,130,214,130
"062601104",423,517,940,336,397,325
"062601203",190,238,428,170,235,166
"065151601",426,449,875,294,333,283
"062601402",439,478,917,297,333,284
"062601405",538,628,1166,370,397,359
"062601411",585,585,1170,345,308,275
"062601501",879,848,1727,443,461,418
"062601503",367,359,726,200,211,192
"062601505",643,629,1272,348,307,292
"062601507",560,566,1126,292,275,264
"062601508",580,539,1119,264,269,250
"062601601",718,738,1456,412,452,396
"062601607",764,835,1599,377,396,370
"062660611",185,176,361,114,281,114
"063573001",119,161,280,172,456,170
"062660301",544,519,1063,304,329,286
"062660509",97,119,216,75,192,75
"062740609",471,497,968,252,256,238
"062660606",74,64,138,61,172,59
"064202204",78,98,176,65,264,65
"062660711",301,295,596,159,182,150
"062700204",532,506,1038,288,298,265
"062700303",871,838,1709,435,442,413
"062700310",691,704,1395,383,411,366
"062700408",256,295,551,180,239,176
"062700411",879,902,1781,478,473,439
"062700510",764,792,1556,418,429,380
"064270909",336,322,658,180,143,142
"062700512",387,371,758,235,389,235
"062700602",264,281,545,186,428,181
"062700606",770,771,1541,442,469,411
"062700609",635,646,1281,363,458,355
"062700718",956,955,1911,522,523,487
"062700719",818,820,1638,445,466,413
"062700802",64,58,122,43,103,42
"064271901",352,462,814,235,220,201
"062701006",735,687,1422,385,315,278
"062740104",323,324,647,215,200,187
"062740109",432,478,910,261,249,228
"062740115",916,916,1832,530,491,454
"062740310",664,671,1335,403,385,366
"062740401",629,691,1320,362,354,327
"062740414",641,635,1276,300,304,293
"062740506",454,441,895,225,218,211
"062740509",503,487,990,268,275,255
"062740516",531,583,1114,315,297,273
"062740605",716,711,1427,396,417,388
"062740709",641,678,1319,339,332,302
"062740712",523,562,1085,277,272,263
"062740802",451,456,907,269,232,203
"062740818",612,593,1205,300,309,286
"062740901",659,622,1281,344,373,326
"062740904",585,604,1189,292,316,286
"062740905",526,527,1053,256,267,245
"062740922",552,538,1090,282,315,274
"062741002",586,518,1104,302,313,279
"062741112",575,581,1156,301,313,284
"062741114",621,601,1222,299,314,281
"062741201",707,757,1464,455,464,410
"062741203",484,557,1041,312,348,300
"062741204",320,378,698,186,228,169
"062741207",396,430,826,232,228,208
"062741212",785,798,1583,398,413,379
"062741304",411,415,826,250,256,235
"062741310",409,408,817,242,236,222
"062741312",599,646,1245,387,405,359
"062741317",680,758,1438,440,470,417
"062741404",402,419,821,298,332,293
"062741407",278,356,634,241,354,239
"062741517",746,717,1463,366,339,328
"062741613",714,705,1419,384,298,288
"062741608",511,541,1052,290,302,279
"062741609",441,434,875,238,235,226
"062741707",422,421,843,245,228,207
"062741710",635,605,1240,331,313,294
"062741803",526,520,1046,280,242,238
"062741805",555,545,1100,252,242,234
"064275201",917,1098,2015,453,411,401
"062741809",679,646,1325,306,301,292
"062742005",948,931,1879,494,439,418
"062742012",684,701,1385,343,325,308
"062742109",555,542,1097,263,251,248
"062742111",486,493,979,260,265,251
"062742117",784,755,1539,394,328,293
"062742206",654,636,1290,315,335,305
"062742211",818,738,1556,402,465,394
"062770109",350,355,705,213,253,212
"062770111",618,634,1252,429,483,417
"062800102",343,305,648,177,222,172
"062800109",240,237,477,129,145,124
"062800308",76,102,178,48,351,48
"062800310",55,63,118,52,353,52
"062800313",30,41,71,29,332,29
"062800404",12,11,23,13,368,12
"062800603",50,46,96,33,115,32
"062800604",28,28,56,24,126,24
"062800617",28,36,64,26,79,25
"064276705",745,723,1468,312,260,251
"062801005",100,118,218,95,377,93
"062800910",15,8,23,10,130,10
"062800912",84,82,166,57,171,57
"062801103",487,598,1085,363,467,345
"062801210",322,303,625,193,208,189
"062870413",472,512,984,350,400,317
"063571602",321,362,683,264,326,254
"062940203",564,553,1117,383,439,379
"062940407",13,7,20,9,12,9
"062940609",178,166,344,123,150,121
"064278715",441,478,919,230,224,219
"062940610",193,172,365,133,163,132
"063570206",427,432,859,276,329,272
"062940807",324,372,696,218,241,216
"063010507",268,292,560,187,223,182
"064279213",667,702,1369,347,348,321
"063010805",280,289,569,191,410,191
"064279306",1077,1034,2111,543,510,478
"063080603",61,52,113,31,39,30
"063150112",526,527,1053,304,352,294
"063150118",456,500,956,289,348,281
"063150301",448,485,933,261,325,258
"063573107",189,307,496,302,622,291
"063220601",580,577,1157,388,475,384
"063220604",251,272,523,197,220,192
"063220617",409,440,849,255,293,252
"063221002",35,33,68,25,42,24
"063290201",100,98,198,60,74,55
"063290304",384,420,804,247,282,241
"063570806",405,427,832,266,287,253
"064342102",328,406,734,252,271,245
"063430701",165,170,335,101,144,100
"063430702",309,304,613,179,208,177
"063510601",234,250,484,157,237,151
"063510602",139,147,286,101,272,100
"063570201",458,473,931,287,317,275
"063570302",275,255,530,171,283,170
"063570311",535,597,1132,355,444,336
"063570504",357,318,675,244,315,242
"063570601",483,484,967,307,336,292
"063570804",375,411,786,249,299,245
"063570812",521,576,1097,356,405,348
"063571003",586,622,1208,382,431,376
"063571009",428,426,854,243,263,236
"063573701",162,212,374,213,494,208
"063571014",518,511,1029,266,278,248
"063571101",354,386,740,213,245,205
"063571107",593,605,1198,314,284,264
"063571109",641,714,1355,417,415,368
"063571201",534,544,1078,322,358,316
"063571208",754,683,1437,375,377,345
"063571308",461,473,934,282,320,279
"063571404",435,515,950,326,360,311
"063571503",345,388,733,272,312,269
"063571509",364,399,763,294,323,257
"063571701",401,393,794,266,343,262
"063571703",216,240,456,183,278,182
"063571706",282,276,558,195,267,193
"063571805",392,461,853,321,429,319
"063571806",326,370,696,255,312,250
"063572004",126,162,288,151,366,151
"063572405",188,244,432,238,796,229
"063572602",222,337,559,323,1053,320
"063572702",146,192,338,182,466,180
"064411903",229,305,534,230,314,228
"063573404",229,382,611,365,784,362
"063573408",84,124,208,98,223,95
"063573504",164,218,382,196,427,195
"063574001",20,34,54,24,75,20
"063574005",125,135,260,143,595,142
"063574007",216,272,488,268,888,258
"063574206",128,169,297,170,445,168
"063574409",99,89,188,84,278,83
"063574507",357,460,817,283,413,271
"063574510",431,452,883,278,356,274
"063574511",140,176,316,126,376,126
"063574604",168,220,388,149,215,144
"063574607",182,235,417,197,262,194
"063574703",352,440,792,317,393,309
"063574907",315,395,710,291,393,287
"063575004",442,514,956,343,403,340
"063575106",516,511,1027,296,322,273
"063575707",274,340,614,223,256,219
"063575307",594,647,1241,385,427,366
"063575406",340,389,729,247,289,242
"063575407",377,402,779,241,273,236
"063575604",435,563,998,373,450,368
"063575607",442,516,958,346,386,330
"063575701",686,721,1407,473,488,447
"063575905",358,419,777,286,345,275
"063575909",220,286,506,181,217,171
"063575910",215,280,495,192,234,173
"063575911",414,457,871,318,385,309
"063576003",338,431,769,292,363,289
"063576004",244,295,539,205,241,196
"063576008",319,348,667,240,267,229
"063576201",478,528,1006,334,400,314
"063576401",588,597,1185,352,420,345
"063576405",309,338,647,204,305,200
"063576411",138,172,310,118,463,117
"063576501",273,281,554,178,217,177
"063576507",410,408,818,252,318,246
"063576510",271,284,555,187,278,184
"063576513",99,101,200,70,232,68
"063576602",419,451,870,289,312,278
"063576702",364,401,765,242,250,210
"063576713",404,381,785,213,187,183
"063577003",648,669,1317,447,505,433
"063577009",356,389,745,232,239,224
"063577014",522,539,1061,286,292,264
"063577207",604,576,1180,341,343,323
"065151609",457,445,902,268,299,253
"063710503",238,267,505,186,188,157
"063577712",81,89,170,58,146,56
"063577715",72,67,139,48,183,48
"063577804",521,533,1054,289,325,283
"063577904",418,392,810,231,262,224
"063577906",440,446,886,219,227,213
"063577907",414,404,818,199,198,177
"063578002",425,436,861,249,322,240
"063578003",504,526,1030,291,319,269
"063578004",567,519,1086,296,316,281
"063578016",398,372,770,230,313,224
"064416613",423,416,839,204,241,198
"063578110",283,270,553,176,207,160
"063578212",209,223,432,153,335,144
"063578213",241,186,427,123,138,120
"063640305",330,355,685,187,203,185
"063640211",211,186,397,116,167,114
"063640214",186,180,366,116,203,114
"063640312",491,543,1034,273,359,236
"063640401",621,656,1277,375,395,357
"063640409",462,466,928,240,277,239
"063640702",421,447,868,264,312,244
"063640707",346,418,764,251,284,242
"063640713",387,438,825,277,324,274
"063640808",384,349,733,199,134,84
"063640816",369,368,737,221,330,214
"063710209",553,628,1181,398,419,394
"063640819",489,478,967,267,305,256
"063710103",790,765,1555,405,374,371
"063710205",974,983,1957,524,513,461
"063710303",239,295,534,176,158,154
"063710307",485,521,1006,336,351,315
"063710310",378,466,844,238,240,235
"063710509",556,629,1185,394,404,380
"063710603",471,497,968,302,262,242
"063710609",729,769,1498,372,326,319
"063710611",808,816,1624,434,428,416
"063710702",897,987,1884,461,456,425
"063710901",568,613,1181,391,385,359
"063710803",436,522,958,319,355,314
"063710805",402,452,854,303,352,283
"063710903",361,441,802,258,269,245
"063710907",487,517,1004,308,300,274
"063711015",400,532,932,339,378,320
"063711201",487,584,1071,384,424,363
"063711205",261,275,536,227,274,226
"063711307",544,604,1148,393,428,376
"063711309",581,688,1269,429,438,382
"063711409",475,480,955,246,217,210
"063711504",285,295,580,145,130,130
"063711508",382,372,754,182,154,149
"063711801",536,591,1127,399,396,329
"063711811",586,651,1237,434,464,404
"063711815",668,755,1423,451,453,411
"063711905",445,483,928,330,381,323
"063711908",437,488,925,339,367,321
"063712004",545,600,1145,404,439,374
"063712007",562,644,1206,405,386,363
"063712104",219,255,474,176,215,171
"063712106",178,202,380,119,130,118
"063712110",446,488,934,324,342,283
"063712114",373,466,839,292,330,273
"063712201",423,437,860,314,354,306
"063712207",452,500,952,335,357,308
"063712310",206,239,445,200,341,199
"063712403",559,614,1173,411,430,394
"063712501",394,402,796,271,290,256
"063712502",428,527,955,296,318,288
"063712602",345,444,789,236,216,184
"063712705",422,472,894,306,345,302
"063712706",244,286,530,179,182,168
"063712803",38,51,89,32,46,32
"063712804",165,152,317,104,120,99
"063712904",418,489,907,326,375,308
"063713003",561,550,1111,348,286,262
"063713007",290,325,615,222,249,214
"063713008",347,338,685,256,270,241
"063713201",134,133,267,66,107,66
"063713305",594,686,1280,424,464,416
"063713310",234,263,497,199,213,190
"063713402",573,625,1198,392,350,323
"063713407",496,543,1039,330,324,287
"063713503",422,426,848,255,231,217
"063713705",366,348,714,182,153,140
"063850702",393,440,833,289,329,286
"063850703",273,274,547,204,238,202
"063850705",356,433,789,311,387,302
"063850716",260,322,582,215,250,212
"063920114",488,512,1000,304,337,295
"063920401",177,154,331,124,158,123
"063920708",204,221,425,150,164,148
"063920906",194,212,406,130,159,127
"063920907",279,267,546,177,215,177
"063921201",638,628,1266,284,296,277
"064344408",324,366,690,224,241,222
"063990109",256,273,529,182,212,181
"063990303",214,225,439,134,159,134
"064903310",742,701,1443,378,300,285
"064344409",309,296,605,207,223,199
"064080113",642,683,1325,411,419,390
"064080211",484,539,1023,332,344,311
"064080304",499,527,1026,307,295,273
"064080402",1155,1187,2342,626,547,534
"064080506",404,439,843,240,218,203
"064080509",524,552,1076,304,327,301
"064080604",382,424,806,274,328,272
"064080608",384,462,846,284,309,272
"065151702",607,644,1251,365,407,341
"064080804",300,315,615,205,233,196
"064080808",427,482,909,336,358,322
"064080906",475,545,1020,363,403,354
"064081102",545,555,1100,331,317,298
"064970112",482,515,997,252,259,244
"064081208",855,810,1665,474,511,464
"064081301",706,764,1470,452,479,433
"064081303",570,604,1174,320,297,279
"064081407",355,395,750,248,260,230
"064081409",395,453,848,262,225,203
"064081509",514,542,1056,352,351,303
"064100102",702,702,1404,381,353,342
"064100103",684,698,1382,384,310,304
"064100104",772,767,1539,447,456,427
"064100111",1408,1453,2861,817,902,792
"064100205",692,703,1395,397,408,375
"064270104",126,137,263,117,165,117
"064100409",838,885,1723,476,459,431
"064100410",443,465,908,246,260,242
"064120712",661,682,1343,359,330,323
"064971306",434,491,925,319,353,309
"064100605",493,494,987,323,361,313
"064100702",263,296,559,195,205,184
"064100804",402,419,821,259,266,236
"064100806",663,740,1403,420,448,397
"064100901",577,740,1317,398,445,391
"064100907",388,475,863,306,309,282
"064101103",383,448,831,294,338,285
"064101307",761,820,1581,495,507,459
"064120910",771,693,1464,379,346,335
"064120207",610,636,1246,331,354,306
"064120208",617,655,1272,385,352,344
"064270105",97,132,229,138,226,137
"064120308",512,552,1064,311,315,278
"064120309",450,527,977,291,308,285
"064120510",715,745,1460,399,377,359
"064120511",561,583,1144,313,314,297
"064120512",519,546,1065,325,322,301
"064120606",599,611,1210,410,442,389
"064120607",673,695,1368,395,390,368
"065150703",552,547,1099,284,264,249
"064120710",701,741,1442,416,375,331
"064120802",659,695,1354,400,383,356
"064120810",581,631,1212,303,283,276
"064270107",413,538,951,446,604,433
"064120903",776,727,1503,377,441,359
"064411812",210,251,461,210,286,204
"065150909",679,700,1379,419,408,387
"064120912",493,468,961,226,239,222
"064121016",726,779,1505,335,341,314
"064270108",291,364,655,280,331,280
"064121101",788,786,1574,359,277,267
"064121104",491,528,1019,238,236,226
"064121108",556,505,1061,274,249,235
"064121113",514,476,990,255,246,233
"064121119",822,806,1628,411,388,369
"064121311",605,595,1200,314,319,306
"064121404",543,528,1071,280,281,269
"064121407",721,795,1516,395,377,358
"064121501",464,457,921,250,249,231
"064121505",467,464,931,254,272,249
"064130107",464,525,989,331,361,326
"064130109",368,407,775,285,310,272
"064130201",722,732,1454,408,422,389
"064130310",464,447,911,292,288,275
"064130511",372,426,798,330,401,319
"064131305",294,284,578,158,181,151
"064131502",43,45,88,27,27,27
"064132205",332,366,698,178,197,163
"064131802",62,77,139,39,42,37
"064132109",722,715,1437,473,517,468
"064132110",464,563,1027,392,419,344
"064200202",41,40,81,37,339,37
"064200109",192,201,393,134,283,131
"064200115",79,83,162,69,269,68
"064200211",72,83,155,63,236,62
"064200216",344,372,716,227,405,219
"064200304",161,157,318,104,256,102
"064200310",109,111,220,72,129,70
"064200406",169,137,306,102,440,101
"064200319",71,82,153,58,303,55
"064200402",86,97,183,71,518,71
"064200403",224,225,449,133,270,126
"064200409",54,61,115,46,375,46
"064200507",261,287,548,174,323,173
"064200512",101,105,206,79,273,79
"064200601",83,101,184,79,434,73
"064200710",40,50,90,41,248,37
"064200711",51,47,98,41,324,41
"064200808",115,125,240,86,323,86
"064200906",79,85,164,60,296,59
"064200908",134,123,257,82,234,81
"064201004",78,90,168,72,253,72
"064201009",79,71,150,59,252,58
"064201010",147,136,283,96,637,95
"064201012",98,90,188,58,436,58
"065320305",640,613,1253,307,322,294
"064201104",94,90,184,67,383,67
"064201112",195,181,376,98,235,97
"064201212",62,64,126,46,323,46
"064201302",48,55,103,44,291,43
"064201409",40,35,75,33,636,33
"064201509",144,149,293,100,219,98
"064201602",26,24,50,19,504,19
"064202010",77,83,160,70,314,65
"064201806",23,28,51,21,220,21
"064270102",148,216,364,207,279,194
"064201907",221,234,455,148,249,146
"064201911",154,173,327,107,380,107
"064202004",38,58,96,44,867,44
"064202006",62,60,122,51,435,51
"064202103",191,224,415,149,291,148
"064202107",340,372,712,226,376,221
"064202202",397,452,849,237,403,232
"064270112",320,366,686,281,380,274
"064270311",426,470,896,314,365,312
"064270312",424,530,954,406,541,359
"064270405",455,560,1015,356,346,314
"064270407",473,522,995,344,360,329
"064270501",796,865,1661,518,464,442
"064270505",649,730,1379,459,464,433
"064270606",328,357,685,249,267,247
"064270610",360,373,733,239,241,229
"064270705",563,627,1190,356,374,313
"064270901",729,765,1494,437,445,407
"064270905",752,827,1579,445,465,423
"064270908",521,583,1104,339,346,305
"064271002",399,464,863,255,263,238
"064271106",604,671,1275,423,412,371
"064271408",1823,1782,3605,870,569,540
"064271409",657,677,1334,393,309,286
"064271515",471,513,984,320,312,275
"064271613",248,250,498,146,199,143
"064271801",912,939,1851,449,415,387
"064271802",1024,1055,2079,475,275,253
"064271808",1149,1228,2377,530,439,413
"064271904",465,473,938,268,273,246
"064271906",647,663,1310,370,383,350
"064272008",365,409,774,309,345,308
"064272106",605,612,1217,366,293,279
"064272207",645,687,1332,442,452,416
"064272208",468,479,947,309,334,283
"064272307",591,668,1259,406,425,367
"064272310",830,837,1667,540,485,420
"064272407",898,951,1849,542,440,401
"064272409",554,631,1185,378,407,361
"064272410",451,503,954,250,213,199
"064272502",423,430,853,285,315,263
"064272606",350,380,730,240,250,236
"064272706",482,548,1030,374,401,363
"064272806",553,640,1193,385,417,363
"064272908",607,702,1309,420,482,401
"064273004",276,373,649,341,517,331
"064273009",188,264,452,202,259,186
"064273013",443,514,957,318,382,302
"064273107",373,425,798,283,301,257
"064273201",315,385,700,252,285,247
"064273211",352,393,745,265,286,256
"064273212",306,344,650,214,226,203
"064273307",280,316,596,212,234,202
"064273402",413,439,852,268,306,261
"064273410",367,383,750,237,259,211
"064273501",571,622,1193,401,461,396
"064273511",592,664,1256,417,445,396
"064273512",560,629,1189,399,414,355
"064273606",410,433,843,203,143,139
"064273607",211,261,472,165,155,120
"064273804",482,462,944,235,215,210
"064273809",271,271,542,188,190,165
"064273903",454,444,898,257,222,206
"064273910",549,577,1126,322,269,254
"064274005",705,700,1405,376,388,361
"064274105",610,653,1263,386,417,369
"064274108",1310,1318,2628,667,576,541
"064274211",484,526,1010,297,277,255
"065393405",722,710,1432,361,358,331
"064274309",550,625,1175,379,392,361
"064274310",478,516,994,313,318,278
"064274402",468,513,981,295,268,243
"064274405",299,318,617,214,185,160
"064274406",399,424,823,266,287,248
"064274408",336,382,718,248,231,205
"064274609",2150,2231,4381,1228,1194,1108
"064274712",1294,1419,2713,511,96,93
"064274908",716,774,1490,375,347,344
"064274808",863,950,1813,527,416,392
"064274810",861,884,1745,475,402,369
"064274814",829,895,1724,487,470,448
"064274905",683,718,1401,378,342,318
"064274912",555,512,1067,262,255,250
"064275007",633,687,1320,405,395,365
"064275008",526,539,1065,301,299,280
"064275112",543,578,1121,383,408,352
"064275203",710,712,1422,337,282,279
"064275204",775,827,1602,419,387,380
"064275308",840,899,1739,452,415,400
"064275309",369,406,775,211,189,186
"064275406",517,517,1034,272,274,266
"064275507",409,431,840,268,286,250
"064275602",890,873,1763,512,477,454
"064275608",536,624,1160,381,440,372
"064275701",638,700,1338,388,358,340
"065600408",417,361,778,284,314,271
"064275907",413,468,881,243,198,180
"064275908",614,613,1227,336,309,293
"064275910",594,609,1203,362,347,337
"064276002",696,862,1558,391,328,300
"064276003",560,867,1427,315,274,261
"064276011",812,962,1774,437,376,356
"064276107",830,896,1726,413,233,223
"064276204",621,625,1246,335,309,300
"064276207",608,631,1239,335,268,254
"064276211",689,725,1414,314,132,128
"064276214",412,445,857,240,197,191
"064276402",501,514,1015,254,158,153
"064276407",921,935,1856,445,391,378
"064276415",791,850,1641,372,205,195
"064276416",1129,1257,2386,422,123,112
"064276516",872,948,1820,496,455,432
"064276517",974,995,1969,534,494,474
"064276706",826,835,1661,416,326,310
"064277010",542,550,1092,293,260,246
"064277017",472,492,964,262,195,186
"064277106",444,459,903,273,286,255
"064277114",826,829,1655,410,331,321
"064277115",708,738,1446,367,330,312
"064277203",465,517,982,247,231,215
"064277205",798,792,1590,406,326,304
"064277208",511,479,990,266,232,225
"064277210",584,619,1203,312,285,270
"064277212",702,712,1414,373,333,321
"064277306",800,810,1610,435,377,357
"064277309",1016,1006,2022,509,373,362
"064277417",671,664,1335,331,316,297
"064277501",1048,1140,2188,520,267,258
"064277512",734,741,1475,356,305,297
"064277811",574,620,1194,302,281,262
"064277801",1665,1593,3258,653,178,166
"064277806",617,602,1219,316,249,241
"064277808",535,565,1100,267,232,227
"064277812",794,831,1625,411,385,368
"064277813",903,878,1781,438,370,355
"064277908",474,528,1002,264,241,223
"064279217",520,497,1017,229,221,213
"064278304",934,902,1836,477,338,316
"064278309",689,696,1385,334,294,280
"064278501",1111,1122,2233,546,496,477
"064278506",691,768,1459,416,385,368
"064278511",735,805,1540,441,371,340
"064278611",630,641,1271,329,272,257
"064278703",504,472,976,271,266,258
"064278705",851,911,1762,495,456,423
"064278803",1045,1074,2119,543,442,418
"064278805",1322,1269,2591,644,386,366
"064278901",1864,1936,3800,812,405,364
"064278913",1093,1069,2162,546,530,500
"064279002",962,980,1942,520,450,430
"064279004",636,639,1275,325,280,260
"064279013",470,484,954,248,269,236
"064279105",480,475,955,283,257,245
"064279115",204,200,404,111,245,102
"065680602",394,452,846,316,346,291
"064279206",1067,1094,2161,492,541,467
"064279207",1184,1160,2344,526,534,500
"064279210",902,919,1821,421,417,391
"064279304",861,818,1679,393,366,343
"064279308",897,866,1763,446,455,416
"064279314",871,922,1793,463,436,416
"064279412",879,845,1724,435,406,383
"064279509",788,778,1566,386,340,322
"064279713",470,495,965,273,284,240
"064279607",690,659,1349,326,283,272
"064279703",1095,1123,2218,475,408,359
"064279718",352,361,713,193,201,170
"064279722",403,396,799,205,226,194
"064340209",64,86,150,53,66,52
"064340302",352,415,767,294,345,281
"064340401",465,527,992,362,425,359
"064340503",364,392,756,283,304,270
"064340505",491,536,1027,333,358,311
"064340606",517,558,1075,382,450,378
"064340607",474,499,973,329,364,317
"064340711",257,282,539,165,183,150
"064340808",167,182,349,88,84,82
"064340901",442,476,918,248,254,241
"064340902",670,679,1349,353,274,265
"064340912",449,479,928,249,216,209
"064340913",500,496,996,266,232,221
"064341103",415,400,815,247,266,245
"064341110",285,315,600,189,203,187
"064341206",563,570,1133,350,376,337
"064341311",656,723,1379,431,430,391
"064341401",369,427,796,286,312,264
"064341405",330,375,705,251,314,246
"064341509",222,269,491,189,254,185
"064341609",424,519,943,339,381,333
"064341610",577,648,1225,378,420,359
"064341704",395,431,826,297,356,292
"064341707",200,239,439,160,194,158
"064341711",352,388,740,265,298,256
"064341901",466,516,982,341,346,301
"064342008",460,516,976,342,352,330
"064342210",726,794,1520,487,444,429
"064342213",541,597,1138,388,383,359
"064342410",368,454,822,283,282,228
"064342505",358,407,765,233,235,215
"064342507",536,566,1102,283,227,225
"065810709",275,296,571,214,258,207
"065810710",239,247,486,175,209,168
"064342518",319,332,651,195,205,185
"064342615",309,354,663,195,142,136
"064342708",394,469,863,280,253,232
"064342710",757,763,1520,423,424,378
"064342805",412,444,856,271,284,262
"064342808",734,815,1549,479,478,432
"064342811",333,378,711,230,239,201
"064343009",433,471,904,307,352,302
"064343106",284,339,623,293,400,287
"064343202",328,385,713,315,450,313
"064343203",210,270,480,215,319,214
"064343205",193,260,453,184,257,172
"064343206",201,224,425,161,226,161
"064343401",454,527,981,329,374,323
"064343407",397,432,829,274,295,272
"064343506",404,462,866,285,320,284
"064343608",348,407,755,253,253,212
"064343806",399,493,892,320,392,313
"064343905",383,469,852,310,398,301
"064343907",361,453,814,279,310,258
"064344003",277,324,601,206,209,181
"064344008",438,525,963,372,405,366
"064344102",375,400,775,267,299,257
"064344108",558,504,1062,339,367,312
"064344302",396,418,814,267,308,261
"064344410",400,430,830,276,313,273
"064344412",547,595,1142,378,413,356
"064344511",509,579,1088,363,377,344
"064344512",769,840,1609,489,512,460
"064410202",189,234,423,233,249,200
"064410306",327,332,659,297,329,290
"064410401",438,471,909,377,484,350
"064410404",210,246,456,191,252,190
"064410602",146,168,314,172,233,163
"064410606",164,213,377,204,254,175
"064410608",161,194,355,190,302,181
"064410707",178,286,464,269,403,260
"064410803",72,138,210,119,176,114
"064410804",109,177,286,141,215,134
"064410908",221,267,488,212,278,203
"064410914",190,210,400,195,257,193
"064411003",283,354,637,222,241,217
"064411004",230,248,478,209,265,205
"064411013",268,300,568,242,296,233
"064411106",195,237,432,180,247,179
"064411112",404,490,894,373,492,355
"064411201",177,210,387,215,338,209
"064411211",192,301,493,265,394,248
"064411215",116,188,304,157,401,152
"064411303",61,115,176,100,172,98
"064411309",231,286,517,257,400,253
"064411602",237,263,500,206,260,204
"064411604",236,243,479,216,268,209
"064411704",240,298,538,203,247,198
"064411910",185,222,407,184,267,181
"064412002",243,266,509,226,322,216
"064412106",218,249,467,197,277,194
"064412111",209,240,449,189,243,187
"064412201",283,328,611,263,360,259
"064412203",415,452,867,362,451,358
"064412302",202,247,449,186,222,181
"064412307",328,382,710,254,306,245
"064412402",251,302,553,208,307,206
"064412707",279,316,595,238,268,223
"064412809",278,357,635,243,280,239
"064412906",252,260,512,197,257,192
"064413009",443,478,921,312,348,297
"064413101",573,626,1199,377,404,350
"064413109",322,365,687,235,277,228
"064413202",262,288,550,183,214,178
"064413203",565,601,1166,407,448,381
"064413209",356,365,721,248,287,234
"064413301",399,480,879,345,390,329
"064413307",326,375,701,243,268,235
"065952614",289,268,557,175,218,173
"064413507",454,453,907,285,289,272
"064413514",445,496,941,300,301,281
"064413515",784,799,1583,434,423,400
"064413709",521,578,1099,376,386,350
"064413712",653,673,1326,413,415,379
"064413803",444,461,905,270,268,239
"064413910",741,782,1523,435,422,401
"064414003",311,349,660,238,262,235
"064414012",619,656,1275,332,327,314
"066021403",87,61,148,50,161,50
"064414206",889,791,1680,449,471,431
"064414207",749,723,1472,381,429,364
"064414211",526,495,1021,298,304,286
"064414218",630,715,1345,395,431,382
"064414307",387,402,789,229,240,213
"064414313",438,397,835,244,283,227
"064414314",576,588,1164,328,364,315
"064414408",467,445,912,229,228,209
"064760103",201,252,453,194,225,183
"064414503",449,508,957,298,318,282
"064414507",583,546,1129,310,313,279
"064414703",525,546,1071,315,275,252
"064414706",454,475,929,288,313,266
"064414710",548,519,1067,257,290,245
"064414801",465,523,988,329,367,320
"064414905",210,258,468,190,217,181
"064415006",279,337,616,235,281,229
"064415102",498,487,985,260,275,257
"064415103",289,317,606,211,228,206
"064415115",311,298,609,213,223,191
"064415117",595,626,1221,421,491,410
"064415404",317,373,690,250,284,242
"064415405",569,593,1162,387,447,380
"064415502",953,936,1889,496,533,473
"064415601",421,457,878,269,328,268
"064415603",269,307,576,192,224,183
"066230702",311,312,623,219,245,204
"064415808",245,284,529,193,230,190
"064415908",508,576,1084,337,363,321
"064416106",618,620,1238,370,426,364
"064416111",424,420,844,264,332,260
"064416202",424,447,871,259,270,250
"064416204",398,445,843,281,314,264
"064416212",285,294,579,177,221,174
"064416310",359,394,753,222,280,217
"064416404",296,303,599,158,190,146
"064416410",65,62,127,37,42,31
"067001209",241,266,507,175,190,172
"065151902",548,593,1141,295,289,280
"064416419",598,573,1171,329,262,197
"064416803",406,425,831,238,248,221
"064416804",380,382,762,233,276,229
"064416612",617,605,1222,337,369,328
"064416807",315,294,609,166,255,163
"064416809",197,215,412,141,254,140
"066380305",374,386,760,221,293,218
"064416903",552,524,1076,326,376,302
"064416909",620,565,1185,350,394,328
"064417002",488,492,980,260,285,255
"064480603",366,356,722,250,261,224
"064480604",262,336,598,255,299,249
"064480614",398,424,822,246,274,242
"064550113",298,318,616,211,236,207
"064551414",266,343,609,242,340,239
"064620403",489,575,1064,392,444,386
"064690103",344,368,712,236,257,232
"064690105",346,371,717,246,281,241
"064690109",637,651,1288,435,461,401
"064690213",220,258,478,182,205,176
"064690604",263,273,536,148,170,147
"064690807",280,281,561,188,242,188
"064690909",334,340,674,249,303,246
"064691501",484,485,969,324,390,322
"064830103",504,585,1089,388,434,384
"066440305",142,137,279,89,197,83
"064830102",587,610,1197,368,419,353
"064761401",437,420,857,242,248,230
"064761408",476,490,966,312,330,301
"064830108",265,314,579,237,307,235
"064830109",318,427,745,280,330,272
"064830407",605,639,1244,372,392,364
"064830409",433,466,899,292,322,284
"064830806",215,221,436,137,170,133
"064900204",622,603,1225,328,264,249
"064900108",419,453,872,207,181,168
"064900309",530,636,1166,352,345,312
"064900312",554,594,1148,315,264,241
"064900402",587,581,1168,318,290,278
"064900407",840,725,1565,414,414,375
"064900606",276,323,599,210,257,208
"064900611",379,399,778,284,278,267
"064900614",512,599,1111,355,395,352
"064900703",610,659,1269,381,332,299
"064900704",428,467,895,260,265,252
"064900708",302,329,631,219,201,186
"064900715",495,506,1001,301,228,222
"064901007",284,318,602,207,242,205
"064901013",432,528,960,331,383,317
"064901015",363,425,788,258,333,254
"064902605",300,335,635,236,251,232
"064901103",348,427,775,305,329,272
"064901104",387,460,847,315,355,304
"064901106",186,196,382,172,241,168
"064901203",414,479,893,341,388,330
"064901204",233,289,522,189,216,173
"064901210",456,483,939,332,359,316
"064901309",580,679,1259,394,353,326
"064901402",526,582,1108,341,365,337
"064901409",391,402,793,258,250,225
"064901507",398,450,848,237,165,156
"064901901",466,524,990,341,390,333
"064901701",610,638,1248,388,388,351
"064901801",587,606,1193,393,391,374
"064901802",434,513,947,322,352,311
"064901906",384,432,816,296,292,255
"064902001",440,462,902,308,342,300
"064902008",305,385,690,247,268,242
"064902109",247,312,559,213,255,210
"064902208",93,117,210,102,219,102
"064902303",384,429,813,303,342,280
"064902306",374,437,811,296,373,295
"064902308",96,118,214,112,248,112
"064902309",239,337,576,255,370,244
"064902401",362,403,765,265,302,259
"064902504",328,400,728,269,297,247
"064902506",404,432,836,288,314,270
"064902608",336,364,700,244,266,231
"064902612",389,420,809,290,277,245
"064902713",277,304,581,182,171,157
"064902904",614,672,1286,359,372,343
"064903109",559,579,1138,328,285,269
"064903201",869,914,1783,455,419,394
"064903208",807,803,1610,422,381,357
"064903411",708,702,1410,354,278,269
"064903503",748,677,1425,429,490,373
"064903504",731,691,1422,462,606,444
"064903506",826,816,1642,519,591,500
"064903514",716,824,1540,395,319,296
"064903518",670,660,1330,395,325,305
"064903601",841,830,1671,446,312,302
"064903607",571,594,1165,315,258,254
"064903610",739,789,1528,426,328,318
"064903704",434,473,907,252,228,210
"064903708",373,404,777,250,177,167
"064903713",824,880,1704,482,444,410
"064903806",633,627,1260,300,281,274
"064903814",445,441,886,221,193,187
"064904001",475,501,976,240,167,164
"064904005",553,554,1107,291,273,262
"064904007",786,806,1592,377,358,354
"064904011",635,620,1255,322,329,311
"064904012",1297,1044,2341,516,313,283
"064904102",55,62,117,32,21,18
"064904205",337,433,770,254,245,214
"064904306",496,531,1027,315,310,308
"064904404",635,613,1248,378,365,316
"064904409",736,839,1575,439,438,402
"064904504",633,636,1269,412,438,402
"064904805",216,267,483,177,220,174
"065391210",666,629,1295,337,332,317
"065391301",808,860,1668,472,493,455
"065391302",505,511,1016,276,282,270
"065391304",734,740,1474,378,382,362
"065391307",523,561,1084,319,320,291
"065391414",478,487,965,271,274,251
"065391502",321,359,680,274,335,247
"065391503",222,297,519,195,224,194
"065391506",287,323,610,245,294,241
"060631201",25,23,48,15,16,15
"060840908",8,11,19,6,11,6
"060070106",10,5,15,5,15,5
"060070205",11,6,17,7,14,7
"060070304",22,12,34,12,23,11
"060070409",6,9,15,4,14,4
"060070503",8,7,15,4,10,4
"060070506",8,3,11,4,10,4
"060070701",14,18,32,9,11,9
"060070902",13,15,28,9,11,9
"060071003",7,6,13,5,13,4
"060071005",19,15,34,13,26,13
"060140302",65,35,100,34,55,34
"060140801",42,34,76,30,56,29
"060141002",42,45,87,29,91,28
"060210205",6,6,12,3,24,3
"061890605",1,0,1,1,8,1
"060210702",6,5,11,5,33,5
"061890801",3,3,6,2,15,2
"060210902",16,4,20,10,24,10
"060210903",17,15,32,13,23,13
"062030801",18,17,35,12,30,12
"062171102",25,20,45,18,32,17
"060420801",71,43,114,42,72,42
"060421201",84,63,147,52,70,51
"060421301",62,32,94,44,49,40
"062380606",23,18,41,18,26,18
"060490702",50,41,91,35,38,32
"060492301",91,70,161,64,88,62
"060630604",42,34,76,24,51,24
"060630606",23,16,39,18,57,18
"065391703",532,564,1096,310,298,275
"060630905",14,10,24,9,29,9
"062031406",5,1,6,5,14,3
"060631004",32,23,55,23,53,21
"060631102",87,57,144,46,110,46
"060631105",66,61,127,40,65,40
"060700804",24,21,45,15,32,13
"060700806",9,7,16,4,11,4
"060700904",12,2,14,5,14,5
"065391711",373,390,763,243,244,226
"060701102",5,6,11,5,11,5
"065391714",346,406,752,238,218,210
"060771303",22,17,39,13,16,11
"060840403",31,26,57,16,34,16
"060840605",15,7,22,9,19,9
"060840701",104,91,195,67,107,66
"060841001",24,20,44,12,24,12
"065391805",667,665,1332,393,369,344
"060980405",16,9,25,10,13,6
"061050402",33,22,55,22,51,22
"061050805",102,107,209,70,135,68
"061050809",56,40,96,35,76,35
"061051101",578,64,642,59,120,59
"063080101",34,19,53,19,29,18
"061120506",9,7,16,7,21,7
"061120705",17,8,25,8,16,8
"061120905",9,7,16,6,11,6
"061120907",15,13,28,10,11,10
"061121106",57,44,101,36,110,35
"061190202",30,20,50,18,21,11
"061190804",10,11,21,7,16,7
"063430105",46,41,87,25,44,24
"061260517",32,26,58,17,19,17
"068052609",441,413,854,299,707,293
"061261003",335,285,620,203,364,163
"061340205",82,64,146,48,66,39
"061340701",32,35,67,24,41,24
"061340602",62,70,132,45,62,45
"061400203",46,21,67,20,33,20
"061400402",36,33,69,23,37,22
"061470307",24,16,40,17,50,15
"061470705",5,4,9,4,13,4
"061470906",18,14,32,12,52,12
"061540103",24,27,51,14,29,14
"061540207",24,22,46,15,20,15
"061540403",21,13,34,10,40,10
"061540702",34,25,59,22,56,22
"061540806",61,37,98,35,56,35
"061610402",42,40,82,25,51,25
"061610701",47,40,87,26,57,26
"061680204",11,8,19,4,7,4
"065392009",818,825,1643,441,431,401
"065392010",875,904,1779,446,397,387
"061750303",12,4,16,5,9,5
"061750503",8,3,11,5,12,5
"065392013",488,492,980,260,250,241
"065392014",521,499,1020,254,253,245
"061890201",0,2,2,1,9,1
"061890202",2,1,3,2,15,2
"061890204",1,1,2,1,13,1
"061890401",5,2,7,2,13,2
"061890602",22,13,35,10,16,10
"061890705",7,5,12,6,14,6
"061890901",9,6,15,7,13,7
"061891104",6,3,9,4,8,4
"061891209",4,2,6,3,7,3
"061891403",11,9,20,7,14,7
"061891505",25,16,41,18,35,18
"061960302",13,11,24,10,17,10
"061960304",7,5,12,4,15,4
"061960501",9,9,18,6,15,6
"061960901",0,2,2,1,3,1
"061960905",29,18,47,11,24,10
"061961003",9,9,18,3,9,3
"061961105",22,23,45,16,22,16
"061961106",13,10,23,8,16,8
"061961202",23,17,40,16,30,15
"061961402",19,12,31,13,28,13
"061961503",7,11,18,6,13,6
"062030301",23,16,39,14,27,14
"062030303",10,9,19,8,22,8
"062030902",20,16,36,14,28,14
"062030906",2,1,3,1,8,1
"062031104",8,3,11,4,11,4
"065392312",876,870,1746,426,375,366
"062031302",8,8,16,5,11,5
"062100601",50,41,91,25,48,24
"062100801",213,177,390,119,151,113
"062170301",81,78,159,48,68,48
"062170506",20,16,36,15,30,14
"065392401",789,875,1664,476,488,443
"065392406",476,498,974,285,297,270
"065392407",474,518,992,276,243,225
"065392408",415,464,879,243,206,191
"062170803",37,37,74,22,39,22
"065392510",671,707,1378,349,352,336
"062171101",94,53,147,57,92,57
"062171104",17,11,28,9,20,9
"068052615",173,175,348,121,312,115
"063990301",69,50,119,43,72,43
"062310103",25,17,42,16,30,16
"062240701",5,2,7,2,12,2
"062240702",18,19,37,14,23,14
"062240906",118,99,217,70,100,69
"062241303",22,18,40,13,26,13
"065392607",949,906,1855,479,477,451
"062241903",27,20,47,14,44,14
"062242006",11,10,21,6,24,6
"062310106",43,31,74,29,74,29
"062310304",10,12,22,8,14,8
"062310605",14,9,23,7,10,6
"062310801",19,15,34,14,44,14
"062310903",28,14,42,15,24,14
"062311002",3,1,4,3,14,3
"065392609",690,699,1389,358,346,331
"062450507",267,76,343,54,92,54
"062521601",287,217,504,175,487,173
"062770116",30,23,53,20,47,20
"062800509",11,7,18,7,14,7
"062800602",14,7,21,7,14,7
"062800702",10,10,20,9,11,9
"062800708",36,31,67,23,20,13
"062800808",6,3,9,6,15,6
"062800814",11,5,16,7,9,7
"062800818",9,3,12,4,7,4
"065392702",787,748,1535,352,339,331
"062801203",5,3,8,3,9,3
"062870502",146,73,219,60,101,60
"062940505",27,22,49,13,27,13
"062940605",7,4,11,4,32,4
"062940705",15,8,23,9,24,9
"063010501",12,7,19,5,22,5
"065392707",675,682,1357,361,364,332
"063010601",188,97,285,78,164,76
"063010701",126,107,233,78,125,77
"063080701",41,30,71,28,61,28
"063150201",95,66,161,56,105,56
"063220505",19,12,31,11,31,11
"063220705",12,5,17,10,28,10
"063221103",13,13,26,10,23,10
"063290103",41,24,65,24,33,24
"063430402",50,45,95,30,60,30
"065392801",515,561,1076,268,256,242
"063430502",27,26,53,20,35,20
"063510104",13,13,26,11,19,10
"063510202",47,29,76,22,45,22
"063510304",21,13,34,13,41,12
"063510801",40,33,73,21,45,21
"063510802",15,12,27,11,24,11
"063510803",47,31,78,26,45,25
"063577706",42,27,69,21,28,21
"063577807",209,146,355,112,126,104
"063578103",15,11,26,10,11,10
"063640601",19,13,32,12,15,12
"064690502",7,8,15,4,5,3
"064760803",20,14,34,14,28,13
"063850103",24,21,45,15,51,15
"063850301",8,6,14,6,15,6
"063920805",38,12,50,27,45,27
"063920405",24,18,42,11,32,11
"063920503",19,14,33,11,18,11
"063920701",18,8,26,12,28,12
"063920710",32,23,55,24,55,24
"063921209",31,25,56,19,25,18
"063921303",42,25,67,26,40,26
"063990804",34,17,51,25,27,18
"064060209",6,2,8,5,25,5
"064060213",27,16,43,18,54,18
"064060304",34,26,60,24,25,18
"064060306",22,21,43,14,29,12
"065110510",12,7,19,7,9,7
"064130702",NA,NA,NA,NA,NA,NA
"064130903",NA,NA,NA,NA,NA,NA
"065180408",11,3,14,10,16,10
"064200315",31,27,58,20,129,19
"064202214",51,32,83,26,100,26
"065810908",3,3,6,2,6,2
"065810910",6,4,10,4,10,4
"065811101",3,3,6,2,14,2
"066020307",13,6,19,8,14,8
"066020501",17,2,19,11,21,10
"066090501",24,10,34,10,21,10
"066091003",14,7,21,10,28,10
"064416503",340,316,656,178,222,160
"064416510",849,792,1641,442,460,414
"066300201",19,19,38,11,19,11
"064416701",223,195,418,122,166,119
"064416702",74,65,139,42,54,42
"064416817",65,56,121,39,39,34
"064480103",17,11,28,14,24,14
"064480401",15,10,25,9,7,7
"064480613",4,5,9,2,10,2
"064481102",22,12,34,10,13,10
"064481103",8,3,11,6,13,6
"064481202",6,6,12,5,16,5
"064481203",12,7,19,8,20,8
"064481205",25,19,44,16,28,16
"064550606",34,21,55,15,22,15
"064550607",76,68,144,55,81,51
"064550901",58,38,96,36,72,36
"065600808",714,717,1431,393,401,366
"064620101",21,10,31,12,38,12
"064621101",29,24,53,16,31,16
"064621207",40,31,71,22,32,22
"064690403",17,22,39,9,27,9
"064690503",11,8,19,8,15,8
"064690908",36,27,63,18,35,18
"064691006",5,4,9,4,12,4
"064691105",19,14,33,10,23,10
"064691303",58,38,96,31,58,31
"064691304",20,17,37,11,26,11
"064691503",6,5,11,4,19,4
"064691504",2,0,2,2,10,2
"064691505",6,6,12,4,12,4
"064760205",62,65,127,36,45,36
"064760206",39,34,73,23,36,23
"064760403",10,6,16,7,16,7
"065600810",465,499,964,318,311,290
"064761206",48,25,73,27,45,27
"064830506",15,12,27,9,16,9
"064970608",49,41,90,26,34,26
"065050207",29,21,50,13,27,13
"065110402",10,6,16,6,18,6
"065180110",5,3,8,3,5,3
"065180404",25,13,38,21,35,20
"065180503",24,23,47,18,28,18
"065180507",15,19,34,8,16,8
"065180510",37,37,74,22,29,20
"065180511",51,43,94,34,120,34
"065180801",3,1,4,3,6,3
"065250202",65,62,127,40,51,40
"067420411",2,0,2,1,6,1
"065320805",77,60,137,43,77,43
"065321303",11,8,19,6,6,4
"065470303",31,32,63,27,41,25
"065470601",128,115,243,73,135,73
"066091709",14,11,25,8,21,8
"067631908",94,82,176,43,46,42
"067700302",6,7,13,4,7,4
"067841101",15,10,25,5,11,5
"065740102",47,39,86,28,47,28
"065740502",77,65,142,39,62,39
"065740706",50,44,94,29,61,29
"065740901",31,30,61,15,25,15
"065810601",24,10,34,11,25,11
"065810804",51,42,93,28,40,28
"065601108",731,736,1467,396,395,343
"065601109",729,738,1467,382,394,361
"065811106",4,4,8,4,14,4
"065811108",13,6,19,11,17,11
"065811201",17,7,24,12,27,12
"065811202",10,3,13,8,19,8
"065811204",26,24,50,21,29,21
"065811206",79,67,146,42,62,42
"065880401",42,35,77,22,40,22
"065880504",14,14,28,8,10,8
"065880801",115,93,208,59,134,58
"065880904",203,161,364,127,226,124
"065881007",48,46,94,29,42,29
"065881303",48,39,87,24,46,23
"065950701",106,82,188,64,102,63
"065950901",93,64,157,65,94,63
"065951201",58,47,105,34,62,34
"065393007",397,362,759,197,212,195
"065601113",723,751,1474,421,465,389
"065393011",597,574,1171,335,340,319
"066020203",132,88,220,73,121,71
"066020305",17,7,24,12,57,12
"066021201",70,36,106,43,84,43
"066021301",97,46,143,69,158,69
"068331505",14,12,26,9,21,9
"065393104",948,903,1851,479,482,446
"066090802",4,5,9,3,17,3
"066090803",1,1,2,1,15,1
"066091202",28,23,51,15,23,15
"066091303",7,4,11,4,15,4
"066091502",15,8,23,7,10,7
"066230704",25,27,52,16,37,15
"066230901",38,24,62,20,28,20
"066231603",24,18,42,15,25,15
"066232302",19,20,39,12,21,12
"066300301",82,49,131,43,71,42
"066382001",41,25,66,24,25,20
"067700403",12,8,20,7,16,7
"066480405",23,19,42,19,24,19
"067700404",9,4,13,5,15,5
"066510302",14,9,23,9,22,9
"066510402",11,5,16,9,31,9
"066510403",23,15,38,15,27,15
"066511101",13,11,24,9,27,9
"066511103",11,7,18,7,10,7
"066511311",17,17,34,15,21,13
"066650304",30,36,66,17,23,17
"066650502",40,40,80,27,47,25
"066720102",33,26,59,21,31,21
"066720103",10,9,19,8,9,8
"066720602",16,11,27,9,19,9
"066721103",29,18,47,15,22,15
"066721211",28,31,59,20,40,20
"066721303",26,27,53,19,42,19
"065393206",842,792,1634,395,381,359
"066721401",14,6,20,9,18,9
"066721402",76,57,133,51,89,49
"066790402",29,13,42,12,18,12
"066790405",6,13,19,6,21,6
"066790702",22,12,34,13,24,13
"066791204",42,22,64,31,58,31
"066860605",26,17,43,19,26,19
"065393212",84,70,154,44,52,44
"066930202",58,52,110,40,64,40
"066930302",53,42,95,32,67,32
"066930303",90,81,171,58,84,55
"066930304",86,61,147,58,90,54
"066930601",22,23,45,15,28,15
"066930602",28,29,57,15,30,15
"067000103",11,7,18,7,11,7
"067000301",7,3,10,7,29,7
"067000302",11,8,19,10,30,10
"067000401",32,10,42,16,18,15
"067000402",21,10,31,14,22,14
"067000601",5,2,7,3,14,3
"067000602",701,17,718,12,36,12
"067000702",11,9,20,7,18,7
"067001102",9,4,13,5,15,5
"067070402",176,137,313,101,158,99
"067070502",54,41,95,32,55,31
"067070503",45,50,95,34,76,34
"067140204",10,10,20,7,15,7
"065393307",789,766,1555,425,431,397
"067140504",127,111,238,59,85,58
"067140701",12,5,17,6,10,6
"067140803",12,6,18,8,16,8
"067280602",27,26,53,14,18,14
"067280603",4,4,8,4,9,4
"067210208",10,9,19,7,16,7
"067281023",118,95,213,55,66,54
"067281026",19,18,37,13,38,13
"067281102",76,43,119,31,38,30
"067281408",47,44,91,28,32,28
"067350205",78,44,122,43,61,42
"065393312",557,576,1133,338,370,325
"067420201",83,52,135,57,97,57
"067420412",4,4,8,3,5,3
"065393313",658,679,1337,396,409,366
"065393406",704,640,1344,337,294,272
"065393408",756,746,1502,382,375,346
"067491505",126,104,230,80,230,76
"067491510",192,177,369,120,321,120
"060210503",8,4,12,5,15,5
"067631203",33,24,57,22,42,22
"067631301",7,5,12,6,10,6
"067631501",36,18,54,24,43,24
"067631907",32,27,59,17,25,17
"068052613",114,91,205,84,373,83
"067700208",35,23,58,15,20,15
"067700301",28,33,61,13,17,12
"067701301",23,13,36,12,25,12
"067701705",26,16,42,14,33,14
"067701903",14,9,23,8,12,8
"067780503",24,21,45,14,23,14
"067840404",11,8,19,6,12,6
"067840704",19,24,43,11,14,11
"067841203",49,43,92,26,30,26
"067910905",55,42,97,30,38,30
"067911105",60,46,106,34,42,34
"067911601",45,34,79,29,33,29
"065470308",203,188,391,116,135,110
"065470309",479,487,966,261,340,257
"068052601",81,46,127,49,235,47
"065470904",622,729,1351,446,504,438
"065530103",180,183,363,147,505,147
"065530107",68,67,135,58,439,58
"068120302",11,8,19,7,14,7
"065530108",93,108,201,86,427,85
"065530309",49,50,99,42,345,42
"065600101",784,770,1554,394,362,347
"065600201",805,758,1563,397,392,370
"065600203",787,741,1528,414,369,355
"065600212",628,620,1248,324,341,305
"065600213",675,657,1332,333,362,320
"065600405",642,725,1367,322,280,267
"065600309",837,862,1699,421,354,338
"065600410",729,679,1408,363,341,335
"065600504",693,645,1338,357,340,326
"065600601",662,651,1313,375,354,338
"065601215",412,413,825,262,267,238
"065600602",781,890,1671,431,406,389
"065600604",494,484,978,271,255,241
"065600607",2282,2349,4631,1225,1179,1109
"065600611",696,755,1451,422,363,344
"065602401",248,305,553,229,270,198
"067631701",555,608,1163,393,418,363
"065601303",937,980,1917,474,461,437
"065600618",506,572,1078,288,290,277
"068052616",86,57,143,57,236,56
"065180610",62,60,122,38,93,37
"065180612",112,95,207,75,184,67
"065600703",568,604,1172,364,362,357
"065180713",185,210,395,130,245,127
"065180802",68,66,134,42,117,42
"065600706",862,869,1731,454,412,401
"065600710",387,395,782,209,215,200
"065250105",514,535,1049,284,311,270
"065250409",598,638,1236,338,371,329
"065320204",343,449,792,282,318,270
"065320306",519,558,1077,296,327,285
"065321402",420,424,844,287,322,276
"065321501",405,396,801,262,272,249
"065390107",692,644,1336,308,267,261
"065390204",703,741,1444,437,483,420
"065390208",579,671,1250,433,442,375
"065390304",668,674,1342,335,316,298
"065390308",246,293,539,191,216,184
"065390410",341,428,769,267,284,252
"065390506",404,439,843,270,271,262
"065390602",409,420,829,250,261,230
"065390701",552,674,1226,410,423,378
"065390802",452,467,919,294,310,279
"065390808",991,1063,2054,544,488,457
"065390813",652,624,1276,331,325,309
"065390905",746,713,1459,389,359,344
"065390908",887,837,1724,447,424,407
"065390911",412,504,916,191,133,130
"065390912",700,749,1449,371,336,320
"065391013",815,838,1653,425,397,382
"065391108",948,954,1902,528,420,403
"065391110",707,730,1437,374,354,343
"065391111",665,680,1345,378,362,339
"065391113",589,603,1192,336,308,287
"065391115",739,736,1475,404,409,366
"067561005",181,250,431,197,242,195
"064131404",699,42,741,24,34,24
"064200511",99,100,199,83,254,81
"064275504",432,473,905,271,248,213
"065810107",330,397,727,278,336,268
"066580809",238,324,562,292,414,289
"067490902",578,634,1212,372,400,369
"060350101",1301,1277,2578,731,511,491
"061260916",114,88,202,60,145,49
"063920303",22,22,44,18,23,18
"060420901",153,94,247,93,151,93
"060700301",153,91,244,53,92,52
"061190501",121,116,237,73,335,70
"061260601",182,163,345,117,238,110
"061260605",170,159,329,102,179,98
"061680804",8,6,14,6,13,6
"061750102",45,34,79,30,47,30
"061750204",4,2,6,2,10,2
"061750417",145,158,303,97,125,95
"061750613",1024,1132,2156,592,639,589
"062171201",405,386,791,245,350,158
"062600310",874,912,1786,471,507,466
"062870416",1435,33,1468,28,60,28
"062700806",41,55,96,32,219,28
"063220611",98,87,185,53,64,52
"065392903",146,168,314,77,74,71
"064416815",272,262,534,147,193,142
"063640317",285,305,590,94,138,66
"063640413",507,361,868,200,240,189
"063640501",602,565,1167,309,156,89
"063851002",822,824,1646,465,603,459
"063920903",141,128,269,102,147,102
"063921207",189,189,378,109,133,103
"064131402",59,60,119,36,42,35
"064131201",NA,NA,NA,NA,NA,NA
"064416520",328,334,662,209,249,165
"064416812",142,145,287,96,173,94
"064620404",60,50,110,38,57,38
"066650208",475,483,958,284,324,273
"064970609",354,315,669,188,270,182
"068331304",80,76,156,54,244,54
"065180113",25,21,46,17,32,16
"065250504",252,220,472,118,175,116
"065320904",311,318,629,196,269,189
"065320910",1658,1702,3360,828,853,782
"065391007",1498,1415,2913,717,710,653
"065740802",42,40,82,28,43,28
"065811307",152,120,272,88,138,86
"065880903",217,210,427,149,253,147
"065950601",112,86,198,83,114,75
"066790904",144,122,266,79,115,78
"066860203",46,44,90,28,53,28
"066860603",45,40,85,24,105,24
"066860701",33,25,58,21,49,21
"067140804",66,52,118,41,65,41
"067350404",219,200,419,124,149,112
"067840202",257,264,521,160,208,157
"068261803",54,33,87,30,49,30
"068331302",147,133,280,106,643,105
"068331809",207,189,396,127,237,99
"068750801",84,71,155,66,183,66
"068820813",1644,991,2635,433,407,387
"062170505",75,56,131,56,173,55
"065681409",427,448,875,348,443,342
"065681810",401,530,931,318,363,314
"065681603",390,434,824,267,232,212
"065681610",528,559,1087,374,395,368
"065681701",556,627,1183,346,372,336
"065681814",292,337,629,223,257,219
"065681904",320,379,699,241,256,225
"065681910",309,342,651,222,250,213
"065682014",363,368,731,244,273,240
"065682105",128,154,282,142,317,142
"065682113",422,474,896,371,459,362
"065682210",260,251,511,188,196,188
"065682308",569,639,1208,412,448,397
"065682309",436,477,913,336,362,311
"065682310",338,403,741,254,257,234
"065682404",526,599,1125,384,441,379
"065682405",478,548,1026,359,393,337
"065682505",310,370,680,216,234,201
"065682601",286,363,649,233,226,201
"065682608",321,364,685,227,251,223
"068050307",732,809,1541,411,539,407
"065682703",563,543,1106,305,313,294
"065682801",666,783,1449,445,480,429
"065682805",747,800,1547,445,416,392
"065682904",488,539,1027,287,268,251
"065682910",544,569,1113,281,279,271
"065683110",520,533,1053,296,262,232
"065740402",721,737,1458,374,465,367
"065740410",479,581,1060,370,421,365
"065810108",447,436,883,265,277,255
"065810109",444,481,925,277,293,272
"065810204",321,380,701,253,339,242
"065810707",60,64,124,39,50,38
"065811705",347,403,750,274,371,274
"065811302",419,434,853,223,231,221
"065811305",398,482,880,281,299,276
"068052501",552,583,1135,309,367,269
"065811508",451,429,880,282,301,266
"065811607",353,410,763,263,289,253
"065811805",106,142,248,111,403,111
"065811809",93,112,205,102,457,102
"065811904",191,199,390,138,304,138
"065811910",238,252,490,166,186,159
"065880101",360,450,810,357,411,349
"065880107",286,303,589,234,276,228
"065880116",371,385,756,242,287,237
"065880117",312,333,645,237,276,232
"065880203",390,391,781,243,272,241
"065880206",223,276,499,198,259,195
"065880301",239,225,464,153,187,150
"065880908",455,465,920,310,340,306
"065880909",405,437,842,291,344,282
"065880912",687,758,1445,346,376,334
"065881501",174,173,347,122,158,113
"065881701",371,419,790,298,352,292
"065950106",337,414,751,272,290,266
"065950202",398,436,834,315,371,313
"065950204",287,411,698,324,444,312
"065950302",327,404,731,303,340,300
"065950304",320,385,705,317,423,314
"065950305",325,349,674,261,322,259
"065950308",260,310,570,255,342,247
"065950403",420,434,854,298,328,296
"065951602",596,634,1230,357,385,350
"065951904",317,204,521,134,162,130
"065951909",175,173,348,132,155,129
"065952406",331,398,729,276,331,270
"065952706",91,86,177,60,75,57
"065952607",515,546,1061,326,372,321
"066020201",263,258,521,152,233,149
"066090210",294,335,629,255,311,248
"066021406",68,70,138,44,120,44
"068331904",371,401,772,256,324,251
"066021608",244,327,571,255,301,243
"066021610",387,450,837,314,367,297
"066090103",408,479,887,330,395,327
"066090105",288,380,668,285,404,282
"066090211",473,539,1012,339,394,331
"066091701",410,434,844,325,381,320
"066091707",36,40,76,23,31,22
"067491405",547,581,1128,317,325,299
"066091907",493,518,1011,372,395,359
"068401009",169,224,393,187,254,186
"066160302",417,414,831,289,326,281
"066160303",328,359,687,256,277,233
"066230102",496,569,1065,379,403,355
"066230108",533,554,1087,389,420,366
"066230109",400,426,826,282,288,270
"066230204",320,435,755,313,402,304
"066230305",282,394,676,255,344,251
"066230402",355,453,808,320,380,313
"066231104",274,269,543,179,211,177
"066231803",296,303,599,215,253,208
"066232101",269,263,532,139,145,129
"066232204",383,493,876,294,300,280
"066232811",272,272,544,179,235,178
"066232904",316,307,623,184,184,177
"066232907",610,618,1228,328,341,310
"066300202",440,479,919,280,346,275
"066380110",810,874,1684,449,445,416
"066380213",491,528,1019,294,299,269
"066380202",599,627,1226,386,570,373
"066380402",800,840,1640,451,385,362
"066380404",360,398,758,235,303,229
"066380502",85,123,208,65,108,65
"066380512",568,568,1136,296,286,264
"066380603",692,729,1421,412,437,394
"066380612",566,633,1199,306,331,297
"066380614",877,902,1779,446,426,396
"066380704",598,632,1230,339,336,301
"066380711",417,402,819,237,278,227
"066380803",511,568,1079,295,348,293
"066380807",230,232,462,167,220,161
"066380813",208,212,420,125,188,122
"066380903",502,516,1018,287,273,251
"066380907",1152,1142,2294,575,542,515
"066381203",691,710,1401,388,402,350
"066480507",944,944,1888,466,454,430
"066381210",201,188,389,105,119,91
"066480508",455,525,980,263,269,256
"066381306",1032,1029,2061,527,539,497
"066381312",400,446,846,239,318,237
"066381316",387,364,751,190,192,176
"066381409",732,684,1416,356,363,336
"066381508",814,822,1636,464,454,388
"066381510",829,835,1664,405,463,388
"066381602",298,334,632,203,256,198
"066381604",319,345,664,229,291,228
"066381605",242,284,526,199,241,182
"066381701",553,513,1066,308,311,227
"066381809",466,496,962,313,308,291
"066381901",529,510,1039,301,522,298
"067630306",333,422,755,308,378,301
"066382201",1066,1054,2120,582,554,521
"066382003",526,473,999,304,418,296
"066382009",400,432,832,230,310,216
"066382107",510,546,1056,260,457,259
"066382207",336,396,732,230,242,218
"066382212",282,287,569,153,179,128
"066382301",483,420,903,207,220,201
"066440205",44,48,92,36,286,36
"066440308",60,63,123,34,365,34
"066440312",36,28,64,31,256,27
"066440602",283,284,567,154,165,137
"068751614",513,483,996,294,314,291
"066440407",56,64,120,47,453,47
"066440508",120,116,236,101,358,101
"066440607",317,296,613,179,201,152
"066440613",466,439,905,241,371,191
"066440622",251,236,487,158,272,140
"066480109",436,480,916,258,266,251
"066480118",611,570,1181,299,288,256
"066480201",822,817,1639,391,383,373
"066480205",603,597,1200,299,303,262
"066480207",794,774,1568,410,408,364
"066480208",713,722,1435,375,373,355
"066480401",582,588,1170,290,282,277
"066480509",725,766,1491,457,412,380
"066510106",232,240,472,205,231,192
"066510714",278,312,590,254,360,252
"066510818",190,218,408,155,221,155
"066511310",91,110,201,75,98,70
"066550304",55,51,106,41,171,40
"066550211",243,254,497,176,221,172
"066550302",41,38,79,33,151,33
"066580103",454,505,959,350,388,340
"066580301",624,566,1190,313,327,288
"066580302",728,641,1369,329,334,295
"066580402",566,556,1122,336,358,314
"066580408",605,633,1238,401,430,384
"066580413",313,360,673,239,248,231
"066580506",482,502,984,307,281,254
"066580603",382,446,828,314,370,281
"066580605",415,458,873,314,360,304
"066580608",239,253,492,174,204,170
"066580708",676,724,1400,376,369,345
"066580804",337,449,786,328,449,324
"066580908",174,203,377,166,249,163
"066580911",186,237,423,188,239,179
"066581003",414,421,835,264,262,236
"066581006",297,334,631,229,292,228
"066581104",258,291,549,206,225,194
"066581106",360,407,767,272,288,265
"067071112",331,329,660,205,241,199
"066581203",634,711,1345,411,401,356
"066581204",436,561,997,398,434,369
"066581206",425,517,942,307,381,295
"066581208",332,419,751,308,376,307
"066581212",447,493,940,337,356,320
"066581307",498,454,952,273,255,238
"066581407",519,540,1059,261,286,261
"066581603",289,354,643,241,260,232
"066581610",285,302,587,221,283,216
"066581704",367,432,799,291,336,282
"066581705",384,460,844,322,374,316
"066581801",168,180,348,132,168,130
"066581907",268,273,541,187,200,179
"066582003",715,742,1457,421,422,396
"066582004",634,639,1273,349,340,322
"066582005",639,699,1338,361,341,326
"066582116",576,614,1190,283,274,267
"066582202",407,479,886,329,364,313
"066582205",322,350,672,232,254,222
"066582311",515,538,1053,325,317,293
"066582405",416,481,897,309,333,303
"066582411",299,354,653,245,294,243
"066582504",289,332,621,234,241,206
"066582508",440,515,955,331,328,291
"066582606",461,479,940,341,387,338
"066582609",315,379,694,241,262,222
"066582713",544,559,1103,307,290,275
"066582903",299,336,635,219,253,218
"066582907",634,696,1330,374,386,368
"066583103",962,1058,2020,658,650,633
"066583106",1595,1689,3284,1053,1064,1002
"066583108",306,367,673,230,238,220
"066583113",285,300,585,199,204,183
"066583305",1312,1250,2562,637,582,572
"066583307",672,747,1419,408,394,381
"066583308",351,361,712,204,198,196
"066583405",516,530,1046,314,305,295
"066583406",636,635,1271,400,416,381
"066583503",440,458,898,281,288,263
"066583702",1173,1075,2248,633,622,590
"066583813",501,578,1079,329,340,325
"066583902",743,755,1498,418,373,366
"066583910",985,1027,2012,521,485,467
"066584004",985,992,1977,456,455,427
"066584012",728,757,1485,389,349,335
"066584017",876,904,1780,487,466,451
"066584105",727,788,1515,426,441,408
"066584106",788,817,1605,475,455,423
"066584115",605,589,1194,310,294,269
"066584401",576,665,1241,329,345,319
"066584407",357,392,749,229,240,220
"066650302",504,550,1054,285,307,277
"066650309",545,532,1077,286,308,273
"066650310",627,655,1282,457,487,443
"066651303",536,559,1095,308,352,306
"066651305",655,668,1323,419,441,390
"066651308",471,460,931,255,270,240
"066651309",733,734,1467,377,406,361
"066721202",323,392,715,263,312,262
"066721204",462,539,1001,376,433,368
"066790303",235,230,465,159,196,159
"066790905",243,223,466,165,182,158
"066860102",678,757,1435,418,410,378
"066860108",274,332,606,254,325,248
"067071113",537,550,1087,341,391,336
"067281019",466,491,957,303,324,292
"066861310",361,412,773,299,347,291
"066930703",126,125,251,92,132,87
"067000603",195,206,401,152,175,151
"067001213",258,269,527,199,233,195
"067070104",366,360,726,227,239,213
"067070105",471,545,1016,396,470,389
"067070110",287,341,628,237,273,234
"067070115",359,370,729,247,290,246
"067070116",306,322,628,178,194,174
"067070117",469,479,948,295,338,279
"067070501",107,102,209,77,111,77
"067071104",580,626,1206,377,432,367
"067140104",362,440,802,321,367,317
"067140611",434,473,907,328,358,319
"067140801",186,192,378,138,161,138
"067210201",299,304,603,232,268,228
"067210202",109,130,239,108,151,108
"067490306",232,302,534,167,194,163
"067281021",411,452,863,267,299,254
"067281301",232,245,477,156,224,154
"067350201",288,285,573,184,249,183
"067350308",325,328,653,182,235,173
"067350701",368,369,737,229,260,226
"067350704",235,252,487,149,157,140
"067420414",296,296,592,192,225,191
"067490104",244,232,476,132,80,78
"067490210",481,611,1092,347,384,339
"067490508",168,260,428,170,250,169
"067490602",315,392,707,331,392,328
"067490704",559,577,1136,369,385,353
"067490705",668,728,1396,451,463,430
"067490807",683,739,1422,453,399,364
"067490904",645,707,1352,429,425,385
"067491005",599,673,1272,418,412,378
"067491108",397,351,748,182,161,159
"067491208",525,565,1090,340,377,332
"067491401",341,332,673,199,194,172
"067491403",510,525,1035,285,170,155
"067491404",503,544,1047,289,286,266
"067560209",230,298,528,302,403,301
"067560401",363,411,774,265,319,254
"067560503",312,356,668,243,306,239
"067600211",325,399,724,267,277,251
"067560508",319,376,695,279,365,267
"067560509",272,351,623,245,339,242
"067560510",388,428,816,261,308,257
"067560707",322,456,778,304,413,300
"067560902",219,234,453,184,278,180
"067560903",462,530,992,336,370,329
"067560907",586,696,1282,415,461,410
"067561001",235,300,535,221,277,220
"067561010",430,512,942,322,398,317
"067561105",334,401,735,357,466,353
"067561112",436,457,893,335,462,309
"067561208",467,502,969,355,425,344
"067561314",1062,1115,2177,512,508,492
"067561406",317,402,719,252,274,247
"067561506",466,503,969,293,310,288
"067561512",348,346,694,209,252,206
"067561606",247,301,548,191,207,188
"067561607",275,288,563,279,376,276
"067561608",369,417,786,286,332,273
"067561708",582,611,1193,407,438,378
"067561802",549,587,1136,394,445,389
"067561810",319,412,731,301,350,296
"067561906",615,644,1259,432,463,412
"067561908",628,674,1302,439,448,409
"067561909",552,611,1163,393,412,362
"067562105",442,470,912,252,272,236
"067562109",501,520,1021,298,361,295
"067562110",110,136,246,77,99,74
"067562205",521,543,1064,345,297,260
"067562301",1222,1320,2542,600,590,565
"067562304",658,650,1308,412,385,354
"067562410",364,402,766,257,255,249
"067562508",242,274,516,190,203,183
"067562602",358,387,745,255,248,234
"067562607",538,597,1135,393,394,362
"067562701",904,900,1804,456,367,361
"067562704",614,630,1244,320,302,298
"067562711",677,712,1389,453,434,426
"067600104",474,491,965,304,280,267
"067600304",379,417,796,294,307,283
"067600306",315,394,709,228,275,215
"067600311",413,506,919,351,413,349
"067600312",116,112,228,76,106,73
"067600509",681,691,1372,460,461,404
"067600511",1134,1252,2386,782,827,728
"067600609",813,815,1628,425,387,354
"067600702",936,929,1865,559,553,497
"067600706",439,437,876,254,280,239
"067600709",593,668,1261,367,391,352
"067600801",453,475,928,338,419,320
"067600806",520,578,1098,363,383,346
"067601006",66,88,154,61,58,54
"067601108",1144,1177,2321,595,561,521
"067601207",252,266,518,111,127,107
"067601215",651,674,1325,312,304,285
"067601218",500,486,986,237,224,190
"067601301",304,340,644,196,230,195
"067601312",612,559,1171,331,344,307
"067601403",536,536,1072,302,309,287
"067601411",592,596,1188,308,243,239
"067601413",849,838,1687,415,353,339
"067601602",473,505,978,283,254,235
"067601710",573,556,1129,307,317,291
"067601715",608,659,1267,342,343,331
"067630101",494,567,1061,354,388,340
"067630112",280,333,613,229,265,226
"067630115",559,624,1183,391,446,385
"067630201",131,166,297,119,156,117
"067630202",121,117,238,78,74,69
"067630501",361,367,728,231,234,214
"067630510",433,443,876,239,228,219
"067630603",706,694,1400,288,292,282
"067630606",688,685,1373,353,345,329
"067630607",760,710,1470,400,383,363
"067630611",529,503,1032,267,262,254
"067630712",291,311,602,165,162,148
"067630803",356,407,763,235,265,233
"067630812",290,277,567,135,140,129
"067630901",348,400,748,246,284,242
"067631101",598,605,1203,376,401,360
"067631201",214,220,434,149,176,148
"067631709",427,455,882,249,251,228
"067631807",326,324,650,182,190,180
"067631810",500,547,1047,370,391,361
"067631905",545,608,1153,349,383,343
"067631906",242,291,533,180,208,180
"067632012",396,400,796,240,238,223
"067700203",56,53,109,44,67,40
"067701006",581,598,1179,365,370,321
"067910217",334,355,689,294,348,283
"067702106",337,417,754,266,335,261
"067702108",325,336,661,244,275,234
"067780103",360,387,747,233,273,230
"067780106",625,625,1250,349,386,340
"067780110",66,47,113,37,47,25
"067780201",395,365,760,211,247,202
"067780203",304,285,589,165,182,159
"067780214",458,472,930,290,310,274
"067780218",404,422,826,220,231,214
"067780506",621,609,1230,329,353,323
"067781005",527,538,1065,321,321,307
"067781011",383,442,825,270,296,256
"067840810",306,352,658,232,260,230
"067910109",216,253,469,226,303,219
"067910303",344,369,713,241,283,239
"067910306",222,271,493,202,241,187
"067911213",549,604,1153,405,434,389
"067911307",400,431,831,246,265,244
"067911814",456,518,974,326,364,323
"067911908",185,284,469,223,294,222
"067912112",581,573,1154,338,383,332
"067912206",603,615,1218,354,368,344
"067912209",390,434,824,293,326,280
"067912215",352,385,737,265,326,260
"067980702",530,581,1111,400,490,391
"067980711",333,383,716,261,311,260
"068050105",200,203,403,110,184,110
"068050204",698,701,1399,395,424,376
"068050205",826,869,1695,469,467,424
"068050408",465,487,952,297,285,276
"068050501",510,541,1051,347,376,341
"068050512",803,820,1623,462,454,439
"068050706",251,246,497,156,556,140
"068050811",872,898,1770,477,414,387
"068051104",831,906,1737,510,519,465
"068051205",392,472,864,301,319,277
"068051404",617,688,1305,414,343,319
"068051416",938,976,1914,556,513,481
"068400409",432,453,885,286,297,281
"068051702",615,703,1318,433,378,342
"068051707",770,824,1594,472,479,435
"068051801",407,420,827,227,195,180
"068051911",723,803,1526,475,527,459
"068052005",697,734,1431,423,436,403
"068052014",475,512,987,312,342,297
"068052102",517,551,1068,289,261,257
"068052110",584,633,1217,329,321,309
"068052204",1019,923,1942,523,473,458
"068052304",821,859,1680,462,435,407
"068052405",953,955,1908,506,431,392
"068052313",631,664,1295,350,479,345
"068052314",940,924,1864,457,456,441
"068052409",819,778,1597,401,399,374
"068052504",203,221,424,139,180,134
"060281804",440,459,899,231,218,205
"068190902",107,89,196,70,173,69
"068260118",430,400,830,214,224,202
"068190906",139,143,282,106,236,104
"068260103",559,569,1128,326,293,245
"068260106",281,338,619,252,322,246
"068260115",269,339,608,248,310,245
"068260204",312,314,626,189,196,173
"068260702",265,286,551,183,207,176
"068261607",241,265,506,195,241,193
"068261901",310,383,693,284,366,281
"068261903",255,284,539,194,230,191
"068261906",367,401,768,220,250,217
"068261908",373,367,740,215,211,198
"068261910",341,343,684,251,291,248
"068330105",282,310,592,225,267,220
"068330111",348,438,786,311,400,307
"068330113",611,631,1242,450,490,413
"068330116",248,268,516,210,240,208
"068330206",201,272,473,196,310,196
"068331002",416,412,828,229,273,221
"068331003",16,14,30,6,6,5
"068331004",568,617,1185,427,483,416
"068331702",315,309,624,212,252,205
"068331804",72,79,151,68,445,66
"068331802",231,225,456,164,605,160
"068331905",665,679,1344,446,510,438
"068331907",545,465,1010,306,331,294
"068331910",415,414,829,238,251,229
"068331912",361,357,718,222,240,211
"068400108",418,415,833,198,168,166
"068400203",452,485,937,331,333,292
"068400306",611,666,1277,363,335,304
"068400309",492,516,1008,292,306,288
"068400403",495,506,1001,279,250,240
"068400410",761,770,1531,433,443,414
"068400414",503,513,1016,342,399,341
"068400416",561,579,1140,399,421,372
"068400701",601,689,1290,418,429,393
"068400709",458,530,988,355,406,348
"068400808",340,353,693,237,241,217
"068400903",413,439,852,327,369,324
"068400909",298,343,641,242,254,236
"068401010",299,301,600,250,322,249
"068401103",256,261,517,170,189,165
"068401105",404,416,820,266,276,249
"068401205",421,483,904,317,327,306
"068401206",10,8,18,4,4,4
"068401207",299,335,634,214,213,186
"068401302",280,292,572,205,216,200
"068401305",363,423,786,282,313,270
"068401307",237,296,533,210,247,194
"068401309",425,466,891,337,409,334
"068401503",336,375,711,261,318,258
"068401504",312,378,690,256,261,224
"068401508",246,298,544,249,312,249
"068401511",230,262,492,182,238,181
"068401514",431,489,920,335,387,320
"068401708",419,446,865,306,327,278
"068401711",272,300,572,196,212,177
"068401712",303,336,639,217,241,200
"068401713",279,302,581,215,248,209
"068401809",496,551,1047,347,382,339
"068401813",466,531,997,350,392,336
"068401906",575,630,1205,398,391,330
"068402403",274,313,587,202,202,184
"068401909",367,405,772,243,263,235
"068402002",396,445,841,275,303,263
"068402007",421,440,861,295,321,270
"068402102",285,337,622,218,252,217
"068402109",656,694,1350,362,327,317
"068402305",500,565,1065,367,402,364
"068402407",433,484,917,298,302,277
"068402504",485,429,914,248,232,218
"068402604",236,268,504,162,177,160
"068402606",1574,1697,3271,938,947,904
"068402708",411,465,876,277,314,265
"068402710",489,549,1038,351,344,299
"068402711",343,360,703,240,221,199
"068402712",452,549,1001,324,355,300
"068402802",448,488,936,313,292,243
"068402806",462,466,928,277,287,260
"068402905",546,628,1174,389,397,349
"068403005",228,260,488,170,203,156
"068403202",420,455,875,305,357,290
"068052617",26,12,38,18,56,18
"068470101",215,222,437,158,191,156
"068470113",293,313,606,198,205,191
"068052620",245,227,472,179,477,171
"068052621",102,100,202,72,225,70
"068120403",12,8,20,9,26,9
"068540112",363,441,804,287,340,282
"068540202",763,816,1579,455,516,443
"068190701",31,19,50,24,39,23
"068190802",60,36,96,32,85,31
"068261101",143,44,187,32,60,32
"068261401",36,24,60,22,36,19
"068261501",79,53,132,40,46,35
"068261602",78,57,135,42,49,42
"068261805",33,35,68,17,27,16
"068330502",12,11,23,9,28,9
"068330903",37,30,67,26,46,26
"068331605",45,19,64,19,33,19
"068331705",125,99,224,79,105,79
"068470204",51,38,89,32,62,30
"068540803",46,25,71,31,69,31
"068541010",83,68,151,52,87,50
"068541101",56,39,95,31,51,31
"068680501",15,9,24,14,14,13
"068750301",84,61,145,58,116,58
"068750502",71,46,117,47,83,47
"068750606",183,157,340,98,122,98
"068751302",96,71,167,70,122,68
"068540301",129,136,265,91,109,90
"068751701",255,173,428,153,193,144
"068820601",77,67,144,54,169,54
"068610301",317,370,687,328,367,326
"068541007",148,146,294,101,122,100
"068541008",146,153,299,112,153,111
"068541015",165,180,345,124,154,124
"068610106",252,307,559,222,274,216
"068541402",145,134,279,98,142,98
"068541406",251,243,494,153,187,152
"068610102",234,243,477,168,204,166
"068610211",367,384,751,246,297,244
"068610110",245,305,550,236,342,231
"068610206",200,228,428,173,246,172
"068610210",422,502,924,301,368,299
"068610307",217,312,529,248,288,247
"068610308",261,335,596,281,312,273
"068610401",219,271,490,286,434,285
"068610409",246,350,596,234,265,206
"068610502",205,223,428,223,322,220
"068610602",195,234,429,221,318,213
"068610903",292,300,592,224,249,219
"068610912",392,445,837,302,325,293
"068611006",449,472,921,314,365,313
"068611104",296,327,623,236,278,228
"068611108",302,343,645,236,275,231
"068611302",249,287,536,238,302,232
"068611602",253,280,533,201,231,196
"068611611",390,453,843,280,314,274
"068611708",453,505,958,323,377,315
"068611802",482,528,1010,351,396,350
"068611903",324,400,724,303,392,301
"068611911",442,493,935,341,391,332
"068612303",582,636,1218,399,410,372
"068612401",533,611,1144,410,473,395
"068612410",439,506,945,352,365,326
"068612504",385,352,737,206,192,175
"068612509",494,553,1047,360,387,346
"068612703",398,426,824,280,323,268
"068612807",340,386,726,268,325,264
"068612908",930,898,1828,502,482,460
"068612909",409,389,798,183,333,182
"068613004",884,972,1856,492,407,401
"068613006",436,488,924,259,254,245
"068613011",359,430,789,283,286,260
"068613101",600,646,1246,442,512,413
"068613109",524,502,1026,320,331,300
"068613201",239,286,525,213,257,207
"068613207",516,544,1060,383,445,369
"068613209",249,239,488,203,259,167
"068613210",445,485,930,364,454,351
"068613302",450,491,941,350,432,315
"068680206",298,315,613,211,487,209
"068680204",256,270,526,179,285,166
"068680211",45,47,92,34,309,34
"068680308",72,80,152,44,365,43
"068680401",37,38,75,28,325,28
"068680404",8,7,15,5,201,5
"068680503",780,701,1481,373,414,356
"068680604",92,97,189,90,415,90
"068680704",126,131,257,90,434,88
"068680712",78,75,153,47,48,47
"068680802",409,407,816,252,261,216
"068680810",49,67,116,45,248,45
"068750603",149,174,323,114,132,112
"068751507",500,549,1049,303,327,289
"068820214",398,396,794,215,211,196
"068820308",507,622,1129,388,386,366
"068820502",840,770,1610,460,484,444
"068820509",761,721,1482,436,494,415
"068820803",624,632,1256,397,370,328
"068820807",382,446,828,305,327,287
"068821009",719,754,1473,429,420,380
"068821607",593,578,1171,311,302,285
"068821711",580,557,1137,300,322,297
"065601410",480,523,1003,236,218,211
"065601505",496,574,1070,266,250,240
"065601514",766,808,1574,384,361,340
"065601704",373,369,742,188,94,77
"065601705",406,394,800,238,324,225
"067702209",328,354,682,236,251,204
"065601713",520,504,1024,240,256,225
"065601804",402,375,777,225,258,220
"065601813",481,505,986,275,320,258
"065601902",524,531,1055,291,319,284
"065601911",410,434,844,262,309,252
"065602001",1234,1252,2486,468,462,449
"065602005",596,569,1165,274,268,254
"065602014",644,600,1244,344,329,311
"065602316",429,415,844,298,325,283
"065602402",222,267,489,186,246,185
"065602407",506,536,1042,308,349,303
"065602502",365,438,803,265,282,250
"065602503",507,555,1062,374,418,361
"065602510",700,806,1506,507,528,463
"065602511",420,444,864,264,281,236
"065680207",453,522,975,338,357,310
"065680315",1007,1076,2083,558,524,511
"065680204",374,391,765,252,256,220
"065680306",360,398,758,254,238,225
"065680503",316,379,695,245,272,235
"065680505",473,569,1042,369,437,364
"065680604",425,447,872,334,396,331
"065680608",342,432,774,292,356,288
"065680803",419,445,864,241,259,233
"065680905",303,323,626,208,221,193
"065680906",365,409,774,277,307,267
"065680909",352,376,728,263,309,256
"065681004",414,451,865,298,329,295
"065681010",297,363,660,225,252,216
"065681011",306,323,629,224,252,222
"065681015",323,387,710,265,300,257
"065681102",506,548,1054,368,383,333
"065681107",404,441,845,277,323,270
"065681112",407,470,877,322,382,319
"065681304",417,450,867,330,380,316
"064904809",230,284,514,212,278,208
"066583202",560,623,1183,384,401,381
"064904911",404,430,834,328,346,299
"064905006",500,580,1080,379,404,372
"064905007",448,509,957,341,357,333
"064970308",651,722,1373,350,366,337
"065151912",456,476,932,257,244,216
"064970504",648,630,1278,334,352,308
"064970702",145,165,310,127,179,123
"064970709",244,295,539,207,240,194
"065390412",402,475,877,273,285,265
"064971103",394,454,848,328,362,302
"064971201",538,549,1087,302,313,261
"064971206",462,507,969,296,326,287
"064971307",376,411,787,261,290,261
"064971407",182,213,395,162,227,159
"064971409",517,542,1059,311,337,298
"066651312",809,836,1645,508,526,483
"065050211",253,269,522,179,214,176
"065152003",597,622,1219,323,273,258
"065152004",507,483,990,257,224,216
"065152006",401,399,800,233,228,210
"065152008",618,594,1212,315,327,309
"065152014",925,921,1846,485,444,427
"065050308",418,396,814,259,289,257
"065050318",194,190,384,106,92,77
"065050401",140,147,287,95,145,95
"065110502",373,421,794,302,365,293
"065110507",383,444,827,297,363,293
"065110508",418,505,923,322,374,312
"065110601",184,181,365,133,177,130
"065152104",425,419,844,227,234,201
"065152106",411,488,899,294,269,247
"065152112",521,517,1038,252,257,233
"065152114",397,389,786,224,229,214
"065180115",344,367,711,197,221,190
"065180603",104,104,208,79,261,76
"065180605",112,130,242,75,160,74
"065150204",65,49,114,33,30,28
"065150405",482,489,971,275,296,260
"065150501",473,460,933,241,214,212
"065150611",361,355,716,206,216,203
"065150704",1066,1050,2116,537,470,450
"065150709",838,803,1641,464,429,407
"065150711",332,347,679,169,146,140
"065150802",523,513,1036,312,310,280
"065150806",436,458,894,243,229,219
"065150807",579,587,1166,362,366,340
"065150901",394,434,828,255,274,240
"060282904",528,503,1031,290,282,257
"060283602",223,266,489,186,228,183
"060283912",759,810,1569,422,469,418
"060350304",462,537,999,357,376,354
"060351508",420,451,871,324,352,312
"065151003",637,726,1363,416,413,382
"065151004",365,428,793,273,295,261
"060560309",264,313,577,218,248,208
"060560801",857,845,1702,476,487,459
"065151113",535,552,1087,301,298,270
"060980313",202,228,430,140,145,133
"060980706",541,529,1070,368,393,332
"065151207",800,839,1639,485,409,376
"065151208",438,462,900,251,198,181
"061260108",378,407,785,265,267,251
"060070413",6,8,14,6,14,6
"060070809",430,497,927,358,400,345
"060141005",315,362,677,221,237,209
"060071001",13,8,21,12,17,11
"061820212",294,320,614,225,264,222
"061820306",1,0,1,1,2,1
"060140501",164,204,368,153,179,150
"060141014",293,302,595,212,240,207
"060210501",192,220,412,138,195,138
"060210605",253,351,604,261,302,260
"060210607",598,594,1192,395,466,392
"060280101",663,645,1308,360,326,306
"060280102",595,618,1213,290,247,240
"060280107",638,654,1292,326,353,306
"060280111",602,644,1246,395,411,378
"060280301",819,819,1638,473,454,420
"060280308",968,987,1955,525,528,517
"060280311",425,465,890,251,241,236
"060281107",284,342,626,208,239,201
"060280410",678,743,1421,361,310,307
"060280503",20,23,43,11,12,11
"060280608",407,426,833,226,223,213
"060280613",360,421,781,244,255,240
"060280704",695,780,1475,417,374,345
"060280805",640,637,1277,324,272,264
"060280906",596,633,1229,395,392,368
"060281003",522,612,1134,369,341,323
"060281004",377,419,796,249,212,202
"060281005",432,461,893,283,241,233
"060281010",551,577,1128,311,294,286
"060281011",556,580,1136,302,286,269
"060281013",987,1012,1999,528,520,497
"060281113",348,405,753,227,253,212
"060282002",625,685,1310,330,326,303
"060281307",510,493,1003,255,246,234
"060281312",412,499,911,290,296,270
"060281504",539,553,1092,269,242,231
"060281505",567,540,1107,300,290,272
"060351211",392,433,825,329,435,328
"060281601",440,451,891,274,279,273
"060281803",854,842,1696,440,441,416
"060282003",402,348,750,194,193,182
"060282007",608,596,1204,293,258,233
"060282106",279,304,583,212,243,202
"060282208",450,406,856,262,234,221
"060282209",647,704,1351,385,357,344
"060282210",900,887,1787,495,470,450
"060282214",434,433,867,246,246,230
"060282301",680,707,1387,453,440,406
"062030501",48,47,95,38,66,37
"060282304",514,584,1098,379,390,352
"060282604",252,362,614,241,287,241
"060282608",215,263,478,171,237,171
"060282709",225,207,432,141,155,140
"060282801",523,581,1104,354,334,318
"060282804",677,623,1300,307,315,301
"060282905",469,484,953,256,263,252
"060282906",477,487,964,222,209,192
"060282910",478,461,939,246,241,220
"060283008",1004,1010,2014,490,386,362
"060283014",563,588,1151,304,293,282
"060283016",506,562,1068,284,287,263
"060283310",387,443,830,297,358,289
"060283207",454,509,963,309,317,275
"060283410",514,547,1061,355,409,346
"060283505",973,908,1881,449,418,391
"060283507",834,812,1646,438,383,338
"060283705",681,637,1318,371,378,351
"060283608",396,481,877,284,314,279
"060283709",462,450,912,279,301,263
"060283710",631,667,1298,356,384,343
"060283802",648,651,1299,347,362,344
"060283805",536,584,1120,392,434,372
"060283808",601,623,1224,386,423,342
"060283811",420,461,881,269,284,250
"060350201",530,544,1074,321,276,266
"060350202",581,555,1136,278,260,258
"060350303",465,486,951,287,272,256
"060350314",383,428,811,277,299,272
"060350406",492,541,1033,342,336,308
"060350409",660,748,1408,435,436,407
"060350414",349,379,728,258,312,256
"060350502",565,676,1241,465,455,369
"060350602",491,592,1083,385,412,374
"060350605",398,483,881,316,364,296
"060350609",534,603,1137,315,324,307
"060350611",380,417,797,218,228,214
"060350705",378,457,835,286,319,275
"060350807",352,352,704,227,229,220
"060350809",401,432,833,267,239,224
"060350815",893,893,1786,501,186,171
"060350902",337,339,676,179,194,179
"060350906",365,389,754,190,221,179
"060350907",491,487,978,285,284,280
"060350910",755,723,1478,402,381,368
"060350911",624,611,1235,336,334,306
"060351105",633,741,1374,547,567,418
"060351210",327,462,789,397,494,396
"060351304",380,410,790,302,375,295
"060351305",347,374,721,245,249,212
"060351310",282,345,627,243,287,220
"060351402",234,320,554,225,265,224
"060351703",411,455,866,299,326,290
"060351704",396,470,866,323,356,307
"060351711",304,361,665,232,241,211
"060351811",404,503,907,320,347,304
"060351905",408,507,915,324,387,314
"060352109",329,362,691,249,275,236
"060352308",415,425,840,212,205,191
"060352411",668,730,1398,363,289,270
"060352505",490,560,1050,340,327,298
"060352507",399,457,856,301,302,277
"060352508",457,503,960,307,305,280
"060352607",480,537,1017,277,292,273
"060352609",589,603,1192,303,277,268
"060352713",349,429,778,230,214,194
"060352903",483,526,1009,345,346,300
"060353008",478,559,1037,356,373,322
"060353202",350,400,750,258,287,238
"060353306",371,435,806,291,342,279
"060353401",383,417,800,264,278,221
"060353402",353,422,775,240,235,213
"060353404",350,395,745,259,263,206
"060353504",384,416,800,246,263,226
"060353506",381,405,786,253,248,222
"060420101",681,702,1383,381,433,370
"060420104",279,326,605,247,293,244
"060420105",338,378,716,235,259,233
"060420109",572,627,1199,424,491,418
"060421906",354,477,831,310,372,301
"060490104",278,371,649,291,416,290
"060490105",266,351,617,265,406,261
"060490108",331,421,752,299,398,292
"060490114",435,437,872,255,277,248
"060490202",322,415,737,283,335,270
"060490204",511,549,1060,365,389,350
"060490602",379,434,813,212,148,134
"060491007",191,186,377,115,143,115
"062450414",144,149,293,100,175,99
"060560302",202,267,469,238,327,236
"060560112",241,309,550,277,357,268
"060560203",271,285,556,182,207,178
"065151304",543,557,1100,305,309,290
"060560506",432,482,914,327,369,321
"060560601",445,470,915,272,291,266
"060560706",359,371,730,242,271,236
"060560707",505,610,1115,347,378,337
"060560709",578,603,1181,357,389,348
"060561007",250,284,534,245,337,240
"065151306",765,820,1585,462,473,424
"060560904",309,343,652,255,348,248
"060560908",322,355,677,264,277,226
"060560909",236,249,485,153,152,141
"060561011",236,266,502,195,246,193
"060561201",284,313,597,310,353,306
"060561305",191,207,398,178,229,177
"060561401",242,251,493,208,256,203
"060561409",166,212,378,170,222,169
"060561415",127,195,322,191,291,172
"060561417",238,351,589,280,351,267
"060561418",164,286,450,217,332,204
"060561419",225,329,554,256,356,251
"060561504",340,360,700,246,274,242
"060561512",601,617,1218,400,418,389
"060561515",709,740,1449,447,487,420
"060561601",264,311,575,214,238,212
"060561610",316,396,712,270,350,266
"060561611",336,442,778,335,447,330
"060561613",322,439,761,341,454,332
"060561709",281,379,660,253,346,248
"060561801",531,560,1091,384,427,377
"062600202",923,933,1856,501,461,436
"060561911",466,548,1014,340,376,337
"060561913",630,656,1286,413,429,387
"060561914",328,350,678,228,235,219
"060562210",358,444,802,283,318,279
"060562215",462,504,966,297,309,294
"060562216",425,507,932,343,356,333
"060562415",434,404,838,238,254,233
"060562508",555,593,1148,395,452,385
"063573902",130,170,300,162,483,160
"065151309",734,795,1529,444,464,435
"065151313",491,526,1017,321,339,310
"062601615",863,808,1671,455,436,402
"060562707",587,584,1171,325,385,321
"060563004",263,288,551,205,236,204
"060630106",363,432,795,287,318,269
"060630108",538,558,1096,382,422,366
"060630111",349,414,763,297,322,269
"060630206",242,270,512,159,171,153
"062700104",726,692,1418,338,340,320
"060630806",92,91,183,66,85,65
"060631101",35,34,69,23,37,22
"060700101",193,240,433,166,202,161
"063573905",136,160,296,138,393,138
"060700211",420,426,846,246,303,240
"060700212",641,641,1282,373,401,351
"062740302",505,476,981,291,256,242
"063710508",301,341,642,194,207,193
"060840702",318,324,642,191,213,188
"060840707",311,375,686,273,335,266
"060911105",444,520,964,326,330,304
"060910103",298,327,625,226,249,215
"060910401",803,869,1672,396,408,389
"060910501",986,1059,2045,479,422,417
"060910503",874,838,1712,449,459,421
"062741709",574,559,1133,329,339,305
"060910601",592,639,1231,343,303,285
"060910705",482,445,927,268,263,245
"064410411",302,411,713,353,474,341
"060910907",651,674,1325,445,470,420
"060911010",868,899,1767,555,544,492
"060911202",757,782,1539,453,414,399
"060911203",602,633,1235,358,342,318
"060911304",777,673,1450,361,320,292
"060911502",461,457,918,249,224,213
"060911505",467,524,991,299,294,275
"060911506",510,554,1064,307,282,259
"060911508",557,625,1182,297,268,258
"060911511",766,747,1513,410,414,387
"060911512",432,479,911,286,271,243
"060911601",626,674,1300,382,373,345
"060980110",440,516,956,312,338,301
"060911709",678,719,1397,379,361,354
"060911710",634,677,1311,369,365,351
"060911801",473,457,930,236,246,220
"060911805",661,688,1349,385,385,353
"060911806",772,791,1563,391,380,361
"060912101",536,527,1063,266,264,250
"060912102",412,484,896,312,351,307
"060912213",476,487,963,254,334,254
"060912305",330,363,693,228,245,208
"060912310",804,811,1615,455,445,415
"060912317",248,251,499,147,232,138
"060912319",142,119,261,85,146,83
"060912411",487,447,934,250,429,243
"060980103",418,491,909,316,312,300
"060980105",372,386,758,267,287,257
"063573908",142,196,338,173,366,171
"060980209",342,372,714,220,239,215
"060980210",518,552,1070,310,319,300
"060980301",168,209,377,137,151,131
"060980813",379,418,797,239,235,206
"060980507",391,392,783,240,248,222
"060980606",401,478,879,298,325,288
"060980611",530,550,1080,316,330,297
"062940202",159,149,308,98,117,98
"060980804",508,476,984,273,293,267
"060980816",474,519,993,311,321,274
"061050211",415,453,868,346,406,341
"061051102",197,214,411,163,218,160
"061051104",217,229,446,178,225,175
"061051303",358,384,742,233,289,232
"061120108",306,466,772,263,319,259
"061120201",535,567,1102,318,338,311
"061120206",378,467,845,307,348,307
"061120310",103,75,178,64,78,64
"061120601",24,14,38,15,17,14
"061120702",498,530,1028,350,401,342
"061120901",65,62,127,40,56,40
"061190309",519,534,1053,278,267,243
"061190701",319,322,641,201,231,199
"061190801",107,108,215,82,120,76
"061260303",412,482,894,357,454,351
"061260104",337,352,689,231,230,211
"061260202",736,736,1472,442,446,402
"061260203",521,547,1068,347,401,340
"061260301",301,329,630,256,338,252
"061260308",286,316,602,223,272,218
"061260501",535,592,1127,321,343,314
"061260502",590,619,1209,375,406,363
"061260506",472,450,922,277,280,262
"061260710",508,535,1043,295,314,290
"061260903",523,495,1018,278,234,220
"065151409",417,469,886,241,240,232
"061340203",563,580,1143,301,323,286
"061340909",695,721,1416,409,393,350
"061340309",518,609,1127,454,514,443
"061341002",698,714,1412,381,533,366
"061341008",486,488,974,290,318,284
"061400401",116,114,230,82,108,82
"065151410",680,671,1351,384,396,378
"061400306",437,408,845,236,248,226
"061400308",425,495,920,308,356,303
"061470103",260,309,569,240,292,236
"061470104",403,432,835,280,288,249
"061470201",241,224,465,167,209,165
"061470501",846,881,1727,497,520,471
"063573510",96,150,246,132,362,132
"061470901",111,103,214,74,89,73
"061471204",336,339,675,245,267,234
"061540401",65,59,124,46,91,38
"061610105",281,288,569,174,209,172
"061610113",417,458,875,299,342,282
"065391709",243,269,512,181,196,165
"061750403",545,570,1115,273,283,258
"061750409",507,498,1005,327,384,320
"061750412",353,366,719,258,267,242
"061750601",471,501,972,283,301,270
"061750604",475,499,974,278,295,269
"061820111",572,621,1193,324,332,314
"061820307",0,0,0,0,1,0
"061820308",101,23,124,14,26,14
"061820312",39,33,72,24,51,24
"061820602",90,74,164,61,82,56
"061820609",422,406,828,271,290,265
"061820705",492,495,987,292,290,265
"061820902",65,40,105,41,297,38
"063577713",94,100,194,60,147,49
"061960203",164,187,351,104,116,104
"061891002",346,381,727,240,265,236
"061891007",437,478,915,341,401,339
"061891008",333,348,681,216,239,216
"061891009",304,291,595,189,199,176
"061891211",189,209,398,136,190,136
"063578017",210,248,458,140,225,140
"063578108",228,236,464,153,224,145
"063640101",586,570,1156,330,364,320
"061960111",195,194,389,118,229,116
"061960118",230,240,470,157,184,155
"061960208",297,370,667,261,322,256
"061960213",239,268,507,202,229,199
"061960214",265,291,556,203,246,200
"061961507",181,185,366,150,183,147
"062030104",300,352,652,279,325,275
"062030113",407,438,845,263,278,249
"062030212",454,473,927,322,415,316
"062030401",86,79,165,59,93,58
"062030803",416,418,834,234,255,232
"062030810",419,474,893,315,380,303
"062031605",380,374,754,274,308,266
"062031606",297,281,578,158,171,149
"062031613",417,411,828,299,349,297
"062100107",412,455,867,279,295,259
"062100110",177,246,423,168,224,166
"062100115",411,474,885,280,305,275
"062100201",459,448,907,279,356,265
"062100206",271,299,570,198,215,185
"062100606",242,291,533,197,263,194
"062170102",371,461,832,302,371,299
"062101302",441,454,895,309,340,308
"062170101",357,395,752,285,343,278
"062170103",346,368,714,254,314,249
"062170303",149,138,287,79,96,79
"062170406",130,124,254,83,167,80
"062240111",394,491,885,361,417,351
"062170501",18,11,29,11,35,11
"062170503",8,6,14,6,28,6
"063572208",184,290,474,224,394,224
"062170510",13,14,27,7,26,7
"062240101",287,305,592,166,200,162
"062240102",369,450,819,311,353,295
"062240109",378,454,832,326,397,317
"062240208",471,562,1033,366,434,356
"062240301",369,403,772,277,310,267
"062240303",400,422,822,310,345,300
"062240308",557,584,1141,303,261,193
"062240406",292,410,702,282,344,278
"062240409",489,575,1064,369,436,367
"062240410",345,331,676,235,264,228
"062240413",343,461,804,336,388,332
"062240415",213,233,446,134,146,128
"062240501",18,15,33,12,19,12
"062240901",216,216,432,140,217,139
"062240902",428,436,864,287,330,283
"062240911",278,270,548,165,192,163
"063572212",153,222,375,186,415,186
"062310101",328,352,680,227,270,227
"062242202",280,335,615,261,320,248
"062310107",279,264,543,190,233,189
"062311206",222,253,475,197,212,180
"062311208",647,643,1290,398,435,386
"062311213",356,322,678,180,184,171
"062380109",319,385,704,262,337,262
"062380602",157,167,324,88,108,88
"062450110",462,507,969,311,329,294
"062450203",299,305,604,186,185,170
"062450207",501,620,1121,397,413,367
"062450304",866,876,1742,501,446,420
"062450404",404,407,811,235,342,230
"065151503",694,700,1394,362,333,310
"062450405",357,354,711,232,373,229
"062450411",70,68,138,41,70,24
"062450504",432,442,874,278,298,275
"062520203",338,334,672,198,375,194
"062520206",208,201,409,130,229,127
"062520209",833,769,1602,387,389,346
"062520217",497,555,1052,294,275,252
"062520302",133,127,260,85,116,83
"065151506",726,732,1458,350,361,340
"062520401",641,683,1324,347,325,275
"062520506",253,284,537,207,251,201
"063572803",127,178,305,159,550,159
"062520704",867,815,1682,459,403,374
"062520804",801,821,1622,416,428,400
"062520902",1040,1011,2051,501,509,484
"062520905",808,779,1587,412,341,325
"065151510",721,751,1472,380,343,335
"063572804",102,146,248,133,417,129
"062521013",800,763,1563,425,524,405
"062521205",918,890,1808,505,460,422
"065151512",541,603,1144,328,288,265
"062521309",360,378,738,233,266,225
"062521404",651,601,1252,309,333,298
"062521416",505,547,1052,294,306,284
"062521503",636,625,1261,351,324,305
"062521513",374,385,759,248,562,213
"062521514",657,730,1387,421,321,294
"062600110",855,818,1673,469,445,375
"062600111",531,494,1025,295,314,286
"062600108",780,761,1541,446,441,423
"062600115",577,564,1141,312,270,249
"062600201",1101,1125,2226,587,573,525
"062600212",722,724,1446,348,304,287
"062600305",761,796,1557,393,398,383
"062600307",702,680,1382,375,325,304
"062600312",941,1047,1988,519,534,513
"062600317",643,730,1373,377,316,299
"062600318",635,635,1270,345,336,327
"062600513",752,710,1462,399,440,378
"062600515",646,656,1302,357,321,303
"062600603",461,542,1003,326,348,314
"062600605",580,670,1250,400,414,377
"062600615",409,464,873,303,348,294
"062600706",536,583,1119,337,370,329
"062600708",389,434,823,255,276,241
"062600810",466,452,918,254,250,235
"062600813",787,801,1588,446,431,405
"062600903",909,942,1851,502,485,453
"062600904",853,882,1735,455,449,415
"062600906",163,176,339,100,96,87
"062600911",802,794,1596,435,460,377
"062601008",591,611,1202,338,358,322
"062601202",263,296,559,187,222,180
"062601205",581,646,1227,407,452,396
"062601208",445,467,912,314,351,300
"062601302",651,695,1346,477,484,432
"062601312",176,208,384,171,266,170
"065151602",517,515,1032,294,323,277
"062601502",629,605,1234,338,335,301
"062601510",943,928,1871,469,453,423
"063572904",144,212,356,206,592,201
"062601611",677,645,1322,303,324,289
"062601702",33,36,69,21,30,20
"062601713",1160,1160,2320,643,850,630
"062660304",304,341,645,202,214,195
"062660306",205,243,448,166,182,158
"062660308",183,253,436,159,185,156
"062660309",231,281,512,197,251,188
"062660505",69,66,135,54,165,54
"062660612",203,196,399,115,233,114
"062660603",174,160,334,113,173,108
"062660710",593,614,1207,318,320,288
"062700216",674,665,1339,338,358,329
"062700203",499,479,978,281,292,273
"062700205",430,487,917,309,322,288
"062700207",669,745,1414,402,420,381
"062700308",652,642,1294,396,393,350
"062700312",668,713,1381,456,523,439
"062700315",352,379,731,256,302,241
"062700401",298,279,577,172,183,165
"062700405",721,716,1437,403,447,391
"062700413",625,639,1264,366,396,339
"062700617",918,939,1857,495,532,465
"062700701",503,508,1011,266,268,248
"062700703",599,611,1210,320,337,308
"062700707",720,746,1466,431,481,418
"062700709",351,407,758,220,243,203
"062700714",586,590,1176,331,348,319
"062700717",730,787,1517,389,414,368
"062700910",690,696,1386,367,384,357
"062700810",508,498,1006,238,236,219
"062700813",89,92,181,63,156,57
"062700903",589,567,1156,295,331,290
"062701001",581,647,1228,370,430,359
"062701003",1219,1224,2443,644,666,589
"062701004",848,912,1760,470,462,411
"062701008",704,695,1399,345,359,328
"062740114",427,450,877,243,233,214
"062740111",462,475,937,294,275,256
"062740202",660,657,1317,376,370,349
"062740203",705,748,1453,414,417,400
"062740413",631,637,1268,318,307,290
"062740311",616,603,1219,350,364,343
"062740410",650,625,1275,342,341,318
"062740411",551,544,1095,283,295,262
"062740501",418,470,888,275,303,268
"062740503",476,519,995,272,267,247
"062740615",787,728,1515,345,347,330
"062740617",566,596,1162,274,269,259
"062740707",765,703,1468,360,354,334
"062740813",878,825,1703,416,428,393
"062740816",514,515,1029,283,288,268
"062740908",373,418,791,208,230,199
"062740914",526,527,1053,248,256,235
"062740915",800,848,1648,402,417,380
"062741015",3647,571,4218,278,379,273
"062741115",585,616,1201,308,317,295
"062741116",559,550,1109,278,264,255
"062741117",785,789,1574,401,387,359
"062741215",707,684,1391,349,318,299
"062741302",315,325,640,199,213,189
"062741303",361,399,760,240,254,225
"062741306",724,718,1442,311,308,297
"062741307",455,486,941,276,277,256
"062741314",250,300,550,191,262,185
"062741403",242,304,546,220,261,204
"062741411",485,592,1077,363,424,347
"062741501",675,692,1367,336,327,323
"062741502",636,617,1253,328,314,303
"062741503",503,498,1001,262,273,260
"062741505",364,404,768,230,200,179
"062741507",544,551,1095,304,300,287
"064274902",561,597,1158,314,302,288
"062741703",510,588,1098,299,288,279
"062741802",600,544,1144,288,267,257
"062741804",508,498,1006,243,225,220
"062741806",929,914,1843,408,360,351
"062741903",652,601,1253,300,281,266
"062741906",774,796,1570,413,358,341
"062741911",933,949,1882,463,473,445
"062742001",922,920,1842,417,363,355
"062742009",551,591,1142,320,285,269
"062742013",790,810,1600,384,359,343
"062742107",941,1092,2033,410,413,398
"064275609",603,619,1222,347,292,256
"062742123",541,615,1156,306,299,275
"062742202",498,551,1049,266,266,245
"062742204",509,489,998,257,264,245
"062770114",317,332,649,229,247,222
"062800101",355,324,679,180,207,176
"062800304",71,74,145,56,429,56
"062800306",73,89,162,50,433,50
"062800307",113,120,233,90,621,90
"062800405",56,73,129,45,359,45
"062800409",199,215,414,127,184,121
"065151606",504,577,1081,293,339,277
"062800605",16,15,31,12,128,12
"062800616",45,45,90,34,100,33
"062800610",237,221,458,128,153,121
"062800612",50,38,88,39,126,38
"062800613",51,31,82,26,102,26
"064277505",1074,1007,2081,493,456,448
"062940406",82,79,161,52,170,51
"062940810",186,171,357,108,131,103
"063010508",301,362,663,246,276,238
"063150106",438,488,926,311,383,303
"063150107",326,366,692,200,222,184
"063150110",467,530,997,376,437,367
"063220702",27,14,41,16,28,16
"063290505",188,189,377,112,157,111
"063290506",270,240,510,156,193,152
"063430703",374,428,802,277,317,262
"064342504",317,320,637,197,205,181
"063510102",192,206,398,135,155,132
"063510301",22,16,38,18,38,18
"063510606",471,472,943,357,380,332
"063570507",253,284,537,183,226,178
"063570509",464,525,989,338,428,331
"063570513",181,211,392,147,227,147
"063570602",378,429,807,261,268,228
"063570704",522,543,1065,307,356,303
"063570706",520,569,1089,343,378,333
"063570708",415,418,833,268,283,258
"063570803",327,341,668,204,221,197
"063570905",552,613,1165,348,332,286
"063570907",594,603,1197,327,331,299
"063570911",573,612,1185,367,346,319
"063570912",674,709,1383,422,460,397
"063571011",466,527,993,330,328,298
"063571206",302,334,636,208,194,174
"063571209",597,610,1207,338,324,296
"063571303",548,621,1169,415,436,385
"063571306",685,679,1364,415,447,393
"063571408",415,482,897,359,419,342
"063571607",195,257,452,188,266,186
"063571702",104,132,236,109,176,109
"063571710",240,265,505,185,271,185
"063571807",318,351,669,247,308,238
"063571809",286,354,640,234,390,232
"063571906",126,152,278,127,288,125
"063572301",174,215,389,165,467,164
"063572308",113,108,221,58,355,58
"063572701",141,210,351,178,509,175
"063572703",192,288,480,240,695,236
"063573305",248,345,593,271,394,268
"063573311",141,226,367,170,250,165
"063573406",123,200,323,162,340,158
"063573407",202,269,471,189,334,187
"063574004",346,642,988,207,844,197
"063574201",116,171,287,163,672,163
"063574307",220,227,447,135,339,134
"063574401",37,37,74,27,51,25
"063574403",313,362,675,235,329,230
"063574406",112,138,250,112,452,111
"063574501",143,210,353,171,227,170
"063574504",272,354,626,227,288,222
"063574513",230,215,445,74,231,74
"063574602",194,275,469,197,230,170
"063574611",336,380,716,244,310,243
"063574706",177,257,434,185,273,185
"063574812",207,228,435,188,231,187
"063574903",262,320,582,222,281,220
"063575010",253,302,555,208,252,204
"063575108",614,607,1221,288,286,266
"063575204",621,646,1267,383,416,378
"063575208",437,441,878,270,251,229
"063575302",509,554,1063,343,348,312
"063575501",257,291,548,199,227,183
"063575603",359,427,786,312,369,305
"063575702",437,496,933,346,404,339
"063575705",289,324,613,217,229,210
"063575706",445,484,929,343,357,317
"063575807",392,434,826,293,322,278
"063575902",362,416,778,301,391,293
"063575903",371,512,883,252,315,236
"063576101",477,502,979,310,376,295
"063576105",458,474,932,284,324,280
"063576110",434,460,894,322,451,319
"063576303",99,89,188,71,312,69
"063576305",179,183,362,133,446,131
"063576306",74,86,160,59,274,59
"063576307",87,81,168,57,269,56
"063576404",398,383,781,225,286,219
"063576506",277,316,593,193,272,193
"063576607",424,469,893,274,299,259
"063576710",583,628,1211,326,357,323
"063576805",267,297,564,183,195,172
"063576806",410,472,882,253,278,243
"063576902",372,408,780,225,263,221
"063576904",415,419,834,250,276,245
"063576905",397,415,812,248,244,212
"063577012",339,379,718,207,205,178
"063577210",748,722,1470,426,443,387
"063577305",579,666,1245,349,404,336
"064415408",226,254,480,168,200,166
"063577508",202,223,425,138,300,135
"063577601",163,166,329,98,131,94
"064415607",455,465,920,296,345,287
"063577611",201,188,389,110,192,108
"064415707",810,781,1591,454,463,401
"063577613",118,104,222,80,246,75
"063577615",116,109,225,79,200,77
"063577616",151,135,286,79,192,78
"063577707",75,67,142,59,135,55
"063577718",58,49,107,40,228,40
"063577802",312,310,622,162,181,157
"063577805",510,517,1027,274,298,255
"063577813",473,476,949,261,290,254
"063577912",352,386,738,223,251,219
"063578104",137,130,267,78,111,73
"063578211",211,220,431,151,309,151
"063640102",314,339,653,227,231,199
"063640105",442,495,937,302,343,297
"063640113",414,397,811,205,214,195
"063640202",518,478,996,300,239,193
"063640711",276,330,606,210,238,203
"063640318",478,498,976,293,310,279
"063640403",681,674,1355,350,385,338
"063640404",201,203,404,118,136,117
"063640407",308,338,646,190,221,176
"064550801",24,19,43,18,27,17
"063640708",347,435,782,258,295,247
"063710208",426,457,883,289,297,280
"063640804",283,260,543,157,182,133
"063640810",527,502,1029,290,332,276
"063640814",349,352,701,196,249,172
"063710210",627,650,1277,416,392,376
"063640817",457,454,911,237,283,236
"063640821",290,292,582,157,179,155
"063710101",640,661,1301,343,271,264
"063710104",394,428,822,234,246,223
"063710201",664,723,1387,403,397,375
"063710207",374,429,803,256,253,245
"063710301",571,717,1288,418,420,400
"063710510",580,624,1204,382,395,361
"063710606",442,479,921,301,280,267
"063710704",692,681,1373,360,305,305
"063710712",474,487,961,317,361,313
"063710802",547,605,1152,371,303,269
"063710905",444,479,923,317,293,273
"063710909",549,625,1174,389,400,358
"063710911",251,276,527,190,194,179
"063711004",253,309,562,220,236,186
"063711008",388,439,827,301,339,296
"063711101",321,399,720,274,304,260
"063711106",240,290,530,231,328,226
"063711109",230,256,486,181,223,177
"063711202",391,426,817,296,298,238
"063711210",275,374,649,297,415,294
"063711312",551,546,1097,373,418,361
"063711512",521,531,1052,291,258,242
"063711603",367,362,729,174,158,153
"063711711",487,532,1019,346,368,330
"063711804",491,519,1010,370,418,351
"063712005",380,424,804,286,289,260
"063712006",498,564,1062,375,407,365
"063712209",192,224,416,188,242,187
"063712301",337,429,766,297,386,295
"063712304",262,301,563,220,374,218
"063712306",321,372,693,260,312,256
"063712404",242,260,502,176,151,133
"063712406",314,306,620,222,230,208
"063712607",343,373,716,252,299,241
"063713001",406,443,849,292,293,270
"063713106",618,685,1303,453,473,446
"063713203",616,686,1302,386,364,347
"063713209",342,382,724,240,257,236
"063713309",497,583,1080,349,341,312
"063713511",832,765,1597,418,385,375
"063713513",528,550,1078,328,334,300
"063713604",924,938,1862,558,489,464
"063713610",515,550,1065,353,392,345
"063713716",775,843,1618,480,455,415
"063713703",388,393,781,198,191,182
"063713704",250,256,506,143,114,106
"063713708",1166,1143,2309,641,585,540
"063850704",476,463,939,302,328,298
"063850714",397,397,794,284,330,274
"063850717",227,271,498,218,241,211
"063850718",98,78,176,53,67,53
"063920101",489,408,897,241,283,224
"063920107",428,437,865,312,362,311
"063920109",527,572,1099,367,441,360
"063920111",364,381,745,248,280,240
"063920112",392,434,826,303,325,288
"063920116",250,268,518,204,241,201
"064902403",260,358,618,199,329,192
"063921206",423,413,836,247,289,245
"063921502",322,321,643,218,250,214
"063990101",342,369,711,281,334,275
"063990102",316,322,638,232,274,230
"063990103",164,198,362,140,176,139
"063990704",371,368,739,272,324,269
"063990705",306,304,610,217,284,217
"064060214",277,325,602,223,253,222
"064080101",522,587,1109,373,366,344
"064080109",700,754,1454,442,446,425
"064080111",844,936,1780,584,568,529
"064080112",641,673,1314,416,375,359
"064081203",558,589,1147,326,336,321
"064080206",416,478,894,331,360,319
"064080207",635,656,1291,437,437,388
"064904013",944,934,1878,449,427,398
"064080303",683,692,1375,381,342,326
"064080309",487,527,1014,327,339,282
"064080401",806,801,1607,395,367,340
"064080403",477,507,984,264,208,203
"064080410",903,979,1882,582,600,557
"064080507",454,500,954,270,247,229
"064080601",598,636,1234,429,461,356
"064080603",490,523,1013,352,412,345
"064080801",531,604,1135,328,331,315
"064080811",531,658,1189,354,356,324
"064081002",471,506,977,303,294,275
"064081105",913,933,1846,482,458,427
"064081305",394,442,836,264,253,236
"064081311",616,662,1278,363,367,341
"064081401",555,645,1200,406,355,319
"064081403",605,694,1299,403,405,385
"064081406",403,381,784,246,260,241
"064081411",485,497,982,300,303,271
"064081412",471,493,964,312,378,294
"064081413",490,507,997,328,344,306
"064081505",668,800,1468,492,494,414
"064100305",613,646,1259,365,371,323
"064100306",491,488,979,297,324,293
"064100307",482,517,999,276,290,265
"064100507",333,381,714,200,193,188
"064100508",595,653,1248,358,347,326
"064100705",563,597,1160,379,401,356
"064100709",472,474,946,305,319,291
"064100902",380,393,773,271,301,263
"064121006",657,677,1334,345,336,314
"064100906",456,488,944,314,328,303
"064101003",532,563,1095,357,390,345
"064101005",465,540,1005,317,342,309
"064101006",436,480,916,310,336,309
"064101007",697,766,1463,466,492,442
"064101010",481,566,1047,356,395,336
"064101107",428,439,867,297,344,289
"064101205",380,409,789,245,257,232
"064101208",234,285,519,178,197,170
"064101210",788,646,1434,226,249,216
"064101301",619,643,1262,404,439,395
"064120103",107,116,223,63,160,63
"064120201",234,216,450,136,169,127
"064120210",488,571,1059,334,355,307
"064120211",458,520,978,299,312,277
"065150302",729,759,1488,368,357,337
"064120305",646,719,1365,426,713,392
"064120403",759,770,1529,409,424,395
"064270106",440,590,1030,453,603,447
"064120407",577,607,1184,354,310,282
"064120410",655,671,1326,384,415,381
"064120507",536,557,1093,338,341,314
"064120508",580,634,1214,371,375,349
"065150506",570,625,1195,357,384,352
"065150706",581,614,1195,340,350,336
"064120714",540,573,1113,305,276,259
"064120716",539,497,1036,285,221,216
"064120805",392,429,821,267,297,250
"064120902",549,565,1114,269,299,264
"064120909",713,721,1434,354,362,334
"064121015",606,636,1242,306,276,255
"064121209",811,770,1581,414,422,395
"064121412",788,765,1553,377,367,353
"064130105",437,466,903,282,278,269
"064130209",389,457,846,311,355,299
"064130412",351,374,725,248,277,248
"064130601",274,299,573,197,206,186
"064130611",434,460,894,295,314,277
"065180211",333,343,676,214,226,205
"064131406",248,298,546,147,154,143
"064131408",401,400,801,178,200,175
"064131505",58,48,106,40,168,39
"064131508",47,44,91,34,110,33
"064131509",44,42,86,34,121,27
"064132101",707,669,1376,436,461,424
"064132107",339,384,723,267,304,256
"064132210",235,254,489,157,186,154
"064200103",165,182,347,109,241,105
"064200106",106,111,217,83,316,80
"064200416",69,88,157,70,483,70
"064200503",211,238,449,167,380,164
"064200509",463,467,930,274,381,257
"064200603",58,79,137,69,285,68
"064200607",49,49,98,42,477,42
"064200610",46,63,109,50,297,49
"064200705",61,66,127,54,272,54
"064200904",143,143,286,101,241,96
"064200905",84,104,188,76,310,75
"064200909",63,72,135,50,384,49
"064201001",211,193,404,110,175,103
"064201002",55,73,128,52,210,52
"064201006",169,156,325,111,505,110
"064201206",85,89,174,62,338,62
"064201305",27,37,64,31,354,31
"064201308",43,55,98,39,416,38
"064201408",39,37,76,31,339,31
"064201502",40,41,81,24,447,24
"064201503",37,36,73,30,427,30
"064201601",25,22,47,22,445,22
"064201609",45,41,86,36,283,36
"064201610",41,49,90,37,304,37
"064201612",303,327,630,210,486,204
"064201708",205,203,408,131,357,118
"064201804",21,30,51,23,321,23
"064201809",52,50,102,38,251,38
"064201810",25,24,49,23,333,23
"064201910",168,180,348,136,258,125
"064202111",356,334,690,197,243,190
"064202205",109,106,215,81,395,81
"064202209",245,239,484,129,198,128
"064270204",270,408,678,353,518,348
"064270211",90,108,198,86,142,85
"064270215",213,231,444,181,258,178
"064270216",173,205,378,177,302,173
"064270302",381,460,841,390,562,372
"064270303",240,309,549,218,253,212
"064270310",342,469,811,382,644,353
"064270409",642,679,1321,427,423,387
"064270506",582,681,1263,392,355,336
"064270808",343,364,707,209,229,192
"064271108",669,695,1364,413,395,376
"064271302",736,755,1491,451,504,445
"064271306",445,438,883,246,269,224
"064271307",392,425,817,282,341,242
"064271402",571,605,1176,318,311,272
"064271411",1490,1501,2991,858,664,617
"064271419",535,540,1075,323,342,290
"064271507",374,438,812,257,235,210
"064271509",375,422,797,258,254,227
"064271512",627,673,1300,413,376,324
"064271513",340,405,745,242,229,207
"064271602",598,691,1289,475,544,452
"064271607",666,703,1369,388,345,334
"064271804",1387,1506,2893,641,491,459
"064271805",2255,2449,4704,1080,910,847
"064271905",376,395,771,238,213,185
"064272102",765,836,1601,449,410,383
"064272108",625,656,1281,399,427,384
"064272301",206,220,426,150,156,137
"064272408",544,620,1164,397,438,376
"064272514",269,274,543,180,193,174
"064272804",403,427,830,280,303,264
"064272805",357,410,767,262,269,237
"064272811",454,534,988,348,398,338
"064272902",494,583,1077,366,429,360
"064272903",311,360,671,232,286,223
"064272909",252,291,543,195,222,191
"064272913",464,540,1004,292,325,275
"064273011",158,203,361,170,227,169
"064273203",324,385,709,262,319,257
"064273205",533,613,1146,389,440,374
"064273207",496,583,1079,366,392,331
"064273303",303,362,665,215,234,204
"064273413",429,486,915,311,311,290
"064273504",323,399,722,245,288,229
"064273703",328,348,676,212,215,195
"064273710",980,1069,2049,579,444,400
"064273802",746,713,1459,378,279,263
"064273901",880,855,1735,485,374,332
"064274001",641,705,1346,342,287,273
"064274002",834,893,1727,458,441,419
"064274003",484,538,1022,262,262,253
"064274010",1027,1075,2102,552,506,471
"064274107",1981,1999,3980,924,681,642
"064274201",730,765,1495,426,457,417
"064274207",452,478,930,296,289,259
"064274302",664,735,1399,440,455,414
"064274606",998,1033,2031,606,596,564
"064274612",753,799,1552,406,485,383
"064274710",561,569,1130,318,286,269
"064274801",507,509,1016,172,160,149
"064274811",872,931,1803,517,444,415
"064274906",1300,1410,2710,619,611,494
"064275012",696,827,1523,487,539,469
"064275103",473,503,976,296,301,282
"064275108",822,906,1728,541,508,491
"064275109",642,670,1312,405,438,381
"065151708",254,250,504,139,176,133
"064275110",674,678,1352,371,390,361
"064275206",819,890,1709,395,312,309
"064275212",831,797,1628,354,253,241
"064275301",1056,1150,2206,522,431,419
"064275304",1062,1025,2087,457,414,408
"064275502",375,419,794,268,276,246
"064275508",566,590,1156,345,361,327
"064275513",795,853,1648,454,377,343
"064275704",549,607,1156,315,279,265
"064275705",620,612,1232,327,266,237
"064275710",548,569,1117,308,241,235
"064275712",716,771,1487,426,406,390
"064275813",498,538,1036,282,190,179
"064276001",921,1107,2028,488,416,379
"064276005",835,1066,1901,525,479,421
"064276108",909,963,1872,470,364,349
"064276113",610,641,1251,340,302,278
"064276203",608,635,1243,326,279,262
"064276215",533,567,1100,315,246,236
"064276216",738,761,1499,418,343,306
"064276413",434,471,905,232,186,181
"064276414",552,573,1125,301,247,227
"065600803",528,535,1063,305,328,276
"064276509",429,449,878,234,185,180
"064276511",1094,1077,2171,556,429,418
"064276604",806,892,1698,420,361,355
"064276609",555,606,1161,302,268,255
"064276718",851,909,1760,425,339,327
"064276802",662,721,1383,360,371,336
"064276803",370,429,799,208,234,198
"064276806",634,688,1322,385,374,325
"064276907",758,729,1487,392,348,323
"064276911",396,430,826,262,253,226
"064276914",732,717,1449,380,330,305
"064276915",754,739,1493,409,371,356
"064276916",580,601,1181,307,291,271
"064277006",592,634,1226,315,246,231
"064277007",508,546,1054,269,208,202
"064277014",585,598,1183,324,321,302
"064277101",664,642,1306,397,368,354
"064277303",687,701,1388,361,299,291
"064277206",534,508,1042,273,245,230
"064277209",650,623,1273,355,296,284
"064277403",971,919,1890,433,312,302
"064277404",837,920,1757,312,190,186
"064277406",938,1044,1982,497,450,429
"064277413",570,607,1177,300,264,258
"064277507",826,851,1677,436,391,355
"064277509",663,697,1360,319,254,243
"064277511",983,979,1962,434,386,374
"064277515",759,753,1512,370,331,325
"064277516",806,794,1600,392,356,348
"064277703",909,939,1848,516,377,363
"064277704",949,1001,1950,545,494,451
"064277805",845,913,1758,453,418,402
"064277807",814,807,1621,427,403,384
"064277902",523,519,1042,295,268,254
"064277905",939,906,1845,490,446,434
"064277906",593,601,1194,331,306,287
"064278004",529,535,1064,290,264,256
"064278009",666,677,1343,313,256,246
"064278011",516,518,1034,247,219,203
"064278202",622,629,1251,309,278,267
"064278203",786,761,1547,380,345,331
"065601913",329,324,653,195,227,190
"064278308",715,708,1423,339,319,299
"064278313",814,886,1700,447,413,389
"064278413",1012,1011,2023,518,435,407
"064278416",790,826,1616,422,416,385
"064278417",866,903,1769,440,451,414
"064278502",1078,1029,2107,506,482,474
"064278612",568,574,1142,313,299,286
"064278707",680,645,1325,338,305,282
"064278709",560,574,1134,293,233,226
"064278712",471,491,962,297,246,233
"064278810",682,686,1368,395,366,332
"064279006",677,614,1291,347,327,309
"065151803",804,762,1566,388,398,382
"064279315",946,963,1909,486,532,443
"064279403",929,987,1916,481,437,425
"064279411",874,829,1703,454,411,386
"064279501",691,628,1319,322,297,287
"064279502",876,861,1737,425,401,373
"064279510",863,878,1741,453,441,398
"064279513",761,788,1549,385,380,345
"064279613",75,77,152,40,50,36
"065151805",687,647,1334,299,283,269
"064279616",250,249,499,143,233,119
"064279701",685,644,1329,326,332,269
"064279705",421,444,865,208,228,199
"064340105",465,534,999,362,384,331
"064340108",426,451,877,299,305,238
"064340110",435,487,922,313,352,301
"064340404",266,341,607,217,256,206
"064340504",371,464,835,327,329,291
"064340506",361,379,740,257,255,224
"064340608",510,562,1072,353,400,344
"064340609",604,600,1204,338,328,312
"064340707",1936,2133,4069,1286,1168,1009
"064340803",350,387,737,216,230,210
"064340806",868,862,1730,486,477,448
"064340911",422,429,851,228,178,171
"064340916",575,567,1142,306,197,187
"064340918",532,523,1055,274,238,232
"064341111",459,489,948,289,298,285
"064341207",596,677,1273,413,379,346
"064341402",299,305,604,218,278,215
"064341404",390,429,819,294,326,282
"064341505",307,329,636,235,286,216
"064342002",502,532,1034,337,347,320
"064342007",359,376,735,240,239,216
"064342107",288,289,577,197,217,185
"064342110",252,305,557,193,212,190
"064342205",403,442,845,260,199,185
"064342207",367,385,752,232,217,203
"064342409",397,454,851,280,296,266
"064342308",646,694,1340,358,345,329
"064342501",622,677,1299,394,407,379
"064342502",282,344,626,207,231,207
"064342601",708,681,1389,353,321,310
"064342704",442,442,884,275,247,215
"064342603",742,713,1455,438,495,332
"064342608",531,596,1127,277,213,204
"064342616",526,469,995,262,247,231
"064342617",520,573,1093,293,189,183
"064342706",482,554,1036,332,327,299
"064342803",748,782,1530,446,400,362
"064342902",545,620,1165,384,432,377
"064343112",244,280,524,238,286,235
"064342905",387,437,824,288,321,267
"064343006",445,484,929,329,369,294
"064343212",276,350,626,238,290,234
"064343302",511,550,1061,368,397,351
"064343305",403,478,881,324,368,320
"064343408",324,341,665,228,256,223
"064343409",269,316,585,208,225,197
"064343502",249,297,546,201,235,197
"064343508",739,782,1521,420,250,232
"064343602",526,610,1136,391,420,378
"064343703",316,348,664,233,257,231
"064343801",230,236,466,168,197,164
"064343902",278,349,627,223,281,221
"064343903",344,438,782,270,328,259
"064344002",485,542,1027,364,410,350
"064344007",348,358,706,228,257,220
"064344204",440,458,898,284,288,261
"064344205",382,432,814,261,236,202
"064344208",462,506,968,270,300,255
"064344411",352,407,759,257,277,249
"064410103",347,365,712,233,265,220
"064410709",207,284,491,246,317,238
"064410108",214,292,506,189,237,184
"064410109",379,418,797,305,354,287
"064410403",468,485,953,372,457,362
"064410407",328,331,659,313,409,291
"064410408",262,332,594,294,392,279
"064410702",198,222,420,191,302,183
"064410706",150,218,368,181,247,180
"064410903",211,239,450,201,230,192
"064410904",283,341,624,308,343,286
"064410912",254,254,508,284,427,276
"064411002",260,308,568,210,220,191
"064411008",259,339,598,234,255,227
"064411012",222,288,510,248,313,231
"064411101",223,334,557,195,280,191
"064411103",207,270,477,193,242,184
"064411104",207,218,425,173,261,173
"064411107",230,258,488,173,231,168
"064411108",198,216,414,192,251,177
"064411809",265,329,594,204,316,200
"064411409",185,218,403,191,299,188
"064411501",237,287,524,290,414,287
"064411503",203,255,458,228,304,223
"064411601",323,410,733,329,419,318
"064411614",324,412,736,332,370,295
"064411703",322,366,688,264,343,258
"064411801",116,178,294,160,242,159
"064411806",177,251,428,168,216,162
"064411906",275,319,594,251,307,229
"064412003",263,303,566,268,354,260
"064412010",171,206,377,178,264,173
"064412011",121,140,261,140,191,133
"064412101",207,263,470,193,241,192
"064412112",236,258,494,204,271,203
"064412113",385,445,830,352,472,344
"064412209",325,363,688,254,325,243
"064412305",283,310,593,231,290,225
"064412407",206,253,459,190,251,188
"064412409",306,333,639,276,356,274
"064412510",296,377,673,274,358,271
"064412706",266,295,561,214,252,206
"064412811",380,453,833,313,420,307
"064412813",434,502,936,356,427,346
"064412905",322,320,642,234,262,228
"064412911",202,278,480,189,236,178
"064412913",404,467,871,330,385,326
"064413005",372,388,760,239,284,225
"064413007",245,264,509,194,228,187
"065952404",336,384,720,283,340,281
"064413112",384,447,831,292,330,290
"064413116",317,360,677,229,236,198
"064413201",274,292,566,206,232,199
"064413210",437,455,892,292,310,265
"064413302",214,253,467,173,201,169
"064413405",456,531,987,317,350,309
"064413415",869,951,1820,460,433,390
"064413506",342,383,725,241,259,233
"064413508",621,613,1234,366,384,355
"064413607",422,478,900,271,278,258
"064413610",563,600,1163,372,392,356
"064413702",688,700,1388,369,383,348
"064413710",696,740,1436,420,451,404
"064413808",387,373,760,208,245,198
"064413901",386,439,825,308,337,303
"064413909",430,462,892,271,275,251
"064414001",450,454,904,276,305,265
"064414103",677,664,1341,357,357,343
"064414104",697,709,1406,418,440,395
"064414210",883,888,1771,469,498,444
"064414216",1479,768,2247,364,366,333
"064414311",413,418,831,228,237,210
"064414402",400,431,831,251,276,239
"064414501",385,379,764,230,257,217
"064414505",465,467,932,250,261,242
"064414506",553,528,1081,313,354,296
"064414508",550,547,1097,305,333,284
"064414509",688,667,1355,356,381,330
"064414608",517,547,1064,326,340,315
"064414802",277,323,600,174,181,166
"064414902",333,399,732,274,303,242
"064414904",272,287,559,216,246,207
"064415005",253,291,544,199,227,194
"064415109",256,317,573,215,240,207
"064415112",230,294,524,177,210,170
"064415205",474,504,978,274,260,243
"064415207",480,502,982,321,328,309
"064415303",252,297,549,191,205,182
"064415309",569,570,1139,369,399,354
"064415310",832,798,1630,391,388,359
"064415402",473,492,965,264,286,256
"064415406",205,230,435,154,174,153
"064415413",201,206,407,126,171,123
"064415606",567,627,1194,389,454,382
"064415701",55,51,106,41,48,38
"064415805",219,254,473,168,201,162
"064415901",314,363,677,228,242,219
"064415910",570,621,1191,385,411,361
"064416101",276,342,618,252,314,252
"064416103",344,385,729,227,248,218
"064416209",305,321,626,197,222,185
"066232002",721,754,1475,400,442,394
"064416307",343,375,718,225,306,216
"064416514",372,336,708,206,332,199
"064416502",321,312,633,179,209,177
"064416506",201,185,386,98,80,45
"064416601",419,423,842,238,278,229
"064416607",650,662,1312,390,434,370
"064416901",652,631,1283,344,349,326
"064416907",424,416,840,227,261,211
"064417004",870,877,1747,457,441,411
"064900807",210,249,459,193,224,191
"064550106",415,465,880,288,296,269
"064550110",325,419,744,271,345,266
"064550114",367,368,735,257,290,209
"065151904",860,824,1684,416,384,363
"066380909",710,778,1488,376,342,327
"064551401",544,579,1123,320,301,271
"064551412",447,505,952,355,403,350
"064620703",502,569,1071,398,452,391
"064620706",646,683,1329,446,504,439
"064690106",376,451,827,367,420,342
"064690108",386,501,887,355,427,347
"064690114",384,398,782,262,296,250
"064690203",505,513,1018,321,354,315
"064690207",382,442,824,319,402,313
"064690212",461,417,878,264,279,247
"064690401",275,266,541,201,234,196
"066381711",210,260,470,189,348,188
"064690601",399,415,814,255,277,240
"064690801",393,374,767,228,276,226
"064691301",330,363,693,265,304,264
"064761407",193,215,408,148,189,144
"064830410",294,283,577,183,203,174
"064830412",405,462,867,271,308,259
"064830414",408,445,853,269,296,264
"066480502",810,822,1632,400,391,365
"064830702",62,66,128,50,77,50
"064830801",136,165,301,106,121,106
"064900102",545,534,1079,306,318,302
"064900104",439,440,879,231,234,223
"064900413",496,537,1033,283,239,217
"064900502",656,649,1305,379,333,310
"064900507",438,464,902,285,257,242
"064900513",378,362,740,209,212,189
"064900603",335,386,721,250,266,244
"064900607",514,539,1053,332,374,316
"064900702",464,479,943,274,236,218
"064900707",554,595,1149,293,282,269
"064900709",342,372,714,218,174,165
"064900711",357,389,746,211,186,179
"064900902",400,428,828,295,321,269
"064900904",272,290,562,182,161,144
"064900907",382,401,783,251,290,246
"064901002",515,576,1091,388,433,365
"064901209",424,470,894,314,340,297
"064901307",305,366,671,243,226,212
"064901312",474,535,1009,315,292,280
"064901315",707,792,1499,456,433,412
"064901503",414,452,866,245,188,179
"064901602",307,337,644,198,212,189
"064901605",572,593,1165,356,366,262
"064901606",424,426,850,257,211,203
"064901708",749,745,1494,428,376,359
"064901807",548,603,1151,332,314,300
"064901808",498,570,1068,352,337,313
"064901813",700,722,1422,442,453,432
"064901816",505,527,1032,299,271,248
"064901903",345,361,706,245,277,239
"064902002",409,441,850,283,301,264
"064902005",387,426,813,294,321,276
"064902104",337,394,731,247,261,232
"064902206",207,264,471,268,438,267
"064902304",344,418,762,266,268,234
"064902305",456,474,930,265,312,264
"064902311",195,254,449,198,278,194
"064902313",181,213,394,175,248,173
"064902603",444,489,933,326,355,322
"064902613",418,439,857,309,356,298
"064902701",414,451,865,301,318,279
"064902705",644,692,1336,422,414,382
"064902707",422,472,894,311,349,306
"064902801",487,496,983,297,269,250
"064902804",700,738,1438,444,450,420
"064902906",829,829,1658,378,304,280
"064903007",437,516,953,303,310,296
"064903202",856,848,1704,432,337,324
"064903209",428,461,889,238,238,227
"064903210",566,609,1175,338,317,292
"064903410",677,683,1360,353,283,274
"064903509",467,499,966,265,215,203
"064903510",607,599,1206,288,235,228
"064903609",522,512,1034,300,222,214
"064903612",592,636,1228,317,214,204
"064903701",664,620,1284,367,325,296
"064903702",514,509,1023,294,181,162
"064903802",642,692,1334,363,292,284
"064903813",384,400,784,219,167,161
"064903816",944,965,1909,516,416,392
"064904002",498,503,1001,250,192,190
"064904101",29,11,40,27,27,27
"064904202",480,484,964,351,377,333
"064904203",412,484,896,280,276,239
"064904407",502,540,1042,361,397,347
"064904304",514,574,1088,342,373,331
"064904411",402,418,820,224,211,195
"064904502",544,588,1132,373,373,337
"064904601",361,449,810,297,338,292
"064904611",505,594,1099,356,374,341
"064904701",196,265,461,71,68,66
"064904706",289,398,687,246,285,234
"065391205",562,603,1165,314,318,296
"065391207",552,570,1122,318,332,311
"065391208",710,752,1462,378,406,370
"065391407",819,950,1769,499,463,436
"060840303",18,17,35,13,28,12
"060840804",8,8,16,6,24,6
"060070104",1,1,2,1,2,1
"060070203",21,18,39,12,14,12
"060070204",7,9,16,4,17,4
"060070208",6,3,9,4,10,4
"060070302",13,7,20,7,16,7
"067561305",493,539,1032,348,385,341
"065391510",275,310,585,212,232,206
"060070306",37,27,64,19,23,19
"060070411",7,7,14,3,8,3
"060070504",12,11,23,10,12,10
"060070508",3,3,6,2,9,2
"060070603",12,5,17,10,22,10
"060070606",21,15,36,14,21,14
"060070613",10,8,18,8,13,8
"060070906",6,8,14,5,6,5
"065391607",527,611,1138,409,445,400
"060071007",9,6,15,6,10,6
"060071009",7,9,16,6,28,4
"061820707",0,0,0,0,1,0
"060210802",5,6,11,6,15,6
"060210803",22,19,41,16,30,16
"060210904",19,16,35,17,26,17
"060211003",11,14,25,8,17,8
"061961205",17,18,35,14,17,11
"060282012",381,345,726,195,233,166
"062030903",3,0,3,2,11,2
"062240905",16,12,28,10,15,10
"062241902",16,12,28,9,15,8
"062310405",13,10,23,7,16,7
"060421401",93,74,167,69,109,66
"060490901",58,33,91,31,61,29
"060491009",84,78,162,57,67,57
"060491402",30,21,51,21,36,21
"060491601",52,45,97,32,61,30
"060562701",136,63,199,46,74,46
"060563001",69,63,132,43,73,43
"065600718",586,535,1121,326,339,301
"060563212",21,1,22,22,5,5
"060630304",32,19,51,17,35,17
"060630404",65,34,99,40,77,40
"060630501",13,19,32,8,10,8
"060630603",42,30,72,25,46,25
"060630904",8,6,14,7,24,7
"060631202",22,22,44,17,37,16
"060700802",10,10,20,8,16,8
"060700902",4,6,10,5,15,5
"065391706",488,512,1000,282,268,255
"060770405",25,23,48,17,23,17
"060770508",39,20,59,22,29,22
"060771301",NA,NA,NA,NA,NA,NA
"060840103",48,32,80,32,51,32
"060840304",27,21,48,17,35,17
"060840402",68,30,98,30,48,27
"060840604",15,13,28,10,22,10
"060840802",25,13,38,12,22,12
"067561508",267,287,554,202,234,201
"065391807",781,790,1571,414,415,397
"061050301",164,126,290,101,157,101
"065391901",526,549,1075,329,317,306
"061050602",57,36,93,37,78,36
"061050701",65,54,119,44,74,44
"061050804",6,10,16,4,7,4
"061120708",7,17,24,6,20,6
"061120902",5,3,8,2,6,2
"061120906",44,38,82,27,34,27
"061121105",0,0,0,0,2,0
"061190205",73,45,118,38,63,31
"065391904",482,518,1000,292,305,280
"061190705",27,33,60,17,70,17
"061190706",15,9,24,7,14,7
"061260405",41,41,82,28,33,28
"061260912",1,1,2,1,2,1
"065391906",503,507,1010,259,257,241
"065391907",521,555,1076,315,282,262
"061340702",29,25,54,18,38,18
"061340405",23,13,36,12,20,12
"061340804",17,19,36,13,26,11
"061400101",66,53,119,36,35,35
"061400312",31,24,55,18,36,18
"061400403",38,30,68,30,29,29
"061470203",73,65,138,43,54,43
"061470304",17,13,30,16,32,16
"061470604",8,4,12,4,4,4
"061470706",3,0,3,2,14,2
"061540104",21,14,35,13,33,13
"061471103",17,17,34,13,19,13
"061540204",41,39,80,23,34,23
"061540804",25,17,42,16,20,16
"061610204",37,21,58,17,20,10
"061610401",37,33,70,26,34,26
"061610502",12,15,27,7,11,7
"061610803",4,2,6,2,7,2
"061610804",21,24,45,14,20,14
"061680403",14,11,25,8,11,8
"061681002",17,16,33,9,10,9
"061750302",12,6,18,5,9,5
"061750501",39,31,70,21,45,21
"061820701",23,20,43,14,37,14
"061820801",37,26,63,26,51,23
"061820903",37,22,59,15,17,13
"061890206",8,4,12,6,15,6
"061890303",16,7,23,7,18,7
"061890403",13,6,19,8,15,8
"065392102",355,406,761,235,253,228
"061890505",9,3,12,4,17,4
"061890606",2,1,3,1,6,1
"061890607",6,5,11,4,9,4
"061890706",3,2,5,2,13,2
"061891101",5,7,12,4,14,4
"061891206",11,7,18,7,25,7
"061891504",32,24,56,24,53,24
"061891507",6,3,9,5,35,5
"061960305",8,2,10,7,12,7
"061960504",8,2,10,4,15,4
"061960703",4,1,5,3,14,3
"061960706",5,4,9,3,4,3
"061960802",16,4,20,13,25,13
"061960804",16,19,35,13,24,13
"061961108",8,12,20,7,15,7
"061961301",9,3,12,3,9,3
"062030207",43,33,76,36,77,36
"062030209",12,9,21,9,34,8
"062030506",10,8,18,7,15,7
"062030701",3,3,6,2,13,2
"062030704",10,6,16,5,15,5
"062030708",2,2,4,2,7,2
"062031004",11,5,16,6,18,6
"062100401",102,59,161,52,94,52
"062100811",154,136,290,87,122,84
"062170201",54,39,93,30,75,29
"062170304",58,45,103,37,84,37
"065392314",666,623,1289,332,291,270
"062170702",20,8,28,12,22,11
"065392402",486,513,999,283,292,277
"062171005",28,18,46,18,32,18
"064060103",24,17,41,16,11,11
"062240602",53,36,89,29,33,29
"062240801",16,17,33,10,26,9
"062241203",32,28,60,22,48,22
"062310105",39,34,73,22,36,22
"062310201",28,22,50,22,40,22
"062310403",12,7,19,9,17,9
"062310707",7,4,11,4,26,4
"062311004",2,0,2,1,9,1
"062380607",70,48,118,43,74,42
"065392613",403,402,805,204,206,196
"065600906",205,190,395,104,105,88
"064132001",NA,NA,NA,NA,NA,NA
"062660102",103,83,186,70,123,65
"062660103",45,59,104,31,60,31
"062660402",17,9,26,5,9,5
"062940504",6,3,9,4,14,4
"062770104",41,30,71,22,34,22
"062800804",6,9,15,5,10,5
"062800810",10,8,18,9,16,9
"062800817",16,14,30,10,21,10
"062870601",127,96,223,66,108,66
"062940208",1,1,2,1,11,1
"065392703",777,795,1572,396,411,375
"062940814",14,8,22,7,26,7
"063150401",117,76,193,84,163,83
"063220305",32,13,45,13,14,13
"063220401",12,6,18,6,8,6
"063220403",15,6,21,10,10,10
"063220902",18,17,35,10,27,10
"063220802",16,9,25,8,13,7
"063290104",27,30,57,23,31,22
"063430401",41,43,84,27,56,25
"065392805",727,695,1422,362,342,330
"063430303",26,23,49,19,36,19
"063430802",35,21,56,18,31,18
"063510402",19,18,37,13,26,13
"063510502",15,9,24,6,9,6
"063510614",22,11,33,11,28,11
"065392812",513,532,1045,294,301,284
"063577801",23,17,40,12,23,12
"063578206",389,335,724,217,272,195
"063640502",338,265,603,24,29,18
"064830805",29,23,52,16,35,16
"063850104",1,1,2,1,11,1
"063850501",12,6,18,7,28,7
"063850601",24,30,54,19,42,19
"063920203",22,10,32,14,18,14
"063920204",12,4,16,6,7,6
"063920504",18,6,24,9,26,8
"063920505",1,1,2,1,11,1
"063920709",47,39,86,23,36,23
"063921302",46,34,80,26,62,25
"063921404",16,13,29,10,21,10
"063990701",14,10,24,11,29,11
"064060105",12,11,23,9,22,9
"064060307",11,12,23,5,16,5
"064060309",9,6,15,6,9,6
"064130701",NA,NA,NA,NA,NA,NA
"064131805",5,7,12,4,7,2
"064131901",23,29,52,15,39,14
"064132003",NA,NA,NA,NA,NA,NA
"065881004",8,7,15,5,20,5
"066232702",5,3,8,4,15,4
"064417101",76,55,131,47,65,45
"064480802",13,12,25,8,12,8
"064620301",10,10,20,9,29,9
"064620901",22,15,37,13,23,13
"064620405",53,43,96,36,60,36
"064620710",57,63,120,40,51,38
"064690404",27,22,49,14,32,14
"064690501",19,16,35,11,19,11
"064691107",50,30,80,29,55,24
"064760902",29,19,48,16,45,16
"064761002",16,13,29,10,19,8
"064761104",11,11,22,8,23,8
"064830907",42,44,86,27,56,27
"064970207",92,76,168,47,94,47
"064971311",9,6,15,4,15,4
"065050101",39,35,74,27,30,19
"065050102",64,57,121,36,47,33
"065050209",61,45,106,34,49,34
"066720701",50,49,99,34,54,32
"065050406",66,62,128,38,53,33
"067001201",13,4,17,8,19,8
"065180105",7,5,12,7,16,7
"065180106",3,3,6,3,8,3
"065180108",9,5,14,6,15,6
"065180109",17,8,25,9,12,9
"065180305",47,34,81,28,49,27
"065180402",30,24,54,20,44,20
"067140302",13,12,25,8,30,8
"065180405",21,16,37,14,31,14
"065180410",10,7,17,6,8,6
"065180805",4,2,6,4,4,4
"065180811",20,18,38,15,15,15
"065250301",71,44,115,35,43,33
"065250412",153,132,285,80,105,78
"065250503",36,26,62,19,28,19
"065320504",64,54,118,49,61,49
"065321002",29,24,53,21,27,21
"067701306",16,16,32,8,14,8
"067701701",10,8,18,6,7,6
"067910603",37,22,59,23,31,23
"065740503",70,53,123,41,55,41
"065810906",11,14,25,8,11,8
"065810703",41,39,80,25,34,24
"065392909",269,244,513,132,147,129
"065601005",679,738,1417,395,410,383
"065601008",632,632,1264,363,391,348
"065601013",535,589,1124,345,358,323
"065601103",424,409,833,238,241,230
"065392910",82,85,167,39,46,37
"065392911",397,388,785,191,201,180
"065392924",828,836,1664,478,409,388
"065810805",32,22,54,17,45,17
"065810806",22,21,43,15,25,14
"065810902",13,8,21,10,23,10
"065810909",5,3,8,3,5,3
"065393004",749,750,1499,404,421,388
"065811005",16,8,24,9,13,9
"065811103",23,10,33,16,29,16
"065811203",21,16,37,15,31,14
"065880308",21,18,39,17,27,17
"065880309",84,64,148,42,69,39
"065881006",27,22,49,19,55,19
"066091801",19,23,42,12,22,12
"065881008",25,20,45,20,40,20
"065881304",38,20,58,23,60,23
"065950501",90,54,144,60,102,59
"066020205",65,38,103,38,68,38
"066020903",15,7,22,11,39,11
"065393014",923,1002,1925,502,419,374
"068331708",20,17,37,16,26,16
"066090302",6,4,10,4,18,4
"066090402",19,20,39,10,18,10
"066090611",23,18,41,15,31,12
"066090612",2,2,4,2,11,2
"066090702",6,7,13,4,15,4
"066090901",31,31,62,24,57,23
"066090906",24,14,38,17,35,17
"066091401",22,16,38,13,17,13
"066091704",17,21,38,13,26,13
"066160107",67,60,127,40,82,39
"066160201",11,13,24,10,30,10
"066160202",10,7,17,8,14,3
"066230705",14,8,22,9,23,9
"066231604",27,22,49,22,38,22
"066232106",138,138,276,71,77,67
"066232212",27,33,60,18,31,17
"066232704",11,12,23,9,26,9
"066232601",37,32,69,25,42,25
"066510103",41,24,65,27,46,27
"066510304",13,7,20,7,28,7
"066510405",6,7,13,6,15,6
"066510709",4,2,6,3,14,3
"066510809",11,7,18,8,8,8
"066510810",14,16,30,11,19,10
"066510815",6,6,12,5,13,5
"066511102",7,2,9,7,23,7
"066511306",22,18,40,15,25,15
"065681813",348,402,750,255,291,247
"066550208",38,27,65,25,64,25
"066650105",114,82,196,66,123,66
"066650301",27,20,47,18,22,18
"066651101",42,29,71,21,45,21
"066651301",17,6,23,9,11,8
"066721001",27,19,46,18,39,17
"066790503",18,13,31,10,24,10
"065393204",646,616,1262,309,278,254
"066721403",104,80,184,62,86,60
"066790103",26,24,50,17,21,17
"066860401",4,3,7,4,14,4
"066860704",2,3,5,1,6,1
"066861003",21,26,47,15,23,15
"066930502",36,39,75,20,36,20
"066930702",27,25,52,16,33,16
"067000105",13,7,20,6,15,6
"067000303",6,4,10,6,14,6
"067000804",11,8,19,7,13,7
"067000805",7,0,7,6,16,6
"067070504",71,61,132,44,79,44
"067140207",25,11,36,12,16,12
"067140306",3,5,8,4,18,4
"067140906",19,16,35,11,16,11
"067210213",22,14,36,13,26,13
"067280303",47,34,81,27,41,27
"067280402",7,8,15,5,11,5
"067280803",27,21,48,18,28,18
"067281302",45,38,83,33,63,32
"067281501",101,64,165,50,64,48
"067350305",50,37,87,22,44,21
"067350306",85,57,142,39,118,38
"067350503",24,16,40,14,26,14
"065393403",688,672,1360,334,332,303
"065393404",657,633,1290,329,311,294
"067491509",189,155,344,107,256,100
"067491513",136,105,241,75,116,70
"067700905",7,4,11,5,8,5
"067631901",26,16,42,12,19,12
"067700601",5,3,8,3,10,3
"067700704",10,4,14,5,6,5
"067701102",21,24,45,14,21,13
"067701206",16,12,28,6,13,6
"067701304",43,31,74,20,20,20
"067701607",18,14,32,9,10,9
"067701803",14,12,26,7,8,7
"067841202",16,12,28,10,17,10
"067780504",47,32,79,29,32,29
"067780701",23,16,39,15,19,15
"067840303",11,13,24,4,15,4
"067840403",11,5,16,5,12,5
"067840703",15,14,29,8,12,8
"067840812",28,21,49,15,27,15
"067841001",20,15,35,9,9,9
"067910901",63,44,107,35,54,35
"067911103",34,31,65,23,36,22
"067980103",25,18,43,19,19,19
"067980202",13,3,16,7,12,7
"067980401",13,11,24,8,28,8
"067980506",19,16,35,14,27,14
"067980801",20,10,30,14,26,14
"065530313",55,48,103,40,363,39
"065810507",86,86,172,94,458,94
"065470905",610,679,1289,428,471,414
"065470906",460,541,1001,359,418,345
"065530202",41,32,73,34,297,34
"065600112",582,576,1158,312,314,296
"065600202",813,806,1619,429,417,394
"065600211",1729,1682,3411,929,997,900
"065601206",401,488,889,286,273,250
"065601208",438,479,917,267,255,235
"065600301",2236,2176,4412,1080,972,920
"065601213",475,526,1001,304,275,251
"065600310",723,726,1449,382,387,360
"065600412",536,559,1095,301,302,276
"065600414",425,480,905,278,297,264
"065600418",463,457,920,282,277,277
"065600515",487,549,1036,282,300,262
"065600605",1309,1279,2588,694,680,646
"065601305",743,731,1474,375,353,336
"065600705",669,690,1359,368,361,353
"065600708",206,190,396,97,91,86
"067631703",428,452,880,278,295,267
"065601311",866,888,1754,483,462,434
"065250110",318,382,700,258,289,253
"065250103",236,233,469,130,138,124
"065250109",510,516,1026,348,389,337
"065250114",472,520,992,256,305,247
"065250304",519,502,1021,254,283,245
"065250407",526,522,1048,281,291,260
"065250609",549,548,1097,271,285,263
"065250607",869,901,1770,549,606,534
"065250612",533,581,1114,305,330,293
"065320106",370,463,833,321,348,306
"065320108",295,380,675,270,375,261
"065320111",457,513,970,336,357,326
"065320112",421,491,912,312,362,302
"065320205",236,307,543,205,234,199
"067490512",186,248,434,200,265,198
"065320311",429,436,865,263,276,250
"065321408",339,405,744,278,336,274
"065321503",426,452,878,281,280,241
"065321505",579,584,1163,311,313,287
"065390106",793,833,1626,428,362,337
"065390205",430,436,866,268,263,246
"065390209",298,313,611,211,230,199
"065390210",354,394,748,240,251,219
"065390213",385,392,777,264,269,255
"065390501",400,431,831,279,292,272
"065390408",500,563,1063,385,406,375
"065390502",599,653,1252,413,443,393
"065390803",605,670,1275,377,377,359
"065390901",79,51,130,23,16,14
"065390907",1025,1142,2167,571,518,493
"065391009",887,879,1766,439,415,385
"067560807",432,456,888,305,341,301
"065391106",456,455,911,242,247,220
"065391107",896,937,1833,512,524,486
"065391201",651,689,1340,346,334,317
"064343204",136,183,319,151,275,150
"064412603",238,292,530,234,291,227
"062311005",124,107,231,56,72,56
"060070702",356,336,692,213,253,207
"060210207",20,14,34,11,20,11
"060700305",813,758,1571,456,484,433
"060421103",500,477,977,299,378,293
"060563202",351,289,640,226,410,222
"060630302",237,233,470,162,215,157
"060980402",304,285,589,144,171,139
"061190103",19,16,35,12,25,10
"061260906",1396,155,1551,86,147,83
"061340206",371,313,684,198,222,194
"061820706",202,218,420,119,131,116
"061891307",11,2,13,11,16,11
"062241403",73,77,150,51,86,51
"062601701",838,796,1634,515,535,457
"062770202",178,141,319,99,144,97
"062700805",80,76,156,46,108,45
"062940209",17,15,32,11,19,11
"062800609",64,57,121,41,103,40
"063080502",129,118,247,85,152,85
"063578203",393,341,734,227,331,225
"063920902",136,122,258,77,97,77
"063640414",74,68,142,47,51,47
"063640801",240,227,467,141,240,138
"063640603",40,37,77,24,83,24
"064131301",203,175,378,118,147,117
"064416703",163,152,315,87,221,87
"064416814",353,356,709,186,226,176
"064480609",360,402,762,230,278,227
"064620201",55,46,101,33,46,33
"064690903",185,182,367,114,153,113
"064691106",265,267,532,186,240,183
"064970403",169,148,317,110,131,109
"067281402",297,272,569,158,176,155
"065320403",149,125,274,91,117,88
"065320903",196,212,408,122,162,119
"065392907",263,246,509,142,172,140
"065392914",488,481,969,241,241,212
"065811105",45,41,86,27,49,27
"065880911",747,749,1496,375,468,362
"068190101",101,104,205,71,89,71
"065952301",148,110,258,97,163,96
"066090404",70,53,123,44,85,44
"066381301",568,597,1165,350,461,341
"066382307",98,79,177,59,74,59
"066480407",73,59,132,37,59,35
"066510104",307,352,659,204,250,200
"066861002",65,53,118,36,37,31
"067000107",16,16,32,12,16,11
"067421001",27,19,46,16,170,16
"067630701",44,32,76,25,24,24
"068751604",532,447,979,272,415,268
"067631812",278,251,529,162,188,158
"067701203",249,244,493,136,151,130
"067780403",91,99,190,61,119,60
"068540201",691,682,1373,390,454,380
"068751605",577,542,1119,387,584,356
"065681402",375,490,865,304,361,298
"065681507",466,535,1001,353,362,330
"065681707",543,554,1097,371,431,364
"065681710",389,415,804,292,340,291
"065681802",136,177,313,166,302,165
"065681907",537,529,1066,347,368,335
"065682003",307,403,710,314,414,313
"065682013",342,405,747,261,281,246
"065682201",267,261,528,184,226,182
"065682203",196,204,400,141,204,140
"065682306",493,542,1035,370,404,339
"065682307",477,549,1026,376,370,331
"068050203",704,654,1358,368,383,354
"065682409",346,396,742,236,233,213
"065682504",582,641,1223,403,423,386
"065682710",405,445,850,278,300,260
"065682905",440,473,913,263,256,242
"065682906",461,451,912,273,277,260
"065682909",569,569,1138,326,319,309
"065683111",320,378,698,204,219,202
"065740404",469,503,972,297,307,285
"065740411",369,423,792,256,291,250
"065810205",192,224,416,165,269,162
"065810212",357,382,739,242,277,231
"065810304",242,294,536,203,243,196
"065810306",228,300,528,210,277,205
"065810307",276,370,646,267,352,261
"065810405",547,556,1103,371,409,360
"065810701",323,316,639,184,232,183
"065811706",338,343,681,234,272,210
"068052108",572,573,1145,312,315,305
"065811303",499,578,1077,286,303,280
"065811310",323,310,633,205,286,203
"065811311",410,429,839,280,415,277
"065811402",465,480,945,275,291,265
"065811404",208,235,443,152,168,146
"065811408",489,461,950,271,286,263
"065811409",376,425,801,257,295,247
"065811411",411,410,821,222,243,213
"068052408",655,645,1300,352,385,340
"065811509",464,541,1005,329,348,319
"065811603",374,450,824,311,368,306
"065811606",585,653,1238,415,476,397
"065811701",269,271,540,203,242,196
"065811703",277,337,614,252,357,248
"065811802",98,122,220,104,178,103
"065811804",316,187,503,94,262,89
"065811906",236,252,488,129,145,122
"065811909",317,310,627,207,229,201
"065811911",296,323,619,199,230,182
"065880106",353,426,779,305,371,297
"065880110",246,337,583,210,241,192
"065880205",201,205,406,103,110,94
"065880302",260,253,513,191,227,186
"065880303",289,339,628,231,267,217
"065881002",102,117,219,77,118,76
"065881301",275,291,566,181,207,181
"065881402",226,221,447,132,191,131
"065950301",311,324,635,226,248,216
"065950312",266,321,587,256,339,252
"065950405",514,557,1071,343,384,340
"065950406",362,375,737,221,247,213
"065950410",433,459,892,276,286,266
"065950412",493,544,1037,368,413,356
"065951611",297,321,618,206,214,205
"065952102",332,327,659,215,249,208
"065952103",207,232,439,161,180,156
"065952408",670,708,1378,427,487,413
"065952411",366,418,784,222,239,220
"065952507",355,373,728,252,275,246
"065952611",603,607,1210,371,415,363
"065952613",385,378,763,234,255,227
"065952711",327,331,658,242,280,235
"066021106",379,425,804,247,291,239
"066021113",418,437,855,289,341,282
"066021601",391,379,770,196,328,192
"066021609",525,532,1057,334,366,306
"066090601",53,39,92,28,36,28
"066090610",114,110,224,58,57,55
"066090904",228,256,484,178,218,176
"067491111",491,514,1005,295,265,239
"066091007",229,225,454,140,172,138
"068400708",500,555,1055,359,384,337
"067491112",337,371,708,229,205,183
"066091904",286,346,632,251,315,246
"066091908",603,605,1208,391,439,388
"066230106",449,531,980,365,419,355
"066230404",304,367,671,259,298,255
"068401609",366,445,811,319,387,307
"068401610",288,323,611,221,228,189
"066231402",371,410,781,258,291,257
"066232501",172,186,358,118,149,114
"066380210",582,566,1148,329,325,298
"066232901",675,668,1343,378,392,365
"066232910",488,529,1017,250,236,221
"066380108",984,997,1981,489,474,437
"066380204",738,733,1471,409,403,357
"066380205",611,625,1236,352,363,336
"066380309",1499,1553,3052,826,1165,813
"066380310",435,411,846,240,311,240
"066380312",902,937,1839,536,522,470
"066380702",543,523,1066,285,284,265
"066380812",283,340,623,157,244,156
"066380816",376,385,761,192,296,188
"066380902",295,267,562,170,266,164
"066380904",368,369,737,184,197,178
"066380908",707,771,1478,373,349,337
"066381004",525,537,1062,289,268,259
"066381104",879,809,1688,452,434,403
"066381206",539,531,1070,328,419,305
"066381305",676,697,1373,391,413,364
"066381315",199,187,386,115,148,115
"066381407",768,774,1542,397,401,357
"066381705",316,363,679,244,289,240
"066381707",336,371,707,266,334,258
"066381808",655,662,1317,368,354,338
"066381902",807,768,1575,464,564,439
"066381906",239,223,462,143,252,127
"066382007",410,419,829,229,268,223
"066382208",632,642,1274,305,310,288
"066382302",522,477,999,289,237,168
"066440102",66,93,159,58,267,57
"066440108",23,18,41,20,130,20
"066440206",98,117,215,71,539,71
"066440302",267,277,544,161,219,146
"066440316",89,82,171,10,189,10
"066440315",160,156,316,18,136,18
"066440403",69,73,142,56,345,55
"066440405",79,70,149,61,394,58
"066440504",267,272,539,144,157,137
"068820212",540,506,1046,251,226,215
"066440507",287,285,572,218,314,216
"066440511",53,67,120,53,343,53
"066480105",548,649,1197,389,401,359
"066480110",883,873,1756,454,464,433
"066480115",526,526,1052,263,263,248
"066480501",474,454,928,228,240,220
"066480302",662,681,1343,363,373,339
"066480504",600,623,1223,312,319,298
"068821606",448,428,876,254,258,237
"066480406",481,465,946,245,249,227
"066510505",271,261,532,189,220,189
"066510506",388,370,758,326,392,325
"066510507",253,285,538,236,292,236
"066510509",362,385,747,314,374,310
"066510510",309,363,672,271,346,268
"066550202",340,371,711,225,260,221
"066580202",429,432,861,255,237,227
"066580203",479,502,981,249,259,230
"066580207",593,591,1184,298,243,228
"066580306",438,520,958,307,266,237
"066580501",299,372,671,224,243,217
"066580508",449,530,979,312,314,294
"066580805",314,371,685,322,464,318
"066580902",471,490,961,323,415,315
"066581009",305,376,681,261,302,258
"066581209",400,455,855,287,350,286
"066581210",372,439,811,281,371,281
"066581405",272,266,538,131,128,122
"066581406",267,265,532,135,128,123
"066581409",864,824,1688,434,427,407
"066581602",308,377,685,260,328,256
"066581605",253,312,565,209,252,206
"066581710",353,401,754,278,303,264
"066581712",371,432,803,317,358,311
"066581806",325,418,743,286,351,284
"066581812",185,207,392,148,175,138
"066581903",258,281,539,201,236,195
"066582006",536,530,1066,254,201,188
"066582101",784,866,1650,492,502,448
"066582103",832,854,1686,495,512,468
"066582111",775,800,1575,451,475,444
"066582115",605,608,1213,296,291,271
"066582201",448,485,933,328,371,325
"066582203",427,479,906,314,364,307
"066582204",330,394,724,266,292,261
"066582209",754,835,1589,456,480,446
"066582402",467,502,969,345,366,331
"066582404",373,413,786,284,320,271
"066582406",519,547,1066,358,388,347
"066582412",321,339,660,237,265,234
"066582506",367,446,813,304,330,291
"066582603",488,537,1025,341,358,327
"066582607",345,429,774,278,301,271
"066582705",232,239,471,120,117,112
"066582710",513,563,1076,288,232,218
"066582808",724,743,1467,431,372,338
"066582910",722,733,1455,378,343,328
"066583008",767,722,1489,389,395,367
"066583012",465,508,973,275,259,245
"066583101",355,468,823,310,330,295
"066583201",352,397,749,241,242,237
"066583205",419,472,891,274,259,246
"066583402",560,574,1134,319,282,274
"066583407",429,479,908,309,322,304
"066583602",1043,1042,2085,535,502,476
"066583604",381,394,775,249,260,238
"066583705",388,377,765,206,301,186
"066583708",788,821,1609,398,398,393
"066583709",554,552,1106,310,299,286
"066583803",472,475,947,251,231,228
"066583812",538,610,1148,355,297,285
"067491410",526,547,1073,277,278,265
"066584006",271,268,539,143,134,131
"066584015",1048,1069,2117,551,498,485
"066584101",567,580,1147,330,279,262
"066584109",840,872,1712,468,460,427
"066584111",490,490,980,253,244,233
"066584112",615,566,1181,313,321,303
"066584203",700,687,1387,401,357,327
"066584212",664,758,1422,404,481,375
"066584307",517,525,1042,247,200,187
"066584308",833,880,1713,470,465,444
"066650202",381,439,820,304,341,299
"066650305",232,242,474,153,152,142
"066651310",453,488,941,311,340,303
"066790610",409,412,821,291,338,290
"066790901",252,255,507,163,195,162
"066860609",330,294,624,189,221,185
"066861304",463,492,955,262,286,258
"066861305",534,501,1035,274,290,255
"066861311",297,358,655,268,319,262
"067000102",257,242,499,174,222,174
"067000208",199,257,456,191,237,188
"067000209",416,512,928,361,458,356
"067000211",334,366,700,237,283,235
"067000215",485,519,1004,315,344,305
"067000216",471,473,944,290,303,279
"067071108",368,464,832,302,369,295
"067071102",562,549,1111,342,400,335
"067140102",465,549,1014,359,420,354
"067140106",398,408,806,306,350,304
"067140108",378,458,836,316,453,312
"067140111",294,328,622,228,269,225
"067140608",467,463,930,264,277,257
"067140612",444,467,911,283,310,276
"067210215",357,343,700,236,287,233
"067210216",263,273,536,220,262,217
"067281004",238,242,480,170,188,156
"067281012",205,213,418,164,189,160
"067281024",505,476,981,263,276,249
"067490302",161,204,365,143,195,141
"067350101",268,231,499,153,178,152
"067350705",563,588,1151,370,367,350
"067420404",317,361,678,259,286,244
"067420406",252,273,525,185,221,183
"067490105",244,258,502,147,134,129
"067490201",274,302,576,198,218,196
"067490203",452,567,1019,341,364,339
"067490503",341,373,714,291,395,287
"067490912",680,705,1385,434,419,382
"067491003",630,664,1294,411,401,365
"067491011",571,671,1242,384,357,329
"067491103",539,588,1127,276,253,242
"067491109",257,245,502,154,167,141
"067491211",741,718,1459,394,395,380
"067491306",880,916,1796,442,430,421
"067491312",474,487,961,278,300,272
"067491314",501,519,1020,295,280,269
"067491315",391,405,796,230,249,229
"067491320",515,537,1052,255,157,157
"067491412",627,656,1283,397,383,363
"067491419",854,867,1721,387,348,343
"067560506",352,377,729,238,335,237
"067560102",279,293,572,172,189,159
"067560115",258,296,554,214,216,185
"067560204",460,525,985,278,287,255
"067560308",235,315,550,268,440,266
"067560310",282,378,660,328,467,328
"067560402",399,465,864,290,354,276
"067560404",393,472,865,288,381,284
"067560501",397,462,859,263,332,260
"067560601",410,522,932,375,452,371
"067560602",230,290,520,257,343,253
"067560611",252,330,582,220,239,189
"067560704",390,444,834,313,390,312
"067560805",484,544,1028,370,420,360
"067560901",289,317,606,204,255,197
"067560905",532,577,1109,380,429,374
"067560906",529,596,1125,405,466,398
"067560913",416,487,903,292,289,249
"067561002",242,318,560,192,270,192
"067561104",295,369,664,276,353,273
"067561309",619,636,1255,363,356,350
"067561407",515,630,1145,402,429,386
"067561410",1113,1121,2234,556,495,487
"067561414",562,545,1107,281,270,265
"067561503",535,591,1126,315,339,312
"067561504",744,757,1501,449,489,440
"067561602",331,368,699,257,284,255
"067561804",520,544,1064,357,382,340
"067561806",330,377,707,244,267,229
"067561903",381,405,786,261,279,258
"067562002",418,476,894,322,352,296
"067562003",569,643,1212,390,378,362
"067562102",660,685,1345,365,266,249
"067562103",433,487,920,245,232,213
"067562202",536,619,1155,348,354,333
"067630107",221,283,504,210,313,209
"067562107",357,343,700,171,193,165
"067562209",427,453,880,279,302,259
"067562212",293,317,610,203,222,200
"067562213",306,304,610,190,207,184
"067562303",432,444,876,250,257,234
"067562309",669,667,1336,385,362,325
"067562402",253,300,553,195,182,158
"067562506",303,350,653,221,229,208
"067562511",578,584,1162,280,215,210
"067562513",443,484,927,305,330,288
"067562515",452,483,935,340,361,329
"067562605",314,363,677,244,240,215
"067562608",603,615,1218,382,400,359
"067562702",790,865,1655,459,442,424
"067562712",654,701,1355,406,369,359
"067600102",547,603,1150,324,287,259
"067600107",776,767,1543,472,449,429
"067600114",696,793,1489,453,442,405
"067600208",172,203,375,135,172,134
"067600303",441,486,927,318,303,280
"067600314",306,334,640,317,498,316
"067600504",384,494,878,242,261,228
"067600508",850,882,1732,532,555,480
"067600602",553,607,1160,383,407,359
"067600603",427,461,888,285,314,277
"067600610",845,763,1608,415,399,387
"067600710",785,845,1630,489,522,463
"067600810",505,579,1084,339,353,306
"067600909",338,365,703,229,290,225
"067600912",670,767,1437,447,485,423
"067601002",472,478,950,262,267,254
"067601007",157,166,323,96,98,92
"067601102",504,554,1058,298,272,252
"067601113",375,405,780,238,240,221
"067601115",311,331,642,180,185,161
"067601203",206,176,382,102,115,99
"067601209",455,384,839,216,249,206
"067601306",911,870,1781,429,362,334
"067601310",843,858,1701,443,412,395
"067601311",643,695,1338,378,347,322
"067601401",446,434,880,234,238,217
"067601407",1058,1046,2104,572,332,311
"067601502",378,447,825,237,264,229
"067601512",596,629,1225,358,377,335
"067601514",439,450,889,250,242,220
"067601613",589,631,1220,338,346,321
"067601701",800,843,1643,438,349,332
"067601708",770,802,1572,400,396,356
"067601712",591,593,1184,297,274,263
"067601807",552,589,1141,304,271,260
"067601808",789,795,1584,398,364,346
"067630103",579,596,1175,384,401,361
"067630104",492,543,1035,362,401,350
"067630110",386,483,869,307,315,286
"067630204",474,515,989,310,330,300
"067630302",463,500,963,355,440,350
"067630304",316,424,740,341,432,336
"067630308",433,472,905,366,449,363
"067630311",346,413,759,285,315,276
"067630610",542,541,1083,298,273,257
"067630804",717,752,1469,410,415,394
"067631602",319,349,668,246,274,243
"067631707",758,798,1556,457,447,414
"067631708",387,399,786,241,249,229
"067631804",403,389,792,237,248,222
"067631911",267,286,553,189,215,185
"067701003",441,474,915,273,288,254
"067701004",382,377,759,222,267,212
"067701010",441,449,890,298,319,284
"067701012",172,168,340,119,131,115
"067701014",68,51,119,31,34,29
"067701603",339,356,695,244,314,244
"067701801",271,257,528,170,211,168
"067702103",308,341,649,254,350,244
"067780202",294,292,586,150,167,149
"067780204",548,506,1054,267,292,257
"067780904",240,231,471,133,161,126
"067781008",727,743,1470,387,390,365
"067910215",359,402,761,298,370,289
"067840803",462,454,916,278,316,266
"067840805",397,406,803,250,281,244
"067840808",531,560,1091,388,423,376
"067840809",410,422,832,265,307,261
"067910110",309,380,689,344,411,331
"067910304",512,587,1099,395,451,383
"067910402",252,299,551,254,340,253
"067911805",246,298,544,192,208,188
"067911202",613,592,1205,352,379,346
"067911204",430,446,876,291,317,287
"067911205",330,369,699,243,277,240
"067911209",459,538,997,376,414,372
"067911304",510,527,1037,317,316,297
"067911306",806,820,1626,531,565,517
"067911806",278,286,564,236,260,229
"067911312",415,439,854,259,268,248
"067911313",467,471,938,300,294,250
"067911803",217,224,441,188,226,161
"067911807",369,412,781,287,317,283
"067911811",333,363,696,211,238,207
"067911906",301,340,641,261,331,254
"067912101",379,368,747,203,216,199
"067912104",405,428,833,231,238,222
"067912107",334,382,716,271,272,249
"067912114",206,180,386,113,124,113
"067912116",345,355,700,221,261,219
"067912205",461,454,915,286,357,279
"067912213",352,369,721,240,268,229
"067980705",256,311,567,174,229,172
"067980710",262,291,553,202,255,200
"068050302",249,232,481,149,166,132
"068050303",594,576,1170,329,323,287
"068050310",225,293,518,140,173,134
"068050404",807,867,1674,464,442,431
"068050405",975,959,1934,501,445,436
"068050409",778,848,1626,490,408,382
"068050601",1128,1109,2237,672,673,665
"068050603",535,577,1112,399,397,349
"068050605",271,309,580,208,368,201
"068050609",450,509,959,407,512,378
"068050708",34,52,86,26,372,26
"068050709",126,123,249,77,219,77
"068050810",394,414,808,214,206,188
"068050814",816,833,1649,467,416,392
"068051002",488,506,994,293,308,292
"068051103",1040,1051,2091,512,545,485
"068051908",330,376,706,226,247,217
"068051313",632,640,1272,374,381,341
"068051411",571,618,1189,343,344,327
"068051412",585,607,1192,344,296,287
"068051503",543,596,1139,381,426,373
"068051510",600,619,1219,364,368,342
"068051603",592,621,1213,347,319,301
"068051705",633,700,1333,417,452,390
"068051706",716,749,1465,447,449,415
"068051806",413,469,882,273,279,254
"068051811",618,737,1355,468,497,408
"068052012",528,532,1060,313,291,269
"068052111",662,705,1367,424,379,366
"068052112",669,642,1311,370,348,341
"068052201",857,862,1719,436,417,403
"060210611",493,484,977,331,398,323
"068052403",554,511,1065,322,384,313
"068052507",1275,1228,2503,601,626,584
"068052511",591,627,1218,359,372,330
"068052512",807,809,1616,473,454,423
"060280502",49,47,96,25,24,24
"060281603",978,1081,2059,559,571,539
"068120501",17,16,33,10,18,10
"068120503",353,327,680,217,262,212
"068190505",174,171,345,140,502,137
"068190903",227,233,460,172,408,169
"068260119",325,312,637,195,215,191
"068260214",131,144,275,109,157,108
"068260501",141,133,274,88,110,84
"068260701",645,686,1331,395,390,370
"068261606",389,391,780,238,290,232
"068330104",452,496,948,354,428,348
"068330112",553,607,1160,437,496,412
"068330204",323,422,745,305,388,296
"068330207",337,416,753,310,414,305
"068400208",362,344,706,241,279,228
"068400209",567,606,1173,350,363,317
"068331801",126,109,235,69,370,66
"068400205",488,543,1031,320,320,292
"068400102",609,614,1223,338,347,332
"068400107",835,821,1656,422,278,252
"068400110",791,809,1600,430,423,410
"068400504",409,468,877,300,305,283
"068400505",450,481,931,300,265,227
"068400510",471,474,945,302,347,287
"068400602",313,341,654,208,207,192
"068400607",412,435,847,297,335,287
"068400703",397,471,868,304,332,284
"068400804",429,505,934,291,326,286
"068400805",487,567,1054,333,371,320
"068400809",548,619,1167,388,412,346
"068400812",517,593,1110,366,410,351
"068400910",407,436,843,320,307,287
"068401006",333,403,736,328,355,321
"068401109",394,451,845,315,318,296
"068401112",425,528,953,336,347,320
"068401203",503,533,1036,366,386,351
"068401606",395,442,837,317,405,311
"068401607",290,350,640,224,245,213
"068401701",338,395,733,273,323,269
"068401802",322,394,716,285,349,264
"068401805",196,248,444,177,238,165
"068401807",472,544,1016,394,474,385
"068402001",378,437,815,293,338,288
"068402203",507,564,1071,353,343,322
"068402204",479,476,955,322,330,293
"068402601",889,865,1754,422,359,354
"068402803",333,383,716,204,208,193
"068402804",434,457,891,274,236,226
"068402903",757,819,1576,452,476,426
"068402904",428,509,937,303,263,217
"068402906",315,378,693,266,323,263
"068403004",405,452,857,304,312,272
"068403101",202,182,384,122,112,110
"068403105",468,531,999,335,348,283
"068403201",198,214,412,148,176,143
"068403207",404,461,865,308,356,299
"068403209",421,473,894,312,345,299
"068470104",538,645,1183,381,432,376
"068120402",21,16,37,10,17,10
"068540109",571,590,1161,371,418,356
"068190603",38,25,63,21,48,20
"068540115",253,267,520,165,193,160
"068540205",268,369,637,242,306,241
"068190909",73,59,132,52,79,52
"068260303",25,16,41,14,30,14
"068260503",12,9,21,8,16,8
"068260703",85,76,161,50,68,50
"068261402",22,7,29,10,12,7
"068261701",39,23,62,17,41,17
"068261703",26,23,49,15,42,12
"068330403",26,23,49,17,24,17
"068470205",14,9,23,9,36,9
"068540502",91,58,149,54,95,54
"068541102",41,29,70,26,65,26
"068541201",95,72,167,54,94,51
"068750401",84,64,148,53,64,46
"068540210",311,303,614,196,234,195
"068821201",235,201,436,134,216,133
"068821803",47,24,71,27,86,27
"068541401",199,206,405,155,203,155
"068610202",282,309,591,211,301,209
"068610212",223,305,528,234,308,227
"068610302",265,332,597,233,249,233
"068610309",137,205,342,179,236,169
"068610407",372,463,835,353,391,298
"068610504",322,384,706,264,329,264
"068610505",291,340,631,232,305,225
"068610508",473,550,1023,338,388,334
"068610509",285,380,665,325,408,322
"068610701",356,427,783,259,287,258
"068610708",313,367,680,285,348,285
"068610807",211,258,469,213,242,200
"068610809",198,230,428,164,198,162
"068610904",296,335,631,239,242,215
"068611308",311,349,660,228,258,220
"068611309",463,483,946,309,339,304
"068611402",220,284,504,232,317,232
"068611408",345,388,733,261,326,256
"068611609",503,559,1062,364,413,363
"068611703",334,412,746,259,295,252
"068611804",315,388,703,263,297,256
"068611904",360,459,819,314,322,266
"068611905",433,534,967,341,384,335
"068612003",408,500,908,359,430,350
"068612005",372,486,858,358,443,351
"068612008",261,340,601,246,372,241
"068612205",471,505,976,350,391,334
"068612212",278,294,572,187,219,183
"068612302",540,625,1165,398,401,350
"068612304",567,602,1169,310,235,218
"068612309",388,399,787,245,249,217
"068612507",408,423,831,316,331,279
"068612602",383,442,825,292,334,279
"068612604",395,452,847,311,354,310
"068612609",452,472,924,328,361,322
"068612702",384,446,830,311,351,304
"068612801",215,264,479,191,236,189
"068612809",320,403,723,253,288,242
"068613002",542,572,1114,291,263,259
"068613012",460,517,977,349,384,340
"068613203",87,97,184,79,97,73
"068613206",351,334,685,249,280,224
"068613306",287,378,665,273,349,256
"068680102",428,418,846,233,275,230
"068680103",361,371,732,212,250,207
"068680106",88,103,191,74,239,73
"068680108",331,369,700,205,396,199
"068680201",260,260,520,180,288,168
"068680209",50,40,90,26,399,24
"068680310",62,66,128,44,278,44
"068680405",53,46,99,32,350,32
"068680406",12,10,22,9,109,9
"068680505",93,88,181,68,456,60
"068680508",250,204,454,149,484,148
"068680707",39,43,82,32,316,32
"068680708",49,48,97,47,402,46
"068680711",60,60,120,48,421,48
"068750608",489,507,996,323,368,319
"068750803",166,204,370,138,174,137
"068820102",574,638,1212,396,371,344
"068820106",529,537,1066,333,350,315
"068820110",459,542,1001,339,348,318
"068820208",441,498,939,353,375,320
"068820302",448,506,954,322,337,307
"068820703",406,415,821,213,188,175
"068820808",398,455,853,307,398,302
"068820810",360,425,785,279,360,278
"068820912",784,765,1549,371,346,309
"068821004",377,424,801,250,240,222
"068821011",931,868,1799,446,406,382
"068821604",621,654,1275,362,347,328
"068821705",1074,1057,2131,518,495,467
"065601603",590,562,1152,340,328,305
"065601612",834,861,1695,463,465,443
"065601712",220,187,407,132,256,132
"065601806",913,898,1811,516,705,506
"065601812",374,442,816,270,331,257
"065601903",744,712,1456,376,409,363
"065601909",481,508,989,289,349,282
"065602317",439,550,989,386,473,376
"065601917",348,309,657,165,213,159
"065602105",441,469,910,257,308,245
"067910101",506,589,1095,415,475,402
"065602313",390,463,853,329,388,318
"065602405",433,444,877,281,279,247
"065602415",215,276,491,198,254,195
"065602416",424,412,836,279,318,278
"065602501",337,357,694,247,263,236
"065602509",710,755,1465,469,486,435
"065602513",777,825,1602,430,441,407
"065680102",533,523,1056,268,293,262
"065680211",479,565,1044,356,403,344
"065680303",496,524,1020,353,390,351
"065680313",632,659,1291,423,456,407
"065680404",380,433,813,288,307,272
"065680407",354,433,787,285,318,279
"065680506",400,443,843,321,387,317
"065680509",313,334,647,222,264,218
"065680611",174,191,365,162,235,160
"065680805",559,622,1181,378,433,369
"065680807",469,521,990,353,341,298
"065680911",298,317,615,224,264,220
"065681101",350,408,758,291,345,288
"065681103",313,359,672,241,282,226
"065681105",270,349,619,282,461,277
"065681106",390,420,810,276,308,274
"065681109",279,300,579,243,294,240
"065681306",548,588,1136,380,443,375
"065681307",576,660,1236,435,488,423
"065681308",505,591,1096,368,386,330
"066300101",167,144,311,110,219,110
"067491501",49,26,75,29,93,25
"060070113",23,16,39,15,27,15
"064904808",411,459,870,315,360,302
"064904905",340,378,718,248,264,237
"064905002",515,591,1106,408,437,399
"064905107",525,627,1152,362,381,350
"064970105",376,409,785,295,377,290
"064970109",254,284,538,196,212,191
"064970302",990,997,1987,369,446,364
"064970310",212,213,425,118,125,114
"064970407",340,320,660,195,220,174
"064970508",476,555,1031,327,380,317
"064970513",478,526,1004,352,409,350
"064970605",516,515,1031,307,328,290
"064970706",262,368,630,291,437,289
"064970710",340,370,710,238,263,211
"064970801",345,380,725,219,219,210
"064970807",361,363,724,234,244,224
"064970811",593,653,1246,406,435,392
"064971207",517,543,1060,321,352,308
"064971308",400,376,776,273,299,264
"064971309",264,241,505,159,156,144
"064971404",50,52,102,24,30,24
"065151914",426,474,900,260,176,171
"065152009",618,689,1307,330,283,270
"065152013",722,758,1480,419,353,331
"065050301",68,84,152,48,116,47
"065050304",104,98,202,66,130,65
"065050320",290,299,589,179,202,179
"065110512",526,609,1135,360,389,357
"065110513",336,379,715,197,285,193
"065152102",288,288,576,146,207,133
"065180102",184,191,375,123,141,121
"065180103",276,306,582,186,210,181
"065180203",315,378,693,247,284,241
"065180301",120,109,229,75,83,71
"065180607",73,91,164,66,125,62
"065150203",282,294,576,176,179,159
"065150205",355,370,725,194,195,157
"065150206",314,300,614,200,289,194
"065150207",763,747,1510,406,385,345
"065150210",1008,938,1946,518,535,508
"065150212",578,592,1170,283,248,235
"065150214",906,891,1797,429,386,362
"065150311",459,469,928,280,290,273
"065150401",596,621,1217,342,342,305
"065150505",452,491,943,302,308,287
"065150606",581,638,1219,395,364,337
"065150608",465,504,969,275,280,260
"065150610",453,485,938,250,263,234
"065150705",516,545,1061,287,256,249
"060283103",372,464,836,288,330,282
"060350105",221,259,480,149,158,146
"060350512",367,411,778,271,296,264
"065150910",749,782,1531,451,438,397
"065151005",410,471,881,302,323,272
"060352606",385,435,820,223,237,217
"065151010",384,382,766,234,238,211
"065151011",419,434,853,232,238,229
"065151014",570,604,1174,337,338,322
"065151015",443,470,913,290,304,290
"060562003",354,439,793,311,390,309
"060562109",284,398,682,269,308,264
"060770101",584,587,1171,324,349,313
"060910801",393,388,781,266,297,265
"060980610",384,411,795,226,232,221
"061051103",187,231,418,156,188,151
"065151204",456,450,906,233,185,176
"065151210",511,538,1049,291,244,238
"065151211",625,631,1256,353,266,249
"061340901",88,81,169,38,53,37
"060070102",324,353,677,253,275,251
"060070405",406,437,843,332,392,329
"060070612",63,59,122,50,71,49
"060070810",366,399,765,309,383,303
"060561008",329,408,737,325,429,323
"060141001",205,189,394,127,144,127
"060141008",320,379,699,213,241,209
"060141009",337,381,718,277,330,274
"060141012",281,298,579,193,214,189
"065151213",538,544,1082,280,210,206
"060210612",342,326,668,227,264,218
"060280105",270,344,614,201,215,196
"060280109",785,831,1616,485,475,446
"060280208",625,619,1244,324,271,262
"060280305",858,934,1792,406,275,270
"060280309",484,589,1073,277,251,246
"060280501",38,34,72,21,21,19
"060280504",553,556,1109,306,276,269
"060280702",1011,1022,2033,546,453,433
"060280703",1075,1088,2163,573,478,458
"060280706",699,751,1450,449,454,411
"060280801",185,197,382,82,82,79
"060280806",439,490,929,267,260,253
"060280807",445,493,938,260,255,242
"060280901",810,832,1642,463,396,389
"060281017",406,417,823,245,257,233
"060281207",339,401,740,273,342,270
"060281210",685,746,1431,429,421,382
"060281211",548,613,1161,372,399,358
"060281302",396,393,789,235,253,230
"060281303",479,477,956,236,234,211
"060281308",676,635,1311,332,325,311
"060281410",621,637,1258,304,267,260
"060281512",495,536,1031,292,281,255
"060281608",450,464,914,277,300,274
"060281907",462,449,911,282,330,273
"060282004",1075,980,2055,490,503,474
"060282010",719,673,1392,319,309,304
"060282015",746,735,1481,377,392,357
"060282108",558,580,1138,306,342,289
"060282109",680,642,1322,327,300,284
"060282113",430,460,890,254,279,245
"063573707",111,178,289,159,441,159
"060282405",750,901,1651,453,433,416
"060282602",176,209,385,126,144,126
"060282605",280,372,652,224,243,224
"060282609",388,476,864,280,316,280
"060282701",316,342,658,210,225,206
"060282710",240,236,476,158,175,150
"060282712",429,473,902,306,351,304
"060282713",483,502,985,344,401,324
"060282807",607,639,1246,374,403,360
"060283006",469,487,956,288,266,255
"060283007",717,706,1423,360,378,342
"060283010",743,753,1496,385,386,362
"060283112",460,475,935,300,326,283
"060283301",1046,1074,2120,627,382,284
"060283314",988,931,1919,482,489,449
"060283404",619,681,1300,367,377,345
"060283406",553,592,1145,375,392,357
"060283509",842,859,1701,415,411,394
"060283605",800,795,1595,420,432,390
"060283607",674,743,1417,438,489,431
"060283613",585,543,1128,364,463,354
"060283615",927,889,1816,448,452,420
"060283711",655,678,1333,380,395,363
"060283713",558,582,1140,275,253,235
"060283807",383,378,761,229,258,225
"060283905",630,648,1278,317,303,286
"060283915",465,484,949,269,307,251
"060561009",224,317,541,230,298,228
"060350106",351,391,742,225,212,201
"060350110",486,530,1016,286,268,262
"060350111",485,463,948,256,188,171
"065151216",536,516,1052,300,254,242
"060350301",488,511,999,308,316,294
"062170509",8,6,14,4,19,4
"060350405",540,605,1145,356,367,350
"060350408",408,456,864,250,257,229
"060351302",433,469,902,338,418,333
"060350608",408,472,880,303,337,300
"060350802",338,335,673,174,189,173
"060350808",320,360,680,215,217,200
"060350814",341,348,689,222,237,200
"060350904",1244,1366,2610,711,432,412
"060350912",295,338,633,191,146,135
"060351610",469,495,964,334,356,322
"060351706",354,394,748,266,293,244
"060351710",489,581,1070,351,384,342
"060351801",387,456,843,286,335,278
"060352304",168,192,360,131,307,128
"060352006",415,481,896,287,320,275
"060352008",477,505,982,343,356,320
"060352305",472,547,1019,381,483,375
"060352101",544,591,1135,404,440,396
"060352110",348,433,781,299,361,282
"060352204",195,254,449,192,256,189
"060352207",292,354,646,274,365,273
"060352302",218,251,469,173,504,171
"060352312",667,685,1352,363,325,295
"060352608",422,434,856,235,213,202
"060352610",917,979,1896,484,441,427
"063573802",135,184,319,179,783,179
"060352701",149,143,292,69,69,66
"060352706",874,848,1722,482,371,354
"060352804",357,405,762,272,295,259
"060352904",385,440,825,267,261,205
"060353109",278,305,583,219,201,169
"060353406",487,520,1007,341,390,322
"060353507",335,375,710,242,245,218
"060421905",363,472,835,309,354,297
"060490211",412,439,851,279,304,276
"060490506",303,373,676,282,337,274
"060490606",452,556,1008,373,406,346
"060490615",254,239,493,142,163,133
"060492001",485,532,1017,391,419,378
"062520304",368,412,780,232,253,221
"063572101",151,194,345,157,247,154
"060492507",636,689,1325,437,490,425
"060560104",160,179,339,166,238,164
"060560105",202,188,390,194,279,191
"060560106",175,181,356,177,237,169
"060560109",152,208,360,185,224,183
"060560113",229,297,526,241,306,233
"060560303",271,402,673,285,392,276
"060560207",308,390,698,301,350,294
"060560213",215,256,471,177,212,175
"060560310",355,379,734,279,346,277
"060560312",295,326,621,233,249,221
"060560501",340,381,721,228,225,206
"060560502",443,578,1021,301,321,294
"060560705",338,348,686,223,234,197
"060560708",384,426,810,277,305,274
"060560803",636,643,1279,367,362,343
"060561006",145,221,366,171,270,170
"060560812",504,484,988,275,255,241
"060560902",286,353,639,270,381,264
"060560905",238,331,569,224,308,223
"060561105",153,225,378,215,305,212
"060561113",209,301,510,253,314,247
"060561207",132,240,372,203,278,196
"060561209",232,268,500,242,348,241
"060561210",100,156,256,145,199,142
"060561308",291,331,622,311,393,306
"060561412",151,217,368,176,234,175
"060561413",278,418,696,282,413,276
"060561416",316,368,684,328,448,324
"060561605",362,427,789,313,359,302
"060561612",263,313,576,258,369,242
"062600103",546,536,1082,271,217,205
"060561806",367,427,794,295,336,289
"060561810",354,372,726,252,305,244
"062600302",513,528,1041,247,243,233
"060562206",561,560,1121,351,331,322
"060562212",246,226,472,101,313,100
"060562316",532,517,1049,296,305,278
"060562404",615,636,1251,365,408,358
"065151307",397,400,797,258,297,253
"060562409",646,648,1294,361,382,352
"060562413",699,689,1388,405,419,393
"060562505",644,671,1315,354,367,347
"060562514",398,374,772,314,414,307
"065151308",449,492,941,305,319,292
"062601310",305,392,697,209,230,203
"060562607",484,486,970,316,402,314
"065151311",666,739,1405,447,463,427
"060562702",416,430,846,244,353,242
"060562706",169,168,337,100,195,96
"060563203",602,536,1138,339,425,327
"060563206",533,586,1119,340,365,332
"060630112",268,327,595,217,274,215
"062660707",364,373,737,257,322,254
"060630207",454,505,959,325,371,320
"060630801",7,5,12,6,10,6
"062700706",528,498,1026,237,250,229
"060631303",560,622,1182,439,489,423
"060631308",540,548,1088,372,402,341
"060700203",273,308,581,202,207,183
"060700306",883,875,1758,454,470,432
"060770502",342,318,660,215,235,206
"060770505",478,457,935,257,269,237
"060840901",941,265,1206,179,232,178
"060910306",667,709,1376,422,439,404
"060910106",350,354,704,224,232,214
"060910309",545,597,1142,396,416,376
"060910312",197,234,431,156,210,152
"060910402",678,717,1395,353,330,310
"060910403",808,834,1642,447,451,424
"060910404",917,920,1837,459,462,430
"060910408",327,382,709,223,232,219
"060910502",574,644,1218,378,391,361
"060910504",404,425,829,245,274,239
"060910509",295,292,587,160,153,133
"060910611",611,615,1226,322,320,291
"060910702",512,557,1069,328,326,304
"060910605",352,377,729,232,247,223
"060910606",583,588,1171,307,314,287
"060910906",523,546,1069,360,339,325
"060911002",278,335,613,209,207,200
"060911003",692,750,1442,448,443,418
"060911103",283,317,600,206,232,200
"060911107",563,620,1183,406,433,392
"060911409",462,468,930,261,268,248
"060911611",917,943,1860,514,499,462
"060911701",488,508,996,282,297,265
"060911808",530,589,1119,343,355,328
"060911904",747,858,1605,382,382,337
"060912103",526,481,1007,275,283,266
"060912104",373,406,779,262,273,257
"060912112",826,795,1621,424,401,373
"060912117",807,844,1651,446,403,385
"060912208",450,457,907,265,277,259
"060912214",301,294,595,175,260,174
"060912405",587,574,1161,281,315,264
"060980106",420,503,923,299,329,292
"060980204",634,690,1324,406,416,391
"060980208",599,619,1218,360,397,348
"063573909",66,109,175,101,220,101
"060980604",382,394,776,231,220,207
"060980608",474,530,1004,345,370,328
"061050209",222,295,517,207,253,203
"060980613",471,442,913,240,243,234
"060980617",371,412,783,232,243,221
"060980812",310,355,665,231,254,208
"061050210",330,392,722,287,338,283
"060980803",391,404,795,240,251,221
"060980815",511,543,1054,326,337,300
"061050105",275,299,574,241,327,237
"061050204",151,220,371,165,196,160
"061120104",189,228,417,172,233,172
"061051407",441,468,909,283,290,273
"061120106",323,408,731,284,333,278
"061120113",516,491,1007,271,278,241
"061120701",248,258,506,157,187,153
"061121305",127,121,248,86,127,86
"061121403",353,388,741,282,322,272
"061190306",307,295,602,181,219,176
"061191004",433,393,826,224,250,218
"061191006",686,723,1409,426,477,419
"061260105",371,401,772,255,259,244
"061260106",353,427,780,261,268,231
"061260109",463,515,978,328,373,319
"061260110",406,443,849,286,344,278
"061260114",325,320,645,227,260,220
"061260306",332,381,713,245,319,226
"061260310",504,560,1064,368,409,351
"061260401",327,355,682,249,312,245
"061260510",439,440,879,237,247,222
"061260607",173,180,353,108,352,105
"061260806",340,371,711,260,327,250
"061260905",156,144,300,89,145,86
"061340201",534,616,1150,354,374,341
"061340307",727,755,1482,474,486,435
"061340906",306,300,606,169,179,157
"061400302",571,649,1220,401,433,387
"061400319",433,423,856,279,300,271
"061470301",226,245,471,145,190,142
"061471101",87,87,174,57,79,40
"061471210",366,370,736,231,226,216
"061540611",295,303,598,195,221,188
"061540601",286,249,535,165,181,156
"061540605",169,184,353,140,165,136
"061540802",85,73,158,46,64,46
"061610102",328,322,650,208,238,203
"061680904",477,521,998,348,419,343
"061750602",297,319,616,232,237,218
"061750603",409,389,798,246,247,226
"061820104",576,651,1227,328,249,217
"061820502",226,212,438,127,142,124
"061821008",404,464,868,332,410,329
"061890601",19,19,38,17,27,17
"063572204",140,202,342,165,287,164
"061891003",404,406,810,252,271,246
"061891004",401,441,842,278,309,273
"061891502",449,507,956,363,463,359
"061960104",353,389,742,258,285,253
"061960112",515,548,1063,338,373,336
"061960206",329,402,731,318,388,313
"061960211",226,232,458,154,168,152
"061960701",205,216,421,136,156,134
"062030107",241,285,526,228,288,214
"062030108",408,418,826,294,315,283
"061961506",132,118,250,91,120,91
"062030103",303,397,700,293,390,290
"062030201",214,227,441,182,202,177
"062030210",357,352,709,248,284,244
"062030211",184,205,389,147,168,145
"062030805",501,589,1090,424,474,411
"062030808",724,759,1483,483,553,478
"063572206",208,280,488,242,464,240
"062031604",645,662,1307,425,459,415
"062031609",590,610,1200,405,465,393
"063711108",252,298,550,245,342,243
"062100104",203,241,444,168,204,167
"062100113",296,293,589,203,242,202
"062100121",393,420,813,271,293,262
"062100207",624,677,1301,440,471,414
"062100603",261,249,510,165,196,160
"062100608",141,139,280,94,122,92
"062100901",281,313,594,222,258,217
"062101303",226,289,515,187,194,179
"062101306",508,561,1069,404,425,383
"062170108",257,327,584,218,282,211
"062170111",268,294,562,214,277,199
"062170403",214,216,430,125,176,123
"062170407",139,138,277,90,170,88
"062170410",326,384,710,223,249,218
"062240113",439,472,911,282,295,271
"062171003",519,550,1069,377,429,370
"062171013",311,339,650,223,267,220
"062171202",1057,1210,2267,592,596,569
"062171208",332,366,698,257,283,248
"062171209",329,322,651,226,248,218
"062171215",328,340,668,216,318,215
"062240104",353,356,709,250,274,233
"063572210",136,209,345,173,308,165
"062240309",263,273,536,167,191,158
"062240404",318,395,713,286,344,281
"062240407",365,467,832,321,370,308
"062240414",237,282,519,155,178,148
"064080115",137,168,305,107,115,101
"062240903",126,136,262,85,206,83
"062240912",216,228,444,144,249,140
"062380101",306,292,598,193,209,192
"062380107",658,649,1307,420,481,413
"062380112",380,422,802,252,271,248
"062600213",661,608,1269,334,334,325
"062380601",232,202,434,131,146,125
"062380605",13,15,28,9,13,9
"062380610",21,15,36,16,22,16
"062380611",274,293,567,183,189,177
"062450211",905,880,1785,488,499,466
"062450214",430,449,879,267,285,262
"062450301",439,463,902,312,329,293
"062450302",588,630,1218,382,406,363
"065151502",475,523,998,293,290,271
"062450410",418,417,835,233,241,227
"062450506",4,1,5,3,3,3
"062520107",910,959,1869,543,584,513
"062520113",441,483,924,335,364,283
"062520404",405,412,817,265,275,250
"062520207",304,322,626,173,274,169
"062520213",390,421,811,253,290,241
"062520303",174,170,344,112,191,110
"062520305",947,886,1833,445,422,393
"062520309",299,310,609,204,253,193
"062520405",504,509,1013,319,330,299
"062520509",605,636,1241,378,377,368
"062520703",746,804,1550,420,412,348
"062520803",801,811,1612,425,455,398
"062521304",548,549,1097,319,332,298
"062520910",748,760,1508,399,379,362
"062520912",821,839,1660,414,363,352
"062521305",609,656,1265,361,367,338
"062521015",287,301,588,199,297,193
"065151511",760,718,1478,384,249,234
"062521104",499,511,1010,366,406,351
"062521108",158,140,298,97,165,96
"062521203",811,809,1620,428,385,372
"062521301",381,361,742,223,191,177
"062521302",715,739,1454,370,381,352
"062521303",659,666,1325,387,386,354
"062521405",404,363,767,214,204,185
"062521406",426,430,856,221,222,202
"062521408",860,924,1784,492,514,479
"062521410",462,504,966,300,331,287
"062521412",877,837,1714,395,416,372
"062521417",470,462,932,292,327,285
"062521504",779,772,1551,426,453,410
"064130505",111,192,303,159,235,156
"062521510",300,322,622,194,408,193
"062521512",991,933,1924,492,439,418
"064130603",432,490,922,338,375,328
"062600112",814,798,1612,418,398,361
"062600206",701,655,1356,328,276,259
"065151513",677,697,1374,395,364,333
"062600208",122,117,239,82,139,79
"062600215",786,782,1568,411,415,398
"062600501",648,625,1273,351,344,323
"062600313",899,939,1838,463,477,458
"062600404",573,594,1167,336,319,298
"062600407",509,503,1012,289,268,257
"062600410",333,393,726,235,241,227
"062600502",589,627,1216,325,337,320
"062600506",836,841,1677,424,357,349
"062600512",614,633,1247,313,264,250
"062600604",590,706,1296,432,441,400
"062600606",318,374,692,221,234,209
"062600614",490,501,991,353,394,341
"062600711",452,525,977,323,360,303
"062600910",683,684,1367,372,385,357
"062601001",595,669,1264,337,358,329
"062601009",404,465,869,238,230,209
"062601207",313,362,675,213,196,174
"062601301",367,401,768,253,288,246
"062601311",296,388,684,269,380,261
"062601403",406,463,869,287,299,268
"062601413",495,487,982,291,287,265
"062601513",615,639,1254,342,305,280
"062601514",498,478,976,244,243,220
"062601515",593,605,1198,285,297,281
"062601516",585,683,1268,307,326,298
"062601519",573,586,1159,329,324,290
"063572905",67,64,131,51,116,46
"062601608",244,256,500,125,129,122
"062601610",563,575,1138,286,313,278
"062601616",631,646,1277,361,398,334
"062660302",376,415,791,285,298,268
"062660307",232,316,548,186,209,182
"062660310",386,449,835,279,300,257
"062660604",104,103,207,77,236,77
"062740807",657,752,1409,376,363,347
"062700311",559,571,1130,356,381,343
"062700407",495,551,1046,339,374,330
"062700409",571,631,1202,433,483,425
"062700504",940,940,1880,465,449,416
"062700505",763,743,1506,380,380,358
"062700508",834,787,1621,434,462,407
"064271420",354,408,762,239,204,169
"062700909",847,821,1668,392,284,241
"062701005",676,709,1385,368,388,350
"062740103",328,349,677,227,242,214
"062740105",774,835,1609,493,487,454
"062740108",242,270,512,177,187,171
"062740205",554,586,1140,331,324,304
"062740206",764,859,1623,496,459,440
"062740209",476,481,957,273,265,261
"062740211",813,830,1643,442,408,392
"062740212",569,586,1155,328,317,307
"062740214",606,665,1271,405,399,377
"062740306",380,383,763,211,219,195
"062740307",788,827,1615,458,375,356
"062740512",622,659,1281,359,341,315
"062740606",709,752,1461,396,390,367
"062740705",572,580,1152,324,312,289
"062740710",626,591,1217,303,304,269
"062740804",457,511,968,257,258,250
"062740809",484,503,987,251,250,240
"062740903",649,651,1300,327,359,317
"062740917",582,590,1172,297,310,281
"062740921",640,666,1306,344,308,289
"064274006",668,737,1405,378,358,332
"062741105",791,796,1587,437,397,374
"062741213",426,461,887,232,213,203
"062741309",559,544,1103,287,289,265
"062741401",638,668,1306,416,421,391
"062741405",503,576,1079,376,413,368
"062741406",244,272,516,205,282,202
"062741408",409,485,894,313,352,298
"064275005",567,610,1177,367,378,347
"062741705",515,553,1068,294,254,236
"063573010",116,182,298,160,388,159
"063573011",176,232,408,205,591,205
"062742006",805,796,1601,411,421,394
"062742016",634,596,1230,280,276,258
"062742101",309,370,679,213,224,201
"063571203",449,468,917,298,318,280
"062742121",406,401,807,225,240,224
"062742207",79,78,157,47,169,44
"062742208",165,180,345,93,154,92
"062742212",448,448,896,244,360,240
"062770103",169,173,342,113,140,111
"062800103",302,309,611,184,201,172
"062800203",205,245,450,177,242,171
"062800205",514,559,1073,342,426,332
"062800207",337,419,756,290,418,276
"062800303",82,88,170,62,430,62
"062800305",117,121,238,83,334,83
"062800309",36,67,103,46,346,46
"062800311",39,39,78,37,813,37
"062800403",35,46,81,35,212,33
"064276513",556,542,1098,272,251,243
"063573104",77,109,186,111,214,104
"062801002",265,300,565,197,314,194
"062801112",223,232,455,137,175,133
"062801206",496,555,1051,336,360,331
"062870415",536,528,1064,279,313,248
"062940402",459,466,925,331,391,328
"062940602",173,200,373,146,166,144
"062940805",168,178,346,143,177,142
"062940809",105,96,201,56,71,54
"064279012",509,508,1017,262,199,171
"064279110",368,395,763,188,185,172
"063010511",308,380,688,287,346,282
"063010811",329,417,746,280,341,278
"063010812",489,524,1013,358,418,351
"063010814",339,308,647,222,266,212
"063573106",167,228,395,189,371,186
"063150108",386,412,798,227,254,220
"063150109",465,595,1060,368,443,364
"063220607",290,313,603,194,217,186
"063220616",277,275,552,188,213,182
"063290101",19,22,41,15,31,13
"064340708",240,286,526,178,175,148
"063570401",296,348,644,231,317,224
"063290305",545,547,1092,304,319,292
"063290312",392,473,865,332,396,326
"063290313",239,282,521,190,211,180
"063290316",445,473,918,264,291,254
"063290401",71,59,130,32,41,32
"064341812",234,266,500,199,261,197
"063430706",386,406,792,263,294,255
"063430712",288,270,558,182,239,182
"063510103",208,205,413,140,174,140
"063510401",335,296,631,205,263,202
"063510406",380,386,766,290,343,289
"063570103",602,616,1218,359,381,338
"063570106",342,386,728,247,288,241
"063570306",462,567,1029,327,413,319
"063570307",346,421,767,282,457,278
"063570403",191,219,410,161,323,158
"063570606",334,359,693,236,287,230
"063570607",401,475,876,333,394,323
"063570608",507,516,1023,340,400,333
"063570805",459,508,967,320,368,309
"063570810",514,542,1056,370,410,354
"063570903",501,520,1021,284,278,244
"063570904",596,619,1215,349,348,318
"063570906",675,685,1360,376,391,353
"063570908",565,572,1137,319,281,265
"063571013",421,381,802,217,232,210
"063571214",364,435,799,295,378,293
"063571309",266,281,547,185,223,183
"063571407",493,572,1065,383,431,376
"063571705",592,588,1180,379,466,327
"063571709",281,326,607,226,309,226
"063571905",143,165,308,162,556,162
"063571910",96,141,237,110,293,107
"063572303",114,156,270,110,266,110
"063572307",95,103,198,110,544,110
"063572501",183,278,461,249,1071,242
"063572502",211,279,490,241,1075,239
"063572503",118,145,263,138,771,138
"063573301",289,354,643,270,334,264
"063573306",195,260,455,226,355,224
"063574003",128,178,306,160,648,160
"063574106",59,74,133,62,302,60
"063574205",107,136,243,137,379,135
"063574301",75,94,169,80,360,80
"063574303",110,129,239,107,394,106
"063574304",185,254,439,166,376,161
"063574305",50,54,104,55,296,55
"063574310",86,122,208,96,558,96
"063574312",92,108,200,92,363,91
"063574508",268,394,662,269,359,266
"063574512",151,164,315,134,286,134
"063574516",318,349,667,268,612,266
"063574612",330,398,728,249,341,245
"063574701",309,414,723,317,385,312
"063574710",344,420,764,327,434,309
"063574802",411,489,900,325,369,318
"063574803",360,432,792,297,374,291
"063574806",209,241,450,166,206,151
"063574809",214,245,459,172,211,168
"063575007",588,605,1193,367,415,349
"063575105",555,550,1105,335,331,295
"063575203",571,644,1215,379,425,374
"063575206",383,432,815,243,259,236
"063575214",704,750,1454,381,394,365
"063575215",854,811,1665,443,446,410
"063575216",860,851,1711,447,463,424
"063575304",398,438,836,298,334,274
"063575306",441,409,850,259,305,244
"063575315",544,564,1108,298,279,265
"063575610",177,217,394,160,185,152
"063575808",608,669,1277,437,454,410
"063575907",534,519,1053,311,340,299
"063576005",410,419,829,280,314,269
"063576104",290,357,647,223,276,214
"063576406",236,234,470,143,268,142
"063576508",489,536,1025,323,405,286
"063576606",434,425,859,253,285,246
"063576608",321,348,669,213,237,198
"063576706",343,410,753,241,259,228
"063576715",700,671,1371,365,350,330
"063576801",637,690,1327,437,444,410
"063576907",622,693,1315,372,379,350
"063577001",425,455,880,261,273,233
"063577005",282,325,607,204,231,201
"063577111",751,731,1482,391,401,367
"063577206",541,504,1045,293,316,288
"063577308",312,272,584,145,163,142
"063577310",5,3,8,3,5,3
"063577312",113,102,215,74,160,73
"063577415",302,263,565,175,280,175
"063577501",195,221,416,149,365,146
"063577603",83,70,153,56,157,53
"063577606",59,61,120,45,142,45
"063577607",118,151,269,94,339,91
"063577608",155,177,332,131,398,128
"063577614",70,55,125,49,248,49
"063577702",330,370,700,187,200,181
"063577703",101,106,207,62,71,58
"063577710",195,213,408,76,279,74
"063577908",576,540,1116,311,357,296
"063577913",632,652,1284,369,394,335
"063710504",326,368,694,245,242,223
"063578111",256,262,518,171,230,167
"063640109",498,483,981,245,271,239
"063640110",463,468,931,252,267,236
"063640112",294,342,636,187,209,180
"063640210",472,487,959,283,352,271
"063640313",146,194,340,106,296,101
"063640314",0,0,0,0,213,0
"064551413",372,430,802,321,370,309
"064620402",333,401,734,276,313,269
"064620601",163,155,318,104,135,104
"064621201",195,166,361,112,136,109
"063640704",630,661,1291,332,391,321
"063640705",410,510,920,270,285,259
"063640809",487,462,949,263,301,252
"063640818",452,452,904,262,292,253
"063710211",415,444,859,261,256,247
"063710105",372,347,719,189,173,172
"063710108",251,230,481,111,102,96
"063710305",509,521,1030,361,312,302
"063710312",210,225,435,115,119,115
"063710607",448,493,941,303,262,255
"063710710",304,332,636,222,239,210
"063710806",611,683,1294,406,428,403
"063710906",671,796,1467,504,514,473
"063710908",516,613,1129,371,388,356
"063711002",513,583,1096,382,427,373
"063711005",325,349,674,228,276,225
"063711011",378,468,846,293,347,286
"063711012",191,185,376,108,105,102
"063711016",263,308,571,193,214,191
"063711204",531,563,1094,378,412,365
"063711302",481,500,981,319,350,312
"063711411",436,475,911,278,246,210
"063711502",463,509,972,236,214,208
"063711606",325,331,656,190,165,150
"063711607",347,376,723,250,261,226
"063711610",393,468,861,261,268,237
"063711611",480,514,994,285,273,243
"063711712",376,403,779,258,278,244
"063711714",492,527,1019,343,374,329
"063711808",420,455,875,275,274,249
"063711814",671,754,1425,460,493,438
"063712003",395,490,885,302,297,263
"063712107",391,479,870,274,303,273
"063712108",526,604,1130,375,428,367
"063712109",396,437,833,336,410,326
"063712205",271,304,575,211,226,183
"063712208",230,320,550,230,306,218
"063712211",126,152,278,134,259,133
"063712212",227,239,466,208,269,208
"063712405",297,319,616,205,213,173
"063712507",446,511,957,327,348,295
"063712606",524,539,1063,321,301,263
"063712608",353,385,738,248,266,226
"063712902",218,274,492,205,306,205
"063713005",396,441,837,297,336,295
"063713006",578,661,1239,297,327,293
"063713101",468,536,1004,331,337,306
"063713105",414,470,884,301,300,270
"063713206",455,512,967,403,389,351
"063713306",625,705,1330,415,421,368
"063713505",398,422,820,244,225,203
"064343605",408,448,856,288,325,270
"064901006",257,287,544,210,247,205
"063850708",377,504,881,309,371,305
"063850709",411,383,794,270,321,261
"063850712",85,64,149,47,73,47
"063851001",438,498,936,316,329,312
"063920103",244,292,536,220,260,214
"063920301",362,331,693,256,296,255
"064902106",382,450,832,310,357,297
"063920702",269,285,554,204,248,202
"064902203",257,294,551,256,368,253
"063921401",31,32,63,18,32,17
"063921501",307,337,644,223,257,212
"063990502",227,206,433,156,179,152
"064903406",536,553,1089,297,293,283
"064903608",561,515,1076,305,284,264
"064060206",399,478,877,329,381,321
"064080103",514,566,1080,351,370,335
"064411810",259,317,576,256,359,244
"064080201",545,563,1108,318,329,300
"064903914",775,723,1498,397,313,310
"064080202",541,645,1186,373,375,337
"064080203",575,626,1201,389,363,328
"064080409",685,709,1394,417,367,342
"064080501",448,479,927,262,239,227
"064080510",416,398,814,253,273,249
"064080512",364,406,770,241,261,238
"064080802",583,574,1157,324,289,282
"064080803",322,362,684,206,230,203
"064080813",455,460,915,255,263,249
"064081004",541,580,1121,368,403,358
"064081006",471,546,1017,309,292,277
"064081110",340,350,690,184,180,171
"064081304",482,516,998,289,286,267
"064081308",527,580,1107,314,327,301
"064081309",553,538,1091,279,263,256
"064100309",755,823,1578,465,422,383
"064081501",610,613,1223,405,432,382
"064081506",123,150,273,106,126,105
"064411811",368,476,844,392,543,380
"064100202",491,535,1026,297,334,277
"064100204",103,94,197,61,72,60
"064100206",156,157,313,88,65,57
"064100308",469,489,958,287,297,267
"064100411",373,394,767,233,254,223
"064100412",628,712,1340,369,271,243
"064100503",684,678,1362,412,423,392
"064100511",491,530,1021,282,279,272
"064100515",1625,1052,2677,487,370,366
"064100607",531,614,1145,327,371,312
"064100801",344,340,684,227,226,213
"064100803",628,655,1283,402,430,397
"064100903",640,698,1338,440,487,425
"065050310",251,278,529,163,184,158
"064100909",364,445,809,284,297,268
"064101104",385,457,842,291,333,283
"064101106",298,296,594,209,290,207
"064101202",439,533,972,360,407,331
"064101209",338,364,702,224,248,218
"064101303",340,362,702,232,224,202
"064101306",701,735,1436,456,483,437
"064120101",366,359,725,212,242,200
"064120108",242,230,472,134,229,134
"065150105",887,925,1812,477,454,439
"064120112",680,622,1302,317,328,302
"064120113",616,632,1248,300,296,278
"064120202",576,607,1183,335,366,317
"064120203",572,651,1223,344,325,299
"064120310",508,615,1123,334,351,321
"064120404",795,874,1669,478,467,417
"064120505",310,335,645,215,229,212
"064120609",512,507,1019,273,279,262
"064120610",482,465,947,269,264,243
"064120703",770,779,1549,412,399,363
"064120704",548,533,1081,294,288,278
"064120706",418,499,917,243,236,210
"064120814",669,666,1335,311,315,297
"064120916",432,449,881,203,211,199
"064121001",758,792,1550,401,376,359
"064121019",840,917,1757,412,418,397
"064121111",541,579,1120,279,264,251
"064121204",835,838,1673,458,431,401
"064121206",672,718,1390,341,339,320
"064121208",702,767,1469,391,356,338
"064121309",505,528,1033,295,306,287
"064121310",423,434,857,237,241,222
"064121312",830,826,1656,424,409,386
"064121405",572,590,1162,331,318,301
"064121413",559,567,1126,299,261,252
"064121502",784,793,1577,466,445,403
"064130204",482,526,1008,273,302,265
"064130208",395,469,864,316,348,302
"064130210",346,445,791,322,379,319
"064130407",302,332,634,256,292,254
"065152005",529,530,1059,304,271,269
"064130609",506,534,1040,332,358,316
"065180601",61,78,139,53,246,53
"064132209",191,187,378,128,147,126
"064200203",45,45,90,36,238,36
"064200207",62,54,116,55,341,55
"064200215",147,177,324,132,413,130
"064200305",143,158,301,103,262,102
"065250108",423,484,907,332,381,328
"064200418",61,47,108,42,474,42
"064200419",100,92,192,78,422,78
"064200508",347,340,687,212,311,209
"064200602",22,18,40,19,265,18
"064200704",47,54,101,40,319,40
"064200706",116,115,231,88,350,86
"064200803",183,185,368,125,253,123
"064200805",176,183,359,150,249,147
"064200903",311,349,660,200,317,190
"064200912",28,29,57,23,314,23
"065320107",277,344,621,246,307,243
"064201007",172,161,333,130,320,126
"064201008",60,67,127,51,507,51
"064201115",96,87,183,71,470,68
"064201013",153,154,307,110,593,108
"065321401",302,357,659,277,331,266
"064201207",47,57,104,45,387,41
"064201403",161,171,332,108,384,103
"064201303",66,53,119,44,351,44
"064201306",77,67,144,59,313,57
"064201402",41,38,79,36,369,36
"064201406",32,30,62,25,436,25
"064201504",21,24,45,17,412,16
"064201701",95,94,189,76,379,72
"064202002",166,192,358,130,390,130
"064202003",138,129,267,93,339,93
"064202008",23,32,55,25,265,25
"064202009",64,61,125,53,352,53
"064202109",694,652,1346,383,424,330
"064202208",110,105,215,69,274,68
"064270202",299,301,600,194,204,181
"064270210",310,364,674,282,385,273
"064270212",324,367,691,195,221,180
"064270214",228,260,488,184,238,182
"064270306",452,574,1026,344,388,335
"064270402",548,603,1151,388,396,349
"064270510",426,474,900,310,307,284
"064270608",297,295,592,208,225,190
"064270803",546,590,1136,364,377,344
"064270804",716,792,1508,442,457,412
"064270903",981,995,1976,550,554,519
"064271006",538,625,1163,354,357,310
"064271011",274,319,593,199,223,179
"064271101",623,674,1297,439,413,379
"064271105",477,564,1041,346,330,306
"064271210",349,386,735,235,225,197
"064271410",1429,1475,2904,818,673,621
"064271416",652,676,1328,401,396,347
"064271502",403,438,841,253,213,190
"064271503",327,391,718,269,291,258
"064271506",443,531,974,298,291,267
"064271604",598,627,1225,336,220,200
"064271705",446,463,909,259,219,212
"064271612",478,555,1033,388,465,379
"064271701",588,610,1198,382,429,359
"064271703",705,679,1384,423,257,240
"064271706",498,506,1004,214,172,169
"064271711",2217,2222,4439,1016,736,702
"064271803",695,710,1405,272,165,160
"064271806",109,114,223,43,23,23
"064271807",1202,1258,2460,562,434,418
"064271809",1500,1542,3042,692,503,475
"064271902",333,356,689,212,221,205
"064271907",571,609,1180,378,399,341
"064271910",493,555,1048,335,330,292
"064272002",432,450,882,251,254,234
"064276304",554,598,1152,291,270,257
"064272012",179,225,404,114,119,112
"064272304",819,890,1709,558,582,523
"064272305",555,627,1182,416,434,389
"064272401",604,659,1263,408,443,387
"064272402",427,438,865,188,57,56
"064272406",575,605,1180,362,337,310
"064272511",1481,1509,2990,773,623,591
"064272515",484,471,955,313,304,282
"064272705",373,443,816,274,288,252
"064272904",339,376,715,244,232,210
"064273008",187,232,419,189,268,184
"064273010",358,362,720,306,394,298
"064273101",291,353,644,295,400,292
"064273102",394,459,853,309,366,301
"064273110",388,420,808,287,327,279
"064273209",289,319,608,216,277,214
"064273306",227,262,489,182,209,178
"065392917",39,30,69,21,18,18
"064273403",699,805,1504,505,557,485
"064273412",680,773,1453,481,438,399
"065392923",476,539,1015,315,320,294
"064273503",330,407,737,214,255,195
"064273509",671,767,1438,477,511,452
"064273907",495,546,1041,300,260,236
"064274011",850,915,1765,461,403,393
"064274103",1075,1137,2212,604,575,512
"064274109",1208,1152,2360,604,528,498
"064274206",494,555,1049,320,283,254
"064274209",851,837,1688,518,503,470
"064274403",719,782,1501,464,425,392
"064274407",299,357,656,200,209,172
"064274411",308,351,659,212,202,193
"064274510",573,637,1210,330,336,286
"064274605",961,939,1900,559,508,479
"064274706",424,459,883,167,58,54
"064275605",479,573,1052,268,227,221
"064274901",1042,1171,2213,548,515,474
"064274910",805,807,1612,379,318,308
"064274911",460,468,928,223,248,214
"064275003",599,625,1224,385,365,335
"064275010",580,628,1208,345,336,313
"065600102",764,760,1524,381,374,348
"064275303",513,503,1016,228,196,196
"064275307",870,967,1837,434,400,386
"065600302",926,965,1891,501,451,428
"064275410",1910,1934,3844,945,785,741
"064275505",691,818,1509,451,433,344
"064275512",912,1035,1947,501,421,392
"064275604",468,468,936,260,228,222
"064275610",654,731,1385,427,438,405
"064275613",476,542,1018,292,296,271
"064275708",475,538,1013,276,240,233
"064275715",366,397,763,207,196,189
"064275804",693,711,1404,382,327,308
"064275809",251,305,556,151,115,90
"064275812",478,499,977,281,234,225
"064275814",443,448,891,259,210,195
"064275906",438,444,882,236,245,221
"064275909",438,475,913,274,266,252
"064276112",545,591,1136,305,203,186
"064276103",747,907,1654,470,347,318
"064276104",960,992,1952,549,487,448
"064276201",556,606,1162,311,254,239
"064276205",1251,1370,2621,650,524,498
"064276206",618,654,1272,339,320,287
"064276208",423,406,829,258,247,225
"064276212",589,606,1195,340,307,284
"064276311",1059,1186,2245,511,350,341
"064276404",539,519,1058,285,215,198
"064276405",695,679,1374,329,233,226
"064276408",560,534,1094,298,204,191
"064276502",1012,1019,2031,493,345,330
"064276505",467,516,983,234,203,199
"064276507",1020,954,1974,478,348,336
"064276607",506,578,1084,305,286,276
"064276804",463,509,972,267,258,234
"064276809",558,573,1131,321,321,300
"064277002",664,670,1334,341,309,281
"064277003",646,661,1307,325,283,259
"064277009",681,649,1330,298,162,155
"064277105",425,436,861,236,188,180
"064277109",445,494,939,260,225,219
"064277201",1281,1312,2593,572,268,262
"064277207",560,532,1092,298,272,260
"064277304",638,598,1236,297,278,244
"064277307",1519,1723,3242,579,274,259
"064277310",1021,1007,2028,476,463,424
"064277314",650,655,1305,287,238,232
"064277402",1078,1132,2210,539,472,452
"064277411",1461,1646,3107,631,427,403
"064277416",590,605,1195,280,247,241
"064277606",793,836,1629,466,411,391
"064277607",1138,1180,2318,573,436,419
"064277608",988,1005,1993,511,454,345
"064277702",796,834,1630,440,416,403
"065601714",391,385,776,194,212,183
"064277713",598,579,1177,339,309,284
"064277716",494,542,1036,293,287,266
"064278007",727,703,1430,350,290,284
"064278010",404,418,822,205,207,202
"064278012",532,521,1053,251,255,223
"064278015",449,474,923,230,209,192
"064278102",656,695,1351,347,249,239
"064278201",1035,994,2029,461,359,356
"064278208",865,894,1759,420,343,323
"064278211",740,709,1449,318,238,231
"064278303",763,846,1609,413,348,330
"064278402",537,513,1050,260,388,256
"064278403",677,654,1331,342,261,245
"064278410",726,701,1427,337,314,299
"064278504",574,604,1178,300,323,291
"064278508",399,462,861,247,237,212
"064278509",890,904,1794,512,483,437
"065602206",409,428,837,257,268,249
"064278602",573,596,1169,318,327,292
"064278608",545,552,1097,275,278,250
"064278609",577,636,1213,317,298,274
"064278702",604,652,1256,325,285,269
"064278710",656,649,1305,353,306,292
"064278807",607,654,1261,340,327,296
"064279008",703,715,1418,373,357,349
"064278908",1098,1030,2128,535,445,424
"064279107",592,611,1203,342,299,288
"064279111",428,445,873,261,196,192
"064279113",237,235,472,164,269,111
"064279204",956,968,1924,447,418,385
"064279303",737,737,1474,334,308,291
"065151804",804,800,1604,378,359,342
"064279401",979,1067,2046,477,380,358
"064279402",899,945,1844,444,407,383
"064279405",1195,1178,2373,515,491,465
"064340710",309,361,670,216,234,212
"064279602",837,844,1681,389,397,341
"064279605",1075,1028,2103,462,244,218
"065681704",305,356,661,234,219,198
"064340301",444,541,985,340,379,332
"064279702",2348,2255,4603,934,405,384
"064279707",952,922,1874,412,422,347
"065151809",428,408,836,235,166,156
"064340205",333,445,778,293,363,292
"064340207",84,81,165,60,70,59
"064340303",714,815,1529,522,601,482
"064340307",435,526,961,341,363,305
"064340402",400,426,826,286,312,266
"064340508",432,462,894,310,337,298
"064340604",478,530,1008,341,341,296
"064340701",437,402,839,236,226,217
"064340705",521,489,1010,284,277,268
"064340811",613,637,1250,309,260,260
"064340910",496,554,1050,294,229,211
"064341005",360,365,725,239,228,208
"064341007",506,543,1049,332,364,325
"064341107",302,345,647,198,220,197
"065740407",369,424,793,291,353,290
"064341201",468,523,991,345,355,326
"064341204",503,550,1053,355,400,343
"064341310",480,534,1014,334,335,312
"064341312",528,546,1074,319,323,296
"065740701",216,234,450,169,221,168
"064341406",436,437,873,322,345,302
"064341502",293,371,664,298,493,296
"064341508",251,327,578,249,314,226
"064341513",418,487,905,338,450,327
"064341605",213,264,477,196,247,194
"064341701",341,404,745,268,293,262
"064341706",263,308,571,198,231,186
"064341904",413,466,879,313,359,304
"064341906",455,508,963,325,361,303
"064342101",471,514,985,344,345,328
"064342103",364,359,723,269,295,261
"064342109",280,326,606,213,243,209
"064342307",313,298,611,191,158,150
"064342404",345,362,707,231,247,217
"064342506",486,455,941,247,206,195
"064342508",501,554,1055,329,335,298
"064342514",359,411,770,249,258,225
"064342515",323,364,687,214,205,189
"064342605",263,266,529,119,67,67
"064342609",464,396,860,220,159,149
"064342613",662,688,1350,361,289,278
"064342807",399,427,826,260,273,258
"064342809",611,660,1271,430,405,346
"064342810",545,638,1183,385,400,365
"064342909",480,560,1040,350,376,330
"064342910",295,316,611,186,220,182
"064342911",284,297,581,197,214,185
"064343002",311,332,643,222,264,222
"064343003",393,413,806,289,331,283
"064343005",453,451,904,316,390,307
"064343008",314,335,649,240,270,227
"064343102",284,329,613,211,236,198
"064343107",190,255,445,185,211,166
"064343301",410,441,851,285,325,275
"064343306",468,516,984,325,349,312
"064343413",542,580,1122,347,344,316
"064343509",400,455,855,285,291,264
"064343607",320,388,708,251,285,245
"064343702",355,412,767,295,333,262
"064343706",430,491,921,336,368,301
"064343904",289,326,615,228,235,205
"064344001",526,552,1078,348,371,319
"064344005",275,298,573,195,223,190
"064344103",523,557,1080,392,438,374
"064344104",506,524,1030,321,343,309
"064344402",433,451,884,276,251,236
"064344404",286,328,614,182,194,171
"064344407",671,740,1411,456,438,406
"064344502",880,876,1756,485,462,444
"064344503",578,589,1167,295,247,242
"064410105",257,302,559,228,295,227
"064410303",200,232,432,189,210,180
"064410409",265,342,607,290,377,285
"064410502",321,321,642,276,338,268
"064410503",259,271,530,224,272,222
"064410506",301,305,606,219,270,181
"064410604",153,201,354,190,292,184
"064410605",297,330,627,271,379,254
"064410609",271,330,601,298,396,282
"064411009",414,467,881,371,472,351
"064411105",232,307,539,228,276,225
"064411114",322,333,655,293,341,235
"064411203",126,175,301,149,225,132
"064411206",181,203,384,189,287,182
"064411210",77,134,211,106,182,105
"064411301",156,205,361,192,274,180
"064411306",156,178,334,149,232,145
"064411607",421,523,944,356,489,343
"064411405",229,326,555,301,423,291
"064411407",188,224,412,215,314,210
"064411505",230,320,550,276,391,275
"064411608",251,273,524,200,246,194
"064411610",459,533,992,398,483,381
"065950101",518,550,1068,291,310,277
"064411615",88,102,190,89,120,81
"064411701",212,241,453,192,232,187
"064411911",247,290,537,241,306,236
"065950602",33,32,65,22,23,10
"064412503",218,263,481,198,274,194
"064412403",238,284,522,186,220,181
"064412502",273,337,610,265,335,256
"065951911",480,473,953,313,371,308
"064412708",405,554,959,384,455,381
"064412709",459,500,959,347,404,344
"064412806",244,274,518,197,241,190
"064413003",406,459,865,285,318,276
"065952405",334,380,714,277,347,276
"064413108",242,302,544,211,240,204
"064413111",557,613,1170,400,453,390
"064413207",467,524,991,334,352,316
"064413309",526,623,1149,402,414,375
"064413503",262,278,540,207,217,204
"064413604",323,353,676,220,215,203
"064413609",498,510,1008,309,315,290
"064413611",516,514,1030,314,334,297
"064413703",418,430,848,197,195,188
"064413806",519,719,1238,307,333,294
"064413810",444,502,946,305,293,280
"064413906",471,489,960,303,310,285
"064414105",694,676,1370,403,419,377
"064414111",237,181,418,123,128,95
"064414201",1068,989,2057,508,527,488
"064414302",403,473,876,297,315,274
"064414309",597,569,1166,367,445,354
"064414410",1324,1247,2571,602,593,552
"064414601",484,504,988,295,303,275
"064414603",480,482,962,283,300,273
"064414702",637,633,1270,368,349,317
"064414705",568,586,1154,360,339,287
"064414803",302,377,679,244,263,239
"064414807",438,511,949,332,349,315
"064414808",302,316,618,197,203,195
"064415001",256,297,553,198,216,187
"064415010",308,387,695,263,294,259
"064415104",434,476,910,292,306,261
"064415108",350,435,785,282,319,268
"064415209",264,268,532,186,212,179
"064415302",521,593,1114,377,413,368
"064415304",427,468,895,297,330,292
"064415306",322,343,665,234,258,225
"064415401",507,509,1016,299,319,290
"064415409",283,310,593,214,238,207
"064415417",573,590,1163,354,397,336
"064415504",375,399,774,230,229,217
"064415510",226,222,448,130,126,119
"064415605",574,636,1210,403,471,391
"064415704",352,388,740,241,263,239
"064415705",584,649,1233,364,410,349
"066230504",418,540,958,322,327,308
"064415906",333,329,662,224,242,212
"064415909",440,420,860,267,279,259
"064416008",348,380,728,223,271,212
"064416210",306,344,650,183,206,172
"064416516",396,468,864,263,272,239
"064416213",672,678,1350,351,392,338
"064416301",327,335,662,216,271,209
"064416308",276,289,565,184,222,176
"064416311",234,217,451,140,234,138
"064416406",272,290,562,155,187,151
"064416407",228,254,482,157,144,108
"064416413",166,163,329,91,124,90
"064416515",542,558,1100,312,347,300
"065151901",829,857,1686,451,454,412
"064416505",173,187,360,72,40,24
"066232905",396,445,841,247,271,244
"064760105",258,273,531,209,238,207
"064416518",350,351,701,186,175,149
"064416608",460,489,949,295,316,274
"066380201",654,691,1345,341,435,335
"064416902",566,552,1118,339,378,324
"064416908",684,655,1339,349,361,330
"064480607",358,443,801,285,340,281
"064551406",377,454,831,321,359,303
"064551410",446,463,909,284,326,282
"064620406",147,148,295,110,129,110
"064690111",422,435,857,297,323,287
"064690602",671,681,1352,413,427,400
"064690603",386,379,765,243,257,239
"064691007",276,264,540,171,207,169
"064691101",115,119,234,94,126,93
"064760101",403,424,827,233,235,224
"066440404",55,63,118,47,344,46
"064761402",446,464,910,283,289,275
"064761404",385,370,755,257,291,255
"064830112",310,406,716,205,220,202
"064830406",177,167,344,109,118,100
"064900202",1002,1043,2045,534,345,333
"064900110",296,289,585,166,171,164
"064900208",1006,1003,2009,549,452,437
"064900301",589,608,1197,342,308,294
"064900303",476,491,967,277,220,207
"064900306",703,757,1460,406,355,332
"064900307",428,487,915,274,237,219
"064900310",980,988,1968,503,513,466
"064900311",238,252,490,159,142,130
"064900401",680,709,1389,411,326,304
"064900404",526,472,998,246,227,222
"064900514",581,575,1156,320,338,316
"064900605",325,344,669,222,225,198
"064900608",558,673,1231,366,381,360
"064900705",548,588,1136,361,368,342
"064900712",538,565,1103,351,321,280
"064900905",535,585,1120,392,416,371
"064901111",172,243,415,184,296,184
"064901116",422,481,903,357,446,354
"064901301",500,556,1056,381,410,368
"064901304",288,330,618,219,210,201
"064901313",482,522,1004,316,272,269
"064901403",356,379,735,212,191,175
"064901407",373,432,805,283,283,266
"064901412",763,758,1521,418,246,233
"064901505",517,583,1100,312,199,192
"064901509",315,369,684,178,105,97
"064901706",646,737,1383,398,354,340
"064901707",617,642,1259,395,398,347
"064901804",559,621,1180,404,369,344
"064901811",562,599,1161,349,362,333
"064901815",788,865,1653,479,415,398
"064901905",349,420,769,278,324,272
"064901907",498,583,1081,381,388,357
"064901908",362,395,757,253,259,238
"064902007",526,584,1110,376,405,359
"064902110",358,449,807,337,419,333
"064902204",134,211,345,204,326,201
"064902209",252,390,642,197,354,197
"064902307",291,328,619,234,305,231
"064902507",385,409,794,283,330,273
"064902601",421,457,878,316,352,310
"064902609",204,235,439,157,192,155
"064902802",326,378,704,227,206,193
"064902905",654,604,1258,335,312,295
"064902909",662,737,1399,430,423,401
"064903010",525,599,1124,358,394,351
"064903106",718,755,1473,407,371,348
"064903107",679,653,1332,377,341,323
"064903203",724,741,1465,358,328,314
"064903305",856,895,1751,474,391,358
"064903307",454,451,905,224,226,205
"064903403",532,616,1148,320,258,239
"064903407",516,547,1063,287,232,220
"064903408",430,477,907,252,165,147
"064903412",637,660,1297,333,274,261
"064903507",588,628,1216,403,445,396
"064903513",924,963,1887,461,399,388
"064903602",832,863,1695,427,349,339
"064903606",632,651,1283,361,294,271
"064903611",551,590,1141,282,198,197
"064903803",376,357,733,179,138,132
"064903906",853,807,1660,472,361,330
"064903908",568,558,1126,287,270,248
"064903915",1186,1244,2430,640,573,524
"064904006",1207,1215,2422,618,432,416
"064904008",893,852,1745,423,382,372
"064904201",397,415,812,282,283,253
"064904408",536,561,1097,354,373,341
"064904303",373,437,810,280,289,268
"064904311",272,333,605,214,224,201
"064904312",406,487,893,294,277,260
"064904413",516,548,1064,286,265,250
"064904703",267,323,590,209,196,178
"064904705",373,451,824,289,316,285
"064904713",390,426,816,259,307,255
"065391308",518,557,1075,360,368,334
"065391408",610,634,1244,347,310,290
"065391415",467,488,955,271,273,250
"060630502",25,16,41,16,21,16
"061470306",8,7,15,7,20,7
"065391509",320,394,714,257,263,245
"061680104",15,15,30,10,17,10
"060070305",4,3,7,4,11,4
"060070510",5,3,8,3,10,3
"065391601",370,397,767,237,260,234
"060070903",9,5,14,7,20,7
"060070904",6,4,10,6,10,6
"060070905",4,0,4,3,11,3
"060071010",16,15,31,10,13,10
"060071102",0,0,0,0,7,0
"060071105",9,5,14,4,7,4
"061820401",35,24,59,22,43,21
"060141501",4,3,7,3,16,3
"060210203",26,16,42,14,31,14
"061890304",2,1,3,2,10,2
"060210301",10,6,16,7,19,7
"060210502",18,13,31,11,19,11
"061891406",8,3,11,6,10,5
"062170603",11,14,25,9,28,9
"060490401",199,173,372,128,232,123
"065600715",763,772,1535,406,381,370
"060491501",62,29,91,35,57,35
"060492102",105,64,169,48,79,44
"060492401",35,21,56,19,35,19
"060562901",28,15,43,17,36,17
"060563204",180,146,326,113,122,91
"060630403",36,19,55,23,61,23
"060770403",26,14,40,16,21,15
"060700501",59,48,107,42,85,39
"060770301",27,16,43,13,15,13
"060700702",27,32,59,19,30,19
"060700901",6,6,12,7,13,7
"060701003",30,17,47,19,33,19
"065391712",349,377,726,255,268,239
"060770601",33,34,67,21,25,21
"060770602",47,37,84,31,50,28
"060770603",53,23,76,18,31,18
"060771003",11,8,19,8,11,8
"060771201",28,32,60,21,20,20
"060840101",30,27,57,19,23,19
"060840603",9,7,16,6,11,6
"065391804",458,510,968,308,342,290
"065391806",745,714,1459,402,396,371
"062940102",7,3,10,2,22,2
"061050901",62,43,105,42,106,42
"061051304",118,108,226,79,135,77
"061120307",12,11,23,10,14,10
"061120504",7,4,11,4,18,4
"061120706",16,10,26,7,12,7
"061120903",15,12,27,11,15,10
"061121203",7,8,15,6,12,6
"063220103",17,12,29,11,15,11
"063220304",30,27,57,18,38,18
"061190204",61,28,89,28,31,25
"061190405",40,28,68,26,42,24
"068052610",314,283,597,222,521,213
"061340802",21,17,38,14,27,14
"061340803",44,43,87,31,51,31
"061340902",271,204,475,162,232,156
"065392006",652,689,1341,366,337,321
"061400313",16,13,29,13,25,13
"061470403",22,13,35,15,57,15
"061400501",44,24,68,19,23,19
"061470502",22,19,41,14,22,14
"061470903",12,8,20,9,26,9
"061540208",38,43,81,30,35,30
"061540404",20,14,34,12,47,12
"061540703",25,23,48,15,29,15
"061610301",54,37,91,30,41,29
"061610405",79,65,144,47,71,46
"061610504",62,49,111,33,41,33
"061610802",27,22,49,16,21,10
"065392008",793,823,1616,464,448,427
"061680702",12,11,23,7,15,7
"061680801",28,18,46,17,29,17
"061681102",21,14,35,14,18,14
"061750504",6,3,9,5,28,5
"061820603",30,21,51,18,37,14
"065392101",421,458,879,277,293,264
"061890703",15,14,29,11,19,11
"061890704",4,3,7,2,3,2
"061890707",14,5,19,10,16,9
"061890803",8,2,10,4,8,4
"061890902",16,12,28,16,20,10
"061891204",4,3,7,3,8,3
"061891305",3,3,6,2,7,2
"061891404",2,2,4,2,9,2
"061891603",21,10,31,11,21,10
"061891605",5,0,5,4,22,4
"061891701",35,32,67,23,29,23
"061960402",22,15,37,10,21,10
"061960601",12,6,18,7,15,7
"061960801",13,8,21,9,13,9
"061960902",11,8,19,5,26,5
"061961005",18,18,36,13,26,13
"061961203",11,6,17,6,19,6
"062030601",14,7,21,9,19,9
"061961206",11,5,16,9,21,8
"061961305",20,11,31,11,21,11
"061961403",13,14,27,10,16,8
"062030208",13,12,25,10,43,10
"062030306",14,10,24,9,17,9
"062030405",9,5,14,6,13,6
"062030407",11,7,18,5,15,5
"065392207",787,807,1594,477,436,415
"062030505",12,5,17,7,23,7
"062030507",2,4,6,3,9,3
"065392303",597,565,1162,310,311,300
"062030907",5,4,9,5,6,5
"062031202",15,6,21,6,15,6
"062100610",28,21,49,21,39,21
"065392313",752,744,1496,357,317,307
"062170207",32,16,48,15,30,15
"062170507",33,29,62,20,32,20
"065392404",777,788,1565,424,391,379
"065392405",540,573,1113,300,292,279
"063920603",14,9,23,7,28,7
"065392507",601,602,1203,329,353,320
"065392512",438,470,908,220,223,210
"062240703",21,16,37,15,28,14
"068120401",58,51,109,30,31,19
"062241001",14,16,30,9,22,9
"065392606",657,666,1323,344,343,325
"062242005",38,24,62,18,37,17
"062242103",13,10,23,7,19,7
"062310602",14,16,30,8,11,7
"062310902",64,42,106,37,62,37
"062311214",60,60,120,39,51,36
"062381001",10,5,15,8,41,8
"062520301",94,89,183,52,63,51
"062520602",3,2,5,3,4,3
"062770201",54,46,100,31,48,31
"062800502",21,17,38,13,23,13
"062800505",9,6,15,9,12,9
"062800809",30,18,48,17,25,17
"062870101",148,97,245,91,160,91
"062870417",10,1,11,7,11,6
"062940301",11,13,24,10,13,10
"063081001",51,27,78,39,101,39
"063220803",22,14,36,16,14,13
"063220801",12,10,22,8,13,8
"063221101",22,11,33,11,18,11
"063221102",21,10,31,12,20,12
"063430301",46,37,83,30,62,28
"063510201",95,81,176,50,84,50
"063510302",11,12,23,7,15,7
"063510405",36,21,57,15,30,15
"063510612",6,11,17,4,13,4
"067562407",266,286,552,194,205,191
"063577917",96,78,174,43,49,42
"067631815",326,309,635,177,198,166
"063578201",59,38,97,35,54,35
"064480102",13,8,21,8,14,8
"064131104",NA,NA,NA,NA,NA,NA
"063850303",18,16,34,13,33,11
"063850403",21,14,35,13,28,13
"063851102",68,36,104,19,50,19
"063920201",39,17,56,19,33,19
"063920804",25,16,41,17,47,17
"063920905",31,25,56,20,31,20
"063921001",32,28,60,19,42,18
"063921505",21,13,34,13,24,12
"063990202",72,48,120,38,61,38
"065600807",750,692,1442,378,363,327
"065180502",12,9,21,11,20,10
"065392905",196,185,381,92,102,86
"064200501",10,4,14,4,6,4
"065881604",21,18,39,11,31,11
"064416816",281,233,514,167,201,166
"064480201",19,16,35,10,16,10
"064480501",25,24,49,11,14,10
"064480503",7,5,12,4,14,4
"064480702",2,3,5,1,13,1
"064480703",8,7,15,5,13,5
"064480904",13,7,20,6,9,6
"064481201",9,6,15,7,13,7
"064550602",19,14,33,18,33,18
"065392908",204,200,404,111,116,99
"064551101",94,73,167,59,124,58
"064620501",11,12,23,6,32,6
"064620709",15,10,25,9,13,9
"064690504",9,10,19,6,12,6
"064690804",49,39,88,38,73,38
"064691103",6,2,8,5,16,5
"064691201",15,10,25,8,11,8
"064691403",36,39,75,24,45,24
"064691506",27,24,51,16,36,16
"064760504",30,18,48,15,26,15
"065600811",452,491,943,274,272,235
"064760702",86,66,152,48,64,47
"064760901",33,21,54,19,28,18
"064761001",60,40,100,30,47,30
"064830601",54,52,106,32,35,31
"064830703",49,46,95,30,56,30
"064830902",70,48,118,41,58,39
"064831001",43,34,77,29,54,29
"066511002",6,0,6,4,18,4
"064970204",28,28,56,20,32,20
"064970805",73,81,154,48,71,48
"064970901",64,39,103,29,54,29
"064971007",21,20,41,11,13,11
"064971310",74,78,152,29,34,29
"065050103",125,99,224,72,89,57
"065050208",33,29,62,24,38,24
"065050106",21,18,39,15,22,15
"065050204",187,169,356,108,187,105
"066720404",25,18,43,15,34,15
"066721212",68,48,116,43,79,43
"065110304",69,57,126,42,62,41
"065110401",46,48,94,31,43,30
"066861103",16,14,30,13,41,13
"067000502",10,8,18,6,31,6
"067000808",0,0,0,0,12,0
"065180403",11,9,20,6,23,6
"065180509",3,2,5,3,8,3
"065180615",14,9,23,9,16,9
"065180813",14,8,22,7,15,7
"065180814",6,4,10,3,3,3
"065250201",64,52,116,32,30,21
"065320803",26,22,48,14,34,13
"065321005",52,33,85,23,37,23
"065321103",33,30,63,25,54,25
"065321104",18,11,29,11,14,11
"065600812",384,421,805,232,250,214
"065393316",21,23,44,14,18,10
"065600908",164,157,321,78,89,69
"065740302",65,45,110,32,50,32
"065740401",132,121,253,71,94,69
"065740703",40,34,74,27,44,27
"065810704",35,21,56,19,25,17
"065601003",498,546,1044,314,343,292
"065601102",650,666,1316,384,386,368
"065392925",593,562,1155,309,276,249
"065810808",28,33,61,18,30,18
"065810903",10,2,12,8,17,6
"065810907",6,4,10,4,4,3
"065811002",38,26,64,22,50,22
"065811004",7,4,11,7,18,7
"065811107",33,29,62,23,100,19
"065811109",32,5,37,5,14,5
"065601111",797,809,1606,427,421,377
"065811207",24,15,39,17,26,17
"065880502",32,16,48,17,48,17
"065881202",13,10,23,9,16,8
"065881305",44,27,71,26,51,26
"065881605",4,3,7,5,20,5
"065881606",21,18,39,12,27,12
"065881608",15,18,33,10,23,10
"065881609",6,2,8,3,14,3
"065950802",109,84,193,58,111,58
"065951701",71,62,133,46,62,46
"066021001",13,5,18,13,47,13
"065393105",564,573,1137,321,350,306
"066021401",57,34,91,38,114,37
"066021501",1,0,1,1,3,1
"066090604",6,5,11,6,13,6
"066090701",7,5,12,4,11,4
"066090804",6,7,13,5,8,5
"065393108",560,576,1136,282,289,278
"066091102",35,24,59,18,24,18
"066091302",19,14,33,11,33,11
"066091402",30,24,54,20,36,20
"066160104",89,50,139,64,71,49
"066230601",4,5,9,4,25,4
"066230802",14,9,23,9,14,9
"066231403",40,35,75,25,51,25
"066231503",24,18,42,13,25,13
"066232105",31,33,64,22,25,21
"066300401",70,48,118,48,73,47
"066510706",10,6,16,8,29,8
"068750101",14,11,25,11,24,9
"068751101",24,6,30,12,29,12
"068821708",313,262,575,193,287,160
"066510112",13,6,19,6,12,6
"066510301",14,14,28,11,18,11
"066510501",5,2,7,3,3,3
"066510502",5,4,9,3,10,3
"066510702",18,11,29,12,21,12
"066510602",9,7,16,7,29,7
"066510604",15,7,22,10,20,10
"066510606",19,16,35,9,18,9
"066510607",18,16,34,13,16,12
"066510808",16,14,30,11,18,11
"066510816",3,1,4,3,14,3
"066511104",11,10,21,10,17,10
"066511202",16,13,29,9,9,9
"066550104",53,35,88,29,45,29
"066550106",26,24,50,19,42,19
"066651004",33,21,54,23,34,23
"066720604",8,6,14,6,14,6
"066720801",16,19,35,13,13,12
"066720503",14,6,20,8,22,8
"066720603",6,4,10,4,15,4
"066720902",22,8,30,13,36,13
"066721102",18,10,28,16,29,16
"066721104",22,18,40,15,26,15
"066721301",19,17,36,13,24,13
"066790403",19,14,33,11,14,10
"066790801",30,21,51,21,32,21
"066790903",25,24,49,13,21,13
"066791002",15,12,27,10,26,10
"066860205",4,1,5,3,17,3
"065393209",457,428,885,235,226,212
"066860705",11,12,23,7,15,7
"066860707",26,23,49,16,37,16
"066861204",11,8,19,7,13,7
"067000201",18,10,28,14,22,14
"067000806",4,3,7,3,17,3
"067000809",7,4,11,5,12,5
"067000902",7,2,9,5,17,5
"067001002",16,10,26,8,13,8
"067001101",20,18,38,14,30,14
"067001202",18,19,37,16,24,15
"067070201",30,15,45,26,53,25
"067070601",14,8,22,9,13,8
"067070608",47,43,90,31,74,31
"067071001",39,31,70,23,40,23
"067140201",12,14,26,6,15,6
"067140205",12,9,21,7,17,7
"067140206",13,10,23,10,12,10
"067140806",114,81,195,64,111,64
"067140903",17,8,25,12,30,12
"067140904",30,26,56,18,28,18
"067210209",27,22,49,23,31,18
"067280204",26,14,40,15,29,15
"067280401",25,33,58,16,19,16
"067280502",14,10,24,9,17,9
"067280702",30,24,54,8,19,8
"067280902",164,131,295,90,100,90
"067281101",8,6,14,6,8,6
"067281503",36,21,57,22,36,22
"067350203",7,7,14,4,10,4
"067350302",44,41,85,26,49,24
"067350303",26,18,44,15,35,15
"067350501",20,14,34,8,13,8
"065601114",599,578,1177,342,379,323
"065393416",77,79,156,45,56,45
"065470305",415,420,835,241,272,234
"067631103",21,26,47,17,26,17
"067700701",11,17,28,9,9,8
"067700906",81,69,150,44,54,44
"067701204",18,14,32,8,14,8
"067701402",22,20,42,15,26,15
"067701703",9,6,15,4,13,4
"067701805",29,32,61,16,25,15
"067780801",25,30,55,16,35,16
"067840601",14,13,27,10,18,10
"067840301",8,8,16,7,17,6
"067840501",20,13,33,7,11,7
"067840502",17,11,28,6,12,6
"067910701",102,63,165,55,79,53
"067910906",75,67,142,51,82,51
"067911504",79,57,136,46,54,46
"067980301",28,12,40,14,18,14
"067980302",33,16,49,21,31,21
"067980507",24,12,36,13,20,13
"067980901",38,19,57,19,33,19
"067981006",12,8,20,6,16,6
"065470311",172,169,341,118,245,116
"065470902",582,537,1119,318,371,307
"065530101",340,394,734,253,384,242
"065530105",124,115,239,78,313,75
"068052614",61,54,115,37,168,36
"065530205",65,53,118,52,429,52
"065600115",532,499,1031,275,307,268
"065601207",487,503,990,287,275,259
"065601212",492,510,1002,262,263,256
"065600311",664,722,1386,383,407,373
"065600314",451,458,909,235,236,217
"065600502",673,693,1366,386,392,368
"065600506",108,105,213,59,58,55
"065600609",750,812,1562,445,447,404
"065600614",378,403,781,214,224,209
"065600702",580,590,1170,337,347,327
"065180716",129,145,274,101,385,98
"065250106",528,579,1107,317,351,295
"065250608",411,403,814,236,262,223
"065250403",466,447,913,228,235,219
"065250404",717,698,1415,352,349,330
"065250605",291,336,627,196,207,183
"065250606",665,698,1363,497,543,482
"065250611",651,741,1392,483,553,471
"065320102",475,553,1028,377,408,362
"065320202",361,428,789,295,352,289
"065320307",572,554,1126,309,283,259
"065320310",486,475,961,277,273,257
"065321403",431,531,962,352,411,343
"065321502",509,524,1033,315,360,302
"065390201",369,382,751,238,247,221
"065390207",579,650,1229,391,370,350
"065390310",642,695,1337,439,468,426
"065390407",189,265,454,185,249,183
"065390504",514,603,1117,343,341,321
"065390507",611,632,1243,404,414,390
"065390509",590,646,1236,418,439,410
"065390601",629,707,1336,442,424,405
"065390607",800,828,1628,484,458,438
"065390704",900,925,1825,543,502,472
"065390804",443,474,917,262,266,253
"065390815",584,561,1145,310,292,289
"065391003",746,752,1498,354,331,315
"067560605",210,272,482,240,318,238
"065391116",739,731,1470,409,382,359
"065391204",944,951,1895,497,489,464
"062311210",377,415,792,289,335,287
"067560604",106,149,255,134,220,132
"061050208",166,205,371,151,226,150
"062450409",403,401,804,231,272,221
"061051408",138,133,271,79,119,78
"061120801",8,9,17,7,12,7
"061190203",195,159,354,112,253,109
"061190502",63,42,105,30,77,30
"061260516",720,645,1365,349,405,323
"061400310",349,361,710,192,212,184
"061540205",224,243,467,133,153,129
"061820702",401,408,809,199,232,193
"062450309",675,687,1362,392,398,367
"062520101",308,289,597,147,157,142
"062601712",204,185,389,108,217,106
"062660204",640,674,1314,309,312,287
"062660602",393,321,714,223,583,216
"062700106",482,258,740,169,278,165
"062770106",67,48,115,45,304,44
"063150302",185,181,366,105,124,103
"063850401",85,69,154,63,99,62
"064416521",167,140,307,113,383,111
"064060302",87,74,161,47,65,42
"064131902",316,330,646,165,187,154
"064278412",733,719,1452,401,411,357
"064416811",173,170,343,111,204,110
"064416813",63,51,114,36,94,36
"064970402",100,82,182,60,105,59
"064970815",584,513,1097,318,321,230
"064971211",243,259,502,130,208,123
"066160102",42,31,73,24,40,17
"066160105",39,34,73,26,37,25
"065391011",841,857,1698,445,434,409
"065391016",904,897,1801,458,547,433
"065470901",574,563,1137,218,395,208
"065530204",696,652,1348,387,752,367
"065740707",40,35,75,22,51,22
"066650303",452,409,861,237,282,225
"065951901",2353,269,2622,157,208,156
"066232001",408,317,725,227,367,225
"066232209",109,142,251,83,97,81
"066860805",50,45,95,33,51,32
"066232504",117,119,236,76,98,75
"066380105",314,318,632,190,366,180
"066381102",317,304,621,147,145,126
"066382004",46,54,100,25,32,22
"066382305",10,6,16,6,25,6
"067280904",446,437,883,224,252,215
"067140901",93,98,191,51,83,50
"067980708",693,735,1428,413,500,404
"067631903",136,110,246,65,90,65
"067632001",169,197,366,105,153,99
"067780109",389,345,734,241,293,232
"068260402",46,55,101,42,70,42
"068331901",482,474,956,272,298,252
"068540403",121,103,224,81,143,81
"068821101",384,318,702,232,302,223
"060980401",95,95,190,55,74,54
"065681403",591,660,1251,447,506,416
"065681406",273,296,569,207,250,201
"065681510",420,458,878,305,328,297
"065681606",486,556,1042,350,371,342
"065681711",399,476,875,311,354,306
"065681803",191,231,422,178,271,177
"065682001",463,553,1016,344,420,339
"065682009",565,645,1210,409,449,397
"065682110",157,199,356,174,276,168
"065682112",227,247,474,246,382,246
"065682402",461,470,931,310,336,297
"065682509",555,587,1142,316,302,291
"065682512",633,678,1311,403,411,370
"065682606",315,336,651,218,220,186
"065682607",616,693,1309,412,405,364
"065682806",659,661,1320,353,359,342
"065682808",499,540,1039,289,293,273
"065682903",464,443,907,259,253,238
"065682914",516,527,1043,262,263,242
"065683003",686,777,1463,441,442,416
"065683004",725,783,1508,457,456,425
"065740405",454,430,884,254,292,245
"065810104",545,644,1189,381,387,363
"065810203",124,178,302,144,213,140
"065810401",483,500,983,360,391,332
"065810404",315,317,632,232,277,230
"065810801",284,310,594,188,225,188
"068052311",417,397,814,212,217,186
"065811410",397,455,852,268,268,250
"065811412",587,646,1233,395,425,374
"065811506",450,471,921,279,249,231
"065811510",437,432,869,307,325,294
"065811702",274,344,618,238,289,232
"065811905",505,527,1032,269,325,262
"065880111",534,589,1123,416,480,409
"065811908",502,551,1053,351,389,338
"065880103",460,546,1006,381,465,371
"065880109",308,345,653,233,271,226
"065880202",451,497,948,336,378,327
"065881012",180,215,395,137,183,136
"065881401",147,151,298,101,169,100
"065881602",488,498,986,336,391,331
"065881704",473,472,945,318,349,305
"065881706",371,421,792,326,401,321
"065881707",241,304,545,237,292,231
"065881708",264,320,584,211,282,209
"065950109",414,426,840,260,279,258
"065950205",204,264,468,224,264,180
"065950207",329,390,719,305,346,295
"065950411",355,379,734,243,273,235
"068260403",346,428,774,281,341,279
"065951907",159,159,318,105,138,105
"065952001",359,372,731,256,280,249
"065952502",306,340,646,262,297,241
"065952602",853,919,1772,421,444,413
"065952609",410,418,828,247,258,232
"065952702",777,775,1552,444,485,434
"065952710",259,284,543,193,209,188
"068330801",31,32,63,23,59,23
"066020308",692,705,1397,437,478,422
"066020806",18,22,40,15,37,15
"066021108",604,680,1284,429,482,419
"066021110",12,7,19,10,10,10
"066021604",365,386,751,229,277,227
"066021606",397,446,843,300,321,278
"066021607",334,366,700,279,298,254
"066090101",694,708,1402,408,407,399
"066090203",207,261,468,204,270,198
"066090205",374,452,826,329,391,324
"066090213",696,700,1396,433,458,407
"066090401",133,149,282,90,120,90
"066090613",109,102,211,71,200,69
"066091101",28,21,49,13,15,13
"066160301",355,339,694,230,253,220
"066230103",528,618,1146,400,442,385
"066230104",454,515,969,364,424,360
"066230202",287,384,671,247,320,238
"066230307",204,328,532,257,372,251
"066230405",429,502,931,332,360,317
"066230406",517,613,1130,404,429,393
"066230409",519,544,1063,302,325,285
"066230506",545,686,1231,405,427,395
"067491406",583,648,1231,327,319,301
"066230903",137,149,286,95,105,94
"066232005",555,596,1151,294,297,281
"066232010",448,453,901,258,274,252
"066232207",438,535,973,328,353,318
"068540211",367,376,743,261,266,236
"066232807",504,572,1076,345,357,325
"066232808",636,635,1271,363,376,346
"066232909",470,437,907,274,256,247
"066232911",419,416,835,230,249,220
"066380104",202,189,391,107,161,101
"068610305",236,319,555,280,310,261
"066380203",492,496,988,252,233,222
"066380301",853,851,1704,380,365,344
"066380304",1085,1080,2165,533,503,477
"066380308",231,239,470,142,318,141
"066380503",144,158,302,84,132,82
"066380504",121,121,242,57,115,56
"066380409",404,365,769,248,349,239
"066380410",465,454,919,291,387,281
"066380601",695,738,1433,387,386,341
"066380609",244,241,485,154,216,142
"066380701",1067,1090,2157,528,426,390
"066380708",349,332,681,215,332,208
"066380810",307,295,602,199,323,190
"066380906",758,736,1494,403,447,389
"066380910",621,633,1254,362,328,322
"066381107",588,703,1291,372,370,328
"066381204",292,336,628,94,127,91
"066381208",21,22,43,15,352,15
"066381307",831,868,1699,484,446,405
"066381313",656,715,1371,387,676,381
"066381317",187,218,405,112,174,109
"066381404",514,530,1044,280,279,248
"066381408",719,748,1467,355,342,321
"066381507",805,852,1657,474,470,424
"066381606",475,503,978,319,355,315
"066381703",461,455,916,327,450,308
"066381706",235,267,502,193,230,190
"066381708",390,443,833,352,490,337
"066381709",144,192,336,165,300,161
"066381714",359,433,792,340,527,329
"066381805",221,268,489,149,164,141
"066382005",411,409,820,221,256,212
"066382204",800,773,1573,393,356,338
"066382101",252,168,420,114,142,114
"066382211",398,305,703,170,169,125
"066440109",20,15,35,12,150,12
"066440207",133,137,270,99,449,90
"066440615",421,407,828,243,295,221
"066440306",62,76,138,49,198,49
"066440307",118,136,254,92,439,89
"066440311",89,67,156,58,363,57
"066440406",35,36,71,26,389,26
"066440501",59,53,112,42,548,41
"066440512",84,83,167,79,412,79
"066440513",23,33,56,35,357,35
"066440604",158,190,348,121,313,120
"066440605",124,138,262,91,291,84
"066440609",451,410,861,235,242,220
"066440616",154,165,319,120,297,117
"066440617",86,84,170,57,222,55
"066480101",678,676,1354,360,358,338
"066480111",665,689,1354,348,353,327
"066480117",492,501,993,274,293,260
"066480213",645,684,1329,404,417,379
"066480307",481,500,981,233,241,219
"066480308",936,925,1861,449,445,412
"066480404",690,661,1351,318,347,308
"066480510",469,513,982,255,260,229
"066510107",230,273,503,183,211,180
"066510109",268,294,562,227,257,225
"066510504",275,309,584,211,257,210
"066510701",172,187,359,141,169,140
"066511308",161,145,306,122,157,122
"066550203",281,302,583,220,282,218
"066550205",370,387,757,233,276,230
"066550305",79,81,160,65,267,65
"066580102",535,579,1114,378,405,365
"066580112",70,46,116,50,45,39
"066580404",479,495,974,271,273,259
"066580405",459,479,938,284,321,272
"066580502",236,261,497,171,181,164
"066580503",423,468,891,299,290,272
"066580705",328,372,700,269,315,267
"066580707",438,475,913,272,269,248
"066580907",179,235,414,195,297,192
"066581012",864,845,1709,427,428,401
"066581110",368,429,797,306,345,294
"066581213",296,372,668,264,320,247
"066581303",188,204,392,109,99,93
"066581309",450,449,899,268,249,236
"066581401",299,324,623,152,155,148
"066581402",134,132,266,65,67,61
"066581403",167,172,339,81,85,77
"066581404",385,354,739,188,188,172
"066581408",422,460,882,217,221,206
"066581505",579,619,1198,371,366,338
"066581510",334,337,671,233,261,227
"066581612",335,365,700,253,254,223
"066581709",471,514,985,364,410,346
"066581811",288,332,620,247,280,241
"066581904",219,255,474,193,220,192
"066581908",373,407,780,276,319,269
"066581910",431,426,857,277,340,272
"066581911",529,516,1045,305,295,278
"066582001",483,474,957,301,327,297
"066582009",910,1040,1950,566,554,497
"066582105",722,727,1449,392,381,363
"066582106",837,900,1737,469,453,427
"066582114",630,659,1289,366,374,346
"066582207",385,426,811,298,331,289
"066582309",675,694,1369,371,351,339
"066582407",459,503,962,323,348,312
"066582704",239,230,469,125,121,115
"066582901",625,669,1294,432,430,381
"066582905",501,554,1055,345,368,339
"066583004",344,394,738,262,292,260
"066583009",832,823,1655,457,417,397
"066583204",309,322,631,193,199,190
"066583207",689,873,1562,523,526,506
"066583304",742,794,1536,352,344,340
"066583403",525,567,1092,326,302,297
"066583404",523,566,1089,333,281,276
"066583505",387,432,819,271,259,226
"066583507",511,543,1054,335,314,286
"066583603",544,573,1117,367,376,321
"066583608",495,527,1022,293,300,290
"066583614",560,603,1163,310,264,248
"066583704",446,470,916,233,241,221
"066583710",499,514,1013,272,268,247
"066583811",920,924,1844,522,505,470
"066584009",389,405,794,195,181,180
"066584016",622,600,1222,339,350,337
"066584303",839,943,1782,498,468,439
"066584304",989,1001,1990,480,460,449
"066584310",385,444,829,232,239,229
"066584311",635,659,1294,363,363,343
"066584406",595,620,1215,349,333,310
"066584411",1018,952,1970,503,477,459
"066584413",292,290,582,145,140,132
"066584414",368,398,766,187,190,185
"066650101",387,399,786,239,270,230
"066650203",518,614,1132,401,442,398
"066650205",647,733,1380,451,467,434
"066650401",186,216,402,123,150,121
"067491411",201,186,387,97,96,95
"066860202",191,198,389,142,174,128
"066721203",456,476,932,333,363,323
"066721206",385,459,844,346,421,339
"066790603",369,380,749,238,270,231
"066790605",597,664,1261,389,436,379
"066790607",468,416,884,264,314,261
"066790609",362,354,716,244,310,244
"066860105",301,370,671,281,332,276
"066861302",394,337,731,198,224,194
"066861307",349,364,713,234,266,226
"066930309",216,238,454,180,207,177
"066930307",555,574,1129,434,479,420
"067000213",344,400,744,296,348,295
"067000206",330,315,645,227,254,222
"067000214",409,416,825,305,344,302
"067000606",246,311,557,183,226,183
"067000701",253,263,516,199,262,197
"067001205",291,286,577,182,206,181
"067070102",719,842,1561,458,506,447
"067070108",264,328,592,227,294,221
"067071109",260,300,560,218,279,217
"067140101",581,637,1218,408,468,397
"067140109",302,391,693,298,365,292
"067140112",370,452,822,298,351,294
"067140601",594,648,1242,330,343,313
"067140602",560,587,1147,339,342,328
"067140604",531,479,1010,256,261,242
"067140613",786,789,1575,471,500,445
"067140809",261,272,533,195,245,193
"067281008",261,278,539,186,198,180
"067281015",243,260,503,194,222,189
"067281018",377,438,815,248,266,243
"067350110",552,632,1184,403,420,379
"067350708",469,553,1022,344,382,333
"067490401",148,172,320,91,36,19
"067490406",364,407,771,265,283,239
"067490507",179,227,406,195,300,194
"067490511",155,178,333,145,205,136
"067490603",429,493,922,348,455,340
"067490605",401,462,863,306,345,278
"067490709",481,471,952,238,96,91
"067490801",391,426,817,272,299,254
"067490802",263,287,550,178,196,171
"067490911",651,652,1303,409,435,378
"067490913",277,278,555,128,127,124
"067491004",567,621,1188,380,334,315
"067491009",500,557,1057,289,277,254
"067491106",340,360,700,216,186,176
"067491107",551,588,1139,330,299,270
"067491206",539,527,1066,273,262,245
"067491207",522,548,1070,286,285,268
"067491303",590,591,1181,265,264,247
"067491309",439,488,927,266,232,221
"067491414",650,707,1357,414,391,361
"067491415",555,619,1174,355,320,309
"067491416",657,628,1285,320,301,291
"067560106",373,442,815,257,280,249
"067560107",541,622,1163,443,472,437
"067560112",482,500,982,330,385,329
"067560304",216,275,491,250,339,249
"067560305",95,160,255,140,237,137
"067560505",344,392,736,232,298,231
"067560406",323,385,708,223,270,223
"067560804",538,541,1079,367,406,359
"067561008",190,276,466,245,350,243
"067561103",296,362,658,294,363,292
"067561402",1348,1356,2704,704,683,644
"067600316",152,179,331,132,203,131
"067561415",484,513,997,278,285,261
"067561501",687,729,1416,401,459,391
"067561505",621,692,1313,399,426,381
"067561611",543,617,1160,334,386,330
"067561612",450,486,936,262,304,259
"067561613",446,476,922,290,321,270
"067561805",318,340,658,224,219,199
"067561807",277,323,600,206,233,203
"067561901",593,615,1208,385,415,370
"067562009",475,499,974,306,308,278
"067562104",800,902,1702,436,502,432
"067562210",418,477,895,293,295,262
"067562307",535,590,1125,385,430,378
"067562401",481,546,1027,340,317,293
"067562411",499,605,1104,392,413,386
"067562413",407,482,889,352,377,342
"067562512",619,679,1298,387,386,349
"067562606",521,566,1087,363,393,339
"067562705",732,774,1506,420,385,381
"067562707",298,340,638,224,197,195
"067562710",439,459,898,255,244,235
"067600103",581,594,1175,385,326,293
"067600302",677,769,1446,501,502,462
"067600317",369,447,816,328,394,300
"067600505",592,656,1248,397,429,370
"067600605",412,467,879,300,334,285
"067600701",1021,1112,2133,571,581,504
"067600803",486,542,1028,386,434,369
"067600804",545,575,1120,367,389,350
"067601010",158,170,328,82,71,68
"067601013",733,715,1448,378,376,353
"067601014",737,738,1475,389,302,288
"067601107",694,741,1435,396,397,363
"067601116",320,423,743,150,174,138
"067601204",358,363,721,229,229,166
"067601206",307,295,602,207,293,171
"067601214",668,650,1318,338,316,303
"067601305",453,493,946,306,285,266
"067601308",502,503,1005,272,257,238
"067601313",531,511,1042,259,317,252
"067601315",832,810,1642,411,422,377
"067601501",508,587,1095,325,310,281
"067601509",809,874,1683,427,387,376
"067601513",507,533,1040,303,279,265
"067601516",387,391,778,205,216,200
"067601611",389,416,805,234,238,212
"067601711",506,489,995,274,251,229
"067601714",490,502,992,278,298,265
"067601716",427,431,858,240,235,221
"067630111",462,513,975,354,406,350
"067630205",628,701,1329,427,436,407
"067630208",243,285,528,162,202,156
"067630211",412,498,910,351,425,345
"067630212",142,196,338,169,244,168
"067630310",321,363,684,261,302,256
"067630503",377,393,770,252,272,247
"067630505",383,381,764,249,247,229
"067630506",607,632,1239,362,383,340
"067630515",397,416,813,273,279,261
"067630517",488,472,960,271,256,239
"067630615",768,756,1524,426,426,409
"067630705",479,523,1002,308,350,302
"067630711",1035,1025,2060,519,466,444
"067630802",570,542,1112,320,327,302
"067630805",556,558,1114,307,314,295
"067630811",454,462,916,302,286,281
"067631102",622,639,1261,399,423,383
"067631705",416,490,906,275,293,266
"067631706",479,514,993,317,334,314
"067631803",618,618,1236,352,350,321
"067700110",354,405,759,259,310,253
"067632006",577,611,1188,368,371,332
"067632007",226,257,483,155,158,152
"067632008",639,664,1303,393,362,334
"067700107",498,599,1097,379,431,370
"067700206",266,271,537,198,238,195
"067702107",536,592,1128,415,441,389
"067702110",303,389,692,266,321,263
"067780205",672,705,1377,392,437,375
"067780206",402,426,828,256,290,249
"067780209",576,664,1240,360,347,324
"067780211",316,363,679,184,223,183
"067780213",327,332,659,175,192,175
"067780401",26,21,47,19,30,19
"067781004",540,574,1114,308,319,303
"067780906",618,618,1236,357,429,352
"067910213",358,453,811,345,443,339
"067780909",390,427,817,248,287,238
"067780913",442,455,897,307,370,302
"067781003",548,493,1041,258,271,249
"067910106",300,397,697,302,390,283
"067910206",401,439,840,370,431,355
"067910207",350,396,746,291,342,286
"067910212",317,417,734,299,395,294
"067910307",491,568,1059,387,461,382
"067910308",304,380,684,244,258,242
"067910310",575,604,1179,404,459,392
"067910408",223,302,525,274,389,266
"067910409",238,287,525,191,259,188
"067910410",202,279,481,200,264,190
"067910412",211,216,427,193,242,189
"067911208",560,604,1164,422,464,417
"067911211",302,329,631,225,246,223
"067911804",308,345,653,253,302,246
"067912005",424,513,937,306,326,301
"067912009",478,505,983,333,398,328
"067912102",646,570,1216,361,374,345
"067912201",220,196,416,131,197,128
"068050101",338,347,685,214,275,192
"067980501",75,83,158,49,73,48
"067981001",30,27,57,20,36,20
"068050107",446,465,911,247,333,247
"068050305",772,787,1559,453,676,421
"068050308",445,488,933,220,254,218
"068050502",484,580,1064,346,376,336
"068050513",760,718,1478,387,381,368
"068050702",385,405,790,285,274,251
"068050703",507,587,1094,349,373,340
"068050804",271,273,544,249,454,234
"068050806",448,477,925,291,333,263
"068050809",927,898,1825,474,426,404
"068050904",1037,1045,2082,611,635,597
"068050906",1148,1292,2440,585,696,559
"068051108",1151,1216,2367,565,455,424
"068051202",493,505,998,321,356,315
"068051206",305,344,649,232,258,232
"068051211",504,565,1069,349,375,334
"068051213",403,438,841,281,311,279
"068051306",515,484,999,277,264,245
"068051310",410,453,863,242,201,188
"068051316",555,596,1151,380,417,367
"068051401",727,745,1472,403,407,397
"068051405",825,893,1718,484,455,425
"068051507",640,667,1307,404,415,368
"068051601",873,887,1760,448,356,337
"068051910",372,360,732,227,233,211
"068051901",440,445,885,259,208,194
"068051902",475,492,967,274,291,265
"068052008",452,492,944,285,247,228
"068052013",625,617,1242,318,270,251
"068052106",626,610,1236,345,297,274
"068052114",544,554,1098,307,293,268
"068052202",1021,921,1942,499,498,473
"068052203",883,894,1777,482,478,461
"068052207",671,712,1383,381,349,322
"068052208",567,588,1155,340,363,318
"068052306",514,581,1095,333,373,322
"068052312",2826,2793,5619,1326,1128,1049
"068052315",754,741,1495,362,340,334
"068052406",394,385,779,226,232,206
"068052506",864,847,1711,460,407,386
"060280206",672,673,1345,337,319,312
"068190403",305,396,701,283,335,281
"068190911",215,217,432,147,184,142
"068190901",82,86,168,60,175,59
"068190905",212,209,421,170,283,168
"068190912",241,243,484,166,199,164
"068260101",1052,1120,2172,627,507,430
"068260109",179,222,401,189,258,188
"068260113",370,359,729,228,238,218
"068260206",179,212,391,150,177,150
"068260208",163,180,343,152,241,152
"068260209",336,429,765,270,338,267
"068260210",199,223,422,158,187,153
"068330109",371,442,813,323,448,316
"068261907",317,321,638,179,227,162
"068330101",251,297,548,215,240,209
"068330110",455,490,945,373,468,371
"068330209",297,407,704,266,394,265
"068330211",367,456,823,343,407,339
"068331011",511,493,1004,314,356,307
"068331006",535,602,1137,358,392,346
"068331010",308,337,645,224,251,219
"068331401",298,299,597,204,252,204
"068331709",257,241,498,188,221,185
"068331807",99,92,191,77,433,77
"068331906",580,530,1110,309,356,305
"068331911",498,533,1031,268,275,235
"068400204",442,499,941,294,298,259
"068400104",504,544,1048,292,259,231
"068400305",679,706,1385,391,397,377
"068400312",734,759,1493,426,433,412
"068400413",610,614,1224,381,378,353
"068400415",608,658,1266,383,380,345
"068400509",344,375,719,235,254,225
"068400605",524,607,1131,382,381,350
"068400612",308,317,625,197,216,194
"068400705",370,373,743,252,277,244
"068400711",455,677,1132,341,395,331
"068400801",383,451,834,301,337,289
"068400811",415,483,898,315,370,296
"068400904",329,382,711,210,238,209
"068400906",342,396,738,306,318,305
"068400908",295,349,644,235,260,231
"068401005",267,321,588,207,220,205
"068401007",354,410,764,305,336,300
"068401011",305,338,643,259,331,253
"068401104",138,169,307,105,99,96
"068401311",363,417,780,249,281,234
"068401312",417,542,959,357,443,351
"068401401",467,538,1005,337,389,319
"068401407",366,435,801,294,326,277
"068401513",416,460,876,324,393,314
"068401611",235,270,505,195,224,169
"068401801",213,230,443,117,114,113
"068401812",316,328,644,218,246,209
"068401907",349,409,758,282,292,252
"068402003",536,596,1132,378,395,354
"068402004",486,541,1027,358,395,351
"068402107",519,565,1084,381,426,376
"068402207",531,589,1120,380,407,362
"068402302",394,443,837,293,300,267
"068402402",385,430,815,288,326,284
"068402501",230,230,460,125,128,122
"068402510",462,496,958,257,227,217
"068402511",391,433,824,211,195,184
"068402607",288,285,573,199,214,173
"068402608",7,9,16,6,26,5
"068402702",610,616,1226,373,399,349
"068402703",542,582,1124,303,289,279
"068402705",135,127,262,103,141,103
"068402902",368,403,771,263,277,256
"068402909",475,554,1029,351,388,330
"068402910",547,590,1137,371,401,363
"068402911",261,292,553,179,192,171
"068403103",390,499,889,363,455,360
"068403205",432,453,885,260,310,248
"068470114",460,494,954,286,307,285
"068120602",7,2,9,6,11,6
"068190301",27,13,40,18,36,18
"068540401",267,268,535,188,222,186
"068261802",41,26,67,24,43,24
"068540207",467,513,980,348,406,336
"068261702",34,14,48,21,25,21
"068261704",9,7,16,6,17,6
"068330303",6,4,10,4,8,4
"068330601",14,4,18,5,6,5
"068330603",15,8,23,11,21,11
"068330703",36,29,65,18,22,18
"068331102",3,4,7,3,7,3
"068331104",7,7,14,8,17,8
"068331301",10,5,15,7,31,7
"068331602",11,8,19,9,17,9
"068470108",5,3,8,3,23,3
"068470109",18,11,29,10,28,10
"068540402",146,128,274,91,129,90
"068540602",208,185,393,152,389,151
"068541301",88,61,149,51,72,49
"068750402",55,53,108,38,95,36
"068751601",243,203,446,138,200,138
"068541006",503,526,1029,321,406,309
"068610105",367,416,783,314,379,311
"068610208",174,127,301,139,229,137
"068610303",336,448,784,323,353,321
"068610603",348,387,735,257,303,243
"068610607",254,298,552,296,336,273
"068610707",304,380,684,275,361,274
"068612810",366,452,818,298,319,292
"068610806",289,319,608,234,279,233
"068610810",421,422,843,277,296,256
"068610902",212,244,456,227,312,226
"068610905",503,565,1068,397,460,386
"068610907",389,452,841,322,352,292
"068610908",249,352,601,274,363,273
"068611002",552,531,1083,409,496,395
"068611206",314,363,677,252,284,231
"068611405",232,311,543,206,231,201
"068611409",401,556,957,355,425,349
"068611505",164,214,378,185,257,184
"068611801",509,552,1061,388,421,368
"068611803",396,488,884,302,326,271
"068612407",598,659,1257,433,445,404
"068611909",406,452,858,280,299,267
"068612101",469,539,1008,331,371,324
"068612103",412,449,861,318,379,313
"068612104",410,494,904,313,358,311
"068612106",462,557,1019,360,400,350
"068612607",435,463,898,346,402,342
"068612108",523,573,1096,403,457,397
"068612203",443,492,935,334,334,301
"068612307",634,640,1274,401,418,363
"068612405",560,580,1140,380,369,324
"068612505",437,475,912,290,313,279
"068612603",345,400,745,270,316,261
"068612704",325,367,692,243,278,233
"068612708",450,496,946,333,350,295
"068612803",316,369,685,238,273,212
"068613001",369,428,797,277,292,269
"068613005",426,493,919,250,221,216
"068613007",530,539,1069,255,246,246
"068613010",293,303,596,217,236,194
"068613103",450,531,981,362,386,346
"068613104",866,984,1850,661,774,638
"068613304",297,323,620,252,304,226
"068613309",437,529,966,364,436,356
"068680205",478,503,981,367,492,340
"068680208",16,20,36,9,115,9
"068680301",770,784,1554,411,461,403
"068680312",39,42,81,38,350,38
"068680407",80,80,160,56,394,56
"068680603",86,82,168,75,511,75
"068680701",450,455,905,284,306,262
"068750901",100,104,204,78,100,78
"068751501",316,325,641,243,288,238
"068751502",167,165,332,125,135,111
"068751508",415,447,862,291,324,283
"068751509",295,297,592,187,213,183
"068751607",344,349,693,233,271,229
"068751609",267,269,536,197,233,193
"068751615",763,791,1554,391,389,342
"068820206",319,340,659,258,345,255
"068820207",398,464,862,312,365,298
"068820210",420,450,870,279,286,243
"068820304",555,602,1157,385,400,358
"068820305",380,431,811,294,330,277
"068820401",644,589,1233,368,372,346
"068820911",453,437,890,251,290,243
"068820506",92,86,178,46,53,45
"068820802",716,725,1441,397,336,305
"068820902",654,636,1290,332,335,306
"068820905",456,439,895,246,244,226
"068820910",654,668,1322,395,423,389
"068821006",678,670,1348,432,433,390
"065601502",386,402,788,205,207,195
"065601407",544,556,1100,269,262,245
"065601408",1028,1042,2070,557,565,520
"065601411",590,609,1199,279,254,238
"065601412",707,737,1444,363,359,338
"065601413",623,659,1282,318,331,312
"065601512",792,861,1653,402,387,369
"065601513",766,771,1537,383,360,351
"065601602",498,520,1018,266,274,242
"065601606",755,751,1506,434,393,366
"065601611",729,759,1488,409,400,370
"065601615",493,451,944,258,290,240
"065601706",391,346,737,222,309,219
"067702206",647,681,1328,411,419,384
"065601718",342,346,688,184,214,178
"065601802",640,646,1286,358,443,333
"067780207",768,742,1510,394,403,384
"065601810",883,865,1748,474,483,437
"065601811",739,722,1461,411,444,394
"065601901",472,494,966,256,293,252
"067780910",354,379,733,243,256,223
"065602007",719,732,1451,339,332,306
"065602008",639,657,1296,293,288,271
"065602009",641,697,1338,335,354,319
"065602010",718,704,1422,325,330,313
"065602013",838,873,1711,423,445,401
"065602103",482,485,967,245,280,231
"065602108",729,759,1488,404,393,355
"065602111",773,821,1594,441,465,420
"065602201",531,524,1055,291,354,279
"065602301",572,555,1127,326,362,322
"065602309",221,245,466,189,260,188
"065602408",433,466,899,297,307,267
"065602411",332,433,765,293,386,271
"065602508",677,711,1388,363,342,319
"065680305",374,400,774,244,219,198
"065680310",455,505,960,227,222,207
"065680311",566,648,1214,395,378,334
"065680406",260,292,552,186,214,175
"065680408",436,506,942,340,376,320
"065680410",393,438,831,295,342,291
"065680706",529,572,1101,367,416,352
"065680901",260,309,569,194,207,187
"065681001",488,558,1046,335,353,321
"065681007",294,312,606,204,221,195
"065681012",447,494,941,339,364,327
"065681017",428,435,863,266,240,226
"065681104",224,265,489,192,281,190
"065681203",442,481,923,327,372,324
"065681303",351,404,755,272,323,260
"065681309",548,586,1134,372,388,362
"066510708",6,7,13,4,19,4
"068751402",68,41,109,46,102,46
"060070114",33,25,58,21,34,21
"064905010",620,641,1261,408,404,381
"064905111",217,248,465,181,211,180
"064970102",240,277,517,202,240,196
"064970502",281,315,596,218,246,215
"065390113",452,470,922,267,249,231
"064970602",501,567,1068,332,367,320
"064970614",237,237,474,133,209,131
"064970707",137,192,329,155,258,144
"064970814",301,323,624,218,230,210
"066584312",557,614,1171,386,402,368
"064971001",312,363,675,214,262,204
"066650201",29,38,67,22,23,22
"064971008",644,607,1251,336,346,309
"064971408",303,373,676,243,273,236
"065152001",855,896,1751,506,474,460
"065152015",692,769,1461,427,402,368
"065050307",279,273,552,173,199,164
"065050316",155,146,301,88,119,88
"065110301",48,47,95,33,50,33
"065110501",160,148,308,100,129,100
"065110503",573,658,1231,379,451,375
"065110509",323,334,657,201,215,176
"065152107",336,389,725,216,211,194
"065152109",615,668,1283,363,353,331
"065152111",487,500,987,299,322,294
"065180101",263,284,547,186,212,182
"065180112",45,38,83,26,37,25
"065180206",319,325,644,190,216,187
"065180302",182,183,365,111,136,110
"065150106",705,680,1385,349,330,323
"065150110",909,857,1766,423,401,391
"065150112",1049,973,2022,530,477,453
"065180604",231,264,495,190,472,176
"066860109",263,328,591,255,337,251
"065150213",473,438,911,209,209,204
"065150216",618,589,1207,281,279,260
"065150310",520,558,1078,294,287,270
"065150403",636,679,1315,329,339,313
"065150404",368,351,719,196,272,189
"065150409",555,623,1178,318,297,285
"065391202",518,507,1025,300,298,281
"065150511",842,822,1664,411,462,405
"065150601",522,484,1006,251,232,225
"065150607",604,680,1284,386,378,353
"065150712",818,816,1634,466,431,402
"065150714",445,483,928,245,221,207
"065150801",685,721,1406,343,365,320
"065150805",391,436,827,251,236,218
"065150809",635,656,1291,393,352,323
"065150904",394,408,802,242,239,231
"065150906",508,569,1077,332,275,256
"065150911",496,482,978,293,313,285
"065150914",659,659,1318,356,314,300
"065151002",808,909,1717,481,459,436
"060351403",441,496,937,335,367,318
"060352902",439,478,917,304,318,287
"060353010",399,430,829,300,344,295
"060562507",673,689,1362,401,439,390
"060563210",417,492,909,315,339,306
"060911406",710,710,1420,338,331,323
"060980304",476,472,948,285,311,281
"061260907",889,895,1784,492,549,485
"061340305",395,432,827,296,351,285
"061340914",245,245,490,159,178,145
"061610108",215,249,464,173,201,173
"061610115",284,281,565,148,152,146
"060070101",240,239,479,178,213,177
"061680802",21,18,39,12,16,11
"060070403",260,304,564,234,279,234
"060070404",344,348,692,253,296,249
"060140505",209,216,425,154,196,140
"060141003",221,232,453,150,179,146
"060141006",270,307,577,204,237,203
"060210201",213,205,418,154,175,153
"060210608",181,194,375,143,171,143
"060210801",96,96,192,70,121,70
"060280113",476,475,951,277,249,236
"060280310",492,542,1034,318,314,309
"060280404",709,656,1365,331,278,277
"060280508",130,149,279,75,72,72
"060280601",583,661,1244,389,398,373
"060280611",546,557,1103,254,254,241
"060280614",1426,1435,2861,762,733,700
"060280707",1202,1241,2443,666,690,593
"060280711",771,826,1597,433,436,403
"060280905",510,576,1086,300,306,288
"060281006",500,523,1023,281,225,219
"060281015",479,517,996,286,283,255
"060281103",397,446,843,276,247,227
"060281104",346,360,706,225,238,217
"060281311",605,613,1218,367,333,319
"060281407",828,869,1697,454,395,379
"060281703",310,309,619,186,167,161
"060281705",438,478,916,257,282,253
"060281805",441,432,873,240,229,221
"060281901",593,676,1269,364,339,329
"060281913",396,381,777,192,195,177
"060282011",585,564,1149,262,269,258
"060282013",799,811,1610,406,418,372
"060282107",509,525,1034,307,346,289
"060282306",412,487,899,318,352,301
"060282308",311,329,640,213,223,195
"060282309",444,443,887,284,282,265
"060282403",412,490,902,291,312,282
"060282409",426,509,935,341,386,338
"060282501",353,393,746,262,273,235
"060282507",262,324,586,218,333,213
"060282508",222,310,532,199,257,197
"060282513",398,451,849,307,345,293
"060282603",425,494,919,284,271,234
"060282612",216,239,455,123,130,119
"060282703",801,768,1569,373,334,318
"060282805",762,847,1609,441,439,411
"060282903",477,518,995,302,331,296
"060282908",535,514,1049,283,267,255
"060282909",559,565,1124,301,308,291
"060283107",660,707,1367,387,398,374
"060283109",496,539,1035,279,243,228
"060283206",382,401,783,238,265,232
"060283312",609,615,1224,361,357,327
"060283502",809,738,1547,351,355,331
"060283611",596,635,1231,304,311,296
"060283702",433,485,918,276,287,268
"060283703",536,482,1018,286,280,254
"060283714",567,597,1164,289,334,274
"060283803",709,672,1381,347,368,339
"060283804",742,745,1487,436,445,405
"060283904",671,665,1336,360,348,333
"062170404",268,244,512,169,194,160
"060350103",363,394,757,239,238,216
"060350308",380,440,820,291,306,289
"060350311",465,517,982,334,345,329
"060350407",486,585,1071,348,364,341
"060350413",443,508,951,327,343,316
"060350504",526,617,1143,375,386,352
"060350711",267,374,641,191,328,162
"060350801",450,536,986,274,304,264
"060350908",644,619,1263,342,440,307
"060351003",428,488,916,297,323,285
"060351107",164,180,344,107,120,101
"060351201",293,360,653,250,287,229
"060351408",421,470,891,294,349,287
"060351412",306,333,639,216,237,204
"063573801",151,238,389,238,1002,234
"060351509",317,433,750,261,278,241
"060351511",340,430,770,264,304,261
"060351606",388,432,820,267,302,259
"060351701",364,449,813,296,332,282
"060351702",359,436,795,262,266,226
"060351807",306,359,665,248,301,242
"060351809",409,431,840,306,337,302
"060351907",384,437,821,289,225,188
"060352003",510,579,1089,438,531,431
"060352005",422,446,868,304,294,261
"060352102",477,566,1043,391,408,381
"060352103",273,312,585,205,238,204
"060352205",239,294,533,201,251,201
"060352311",457,536,993,323,336,303
"060352402",465,475,940,315,303,277
"060352403",612,663,1275,406,374,351
"060352406",419,490,909,307,327,300
"060352407",419,501,920,317,292,270
"060352504",382,431,813,277,324,270
"060352603",383,390,773,208,219,200
"060352605",972,1041,2013,593,613,578
"060352614",476,463,939,267,252,240
"060352702",388,458,846,261,277,245
"060352708",202,205,407,128,118,106
"060352712",665,763,1428,412,323,291
"060352714",630,611,1241,297,275,268
"060353006",414,514,928,333,375,319
"060353201",482,544,1026,353,358,308
"060353403",281,322,603,223,237,201
"060353409",320,372,692,252,247,209
"060353508",354,378,732,247,284,242
"060420107",342,341,683,232,273,227
"060561309",149,183,332,172,244,169
"062380215",28,38,66,20,25,20
"060490210",377,354,731,217,222,209
"060490608",664,693,1357,420,455,400
"060491001",165,158,323,116,158,112
"060492003",63,48,111,35,64,31
"060492503",300,283,583,225,281,217
"062520211",438,468,906,272,274,254
"060492502",799,845,1644,431,436,421
"060492509",684,704,1388,415,420,392
"060561004",281,371,652,308,426,303
"060560110",216,276,492,240,312,238
"060560114",185,218,403,223,293,219
"060560202",655,619,1274,377,384,360
"060560211",486,488,974,318,355,314
"060560604",296,337,633,213,254,212
"060560606",246,297,543,201,254,199
"060560702",378,388,766,309,369,308
"060560710",468,499,967,330,377,319
"060561005",182,228,410,197,299,175
"060560805",746,793,1539,472,486,434
"060560808",158,156,314,73,73,69
"060560811",38,39,77,23,29,23
"060560813",623,606,1229,325,339,319
"062521206",605,629,1234,360,374,330
"060560814",763,777,1540,400,415,392
"060561101",216,263,479,210,293,207
"060561107",191,287,478,258,366,254
"060561114",191,247,438,209,240,195
"060561204",240,340,580,271,367,271
"060561301",507,532,1039,496,611,470
"060561404",239,272,511,227,272,223
"060561407",246,264,510,240,295,237
"060561421",148,220,368,188,290,188
"060561505",439,441,880,282,298,264
"060561507",434,455,889,307,317,295
"060561508",635,656,1291,381,388,364
"060561509",280,322,602,177,186,171
"060561604",224,239,463,182,234,182
"060561708",299,336,635,259,330,252
"060561710",277,346,623,261,324,253
"060561803",255,319,574,222,242,216
"060561904",551,598,1149,341,351,322
"060561906",648,660,1308,451,504,443
"060562004",354,399,753,320,392,319
"060562007",232,301,533,240,299,239
"060562104",334,340,674,225,248,221
"060562110",344,401,745,252,262,239
"060562201",437,502,939,343,393,331
"060562205",409,448,857,253,244,232
"060562217",484,542,1026,355,360,320
"060562312",298,314,612,207,236,197
"060562401",620,666,1286,392,455,387
"061821006",359,393,752,256,300,243
"060562411",302,283,585,194,203,190
"065151310",592,693,1285,398,397,367
"060562610",948,974,1922,572,689,553
"061821007",351,377,728,247,303,245
"060563002",205,220,425,140,173,139
"060630102",430,461,891,324,339,314
"060630103",503,518,1021,334,350,309
"062660610",243,255,498,151,307,150
"060630105",639,646,1285,417,426,397
"060630109",598,635,1233,381,417,369
"060630114",347,389,736,269,323,257
"060630202",370,426,796,299,377,281
"060630402",28,40,68,28,34,28
"062700503",539,529,1068,280,246,234
"060700102",154,211,365,168,208,164
"060700106",408,441,849,291,325,281
"060700110",368,403,771,284,341,281
"060700210",865,850,1715,467,494,442
"060700213",457,462,919,286,331,282
"060700214",523,574,1097,354,375,334
"060700401",582,625,1207,385,436,378
"063572102",278,337,615,272,459,261
"060770107",187,177,364,107,137,101
"060771406",378,481,859,335,430,332
"060771407",333,403,736,285,348,281
"060840703",347,325,672,207,248,205
"060840708",316,395,711,292,376,287
"062741003",780,787,1567,400,329,305
"060840903",202,194,396,129,143,125
"060840906",319,335,654,225,274,221
"060910108",444,490,934,330,347,312
"060910208",474,566,1040,372,422,352
"060910311",362,415,777,307,349,295
"060910411",778,797,1575,431,400,373
"065151402",505,535,1040,315,270,257
"060910610",764,736,1500,370,356,340
"060910706",485,534,1019,294,297,274
"060910809",702,680,1382,405,410,380
"060910901",295,359,654,227,252,217
"060910904",631,705,1336,422,440,391
"060910908",304,360,664,224,223,219
"060911009",402,484,886,290,298,279
"060911302",600,625,1225,327,273,253
"060911305",802,821,1623,418,430,412
"060911311",481,472,953,270,266,249
"060911408",646,672,1318,385,360,346
"060911610",497,522,1019,285,292,266
"060911704",466,459,925,260,265,238
"060911708",490,538,1028,250,233,223
"060911905",319,359,678,208,236,202
"060911912",649,705,1354,418,418,374
"060912003",265,289,554,153,156,145
"060912013",434,439,873,229,241,218
"060912105",332,378,710,248,276,245
"060912203",585,670,1255,370,387,366
"060912205",493,534,1027,265,354,265
"060980108",316,358,674,258,280,241
"060912312",343,347,690,193,203,174
"060912313",306,315,621,171,189,160
"060912314",1142,752,1894,72,159,72
"060912318",110,94,204,58,105,55
"060912407",240,211,451,153,210,153
"060912413",351,296,647,190,189,175
"060980112",308,387,695,254,302,250
"060980202",503,523,1026,347,375,332
"060980207",588,628,1216,377,424,365
"060980309",913,987,1900,477,437,418
"060980602",520,584,1104,387,429,378
"060980605",615,599,1214,387,411,371
"060980802",762,685,1447,367,287,250
"060980805",206,231,437,164,229,160
"060980807",207,241,448,187,266,183
"060980817",704,671,1375,378,376,352
"061050103",331,400,731,289,333,283
"061051301",217,229,446,176,226,175
"061051402",470,441,911,262,290,249
"061051412",263,278,541,198,221,194
"061120103",552,671,1223,408,466,397
"061120301",111,111,222,72,91,72
"061121401",458,501,959,291,308,273
"061121402",493,535,1028,334,358,326
"061190305",603,690,1293,384,398,354
"061190403",190,172,362,123,221,119
"061191001",131,119,250,80,125,78
"061191008",460,534,994,352,393,336
"061260107",367,363,730,250,274,241
"061260112",510,564,1074,362,406,356
"061260113",336,368,704,242,265,230
"061260305",237,257,494,191,216,189
"061260402",303,361,664,248,303,233
"061260407",966,930,1896,492,497,457
"061260604",178,181,359,108,204,104
"061260707",588,578,1166,331,306,280
"061260709",818,794,1612,468,524,453
"061340801",158,172,330,105,131,104
"061340207",667,710,1377,386,401,365
"061340209",594,592,1186,306,327,287
"061340302",471,510,981,292,315,288
"061340903",231,186,417,133,216,131
"063573602",227,270,497,261,716,260
"063573603",155,200,355,173,569,172
"063574311",78,88,166,81,246,81
"061471205",295,331,626,233,274,229
"061540202",217,206,423,141,164,138
"061540602",221,221,442,146,163,146
"063572106",224,312,536,196,386,190
"061610117",500,553,1053,349,391,343
"063576111",263,328,591,202,241,197
"061680803",27,36,63,21,34,21
"061680901",428,469,897,252,272,246
"061680902",386,386,772,284,324,278
"061680908",298,339,637,178,215,178
"061750201",94,99,193,69,104,69
"061750405",285,366,651,275,327,272
"061750407",265,345,610,260,315,250
"061750413",244,262,506,197,230,191
"061750608",486,466,952,295,320,289
"061750609",528,483,1011,275,292,271
"063577303",23,11,34,19,17,12
"061820103",648,684,1332,376,399,369
"061820106",383,435,818,271,289,254
"063577311",185,158,343,114,200,109
"061820204",362,394,756,265,329,264
"061820205",331,377,708,245,284,223
"061820301",170,63,233,32,47,32
"061820303",89,69,158,46,60,43
"061820311",259,259,518,152,245,149
"061821004",411,482,893,329,368,301
"061820703",538,601,1139,359,406,355
"061821103",471,536,1007,336,382,326
"061891201",224,232,456,151,191,151
"063578010",193,194,387,111,173,110
"061891301",45,35,80,34,62,34
"061891704",277,325,602,218,263,217
"061960101",484,485,969,284,328,280
"061960202",193,164,357,99,107,94
"061960106",183,165,348,106,109,100
"061960110",203,197,400,122,161,119
"061960115",207,261,468,197,245,195
"061960117",232,244,476,181,217,178
"061960210",400,447,847,315,377,311
"063640208",372,405,777,230,219,205
"062030110",450,482,932,317,337,309
"062030112",461,461,922,308,342,302
"062030807",429,490,919,353,403,342
"063710502",492,571,1063,360,316,304
"062031301",11,9,20,7,20,7
"062031603",408,446,854,255,350,242
"062031610",532,502,1034,320,371,314
"062100102",269,267,536,187,211,180
"062100106",345,374,719,271,308,261
"062100111",313,376,689,272,352,266
"062100117",361,438,799,315,350,295
"062100120",429,476,905,306,329,297
"062100612",167,171,338,134,202,134
"062101307",401,454,855,282,305,270
"062170109",310,355,665,256,330,254
"062170114",180,193,373,147,207,146
"063713010",245,266,511,132,119,116
"062170412",356,369,725,194,230,191
"062171001",392,377,769,263,299,258
"062171203",445,483,928,300,335,298
"062240207",388,442,830,300,367,297
"062240411",432,465,897,317,367,315
"062240913",104,92,196,69,177,67
"062240914",107,100,207,68,139,67
"063572211",128,195,323,168,351,168
"062242003",418,441,859,294,344,291
"064080907",684,786,1470,434,449,422
"063572705",171,240,411,239,838,239
"062311207",458,492,950,332,362,326
"062380102",273,288,561,194,219,188
"062380202",506,591,1097,398,450,386
"062380203",369,510,879,328,379,323
"062380204",193,254,447,196,238,194
"062380207",597,603,1200,403,443,373
"062380603",325,373,698,207,238,204
"062380701",68,71,139,51,69,39
"062450201",664,680,1344,395,415,390
"062450308",396,409,805,259,286,248
"064100610",434,472,906,277,302,270
"062450413",418,389,807,236,281,236
"062520115",505,504,1009,310,239,216
"062520502",300,372,672,263,315,245
"062520406",317,370,687,244,294,224
"062520410",408,420,828,248,351,237
"062520411",57,58,115,31,28,23
"062520413",612,590,1202,357,543,352
"062520601",501,458,959,239,223,216
"062520606",472,479,951,291,560,289
"062520708",810,794,1604,433,418,378
"062520710",439,473,912,262,292,261
"062520802",930,922,1852,465,501,433
"062520904",859,867,1726,427,407,389
"062520908",406,411,817,245,249,221
"062521012",794,798,1592,388,402,372
"062521107",457,513,970,307,363,300
"062521014",385,373,758,225,337,221
"062521101",383,416,799,264,276,246
"062521105",656,687,1343,434,416,359
"062521110",505,553,1058,328,400,299
"062521310",329,340,669,219,239,213
"062521311",457,496,953,293,314,283
"062521402",769,775,1544,431,409,388
"062521505",631,656,1287,362,364,335
"064130901",70,85,155,42,50,41
"062600104",425,396,821,235,211,198
"062600105",499,463,962,306,185,152
"062600117",820,844,1664,464,397,365
"062600311",931,972,1903,432,422,415
"062600319",576,547,1123,325,284,277
"062600403",614,612,1226,339,335,322
"062600405",524,526,1050,313,324,304
"064131507",94,91,185,68,383,66
"062600412",537,579,1116,331,314,301
"062600503",425,425,850,240,231,220
"064131801",210,198,408,106,113,103
"062600508",280,322,602,187,197,180
"062601314",184,242,426,218,313,217
"062600608",401,366,767,246,268,234
"062600616",556,600,1156,390,428,377
"062600801",659,678,1337,332,328,304
"062600805",595,593,1188,290,287,281
"063572806",160,193,353,177,610,174
"062600901",592,629,1221,344,344,326
"062600902",591,601,1192,325,315,296
"062601004",494,484,978,303,323,285
"062601201",359,427,786,308,377,305
"062601204",406,446,852,303,373,295
"063572902",112,140,252,110,305,109
"062601210",322,345,667,204,231,199
"062601211",466,482,948,283,269,238
"062601305",631,697,1328,429,461,408
"062601307",545,639,1184,371,430,361
"062601308",504,570,1074,356,368,326
"062601605",636,690,1326,370,368,334
"062601614",897,896,1793,472,450,414
"062601707",111,93,204,58,299,58
"062601709",132,160,292,77,291,75
"062741701",338,376,714,228,224,209
"062660312",34,32,66,26,31,25
"062700208",996,956,1952,478,494,443
"062700214",506,527,1033,263,269,246
"062700301",413,427,840,232,282,229
"062700302",493,472,965,266,278,250
"062700305",804,849,1653,455,465,420
"064270607",318,369,687,241,247,218
"062700502",434,491,925,248,269,224
"062700402",454,437,891,274,320,268
"062700607",759,765,1524,420,487,399
"062700613",169,177,346,108,175,104
"063573002",161,190,351,161,384,157
"062700704",310,314,624,191,219,189
"062700711",724,728,1452,367,399,352
"062700716",698,646,1344,367,434,351
"062700816",373,337,710,188,205,177
"062700901",1331,1282,2613,674,649,599
"062701002",1156,1193,2349,609,603,511
"062740112",449,445,894,253,232,226
"062740113",816,849,1665,463,430,411
"062740208",523,551,1074,301,265,259
"062740303",395,436,831,228,235,213
"062740403",731,699,1430,371,354,333
"062740406",540,555,1095,303,307,289
"062740409",787,804,1591,401,364,351
"062740412",1011,957,1968,490,480,464
"062740505",482,485,967,241,228,217
"062740510",542,562,1104,318,319,293
"062740515",720,676,1396,355,356,327
"062740603",563,543,1106,304,317,290
"062740616",476,450,926,220,186,179
"062740619",413,403,816,198,203,187
"062740811",523,483,1006,242,241,232
"062740912",463,448,911,247,259,239
"062740913",517,511,1028,257,262,248
"062741009",558,551,1109,235,210,193
"062741014",516,455,971,249,267,233
"062741106",1135,1074,2209,602,484,452
"062741108",568,618,1186,314,301,286
"062741118",548,525,1073,295,281,262
"062741209",756,750,1506,403,414,390
"062741210",555,587,1142,331,340,315
"062741211",679,694,1373,365,364,342
"062741305",424,476,900,246,236,225
"062741308",416,436,852,242,259,231
"062741313",246,281,527,177,197,166
"062741504",775,812,1587,440,387,361
"062741506",365,415,780,236,224,208
"062741516",591,612,1203,343,330,322
"062741606",568,598,1166,335,343,327
"062741704",576,603,1179,320,276,258
"064275102",590,610,1200,328,324,320
"062741712",476,470,946,258,199,191
"062741713",598,605,1203,353,320,297
"062741812",407,374,781,202,214,198
"062741814",515,488,1003,243,252,237
"062741818",929,891,1820,447,429,395
"062741909",458,454,912,223,236,211
"062742015",26,22,48,10,482,10
"062742007",1127,1071,2198,486,480,464
"062742011",612,615,1227,332,301,287
"062742014",128,125,253,63,449,47
"062742105",808,886,1694,375,361,349
"065151605",363,394,757,239,254,219
"062742110",469,494,963,265,252,242
"062742113",733,726,1459,380,409,376
"062742114",559,606,1165,314,313,303
"062800204",391,427,818,241,268,224
"062800104",410,388,798,230,243,224
"062800106",270,261,531,137,204,132
"062800407",118,99,217,69,173,66
"062800408",161,165,326,96,172,91
"062800611",138,115,253,73,139,71
"062800819",326,319,645,216,248,214
"062800820",156,152,308,99,116,95
"062800909",63,60,123,41,196,41
"062801008",201,196,397,125,340,125
"062801107",193,229,422,153,210,146
"062801109",327,340,667,214,296,202
"062801111",267,264,531,153,183,147
"063570205",420,426,846,270,342,264
"062940204",425,462,887,336,403,330
"062940404",198,250,448,162,184,155
"062940601",329,383,712,263,306,262
"062940803",252,272,524,199,231,198
"063010510",304,372,676,242,290,237
"064279109",574,547,1121,297,269,265
"064279214",813,791,1604,412,399,390
"063010804",69,59,128,55,172,54
"063010807",206,230,436,117,179,116
"063080602",209,218,427,143,206,142
"063220307",163,178,341,125,165,121
"063220602",313,361,674,272,315,267
"063220612",366,405,771,244,318,233
"064340306",338,381,719,260,264,242
"063220701",85,89,174,68,88,68
"063290307",275,273,548,153,167,145
"063290309",367,415,782,251,268,228
"063290310",462,491,953,307,342,298
"063290314",272,338,610,192,217,181
"063290315",463,505,968,294,334,289
"063570701",371,413,784,287,342,286
"063360201",299,304,603,175,227,173
"063430711",354,337,691,215,253,208
"063510603",413,454,867,312,356,308
"063510607",396,428,824,340,399,333
"063570102",501,512,1013,326,347,309
"063570203",398,469,867,267,334,263
"063570209",444,451,895,281,339,268
"063570301",210,211,421,147,213,143
"063570409",350,356,706,228,328,224
"063571002",316,336,652,214,274,212
"063571005",603,642,1245,337,357,314
"063571104",783,785,1568,404,397,364
"063571110",424,444,868,269,276,244
"063571205",504,580,1084,381,442,379
"063571213",477,500,977,279,306,275
"063571307",587,578,1165,364,358,313
"063571502",264,343,607,208,243,200
"063571505",445,567,1012,356,431,353
"063571506",330,381,711,245,283,242
"063571507",761,966,1727,701,822,662
"063571601",366,375,741,269,334,257
"063571605",287,344,631,201,281,189
"063571609",166,201,367,155,251,155
"063571611",171,217,388,170,235,169
"063571613",229,288,517,205,237,196
"063571704",310,326,636,199,253,198
"063571708",383,392,775,249,316,246
"063571903",159,206,365,155,403,150
"063572214",140,209,349,204,459,203
"063573209",225,332,557,252,350,251
"063573401",174,231,405,176,248,172
"063573501",197,280,477,256,819,254
"063574006",108,170,278,161,744,159
"063574302",108,123,231,89,225,86
"063574408",198,198,396,126,229,122
"063574502",224,259,483,184,269,184
"063574509",491,518,1009,336,391,325
"063574603",280,353,633,238,381,237
"063574704",312,355,667,261,329,260
"063574801",411,528,939,363,447,353
"063574805",228,291,519,204,234,203
"063574808",229,269,498,197,236,196
"063574815",234,285,519,214,268,204
"063575001",327,382,709,257,307,246
"063575013",258,307,565,192,220,186
"063575101",345,366,711,237,281,224
"063575212",563,578,1141,324,333,305
"063575305",410,408,818,264,302,256
"063575311",554,564,1118,329,348,316
"063575314",402,411,813,234,239,210
"063575401",435,456,891,301,324,283
"063575506",374,446,820,257,270,250
"063575606",342,425,767,284,330,264
"064413603",316,364,680,235,243,217
"063575708",245,297,542,208,237,195
"063575805",459,505,964,350,392,339
"063575904",358,408,766,291,372,286
"063576009",294,362,656,212,236,206
"063576106",573,611,1184,373,454,364
"063576204",381,450,831,292,344,283
"063576208",243,269,512,183,234,181
"064414011",685,650,1335,386,372,357
"063576301",46,13,59,4,5,4
"063576504",471,539,1010,334,455,321
"063576704",505,529,1034,302,320,287
"063576707",687,673,1360,402,417,379
"063576708",401,436,837,252,259,233
"063576711",659,750,1409,379,385,343
"063576901",386,438,824,240,249,209
"063576911",328,343,671,194,214,176
"063577004",584,675,1259,419,462,407
"063577006",383,395,778,253,273,243
"063577007",554,602,1156,380,407,353
"063577103",544,610,1154,397,437,375
"063577105",412,449,861,269,292,249
"063577107",460,492,952,321,321,287
"063577108",552,655,1207,424,455,395
"063713108",416,472,888,304,290,243
"063577201",573,594,1167,289,299,276
"063577306",680,687,1367,347,378,342
"063577307",136,123,259,71,95,70
"063577401",474,509,983,336,465,330
"063577403",382,368,750,228,256,216
"064415202",355,376,731,254,260,243
"063577416",278,249,527,158,251,153
"063577505",124,123,247,64,276,64
"063577507",285,312,597,196,356,187
"063577509",106,121,227,82,243,81
"063577516",92,78,170,58,159,58
"063577610",356,375,731,242,443,234
"063577708",75,61,136,42,139,41
"063577716",1065,671,1736,66,314,65
"063577803",220,199,419,111,126,106
"063577810",602,594,1196,296,307,285
"063577816",416,406,822,207,208,196
"063578014",234,199,433,137,176,135
"063578012",160,144,304,100,147,98
"063578208",108,114,222,90,210,90
"063578209",93,98,191,67,166,67
"063640103",503,575,1078,368,373,329
"063640206",419,395,814,234,237,175
"063640213",261,246,507,143,225,139
"063640303",429,406,835,230,274,224
"063640406",426,412,838,213,242,212
"063640408",468,442,910,237,218,195
"063640701",438,399,837,263,306,250
"063710106",305,349,654,162,130,124
"063710107",222,196,418,102,101,99
"063710203",586,627,1213,426,406,376
"063710401",620,758,1378,478,465,432
"063710701",429,506,935,283,299,267
"063710706",782,777,1559,426,310,295
"063710808",500,551,1051,359,391,334
"063710810",464,513,977,340,378,335
"063711003",478,525,1003,352,380,324
"063711102",251,411,662,237,284,236
"063711208",583,635,1218,432,495,423
"063711404",473,515,988,248,254,241
"063711412",405,455,860,281,253,236
"063711505",1251,1257,2508,654,508,501
"063711702",430,529,959,331,364,317
"063711704",461,499,960,321,348,309
"063711707",424,434,858,305,338,296
"063711713",539,595,1134,368,406,359
"063711903",391,409,800,309,379,304
"063711907",466,563,1029,370,418,357
"063712203",406,444,850,276,288,259
"063712101",548,540,1088,312,388,311
"063712113",387,426,813,292,318,275
"063712302",551,709,1260,414,446,409
"063712303",157,198,355,150,281,147
"063712316",577,671,1248,426,446,404
"063712317",383,406,789,278,333,278
"063712504",451,485,936,297,353,285
"063712601",508,546,1054,371,400,342
"063712604",477,491,968,334,360,323
"063712703",881,883,1764,524,545,490
"063712905",580,633,1213,404,458,390
"063712908",891,1011,1902,654,681,588
"063713210",699,725,1424,440,413,391
"063713301",472,506,978,267,266,258
"063713405",793,811,1604,460,444,432
"063713406",430,457,887,284,298,255
"063713408",471,540,1011,349,377,314
"063713508",130,112,242,54,22,22
"063850715",354,387,741,272,306,259
"063920106",436,492,928,385,458,385
"063920113",538,511,1049,318,329,303
"063920801",377,378,755,258,293,252
"063990801",33,23,56,20,39,19
"064060207",432,390,822,235,279,229
"064060216",328,283,611,214,251,211
"064080107",584,614,1198,399,407,369
"064080114",55,64,119,34,26,26
"064080404",957,924,1881,508,378,360
"064080405",614,649,1263,360,366,349
"064080406",483,518,1001,284,274,254
"064080503",608,609,1217,356,350,333
"064080505",227,262,489,135,110,103
"064080607",490,539,1029,344,375,336
"064080609",467,505,972,351,402,339
"064080704",604,646,1250,424,406,373
"064080708",459,492,951,337,380,326
"064080709",317,351,668,218,236,214
"064080805",334,389,723,241,256,228
"064080809",371,400,771,253,274,245
"064080810",507,529,1036,335,369,322
"064080904",349,398,747,261,292,245
"064081003",653,738,1391,436,424,377
"064081109",140,145,285,73,78,72
"064081312",566,567,1133,344,335,318
"064081410",415,461,876,273,278,251
"064970606",196,189,385,100,113,98
"064100107",371,392,763,227,304,223
"064100210",422,462,884,287,306,273
"065151703",295,290,585,194,217,183
"064100402",573,627,1200,336,341,302
"064100406",603,602,1205,364,400,341
"064100416",260,289,549,181,254,167
"064100502",517,520,1037,297,266,253
"064100506",384,398,782,219,193,174
"064100513",625,672,1297,394,384,355
"064100601",661,654,1315,356,368,346
"064100603",583,619,1202,380,410,370
"064100701",302,352,654,222,238,218
"064100704",620,681,1301,440,471,429
"064100712",429,486,915,282,305,269
"064100807",561,617,1178,387,417,379
"064101001",599,658,1257,420,450,405
"064101002",615,667,1282,430,473,410
"064121115",661,671,1332,362,358,339
"064101102",455,568,1023,352,412,350
"064101105",261,309,570,200,320,199
"064101110",502,536,1038,348,382,341
"064101201",411,498,909,331,408,327
"064101203",261,333,594,212,237,201
"064101213",685,784,1469,472,476,436
"064101310",371,434,805,250,257,229
"064120105",201,181,382,99,155,98
"064120110",713,721,1434,406,450,380
"064120114",646,615,1261,332,350,325
"064120302",804,825,1629,448,465,428
"064120303",701,751,1452,441,449,418
"064120304",682,713,1395,405,388,357
"064120409",320,383,703,230,242,212
"064120608",785,848,1633,461,441,412
"064120514",446,512,958,297,371,275
"064120601",248,271,519,171,262,169
"064120603",383,471,854,292,336,277
"064120605",357,409,766,282,282,249
"064120611",820,908,1728,475,465,420
"064120613",525,582,1107,342,338,305
"064120701",721,737,1458,370,373,348
"064120705",484,486,970,274,245,238
"064120713",701,699,1400,374,347,324
"064120918",808,814,1622,407,413,380
"064121013",510,480,990,259,223,212
"064121020",799,826,1625,399,399,369
"064121021",673,716,1389,330,420,327
"064121110",436,435,871,242,225,209
"064270109",305,290,595,262,297,258
"064121116",574,600,1174,289,277,266
"064121203",830,764,1594,386,364,346
"064121207",886,867,1753,448,420,399
"064121302",710,750,1460,381,364,351
"064121307",671,631,1302,299,284,276
"064121401",419,434,853,250,271,249
"064121402",575,584,1159,326,315,307
"064130108",412,495,907,299,327,285
"064121508",512,524,1036,270,255,244
"064121509",511,534,1045,291,288,265
"064130102",435,473,908,293,278,257
"064130104",568,607,1175,372,377,363
"064130203",488,542,1030,322,354,304
"064130211",349,368,717,298,375,283
"064130212",358,420,778,301,352,292
"064130213",427,479,906,258,274,250
"064130305",255,319,574,240,373,237
"065151906",478,475,953,240,233,229
"064130311",390,394,784,267,292,266
"064130409",467,502,969,386,467,377
"064130502",334,416,750,298,345,293
"064130513",157,240,397,148,224,143
"064900805",195,238,433,157,199,155
"064130606",352,394,746,307,367,303
"064131303",299,306,605,172,200,164
"064131903",74,70,144,40,62,40
"064132203",66,65,131,42,105,42
"064132207",103,110,213,68,99,66
"064200108",108,120,228,81,287,80
"065151807",718,713,1431,349,286,280
"065180808",123,108,231,83,390,82
"064200206",33,34,67,26,258,24
"064200303",61,84,145,63,334,61
"064200317",61,60,121,58,341,58
"064200318",55,57,112,39,346,38
"064200320",256,265,521,132,285,131
"065151705",316,335,651,204,310,203
"065151706",799,817,1616,388,597,365
"064411813",200,234,434,203,282,199
"064200407",168,167,335,114,337,112
"064200411",141,168,309,101,211,92
"064200415",93,100,193,72,450,72
"065250414",706,746,1452,373,419,361
"064200611",9,9,18,8,255,8
"064200708",51,58,109,53,379,53
"064200709",24,29,53,24,337,22
"064200807",137,162,299,111,410,108
"064201003",24,34,58,29,289,28
"065320308",577,596,1173,355,355,331
"064201106",140,152,292,89,216,84
"064201114",85,79,164,74,502,71
"064201116",167,162,329,115,754,115
"064201203",128,116,244,101,762,101
"064201205",90,89,179,69,340,69
"064201407",25,25,50,23,298,19
"064201507",32,38,70,32,477,32
"064201604",21,17,38,15,316,15
"064201607",19,27,46,16,347,16
"064201705",42,40,82,34,493,33
"064201709",324,349,673,196,400,181
"064201801",25,18,43,16,303,16
"064201903",136,136,272,100,367,97
"064202102",85,93,178,68,224,63
"064202110",333,290,623,200,243,197
"064270113",375,427,802,307,330,267
"064270207",248,315,563,259,386,256
"064270208",293,331,624,251,306,243
"064270404",387,458,845,312,332,301
"064270406",483,510,993,322,352,307
"064270603",528,524,1052,319,310,295
"064270604",881,991,1872,574,501,462
"064270605",280,327,607,212,196,177
"064270701",570,665,1235,408,438,379
"064270801",663,716,1379,393,371,346
"064270802",619,724,1343,421,465,418
"064270805",562,644,1206,349,370,333
"064270810",787,840,1627,456,426,396
"064271001",690,800,1490,473,458,412
"064271005",669,679,1348,400,418,378
"064271008",604,677,1281,390,420,366
"064271012",609,698,1307,410,412,368
"064271202",619,716,1335,438,499,424
"064271204",324,354,678,216,244,204
"064271417",432,448,880,258,230,210
"064271504",539,664,1203,419,465,398
"064271508",426,427,853,269,261,244
"064271510",414,413,827,271,215,199
"064902604",218,225,443,160,181,155
"064271707",2881,2971,5852,1370,1068,979
"064271709",483,598,1081,275,238,228
"065391609",324,365,689,215,223,197
"064271811",934,896,1830,447,378,356
"064271812",182,185,367,67,60,55
"064272001",566,519,1085,242,219,218
"064272004",354,363,717,229,260,229
"064272016",1197,1335,2532,653,476,448
"064272101",703,792,1495,437,435,398
"064272103",827,879,1706,498,458,401
"064272107",473,519,992,320,361,312
"064272201",448,468,916,279,264,243
"064272209",586,622,1208,392,439,373
"064272303",888,984,1872,609,591,529
"064272306",608,700,1308,418,431,397
"064272512",1616,1677,3293,849,702,667
"064272611",583,650,1233,426,427,391
"064272801",492,579,1071,385,423,370
"064272809",353,399,752,246,258,237
"064272812",502,584,1086,396,419,365
"066580815",129,183,312,157,247,148
"065392712",801,845,1646,430,382,373
"064272914",579,627,1206,382,416,338
"064273202",375,446,821,271,311,249
"064273312",736,821,1557,508,542,480
"064273313",428,491,919,300,325,283
"064273411",320,380,700,255,297,248
"065392922",642,638,1280,362,355,333
"064273506",606,643,1249,408,430,381
"064273508",542,597,1139,343,354,322
"064273602",471,549,1020,334,378,312
"064273702",354,331,685,211,202,187
"064273902",614,619,1233,327,291,272
"064273904",669,756,1425,404,372,347
"064273908",60,35,95,22,13,12
"064274106",864,837,1701,374,337,329
"064274205",736,770,1506,394,377,352
"064274210",383,434,817,253,238,220
"064274303",694,767,1461,444,417,391
"064274304",543,603,1146,381,432,362
"064274308",534,607,1141,366,372,334
"064274311",503,535,1038,295,315,290
"064274404",615,702,1317,432,451,399
"064274503",467,478,945,308,328,302
"064274602",507,489,996,227,202,186
"064274613",785,837,1622,451,423,378
"064274704",359,381,740,225,217,204
"064274805",417,506,923,304,326,281
"064274813",658,709,1367,415,385,361
"064274903",681,729,1410,351,300,276
"064275006",784,802,1586,475,456,438
"065530303",103,85,188,64,241,60
"064275105",534,574,1108,317,281,270
"064275205",879,877,1756,448,386,368
"064275207",706,714,1420,376,319,308
"064275405",532,572,1104,298,283,269
"064275601",523,543,1066,293,295,278
"064275711",476,502,978,275,190,181
"064275714",414,435,849,231,193,190
"064275806",423,452,875,248,211,200
"064275807",669,694,1363,347,316,296
"064275815",1181,1200,2381,543,82,76
"064275903",1001,1065,2066,561,418,396
"064276004",572,639,1211,319,298,282
"064276017",518,542,1060,312,294,273
"064276101",939,1011,1950,532,512,478
"064276105",1157,1156,2313,582,499,478
"064276106",848,798,1646,375,287,277
"064276209",609,696,1305,340,263,238
"064276210",998,1055,2053,554,446,407
"065600717",790,746,1536,416,449,396
"064276403",876,908,1784,438,248,236
"064276409",860,901,1761,495,385,367
"064276501",1110,1088,2198,492,403,383
"064276506",687,799,1486,335,139,132
"064276602",642,648,1290,323,293,282
"064276702",1038,1055,2093,470,274,251
"064276703",572,573,1145,288,282,250
"064276715",684,706,1390,299,217,205
"064276810",451,463,914,261,267,253
"064276901",571,566,1137,289,218,210
"065601107",765,742,1507,393,437,370
"064276910",301,370,671,221,228,190
"064276912",439,505,944,268,258,246
"065601204",392,414,806,232,241,223
"064277008",823,801,1624,389,270,247
"064277015",423,502,925,244,224,215
"064277107",804,854,1658,469,434,393
"064277116",814,800,1614,420,399,375
"064277315",702,697,1399,300,268,262
"064277408",800,789,1589,391,311,284
"064277410",874,915,1789,384,282,273
"064277414",866,839,1705,413,380,370
"064277503",792,806,1598,410,317,292
"064277504",1119,1114,2233,520,331,306
"064277513",760,769,1529,357,278,269
"064277514",633,624,1257,321,267,264
"064277601",889,905,1794,464,418,400
"064277810",764,688,1452,357,284,276
"065601703",627,619,1246,334,222,185
"064277611",1164,1148,2312,597,472,438
"064277612",1189,1183,2372,578,472,454
"064277614",576,567,1143,284,246,231
"064277615",1039,1016,2055,491,407,365
"064277616",1015,1047,2062,493,421,372
"064277707",704,701,1405,360,292,281
"064277909",508,517,1025,297,291,280
"064277910",813,844,1657,462,358,333
"064278002",945,866,1811,475,441,427
"064278014",566,594,1160,272,220,213
"064278104",726,726,1452,318,234,226
"064278112",131,144,275,65,65,64
"064278205",937,949,1886,415,244,239
"064278207",1028,1042,2070,482,419,413
"064278213",646,657,1303,349,334,316
"065602011",493,547,1040,276,224,217
"064278406",601,626,1227,334,332,312
"064278603",644,673,1317,361,385,348
"064278610",565,563,1128,303,311,282
"064278701",627,628,1255,342,312,298
"064278711",79,78,157,45,44,42
"064278802",1008,1059,2067,546,527,503
"064278904",1183,1178,2361,588,520,498
"064278912",1107,1143,2250,538,476,454
"064279003",403,482,885,236,197,187
"064279103",904,879,1783,434,340,320
"064279216",690,720,1410,367,323,304
"064279201",873,864,1737,389,393,359
"064279203",516,477,993,235,238,205
"064279205",894,912,1806,432,388,372
"064279212",624,670,1294,371,380,353
"064279219",800,817,1617,413,404,371
"064279301",838,785,1623,363,338,316
"065681301",300,307,607,221,269,218
"064279407",687,680,1367,309,272,246
"064279508",1171,1127,2298,470,377,370
"064279514",801,785,1586,389,376,342
"065681508",561,609,1170,416,455,412
"064279715",372,398,770,216,231,207
"065151811",595,553,1148,308,218,216
"064279717",576,531,1107,277,293,247
"064279719",415,384,799,216,247,214
"064340208",268,293,561,197,224,193
"064340304",409,496,905,307,307,245
"064340408",188,206,394,144,183,143
"064340410",470,529,999,368,420,354
"064340502",560,633,1193,383,440,368
"064340601",433,541,974,334,391,328
"064340704",317,360,677,230,245,214
"064340709",280,298,578,177,173,149
"064340815",727,788,1515,421,406,380
"064340905",402,421,823,222,158,146
"064340909",585,589,1174,315,204,191
"064340914",675,709,1384,381,347,329
"064341001",485,520,1005,290,274,254
"064341006",496,536,1032,315,329,303
"064341010",598,599,1197,342,320,295
"064341011",780,828,1608,379,347,326
"064341109",416,438,854,268,256,247
"064341112",554,638,1192,394,425,374
"064343115",152,195,347,140,213,139
"064341205",447,480,927,313,347,312
"064341208",423,457,880,324,340,296
"064341308",494,560,1054,347,418,341
"064341602",381,420,801,284,318,267
"064341611",445,496,941,320,343,314
"064341613",499,597,1096,380,429,363
"064341703",443,515,958,352,417,322
"064341803",519,604,1123,396,423,368
"064341807",194,250,444,184,259,183
"064341814",114,146,260,113,146,113
"064341902",500,540,1040,367,417,348
"064342004",241,305,546,206,222,200
"064342005",394,458,852,318,353,318
"064342105",355,384,739,249,254,243
"064342106",308,345,653,208,191,176
"064342108",370,396,766,252,266,245
"064342201",498,526,1024,301,293,260
"065810504",77,91,168,83,403,83
"064342204",523,557,1080,311,305,291
"064342206",477,540,1017,314,191,188
"064342309",480,495,975,267,247,239
"064342311",696,695,1391,393,377,363
"064342312",457,508,965,290,200,194
"064342401",392,435,827,239,209,187
"064342402",302,290,592,201,216,190
"064342405",375,380,755,261,278,248
"064342510",412,440,852,257,232,220
"064342511",452,477,929,294,258,243
"064342513",435,436,871,265,276,254
"064342604",741,707,1448,361,333,314
"064342611",405,430,835,214,187,174
"064342702",459,484,943,316,324,281
"064342705",256,316,572,190,204,163
"064342806",519,562,1081,358,325,294
"064342814",460,489,949,283,304,276
"064343104",292,317,609,216,248,215
"064343213",324,405,729,294,365,291
"064343308",326,356,682,248,251,214
"064343410",510,574,1084,346,362,327
"064343411",489,559,1048,347,379,339
"064343503",256,282,538,177,201,170
"064343510",532,555,1087,294,281,255
"064343513",495,504,999,302,263,238
"064343601",536,531,1067,366,408,356
"064343701",293,350,643,219,255,213
"064343704",422,460,882,303,327,286
"064343804",384,478,862,339,427,329
"064343908",212,248,460,175,189,164
"064344106",541,554,1095,316,288,274
"064344303",499,575,1074,382,421,358
"064344307",372,440,812,261,291,249
"064344308",300,377,677,231,260,223
"064344406",902,924,1826,463,468,443
"064410112",352,350,702,309,413,298
"064410204",214,225,439,208,246,201
"064410211",292,295,587,223,246,211
"064410302",525,563,1088,415,426,387
"064410504",229,291,520,251,393,240
"064410507",153,163,316,145,199,135
"064410607",199,247,446,219,297,210
"064410704",186,297,483,225,273,221
"064410809",162,269,431,245,416,244
"064410905",199,272,471,231,313,225
"064410910",56,87,143,71,98,71
"064411001",579,584,1163,400,412,384
"064411015",150,230,380,177,283,173
"064411115",175,251,426,202,297,198
"064411213",158,210,368,200,358,199
"064411214",142,193,335,169,322,167
"064411302",224,287,511,268,369,254
"064411304",238,312,550,281,460,272
"064411305",107,158,265,142,222,134
"064411307",202,252,454,215,292,209
"064411606",415,467,882,351,418,345
"064411406",140,184,324,159,200,152
"064411504",263,302,565,241,365,238
"064411508",163,188,351,202,269,198
"064411712",356,423,779,298,360,294
"064411909",191,231,422,204,265,200
"064412014",36,55,91,57,241,57
"064412108",197,238,435,196,265,187
"064412202",365,424,789,288,353,276
"064412205",376,425,801,300,365,299
"064412207",281,316,597,216,264,213
"064412208",341,379,720,253,317,250
"064412405",498,573,1071,411,496,403
"064412411",506,555,1061,377,469,366
"064412506",254,302,556,231,318,230
"064412508",274,308,582,224,264,218
"064412602",252,285,537,214,269,198
"064412607",316,379,695,266,321,259
"064412703",430,477,907,313,359,312
"064412704",397,470,867,331,397,322
"064412907",256,332,588,242,288,232
"064412914",501,546,1047,337,401,332
"064413006",491,550,1041,362,388,348
"064413107",301,374,675,233,270,229
"064413308",307,311,618,230,258,212
"064413311",569,681,1250,423,448,390
"064413409",323,355,678,223,233,219
"064413411",370,402,772,231,229,210
"064413509",528,602,1130,361,388,354
"064413512",489,509,998,349,373,336
"064413516",1366,1280,2646,752,660,603
"064413801",777,860,1637,501,505,465
"064413809",583,584,1167,311,282,249
"064413908",470,478,948,295,288,270
"064414002",433,440,873,272,272,263
"064414005",258,295,553,182,186,169
"064414010",656,686,1342,371,357,342
"064414101",1156,1110,2266,588,575,545
"064414106",475,481,956,272,294,265
"064414217",691,737,1428,408,444,388
"064414219",1256,1084,2340,370,383,345
"064414305",352,375,727,238,241,206
"064414707",774,761,1535,496,567,454
"064414809",328,352,680,236,255,213
"064414908",246,275,521,193,223,189
"064414909",302,320,622,250,296,245
"064415003",521,580,1101,405,443,389
"064415107",385,398,783,246,238,212
"064415116",254,247,501,160,172,145
"064415118",494,522,1016,333,381,322
"064415204",620,619,1239,352,363,327
"064415307",300,309,609,214,237,199
"064415407",344,363,707,252,271,233
"064760104",186,264,450,190,215,185
"064415702",393,421,814,255,279,244
"064415711",558,587,1145,340,391,333
"064415803",406,414,820,276,321,276
"064415804",223,270,493,180,216,175
"064415807",389,433,822,228,256,228
"064415903",300,299,599,204,201,192
"064415905",293,367,660,246,265,240
"064415907",472,481,953,302,310,288
"064416201",177,166,343,111,149,107
"064416206",336,397,733,286,321,269
"066232103",10,7,17,5,6,4
"064416305",272,295,567,180,260,172
"066232203",311,392,703,261,282,259
"064416405",254,254,508,136,151,130
"064416409",731,681,1412,395,311,223
"064416415",549,612,1161,329,397,309
"064416416",238,253,491,150,176,144
"064416417",915,447,1362,218,203,187
"064416418",335,328,663,177,251,177
"066232806",562,647,1209,424,444,402
"064416513",282,292,574,150,220,145
"064416517",570,578,1148,324,332,306
"064416602",453,483,936,241,272,239
"064416603",890,874,1764,472,430,361
"064416605",43,30,73,19,13,12
"064416609",604,578,1182,311,334,286
"066380107",665,655,1320,353,385,343
"064416906",821,848,1669,458,465,390
"065151903",847,784,1631,413,450,400
"064416911",610,575,1185,319,357,308
"064900806",264,326,590,222,274,218
"064417001",722,720,1442,424,468,407
"064480601",636,704,1340,464,554,457
"064480602",469,543,1012,357,402,350
"064550107",322,328,650,183,213,180
"064550108",426,405,831,264,290,261
"064551403",246,221,467,144,231,143
"066381405",645,600,1245,323,331,299
"064690107",270,372,642,262,338,260
"064690113",362,368,730,261,293,254
"064690209",258,303,561,206,250,203
"064690901",297,294,591,242,295,240
"064691302",613,602,1215,435,498,420
"064760708",319,285,604,182,206,178
"065151907",955,967,1922,511,504,488
"064761405",271,301,572,220,254,214
"064830117",402,441,843,278,312,273
"064830415",538,581,1119,326,341,310
"064900103",365,354,719,202,221,194
"064900106",399,384,783,222,225,216
"064900302",680,685,1365,390,329,310
"064900403",523,529,1052,281,266,254
"064900409",463,452,915,208,205,194
"064900412",414,426,840,222,160,153
"064900512",750,789,1539,454,455,428
"064900515",815,860,1675,463,353,337
"064900612",378,455,833,337,417,334
"064900801",339,369,708,243,243,229
"064900901",499,584,1083,369,378,326
"064901003",394,451,845,300,358,296
"064901406",342,387,729,226,186,169
"064901501",540,547,1087,290,253,242
"064901508",422,470,892,229,168,155
"064901806",339,385,724,211,198,190
"064901912",260,317,577,200,217,199
"064902006",397,483,880,293,328,289
"064902102",484,506,990,346,389,322
"064902205",180,277,457,223,304,222
"064902407",210,276,486,211,307,209
"064902409",124,177,301,161,249,159
"064902410",197,305,502,244,423,241
"064902607",529,609,1138,361,388,344
"064902611",382,406,788,278,306,276
"064902805",427,484,911,314,355,300
"064902908",718,826,1544,484,488,469
"064903003",498,512,1010,287,273,248
"064903006",519,567,1086,325,278,238
"064903206",943,976,1919,505,375,347
"064903304",595,538,1133,300,271,246
"064903508",850,892,1742,456,372,350
"064903512",509,522,1031,258,253,248
"064903703",413,406,819,245,252,242
"064903706",633,616,1249,361,352,334
"064903714",806,791,1597,458,377,346
"064904009",1134,1130,2264,583,578,563
"064904406",623,650,1273,408,430,371
"064904308",392,396,788,193,190,178
"064904313",450,462,912,275,252,214
"064904401",384,432,816,300,337,290
"064904505",582,603,1185,382,422,374
"064904801",386,430,816,287,342,285
"064904807",370,414,784,286,338,278
"065391406",655,737,1392,431,424,394
"065391504",687,769,1456,385,502,375
"065391507",362,449,811,314,415,306
"061190201",19,11,30,10,17,10
"061540206",15,13,28,9,11,9
"060070108",13,11,24,11,23,11
"060070207",3,0,3,3,8,3
"060070303",28,20,48,15,24,15
"060070401",13,12,25,13,31,13
"060070412",2,0,2,2,7,2
"060070609",8,12,20,8,13,8
"060070614",6,4,10,4,10,4
"065391710",437,505,942,290,294,273
"065391606",312,364,676,297,480,295
"060071109",0,0,0,0,5,0
"060140701",25,13,38,12,32,12
"060141202",22,11,33,18,43,18
"060141301",32,32,64,21,86,21
"060210101",10,8,18,9,17,9
"060210204",11,8,19,6,34,6
"060210804",23,16,39,16,25,16
"060210901",18,14,32,12,31,12
"062031404",7,7,14,5,12,5
"060283017",22,14,36,11,11,10
"062171011",120,123,243,77,114,74
"060420601",97,67,164,58,73,55
"060421601",49,31,80,34,77,34
"060490801",32,21,53,20,31,19
"060492004",51,34,85,34,81,33
"062660201",25,18,43,15,25,15
"065391701",600,627,1227,314,307,288
"060630803",12,8,20,8,19,8
"060630902",17,16,33,17,26,17
"060631203",11,9,20,8,19,8
"060700805",19,19,38,13,28,13
"060701002",41,32,73,19,31,19
"065391713",372,429,801,268,293,257
"060770701",23,12,35,14,21,14
"060770904",33,27,60,24,33,24
"065391801",690,777,1467,360,348,316
"060840502",33,23,56,17,31,17
"065391802",594,623,1217,347,308,258
"060841002",8,3,11,7,18,7
"060841003",14,14,28,10,23,10
"060910510",53,35,88,27,20,19
"062800704",90,72,162,54,83,54
"062800812",21,15,36,15,21,12
"062940502",7,6,13,5,28,5
"061120304",8,10,18,8,12,8
"061120306",13,16,29,8,14,8
"061120502",17,13,30,10,19,10
"061120803",25,14,39,13,19,13
"061120908",6,4,10,3,11,3
"061121302",15,7,22,11,27,11
"065391903",536,546,1082,308,312,293
"061190104",23,20,43,15,26,15
"063220903",5,3,8,5,13,5
"061191010",59,42,101,34,57,33
"061261004",67,52,119,37,118,37
"061340404",122,97,219,67,106,64
"061340501",248,220,468,141,212,137
"065392001",390,426,816,244,235,224
"061341001",64,61,125,38,51,35
"061400102",24,23,47,17,22,17
"061400314",25,12,37,11,26,11
"061470202",23,30,53,13,37,11
"061470601",7,7,14,4,21,4
"061470707",3,1,4,1,11,1
"061470902",82,64,146,48,71,42
"061471102",14,18,32,9,31,9
"061540302",53,42,95,32,47,31
"061540803",34,27,61,19,33,19
"061610503",12,14,26,7,14,7
"061610703",20,19,39,11,32,11
"061680201",23,22,45,11,11,11
"061680202",22,18,40,8,8,8
"061680502",13,7,20,7,14,7
"068052611",148,149,297,112,391,112
"065392011",700,749,1449,379,386,372
"061680603",18,7,25,13,21,13
"061750301",10,7,17,6,11,6
"061750304",1,0,1,1,4,1
"061750615",21,24,45,16,17,16
"061820302",235,31,266,6,19,6
"061820601",30,30,60,20,52,19
"061890501",5,3,8,2,9,2
"061890207",14,6,20,9,18,9
"061890302",8,5,13,5,16,5
"061890503",9,5,14,6,16,6
"061890804",3,0,3,3,13,3
"061891208",9,5,14,5,14,5
"061891306",7,2,9,4,12,4
"061891309",1,2,3,1,11,1
"061891601",22,8,30,11,22,11
"061891604",4,3,7,3,7,3
"061960404",9,7,16,7,13,7
"061960604",4,3,7,4,11,4
"065392203",693,820,1513,448,470,431
"065392206",670,752,1422,436,455,402
"061961302",9,6,15,5,18,5
"061961505",2,3,5,2,6,2
"062030305",13,17,30,9,26,9
"062030404",6,6,12,5,18,5
"062030605",10,1,11,5,11,5
"065392308",652,656,1308,335,319,301
"065392309",702,692,1394,359,341,326
"062031005",12,6,18,6,20,6
"062031102",28,16,44,12,20,12
"062031105",6,2,8,3,11,3
"062031402",18,17,35,11,22,10
"062031303",11,9,20,7,11,7
"062100609",18,18,36,14,23,14
"062170511",21,17,38,12,14,12
"062170604",42,24,66,22,50,21
"062170801",47,38,85,27,54,27
"062170902",51,33,84,31,33,29
"062170906",30,26,56,20,22,20
"065392502",626,674,1300,331,303,283
"062171006",33,37,70,22,33,22
"062171009",38,29,67,22,53,22
"064060104",11,9,20,7,10,7
"062240604",52,51,103,35,49,35
"062240802",19,20,39,12,32,12
"062240910",93,75,168,55,61,52
"062241703",41,28,69,24,35,21
"062241802",26,21,47,18,19,16
"062242101",22,12,34,9,31,9
"062310303",44,40,84,22,25,21
"062310704",31,32,63,16,23,16
"062310705",3,1,4,1,15,1
"062380302",40,21,61,25,48,25
"065392612",748,756,1504,394,396,372
"062660104",101,79,180,62,79,61
"062800705",30,30,60,18,27,18
"062800706",23,18,41,15,27,15
"062800707",9,11,20,10,28,10
"062801204",50,30,80,29,38,29
"062870702",78,47,125,48,80,48
"062940702",18,12,30,12,24,12
"062940703",9,7,16,7,16,7
"063010201",69,58,127,48,77,46
"065392706",783,800,1583,407,374,358
"063080901",54,29,83,35,51,34
"063080401",46,27,73,24,49,24
"063150601",190,143,333,122,156,117
"063220102",5,1,6,3,13,3
"063220203",7,6,13,4,9,4
"063220405",7,5,12,5,7,5
"063220502",10,4,14,10,16,10
"063220609",9,7,16,5,12,5
"063221004",39,25,64,24,36,24
"063221005",34,27,61,22,29,21
"063221301",10,10,20,6,11,6
"063221302",16,6,22,9,13,9
"063290202",35,34,69,18,33,18
"063290303",126,122,248,64,82,64
"063360101",54,48,102,35,58,35
"063360501",184,148,332,116,178,111
"063360901",44,29,73,33,54,30
"063430103",113,102,215,66,96,64
"063430605",29,22,51,17,34,17
"063430801",23,15,38,16,37,15
"063510303",9,3,12,4,9,4
"063510404",30,19,49,17,32,17
"063510609",4,0,4,2,9,2
"063510703",12,9,21,9,21,9
"063577705",83,62,145,52,83,51
"063578105",113,97,210,70,93,67
"064480611",12,11,23,6,20,6
"067631816",395,387,782,218,256,214
"063920202",46,29,75,20,24,19
"063920306",52,50,102,29,52,29
"063990104",41,21,62,23,76,22
"063990803",30,21,51,20,38,20
"065050104",11,17,28,8,13,8
"064130801",NA,NA,NA,NA,NA,NA
"065392901",77,74,151,37,53,37
"064130802",NA,NA,NA,NA,NA,NA
"064131001",NA,NA,NA,NA,NA,NA
"064131105",NA,NA,NA,NA,NA,NA
"065180210",0,0,0,0,1,0
"064131701",NA,NA,NA,NA,NA,NA
"064200101",12,9,21,7,10,6
"064201209",1,5,6,0,0,0
"066230602",17,13,30,10,33,9
"064480203",28,10,38,16,19,15
"064480302",11,4,15,5,10,5
"064480701",19,15,34,10,15,10
"064480902",10,3,13,8,9,8
"064480903",7,4,11,3,5,3
"064481002",13,8,21,7,10,7
"064481004",3,3,6,3,10,3
"064620602",14,11,25,8,33,8
"064620604",22,13,35,13,31,11
"064621001",19,19,38,20,32,20
"064621102",14,15,29,8,15,8
"064690303",9,4,13,10,13,10
"064690406",29,21,50,15,35,15
"064690803",45,28,73,23,32,23
"064690904",24,17,41,11,17,11
"064691004",33,30,63,21,36,21
"064691104",22,17,39,13,28,13
"064691203",22,24,46,12,12,12
"064691204",21,12,33,10,16,10
"066382108",6,5,11,3,3,3
"064760204",38,22,60,25,43,25
"064760208",40,28,68,20,36,20
"064760302",22,17,39,18,34,15
"064760303",21,11,32,10,19,10
"064760404",19,20,39,15,28,15
"064760505",18,15,33,11,25,11
"064760601",13,6,19,9,15,9
"064760801",27,25,52,19,33,19
"064761203",36,27,63,26,32,25
"064761102",72,13,85,24,41,24
"064830201",28,19,47,13,26,13
"064830503",92,71,163,57,76,57
"066511312",13,9,22,9,14,9
"066550207",40,33,73,29,56,29
"064971002",77,51,128,49,63,49
"064971004",57,34,91,30,50,30
"064971006",37,38,75,22,68,22
"065050402",138,135,273,97,160,96
"065050404",61,43,104,36,32,32
"065110511",27,20,47,16,31,16
"065180409",6,6,12,5,8,5
"065180412",20,7,27,12,15,12
"067350403",66,55,121,22,28,22
"065320402",38,33,71,24,57,24
"065320602",14,11,25,8,17,8
"065320906",144,147,291,93,130,89
"065321003",51,45,96,32,54,32
"065321004",39,29,68,18,36,18
"065321102",101,79,180,64,108,64
"065321201",26,18,44,16,35,16
"065321202",13,15,28,9,18,9
"065470503",33,24,57,22,48,22
"067780802",3,4,7,2,6,2
"067980201",47,27,74,22,26,22
"065740301",21,17,38,10,13,10
"065600909",196,188,384,106,112,90
"065740303",109,98,207,56,92,55
"065740413",9,12,21,8,15,8
"065740601",86,67,153,43,74,41
"065740704",20,23,43,15,26,14
"065740705",76,54,130,32,50,32
"065740708",46,35,81,24,45,24
"065600910",94,93,187,55,78,49
"065810706",38,37,75,22,48,22
"065601004",685,696,1381,378,373,335
"065601009",657,646,1303,347,372,330
"065601012",617,624,1241,336,352,312
"065530111",25,15,40,17,395,17
"065392920",856,897,1753,444,438,412
"065810901",13,16,29,7,11,7
"065810904",9,8,17,7,13,7
"065810911",3,1,4,2,3,2
"065810913",14,15,29,11,11,10
"065811006",25,26,51,13,28,13
"065811104",15,11,26,8,16,8
"067000503",13,8,21,8,11,8
"065880306",36,21,57,17,32,17
"065881005",86,51,137,39,55,39
"065881010",17,8,25,8,28,8
"065881101",22,11,33,10,10,10
"067000504",8,11,19,6,12,6
"065951301",85,65,150,53,86,53
"065951802",11,10,21,9,16,8
"065951803",33,28,61,21,35,21
"065952705",29,25,54,19,34,13
"066020206",26,15,41,19,34,19
"066020207",60,24,84,34,69,33
"065393013",719,679,1398,364,378,351
"065393015",501,515,1016,323,326,304
"065393016",575,605,1180,342,362,327
"065393103",752,743,1495,365,373,337
"066091304",42,37,79,25,39,25
"066090304",34,16,50,15,22,15
"066090603",20,7,27,14,36,14
"066090801",6,2,8,2,10,2
"066091503",5,2,7,3,23,3
"066091602",22,17,39,10,21,10
"066091703",40,26,66,26,45,25
"066160103",55,41,96,33,44,33
"066160108",30,17,47,19,40,19
"066230603",0,0,0,0,14,0
"066231201",16,15,31,12,24,12
"066231502",22,23,45,16,26,16
"066231801",31,20,51,18,33,18
"066232211",14,17,31,10,13,9
"066232505",21,14,35,13,17,13
"068540503",31,23,54,18,47,18
"065393110",731,747,1478,380,390,364
"066300501",106,78,184,69,92,65
"068750501",12,19,31,11,19,11
"066382306",53,41,94,32,34,30
"066510101",11,9,20,7,18,7
"066510102",11,7,18,8,12,8
"066510406",4,4,8,3,8,3
"066510601",10,3,13,8,17,8
"066510608",4,1,5,4,5,4
"066510610",12,9,21,6,15,6
"066510712",10,5,15,6,20,6
"066510807",3,4,7,2,11,2
"066511005",5,3,8,3,10,3
"066550105",81,59,140,50,94,50
"066550308",209,188,397,122,192,118
"066650209",46,36,82,27,37,27
"066651003",22,15,37,14,29,14
"066720302",27,30,57,15,18,15
"066720802",20,13,33,14,26,14
"066720901",30,17,47,18,36,18
"065393202",765,802,1567,394,318,305
"066721101",11,8,19,7,22,7
"065393207",793,796,1589,385,316,294
"066790104",17,11,28,11,42,11
"066790202",19,12,31,12,29,12
"066790306",22,18,40,14,26,14
"066790501",5,5,10,4,15,4
"066790701",18,13,31,12,23,12
"066860403",6,4,10,4,17,4
"066861203",38,14,52,15,21,15
"066930603",23,26,49,11,20,11
"066930701",31,21,52,18,35,18
"067000108",9,2,11,4,17,4
"067000106",11,7,18,6,11,6
"067000204",225,149,374,78,93,78
"067000707",19,12,31,11,25,10
"067000807",11,4,15,7,26,7
"067001001",6,3,9,5,11,5
"067140203",19,18,37,11,25,11
"067140305",12,9,21,9,28,9
"067140403",28,25,53,20,47,20
"067140702",119,81,200,58,81,57
"067140802",6,5,11,5,24,5
"067210210",8,3,11,4,6,4
"067280102",96,78,174,60,79,57
"067280302",19,17,36,15,30,15
"067280304",17,10,27,10,12,10
"067280901",202,148,350,112,120,108
"067281303",32,25,57,21,59,21
"067350204",82,56,138,47,72,46
"067350207",29,34,63,21,38,21
"067350601",20,14,34,14,23,14
"067350502",7,4,11,4,6,4
"067350504",3,1,4,2,7,2
"065393315",333,304,637,160,151,146
"067420901",71,37,108,38,64,38
"067491512",180,143,323,102,187,98
"065682305",243,301,544,224,271,220
"065393411",572,632,1204,302,291,268
"067491504",161,123,284,86,253,86
"065393415",460,558,1018,265,301,256
"065393417",556,538,1094,299,296,279
"065393418",392,396,788,214,209,202
"067631302",27,23,50,17,28,17
"067700204",31,29,60,18,34,18
"067700602",17,13,30,9,12,9
"067700801",48,37,85,26,31,25
"067700803",15,17,32,10,15,10
"067701101",62,46,108,35,35,35
"067701605",56,37,93,36,50,36
"067701702",9,13,22,7,12,7
"067701904",7,4,11,5,11,5
"067702002",5,2,7,2,5,2
"067780601",12,3,15,4,4,4
"067840201",10,7,17,5,21,5
"067840302",23,19,42,12,22,12
"067840702",18,12,30,9,12,9
"067910602",69,36,105,38,53,33
"067910904",59,38,97,31,62,31
"067911102",51,39,90,29,47,29
"067911104",96,86,182,60,91,60
"067911503",66,40,106,32,45,32
"067980101",27,22,49,20,23,20
"067980102",38,21,59,21,21,21
"067980402",25,19,44,16,24,16
"067980902",17,11,28,12,23,12
"065810508",84,122,206,102,419,102
"065601115",546,569,1115,319,383,299
"065470908",490,569,1059,376,423,364
"065530102",204,189,393,143,344,143
"065530106",143,127,270,88,267,88
"065530307",91,86,177,73,364,70
"065600107",535,528,1063,259,260,251
"065600111",638,671,1309,316,325,305
"065600409",710,631,1341,328,299,290
"065600209",832,822,1654,465,394,388
"065600305",553,528,1081,269,267,254
"065600312",591,615,1206,345,334,312
"065600316",163,139,302,81,103,78
"065600402",497,500,997,284,266,249
"065600508",157,165,322,89,88,83
"065600510",692,706,1398,381,371,351
"068052603",200,184,384,157,423,150
"065600608",689,735,1424,387,371,358
"065600615",451,472,923,266,262,253
"067701005",532,574,1106,354,383,346
"065601306",482,536,1018,291,295,271
"065180613",105,96,201,61,190,58
"065180708",184,161,345,128,427,125
"065180715",164,187,351,123,276,114
"065180717",123,108,231,104,377,100
"067631704",550,585,1135,379,413,363
"065600709",433,432,865,246,244,222
"065601307",835,841,1676,456,435,403
"065180804",68,61,129,49,220,47
"065601308",596,627,1223,339,359,332
"065250104",333,326,659,189,190,173
"065250402",824,835,1659,433,446,405
"067350703",691,735,1426,381,372,342
"065250408",699,766,1465,414,443,395
"067420402",411,451,862,311,349,304
"065320109",269,371,640,233,302,227
"065320203",399,450,849,305,347,276
"065320207",477,526,1003,349,389,331
"065320302",788,836,1624,504,537,492
"065320911",403,379,782,239,292,225
"067491321",345,374,719,204,203,195
"067491420",471,454,925,210,152,147
"065321407",219,281,500,195,256,194
"065390114",520,641,1161,381,399,350
"065390202",403,385,788,233,223,208
"065390303",451,471,922,283,296,277
"065390306",321,408,729,280,327,273
"065390401",692,774,1466,452,472,414
"065390403",550,631,1181,404,414,386
"065390404",732,807,1539,449,447,434
"065390411",435,508,943,348,369,334
"065390604",487,474,961,281,249,241
"065390608",629,623,1252,352,337,315
"065390708",499,518,1017,323,309,289
"065390709",623,713,1336,451,491,436
"065390801",369,389,758,224,227,207
"065390806",508,549,1057,274,265,245
"065391004",557,576,1133,314,291,270
"065391104",608,633,1241,331,324,293
"063574002",261,274,535,246,603,160
"064340405",319,349,668,243,267,240
"068610306",202,285,487,258,293,249
"068821608",756,747,1503,391,366,344
"068821702",567,578,1145,302,285,259
"060210610",143,160,303,93,135,89
"060283011",538,533,1071,290,273,254
"060492006",270,263,533,189,247,185
"061190404",81,78,159,55,214,55
"060770509",726,757,1483,467,487,442
"061190904",142,130,272,98,134,96
"061260403",30,26,56,17,20,16
"061260508",708,675,1383,359,238,207
"061260904",NA,NA,NA,NA,NA,NA
"061750203",14,6,20,5,15,5
"062030406",9,6,15,6,13,6
"061750505",60,52,112,35,88,35
"061750614",138,128,266,85,103,81
"062031611",171,178,349,105,129,104
"062520801",125,122,247,60,67,54
"064760704",68,55,123,46,68,46
"062660205",207,192,399,125,220,115
"063010101",303,259,562,195,267,195
"064416704",209,180,389,108,134,102
"063920803",73,58,131,42,71,42
"064760703",151,125,276,82,106,78
"064131906",53,38,91,35,63,34
"064416519",768,586,1354,352,423,339
"064279112",1389,930,2319,561,387,369
"064279711",181,174,355,108,151,97
"064416501",323,302,625,169,274,167
"064416509",464,406,870,278,317,277
"064830303",121,112,233,73,87,69
"065951912",269,298,567,175,220,174
"064830904",70,43,113,34,103,33
"064970305",345,340,685,213,534,204
"064970410",469,436,905,234,280,225
"067780602",303,330,633,176,304,176
"066790608",349,304,653,185,242,183
"068541202",35,28,63,20,26,20
"066381401",252,277,529,171,190,164
"066550101",34,25,59,24,30,21
"066480203",255,246,501,161,333,156
"066510902",24,15,39,16,26,16
"066650503",46,41,87,33,53,32
"066721214",276,303,579,170,238,165
"066791001",578,556,1134,266,165,109
"066860602",87,77,164,57,111,55
"067280703",55,57,112,29,38,28
"067700202",88,75,163,55,110,55
"067701002",486,451,937,275,314,256
"068540303",37,39,76,30,60,30
"060980408",70,58,128,45,150,44
"065681404",290,300,590,262,324,259
"065681407",417,439,856,328,453,325
"065681503",415,450,865,334,361,324
"065681609",615,642,1257,423,434,408
"065681612",469,564,1033,388,401,360
"065681804",212,240,452,238,358,236
"065681805",296,322,618,258,328,254
"065681807",426,492,918,333,407,325
"065681808",333,377,710,256,282,252
"065681905",370,404,774,267,290,258
"065681906",571,676,1247,419,461,399
"065681908",531,577,1108,373,390,361
"065681909",532,599,1131,392,378,336
"065682004",348,418,766,298,372,289
"065682008",457,531,988,361,433,356
"065682202",186,186,372,138,160,138
"065682204",260,283,543,184,206,183
"065682211",196,190,386,144,146,144
"065682213",383,394,777,280,375,280
"065682216",314,318,632,211,264,208
"065682304",320,312,632,236,266,209
"065682403",250,256,506,202,223,189
"065682407",402,390,792,269,302,265
"065682410",344,391,735,228,237,213
"065682602",490,539,1029,359,396,343
"065682705",405,433,838,247,266,222
"065682707",589,604,1193,359,381,344
"065682709",487,531,1018,327,333,308
"065682902",487,542,1029,328,335,297
"065682908",500,587,1087,280,244,225
"065682911",1040,1098,2138,536,427,410
"065683005",417,488,905,265,276,255
"065683103",567,613,1180,334,293,273
"065683104",769,844,1613,472,473,448
"065740702",99,108,207,66,102,65
"065740801",148,137,285,104,138,102
"065810209",312,342,654,268,328,255
"065810802",249,252,501,192,219,190
"068051903",473,468,941,295,350,293
"065811504",460,501,961,359,359,340
"068052509",407,433,840,283,286,248
"065811604",436,469,905,319,310,275
"065811608",455,466,921,271,289,259
"065811803",99,131,230,107,205,107
"065811806",96,102,198,94,306,94
"065880113",350,381,731,249,295,247
"065880208",265,319,584,256,336,256
"065880304",115,133,248,87,110,87
"065880501",269,262,531,175,212,174
"065880702",118,117,235,89,125,89
"065880915",466,428,894,234,311,218
"065881702",437,496,933,296,307,283
"065950203",325,367,692,289,350,283
"065950206",275,392,667,291,410,279
"065950208",486,544,1030,362,445,356
"065950209",263,321,584,216,241,210
"065950307",267,341,608,258,407,255
"065950402",433,568,1001,400,493,398
"065950407",350,393,743,261,305,255
"065950408",330,360,690,253,275,241
"065950801",251,241,492,173,219,170
"065951601",559,568,1127,262,293,254
"065951612",308,342,650,224,247,222
"065951905",121,148,269,95,120,95
"065951910",301,301,602,189,192,187
"065952104",323,339,662,224,251,221
"065952407",451,501,952,352,398,338
"065952409",410,426,836,301,324,286
"065952410",439,444,883,256,278,247
"065952504",478,506,984,379,422,370
"065952505",387,388,775,294,352,283
"065952513",406,380,786,215,225,206
"065952704",461,411,872,232,319,231
"065952709",420,381,801,242,261,240
"066020301",649,618,1267,420,449,408
"066021101",570,596,1166,298,312,286
"066020802",357,348,705,265,318,265
"066020804",157,163,320,125,154,124
"066090209",494,576,1070,405,443,383
"068331903",555,583,1138,376,405,332
"066021611",411,421,832,234,266,233
"066090110",488,556,1044,322,345,312
"066090202",294,362,656,274,381,271
"066090212",498,522,1020,318,353,316
"068400303",510,514,1024,316,321,301
"066090215",335,349,684,218,254,216
"066090905",222,223,445,152,190,149
"066091301",99,107,206,74,103,73
"066091905",236,256,492,203,256,197
"066160306",198,237,435,175,222,173
"066160309",202,191,393,150,177,149
"066230110",296,292,588,169,166,157
"066230111",317,396,713,250,272,245
"066230206",332,401,733,295,375,289
"066230207",337,394,731,269,321,262
"066230303",249,303,552,240,317,225
"066230310",293,362,655,291,393,290
"066230401",384,457,841,345,411,339
"066230408",553,622,1175,392,437,381
"068401804",228,267,495,220,273,217
"066231601",208,204,412,129,159,127
"067491409",626,684,1310,338,269,257
"066232810",367,411,778,268,314,263
"066232902",652,671,1323,402,414,376
"066300204",212,262,474,162,199,160
"066380109",789,798,1587,433,432,383
"066380114",489,537,1026,309,630,301
"066380302",861,834,1695,422,398,369
"066380306",386,404,790,228,319,219
"066380307",234,275,509,163,383,159
"066380311",915,941,1856,490,480,431
"066380411",377,393,770,244,352,240
"066380602",481,515,996,301,323,281
"066380606",798,778,1576,390,346,323
"066380705",417,409,826,252,326,248
"066380709",383,405,788,226,272,211
"066381008",1090,1065,2155,524,518,490
"066380809",233,243,476,143,200,135
"066380901",253,283,536,181,288,179
"066380911",735,757,1492,374,360,342
"066381011",518,554,1072,313,308,281
"066381103",1208,1135,2343,573,553,529
"066381106",488,494,982,307,304,267
"066381108",793,739,1532,406,412,376
"066381201",159,171,330,113,143,110
"068612308",325,325,650,234,271,218
"066381209",296,317,613,150,300,136
"066381211",339,296,635,167,160,150
"066381310",649,623,1272,327,354,317
"066381503",552,580,1132,341,374,332
"066381504",625,665,1290,356,375,341
"066381506",551,594,1145,337,396,302
"066381603",434,495,929,377,479,368
"066381609",478,500,978,285,316,263
"066381610",555,638,1193,330,343,309
"066381702",382,353,735,215,255,161
"066381810",363,321,684,198,194,179
"068680403",20,29,49,19,274,19
"066381905",814,715,1529,384,784,346
"066382209",473,446,919,263,265,242
"066440104",46,51,97,43,325,43
"066440505",664,677,1341,446,552,423
"066440620",149,157,306,106,460,103
"066480102",599,594,1193,326,327,305
"066480108",505,546,1051,275,271,253
"066480113",610,646,1256,330,330,316
"066480202",482,450,932,252,270,244
"066480301",508,572,1080,314,324,287
"066480310",777,803,1580,413,444,404
"066480411",82,81,163,47,89,46
"066480511",718,740,1458,366,341,329
"066480512",521,534,1055,270,265,256
"066510803",1,1,2,1,8,1
"066510901",14,11,25,7,12,7
"066580104",328,352,680,249,278,249
"066580206",714,702,1416,428,438,409
"066580307",552,585,1137,378,366,335
"066580412",568,642,1210,398,420,396
"066580511",533,579,1112,356,374,332
"066580601",298,331,629,237,314,234
"066580702",408,453,861,259,314,255
"066580709",610,604,1214,305,287,270
"066580711",420,445,865,260,295,250
"066580813",105,161,266,138,235,138
"066580909",178,232,410,183,239,181
"066580910",299,366,665,302,439,298
"066580913",256,326,582,239,332,230
"066581001",624,594,1218,307,320,275
"066581102",310,367,677,260,301,251
"066581107",358,428,786,289,336,278
"066581302",259,270,529,137,130,123
"066581504",286,271,557,171,161,151
"066581604",219,267,486,186,212,177
"066581711",503,545,1048,361,351,314
"066581901",248,264,512,228,288,221
"066582110",524,556,1080,307,313,297
"066582112",998,1085,2083,553,496,458
"066582206",336,375,711,242,282,229
"066582310",691,700,1391,378,373,349
"066582401",495,489,984,316,344,309
"066582513",530,619,1149,375,396,366
"066582601",814,846,1660,517,549,500
"066582604",472,543,1015,349,340,295
"066582702",571,594,1165,327,320,307
"066582706",735,715,1450,402,403,384
"066582708",421,417,838,214,170,165
"066582709",814,860,1674,457,450,419
"066582712",691,708,1399,370,284,272
"066582908",784,785,1569,391,378,367
"066582911",577,595,1172,360,372,344
"066583102",523,594,1117,387,415,379
"066583104",634,752,1386,456,436,408
"066583109",372,413,785,270,287,264
"066583112",327,369,696,235,245,233
"066583203",502,605,1107,365,396,360
"066583311",525,617,1142,374,404,371
"066583413",616,681,1297,409,409,382
"066583501",499,564,1063,324,277,262
"066583502",645,681,1326,394,404,383
"066583601",1033,1030,2063,524,472,443
"066583703",516,553,1069,275,265,264
"066583706",650,654,1304,307,240,238
"066583802",1008,966,1974,490,368,357
"066583807",210,227,437,108,101,94
"066583810",434,396,830,222,213,211
"066583814",749,813,1562,421,382,352
"066583907",672,673,1345,370,351,339
"066584003",674,601,1275,301,339,291
"066584008",538,514,1052,284,220,215
"066584013",645,609,1254,333,338,331
"066584107",871,943,1814,497,532,491
"066584113",923,941,1864,495,433,414
"066584209",741,808,1549,467,473,433
"066584309",381,410,791,237,199,185
"066584403",774,792,1566,404,404,384
"066584409",1002,1012,2014,530,486,470
"066584410",752,755,1507,402,374,360
"066650102",370,355,725,195,214,191
"066650207",440,505,945,351,379,337
"066650306",305,294,599,169,188,166
"066651001",467,520,987,311,345,299
"066651304",493,482,975,318,322,298
"066651307",403,413,816,268,288,262
"066721201",747,726,1473,483,503,465
"066721208",487,532,1019,384,447,376
"066790305",171,152,323,107,129,106
"066790401",12,6,18,6,17,6
"066860201",348,370,718,244,294,243
"066860608",254,264,518,178,182,133
"066861312",305,364,669,266,313,252
"066930313",330,380,710,269,302,265
"066930317",308,311,619,254,302,252
"066930704",77,71,148,51,96,51
"067000207",186,193,379,150,195,150
"067001206",188,184,372,148,181,148
"067001211",490,521,1011,328,374,326
"067070101",569,555,1124,334,353,327
"067070603",196,197,393,130,169,130
"067071105",377,417,794,276,310,270
"067140107",471,518,989,337,377,332
"067140110",536,595,1131,375,436,368
"067140113",306,331,637,199,212,190
"067140606",306,352,658,240,271,236
"067140607",380,398,778,254,289,249
"067140610",270,299,569,164,197,160
"067210206",347,402,749,236,268,235
"067210214",372,394,766,240,279,237
"067281005",202,229,431,158,185,156
"067281007",228,256,484,162,175,153
"067281010",406,459,865,269,289,262
"067350104",286,362,648,239,304,236
"067350107",403,532,935,329,391,324
"067350301",276,253,529,151,253,144
"067490303",263,273,536,228,290,228
"067350707",586,580,1166,346,358,334
"067490309",275,317,592,239,291,232
"067490311",284,374,658,316,462,311
"067490502",325,387,712,249,320,244
"067490505",259,327,586,253,294,245
"067490708",667,733,1400,438,489,426
"067490804",616,652,1268,346,330,303
"067490805",651,733,1384,404,374,355
"067490905",692,770,1462,416,429,392
"067490906",632,575,1207,324,291,282
"067490907",327,370,697,248,269,233
"067491002",571,655,1226,366,351,307
"067491007",416,499,915,291,318,289
"067491013",306,292,598,191,199,182
"067491102",794,782,1576,375,340,328
"067491203",868,894,1762,446,426,406
"067491307",28,24,52,9,9,9
"067491308",437,434,871,242,199,177
"067491311",408,421,829,246,220,213
"067491316",915,905,1820,504,497,452
"067491317",463,523,986,264,230,220
"067600913",719,784,1503,390,431,381
"067560202",379,429,808,237,261,224
"067560206",401,467,868,278,388,268
"067560408",252,273,525,195,247,190
"067560502",442,468,910,281,371,280
"067560608",324,358,682,235,267,218
"067560709",385,510,895,285,341,279
"067560710",481,563,1044,326,368,319
"067560912",436,487,923,322,349,311
"067561004",248,355,603,331,448,329
"067561012",452,560,1012,337,378,322
"067561106",360,376,736,341,419,337
"067561107",371,404,775,373,481,368
"067561109",155,208,363,175,222,167
"067561211",486,523,1009,332,397,328
"067561306",390,434,824,298,297,259
"067561308",492,571,1063,377,426,346
"067561312",547,624,1171,373,389,335
"067561313",505,589,1094,400,432,379
"067561412",531,533,1064,270,252,241
"067561502",617,658,1275,365,355,335
"067601614",611,570,1181,305,312,301
"067561701",372,439,811,309,373,304
"067561803",364,437,801,295,328,292
"067561811",555,656,1211,425,487,419
"067561902",608,625,1233,421,436,399
"067562001",492,596,1088,285,298,260
"067562007",706,739,1445,468,476,442
"067562008",540,605,1145,362,393,350
"067562101",680,764,1444,415,446,372
"067562204",819,856,1675,465,333,320
"067562306",411,439,850,279,323,276
"067562405",325,385,710,240,248,235
"067562502",432,492,924,317,355,305
"067562505",302,331,633,238,269,230
"067562507",283,300,583,203,218,194
"067562509",499,601,1100,350,374,334
"067600111",339,356,695,222,231,209
"067600203",302,332,634,227,300,218
"067600215",193,228,421,208,307,202
"067600216",166,210,376,185,308,178
"067600501",849,913,1762,542,569,522
"067600503",698,813,1511,480,526,436
"067600707",389,404,793,242,279,236
"067600902",348,395,743,212,214,193
"067600911",700,788,1488,459,513,432
"067600914",610,624,1234,350,347,323
"067601001",441,376,817,228,175,167
"067601008",203,223,426,103,99,97
"067601012",797,894,1691,415,412,390
"067601015",754,751,1505,386,389,367
"067601106",1146,1183,2329,681,689,623
"067601210",455,450,905,234,232,208
"067601302",567,613,1180,330,352,317
"067601404",821,858,1679,444,426,397
"067601406",1169,1095,2264,572,543,499
"067601415",200,229,429,118,127,113
"067601505",848,878,1726,447,442,417
"067601607",580,576,1156,310,306,286
"067601609",482,475,957,262,217,204
"067601705",690,736,1426,345,333,323
"067601706",722,744,1466,391,339,332
"067601707",555,563,1118,295,280,263
"067601713",550,558,1108,316,268,247
"067601806",462,482,944,253,266,250
"067601813",519,545,1064,274,260,248
"067601815",542,547,1089,284,252,242
"067630108",380,485,865,345,449,316
"067630109",504,540,1044,389,513,381
"067630401",502,497,999,325,354,311
"067630409",424,492,916,271,286,268
"067630508",405,404,809,217,219,203
"067630509",471,480,951,257,268,242
"067630511",703,694,1397,432,439,405
"067630512",221,228,449,140,96,89
"067630513",600,616,1216,320,319,300
"067630604",646,679,1325,376,372,340
"067630608",830,771,1601,408,390,372
"067630609",591,593,1184,298,279,248
"067630806",518,568,1086,326,317,294
"067630808",666,645,1311,374,406,367
"067630813",527,534,1061,284,281,267
"067632013",470,469,939,262,265,250
"067631802",499,501,1000,274,259,251
"067631805",377,358,735,215,252,207
"067700111",542,542,1084,340,352,307
"067631814",522,510,1032,301,324,293
"067631910",341,419,760,295,314,278
"067632004",75,64,139,41,64,40
"067632009",438,484,922,310,335,297
"067700103",850,887,1737,510,457,414
"067700104",687,693,1380,359,363,344
"067700108",362,436,798,301,377,291
"067702105",374,433,807,313,367,305
"067702214",634,611,1245,391,436,348
"067780210",386,469,855,309,378,297
"067780215",588,625,1213,317,374,311
"067780907",288,292,580,152,191,151
"067781001",741,741,1482,415,434,400
"067910105",189,235,424,206,247,203
"067910107",389,469,858,371,470,354
"067910201",214,241,455,184,215,172
"067910203",356,417,773,268,299,255
"067910210",405,566,971,355,430,342
"067910406",221,282,503,224,290,217
"067911003",139,143,282,87,104,84
"067911303",395,438,833,267,291,244
"067911305",811,807,1618,498,525,477
"067911907",231,256,487,180,221,170
"067912002",454,534,988,313,338,309
"067912003",845,818,1663,450,502,439
"067912004",569,598,1167,353,383,341
"067912007",449,469,918,326,371,317
"067912111",537,522,1059,288,322,278
"067912212",358,391,749,254,281,251
"067980703",380,433,813,318,435,318
"067980709",257,254,511,180,229,179
"068050104",498,493,991,318,411,301
"068050106",284,280,564,158,242,153
"068050304",1120,1210,2330,607,729,513
"068050407",1328,1340,2668,719,647,621
"068050504",343,349,692,251,290,250
"068050507",749,843,1592,521,541,497
"068050510",387,439,826,269,278,261
"068050606",294,302,596,227,276,213
"068050711",45,49,94,35,336,34
"068050901",2,1,3,1,14,1
"068051007",837,828,1665,418,381,369
"068051010",815,775,1590,379,300,294
"068051102",405,433,838,253,248,237
"068051210",887,953,1840,595,647,568
"068051307",488,507,995,311,322,291
"068051501",402,460,862,275,290,256
"068051508",737,778,1515,433,455,405
"068051602",957,979,1936,550,540,513
"068051609",598,640,1238,316,325,294
"068051610",1088,1089,2177,594,353,329
"068051710",761,803,1564,431,327,299
"068051711",777,841,1618,443,376,355
"068051913",91,87,178,82,99,82
"068052007",1121,1142,2263,533,546,496
"068052104",1014,1041,2055,577,558,526
"068052107",582,583,1165,271,214,205
"068052113",703,709,1412,374,319,301
"068190407",435,412,847,262,308,255
"068052301",671,682,1353,344,332,312
"068052305",644,688,1332,365,348,312
"068052308",463,435,898,250,241,226
"068052310",808,746,1554,392,339,320
"068052402",743,756,1499,447,452,414
"068052404",616,623,1239,374,415,361
"068052410",780,762,1542,431,375,355
"068052503",267,254,521,156,198,154
"060281105",352,385,737,238,258,221
"068400210",421,443,864,279,306,271
"068190904",205,217,422,167,437,165
"068260110",116,159,275,131,189,131
"060281911",762,720,1482,362,351,332
"068260211",215,219,434,145,157,140
"060282401",560,624,1184,390,393,366
"068260704",282,318,600,179,278,178
"068261904",273,289,562,190,216,186
"068261905",228,253,481,165,198,164
"068261909",502,535,1037,339,377,327
"068330106",402,488,890,337,412,330
"068330205",255,341,596,271,384,270
"068330210",327,442,769,320,411,310
"068330213",452,500,952,349,419,342
"068400207",371,451,822,213,238,211
"068331007",582,587,1169,418,456,411
"068331009",545,566,1111,374,410,366
"068331501",103,95,198,76,103,76
"068331506",168,157,325,119,166,117
"068331909",511,499,1010,300,334,293
"068400103",945,1003,1948,537,496,476
"068400109",556,595,1151,313,294,274
"068400301",523,585,1108,368,391,348
"068400304",623,710,1333,403,408,379
"068400310",427,459,886,270,269,257
"068400601",726,748,1474,407,352,314
"068400610",353,373,726,249,263,235
"068400616",508,526,1034,328,359,296
"068401402",298,348,646,231,195,163
"068401001",544,596,1140,411,454,404
"068401002",576,646,1222,441,470,438
"068401106",542,568,1110,378,418,374
"068401107",369,399,768,279,315,277
"068401110",536,635,1171,410,387,341
"068401201",479,555,1034,365,398,346
"068401202",499,575,1074,376,406,369
"068401314",249,354,603,180,264,178
"068401406",309,384,693,262,303,256
"068401502",492,569,1061,407,474,389
"068401608",418,467,885,336,422,334
"068401703",430,509,939,332,402,324
"068403110",368,430,798,268,294,234
"068401905",454,514,968,335,364,317
"068402006",462,494,956,322,367,318
"068402009",481,524,1005,311,298,274
"068402106",558,579,1137,391,400,366
"068402110",627,717,1344,393,357,333
"068402201",642,677,1319,399,409,364
"068402304",318,345,663,225,240,219
"068402307",290,291,581,189,206,186
"068402310",459,486,945,305,297,264
"068402603",633,629,1262,359,379,354
"068402701",349,385,734,250,279,238
"068403109",498,557,1055,380,435,354
"068402805",622,649,1271,380,358,333
"068402901",507,505,1012,333,352,312
"068403007",335,356,691,231,274,227
"068403108",410,496,906,333,384,327
"068403206",355,398,753,267,270,206
"068470111",512,523,1035,351,373,350
"068470112",309,282,591,178,206,177
"068120102",35,33,68,28,44,25
"068190103",42,28,70,30,147,30
"068190104",97,67,164,60,115,59
"068190302",50,28,78,29,67,29
"068540103",375,462,837,300,331,297
"068540104",308,376,684,267,306,256
"068540204",296,397,693,286,348,280
"068260707",31,24,55,20,42,19
"068260709",99,77,176,55,78,53
"068540206",321,416,737,309,387,302
"068260802",19,30,49,14,14,14
"068261603",57,39,96,37,45,36
"068330304",7,6,13,4,18,4
"068540209",656,667,1323,422,499,410
"068331404",8,6,14,5,10,5
"068331105",4,0,4,4,23,4
"068331502",29,18,47,15,27,15
"068331504",20,17,37,12,28,12
"068470106",21,18,39,14,20,11
"068470110",39,25,64,23,57,23
"068470203",50,42,92,25,43,25
"068540501",55,44,99,43,82,43
"068540901",73,71,144,47,83,47
"068541405",51,33,84,29,47,29
"068680511",3,0,3,2,3,2
"068540801",166,159,325,102,152,102
"068821301",302,219,521,178,193,176
"068541004",445,456,901,315,369,312
"068610201",396,437,833,273,306,256
"068610203",159,214,373,143,203,143
"068610209",416,458,874,266,291,266
"068610310",181,285,466,233,343,231
"068610411",215,269,484,199,265,196
"068610703",228,293,521,286,396,268
"068610704",321,399,720,248,269,245
"068610801",338,395,733,341,465,339
"068610808",303,352,655,257,335,255
"068611103",398,402,800,300,343,289
"068611107",530,585,1115,375,427,360
"068611109",385,438,823,308,346,294
"068611201",318,342,660,265,347,261
"068611205",406,493,899,339,410,335
"068611207",436,461,897,309,367,289
"068611305",328,384,712,296,390,295
"068611406",226,267,493,189,234,185
"068611410",313,342,655,248,288,241
"068611503",418,566,984,392,472,390
"068611507",348,410,758,289,353,277
"068611607",422,472,894,318,359,313
"068611608",390,378,768,266,308,255
"068611914",358,404,762,239,255,230
"068612107",452,513,965,338,369,329
"068612207",462,536,998,332,366,308
"068612306",242,246,488,162,172,154
"068612409",420,499,919,333,373,327
"068612701",418,512,930,367,424,356
"068612705",345,376,721,242,266,234
"068612707",448,467,915,346,408,332
"068612710",399,434,833,287,278,243
"068612907",409,437,846,262,193,169
"068613105",324,365,689,237,263,219
"068613202",448,564,1012,404,485,398
"068613303",422,523,945,371,481,359
"068680105",130,140,270,102,257,100
"068680306",262,299,561,204,469,201
"068680313",44,35,79,37,350,37
"068680402",32,25,57,24,218,23
"068680409",37,48,85,29,480,28
"068680602",44,41,85,37,248,37
"068680605",34,45,79,34,86,33
"068680703",157,176,333,121,296,119
"068680705",90,82,172,70,290,67
"068680709",34,27,61,26,386,23
"068680801",501,484,985,305,455,289
"068751504",360,313,673,163,173,149
"068751602",655,666,1321,437,512,429
"068751606",504,529,1033,297,319,280
"068820104",650,700,1350,423,416,390
"068820203",249,276,525,226,308,218
"068820205",363,430,793,314,413,296
"068820501",197,201,398,117,111,107
"068820505",77,69,146,48,43,37
"068820801",830,796,1626,440,440,404
"068821002",325,352,677,230,273,222
"068821007",348,375,723,241,232,203
"068821605",941,914,1855,465,444,424
"065601506",538,556,1094,287,274,261
"065601508",1608,1712,3320,729,1200,705
"065601510",540,586,1126,328,291,282
"065601609",714,722,1436,387,353,325
"065601616",364,380,744,240,328,227
"065601701",734,757,1491,377,381,350
"065601716",458,483,941,248,261,239
"065601723",382,363,745,224,391,223
"065601724",394,366,760,245,491,243
"065601906",335,372,707,203,239,196
"065601907",507,517,1024,302,343,283
"065601908",446,433,879,286,290,262
"065602006",730,710,1440,303,312,300
"065602101",657,656,1313,377,443,355
"066583711",928,975,1903,539,412,400
"065602310",258,339,597,233,320,224
"065602406",455,483,938,282,283,259
"065602507",380,439,819,280,315,274
"065680103",489,550,1039,349,376,348
"065680203",454,492,946,324,388,322
"065680402",307,332,639,233,268,230
"065680411",456,520,976,371,456,366
"065680603",379,429,808,294,336,292
"065680708",381,423,804,281,306,266
"065680801",487,516,1003,337,356,303
"065680907",514,570,1084,393,430,367
"065680908",242,243,485,180,197,175
"065680912",274,325,599,204,235,202
"065681013",470,530,1000,363,385,351
"065681201",333,397,730,265,284,248
"065681205",490,523,1013,387,404,346
"065681207",517,587,1104,401,435,371
"068751505",52,38,90,41,56,38
"064904903",305,373,678,264,278,260
"064904904",439,598,1037,481,512,476
"064904909",282,308,590,207,209,200
"064905001",453,509,962,359,392,350
"064905008",405,487,892,325,329,299
"064905009",281,328,609,215,224,206
"064905011",349,360,709,238,209,193
"064970104",384,493,877,313,374,304
"066583410",329,404,733,245,257,236
"064970306",375,368,743,205,209,192
"064970307",851,819,1670,432,446,404
"066583612",754,754,1508,398,354,342
"065151909",635,642,1277,340,336,301
"064970405",296,298,594,181,184,164
"065321511",553,654,1207,409,462,403
"064970505",819,776,1595,413,436,387
"064970507",587,605,1192,345,376,337
"064970512",504,527,1031,322,340,311
"064970708",407,435,842,295,434,280
"064970806",335,362,697,213,240,209
"066584207",413,371,784,226,243,200
"064971106",476,619,1095,382,425,359
"064971203",452,508,960,293,305,277
"065150107",461,482,943,258,257,251
"064971303",259,258,517,165,238,164
"064971304",253,215,468,137,226,135
"064971403",774,833,1607,502,536,486
"064971410",434,475,909,292,315,282
"065050313",213,241,454,161,172,160
"065050317",161,156,317,91,116,88
"066790101",132,117,249,78,108,78
"065152101",223,196,419,101,199,100
"065152110",572,640,1212,328,326,302
"065152115",370,372,742,203,224,188
"065180111",97,78,175,52,56,50
"065180201",205,214,419,96,101,96
"067140115",291,319,610,211,225,208
"065250113",229,253,482,160,199,157
"065150215",737,742,1479,363,353,329
"065150304",652,671,1323,369,368,347
"065150307",582,579,1161,297,292,268
"065150503",854,878,1732,471,377,364
"065150507",567,560,1127,337,341,327
"065150510",175,161,336,96,96,93
"065150615",345,381,726,233,239,217
"065150701",953,967,1920,525,506,465
"065390413",298,366,664,249,252,216
"065150803",557,546,1103,304,299,283
"065150808",581,597,1178,379,409,360
"060282610",311,328,639,171,173,157
"060283009",638,680,1318,325,277,256
"060283305",343,397,740,288,233,138
"060283910",826,792,1618,452,455,427
"060283911",795,765,1560,408,426,397
"065150912",563,565,1128,345,350,334
"060351204",152,212,364,146,168,146
"060490201",286,368,654,258,329,241
"060490501",293,353,646,261,316,252
"060491002",150,159,309,124,159,122
"060560209",334,370,704,252,277,251
"065151012",290,313,603,162,166,155
"060561202",229,316,545,294,342,293
"060770512",274,300,574,191,206,185
"065151104",385,398,783,230,223,207
"060911706",666,644,1310,363,333,317
"060912409",174,140,314,104,410,101
"061120111",426,494,920,330,379,326
"061470102",401,460,861,321,383,313
"060070103",16,11,27,13,23,13
"060070209",9,7,16,6,4,2
"060070803",375,392,767,257,284,251
"060070807",343,438,781,313,376,295
"060070813",319,330,649,205,242,201
"061820209",315,319,634,252,363,252
"060140504",411,421,832,301,352,298
"060141013",377,417,794,306,352,294
"063573703",163,245,408,206,448,203
"060280303",1040,1048,2088,496,427,408
"060280306",444,427,871,194,180,177
"060280403",797,828,1625,390,259,257
"060280405",791,709,1500,339,324,313
"060280409",940,910,1850,445,362,352
"060280509",116,123,239,62,57,55
"060280510",112,137,249,66,60,59
"060280511",627,627,1254,324,255,246
"060280513",679,677,1356,359,319,309
"060280603",715,818,1533,443,372,346
"060280607",721,745,1466,400,345,327
"060280609",560,585,1145,334,347,325
"060280610",1881,1900,3781,1001,851,826
"060280810",789,836,1625,490,486,463
"060280811",683,722,1405,464,454,426
"060280909",797,857,1654,490,510,484
"060281012",566,543,1109,320,254,253
"060281101",503,571,1074,298,300,284
"063573705",164,243,407,213,651,213
"060281202",410,533,943,335,373,321
"060281203",591,640,1231,408,486,408
"060281209",483,513,996,334,374,331
"060281404",809,832,1641,434,421,404
"060281605",548,625,1173,323,293,282
"060281701",346,431,777,247,263,244
"060281707",498,568,1066,332,356,327
"060281708",649,763,1412,397,305,282
"060281806",849,949,1798,466,471,441
"060281912",616,569,1185,298,291,277
"060282001",654,671,1325,397,419,385
"060282102",372,419,791,249,248,225
"060282203",594,618,1212,345,352,332
"060282205",871,850,1721,438,417,392
"060282212",382,384,766,246,267,241
"060282216",923,982,1905,544,500,471
"060282218",378,387,765,237,221,206
"060282311",349,383,732,262,276,242
"060282408",444,499,943,324,365,315
"060282502",433,472,905,329,438,325
"060282511",532,602,1134,399,450,376
"060282606",381,376,757,227,217,199
"060282707",282,301,583,152,158,147
"060282808",441,437,878,253,225,209
"060283012",519,491,1010,244,197,192
"060283106",597,631,1228,407,449,394
"062100208",333,406,739,289,345,278
"060283204",387,433,820,296,347,283
"060283309",504,597,1101,373,383,329
"060283401",485,485,970,275,297,261
"060283501",712,699,1411,386,392,370
"060283504",523,541,1064,315,340,294
"060283606",766,766,1532,404,411,386
"060283701",578,523,1101,352,399,343
"060283708",398,437,835,259,279,255
"060283806",452,470,922,272,293,263
"060352803",444,471,915,298,304,280
"060283902",746,749,1495,380,373,355
"060283906",502,449,951,251,293,228
"060350108",242,263,505,175,159,146
"060350104",362,361,723,217,162,140
"060350302",622,650,1272,341,298,282
"060351413",290,324,614,210,222,194
"060350312",344,406,750,248,254,244
"060350503",334,396,730,291,329,291
"060350505",1586,1646,3232,830,716,690
"060350603",426,526,952,337,376,321
"060350610",425,492,917,266,267,255
"060350708",149,169,318,117,297,116
"060350805",192,222,414,112,116,112
"060350806",347,390,737,233,228,198
"060350810",298,305,603,180,151,148
"060350901",393,387,780,229,149,140
"060350913",423,448,871,294,267,249
"060351001",402,342,744,256,270,249
"060351002",975,1138,2113,905,1150,899
"060351010",345,397,742,299,376,295
"060351012",271,376,647,283,310,272
"060351407",245,283,528,174,213,171
"060351409",292,373,665,285,366,281
"060351608",483,537,1020,357,360,320
"060351808",291,363,654,229,264,223
"060351904",343,391,734,272,316,266
"060351906",420,505,925,319,304,268
"060352107",314,307,621,212,251,209
"060352201",696,754,1450,421,365,357
"060352210",354,388,742,260,288,236
"060352511",559,644,1203,385,410,367
"060352709",470,503,973,303,300,271
"060352802",521,561,1082,340,346,311
"060352806",426,519,945,321,344,302
"060352808",457,523,980,340,356,320
"060352909",286,322,608,219,242,199
"062242004",9,9,18,5,5,5
"060353203",428,503,931,325,339,296
"060353205",312,365,677,244,308,237
"060353208",364,418,782,286,370,283
"060353302",407,437,844,311,359,292
"060353408",382,433,815,251,296,235
"065151217",399,428,827,231,195,189
"065151301",585,559,1144,317,312,294
"060421907",373,384,757,231,254,222
"060490102",210,273,483,210,254,161
"060490103",308,362,670,259,355,255
"060490106",254,297,551,246,346,243
"060560405",505,633,1138,440,504,435
"060490113",311,396,707,241,285,215
"060490116",320,344,664,189,187,172
"060490404",156,130,286,103,145,101
"060490609",501,513,1014,318,326,299
"062520105",800,745,1545,394,408,370
"060492508",532,565,1097,387,420,377
"060492510",502,557,1059,292,312,282
"060560101",340,358,698,326,433,323
"060560118",168,199,367,176,284,172
"060560119",297,339,636,295,411,288
"065151303",480,499,979,255,184,173
"060560204",287,320,607,193,232,190
"060560205",280,293,573,189,215,187
"060560212",438,489,927,329,383,317
"062520614",372,347,719,199,195,190
"060560214",320,347,667,247,288,241
"060560401",489,571,1060,387,421,380
"060560507",450,503,953,329,357,312
"060560704",510,577,1087,390,418,373
"060560802",893,868,1761,475,508,457
"060560903",258,334,592,263,371,262
"060561001",117,172,289,129,209,128
"060561002",154,208,362,183,254,182
"060561108",174,250,424,234,328,230
"060561211",135,186,321,169,235,167
"060561302",337,354,691,311,478,307
"060561307",297,350,647,321,405,315
"060561414",273,455,728,340,484,326
"060561502",601,703,1304,383,426,376
"060561503",476,496,972,336,374,332
"060561513",367,387,754,234,248,227
"060561516",305,296,601,175,193,172
"060561808",438,513,951,327,375,320
"060561910",906,913,1819,479,480,457
"060562005",425,481,906,357,433,353
"060562106",260,288,548,158,183,158
"062600314",523,485,1008,259,269,249
"060562208",559,611,1170,391,410,364
"060562211",309,374,683,264,310,263
"060562408",1387,1300,2687,732,830,713
"060562417",303,289,592,186,178,166
"060562510",453,505,958,328,366,322
"060562516",409,412,821,343,409,321
"060562602",508,510,1018,289,401,285
"060562605",459,461,920,301,339,291
"060562606",294,278,572,189,215,175
"060562613",782,743,1525,438,531,424
"063573903",138,189,327,168,459,165
"060562618",371,382,753,201,207,197
"062601617",738,753,1491,416,463,385
"060630104",622,617,1239,344,293,246
"060630107",371,431,802,307,369,295
"060630201",683,718,1401,446,509,430
"060630203",365,404,769,303,365,292
"060630708",699,726,1425,406,480,397
"060630906",133,131,264,100,124,100
"060631302",394,531,925,336,399,331
"060700103",295,321,616,229,285,228
"060700107",387,414,801,292,351,285
"060700201",739,739,1478,459,529,452
"060700206",670,667,1337,387,435,371
"060700207",244,249,493,185,212,182
"060700209",454,482,936,296,337,289
"062701010",689,646,1335,338,373,334
"060770401",371,361,732,255,315,250
"060770102",477,481,958,272,278,260
"060770106",497,588,1085,400,435,390
"060770504",241,259,500,176,195,168
"060770511",458,474,932,329,352,307
"060770514",155,163,318,97,101,96
"062740614",522,499,1021,264,258,247
"062740806",333,354,687,189,188,183
"060840711",539,621,1160,342,401,336
"060910209",671,716,1387,424,425,390
"060840905",277,310,587,205,231,203
"060910303",285,349,634,221,258,215
"060841202",229,231,460,140,171,139
"060910308",385,407,792,241,251,233
"060910101",820,786,1606,420,382,377
"060910507",514,522,1036,299,316,298
"060910603",393,418,811,258,285,255
"060910609",786,806,1592,405,380,369
"060910709",612,651,1263,317,311,297
"060910807",707,784,1491,439,408,374
"060910810",559,603,1162,376,382,351
"060911006",744,788,1532,462,439,418
"060911007",516,563,1079,315,308,297
"060911008",448,491,939,278,261,257
"060911106",444,521,965,339,342,321
"060911201",629,668,1297,370,329,309
"060911206",826,877,1703,443,387,380
"060911207",489,494,983,278,298,274
"060911208",838,908,1746,475,479,447
"060911308",634,598,1232,308,278,267
"060911501",422,442,864,247,252,237
"060911707",758,792,1550,379,331,323
"060911713",483,490,973,256,240,234
"060911714",944,903,1847,452,441,421
"062800202",335,367,702,231,293,226
"060911812",726,739,1465,415,469,399
"060911909",319,359,678,226,271,224
"060912005",820,823,1643,418,413,390
"060912006",392,400,792,226,224,214
"060912107",694,691,1385,360,315,304
"060912110",424,477,901,316,345,311
"060912113",600,623,1223,303,305,283
"060912114",558,619,1177,350,365,335
"060912204",601,606,1207,340,407,329
"060912306",674,664,1338,388,415,372
"060912307",343,346,689,223,247,217
"060912308",403,381,784,231,246,216
"060912316",178,177,355,115,160,111
"060912412",329,297,626,179,226,177
"060980107",283,352,635,235,286,227
"060980111",528,613,1141,367,404,363
"060980206",391,471,862,304,349,289
"065151405",335,336,671,164,152,147
"060980211",424,434,858,226,257,216
"060980305",394,406,800,260,267,242
"065151406",548,548,1096,304,236,231
"060980504",440,500,940,290,304,270
"060980505",630,630,1260,328,348,316
"060980510",575,612,1187,319,338,299
"060980702",1040,1090,2130,596,624,570
"060980810",832,854,1686,458,438,400
"061050101",497,524,1021,390,443,384
"061050102",444,468,912,332,394,322
"061050109",270,369,639,250,310,248
"061050201",458,508,966,348,429,344
"061050203",392,471,863,325,386,313
"061050801",214,221,435,138,158,135
"061050803",468,463,931,273,310,270
"061051401",733,756,1489,424,497,416
"061051413",635,619,1254,339,362,331
"061120101",317,324,641,231,265,222
"063010506",299,325,624,222,260,220
"061120208",181,185,366,113,136,108
"061120709",225,229,454,164,191,159
"061121410",299,344,643,279,348,274
"061190302",427,501,928,308,375,306
"061190901",95,88,183,67,94,66
"061260102",594,647,1241,465,442,408
"061260205",536,553,1089,374,420,353
"061260206",386,404,790,238,219,201
"061260210",559,589,1148,335,348,288
"061260302",299,324,623,273,421,266
"061260304",198,218,416,167,239,166
"063360202",214,245,459,149,192,149
"061260404",872,885,1757,432,423,387
"061260504",610,615,1225,320,332,301
"061260608",163,170,333,99,201,99
"061260701",686,683,1369,357,331,300
"061260703",773,808,1581,454,434,403
"061260805",422,454,876,319,372,263
"061260808",401,458,859,301,333,289
"061260809",284,357,641,246,293,235
"061260901",880,897,1777,495,496,457
"061260902",474,486,960,277,277,263
"061260908",459,468,927,308,328,305
"061260909",795,788,1583,420,404,361
"061340105",817,789,1606,427,469,413
"061340303",390,411,801,257,268,244
"061340905",254,257,511,130,155,127
"063572104",153,171,324,131,238,131
"061340913",381,406,787,270,304,261
"061341005",526,558,1084,299,318,278
"061470101",478,525,1003,338,368,326
"061470303",6,2,8,3,4,3
"063573509",186,261,447,239,576,237
"061470702",7,5,12,4,13,4
"061540603",224,240,464,177,204,175
"061540606",61,69,130,60,69,60
"061540608",258,279,537,200,220,194
"061610104",208,223,431,129,134,112
"061610112",310,287,597,164,209,162
"061610116",337,328,665,200,240,198
"063576113",280,351,631,238,372,238
"061680807",276,311,587,196,210,184
"061680907",276,300,576,183,204,180
"061750406",299,389,688,254,318,243
"061750611",366,411,777,275,300,272
"061750612",410,413,823,284,319,280
"061820202",391,468,859,326,387,324
"061820305",116,131,247,68,181,68
"061820504",444,456,900,263,301,259
"061820505",174,183,357,104,173,102
"061821003",407,472,879,338,417,331
"061821104",355,393,748,238,274,229
"061821108",458,471,929,271,302,265
"063577910",472,463,935,228,254,216
"061891005",375,409,784,258,297,255
"061960108",452,474,926,307,325,302
"061960109",202,201,403,121,155,117
"061960119",239,245,484,164,175,156
"061960209",362,479,841,321,397,318
"061960212",220,218,438,137,157,131
"062030101",451,547,998,339,387,333
"062030106",364,408,772,280,321,275
"063640811",331,323,654,161,178,158
"062031602",508,485,993,292,310,276
"062100101",288,293,581,197,209,182
"062100103",217,239,456,164,188,159
"062100119",468,513,981,298,317,276
"062100203",589,636,1225,417,417,376
"062100804",601,632,1233,389,323,294
"062100902",297,315,612,241,282,235
"062101305",373,439,812,239,261,233
"062170104",458,501,959,331,374,317
"062170302",101,91,192,49,65,49
"062170402",422,359,781,199,211,189
"062170408",172,138,310,94,199,92
"062170411",378,348,726,220,249,212
"062240114",494,532,1026,321,367,310
"062240211",283,364,647,261,341,258
"062171213",420,473,893,271,348,268
"062171204",397,402,799,215,217,203
"062240108",258,305,563,216,275,214
"062240203",289,281,570,152,160,148
"062240205",398,432,830,267,301,257
"062240210",346,430,776,316,421,306
"062240213",267,275,542,105,110,92
"062240304",350,434,784,288,378,283
"062240310",407,454,861,266,280,253
"062240417",448,464,912,248,253,240
"062241102",70,53,123,46,84,46
"062242201",251,289,540,233,305,221
"062242203",393,444,837,331,407,327
"062450306",704,697,1401,405,428,381
"062311202",502,529,1031,297,314,279
"062311209",296,326,622,241,273,239
"062380103",472,553,1025,356,421,351
"062380113",236,273,509,163,184,160
"062380201",402,402,804,245,274,240
"062380213",219,255,474,153,181,146
"062450104",346,402,748,270,298,265
"062450105",499,554,1053,351,423,344
"062450205",569,615,1184,372,381,324
"062450213",455,478,933,270,283,254
"062450305",787,774,1561,423,389,373
"063572802",130,191,321,133,648,133
"062450501",480,495,975,302,327,297
"062450416",179,178,357,121,201,120
"062520110",182,235,417,165,193,153
"062520212",298,326,624,188,212,185
"065151505",743,740,1483,390,304,288
"062520409",933,931,1864,509,509,426
"062520507",692,677,1369,455,470,404
"062520607",68,69,137,37,45,35
"062520609",74,72,146,40,48,37
"062520810",245,233,478,157,520,155
"062520903",882,876,1758,455,418,408
"062521002",70,62,132,42,63,42
"062521005",398,379,777,218,237,211
"062521010",556,556,1112,311,361,302
"062521011",668,690,1358,339,331,316
"062521106",464,467,931,281,320,266
"062521204",939,902,1841,473,413,388
"062521401",735,656,1391,340,392,335
"062521414",660,637,1297,327,287,267
"062521415",481,514,995,266,257,245
"062600113",532,501,1033,278,236,213
"062600107",650,655,1305,368,283,259
"063572805",154,190,344,201,581,198
"062600116",589,602,1191,324,275,237
"062600207",842,785,1627,424,408,382
"062600303",702,700,1402,338,273,268
"062600411",370,403,773,247,240,226
"062600514",715,775,1490,386,410,377
"062600611",343,378,721,239,251,228
"062600803",660,624,1284,317,328,307
"062600812",760,806,1566,402,379,360
"062600814",509,533,1042,295,314,288
"062600907",728,742,1470,420,391,355
"062601007",675,685,1360,376,324,309
"062601013",810,829,1639,412,393,370
"062601102",204,240,444,195,303,190
"062601107",539,637,1176,419,430,373
"062601109",573,601,1174,353,392,340
"062601209",414,447,861,274,304,263
"062601409",614,665,1279,380,401,362
"064200408",61,64,125,57,325,57
"062601410",620,696,1316,401,405,360
"062601511",909,872,1781,448,448,423
"064200510",150,143,293,98,203,96
"062601606",680,692,1372,386,410,376
"062601609",654,665,1319,336,345,319
"062601613",603,586,1189,318,339,309
"065681110",262,319,581,226,337,225
"062601706",888,862,1750,457,486,432
"062601711",155,146,301,85,297,85
"062660101",9,10,19,8,20,8
"062660303",453,502,955,274,286,265
"062660503",237,226,463,139,208,131
"062700217",706,727,1433,388,411,371
"062660605",158,142,300,105,222,97
"062660608",125,132,257,102,300,102
"062660702",446,448,894,283,353,272
"062700210",767,815,1582,405,387,362
"062700211",845,836,1681,439,446,423
"062700306",659,694,1353,375,377,337
"062700307",453,478,931,287,311,266
"062700313",399,457,856,258,271,239
"062740910",587,604,1191,341,351,330
"062700403",462,555,1017,372,461,365
"062700404",654,654,1308,401,515,371
"062700410",587,647,1234,364,380,349
"062700511",425,388,813,222,236,191
"062700608",774,734,1508,424,482,411
"064271109",604,661,1265,393,379,351
"062700610",1101,1129,2230,559,594,534
"062700702",420,406,826,218,239,198
"062700803",126,109,235,75,127,69
"062700808",637,708,1345,380,412,375
"062700809",516,528,1044,263,280,250
"062700911",405,414,819,251,266,242
"062700907",372,383,755,246,276,241
"062740106",449,505,954,282,259,246
"062740201",601,674,1275,413,404,363
"062740204",418,453,871,288,300,277
"062740308",540,561,1101,301,309,287
"062740316",546,539,1085,307,303,285
"062740404",723,719,1442,368,358,330
"062740416",597,619,1216,298,278,257
"062740417",569,612,1181,303,327,287
"062740504",659,604,1263,347,349,324
"063573004",154,203,357,182,395,181
"062740514",743,715,1458,374,393,369
"063573005",117,188,305,159,290,157
"062740611",509,497,1006,262,264,245
"062740701",337,280,617,189,252,185
"062740704",610,592,1202,287,289,278
"062740803",358,424,782,262,270,262
"065151604",372,360,732,210,219,202
"062740819",607,629,1236,325,332,301
"062740902",636,579,1215,312,335,304
"062740916",456,449,905,245,251,233
"062740918",568,556,1124,287,314,281
"062740919",740,661,1401,355,372,337
"062741007",719,706,1425,366,343,328
"063573007",102,147,249,130,282,128
"062741202",423,452,875,245,272,240
"062741217",585,622,1207,342,353,321
"062741315",260,330,590,239,326,227
"062741316",401,424,825,271,291,258
"063573009",147,248,395,213,438,210
"062741409",499,556,1055,370,403,352
"062741410",374,429,803,293,342,289
"062741509",467,490,957,266,221,214
"062741510",810,795,1605,428,420,410
"062741511",461,437,898,245,255,244
"062741512",463,485,948,248,241,231
"062741602",854,840,1694,396,384,370
"062741604",1020,986,2006,469,458,435
"062741607",528,511,1039,274,282,261
"062741611",433,439,872,233,236,203
"062741801",899,880,1779,470,457,435
"062741913",555,545,1100,282,295,269
"062742004",1294,1216,2510,618,533,518
"062742010",589,565,1154,297,270,259
"062742102",365,382,747,232,255,217
"062742104",686,661,1347,363,353,336
"062742106",988,1130,2118,412,400,389
"062742108",990,1018,2008,401,394,386
"062742115",789,796,1585,432,416,394
"062770102",173,161,334,120,174,120
"062770108",392,430,822,228,282,228
"062770113",327,344,671,259,292,255
"062770115",444,462,906,303,333,285
"062800107",516,527,1043,254,312,248
"062800108",361,341,702,162,198,157
"062800201",523,535,1058,302,318,298
"064276305",561,608,1169,283,248,242
"062800614",50,36,86,33,140,33
"062800406",133,173,306,103,348,102
"062800606",275,294,569,195,390,191
"062800607",99,111,210,68,140,68
"064277005",801,836,1637,397,357,338
"062801102",436,500,936,299,364,295
"062801104",191,208,399,142,203,139
"062801108",278,302,580,170,199,161
"062801207",630,688,1318,392,420,379
"062870406",225,287,512,199,236,195
"062870409",200,191,391,124,153,124
"062870412",219,260,479,190,228,178
"062870414",281,339,620,223,260,220
"062940211",133,132,265,96,119,96
"062940403",487,546,1033,389,465,383
"062940806",191,208,399,162,183,151
"063010504",330,346,676,219,267,215
"063573105",165,221,386,208,410,204
"063010813",364,357,721,234,278,222
"065151607",649,648,1297,393,418,367
"063150104",345,453,798,315,381,310
"063150115",458,458,916,261,304,256
"063220615",193,227,420,146,178,145
"063573109",186,248,434,258,647,257
"063221001",148,144,292,112,152,112
"063360205",197,205,402,126,156,123
"063570108",548,569,1117,341,396,337
"063570109",430,459,889,255,318,249
"063570305",347,376,723,227,313,218
"063570310",434,473,907,290,368,283
"063570402",225,223,448,171,360,169
"063570405",216,221,437,154,224,147
"063570505",263,283,546,191,241,187
"063570506",326,360,686,237,294,220
"063570508",275,344,619,196,247,193
"063570801",625,608,1233,370,330,301
"063570807",447,542,989,320,355,313
"063570813",328,356,684,213,239,204
"063570814",205,243,448,150,178,144
"063570901",707,723,1430,426,464,412
"063571006",639,653,1292,394,408,360
"063571103",454,460,914,252,267,241
"063571108",349,386,735,210,227,193
"063571215",684,777,1461,380,364,328
"063571302",370,437,807,309,358,305
"063571401",489,521,1010,375,455,368
"063571405",309,300,609,219,287,211
"063571501",461,478,939,351,391,323
"063571504",459,560,1019,352,405,345
"063572002",272,380,652,329,666,327
"063572003",136,213,349,174,344,164
"063573205",95,134,229,139,217,137
"063573302",367,428,795,338,442,326
"063573303",341,428,769,305,396,301
"063573309",183,241,424,180,263,180
"063573403",111,164,275,151,242,150
"063574101",380,438,818,299,676,271
"063574107",122,128,250,115,461,115
"063574204",51,70,121,68,220,68
"063574308",43,54,97,47,265,47
"064412504",164,229,393,187,226,186
"063574601",168,243,411,178,245,177
"063574608",179,246,425,202,281,194
"063574609",321,431,752,274,365,270
"063574613",207,279,486,195,312,194
"063574705",342,462,804,348,464,344
"063574709",315,399,714,300,371,293
"063574804",183,240,423,147,172,144
"063574902",393,470,863,311,370,305
"063575011",203,218,421,155,184,152
"063575102",394,391,785,284,357,281
"064413105",234,293,527,205,246,202
"063575312",604,582,1186,366,437,317
"063575402",443,544,987,325,319,298
"063575508",629,666,1295,438,502,424
"063575602",448,501,949,352,370,326
"063575609",339,421,760,286,318,276
"063575709",531,524,1055,376,434,371
"063575710",302,363,665,237,263,222
"063575804",361,412,773,298,346,286
"063575806",447,508,955,355,396,334
"063576001",438,497,935,321,375,309
"063576107",267,288,555,160,197,139
"063576203",244,262,506,169,231,168
"063576207",344,356,700,229,282,223
"063576209",338,381,719,261,351,259
"063576309",59,66,125,55,320,55
"063576407",262,281,543,170,356,166
"063576410",91,106,197,66,207,63
"063576509",397,418,815,262,473,249
"063576604",518,542,1060,352,393,333
"063576709",493,502,995,291,295,276
"063576714",330,386,716,206,205,184
"063576803",381,434,815,251,251,226
"063576804",265,289,554,200,194,178
"063576807",418,446,864,275,291,262
"063576903",331,333,664,194,199,176
"064414604",417,460,877,293,286,262
"063576908",474,502,976,289,296,268
"063576910",585,644,1229,326,313,289
"063577010",366,393,759,241,217,192
"063577104",539,646,1185,408,424,374
"063577106",668,739,1407,394,392,296
"063577302",685,677,1362,369,448,359
"063577506",208,195,403,128,310,123
"063577512",268,262,530,162,272,146
"063577515",93,118,211,74,167,74
"063577602",248,275,523,153,247,151
"063577609",226,208,434,138,324,136
"063577709",166,179,345,130,333,128
"063577711",90,69,159,61,157,60
"063640106",412,436,848,275,297,271
"064416110",303,369,672,220,277,215
"063577901",3,2,5,2,4,2
"063577902",437,466,903,284,349,278
"064416412",195,177,372,122,146,113
"063578008",303,299,602,180,202,173
"063578018",173,180,353,102,177,98
"063578107",218,206,424,124,174,122
"063578109",272,271,543,162,190,153
"063578114",607,618,1225,340,373,333
"063578207",95,114,209,78,160,78
"063710505",385,398,783,263,247,239
"063640104",502,494,996,262,295,258
"063640117",291,275,566,191,230,187
"063640119",531,574,1105,379,434,366
"063640203",595,559,1154,362,643,350
"063640207",614,606,1220,335,348,320
"063710507",386,442,828,265,286,263
"063640310",308,296,604,161,187,155
"063640315",319,342,661,167,281,166
"063640410",468,458,926,256,284,243
"063640710",207,237,444,186,271,180
"063640703",345,395,740,234,293,226
"063640807",492,493,985,259,137,80
"063640820",403,421,824,195,224,188
"063710212",388,412,800,268,207,202
"063710102",471,490,961,288,273,268
"063710313",324,367,691,204,212,203
"063710405",509,539,1048,356,342,323
"063710605",383,419,802,250,265,202
"063710610",778,781,1559,434,378,345
"063710708",347,381,728,226,255,216
"063710809",518,555,1073,365,386,331
"063710910",523,550,1073,378,413,363
"063710912",308,374,682,233,263,230
"063710915",297,311,608,201,218,184
"063711001",410,438,848,302,320,282
"063711103",337,450,787,315,371,313
"063711805",459,534,993,340,383,329
"063711406",721,764,1485,385,370,366
"063711414",611,612,1223,300,237,212
"063711509",337,335,672,198,212,197
"063711701",508,570,1078,362,425,353
"063711706",434,475,909,333,376,328
"063711709",413,495,908,309,379,300
"063711810",322,381,703,236,242,219
"063711901",240,316,556,210,267,208
"063712001",496,527,1023,372,408,364
"063712002",532,602,1134,373,408,361
"063712111",473,571,1044,404,461,385
"063712214",238,315,553,241,354,239
"063712311",426,324,750,253,330,245
"063712312",366,291,657,233,344,227
"063712313",386,328,714,249,464,245
"063712506",435,488,923,299,330,291
"063712508",405,432,837,292,313,267
"063712605",275,354,629,223,200,176
"063712805",102,91,193,67,72,60
"063712807",113,147,260,83,89,75
"063713004",379,392,771,251,246,215
"063713205",566,604,1170,321,337,309
"063713207",437,488,925,291,294,260
"063713208",703,802,1505,456,482,437
"063713211",693,682,1375,412,419,394
"063713303",676,689,1365,415,424,379
"063713304",469,508,977,307,325,294
"063713404",358,354,712,242,261,237
"063713510",491,504,995,290,227,218
"063713601",1168,1227,2395,603,397,367
"063713607",681,749,1430,401,363,338
"063713611",588,607,1195,415,431,379
"063713702",680,693,1373,363,335,322
"063850107",323,323,646,225,264,224
"063850701",461,472,933,319,357,314
"063850706",244,275,519,207,250,204
"063850710",445,421,866,265,308,256
"063920105",392,457,849,358,427,355
"063920108",409,447,856,320,368,316
"063920601",125,119,244,96,128,93
"063920806",584,624,1208,375,419,371
"063920901",457,448,905,310,358,304
"063990106",376,414,790,291,332,288
"063921506",231,192,423,147,205,145
"064080310",369,394,763,221,226,201
"064060215",430,431,861,298,351,296
"064080204",583,697,1280,388,368,342
"064080208",807,838,1645,488,504,469
"064080302",167,173,340,100,96,90
"064080305",456,483,939,294,302,275
"064904305",2,3,5,2,2,2
"064080504",577,550,1127,313,305,286
"064080508",478,493,971,281,293,276
"064080606",152,161,313,103,115,100
"064080705",478,544,1022,351,377,335
"064080807",403,458,861,267,250,231
"064081001",464,535,999,325,348,319
"064081005",645,744,1389,442,464,429
"064081108",612,653,1265,334,335,316
"064081201",1441,1652,3093,675,335,324
"064081207",621,651,1272,370,408,359
"064081310",691,686,1377,375,345,324
"064081502",711,748,1459,442,444,414
"064081511",366,416,782,270,290,264
"064100109",444,459,903,265,276,241
"064100112",568,599,1167,349,400,332
"064100209",529,543,1072,344,371,322
"064100302",541,592,1133,347,338,293
"064100509",586,584,1170,385,373,333
"064100606",406,511,917,306,338,301
"064100611",344,381,725,223,216,200
"064100612",721,742,1463,438,470,406
"064100615",442,518,960,334,380,329
"064100703",397,489,886,313,341,307
"064100706",390,415,805,295,319,290
"064100711",452,522,974,301,333,298
"064100715",460,455,915,252,257,230
"064100805",447,510,957,289,282,261
"064100808",459,508,967,316,343,291
"064101004",565,718,1283,412,422,373
"064101108",435,444,879,299,347,295
"064101111",447,562,1009,328,352,318
"064101304",334,361,695,223,245,216
"064120312",228,256,484,159,210,151
"064120401",694,708,1402,407,441,391
"064120402",636,636,1272,377,372,346
"064120406",499,511,1010,286,276,263
"064120408",366,338,704,205,202,184
"064120412",793,861,1654,506,484,448
"064120503",532,577,1109,375,391,347
"064120513",631,683,1314,403,403,373
"064120708",538,567,1105,294,266,252
"064120709",302,341,643,215,226,188
"064120717",513,535,1048,290,258,244
"064120803",370,382,752,220,233,216
"064120804",429,451,880,232,232,216
"064120906",133,142,275,86,175,85
"064121003",813,784,1597,418,394,372
"064121004",833,928,1761,448,455,423
"064121005",772,718,1490,371,365,345
"064900804",236,269,505,175,192,172
"064121008",760,729,1489,376,348,325
"064121009",498,527,1025,280,289,264
"064121012",477,463,940,236,232,221
"064121014",789,783,1572,397,377,355
"064121106",661,663,1324,337,314,303
"064121107",546,536,1082,269,222,217
"064121109",568,535,1103,255,257,243
"064121118",677,689,1366,332,319,300
"064121202",678,681,1359,343,340,318
"064121301",671,672,1343,348,342,318
"064121303",455,394,849,206,227,200
"064121406",730,747,1477,411,422,395
"064121503",851,889,1740,505,466,440
"064121504",678,715,1393,371,371,348
"064121510",541,528,1069,298,295,275
"064130106",588,623,1211,380,403,362
"064130206",543,521,1064,294,304,284
"064130301",152,194,346,139,195,135
"064130304",264,324,588,215,313,208
"064130401",285,381,666,265,323,257
"064130402",223,317,540,225,397,221
"064130413",528,577,1105,380,437,373
"064130501",423,505,928,400,481,384
"064130506",257,345,602,266,384,264
"064130703",64,71,135,37,40,37
"064131106",68,71,139,40,49,38
"064131302",565,586,1151,332,343,318
"064131601",15,7,22,8,20,8
"064132102",476,508,984,305,323,291
"064132104",579,659,1238,452,478,399
"064132204",69,90,159,50,110,50
"064132212",147,139,286,97,140,96
"064200105",119,116,235,93,306,93
"064200114",78,94,172,68,336,67
"064200208",108,114,222,88,416,87
"064200209",86,88,174,67,367,66
"064200210",71,77,148,59,123,49
"065180812",91,81,172,66,175,65
"064200306",100,127,227,86,274,86
"064200308",212,204,416,141,330,140
"064200312",122,125,247,92,231,92
"064200404",175,184,359,100,307,93
"065250405",835,823,1658,422,446,406
"065250406",977,957,1934,488,496,447
"064200414",102,102,204,77,354,74
"064200417",48,44,92,38,237,38
"064200504",183,203,386,161,286,160
"065250601",287,295,582,129,143,123
"064200604",75,79,154,57,291,57
"064200606",11,20,31,15,293,15
"064200612",26,30,56,29,400,28
"064200809",52,66,118,54,340,54
"064200901",574,574,1148,332,451,327
"064201011",174,169,343,120,597,119
"064201102",58,60,118,47,294,47
"064201103",49,56,105,43,336,43
"064201110",184,185,369,121,547,121
"064201201",171,189,360,117,618,117
"064201208",193,183,376,90,803,90
"064201211",79,81,160,61,303,60
"064201301",32,28,60,24,312,24
"064201311",112,112,224,74,401,72
"064201401",77,67,144,57,435,57
"064201404",244,261,505,168,447,162
"064201605",12,13,25,14,374,14
"064201606",21,23,44,18,318,18
"064202011",66,78,144,46,313,46
"064201803",33,34,67,33,479,33
"064202013",104,113,217,86,273,84
"064202101",87,111,198,80,200,76
"064202105",182,202,384,140,265,136
"064202106",314,368,682,241,383,236
"064202201",333,326,659,168,202,165
"064202203",227,265,492,146,318,140
"064202206",172,192,364,121,450,118
"064202207",94,67,161,65,312,64
"064270305",337,372,709,262,323,261
"064270307",341,403,744,268,308,261
"064270309",257,319,576,204,232,189
"064270403",696,709,1405,475,511,452
"064270507",656,750,1406,447,441,404
"064270511",460,516,976,320,327,287
"064270612",398,404,802,265,261,246
"064270614",356,449,805,276,243,236
"064270707",300,324,624,229,297,226
"064270712",664,705,1369,409,386,322
"064270806",777,806,1583,487,482,425
"064270807",625,646,1271,392,430,353
"064270812",768,744,1512,464,457,407
"064270902",653,654,1307,390,420,384
"065390909",178,169,347,92,89,85
"064270907",634,659,1293,379,386,358
"064270912",585,587,1172,282,256,254
"064271107",529,557,1086,359,340,310
"064271110",411,461,872,275,266,249
"064271309",498,564,1062,286,311,256
"064271311",655,696,1351,437,509,427
"064271407",936,1108,2044,530,404,363
"064271501",408,510,918,284,295,265
"064271511",383,371,754,246,189,171
"064271605",1062,1061,2123,640,489,412
"064271608",447,493,940,254,234,226
"064271710",1094,1173,2267,549,475,450
"064271810",956,957,1913,442,365,344
"064271903",764,749,1513,476,454,388
"064272007",347,390,737,280,290,245
"064272202",352,404,756,241,228,210
"064272205",524,536,1060,362,296,247
"064272308",721,789,1510,467,467,429
"064272404",514,539,1053,242,135,132
"064272405",1065,1123,2188,473,313,308
"064272504",476,532,1008,316,316,292
"064272601",292,364,656,242,258,215
"064272810",570,653,1223,432,481,408
"064272907",631,685,1316,434,495,410
"064273104",399,494,893,316,363,305
"064273106",474,550,1024,393,445,382
"064273109",377,371,748,266,333,261
"064273208",627,675,1302,430,473,399
"064273302",517,611,1128,411,464,384
"064273315",382,467,849,296,321,275
"064273401",518,533,1051,351,386,343
"064273513",385,451,836,279,312,261
"064273604",317,387,704,212,411,200
"064273609",493,556,1049,380,487,370
"064273704",641,747,1388,461,534,415
"064273705",440,478,918,289,256,233
"064273808",623,705,1328,439,438,380
"064273909",674,721,1395,422,432,391
"064274104",691,686,1377,424,422,392
"064274208",383,408,791,261,265,241
"064274401",913,975,1888,528,430,369
"064274501",876,954,1830,551,547,514
"064274504",734,735,1469,476,518,454
"064274505",483,519,1002,320,333,301
"064274507",871,907,1778,520,474,449
"064274509",502,490,992,311,355,286
"064274604",967,1083,2050,583,516,479
"064274907",910,921,1831,463,353,342
"064274610",565,573,1138,329,353,312
"064274611",603,661,1264,377,351,339
"064274705",438,449,887,262,223,210
"064274708",459,461,920,156,25,25
"064274709",363,431,794,245,266,241
"064274806",1024,1147,2171,615,576,524
"064274809",800,813,1613,472,422,398
"064275001",679,700,1379,420,417,382
"064275002",549,565,1114,329,328,303
"064275013",452,468,920,251,261,234
"065530302",135,102,237,87,258,86
"065151707",553,546,1099,320,361,287
"064275106",470,480,950,259,198,186
"064275111",573,618,1191,384,398,369
"064275306",1063,1219,2282,535,505,490
"064275401",822,903,1725,434,388,363
"064275501",415,483,898,269,220,202
"064275503",371,425,796,255,226,209
"064275702",597,618,1215,332,293,278
"064275713",824,852,1676,448,364,345
"064275801",852,882,1734,501,422,400
"064275803",660,667,1327,370,376,358
"064275808",840,853,1693,475,419,396
"064275810",555,566,1121,313,309,288
"064275811",443,423,866,234,204,189
"064276008",1052,1203,2255,582,500,485
"064276010",704,854,1558,384,334,320
"064276012",565,762,1327,309,226,205
"064276018",522,589,1111,295,264,247
"064276110",1060,1150,2210,553,388,375
"064276306",741,838,1579,411,383,358
"064276308",777,878,1655,491,436,404
"064276310",1241,1436,2677,644,519,493
"064276401",515,541,1056,252,204,199
"064276410",924,989,1913,484,384,369
"064276508",499,491,990,271,201,190
"064276512",538,605,1143,301,240,231
"064276514",583,607,1190,309,251,242
"064276515",787,746,1533,406,317,302
"064276603",1151,1182,2333,554,425,411
"064276606",564,586,1150,304,301,294
"064276611",621,608,1229,324,288,281
"065601106",497,504,1001,257,271,248
"064276906",643,638,1281,312,219,205
"064276917",719,745,1464,385,301,283
"064277004",937,957,1894,479,427,407
"064277018",448,432,880,249,186,177
"064277110",389,413,802,226,198,184
"064277113",815,822,1637,364,293,282
"064277211",891,914,1805,477,469,457
"064277311",564,573,1137,286,201,188
"064277405",749,840,1589,427,309,289
"064277412",836,876,1712,440,431,411
"064277506",880,839,1719,418,225,213
"064277809",624,582,1206,319,310,303
"064277508",779,737,1516,396,354,312
"064277602",1081,1169,2250,535,238,214
"064277604",1020,1003,2023,503,440,428
"064277610",950,979,1929,502,394,368
"064277706",938,952,1890,486,400,378
"064277802",1524,1502,3026,616,423,414
"064277903",585,672,1257,339,279,255
"064278001",1850,1987,3837,809,267,264
"064278101",932,987,1919,462,348,336
"064278103",786,742,1528,373,318,302
"064278105",535,481,1016,236,170,159
"064278106",416,409,825,202,138,111
"064278107",414,411,825,205,116,103
"064278109",207,214,421,106,100,65
"065601915",658,707,1365,312,345,306
"064278301",654,693,1347,375,383,367
"064278314",676,727,1403,368,349,326
"064278401",473,462,935,243,388,241
"064278601",649,699,1348,409,436,389
"064278415",1187,1173,2360,549,555,507
"064278505",590,631,1221,315,266,257
"064278512",804,785,1589,407,337,315
"064278513",921,923,1844,466,420,399
"064278605",576,592,1168,308,302,273
"064278706",519,569,1088,295,281,269
"064278812",536,616,1152,339,323,293
"064278905",1094,1069,2163,522,508,485
"064278906",1003,1007,2010,479,406,384
"064278910",690,712,1402,345,287,275
"064279010",1216,1256,2472,607,603,563
"064279102",560,543,1103,318,141,136
"064279104",708,725,1433,374,330,313
"064279114",222,203,425,132,177,76
"064279209",951,933,1884,441,424,390
"064279406",1334,1392,2726,572,522,499
"064279505",996,969,1965,477,447,418
"064279506",895,869,1764,424,403,381
"064279604",1451,1407,2858,614,348,329
"064279606",992,1004,1996,506,489,421
"064279615",463,435,898,248,292,243
"064279716",318,283,601,133,142,119
"064279724",473,424,897,255,270,245
"064340103",372,406,778,267,300,260
"064340202",87,90,177,55,59,53
"064342407",329,371,700,228,238,221
"064340406",473,531,1004,360,406,350
"064340407",326,330,656,218,239,209
"064340602",450,495,945,307,286,248
"064340605",357,438,795,288,304,271
"064340706",239,260,499,156,168,145
"064340807",445,428,873,224,206,203
"064340813",581,629,1210,321,297,273
"064340915",576,637,1213,359,312,293
"064341012",521,524,1045,297,273,257
"064341101",506,542,1048,333,319,294
"064341102",623,708,1331,393,392,368
"064341114",390,414,804,242,227,211
"064341506",225,275,500,200,286,197
"064341512",158,212,370,150,236,147
"064341606",235,267,502,179,235,179
"064341608",266,291,557,193,213,187
"064341612",529,627,1156,430,466,413
"064341702",427,486,913,328,373,318
"064341802",322,371,693,252,261,225
"064341811",181,233,414,195,264,194
"064341907",415,446,861,315,352,299
"064342001",324,391,715,256,277,247
"064342003",538,600,1138,381,393,347
"064342104",281,288,569,187,201,186
"064342113",460,507,967,332,362,331
"064342211",441,489,930,305,302,293
"064342214",428,513,941,313,269,255
"064342306",737,739,1476,415,383,376
"064342315",533,571,1104,317,224,216
"064342406",327,388,715,244,264,234
"064342516",524,532,1056,323,337,314
"064342612",412,398,810,220,147,139
"064342614",621,664,1285,322,271,266
"064342703",600,648,1248,433,448,423
"064342707",453,475,928,283,263,247
"064342813",337,357,694,234,261,219
"064342906",394,417,811,293,327,285
"064342907",462,537,999,340,364,320
"064342908",423,451,874,285,233,211
"064343103",313,382,695,268,324,266
"064343110",173,214,387,173,297,172
"064343405",350,350,700,225,252,224
"064343505",205,223,428,145,154,120
"064343604",443,477,920,325,364,316
"064343803",385,430,815,335,402,328
"064343809",327,392,719,252,303,247
"064344101",367,411,778,263,305,248
"064344207",362,428,790,261,229,208
"064344301",520,544,1064,372,403,355
"064344501",524,557,1081,335,368,324
"064344505",602,667,1269,372,364,342
"064344508",599,662,1261,365,296,283
"064410101",404,448,852,299,368,291
"064410402",580,622,1202,354,433,347
"064410412",293,373,666,286,392,270
"064410601",249,272,521,248,346,232
"064410701",112,173,285,147,218,144
"064410703",250,329,579,287,387,274
"064410705",261,314,575,321,467,316
"064410708",144,176,320,172,229,160
"064410806",35,58,93,42,68,41
"064410807",135,198,333,180,296,166
"068400408",234,227,461,150,163,149
"064411007",227,253,480,207,242,194
"064411109",193,233,426,200,279,199
"064411202",190,232,422,248,368,239
"064411207",194,264,458,234,361,231
"064411216",138,155,293,177,334,171
"064411502",248,298,546,283,388,273
"064411507",214,265,479,234,334,232
"064411702",234,303,537,213,259,211
"064411802",178,214,392,223,284,214
"064411805",250,325,575,244,343,236
"064411905",147,167,314,157,201,144
"064411907",219,265,484,222,294,209
"064411908",173,214,387,170,225,151
"064412001",320,410,730,322,456,319
"064412006",237,291,528,209,276,207
"064412007",178,223,401,185,257,182
"064412009",248,291,539,262,349,256
"064412013",117,154,271,148,340,146
"064412102",221,278,499,218,330,217
"064412103",426,489,915,383,494,375
"064412105",387,440,827,318,372,314
"064412109",227,243,470,204,271,202
"064412304",233,234,467,191,236,191
"064412308",275,301,576,238,283,234
"064412406",305,416,721,325,466,318
"064412501",208,250,458,232,301,229
"064412509",212,257,469,198,240,189
"064412601",261,283,544,220,261,218
"064412606",384,432,816,314,364,309
"064412614",304,349,653,273,344,267
"064412702",480,509,989,358,452,350
"064412803",249,310,559,240,293,232
"064413106",381,423,804,272,297,265
"064413113",292,314,606,216,242,206
"064413114",344,416,760,261,296,254
"064413204",621,659,1280,410,443,395
"064413401",287,334,621,215,255,209
"064413414",505,555,1060,291,294,272
"064413501",587,611,1198,381,396,362
"064413510",635,576,1211,334,353,326
"064413707",361,389,750,251,263,243
"064414004",317,332,649,228,271,227
"064414009",523,468,991,280,284,272
"066021111",400,512,912,355,438,346
"066021112",358,399,757,279,364,271
"064550109",348,381,729,263,314,259
"064414109",625,652,1277,340,337,311
"064414208",409,408,817,231,258,225
"064414212",439,483,922,283,315,274
"064414304",494,505,999,344,373,328
"064414306",526,533,1059,322,342,289
"064414308",443,439,882,245,268,238
"064414404",414,465,879,258,283,245
"064414409",514,486,1000,252,243,233
"064414510",654,687,1341,339,329,294
"064414607",434,450,884,302,352,292
"064414805",261,332,593,202,218,189
"064414903",392,415,807,300,356,286
"064415004",259,296,555,204,219,201
"064415009",316,372,688,252,282,248
"064415114",279,362,641,227,272,224
"064415305",674,725,1399,388,399,365
"064415308",430,442,872,275,297,259
"064415411",309,332,641,194,221,189
"064415415",352,348,700,204,200,190
"064415503",387,376,763,212,257,207
"064415508",524,555,1079,334,417,323
"064415608",670,668,1338,426,488,412
"064415712",508,547,1055,344,397,340
"064415801",326,366,692,247,290,240
"064415902",344,404,748,238,261,227
"064416001",561,595,1156,364,410,338
"064416003",385,442,827,257,282,250
"064416009",600,593,1193,345,386,335
"064416102",323,361,684,213,231,198
"064416104",333,359,692,227,250,222
"064416109",362,375,737,228,283,220
"064416112",395,463,858,245,302,239
"064416205",84,91,175,65,72,60
"064416207",282,323,605,202,236,193
"064416208",500,541,1041,331,383,321
"064416211",793,776,1569,437,461,416
"066232004",208,203,411,106,131,104
"064416302",327,341,668,219,288,215
"064416306",502,500,1002,252,329,243
"065151813",661,627,1288,350,361,319
"067001210",308,371,679,267,307,260
"064416604",479,521,1000,306,321,294
"064416614",401,391,792,235,245,201
"066380106",737,668,1405,331,338,312
"064480605",270,278,548,201,239,200
"064550102",315,350,665,270,287,262
"064550104",274,321,595,226,288,223
"064550105",351,434,785,258,286,257
"064900808",433,547,980,357,406,349
"064551404",215,221,436,160,177,156
"064551405",347,410,757,280,326,276
"064551407",396,460,856,306,344,289
"064551408",445,480,925,329,346,306
"064620401",152,166,318,111,131,111
"064620707",570,594,1164,401,455,388
"064621203",444,447,891,303,360,297
"064690101",372,396,768,270,288,245
"064690102",404,459,863,346,411,340
"064690104",554,614,1168,461,526,451
"064690110",357,351,708,238,270,228
"064690205",316,363,679,296,331,271
"064690206",264,288,552,216,269,215
"064690214",417,460,877,277,291,262
"066381710",223,271,494,203,272,192
"066382202",485,480,965,266,286,249
"064760108",465,474,939,296,313,291
"064760701",151,166,317,96,107,96
"066440510",65,79,144,47,310,46
"064830106",334,402,736,307,371,294
"064830115",332,371,703,214,243,212
"064830301",159,157,316,94,82,72
"064830403",231,263,494,154,167,149
"064830404",566,592,1158,363,379,347
"066480315",691,650,1341,326,370,320
"064830701",143,152,295,112,124,110
"064900105",497,496,993,258,258,246
"064900111",465,468,933,236,213,199
"064900112",529,561,1090,286,243,228
"064900209",823,825,1648,455,475,413
"064900305",301,309,610,179,171,160
"064900313",546,546,1092,342,336,313
"064900505",366,368,734,245,242,226
"064900516",869,896,1765,539,471,438
"064900610",337,375,712,228,248,221
"064900613",429,530,959,381,411,349
"064900706",564,640,1204,348,347,321
"064900802",315,369,684,238,263,230
"064900809",532,550,1082,385,425,359
"064900906",441,507,948,347,386,330
"064901004",438,497,935,351,412,348
"064901012",385,483,868,310,367,307
"064901101",211,251,462,173,235,173
"064901105",392,475,867,352,428,342
"064901115",282,353,635,229,276,217
"064901117",339,428,767,330,451,330
"064901202",493,565,1058,389,379,334
"064901208",385,434,819,293,324,280
"064901303",451,481,932,320,324,301
"064901306",542,604,1146,358,342,324
"064901308",378,420,798,276,286,273
"064901314",648,648,1296,369,357,343
"064901405",496,486,982,286,253,240
"064901410",598,624,1222,358,282,263
"064901504",456,517,973,268,203,190
"064901510",516,524,1040,289,266,252
"064901511",600,672,1272,335,258,241
"064901603",591,609,1200,327,339,316
"064901604",271,314,585,174,161,144
"064901705",655,713,1368,399,397,375
"064901805",302,360,662,222,235,211
"064901810",506,523,1029,300,280,264
"064901909",213,256,469,168,196,168
"064901910",470,501,971,337,365,319
"064902009",323,328,651,210,242,207
"064902103",449,550,999,353,407,340
"064902108",165,198,363,155,232,154
"064902202",258,341,599,225,314,222
"064903605",517,549,1066,304,267,248
"064902411",147,209,356,199,297,197
"064902502",380,417,797,290,327,289
"064902505",309,363,672,250,305,247
"064902508",474,568,1042,346,389,331
"064902708",443,497,940,311,308,275
"064902711",742,783,1525,478,452,415
"064902808",276,322,598,209,219,194
"064902810",650,677,1327,407,431,386
"064903002",987,1012,1999,523,517,495
"064903005",732,808,1540,478,486,449
"064903008",498,522,1020,316,350,302
"064903009",475,519,994,338,332,297
"064903101",460,447,907,246,223,205
"064903105",628,663,1291,336,317,307
"064903205",515,499,1014,253,191,182
"064903401",1149,1105,2254,665,426,355
"064903405",816,812,1628,442,321,312
"064903414",697,728,1425,361,335,324
"064903415",467,447,914,252,201,193
"064903517",585,589,1174,321,285,269
"064903603",516,511,1027,275,266,249
"064903805",765,791,1556,405,359,347
"064903808",981,948,1929,482,387,368
"064903810",522,536,1058,274,211,206
"064903811",690,683,1373,354,314,297
"064903812",465,507,972,263,199,180
"064903909",684,690,1374,328,296,291
"064904003",633,647,1280,308,273,264
"064904309",707,742,1449,445,464,434
"064904402",477,556,1033,386,438,382
"064904403",419,471,890,281,271,255
"064904412",452,475,927,260,260,241
"064904507",229,281,510,196,206,189
"064904603",371,420,791,273,318,266
"064904604",383,418,801,281,320,271
"064904605",141,171,312,126,163,125
"064904612",374,403,777,265,306,256
"064904804",461,471,932,345,423,335
"065391212",684,747,1431,402,395,375
"065391213",609,628,1237,320,288,283
"065391404",357,364,721,227,256,216
"065391410",397,424,821,266,281,249
"065391411",402,441,843,269,289,257
"065391505",191,257,448,152,238,152
"060631103",63,47,110,44,79,44
"060700502",42,30,72,26,57,22
"061121107",11,6,17,7,15,7
"061400204",24,25,49,19,23,19
"060070105",24,10,34,12,29,12
"060070110",13,7,20,11,13,11
"060070111",11,6,17,8,15,8
"060070307",9,7,16,5,25,5
"060070408",12,10,22,6,14,6
"060070410",4,1,5,2,8,2
"060070505",4,3,7,3,5,3
"060070602",13,7,20,7,17,7
"060070610",11,8,19,9,10,9
"060070901",5,3,8,5,13,5
"060140101",43,23,66,27,39,24
"065391608",303,375,678,220,254,210
"060140401",58,42,100,35,66,35
"060140503",64,36,100,36,85,36
"060141101",32,21,53,18,32,18
"060210302",14,5,19,7,19,7
"065391610",409,466,875,319,347,300
"062170206",16,20,36,15,15,15
"062241302",19,20,39,14,44,14
"062310401",3,1,4,2,11,2
"060421101",31,26,57,24,51,23
"060492101",81,52,133,46,54,43
"060840602",9,8,17,5,9,5
"060563101",81,61,142,59,145,59
"060630406",47,32,79,29,42,29
"065391702",582,593,1175,332,297,274
"060630607",31,12,43,18,30,18
"060630805",78,66,144,56,106,53
"060631104",96,47,143,45,67,45
"060631106",76,36,112,42,92,42
"060700403",30,28,58,19,42,18
"060700701",31,26,57,22,27,14
"060770302",12,6,18,8,18,8
"060701201",35,27,62,21,40,21
"060770902",13,14,27,8,10,8
"060840201",32,15,47,18,36,18
"060840401",6,4,10,4,25,4
"060840601",NA,NA,NA,NA,NA,NA
"060840803",40,37,77,30,57,29
"060840909",25,18,43,13,15,13
"062801201",62,54,116,39,49,39
"065391809",678,719,1397,395,365,339
"061120309",17,12,29,10,18,10
"061120604",29,20,49,15,26,15
"061120403",7,6,13,5,22,5
"061121004",79,56,135,55,105,53
"061190102",20,18,38,13,21,13
"063220504",6,3,9,4,15,4
"061190602",32,23,55,19,33,19
"061190803",NA,NA,NA,NA,NA,NA
"061190902",37,33,70,21,48,21
"063360401",19,13,32,16,26,16
"061340502",62,47,109,32,55,30
"065392007",324,341,665,216,226,210
"061470205",11,7,18,9,28,9
"061470305",22,14,36,15,33,15
"061470503",19,8,27,14,27,14
"061470711",7,10,17,8,18,7
"061470712",2,4,6,2,12,2
"061470803",9,8,17,7,16,7
"061470904",13,9,22,10,26,10
"061470905",12,12,24,9,27,9
"061540301",47,36,83,24,33,24
"061540609",31,19,50,20,36,20
"061610501",24,19,43,14,33,14
"061610201",18,21,39,11,13,11
"061680303",24,15,39,16,27,16
"061680402",18,14,32,10,12,10
"061680405",0,1,1,1,11,1
"061680503",11,10,21,8,14,8
"061681003",33,28,61,22,45,22
"061750202",9,10,19,5,14,5
"061750401",53,39,92,30,48,29
"067561702",592,576,1168,406,449,394
"061890101",18,6,24,9,16,9
"061890103",7,2,9,3,9,3
"061890104",11,7,18,7,18,7
"061890305",7,8,15,5,22,5
"061890604",23,6,29,7,8,7
"061890701",9,6,15,6,17,6
"061890702",6,4,10,3,14,3
"061891207",3,3,6,2,9,2
"061891106",4,5,9,5,11,5
"061891308",8,7,15,5,14,5
"061891602",1,1,2,1,15,1
"061960303",15,11,26,8,16,8
"061960502",3,1,4,2,16,2
"061960503",18,8,26,12,29,12
"061960702",8,4,12,5,10,5
"061960806",14,17,31,10,24,10
"061960903",21,10,31,12,18,12
"065392108",381,392,773,241,252,228
"061961304",18,12,30,12,30,12
"062030206",21,14,35,11,28,11
"062030403",13,9,22,10,29,10
"062030408",17,10,27,12,18,11
"062030502",5,4,9,3,17,3
"062030703",8,4,12,5,6,5
"062030705",5,4,9,4,9,4
"065392304",529,553,1082,282,263,245
"062030802",42,37,79,28,45,28
"062030905",4,0,4,3,10,3
"062031002",21,16,37,11,31,10
"062031203",14,13,27,12,24,12
"062031305",18,12,30,13,29,13
"062031307",17,8,25,11,23,11
"062031308",11,2,13,10,14,9
"062031503",19,13,32,11,7,4
"062100301",118,84,202,70,157,70
"062101101",29,18,47,17,42,17
"062170203",16,20,36,9,26,9
"062170205",33,34,67,21,54,21
"062170512",14,9,23,6,10,6
"062170601",9,5,14,9,49,9
"062170602",11,9,20,6,17,3
"065810502",35,56,91,52,139,52
"062170605",23,20,43,17,81,17
"065392409",466,460,926,234,204,195
"065392410",437,463,900,251,215,208
"065392411",540,547,1087,295,294,272
"062171007",29,16,45,18,26,17
"065392415",912,942,1854,466,445,432
"062171012",15,6,21,11,38,11
"063920502",39,33,72,28,37,23
"065392508",713,714,1427,382,399,378
"065392511",468,476,944,263,267,255
"065392601",751,790,1541,452,451,415
"062171103",28,26,54,20,39,19
"065392604",563,581,1144,268,263,248
"062240907",54,48,102,29,56,29
"062241502",23,21,44,18,32,18
"062242102",5,4,9,4,14,4
"062310301",17,13,30,11,14,11
"062310404",25,23,48,13,27,12
"062310501",22,15,37,12,20,12
"062310604",11,7,18,5,12,5
"062310703",20,11,31,10,10,10
"062310706",7,1,8,5,15,5
"062311003",18,11,29,11,11,11
"062380401",53,34,87,29,58,29
"062800504",2,1,3,3,13,3
"062800506",14,15,29,12,18,12
"062800710",19,15,34,10,22,10
"062800711",14,11,25,11,82,11
"062800803",5,6,11,5,16,5
"062800806",9,9,18,7,14,7
"062800807",20,10,30,13,25,13
"062800813",14,14,28,11,15,11
"062800907",12,10,22,6,6,6
"062800903",7,4,11,5,10,5
"062801202",53,48,101,30,36,30
"062870701",75,51,126,45,72,43
"062940205",35,28,63,20,47,20
"062940607",24,20,44,15,28,15
"062940701",8,3,11,7,14,7
"062940812",8,3,11,3,14,3
"063080301",42,28,70,27,43,27
"063150701",49,32,81,38,53,36
"063220202",12,5,17,6,18,6
"063220303",7,3,10,4,17,4
"063220402",11,5,16,6,12,6
"063220901",24,28,52,17,31,17
"063220608",45,40,85,28,49,26
"063220610",1,0,1,1,6,1
"063220703",31,24,55,17,26,17
"063220704",9,7,16,6,9,6
"065392711",728,771,1499,392,313,306
"063221304",11,12,23,8,20,8
"063290502",165,107,272,101,111,101
"065392802",567,636,1203,328,327,312
"063360601",33,31,64,19,36,16
"063360801",63,48,111,45,55,42
"065392803",575,596,1171,303,308,294
"063430713",233,186,419,148,254,144
"063510702",25,22,47,13,26,13
"063510902",13,9,22,8,18,8
"063577903",147,109,256,84,110,82
"063640602",18,16,34,14,35,12
"063850105",10,6,16,9,17,9
"063850202",19,13,32,12,36,12
"063850302",19,11,30,8,30,8
"063850402",27,21,48,19,33,18
"063920404",10,8,18,6,14,6
"063850802",30,18,48,18,29,18
"063850901",54,29,83,30,36,30
"063851101",31,16,47,16,35,15
"063920305",32,23,55,21,43,21
"063920403",28,23,51,22,36,22
"063920602",36,37,73,23,37,23
"063920802",52,40,92,31,49,31
"063920904",56,45,101,35,47,35
"063921004",30,21,51,19,32,19
"063921006",13,4,17,8,15,8
"063921101",16,10,26,9,15,9
"063921208",33,27,60,19,21,19
"063921301",47,34,81,24,44,24
"063921402",18,9,27,10,17,10
"063921504",49,33,82,23,29,23
"063921507",15,17,32,11,22,11
"063990402",38,15,53,18,32,18
"063990805",32,23,55,20,38,17
"064060102",2,1,3,2,6,2
"064060303",15,10,25,12,14,10
"065392902",152,104,256,55,64,48
"064131604",NA,NA,NA,NA,NA,NA
"065320701",84,65,149,42,73,42
"066232404",9,14,23,8,10,8
"064481001",10,13,23,6,9,6
"064480301",9,9,18,7,13,7
"064480303",8,5,13,5,12,5
"064480402",8,6,14,4,5,4
"064480803",15,13,28,8,24,8
"064481003",4,4,8,3,13,3
"064550301",79,55,134,47,103,46
"064550604",80,62,142,56,118,55
"064620605",21,23,44,15,32,15
"064620711",20,10,30,8,16,8
"064620801",54,59,113,29,52,29
"064621204",10,14,24,8,19,8
"064690702",11,15,26,7,14,7
"064690905",8,8,16,6,30,6
"064690906",25,20,45,15,29,15
"064691202",14,11,25,9,12,9
"064691402",13,15,28,10,20,10
"064760207",28,40,68,25,36,25
"064760401",10,11,21,7,9,7
"064760604",7,11,18,7,28,7
"064761103",27,23,50,20,35,20
"064761205",43,27,70,26,44,26
"064830302",161,145,306,87,124,87
"064830502",74,54,128,42,64,37
"064830504",115,109,224,71,95,66
"064830704",15,14,29,8,11,8
"064830802",65,53,118,43,62,43
"064830905",53,53,106,39,55,37
"064970205",15,15,30,8,17,8
"064971005",16,12,28,11,34,11
"065050405",37,29,66,19,26,19
"065110602",36,24,60,27,51,27
"065110603",34,19,53,24,62,24
"065110702",26,21,47,17,30,17
"066860304",33,35,68,21,41,21
"067070401",261,234,495,138,223,132
"067070404",89,62,151,54,94,51
"067070602",62,49,111,43,99,43
"065180501",23,22,45,11,20,11
"065180505",7,6,13,7,9,7
"065180508",8,6,14,6,15,6
"065180701",44,43,87,27,28,27
"065180806",12,9,21,8,16,8
"065320503",78,61,139,49,66,49
"065320604",20,12,32,10,19,10
"065321302",23,21,44,11,12,11
"065470302",64,61,125,44,70,43
"065470304",63,39,102,33,66,33
"065470602",51,42,93,31,53,27
"065470801",129,106,235,71,128,71
"067910902",79,47,126,66,89,65
"067910903",61,60,121,35,52,34
"065740501",60,48,108,26,40,25
"065740803",44,37,81,27,64,27
"065810602",61,50,111,36,66,36
"068052612",128,100,228,82,327,80
"065601002",446,461,907,273,311,264
"065601101",525,513,1038,293,285,265
"065392913",106,112,218,56,32,20
"065392919",408,423,831,213,219,203
"065392921",700,715,1415,344,322,300
"065810905",6,2,8,3,10,3
"065811003",22,19,41,14,24,14
"065811205",53,44,97,35,31,29
"065880307",26,14,40,12,19,12
"065881404",32,26,58,19,45,19
"065881503",10,6,16,7,12,7
"065951001",91,58,149,54,87,54
"065951401",158,111,269,100,157,99
"065393010",535,565,1100,324,336,304
"066020101",125,38,163,99,111,84
"066020204",30,15,45,23,30,23
"065810505",77,80,157,73,526,73
"066090605",35,17,52,24,46,24
"066091305",21,11,32,9,16,9
"066090703",7,6,13,6,12,5
"066091705",3,4,7,2,7,2
"066091706",9,5,14,5,8,4
"066091802",3,1,4,3,24,3
"066230703",48,32,80,22,57,22
"066230803",11,11,22,10,12,9
"066230904",48,50,98,28,45,27
"066231101",27,29,56,21,34,21
"066231301",4,3,7,3,8,3
"066231302",11,14,25,8,11,8
"066231602",21,18,39,15,24,15
"066231804",22,21,43,15,28,14
"066231902",29,24,53,20,31,20
"065393111",680,736,1416,385,404,378
"065393112",583,629,1212,366,411,358
"068821801",88,64,152,56,171,56
"066510503",12,8,20,10,16,10
"066510603",10,6,16,8,19,8
"066510813",9,4,13,8,8,8
"066511203",18,10,28,15,25,15
"065393115",617,573,1190,296,314,282
"065393116",743,751,1494,387,392,363
"066650103",19,9,28,7,14,7
"066650104",22,15,37,13,105,13
"066650801",24,15,39,13,27,13
"066651006",14,14,28,8,13,8
"066651202",2,0,2,2,70,2
"066720104",27,19,46,14,18,14
"066720502",8,6,14,6,17,6
"067700503",3,3,6,2,3,2
"066720903",19,15,34,15,25,15
"065393203",910,920,1830,415,359,347
"066721302",15,14,29,10,20,10
"066860204",3,2,5,2,17,2
"066860206",7,3,10,3,14,3
"066860210",1,1,2,1,11,1
"066860502",14,18,32,14,58,13
"066861202",6,3,9,4,17,4
"066860801",15,11,26,7,18,7
"066860901",10,9,19,7,21,7
"066861001",7,6,13,4,42,4
"066861102",14,8,22,10,33,10
"066930101",79,63,142,48,68,47
"067600601",522,531,1053,346,389,338
"065810506",173,220,393,149,341,143
"065393214",496,505,1001,275,295,259
"065393302",493,566,1059,278,264,237
"067000104",9,9,18,5,18,5
"065393305",388,379,767,203,192,188
"067000801",12,4,16,8,17,8
"067000903",5,4,9,5,8,4
"067280601",10,12,22,9,14,9
"067070606",82,79,161,56,121,56
"067070702",83,60,143,48,79,45
"067140503",34,27,61,21,31,19
"065393308",787,831,1618,407,411,379
"065393309",918,891,1809,438,455,422
"067140905",6,6,12,6,10,5
"067210102",37,25,62,23,45,23
"067280403",5,2,7,4,10,4
"067281201",37,23,60,21,44,21
"067281403",78,46,124,40,45,39
"067281405",61,76,137,35,57,35
"067281407",35,26,61,18,22,18
"067281502",34,28,62,20,25,20
"067350202",37,33,70,22,25,22
"067350206",50,41,91,32,46,31
"067350307",48,35,83,31,42,27
"067350603",3,1,4,2,8,2
"065393401",595,601,1196,322,316,291
"065393409",829,786,1615,383,364,354
"067491508",86,84,170,58,134,57
"065740416",408,388,796,237,299,225
"065470201",297,306,603,198,247,194
"065530312",44,38,82,32,336,32
"067631202",27,23,50,18,30,18
"067631603",32,22,54,19,39,16
"067631813",17,17,34,11,23,11
"067601110",767,805,1572,422,414,391
"067700305",6,3,9,3,8,3
"067700705",16,8,24,7,11,6
"067700802",6,4,10,4,6,4
"067700805",4,3,7,3,7,3
"067700908",77,48,125,43,77,39
"067701501",6,7,13,3,3,3
"067701505",13,19,32,11,14,11
"067701604",14,6,20,9,13,9
"067701802",10,11,21,8,22,8
"067701806",15,11,26,8,11,8
"067840101",8,11,19,5,14,5
"067840901",12,6,18,9,15,9
"067840902",6,9,15,5,10,5
"067910502",45,27,72,28,36,28
"065470307",714,761,1475,402,426,382
"067911004",57,45,102,35,46,35
"067911401",41,37,78,27,37,25
"067911502",195,121,316,125,147,105
"067911701",90,34,124,42,51,35
"067980504",14,12,26,9,22,9
"067980706",53,47,100,37,83,36
"067980905",15,10,25,10,29,10
"067981004",30,24,54,20,39,20
"065470310",249,202,451,124,263,121
"068052607",35,29,64,27,131,27
"065470909",391,440,831,303,351,293
"065530104",54,63,117,48,165,47
"065530109",57,55,112,51,335,51
"065530203",70,70,140,60,314,60
"065530301",94,74,168,68,258,67
"065530310",26,27,53,22,278,20
"065530314",55,48,103,45,312,44
"065600106",557,542,1099,260,250,235
"065600108",756,727,1483,380,349,339
"065601301",634,682,1316,346,337,313
"065600114",1073,1021,2094,427,441,418
"065600208",772,746,1518,420,398,386
"065601117",410,440,850,257,301,221
"065601201",632,681,1313,360,319,299
"065601203",816,856,1672,435,370,350
"065601210",478,506,984,265,277,247
"065600303",598,570,1168,314,300,274
"065600406",485,436,921,213,234,213
"065600401",593,549,1142,302,284,264
"065600411",572,580,1152,305,259,253
"065600413",456,491,947,292,319,280
"065600415",448,461,909,253,281,242
"065600417",670,715,1385,395,310,289
"065600512",511,550,1061,285,277,257
"065600513",792,772,1564,397,385,363
"065600610",607,639,1246,382,353,324
"065180702",70,47,117,42,116,41
"065180803",122,102,224,78,331,74
"065810410",216,261,477,185,272,178
"065600712",370,380,750,212,226,204
"065600805",499,510,1009,282,333,270
"065601310",859,891,1750,458,445,411
"065250204",224,225,449,146,502,146
"065250416",280,272,552,135,167,135
"065250418",694,744,1438,400,422,384
"065250614",230,245,475,171,187,164
"065320104",442,455,897,334,361,321
"065320208",339,377,716,258,333,253
"065320301",491,546,1037,320,323,298
"065320303",448,479,927,281,309,278
"065321404",420,456,876,316,366,306
"065321405",363,447,810,293,363,286
"065321508",489,501,990,293,296,276
"065390104",507,561,1068,287,306,280
"065390110",447,477,924,248,233,223
"065390206",613,662,1275,434,456,406
"065390301",484,512,996,313,327,297
"065390414",231,271,502,176,189,174
"065390405",488,516,1004,308,298,283
"065390508",474,537,1011,350,359,341
"068052604",94,83,177,71,341,68
"065390805",793,781,1574,417,393,374
"065390807",506,577,1083,273,263,253
"065390810",524,569,1093,310,304,288
"065390814",502,544,1046,311,316,295
"065391008",1128,1076,2204,539,501,490
"065810411",253,294,547,212,316,210
"065391101",490,515,1005,315,314,279
"065391109",659,669,1328,359,367,330
"065391112",421,443,864,250,241,226
"065391114",832,823,1655,440,395,382
"064410106",227,265,492,208,247,204
"064620708",338,370,708,282,309,277
"065811602",443,479,922,342,394,328
"068821703",746,738,1484,421,429,367
"060980404",152,153,305,101,131,100
"061051001",74,53,127,54,123,54
"060141007",270,218,488,137,146,130
"060490407",335,286,621,176,235,172
"060562301",378,361,739,195,223,190
"060980501",570,565,1135,290,306,279
"061121003",609,564,1173,376,306,197
"061121109",740,730,1470,435,346,251
"061190401",248,228,476,153,239,148
"061610403",296,289,585,176,229,175
"061260913",189,205,394,114,204,112
"061610406",230,182,412,131,176,127
"061681001",140,141,281,95,123,95
"061820501",201,213,414,142,220,134
"062100803",545,531,1076,314,394,310
"062240603",65,43,108,36,78,35
"062240904",97,86,183,59,85,57
"062520102",514,495,1009,274,284,252
"062700804",27,31,58,19,25,18
"062700817",73,62,135,37,50,35
"062800908",18,16,34,11,34,11
"062940801",82,91,173,64,82,63
"063010801",201,147,348,91,147,88
"065392509",884,876,1760,407,401,373
"063361002",237,208,445,147,212,143
"063510903",73,65,138,45,63,45
"063640301",373,336,709,209,276,208
"066550309",416,432,848,275,313,268
"063990105",420,393,813,238,323,235
"064131410",NA,NA,NA,NA,NA,NA
"063990504",116,103,219,68,116,67
"063990702",117,127,244,93,118,87
"064275115",174,156,330,85,86,77
"064621002",587,583,1170,346,421,340
"064691002",133,147,280,81,102,81
"064691305",204,191,395,120,187,115
"064830803",49,48,97,30,33,29
"066550311",551,621,1172,407,513,402
"064970301",13,9,22,9,25,9
"064970804",129,116,245,71,80,61
"064970808",148,204,352,79,111,79
"064971208",225,205,430,118,192,118
"065050205",150,138,288,93,167,92
"065050305",92,83,175,52,124,48
"065050322",348,380,728,193,231,184
"065320905",305,298,603,178,248,178
"066160308",63,58,121,42,66,42
"067910802",64,54,118,39,53,37
"065952107",176,130,306,60,98,58
"065952708",174,171,345,98,136,92
"066020805",152,83,235,97,239,92
"066160101",30,32,62,25,31,24
"066300601",209,147,356,134,214,133
"066381319",333,345,678,196,257,192
"066382210",273,290,563,166,207,161
"066380814",321,302,623,164,145,139
"066381111",552,526,1078,275,248,213
"066382103",111,108,219,71,82,65
"066382303",130,117,247,70,103,68
"066440502",240,229,469,141,377,82
"068821709",150,156,306,92,77,66
"066721210",1135,1146,2281,651,712,627
"067280903",209,185,394,130,183,125
"067701804",13,21,34,10,18,10
"067702202",658,645,1303,318,331,310
"067780402",54,63,117,32,55,20
"067780404",254,275,529,126,159,122
"068261303",84,71,155,46,67,46
"068540111",1031,1069,2100,596,551,455
"068751506",737,619,1356,366,419,349
"068821707",268,264,532,173,267,172
"062450412",118,134,252,82,106,81
"066550209",111,107,218,60,97,60
"068821710",698,679,1377,359,380,314
"065681405",276,322,598,184,202,176
"065681502",484,541,1025,356,377,346
"065681505",432,470,902,312,324,308
"065681602",531,572,1103,337,318,311
"065681604",628,687,1315,438,444,411
"065681811",403,449,852,304,348,296
"065681706",608,655,1263,399,435,377
"065681712",380,421,801,284,317,277
"065681806",179,229,408,179,253,177
"065681809",481,515,996,361,395,351
"065681911",648,669,1317,381,394,361
"065682006",226,293,519,223,280,221
"065682007",304,319,623,219,261,215
"065682011",597,611,1208,422,466,404
"065682205",169,191,360,117,170,116
"065682209",242,269,511,169,197,169
"065682217",296,287,583,199,223,193
"065682303",349,408,757,286,363,284
"065682406",351,395,746,249,288,247
"065682502",457,530,987,314,344,306
"065682508",660,687,1347,378,375,355
"065682511",697,734,1431,420,357,325
"065682609",317,352,669,229,220,198
"065682612",524,578,1102,367,403,351
"065682704",537,553,1090,307,277,249
"068050403",1026,1000,2026,535,525,507
"065683007",726,759,1485,435,415,379
"065683011",659,724,1383,427,388,359
"065683102",604,658,1262,398,427,392
"065683107",604,639,1243,402,401,379
"065740805",153,152,305,94,132,93
"065810111",466,491,957,239,252,234
"065810201",320,412,732,291,343,275
"065810207",374,418,792,291,350,289
"065810403",226,305,531,197,242,186
"068051109",869,879,1748,430,362,345
"068051703",319,387,706,236,266,230
"065810809",276,265,541,180,196,176
"065810810",239,256,495,173,202,168
"065811001",220,210,430,141,211,140
"068052109",562,626,1188,325,299,284
"066583208",815,865,1680,548,557,537
"065811301",436,414,850,248,315,243
"065811308",332,280,612,191,351,186
"065811405",253,258,511,163,174,152
"065811407",420,414,834,236,254,220
"065811507",725,764,1489,403,398,379
"068052510",387,475,862,282,283,257
"065811901",107,110,217,84,366,81
"065811903",165,171,336,124,418,124
"065811907",249,245,494,137,149,132
"065880104",402,468,870,334,411,328
"065880115",245,316,561,213,262,210
"065880207",272,318,590,226,294,225
"065880703",134,128,262,95,120,94
"065880914",304,323,627,184,194,173
"068120504",5,4,9,3,4,3
"065881601",371,385,756,279,323,278
"065881703",328,347,675,240,274,235
"065950108",493,533,1026,373,397,366
"065950110",496,566,1062,371,443,366
"065950210",532,595,1127,424,485,414
"065950306",306,384,690,295,356,285
"065950409",495,512,1007,333,356,326
"065951606",360,379,739,241,264,236
"068260205",194,212,406,151,174,150
"065952605",638,656,1294,361,409,349
"065952101",275,308,583,175,189,168
"065952402",311,416,727,307,372,294
"065952506",385,431,816,274,299,265
"065952604",406,410,816,239,246,225
"065952701",594,573,1167,333,364,332
"066020309",365,383,748,248,282,246
"066020901",47,42,89,34,67,34
"066021103",591,581,1172,378,418,359
"066021105",236,320,556,224,267,218
"066021602",302,294,596,175,197,166
"066021405",65,61,126,43,143,43
"066021605",379,391,770,281,289,244
"066021612",21,14,35,16,23,16
"066090206",636,651,1287,418,484,411
"066090903",295,298,593,219,274,218
"066160304",358,403,761,254,266,237
"066230105",412,518,930,331,384,324
"066230209",404,460,864,326,367,321
"066230308",234,331,565,236,317,230
"066230309",248,328,576,223,306,215
"066230501",404,521,925,337,363,332
"066230502",310,400,710,254,277,248
"066230505",534,682,1216,423,433,410
"066230509",357,452,809,270,288,257
"066230510",452,580,1032,370,402,362
"066230902",240,248,488,170,183,165
"066231401",337,381,718,277,315,273
"066231605",323,343,666,230,256,225
"066232202",304,384,688,245,263,239
"066232214",77,92,169,56,71,51
"066232301",238,279,517,181,227,180
"066232304",182,183,365,119,181,117
"066232801",816,849,1665,432,418,386
"066300205",272,296,568,185,223,183
"066380113",1469,1471,2940,792,821,655
"066380206",497,490,987,246,244,232
"066380406",558,577,1135,299,331,281
"066380408",556,621,1177,347,324,265
"066380509",483,517,1000,262,266,243
"066380514",705,753,1458,369,361,346
"066380615",677,739,1416,383,355,332
"066380808",970,978,1948,509,491,447
"066380811",287,304,591,191,282,187
"068611509",204,310,514,255,314,254
"066380905",490,531,1021,310,346,306
"066381001",710,725,1435,362,354,346
"066381009",661,712,1373,379,311,300
"068611915",275,263,538,199,256,197
"066381308",546,571,1117,275,274,252
"066381309",562,536,1098,281,293,272
"066381314",151,178,329,101,164,100
"067630305",283,386,669,236,308,233
"066381318",712,760,1472,412,447,395
"066381406",592,571,1163,343,357,321
"066381502",259,262,521,145,161,143
"066381505",355,348,703,180,211,174
"066381509",681,649,1330,361,375,352
"066381512",737,793,1530,431,458,410
"066381601",460,505,965,363,384,329
"068613307",382,474,856,322,384,318
"066381712",524,570,1094,376,426,343
"066381903",551,572,1123,328,379,317
"068680607",36,49,85,39,344,39
"066382203",450,506,956,252,243,237
"066382104",464,448,912,291,552,283
"066382205",620,589,1209,312,301,283
"066382206",1110,1172,2282,641,625,549
"066382213",459,475,934,233,257,217
"066440103",149,152,301,114,393,109
"068820107",499,517,1016,350,348,311
"066440601",406,442,848,259,279,252
"066440603",230,230,460,135,175,125
"066440611",161,127,288,82,80,68
"066480103",706,784,1490,455,458,409
"066480106",541,589,1130,376,416,366
"066480112",754,757,1511,376,361,349
"066480116",527,479,1006,280,274,240
"066480119",591,598,1189,313,307,289
"066480503",525,499,1024,263,261,249
"068821003",482,511,993,303,317,292
"066480204",605,608,1213,310,344,301
"066480303",139,133,272,60,69,58
"066480309",790,761,1551,417,422,377
"066480311",508,510,1018,258,275,247
"066480312",627,621,1248,325,343,317
"066480402",497,489,986,238,241,228
"066480409",54,40,94,37,90,37
"066510105",342,338,680,274,304,269
"066510108",407,453,860,339,376,332
"066510401",18,13,31,11,19,11
"066510511",426,464,890,323,354,318
"066510716",133,124,257,119,160,116
"066511302",48,47,95,36,68,35
"066550210",186,206,392,158,214,154
"066550301",51,48,99,38,172,38
"066580107",301,388,689,243,288,238
"066580308",678,829,1507,470,498,447
"066580309",599,684,1283,452,482,434
"066580403",573,596,1169,338,324,310
"066580406",433,479,912,283,277,259
"066580415",444,465,909,288,293,272
"066580509",519,572,1091,363,392,359
"066580512",406,417,823,266,280,243
"066580514",419,453,872,286,311,273
"066580606",253,285,538,196,211,193
"066580607",357,381,738,269,289,260
"066580609",566,639,1205,403,425,371
"066580706",410,476,886,270,277,254
"066580803",140,209,349,169,231,167
"066580808",169,229,398,216,372,215
"066580901",508,513,1021,334,363,313
"066581008",342,439,781,304,396,302
"066581013",454,435,889,233,228,228
"066581202",469,561,1030,353,402,342
"066581205",422,482,904,325,373,313
"066581211",442,487,929,344,416,341
"066581306",409,406,815,214,206,200
"066581502",428,478,906,302,334,290
"066581503",595,595,1190,325,317,304
"066581506",270,274,544,183,209,183
"066581507",351,410,761,262,287,260
"066581513",312,350,662,241,254,210
"066581601",323,356,679,261,291,257
"066581606",330,400,730,265,321,265
"066581701",368,453,821,300,307,284
"066581703",308,359,667,254,288,245
"066581707",392,445,837,298,336,292
"066581902",317,374,691,265,302,245
"066581906",235,280,515,190,213,179
"066582007",454,457,911,259,260,231
"066582102",867,882,1749,478,401,384
"066582108",1120,1123,2243,582,563,544
"066582109",692,719,1411,367,359,350
"066582113",903,963,1866,505,476,417
"066582210",550,634,1184,379,392,364
"066582302",586,624,1210,379,344,322
"066582303",642,691,1333,450,516,424
"066582304",541,596,1137,324,324,290
"066582408",347,428,775,271,302,265
"066582501",303,313,616,224,265,220
"066582502",290,361,651,238,272,228
"066582511",667,647,1314,391,470,373
"066582610",470,545,1015,368,412,359
"066582701",695,734,1429,389,324,306
"066582711",736,800,1536,422,352,345
"066582803",374,448,822,293,307,277
"066582807",661,667,1328,332,304,294
"066582809",572,641,1213,370,372,339
"066582904",389,406,795,258,270,238
"066582909",609,667,1276,295,277,264
"066583002",560,594,1154,374,370,340
"066583005",544,603,1147,373,375,338
"066583110",629,675,1304,420,402,392
"066583111",637,668,1305,392,328,311
"066583301",1020,1039,2059,553,528,509
"066583310",370,439,809,276,277,266
"066583401",591,654,1245,403,417,385
"066583408",479,556,1035,340,348,334
"066583506",651,670,1321,416,418,390
"066583609",601,624,1225,352,277,247
"066583610",468,529,997,309,303,267
"066583613",613,647,1260,336,276,267
"066583816",1059,1135,2194,604,513,480
"066583906",609,620,1229,318,305,293
"066584005",735,743,1478,348,345,333
"066584011",405,418,823,212,187,184
"066584103",716,737,1453,421,431,411
"066584108",768,796,1564,425,395,383
"066584208",600,639,1239,341,357,320
"066584213",769,816,1585,450,419,405
"066584402",668,656,1324,352,327,310
"066584412",756,753,1509,393,389,378
"066650206",400,415,815,227,238,227
"066650307",233,229,462,135,139,129
"066721209",353,417,770,287,328,284
"066790302",248,239,487,149,181,147
"066790304",171,164,335,111,128,111
"066790602",465,426,891,265,295,258
"066790611",357,357,714,266,319,263
"066790612",297,319,616,217,239,216
"066791202",23,17,40,16,22,16
"066860103",454,505,959,346,387,325
"066860104",438,491,929,340,384,334
"066861301",228,234,462,140,169,133
"066861308",251,246,497,146,179,145
"066861313",320,393,713,283,340,279
"066861314",279,291,570,190,203,188
"066930308",254,335,589,234,271,233
"066930314",302,312,614,187,227,185
"067000212",320,352,672,236,263,231
"067000604",312,337,649,252,293,246
"067001212",442,488,930,375,433,367
"067070103",321,343,664,222,256,218
"067070114",200,228,428,151,173,148
"067210205",500,522,1022,367,431,358
"067281003",416,441,857,283,311,272
"067281013",312,326,638,209,231,196
"067281014",215,264,479,171,187,167
"067281017",246,265,511,182,210,181
"067350106",537,543,1080,379,409,351
"067350706",755,729,1484,400,416,383
"067420403",304,326,630,242,275,235
"067420407",432,444,876,249,282,246
"067420413",380,377,757,258,295,256
"067490101",49,48,97,25,30,25
"067490205",549,588,1137,328,352,324
"067490207",391,412,803,246,275,243
"067490209",472,542,1014,343,395,336
"067490701",591,645,1236,382,395,360
"067490707",477,554,1031,375,425,367
"067490903",793,846,1639,447,458,429
"067490909",467,518,985,329,341,318
"067490910",352,413,765,261,279,255
"067491006",567,618,1185,400,412,373
"067491101",540,566,1106,295,238,223
"067491110",540,620,1160,329,297,264
"067491204",719,736,1455,423,408,381
"067491302",1040,1078,2118,437,402,390
"067491304",882,864,1746,434,415,398
"067491319",610,618,1228,337,294,280
"067560103",407,402,809,201,218,197
"067560201",438,474,912,275,288,256
"067560203",621,657,1278,394,420,379
"067560301",199,220,419,185,313,185
"067560309",221,344,565,238,429,238
"067560609",226,334,560,270,371,267
"067560702",232,301,533,223,297,222
"067560703",145,197,342,150,195,148
"067560803",413,494,907,328,370,314
"067560911",367,444,811,273,313,266
"067561110",190,248,438,242,304,239
"067561111",277,367,644,309,449,308
"067561204",756,832,1588,513,500,471
"067561206",201,219,420,188,255,186
"067561304",445,501,946,328,337,306
"067561307",446,483,929,322,336,287
"067561311",676,745,1421,426,410,367
"067561405",316,394,710,236,229,200
"067561413",443,428,871,207,203,195
"067561509",373,361,734,213,246,212
"067561603",469,496,965,340,302,273
"067561704",413,461,874,314,345,299
"067561706",433,487,920,313,315,270
"067562106",580,590,1170,313,373,307
"067562207",459,490,949,283,243,232
"067562310",543,585,1128,307,289,272
"067562501",619,643,1262,297,276,270
"067562516",514,559,1073,359,395,349
"067562604",336,380,716,249,267,230
"067562610",344,326,670,194,197,186
"067562611",614,631,1245,400,405,374
"067562703",689,703,1392,342,293,280
"067562708",407,392,799,249,227,218
"067600108",755,778,1533,456,377,354
"067600109",843,875,1718,495,421,395
"067600116",326,339,665,224,243,197
"067600204",324,371,695,279,345,274
"067600207",380,473,853,321,533,311
"067600213",445,520,965,373,458,366
"067600309",290,315,605,203,250,184
"067600313",479,595,1074,440,598,412
"067600510",890,971,1861,597,613,535
"067600606",405,445,850,283,297,261
"067600607",567,579,1146,341,352,324
"067600608",621,667,1288,380,307,273
"067600805",287,330,617,226,258,216
"067600903",577,620,1197,350,333,305
"067600910",591,703,1294,427,483,410
"067601005",385,427,812,215,211,192
"067601009",443,484,927,249,232,219
"067601103",904,962,1866,587,587,550
"067601109",431,410,841,243,244,226
"067601112",371,409,780,226,196,178
"067601114",258,263,521,171,187,157
"067601117",479,410,889,226,255,214
"067601219",649,619,1268,301,256,252
"067601410",661,665,1326,347,314,299
"067601412",892,831,1723,412,394,379
"067601601",499,523,1022,290,265,246
"067601605",718,659,1377,364,364,347
"067601610",531,538,1069,277,267,250
"067601702",716,699,1415,353,317,289
"067601709",510,534,1044,292,307,287
"067601802",550,559,1109,308,313,296
"067601805",458,491,949,243,223,215
"067601816",503,526,1029,256,255,237
"067630210",394,493,887,325,358,308
"067630213",96,117,213,100,137,99
"067630402",509,581,1090,384,416,343
"067630403",456,490,946,309,311,289
"067630404",325,343,668,234,239,223
"067630514",725,719,1444,353,341,320
"067630613",520,572,1092,305,309,288
"067630707",535,568,1103,330,329,302
"067630708",421,441,862,278,291,267
"067630709",373,376,749,221,239,214
"067630903",199,187,386,101,99,96
"067631601",252,285,537,193,228,187
"067700109",328,382,710,295,360,289
"067632005",128,147,275,83,93,83
"067632010",355,383,738,232,246,226
"067700101",209,193,402,120,137,118
"067700105",715,707,1422,417,449,411
"067700106",538,600,1138,394,429,377
"067700205",583,566,1149,302,325,291
"067701007",637,617,1254,367,360,335
"067701602",323,339,662,239,274,238
"067910216",272,335,607,259,310,249
"067701601",495,508,1003,296,337,280
"067702101",313,382,695,248,321,243
"067702104",280,402,682,291,394,286
"067780107",390,410,800,227,242,205
"067780217",308,303,611,187,195,181
"067780405",299,298,597,164,145,124
"067780501",342,390,732,206,216,191
"067780507",473,476,949,246,264,229
"067780912",409,465,874,311,356,293
"067781002",475,504,979,254,253,241
"067781006",297,306,603,205,212,197
"067781007",589,591,1180,341,361,333
"067781010",282,300,582,197,211,190
"067781012",469,511,980,297,317,288
"067781013",794,783,1577,410,419,390
"067910209",279,331,610,255,295,248
"067910403",216,283,499,225,296,223
"067911207",489,557,1046,345,362,323
"067911308",389,450,839,264,282,257
"067911311",470,499,969,279,302,260
"067911802",252,291,543,221,277,219
"067911808",359,410,769,266,291,258
"067911812",353,352,705,234,269,228
"067911901",246,299,545,218,251,213
"067911903",300,403,703,294,347,289
"067911905",471,534,1005,424,496,410
"067911909",144,185,329,175,237,172
"067912103",506,472,978,281,286,263
"067912105",693,674,1367,436,448,422
"067912106",582,633,1215,415,437,406
"067912109",670,720,1390,479,512,467
"067912204",309,316,625,181,221,175
"067912207",746,759,1505,462,493,434
"067912210",470,524,994,365,418,357
"067912211",365,359,724,243,330,241
"067912218",374,303,677,132,174,131
"067980704",299,304,603,220,277,217
"068050610",423,498,921,365,523,342
"067981002",37,33,70,24,38,24
"068050202",379,331,710,204,295,204
"068050309",300,310,610,151,244,151
"068050506",443,511,954,293,289,277
"068050611",442,447,889,303,349,296
"068050803",346,348,694,237,438,182
"068050807",760,842,1602,469,388,356
"068050902",496,518,1014,295,299,287
"068051004",902,923,1825,523,505,475
"068051008",1085,1098,2183,546,506,498
"068051011",657,659,1316,360,289,276
"068051012",614,667,1281,294,328,287
"068051203",475,523,998,361,397,335
"068051207",416,455,871,263,283,260
"068051302",811,778,1589,396,472,394
"068051303",835,900,1735,465,481,441
"068051407",527,533,1060,309,321,298
"068051413",689,725,1414,375,356,340
"068051414",717,716,1433,369,367,361
"068051509",584,632,1216,419,431,404
"068051513",594,609,1203,366,395,352
"068051604",927,918,1845,476,428,411
"068051606",585,588,1173,332,327,313
"068051608",628,659,1287,350,299,271
"068051709",883,902,1785,526,425,380
"068051803",739,781,1520,470,468,403
"068051807",391,477,868,282,284,263
"068051808",657,693,1350,440,435,403
"068051810",670,737,1407,439,453,407
"068051907",382,424,806,256,275,236
"068052003",359,410,769,253,226,209
"068052010",582,615,1197,352,310,292
"068052011",727,739,1466,380,362,346
"068052209",770,742,1512,430,524,409
"068052210",472,465,937,272,314,267
"068052508",540,483,1023,217,392,203
"068190501",27,25,52,20,108,20
"068190504",138,126,264,102,409,100
"068190907",102,114,216,74,232,74
"068260104",243,257,500,176,202,170
"068260105",258,260,518,184,202,181
"068260201",351,386,737,281,305,274
"068260708",72,82,154,48,138,48
"068261609",192,220,412,159,186,158
"068261611",290,279,569,196,222,193
"068261801",89,72,161,58,88,58
"068330102",392,426,818,327,392,322
"068330114",444,533,977,395,478,383
"068330201",339,382,721,291,365,285
"068330202",478,547,1025,378,424,370
"068330203",386,436,822,339,399,328
"068330212",474,518,992,381,487,377
"068331005",612,603,1215,420,486,406
"068331303",57,41,98,40,276,40
"068331704",39,38,77,33,287,31
"068400111",544,597,1141,335,315,293
"068400308",766,801,1567,477,463,430
"068400407",473,489,962,327,346,312
"068400502",455,463,918,293,296,271
"068400506",295,385,680,216,223,191
"068400507",427,476,903,295,397,254
"068400511",760,770,1530,485,538,455
"068400606",604,646,1250,410,430,392
"068400613",487,499,986,288,284,270
"068400802",284,321,605,188,195,166
"068400807",371,418,789,273,284,253
"068400810",304,360,664,242,265,238
"068400902",292,319,611,217,249,215
"068400905",262,297,559,222,226,208
"068401003",266,316,582,240,299,238
"068401012",234,280,514,180,188,164
"068401108",587,609,1196,422,443,401
"068401111",488,540,1028,368,362,328
"068401208",328,348,676,237,265,228
"068401306",299,348,647,233,269,226
"068401404",626,702,1328,430,431,368
"068401405",421,442,863,304,265,205
"068401410",430,488,918,307,345,298
"068401507",230,269,499,195,228,180
"068401509",431,489,920,343,404,325
"068401512",275,279,554,224,256,221
"068401602",350,402,752,284,314,268
"068401603",392,418,810,303,356,291
"068401605",427,475,902,323,411,309
"068401612",269,298,567,210,267,197
"068401614",218,245,463,158,200,157
"068401705",436,454,890,313,325,289
"068401709",278,310,588,201,230,200
"068401710",353,390,743,251,279,236
"068401908",459,535,994,334,307,269
"068401810",505,573,1078,360,374,333
"068401910",291,308,599,222,260,210
"068402008",368,427,795,257,218,191
"068402011",511,621,1132,370,384,331
"068402104",330,368,698,237,230,200
"068402105",346,374,720,216,179,157
"068402206",487,497,984,322,355,316
"068402301",357,387,744,260,271,240
"068402303",228,287,515,172,190,172
"068402408",343,378,721,264,265,230
"068402505",272,275,547,151,144,133
"068402506",697,661,1358,332,277,263
"068402508",274,303,577,164,205,162
"068402709",381,460,841,306,311,265
"068402713",404,443,847,288,322,258
"068402801",492,542,1034,305,294,265
"068402807",542,666,1208,390,424,378
"068403001",320,406,726,273,239,185
"068403002",228,257,485,157,162,133
"068403003",346,427,773,263,319,261
"068403008",467,527,994,323,385,321
"068403010",253,273,526,215,294,212
"068403203",315,365,680,243,293,241
"068470201",77,73,150,56,85,56
"068052619",173,160,333,119,250,115
"068120301",30,26,56,21,25,20
"068190201",95,75,170,58,120,54
"068190503",32,32,64,23,33,23
"068190801",37,28,65,21,53,21
"068260601",52,28,80,28,59,28
"068330301",1,1,2,1,6,1
"068330503",9,7,16,5,19,5
"068330803",13,8,21,7,28,7
"068331407",9,5,14,7,11,7
"068331203",7,7,14,6,17,6
"068331706",15,7,22,12,34,12
"068331915",85,89,174,50,67,49
"068470107",82,44,126,48,94,48
"068540302",40,26,66,28,57,28
"068541012",66,53,119,36,66,36
"068541013",129,98,227,83,140,83
"068541404",19,26,45,14,22,13
"068750201",90,64,154,71,169,45
"068750902",66,34,100,48,107,47
"068751201",196,148,344,120,182,120
"068751801",46,17,63,24,70,24
"068541002",314,325,639,248,295,241
"068610104",339,421,760,308,394,304
"068610111",237,269,506,200,239,192
"068610207",249,308,557,202,248,193
"068610311",250,370,620,324,406,320
"068610402",248,252,500,270,383,191
"068610403",230,287,517,282,356,275
"068610405",240,299,539,267,395,267
"068610604",252,305,557,274,368,273
"068610609",239,342,581,273,392,268
"068610610",410,502,912,393,464,390
"068610709",371,477,848,270,329,266
"068610811",240,254,494,233,344,225
"068610906",404,466,870,335,373,323
"068610911",570,580,1150,400,455,375
"068611001",454,509,963,338,389,330
"068611007",426,430,856,333,379,325
"068611010",402,442,844,304,334,297
"068611105",293,319,612,207,228,196
"068611203",228,274,502,190,226,185
"068611208",424,488,912,323,365,310
"068611303",248,296,544,241,301,224
"068611306",441,506,947,327,373,314
"068611403",283,338,621,249,298,242
"068611411",158,182,340,146,178,144
"068611502",245,342,587,315,413,308
"068611504",110,124,234,96,106,96
"068611603",361,405,766,269,308,265
"068611610",447,465,912,321,382,308
"068611704",301,333,634,228,265,227
"068611709",435,460,895,327,377,318
"068611806",446,528,974,348,392,333
"068611807",406,463,869,309,353,304
"068611809",460,453,913,322,371,306
"068611810",473,554,1027,371,419,362
"068611901",364,423,787,298,337,289
"068611908",359,411,770,259,291,253
"068612102",357,428,785,276,308,266
"068612208",474,564,1038,375,419,368
"068612210",301,361,662,216,238,208
"068612211",273,323,596,207,236,202
"068612406",370,426,796,281,303,277
"068612605",404,467,871,302,334,300
"068612904",348,401,749,265,263,242
"068612911",355,360,715,252,284,238
"068613003",626,688,1314,393,329,311
"068613008",104,112,216,68,72,66
"068613102",707,848,1555,609,653,513
"068613108",604,668,1272,399,416,379
"068613110",580,620,1200,410,423,380
"068613301",423,485,908,343,424,337
"068613308",372,467,839,329,420,313
"068680107",84,83,167,63,174,60
"068680207",88,93,181,74,332,73
"068680212",129,119,248,87,170,80
"068680302",490,487,977,310,337,259
"068680309",41,35,76,36,448,36
"068680408",127,114,241,81,377,80
"068680601",39,37,76,31,430,29
"068680806",69,80,149,38,409,38
"068680808",25,21,46,25,239,25
"068680809",276,259,535,171,539,162
"068750602",262,320,582,189,207,187
"068751611",250,287,537,195,227,191
"068751613",519,473,992,279,326,270
"068820109",370,407,777,287,319,275
"068820201",551,588,1139,410,484,394
"068820204",275,336,611,254,360,253
"068820307",423,443,866,283,261,240
"068820504",895,841,1736,459,457,415
"068820804",580,678,1258,347,359,323
"068820805",476,529,1005,322,340,306
"068820809",331,390,721,293,370,277
"068820811",275,325,600,234,287,228
"068820904",761,748,1509,378,367,353
"068820906",997,884,1881,462,466,433
"068820908",531,541,1072,320,316,288
"068820913",628,609,1237,299,302,273
"068821603",602,655,1257,441,480,437
"068821706",275,235,510,146,139,92
"065601406",836,847,1683,391,372,358
"065601507",450,425,875,226,219,208
"066480505",563,534,1097,261,282,257
"065601608",775,800,1575,396,412,383
"067702208",375,387,762,265,271,242
"065601707",274,292,566,156,288,153
"065601708",143,149,292,77,158,77
"065601722",372,388,760,225,434,220
"065601805",345,305,650,184,262,175
"065601807",350,324,674,219,343,216
"065601918",236,203,439,127,209,124
"065602003",754,744,1498,383,408,371
"065602107",848,855,1703,431,412,381
"065602110",412,428,840,231,301,209
"065602113",583,571,1154,335,330,305
"065602202",534,615,1149,335,442,318
"065602204",627,666,1293,359,351,317
"065602209",524,573,1097,342,354,325
"065602210",581,584,1165,344,351,316
"065602303",421,434,855,267,301,248
"065602306",490,582,1072,335,376,326
"065602311",149,208,357,174,266,173
"065602403",341,364,705,254,299,246
"065602409",290,355,645,223,247,212
"065602410",278,297,575,205,240,197
"065602413",245,317,562,212,236,200
"065602417",725,745,1470,392,378,349
"065602504",664,770,1434,452,504,447
"065602506",391,434,825,249,261,233
"065680302",518,570,1088,368,399,357
"065680307",318,367,685,228,223,195
"065680401",331,365,696,244,261,227
"065680502",603,657,1260,435,494,429
"065680606",401,470,871,373,513,371
"065680609",456,567,1023,379,401,336
"065680703",307,339,646,215,225,205
"065680705",388,425,813,296,320,287
"065680804",501,575,1076,362,392,355
"065680910",511,549,1060,385,440,369
"065681002",237,273,510,161,162,145
"067911801",246,276,522,214,236,211
"065681003",248,263,511,160,157,137
"065681006",303,348,651,216,217,182
"065681016",390,398,788,297,343,285
"065681204",372,419,791,245,271,227
"065681210",381,418,799,280,315,268
"065681302",275,332,607,206,244,200
"065681812",406,454,860,322,386,318
"061261001",181,133,314,93,148,35
"068821802",34,13,47,18,26,18
"064904811",337,374,711,244,262,233
"064905003",383,384,767,299,331,288
"064970101",450,556,1006,381,445,376
"064970103",233,291,524,204,231,199
"064970106",364,486,850,327,413,316
"064970107",290,327,617,214,243,208
"064970111",394,483,877,278,293,272
"064970503",517,563,1080,325,340,315
"064970511",727,686,1413,370,383,346
"064970601",560,612,1172,338,335,292
"064970603",284,314,598,164,182,156
"064970703",172,223,395,147,218,146
"064970705",357,443,800,306,405,301
"064971204",408,436,844,265,276,254
"064971102",497,575,1072,374,409,356
"064971104",459,559,1018,402,460,395
"064971301",779,860,1639,460,466,431
"064971302",674,665,1339,360,371,348
"064971405",646,631,1277,331,346,312
"064971406",566,646,1212,392,415,369
"065150603",426,441,867,239,216,190
"065050201",222,226,448,153,177,145
"065050210",325,310,635,183,225,181
"065152002",481,474,955,273,252,234
"065050319",426,472,898,310,363,298
"065110505",431,479,910,306,356,298
"065152103",329,343,672,197,236,184
"065150101",346,332,678,193,188,175
"065180709",182,165,347,105,229,103
"065180711",327,334,661,189,330,188
"065180704",95,87,182,76,407,76
"065180602",95,98,193,78,388,75
"065180606",126,132,258,86,174,79
"065180705",127,132,259,101,432,100
"065180707",67,65,132,53,251,53
"065180608",4,8,12,4,11,4
"065150208",649,683,1332,371,465,363
"066860601",293,303,596,177,194,173
"065150305",448,412,860,217,225,208
"065150407",567,581,1148,318,315,309
"065150408",673,731,1404,355,321,304
"065150502",435,450,885,247,241,234
"065150604",494,518,1012,287,281,269
"065150602",527,587,1114,341,366,325
"065150616",469,473,942,279,293,273
"065150707",611,647,1258,376,390,368
"065150710",470,491,961,255,215,205
"065150713",429,455,884,263,261,229
"065150804",443,446,889,263,242,230
"065150811",649,655,1304,351,327,313
"060283104",276,285,561,193,200,185
"065150902",652,691,1343,409,413,367
"065150908",429,441,870,256,251,238
"065151001",547,551,1098,293,260,241
"066930310",226,258,484,180,198,173
"065151006",595,603,1198,359,364,320
"060490612",498,543,1041,303,323,296
"065151501",631,696,1327,424,431,398
"060560404",578,659,1237,470,513,449
"065151013",511,540,1051,312,317,299
"060770513",295,321,616,200,227,196
"065151102",635,694,1329,427,489,397
"060841203",299,317,616,206,230,203
"065151110",658,697,1355,399,382,358
"065151111",445,447,892,243,240,229
"065151202",512,422,934,252,271,235
"060911901",349,362,711,223,247,215
"060912004",354,392,746,216,217,209
"060980609",684,710,1394,420,441,395
"065151205",574,584,1158,296,275,255
"061260211",291,302,593,207,237,201
"060070115",200,191,391,140,167,140
"060070406",194,202,396,161,194,161
"060070407",277,257,534,195,222,193
"060070501",55,49,104,43,61,43
"060070804",290,325,615,227,265,219
"060070806",382,405,787,289,357,286
"060070808",263,355,618,251,323,247
"060070814",497,545,1042,312,333,308
"060210604",543,569,1112,384,400,332
"060210202",183,214,397,147,206,147
"063573704",113,144,257,143,398,143
"060280110",335,378,713,229,241,218
"060280112",465,550,1015,301,315,297
"060280202",731,696,1427,369,293,280
"060280203",825,810,1635,437,393,370
"060280205",593,596,1189,292,249,236
"060280307",753,748,1501,346,294,289
"060280402",743,690,1433,367,293,280
"060280406",839,847,1686,379,272,269
"060280507",224,206,430,101,92,92
"060280605",1002,1013,2015,536,474,460
"060280606",949,943,1892,531,512,502
"060280615",1987,2060,4047,1032,890,854
"060280705",736,791,1527,411,353,344
"060280802",141,146,287,73,66,66
"060280902",622,660,1282,349,337,328
"060281001",378,427,805,248,223,217
"060281007",673,665,1338,354,239,235
"060281102",485,492,977,284,288,264
"060281106",293,329,622,215,222,199
"060281111",781,878,1659,526,537,487
"060281208",401,490,891,318,377,310
"060281301",642,690,1332,434,430,385
"060281306",528,543,1071,312,319,297
"060281309",605,628,1233,340,365,329
"060281401",743,803,1546,410,370,354
"060281402",553,580,1133,307,291,281
"060281403",811,876,1687,472,461,431
"060281409",487,462,949,271,262,244
"060281503",468,497,965,279,287,274
"060281602",754,759,1513,362,360,359
"060281606",744,826,1570,441,394,371
"060281704",416,451,867,246,252,242
"060281801",706,790,1496,424,416,380
"060281811",442,438,880,237,259,237
"060281902",513,565,1078,334,359,331
"060281906",168,154,322,92,97,88
"060282008",598,652,1250,312,283,263
"060282009",581,597,1178,283,291,274
"060282104",360,388,748,244,260,234
"060282105",486,506,992,289,313,279
"060282111",576,578,1154,330,327,304
"060282201",207,236,443,147,162,144
"060282207",353,353,706,185,197,181
"060282213",422,461,883,267,260,241
"060282302",675,740,1415,453,438,400
"060282312",309,347,656,213,231,200
"060282402",718,753,1471,418,328,306
"060282406",470,601,1071,335,363,327
"060282504",136,190,326,183,311,178
"060282506",529,552,1081,375,420,351
"060282509",272,299,571,197,232,191
"060282510",514,608,1122,376,451,364
"060282512",425,421,846,286,321,267
"060282607",304,301,605,164,147,141
"060282810",675,615,1290,316,288,283
"060282811",277,320,597,183,147,111
"060282901",611,658,1269,332,318,298
"060282907",583,618,1201,303,262,248
"060283004",569,592,1161,334,319,289
"060283013",412,443,855,237,234,213
"060283201",428,436,864,247,246,231
"060283202",343,414,757,259,243,224
"060283203",493,534,1027,322,338,313
"060283302",671,734,1405,428,463,411
"060283306",2,0,2,1,1,1
"060283411",486,511,997,293,309,281
"065151214",520,513,1033,291,280,274
"060283801",1052,1039,2091,514,507,478
"060283810",492,488,980,281,322,277
"060350107",384,391,775,245,240,215
"060350305",336,391,727,252,271,250
"060350403",526,555,1081,325,305,289
"060350412",451,467,918,273,263,242
"060350507",707,783,1490,438,307,272
"060350511",355,405,760,269,306,265
"060350606",449,512,961,321,365,313
"060350701",334,384,718,225,210,179
"060350704",421,419,840,267,285,229
"060350709",153,184,337,124,275,108
"060350811",406,393,799,238,241,214
"060350812",1430,1780,3210,1116,1150,1024
"060350905",430,445,875,231,231,223
"060351005",247,322,569,195,233,192
"060351007",354,460,814,345,454,338
"060351008",203,253,456,230,308,227
"060351011",292,358,650,249,264,243
"060351202",386,464,850,330,363,326
"060351309",216,259,475,192,213,185
"060351411",282,277,559,150,175,146
"060351601",213,261,474,187,243,185
"060351602",413,515,928,333,386,326
"060351604",179,212,391,136,158,134
"060351707",406,476,882,302,325,287
"060351708",355,423,778,288,316,273
"060351709",353,389,742,273,295,270
"060351901",401,443,844,292,347,286
"060351909",421,450,871,296,304,266
"060351910",560,609,1169,389,441,383
"060351911",516,555,1071,343,384,332
"060352002",460,531,991,391,433,387
"060352007",465,526,991,358,376,307
"060352104",237,283,520,204,278,201
"060352106",215,254,469,180,236,173
"060352212",54,73,127,49,234,47
"060352303",275,346,621,255,402,246
"060352309",364,436,800,280,297,263
"060352401",420,529,949,331,313,296
"060352410",489,578,1067,347,365,320
"060352501",320,341,661,194,193,171
"060352502",427,454,881,266,286,263
"060352509",446,504,950,316,334,295
"060352611",748,836,1584,436,375,366
"060352615",470,541,1011,332,350,305
"060352707",789,768,1557,374,272,264
"060352805",436,459,895,299,304,272
"060352908",362,390,752,242,269,241
"060353001",483,559,1042,347,380,338
"062241701",92,87,179,72,147,72
"060353101",196,227,423,156,192,151
"060353102",209,251,460,161,231,156
"060353104",435,520,955,401,515,392
"060353308",341,404,745,254,303,238
"060353405",388,412,800,244,300,242
"060353407",271,328,599,242,300,238
"060420102",323,369,692,276,318,271
"060420103",307,399,706,296,357,289
"060420106",340,347,687,251,286,246
"060420108",415,528,943,399,475,390
"060421908",408,399,807,224,252,221
"060421909",845,836,1681,502,531,477
"060490107",291,422,713,268,338,257
"060490110",442,456,898,289,298,267
"060490115",344,359,703,188,203,174
"060490203",331,370,701,284,324,273
"060490207",286,357,643,248,307,245
"060490212",478,501,979,297,320,287
"060490502",256,317,573,238,311,236
"060490603",587,614,1201,400,398,373
"062450407",418,418,836,272,306,268
"060492007",253,290,543,202,246,200
"060492504",549,476,1025,276,314,258
"060560102",330,411,741,361,496,352
"060560111",283,324,607,297,404,290
"060560116",229,244,473,214,292,205
"060560206",226,216,442,192,253,184
"060560403",477,508,985,317,331,305
"060560409",264,298,562,211,273,209
"060560504",582,578,1160,395,439,389
"060560505",242,275,517,169,207,166
"060560602",466,496,962,318,339,310
"060560603",536,615,1151,278,298,274
"060560607",599,646,1245,401,422,385
"060560608",575,562,1137,344,529,319
"060560703",498,578,1076,370,381,341
"060560804",772,750,1522,422,461,406
"060560910",237,275,512,185,219,177
"060561104",188,220,408,244,411,241
"060561106",156,230,386,214,299,211
"060561110",267,393,660,271,353,268
"060561203",155,231,386,193,245,190
"060561410",257,340,597,310,389,295
"060561603",285,334,619,244,268,236
"060561609",379,423,802,315,382,312
"060561703",389,471,860,340,398,336
"060561705",200,218,418,184,237,180
"060561707",390,452,842,319,411,317
"060561802",486,535,1021,371,403,359
"060561807",427,522,949,355,393,338
"060561901",507,521,1028,349,391,337
"060561902",473,503,976,342,365,326
"060561907",697,660,1357,393,410,380
"060562006",273,334,607,254,373,251
"060562101",439,466,905,319,373,315
"060562102",377,423,800,300,309,279
"060562108",267,270,537,214,288,210
"060562203",525,586,1111,370,411,357
"060562207",328,348,676,216,219,207
"060562209",283,305,588,206,219,194
"060562303",613,560,1173,334,344,314
"060562304",842,844,1686,481,514,465
"060562305",358,389,747,257,272,256
"060562314",450,514,964,318,324,294
"060562315",473,416,889,263,281,253
"062600807",551,527,1078,266,264,243
"060562403",529,519,1048,305,415,298
"060562407",650,670,1320,390,455,381
"060562414",383,398,781,234,245,226
"060562506",743,710,1453,421,470,418
"060562509",603,597,1200,362,415,351
"060562601",499,489,988,281,351,277
"060562611",712,702,1414,426,527,423
"062601602",554,581,1135,317,326,298
"060562612",264,271,535,166,221,165
"060562619",379,351,730,176,181,170
"060562703",545,567,1112,312,326,298
"060563207",309,300,609,169,224,168
"060563208",459,449,908,247,265,239
"060630117",340,381,721,236,257,228
"060630110",312,355,667,240,268,232
"060630204",503,497,1000,311,365,304
"060630702",345,343,688,189,211,187
"060630901",113,121,234,82,108,81
"063573904",217,345,562,290,709,288
"060631107",24,22,46,18,54,18
"060631304",360,458,818,340,357,321
"062700708",314,393,707,246,292,239
"060700108",350,373,723,275,303,258
"060700113",212,228,440,161,190,156
"060700216",345,356,701,201,215,192
"060700217",217,212,429,134,149,132
"062701009",705,719,1424,371,348,296
"060770402",221,243,464,168,238,167
"060770104",283,352,635,257,307,250
"060770503",515,527,1042,308,341,300
"060911104",267,323,590,224,250,220
"062740613",477,474,951,238,231,217
"060771402",470,545,1015,380,422,367
"060771403",397,466,863,320,373,310
"064343113",303,341,644,297,466,297
"060910304",524,541,1065,300,274,266
"064343114",244,317,561,271,357,270
"062741110",1026,994,2020,539,521,498
"060841204",426,452,878,331,375,329
"060841208",425,484,909,335,390,332
"060910313",207,274,481,220,318,218
"060910407",760,816,1576,391,350,337
"060910506",384,422,806,252,249,243
"062741708",366,390,756,235,233,210
"060910607",715,755,1470,409,415,382
"060910703",381,395,776,245,245,230
"060910708",739,714,1453,362,342,322
"060910808",781,841,1622,458,442,418
"062742103",757,780,1537,422,447,412
"060911303",582,599,1181,303,278,271
"064411807",212,306,518,240,313,230
"060911404",602,601,1203,334,332,319
"060911407",712,748,1460,403,395,372
"060911411",775,812,1587,448,400,374
"060911603",477,522,999,259,232,217
"060911608",440,432,872,270,280,257
"060911705",729,728,1457,357,344,328
"060911803",977,975,1952,551,565,527
"060911809",384,406,790,258,282,251
"060911908",633,608,1241,373,410,346
"060912001",595,608,1203,340,394,337
"060912111",700,693,1393,356,364,341
"060912201",624,665,1289,367,332,306
"060912211",233,231,464,144,246,139
"060912212",203,187,390,124,232,124
"060912215",740,749,1489,410,426,391
"060912309",313,315,628,179,179,162
"065151404",1017,978,1995,515,443,414
"060980101",411,441,852,296,315,273
"060980104",373,419,792,295,343,288
"060980203",373,413,786,268,299,263
"060980214",418,407,825,236,230,218
"060980215",418,415,833,246,254,229
"060980303",523,565,1088,363,375,337
"060980308",662,706,1368,424,447,414
"060980312",213,250,463,168,173,165
"060980506",468,477,945,263,278,256
"060980601",355,385,740,264,307,258
"060980808",289,295,584,243,271,234
"060980701",433,407,840,251,262,220
"060980801",574,568,1142,336,348,323
"060980806",319,325,644,264,300,238
"061050108",419,453,872,331,401,330
"061050206",353,384,737,277,329,271
"061051105",384,411,795,322,396,318
"061051405",345,304,649,225,272,221
"061120202",649,627,1276,341,339,299
"061120209",259,295,554,197,208,194
"061120501",241,196,437,156,193,153
"061121005",292,308,600,194,220,192
"061121103",264,255,519,181,214,175
"061121301",187,199,386,128,155,120
"061121408",332,397,729,299,369,292
"061190308",581,546,1127,321,389,317
"061190408",202,196,398,111,159,107
"061260101",346,408,754,282,293,275
"061260207",391,423,814,247,250,230
"061260209",599,611,1210,382,402,360
"061260505",658,679,1337,377,346,325
"061260511",462,453,915,243,255,233
"061260801",55,45,100,32,24,19
"061260918",404,399,803,189,198,171
"063570404",216,238,454,160,250,158
"063570611",411,411,822,290,320,279
"063572007",141,178,319,151,422,150
"061340112",354,338,692,225,797,218
"061340202",426,443,869,255,298,248
"061340908",647,628,1275,323,354,306
"061340208",573,570,1143,321,340,307
"063571106",653,603,1256,333,349,318
"061340907",421,420,841,209,243,205
"061341004",543,587,1130,291,311,280
"061400301",338,351,689,217,222,202
"061400317",347,422,769,273,305,269
"061470106",322,398,720,289,342,288
"061470107",398,392,790,291,297,282
"061470109",618,700,1318,359,396,358
"061470302",40,36,76,27,56,25
"061471202",413,428,841,304,331,295
"061540101",181,185,366,133,154,131
"063572105",356,411,767,304,481,297
"061540201",482,506,988,342,388,339
"061540209",470,482,952,352,412,346
"061540210",220,203,423,140,167,136
"061540801",135,129,264,92,116,90
"061610103",289,322,611,203,235,195
"061610111",429,422,851,230,245,223
"061610118",166,180,346,109,143,99
"063575901",356,437,793,353,456,347
"061680905",369,436,805,316,367,311
"061821005",359,416,775,284,318,254
"061750414",384,396,780,272,294,264
"061750416",208,228,436,146,155,142
"061750605",415,511,926,351,383,344
"061820109",697,768,1465,387,406,380
"063572202",103,145,248,110,325,110
"061820208",387,428,815,279,347,276
"061820213",331,346,677,242,292,242
"061820304",642,397,1039,52,78,42
"063577617",93,88,181,67,159,62
"061891705",275,305,580,217,259,208
"061891708",424,439,863,269,314,262
"061961101",14,8,22,8,14,8
"061961501",101,77,178,71,91,70
"062030203",253,263,516,201,234,198
"062100204",442,489,931,348,394,341
"062100209",271,363,634,264,330,261
"062100210",547,592,1139,416,453,397
"062100611",87,80,167,64,98,64
"062101304",394,480,874,344,380,334
"062170107",322,401,723,285,375,277
"062170112",315,356,671,266,328,260
"062170113",548,613,1161,404,475,389
"062170405",188,184,372,101,152,99
"062170414",681,689,1370,432,441,404
"062170502",4,5,9,3,27,3
"062171004",393,460,853,295,353,293
"062171207",297,353,650,235,267,232
"062240103",565,600,1165,408,481,403
"062240106",416,435,851,284,360,277
"062240206",388,414,802,273,320,266
"062240212",221,217,438,133,127,103
"062240307",535,542,1077,294,301,272
"062240405",390,492,882,363,421,357
"062242002",176,175,351,129,153,127
"062242204",325,415,740,316,403,307
"062242207",350,385,735,242,274,235
"062380104",498,532,1030,362,402,351
"062380110",440,514,954,335,384,330
"062380209",375,473,848,314,336,300
"062450102",561,606,1167,376,394,365
"064100415",148,155,303,87,89,78
"062450204",309,340,649,219,215,201
"062450208",436,474,910,309,352,292
"062450417",140,119,259,92,105,91
"062450418",216,225,441,130,157,128
"062450503",342,357,699,212,220,185
"062520104",829,901,1730,442,456,421
"062520210",336,352,688,218,281,215
"062520214",449,497,946,287,311,281
"062520308",162,127,289,88,223,87
"065151508",731,732,1463,400,362,348
"065151509",622,617,1239,333,341,329
"062520501",528,643,1171,399,503,380
"062520508",678,766,1444,472,459,426
"062520603",161,167,328,89,63,54
"062520604",394,401,795,228,356,221
"064120806",618,639,1257,316,288,261
"062520608",39,31,70,25,31,22
"062520702",652,703,1355,374,374,352
"062520706",1188,1195,2383,566,499,477
"064121007",625,596,1221,339,331,310
"062520711",798,838,1636,466,535,450
"062520805",815,828,1643,401,399,363
"062520808",492,485,977,274,283,258
"062521003",635,625,1260,340,355,284
"062521016",594,627,1221,330,318,271
"062521102",697,716,1413,469,506,447
"062521207",778,781,1559,420,371,350
"062521208",725,720,1445,340,288,269
"062521307",352,384,736,233,261,225
"062521411",501,504,1005,293,328,288
"062521418",524,519,1043,284,303,278
"062521507",725,756,1481,394,344,325
"062600109",683,747,1430,380,365,342
"062600118",313,325,638,176,171,159
"062600203",920,960,1880,481,458,435
"062600304",1120,1059,2179,534,545,487
"062600308",587,631,1218,320,323,303
"062600504",644,668,1312,371,330,318
"062600509",679,680,1359,378,382,354
"062600511",794,834,1628,405,367,350
"062600516",419,440,859,246,239,228
"062600601",648,711,1359,398,416,372
"062600612",460,533,993,346,408,344
"062600702",512,571,1083,369,415,345
"062600705",423,418,841,254,270,248
"062600709",441,473,914,297,322,289
"062600710",612,694,1306,434,477,418
"062601002",489,502,991,275,278,254
"062601005",181,221,402,146,78,41
"062601011",608,594,1202,337,322,303
"062601015",250,252,502,137,172,135
"062601304",475,516,991,349,406,338
"062601401",578,635,1213,391,414,369
"062601404",318,360,678,214,243,210
"062601407",444,454,898,281,294,269
"062601408",652,680,1332,382,444,378
"062601504",438,466,904,255,262,229
"063572903",121,157,278,137,415,126
"062601506",600,592,1192,317,320,306
"062601512",498,521,1019,294,303,277
"062601518",847,864,1711,454,448,412
"062601603",788,772,1560,394,412,379
"062601704",507,514,1021,262,259,235
"062601708",374,380,754,206,246,203
"062660504",110,103,213,68,169,64
"067000605",338,331,669,236,276,234
"062660701",428,443,871,245,252,227
"062660609",382,329,711,196,248,184
"062660703",748,741,1489,429,469,406
"064270203",136,173,309,144,244,143
"062700213",533,570,1103,256,285,254
"062700506",721,735,1456,361,367,354
"062700614",414,436,850,235,262,230
"062700616",669,709,1378,346,397,333
"062700710",345,374,719,207,208,185
"062700715",503,492,995,278,303,268
"062700801",121,116,237,75,145,74
"062700814",189,201,390,116,155,99
"062700815",295,274,569,170,220,165
"062701007",724,769,1493,377,404,365
"062701103",44,24,68,21,24,21
"062740102",513,542,1055,399,435,376
"062740110",412,451,863,264,294,259
"064272206",567,569,1136,308,226,208
"062740207",518,577,1095,321,325,300
"062740301",660,660,1320,383,371,357
"062740314",684,699,1383,340,311,294
"062740402",730,786,1516,410,402,381
"062740415",685,707,1392,348,346,333
"062740508",651,692,1343,401,407,370
"062740513",574,568,1142,303,280,258
"062740602",521,514,1035,306,313,296
"062740618",514,533,1047,229,203,193
"062740703",612,604,1216,302,302,282
"062740706",743,759,1502,375,388,360
"063573006",179,298,477,247,387,236
"062740801",350,332,682,189,183,174
"062740812",518,495,1013,254,270,250
"062740906",831,791,1622,420,433,373
"062740920",686,700,1386,364,390,354
"062741010",577,510,1087,278,323,259
"062741011",420,356,776,210,301,194
"062741012",623,568,1191,308,330,297
"062741013",310,281,591,165,141,81
"062741103",560,581,1141,304,271,258
"062741104",532,573,1105,316,306,295
"062741214",444,431,875,243,237,217
"062741402",477,535,1012,362,425,345
"062741508",536,524,1060,287,234,226
"062741513",545,586,1131,305,278,260
"062741514",465,481,946,266,265,255
"062741612",543,527,1070,298,246,239
"062741610",612,626,1238,331,301,277
"064275107",596,625,1221,331,288,271
"062741714",622,679,1301,394,376,341
"062741810",663,730,1393,325,324,311
"062741815",399,426,825,230,220,209
"062741817",724,688,1412,373,365,344
"062741904",833,767,1600,430,437,419
"062741907",880,893,1773,417,414,396
"062741908",471,463,934,217,228,207
"062741910",913,888,1801,461,468,436
"062742008",602,609,1211,323,301,276
"062742116",460,485,945,249,248,235
"062742119",628,628,1256,327,326,304
"062742122",503,517,1020,261,264,242
"062800206",310,384,694,244,307,234
"062800301",72,85,157,56,230,56
"062800312",27,31,58,28,426,28
"062800608",187,176,363,116,159,110
"063571204",400,394,794,274,299,264
"062801001",219,274,493,200,343,200
"062801106",233,276,509,176,248,173
"062801110",200,238,438,134,174,127
"062801208",805,804,1609,458,496,449
"062801209",322,310,632,192,199,190
"062870408",343,337,680,205,214,193
"062870410",176,185,361,132,154,130
"062870411",350,387,737,271,324,264
"062940408",441,483,924,305,349,303
"062940405",52,55,107,38,50,37
"062940604",187,212,399,131,167,130
"064278714",558,550,1108,315,289,269
"062940802",253,275,528,206,236,205
"063010505",346,342,688,222,271,218
"063010512",427,496,923,337,390,332
"063010514",306,328,634,188,201,185
"063010802",68,65,133,41,88,40
"063010808",333,401,734,281,331,275
"063010809",285,341,626,248,313,244
"063010810",210,215,425,146,184,142
"064279511",896,813,1709,411,388,373
"063150117",368,381,749,194,218,191
"065151608",692,726,1418,359,407,353
"063570207",332,340,672,213,251,210
"063220301",162,160,322,97,126,96
"063570208",272,303,575,191,211,173
"063220605",241,280,521,212,258,205
"063573108",186,290,476,253,560,253
"063220613",207,233,440,142,274,134
"063290306",378,408,786,217,268,202
"063290308",491,551,1042,318,353,300
"063290311",451,493,944,328,370,321
"064341004",324,381,705,205,211,190
"063361001",239,216,455,123,165,122
"063430601",259,278,537,183,264,181
"063430704",197,192,389,136,156,133
"063430705",339,361,700,236,272,230
"063430707",344,379,723,253,285,243
"063430708",242,260,502,164,207,161
"063430709",366,440,806,309,385,305
"063510604",489,499,988,371,453,367
"063510605",418,441,859,253,282,250
"063510608",152,148,300,97,131,97
"063570204",569,663,1232,343,423,340
"063510615",490,516,1006,275,300,271
"063571202",275,315,590,196,214,193
"063570202",424,452,876,258,297,254
"063570210",386,394,780,244,283,240
"063570309",540,608,1148,363,456,357
"063570407",366,393,759,266,459,255
"063570408",445,458,903,304,419,299
"063570501",565,561,1126,370,406,350
"063570502",531,616,1147,340,387,329
"063570604",549,634,1183,381,429,372
"063570707",442,430,872,282,294,244
"063570709",676,678,1354,424,463,413
"063570710",501,532,1033,308,317,283
"063571004",546,544,1090,298,358,288
"063571010",371,388,759,225,247,216
"063571102",590,599,1189,336,355,316
"063571105",578,585,1163,327,320,283
"063573702",143,218,361,221,649,218
"063571210",705,719,1424,338,376,321
"063571211",756,841,1597,372,398,365
"063571511",175,220,395,163,191,158
"063571606",249,300,549,217,253,211
"063571612",161,207,368,158,208,158
"063571707",232,233,465,172,230,172
"063571802",227,318,545,191,404,188
"063572008",45,48,93,44,180,44
"063571803",169,174,343,140,314,139
"063571804",266,329,595,224,338,216
"063571810",226,275,501,209,468,209
"063571902",202,241,443,166,347,165
"063571904",83,88,171,82,332,82
"063571908",207,247,454,209,376,207
"063572005",74,104,178,104,257,103
"063572604",163,292,455,276,754,269
"063573207",187,263,450,226,371,225
"063573307",235,320,555,277,436,274
"063573502",238,339,577,314,928,312
"063573503",118,174,292,156,364,153
"063574008",153,201,354,194,685,194
"063574203",94,113,207,92,265,92
"063574306",121,156,277,104,284,97
"063574404",350,376,726,235,334,232
"063574405",284,337,621,210,436,207
"063574407",191,211,402,151,371,146
"063574606",307,446,753,309,420,299
"063574610",271,324,595,260,316,245
"063574708",297,387,684,287,421,283
"063574811",346,393,739,299,368,294
"063574813",243,296,539,210,234,191
"063574814",271,333,604,237,278,231
"063574901",294,347,641,234,279,227
"063575003",391,447,838,301,368,297
"063575008",846,918,1764,534,563,520
"063575012",465,572,1037,352,389,332
"063575104",369,451,820,285,339,275
"063575109",617,655,1272,418,461,396
"063575205",431,450,881,283,288,265
"063575211",705,675,1380,361,373,349
"063575213",605,634,1239,340,314,288
"063575301",495,500,995,332,357,308
"063575313",430,428,858,251,271,245
"063575316",510,491,1001,256,269,243
"063575502",301,379,680,272,307,268
"063575504",533,607,1140,438,511,414
"063575507",324,359,683,227,247,219
"063575611",473,570,1043,397,453,383
"063575703",351,391,742,280,301,266
"063575704",538,603,1141,417,467,395
"063575802",328,402,730,277,343,275
"063575908",367,440,807,309,373,297
"063576007",409,460,869,315,385,310
"063576010",378,393,771,246,272,238
"063576109",278,334,612,210,243,198
"063576408",194,207,401,140,332,137
"063576601",448,458,906,285,323,274
"063576703",534,529,1063,322,361,303
"063576712",581,608,1189,332,344,308
"063576808",335,397,732,234,265,225
"063576810",524,582,1106,325,336,307
"063576909",500,506,1006,289,291,272
"063577008",517,551,1068,375,398,351
"063577011",423,443,866,261,241,221
"063577109",672,696,1368,421,464,399
"063577110",580,506,1086,301,282,263
"063577202",627,632,1259,327,314,299
"063577203",521,512,1033,256,236,216
"063577204",638,670,1308,370,331,309
"063577211",607,609,1216,348,378,338
"063577407",389,374,763,224,269,220
"063577412",241,280,521,163,250,162
"063577414",520,518,1038,330,436,308
"063577418",276,267,543,177,278,174
"063577503",32,38,70,27,217,26
"063577513",218,236,454,151,264,144
"063577514",130,140,270,92,201,88
"063577612",127,134,261,89,218,87
"063578202",74,66,140,47,102,41
"063577911",276,270,546,165,175,157
"063577808",340,310,650,200,308,198
"063577809",2020,564,2584,233,244,221
"063578005",693,681,1374,406,472,379
"063578007",307,321,628,175,196,160
"063578011",231,209,440,143,215,140
"063578013",303,272,575,156,192,152
"064416610",356,371,727,219,252,210
"063578205",493,455,948,266,351,265
"063578210",92,95,187,72,134,71
"063640115",249,304,553,196,255,189
"063640118",278,307,585,202,257,201
"063640201",293,310,603,176,255,153
"063640209",427,413,840,233,190,165
"063640302",474,464,938,260,295,249
"063640307",795,877,1672,448,483,440
"063640316",0,0,0,0,317,0
"063640402",668,676,1344,345,170,124
"063640716",339,363,702,183,209,179
"063640717",327,321,648,159,199,153
"063640812",314,313,627,152,186,149
"063640813",481,457,938,259,326,251
"063640822",350,358,708,178,223,169
"063640823",536,521,1057,305,384,301
"063710110",981,870,1851,483,404,391
"063710111",40,33,73,21,27,20
"063710202",637,724,1361,393,388,366
"063710206",507,571,1078,333,290,275
"063710304",711,784,1495,501,418,398
"063710306",555,581,1136,349,315,291
"063710308",638,646,1284,400,382,365
"063710406",610,678,1288,428,429,376
"063710601",339,362,701,233,237,205
"063710705",513,572,1085,287,266,263
"063710707",873,926,1799,534,493,467
"063710812",499,536,1035,354,369,320
"063711105",254,318,572,280,380,278
"063711203",268,307,575,223,230,204
"063711207",402,433,835,322,329,278
"063711209",322,357,679,273,320,268
"063711301",466,544,1010,337,346,300
"063711303",599,618,1217,411,433,379
"063711304",461,531,992,349,407,341
"063711308",428,475,903,329,373,307
"063711402",400,453,853,288,318,277
"063711403",260,346,606,192,198,170
"063711410",452,451,903,252,213,206
"063711510",226,220,446,124,131,122
"063711601",503,482,985,212,159,153
"063711604",681,651,1332,336,297,293
"063711605",204,193,397,111,63,59
"063711608",516,553,1069,341,347,309
"063711613",519,581,1100,345,327,278
"063711614",436,454,890,265,244,229
"063711806",521,611,1132,370,368,342
"063711807",544,606,1150,372,369,323
"063711813",663,755,1418,434,381,341
"063711909",474,556,1030,394,480,374
"063712008",301,350,651,225,237,218
"063712102",570,505,1075,368,444,355
"063712401",520,593,1113,371,384,349
"063712708",307,329,636,215,252,210
"063712801",338,325,663,172,166,163
"063712806",477,536,1013,284,272,238
"063712909",452,485,937,355,405,353
"063713002",591,649,1240,394,413,373
"063713011",412,458,870,310,351,298
"063713103",566,655,1221,398,397,358
"063713104",214,260,474,171,141,123
"063713213",598,604,1202,372,383,347
"063713308",360,427,787,257,231,217
"063713401",365,408,773,251,272,241
"063713403",210,239,449,160,157,133
"063713409",335,370,705,247,261,213
"063713504",374,400,774,235,223,206
"063713512",539,595,1134,292,277,265
"063713603",844,787,1631,402,290,261
"063713608",502,549,1051,347,396,333
"063713706",398,423,821,207,182,174
"063713709",871,887,1758,501,465,441
"063713711",896,880,1776,410,379,360
"063713713",774,821,1595,447,383,360
"063713714",631,691,1322,377,368,350
"063713715",680,698,1378,411,357,340
"063850711",260,312,572,209,248,208
"063920102",667,640,1307,439,489,432
"063920104",237,297,534,209,258,208
"064343906",351,421,772,281,355,278
"063920705",155,155,310,111,125,107
"063921203",532,505,1037,300,343,296
"064080106",290,324,614,217,239,212
"063990706",265,296,561,222,262,220
"064060202",383,458,841,321,364,303
"064060204",546,572,1118,348,375,330
"064080110",364,371,735,239,247,235
"064080205",326,375,701,243,256,230
"064080301",201,198,399,105,105,97
"064080308",1124,1176,2300,621,633,601
"064080412",611,622,1233,359,317,297
"064080511",410,427,837,271,285,260
"064080707",133,140,273,94,110,94
"064080806",509,516,1025,310,324,292
"064080814",749,770,1519,452,461,433
"064080901",537,595,1132,392,426,365
"064080908",554,614,1168,374,346,314
"064081101",445,509,954,274,276,258
"064200910",63,70,133,48,342,47
"064081103",418,517,935,342,370,342
"064081104",524,556,1080,337,357,323
"064081111",126,129,255,74,83,74
"064081204",642,682,1324,352,343,317
"064081205",824,867,1691,488,496,447
"064081209",469,498,967,297,325,281
"064081307",574,623,1197,359,353,337
"064081313",381,411,792,226,241,205
"064081405",286,305,591,190,182,167
"064081408",358,409,767,235,260,230
"064081507",439,467,906,274,284,266
"064081512",182,234,416,140,166,132
"064081513",473,535,1008,347,337,291
"064100101",661,735,1396,397,323,300
"064100113",327,316,643,183,263,180
"064100201",460,466,926,289,328,276
"064100207",370,416,786,242,252,236
"064100208",703,750,1453,438,429,395
"064100310",551,561,1112,301,315,286
"064100403",607,669,1276,407,426,394
"064100405",385,400,785,233,253,232
"064100407",397,427,824,251,244,220
"064100408",448,479,927,291,297,265
"064100501",396,440,836,251,250,232
"064100504",426,422,848,249,230,217
"064100505",545,530,1075,289,282,268
"064100512",609,585,1194,319,299,275
"064100514",485,553,1038,281,217,211
"064100604",497,554,1051,358,369,336
"064100609",390,436,826,286,313,279
"064100707",762,738,1500,464,480,446
"064100708",493,515,1008,303,301,277
"064100714",524,554,1078,306,282,270
"064100809",694,765,1459,464,496,434
"065050312",310,357,667,243,275,239
"064100908",391,439,830,282,359,279
"064101206",393,416,809,286,303,276
"064101211",409,480,889,293,314,280
"064101309",421,439,860,271,264,248
"064120104",322,290,612,164,169,157
"064120116",915,892,1807,466,452,433
"064120306",463,499,962,332,383,321
"064120209",691,747,1438,416,368,339
"064120313",314,342,656,208,244,207
"064120411",643,666,1309,364,334,321
"064120504",380,394,774,242,240,217
"064120707",413,445,858,224,216,206
"064120715",492,491,983,257,236,221
"064120801",808,790,1598,464,453,407
"064120808",487,491,978,258,234,222
"064120812",537,559,1096,284,272,260
"064120815",541,570,1111,291,251,240
"064120901",473,449,922,218,235,211
"064120907",280,247,527,137,196,135
"064120908",752,742,1494,366,382,351
"064120913",495,500,995,240,240,226
"064120914",842,876,1718,426,436,399
"064120915",759,730,1489,372,382,352
"064120917",461,403,864,226,152,114
"064121002",691,730,1421,374,356,338
"065151109",601,669,1270,377,356,326
"064121102",606,627,1233,323,337,308
"064121114",484,456,940,252,244,233
"064121120",976,988,1964,503,448,424
"064121201",600,626,1226,322,320,293
"065151312",683,686,1369,363,337,329
"064121410",652,651,1303,345,350,331
"064121507",560,572,1132,297,305,287
"064121511",671,714,1385,376,373,357
"064121512",900,936,1836,462,471,440
"064130110",430,508,938,344,401,337
"064130205",597,579,1176,329,274,261
"064130302",278,358,636,256,374,246
"064130303",252,412,664,313,419,311
"064130307",501,564,1065,363,401,353
"064130309",511,529,1040,314,311,285
"064130405",350,403,753,288,362,284
"064130410",226,267,493,193,235,191
"064130411",451,513,964,351,353,320
"064130503",381,441,822,329,392,325
"064130610",375,418,793,239,246,222
"064131304",478,524,1002,286,379,276
"064131306",55,60,115,35,40,34
"064131307",596,612,1208,358,365,342
"064131409",214,252,466,129,142,127
"065180506",109,96,205,67,86,67
"064131905",88,82,170,44,68,44
"064132103",275,317,592,228,261,224
"064132106",252,301,553,210,230,203
"064132208",168,199,367,110,109,82
"064200104",400,418,818,222,395,214
"064200110",301,311,612,181,346,180
"064200212",180,187,367,113,325,111
"064200214",122,125,247,96,241,91
"064200307",135,144,279,97,238,94
"064200309",155,156,311,86,180,84
"064200316",48,44,92,35,339,34
"064200413",87,82,169,61,313,60
"064200502",40,51,91,37,292,37
"064200505",196,214,410,140,314,136
"064200506",298,318,616,228,489,226
"064200702",34,31,65,30,377,30
"064200802",431,430,861,262,407,255
"064200804",173,175,348,120,283,119
"064201107",83,85,168,57,387,57
"064201111",102,99,201,74,482,74
"064201113",124,121,245,80,304,78
"064201117",222,225,447,135,290,130
"064201210",27,14,41,19,229,19
"064201304",21,19,40,16,253,16
"064201307",119,132,251,86,502,85
"064201405",41,56,97,38,388,37
"064201510",265,271,536,164,252,163
"064201608",33,31,64,25,286,25
"064201703",24,30,54,25,563,25
"064201802",17,18,35,15,223,15
"064201807",22,25,47,23,280,23
"064201905",255,234,489,158,451,156
"064201906",267,272,539,178,472,168
"064201909",72,71,143,61,273,61
"064201912",58,71,129,54,405,54
"064202005",52,64,116,44,299,43
"064202012",59,69,128,58,500,57
"064202108",490,573,1063,310,414,296
"064202112",487,461,948,279,342,254
"064202212",75,62,137,55,354,55
"064270101",178,236,414,220,299,217
"064270111",407,490,897,336,389,330
"064270206",181,193,374,176,246,175
"064270209",296,357,653,307,382,303
"064270213",230,297,527,238,306,233
"064270217",299,327,626,246,334,231
"064270401",455,486,941,301,302,262
"064270508",323,376,699,257,264,230
"064270602",802,873,1675,510,485,445
"064270703",494,515,1009,334,386,317
"064270710",845,927,1772,509,464,401
"065390903",591,621,1212,316,269,258
"064271003",409,428,837,258,231,203
"064271004",675,733,1408,421,466,413
"064271009",777,814,1591,476,458,424
"064271103",759,761,1520,472,431,389
"064271104",506,579,1085,366,378,335
"064271111",357,465,822,267,289,265
"064271201",710,741,1451,464,501,435
"064271205",593,642,1235,371,379,338
"064271206",630,662,1292,436,438,391
"064271208",312,342,654,217,226,196
"064271304",931,992,1923,510,511,494
"064271305",913,967,1880,525,563,492
"064271308",492,505,997,282,348,282
"064271310",637,698,1335,401,469,395
"064271405",832,848,1680,399,227,222
"064271406",240,276,516,146,119,111
"064271413",1242,1292,2534,797,867,772
"064271601",631,673,1304,429,458,390
"064271603",632,705,1337,406,396,338
"064271606",699,715,1414,372,304,287
"064271702",408,464,872,327,349,296
"064271909",656,716,1372,399,425,386
"064272003",429,475,904,274,309,271
"064272006",545,568,1113,330,351,312
"064272010",508,533,1041,298,324,293
"064272011",658,744,1402,459,459,434
"064272015",624,672,1296,330,280,256
"064272105",500,541,1041,315,304,284
"064272203",689,735,1424,438,376,340
"064272204",659,679,1338,405,362,312
"064272302",531,628,1159,358,391,348
"064272501",334,359,693,236,252,225
"064272506",445,503,948,303,300,275
"064272507",270,307,577,214,221,201
"064272510",1939,1988,3927,964,694,673
"064272513",257,286,543,184,204,169
"064272603",645,727,1372,436,441,408
"064272608",521,613,1134,409,425,384
"064272701",834,919,1753,582,561,526
"064272709",660,735,1395,459,453,399
"064272901",541,624,1165,396,449,365
"064272905",448,505,953,368,473,368
"064272906",440,504,944,326,364,313
"064272911",649,694,1343,412,456,392
"065392804",789,828,1617,396,392,369
"064273006",375,497,872,339,536,308
"064273007",390,468,858,354,457,326
"064273103",489,583,1072,332,365,323
"064273108",210,255,465,172,203,171
"064273309",357,408,765,262,262,235
"064273404",451,502,953,331,364,319
"064273405",475,557,1032,343,375,333
"064273407",513,624,1137,357,374,344
"064273409",583,642,1225,420,475,408
"064273507",334,390,724,278,292,255
"064273510",350,394,744,250,290,237
"064273610",411,463,874,309,394,296
"064273611",446,491,937,355,439,349
"064273709",732,773,1505,456,444,398
"064273803",1094,1205,2299,578,538,519
"064273805",548,567,1115,305,284,255
"064273906",482,523,1005,293,274,246
"064273911",606,596,1202,343,263,215
"064274008",1229,1258,2487,596,514,484
"064274101",1117,1096,2213,603,481,454
"064274412",701,757,1458,447,438,383
"064274508",859,904,1763,510,534,498
"064274601",605,690,1295,386,419,375
"064274608",395,394,789,226,183,167
"064274703",376,405,781,143,45,41
"064274807",675,723,1398,419,408,375
"064274812",889,975,1864,538,520,478
"064274904",768,819,1587,390,320,305
"064275213",991,972,1963,472,354,342
"064275202",974,1032,2006,493,452,437
"064275208",778,791,1569,374,310,300
"064275305",1210,1199,2409,607,468,448
"064275403",638,685,1323,334,247,237
"064275411",638,629,1267,332,280,272
"064275412",807,844,1651,481,462,424
"064275510",837,815,1652,425,327,306
"064275511",868,944,1812,494,362,342
"064275703",523,572,1095,292,246,234
"064275709",371,359,730,212,201,183
"064275805",460,430,890,248,195,189
"064275905",928,1004,1932,504,422,396
"064275912",525,519,1044,296,263,251
"064275913",491,524,1015,298,293,283
"064276006",982,1189,2171,555,468,442
"064276009",893,1040,1933,472,384,371
"064276013",475,522,997,272,267,262
"064276213",706,780,1486,383,286,267
"064276301",850,961,1811,472,455,424
"064276302",234,247,481,104,67,61
"064276412",701,723,1424,369,286,272
"064276510",578,586,1164,279,229,215
"064276605",856,915,1771,484,386,375
"064276608",608,646,1254,335,302,265
"064276704",1828,1801,3629,840,656,618
"064276708",616,656,1272,342,264,245
"064276710",494,485,979,250,225,206
"064276711",585,612,1197,314,237,219
"064276716",636,706,1342,289,217,202
"064276807",505,497,1002,299,244,233
"064276808",564,566,1130,340,287,259
"064276909",912,994,1906,523,480,436
"064277011",529,519,1048,287,277,268
"065601304",560,591,1151,321,324,311
"064277102",708,776,1484,427,400,375
"064277104",455,455,910,240,191,175
"064277204",632,680,1312,350,291,262
"064277308",1002,987,1989,510,457,437
"064277316",701,639,1340,329,299,281
"064277407",845,838,1683,436,395,363
"064277502",1323,1328,2651,579,331,323
"064277510",971,910,1881,471,382,369
"064277705",577,615,1192,301,249,244
"064277708",534,559,1093,306,256,238
"064277714",546,535,1081,301,279,251
"064277715",480,524,1004,268,249,230
"064277901",1301,1285,2586,568,317,303
"064277911",931,943,1874,495,470,452
"064278008",892,876,1768,458,381,368
"064278016",645,622,1267,293,259,248
"064278108",77,67,144,35,23,20
"064278204",579,638,1217,312,286,278
"064278206",1051,1019,2070,433,57,54
"065601914",421,456,877,243,282,241
"064278209",1637,1654,3291,747,378,376
"065602002",741,732,1473,363,362,333
"064278310",729,707,1436,355,326,316
"064278311",629,657,1286,351,321,304
"064278404",796,824,1620,399,395,366
"064278405",973,929,1902,508,483,445
"064278408",813,838,1651,403,390,375
"064278613",696,784,1480,386,351,332
"064278704",705,712,1417,382,355,343
"064278708",872,824,1696,477,476,464
"064278713",590,595,1185,336,334,309
"064278902",1284,1252,2536,572,298,285
"064278907",1299,1172,2471,561,507,485
"064278914",1248,1190,2438,559,498,484
"064279009",1280,1336,2616,599,574,558
"064279011",549,547,1096,295,289,252
"064279106",503,552,1055,308,314,294
"064279108",706,673,1379,374,319,305
"064279208",1048,1046,2094,488,494,474
"065151709",154,152,306,117,152,113
"065151801",908,894,1802,488,458,439
"065151802",555,581,1136,333,286,267
"064279309",757,832,1589,451,455,420
"064279310",739,803,1542,445,462,429
"064279312",769,827,1596,415,404,379
"064279313",910,896,1806,453,426,411
"064279409",786,786,1572,426,419,390
"064279410",735,740,1475,380,381,344
"064279503",1032,1079,2111,485,456,431
"065681310",653,635,1288,347,351,324
"064279610",1124,1077,2201,498,509,444
"064279612",885,832,1717,391,375,333
"064279614",976,926,1902,437,376,349
"065151806",756,784,1540,351,345,334
"064279714",729,679,1408,377,402,361
"065151808",577,580,1157,309,287,277
"064279712",277,293,570,140,138,112
"065682218",175,182,357,129,199,128
"064279723",587,585,1172,289,274,258
"065682510",575,588,1163,326,304,290
"064340102",377,450,827,285,296,265
"064340109",334,377,711,256,318,249
"064340111",400,487,887,309,346,273
"064340309",709,776,1485,502,574,487
"065682807",387,423,810,243,226,211
"064340703",426,484,910,304,322,268
"064340805",456,482,938,287,306,283
"064340906",537,549,1086,282,261,257
"064340908",505,519,1024,271,242,232
"064341002",238,271,509,167,196,165
"064341202",525,607,1132,380,423,366
"064341302",302,346,648,219,253,217
"064341309",489,534,1023,360,375,339
"064341408",430,496,926,347,377,326
"064341501",193,247,440,180,252,180
"064341503",151,207,358,177,306,177
"064341504",277,328,605,218,270,213
"064341510",205,224,429,178,248,177
"064341511",167,222,389,173,280,173
"064341709",305,355,660,250,280,246
"064341804",296,313,609,219,267,210
"064341806",393,505,898,384,505,380
"064341808",284,329,613,261,295,255
"064341810",160,188,348,167,224,165
"064341813",369,429,798,302,360,301
"064341905",488,544,1032,354,408,349
"064342006",550,639,1189,406,412,389
"064342009",401,423,824,292,317,277
"064342112",446,513,959,313,314,279
"064342212",418,493,911,311,275,256
"064342303",653,692,1345,367,352,329
"064342310",457,467,924,257,244,236
"064342403",256,295,551,242,249,206
"064342503",244,296,540,179,179,161
"065810712",247,249,496,158,203,151
"064342509",336,381,717,225,213,193
"064343201",424,526,950,337,420,334
"064342606",256,258,514,128,114,110
"064342804",464,553,1017,308,294,276
"064342812",357,401,758,238,260,230
"064342901",512,524,1036,357,358,310
"064343108",203,234,437,183,239,183
"064343208",351,421,772,273,296,256
"064343307",440,514,954,326,368,319
"064343404",324,376,700,229,248,225
"064343414",595,595,1190,309,277,261
"064343501",495,585,1080,371,373,340
"064343504",686,799,1485,429,431,395
"064343512",335,299,634,164,101,90
"064343603",470,505,975,325,369,308
"064343606",472,575,1047,342,386,328
"064343708",316,345,661,235,283,232
"064343807",224,265,489,217,272,216
"064344006",314,340,654,221,229,206
"064344105",426,496,922,306,330,296
"064344305",347,407,754,244,258,221
"064344504",556,578,1134,320,254,246
"064410102",369,437,806,303,357,282
"064410104",339,373,712,258,284,247
"064410209",364,475,839,392,409,336
"064410107",307,299,606,244,268,212
"064410305",277,330,607,258,304,254
"064410308",277,304,581,239,218,197
"064410509",147,217,364,157,215,149
"064410603",165,231,396,227,307,209
"064410805",117,167,284,157,271,157
"064410808",179,251,430,231,325,226
"064410901",149,176,325,153,172,148
"064410902",253,346,599,293,390,283
"064410909",201,236,437,243,373,242
"064410911",187,218,405,210,329,208
"064411011",225,270,495,193,254,189
"064411113",287,435,722,323,440,315
"064411116",185,235,420,203,314,203
"064411209",128,172,300,163,261,158
"064411212",118,216,334,161,234,143
"064411308",177,226,403,200,307,196
"064411401",133,171,304,173,266,157
"064411402",108,183,291,155,213,137
"064411512",174,217,391,195,287,192
"064411603",232,242,474,214,264,209
"064411613",194,195,389,166,215,162
"064411705",374,441,815,314,388,302
"064411706",401,555,956,190,228,181
"064411708",254,290,544,245,316,240
"064411710",215,270,485,179,207,175
"064412004",154,216,370,166,232,166
"064412008",217,257,474,228,326,227
"064412012",121,180,301,131,209,128
"064412015",130,193,323,163,382,161
"064412016",125,158,283,151,442,146
"064412017",165,188,353,147,214,146
"065950413",491,561,1052,346,368,329
"064412107",214,255,469,199,262,193
"064412206",277,303,580,233,308,230
"064412303",230,335,565,234,291,230
"064412401",211,248,459,204,269,202
"064412410",206,220,426,187,264,186
"064412505",350,430,780,331,430,323
"064412604",200,215,415,165,209,159
"064412605",219,251,470,196,226,172
"064412609",249,266,515,203,260,197
"064412610",491,541,1032,400,448,389
"064412705",484,551,1035,384,448,364
"064412802",390,416,806,307,370,300
"064412901",251,262,513,212,257,203
"064412902",239,303,542,210,238,208
"064412903",286,337,623,241,285,236
"064412910",257,271,528,202,232,195
"064413002",571,595,1166,360,401,338
"064413008",322,354,676,225,240,211
"065952403",315,382,697,289,350,287
"064413104",227,262,489,177,177,162
"064413110",264,344,608,218,243,212
"064413115",301,381,682,238,254,226
"064413205",535,626,1161,390,439,376
"064413208",455,534,989,319,328,298
"064413303",364,421,785,277,312,265
"064413402",355,420,775,252,283,239
"064413404",377,417,794,258,270,242
"064413413",553,532,1085,301,312,289
"064413504",249,307,556,201,213,196
"064413511",614,701,1315,430,431,421
"064413601",410,405,815,289,299,279
"064413605",509,567,1076,358,381,343
"064413606",717,691,1408,340,364,332
"064413612",580,601,1181,325,342,313
"064413705",691,669,1360,337,356,325
"064413708",486,492,978,297,308,279
"064413713",449,476,925,255,301,243
"064413805",448,492,940,288,301,272
"064413807",546,584,1130,349,343,314
"064413902",294,329,623,232,262,226
"064414006",516,542,1058,348,379,338
"064414007",483,504,987,293,287,274
"064414008",471,469,940,265,273,251
"064414209",511,530,1041,283,313,273
"064414213",243,264,507,137,131,128
"064414214",265,256,521,131,135,97
"064414301",404,433,837,265,298,250
"064414315",858,816,1674,461,525,434
"064414401",416,475,891,283,300,275
"064414606",324,353,677,232,261,211
"064414701",849,938,1787,520,342,281
"064414704",698,732,1430,456,499,441
"064414901",424,483,907,314,342,304
"064415008",282,336,618,235,260,226
"064415106",335,317,652,178,169,166
"064415110",203,260,463,171,186,163
"064415201",616,595,1211,296,312,271
"064415210",299,364,663,252,301,245
"064415806",268,274,542,197,221,191
"064415410",435,501,936,293,336,283
"064415412",498,512,1010,308,340,301
"064415501",866,940,1806,487,483,436
"064415509",435,404,839,246,275,220
"064415602",574,601,1175,369,432,366
"064415604",364,407,771,265,312,260
"064415708",407,437,844,289,284,235
"064415709",437,451,888,245,270,242
"064415713",361,437,798,244,269,230
"064415904",389,446,835,282,304,280
"064416105",416,450,866,288,321,281
"064416108",175,180,355,95,108,88
"064416303",425,442,867,274,366,268
"064416304",513,505,1018,293,358,284
"064416403",332,272,604,137,159,133
"064416504",70,70,140,40,62,38
"064416508",70,86,156,45,86,43
"064416802",748,808,1556,446,502,428
"064416910",343,363,706,232,272,230
"064417006",585,549,1134,298,325,287
"066380710",629,605,1234,341,346,309
"064480608",578,635,1213,385,441,371
"066380804",252,243,495,160,370,159
"064550111",223,224,447,143,170,140
"066381302",563,535,1098,303,304,282
"064620701",465,480,945,319,342,305
"064690204",489,601,1090,394,445,384
"064690211",414,401,815,262,290,252
"064691001",165,178,343,125,149,123
"064691307",401,411,812,259,304,256
"064760102",402,453,855,292,300,276
"064760201",552,574,1126,407,485,406
"066440101",84,102,186,65,286,64
"066440203",57,56,113,48,307,48
"064760707",246,228,474,133,166,129
"066440402",101,106,207,68,392,64
"064761101",18,14,32,10,14,10
"064761201",5,7,12,3,17,3
"064761403",436,496,932,322,345,305
"064830107",222,317,539,215,333,214
"064830110",399,441,840,306,341,291
"064830402",247,267,514,180,204,176
"064830416",370,401,771,228,251,216
"064900203",696,697,1393,356,252,247
"064900107",402,386,788,229,256,223
"064900210",698,689,1387,368,356,334
"064900304",231,239,470,134,116,115
"064900406",677,666,1343,348,298,268
"064900410",580,545,1125,301,256,236
"064900411",776,763,1539,441,347,313
"064900414",846,888,1734,494,476,432
"064900503",407,448,855,286,251,231
"064900509",447,472,919,259,243,223
"064900510",762,834,1596,458,339,314
"064900615",468,538,1006,308,331,304
"064900713",410,366,776,247,230,218
"064901001",322,370,692,233,244,221
"064901005",550,662,1212,354,436,351
"064901009",384,441,825,263,251,236
"064901011",505,574,1079,396,404,364
"064901102",370,421,791,287,326,276
"064901107",153,213,366,185,242,164
"064901112",234,264,498,239,357,229
"064901206",425,531,956,354,431,346
"064901207",411,497,908,329,361,325
"064901401",500,521,1021,312,279,254
"064901404",396,400,796,242,254,240
"064901408",380,417,797,253,220,207
"064901502",525,530,1055,296,294,277
"064901703",515,515,1030,254,202,193
"064901704",664,656,1320,385,341,319
"064901709",482,516,998,297,297,262
"066580414",296,350,646,198,445,198
"064902003",495,586,1081,336,357,330
"064902004",303,331,634,215,242,209
"064902105",411,468,879,337,389,331
"066580704",379,448,827,302,373,300
"064902201",345,412,757,265,330,263
"064902210",308,432,740,378,575,364
"064902301",383,444,827,286,306,273
"064902302",292,340,632,240,288,236
"064902408",151,196,347,183,292,165
"064902602",361,384,745,265,293,258
"064902702",643,685,1328,421,429,397
"064902710",646,771,1417,492,488,440
"064902806",568,628,1196,413,459,410
"064902811",388,452,840,313,315,290
"064902903",560,578,1138,304,261,249
"064903004",471,508,979,276,288,271
"064903103",737,766,1503,413,405,389
"064903108",773,795,1568,401,339,317
"064903110",443,477,920,275,264,249
"064903204",610,602,1212,301,280,260
"064903207",621,632,1253,338,281,269
"064903301",421,404,825,239,211,191
"064903302",562,563,1125,283,247,234
"064903303",799,793,1592,441,371,345
"064903413",736,761,1497,359,332,326
"064903501",464,434,898,259,285,224
"064903502",471,445,916,270,252,237
"064903511",494,523,1017,271,227,216
"064903515",449,442,891,243,220,215
"064903707",506,485,991,251,161,151
"066582208",323,351,674,223,227,211
"064903902",368,373,741,188,181,170
"064903910",489,561,1050,240,228,212
"064903913",454,429,883,203,155,153
"064904204",430,495,925,325,360,300
"064904206",460,505,965,331,315,280
"064904301",23,15,38,15,12,12
"064904302",313,333,646,245,276,236
"064904609",386,452,838,288,323,271
"064904702",403,447,850,309,341,294
"064904712",360,432,792,278,310,262
"064904802",392,415,807,271,343,268
"065391206",555,558,1113,334,349,323
"065391211",537,534,1071,300,312,293
"065391214",609,638,1247,345,312,290
"065391303",509,534,1043,281,290,270
"065391305",536,522,1058,298,273,264
"065391306",624,632,1256,317,322,313
"065391401",442,525,967,351,396,340
"065391403",371,453,824,305,347,298
"061120308",17,14,31,9,20,8
"061610603",5,6,11,6,12,6
"061680404",3,1,4,3,7,3
"060070109",13,7,20,8,15,8
"060070112",4,10,14,7,10,6
"060070301",8,5,13,5,17,5
"065391511",425,511,936,289,303,277
"060070512",9,6,15,5,17,5
"060070515",17,14,31,11,15,11
"060070605",13,8,21,9,15,9
"060070608",8,5,13,6,9,6
"060070615",15,7,22,8,10,8
"065391603",254,304,558,204,212,181
"060071006",15,14,29,13,27,13
"060071101",25,13,38,11,19,11
"060210401",17,16,33,12,35,12
"062170701",12,10,22,8,13,7
"060420201",90,63,153,55,88,47
"060421701",62,49,111,36,39,36
"060491102",60,41,101,42,75,42
"060491301",56,33,89,38,82,38
"060491401",27,19,46,18,41,18
"060563201",28,17,45,23,65,23
"062310606",41,27,68,23,45,23
"060563007",43,37,80,27,55,27
"060630305",57,31,88,32,41,26
"060630602",40,20,60,22,39,22
"060630804",40,38,78,27,59,27
"060630903",24,15,39,17,41,17
"060631002",173,180,353,122,149,121
"060631003",62,29,91,43,104,42
"060700402",29,18,47,19,43,19
"060700903",18,16,34,13,30,13
"065391717",312,353,665,237,262,216
"060770506",46,36,82,30,33,30
"060770801",18,12,30,14,32,14
"060770901",19,12,31,12,31,12
"060770903",23,20,43,13,18,13
"060770905",13,13,26,11,18,11
"060771102",16,10,26,8,8,7
"060840907",52,38,90,30,47,30
"062800508",49,19,68,19,22,13
"062800811",11,7,18,8,12,8
"062940101",13,4,17,9,30,9
"065391902",563,649,1212,350,340,334
"061050501",54,45,99,40,86,40
"061120302",17,10,27,9,12,7
"061120303",16,18,34,7,16,7
"061120602",12,9,21,9,15,9
"061120603",26,17,43,14,36,14
"061120605",16,14,30,10,17,10
"061120802",41,19,60,25,32,19
"061120805",27,15,42,13,17,13
"061121001",69,55,124,46,73,45
"061121303",36,22,58,24,73,23
"063220201",28,19,47,16,18,16
"061121304",19,13,32,13,40,12
"061190101",45,51,96,27,47,25
"061190402",17,18,35,12,25,12
"061190601",27,15,42,19,33,19
"061190703",35,24,59,23,42,23
"061190805",19,18,37,15,21,15
"061190806",36,32,68,20,28,20
"061260406",23,18,41,15,32,14
"065392002",110,135,245,12,16,12
"061400202",17,15,32,15,36,15
"061470204",22,12,34,9,16,8
"061470704",28,15,43,16,34,16
"061470710",11,4,15,7,11,6
"061470907",31,36,67,22,56,22
"061471002",47,41,88,23,49,23
"061471003",21,20,41,15,57,15
"061540203",32,24,56,23,25,23
"061540805",37,27,64,22,28,21
"061610202",14,11,25,11,15,11
"061610203",7,10,17,7,16,7
"061610605",44,34,78,24,33,23
"065392012",763,841,1604,439,424,400
"061750104",15,10,25,7,13,7
"061750502",51,48,99,31,55,28
"061890205",1,1,2,1,5,1
"061890502",6,1,7,4,14,4
"061890802",18,12,30,9,19,9
"061891102",14,15,29,10,30,10
"061891105",19,14,33,15,12,10
"061891506",3,4,7,2,14,2
"061960401",28,15,43,19,30,19
"061960602",21,1,22,3,12,3
"065392106",393,426,819,267,283,256
"061961001",15,11,26,9,14,9
"065392202",850,917,1767,525,503,477
"063640503",18,15,33,15,23,15
"062030602",9,4,13,8,14,8
"062030205",24,16,40,18,29,18
"062030302",16,17,33,13,22,13
"062030604",22,17,39,12,16,12
"062030709",2,2,4,2,9,2
"062030710",14,8,22,9,14,9
"065392305",768,787,1555,428,415,390
"065392306",678,730,1408,382,397,365
"062030811",135,110,245,94,190,93
"062030812",261,254,515,167,205,159
"065392310",604,650,1254,338,314,291
"065392311",689,670,1359,353,350,331
"062031003",15,8,23,12,23,12
"062031201",9,8,17,7,27,7
"062031306",16,10,26,9,18,9
"062031407",3,3,6,3,4,3
"062031408",0,0,0,0,55,0
"062100701",105,93,198,64,106,62
"062170508",25,23,48,19,37,19
"062170802",32,29,61,21,38,21
"063850204",15,5,20,11,28,11
"065392414",855,838,1693,422,396,381
"065392505",492,536,1028,287,283,255
"065392506",517,494,1011,280,273,266
"062171105",64,56,120,37,67,35
"065392605",665,689,1354,371,358,332
"062171106",22,13,35,13,27,13
"062240502",15,15,30,8,15,8
"062240503",36,31,67,25,54,25
"062241002",28,23,51,21,72,21
"062241501",10,10,20,8,15,8
"062241801",15,17,32,10,19,10
"062241904",27,32,59,18,36,18
"062242008",12,9,21,11,22,11
"062310701",17,23,40,14,20,14
"062310805",12,9,21,6,21,6
"062311101",1,5,6,2,6,2
"062380801",29,31,60,22,45,22
"065392611",536,517,1053,307,316,281
"062660203",36,31,67,26,46,26
"062770101",6,1,7,4,12,4
"062800501",16,1,17,7,15,7
"062800503",13,5,18,7,11,7
"062800701",19,12,31,10,16,10
"062800703",30,31,61,21,35,21
"062800802",8,6,14,4,10,4
"062800805",4,4,8,3,14,3
"062800815",21,20,41,14,22,14
"062870301",12,8,20,9,19,8
"062870402",11,17,28,9,22,9
"062870501",47,24,71,27,43,27
"062940206",14,14,28,8,35,8
"062940302",8,3,11,5,8,5
"062940303",7,6,13,7,22,7
"065392705",578,606,1184,317,310,288
"063010502",119,86,205,55,94,55
"063010503",48,45,93,29,43,29
"065392708",705,773,1478,391,371,370
"063150502",200,142,342,122,178,122
"063220306",19,20,39,11,14,11
"063221008",22,14,36,16,30,16
"063221203",7,5,12,7,10,7
"065392904",152,132,284,72,86,70
"063290102",62,54,116,36,53,35
"063290301",63,62,125,33,47,32
"063290601",46,40,86,25,43,25
"065392806",876,921,1797,456,423,402
"063430102",40,38,78,28,46,26
"065392809",566,552,1118,318,307,290
"063430302",23,26,49,16,35,15
"063510101",25,17,42,12,18,12
"063510610",3,2,5,4,15,4
"065392811",743,757,1500,399,415,382
"063578101",178,134,312,95,118,95
"064691005",6,7,13,3,24,3
"064830505",78,52,130,42,68,41
"063850102",20,12,32,14,36,14
"063850203",29,19,48,20,39,20
"063850902",47,20,67,25,29,25
"063920304",14,10,24,6,17,6
"063920703",96,78,174,58,87,57
"063921005",81,56,137,46,73,46
"063921103",4,3,7,2,8,2
"063921403",2,2,4,2,7,2
"063990201",15,14,29,11,29,11
"064060101",5,5,10,3,7,3
"064060106",17,13,30,8,15,8
"064060208",46,22,68,23,28,22
"064131103",NA,NA,NA,NA,NA,NA
"064131102",NA,NA,NA,NA,NA,NA
"064131503",34,27,61,22,35,21
"064131504",4,2,6,2,10,2
"064131603",NA,NA,NA,NA,NA,NA
"065392906",260,270,530,143,145,135
"064132002",NA,NA,NA,NA,NA,NA
"065811102",11,7,18,8,13,7
"065952106",1,1,2,1,2,1
"066090502",64,48,112,29,41,29
"064416408",86,63,149,48,36,34
"064416511",634,558,1192,326,354,299
"064480901",8,8,16,5,6,5
"064481204",7,8,15,4,11,4
"064550401",125,100,225,80,154,80
"064550501",39,28,67,27,42,27
"064550601",87,89,176,61,89,58
"064551201",92,92,184,62,123,62
"064620502",24,11,35,12,24,11
"064620603",31,20,51,18,36,18
"064621206",25,13,38,13,22,13
"064690302",23,19,42,12,13,12
"064690701",20,9,29,10,12,10
"064690805",42,28,70,23,38,23
"064690806",71,42,113,32,42,32
"064691003",48,36,84,26,48,26
"064691404",26,18,44,12,31,12
"064760301",48,37,85,29,51,29
"064760402",8,1,9,8,20,8
"064760802",22,16,38,17,25,16
"064830203",48,29,77,22,29,20
"064830903",142,88,230,74,120,73
"064970203",68,55,123,41,73,41
"064971209",69,66,135,45,64,45
"066720101",17,12,29,10,19,10
"066720301",7,3,10,3,8,3
"066720401",23,11,34,14,25,14
"066720702",39,22,61,29,46,28
"065110101",32,19,51,18,23,18
"065110201",29,20,49,17,30,16
"065110303",28,31,59,22,39,22
"065180303",98,70,168,67,113,66
"065180401",19,16,35,13,20,12
"065180407",14,9,23,6,12,6
"067210212",19,12,31,14,45,12
"067281025",96,86,182,42,47,38
"065320801",34,29,63,22,39,22
"065320804",42,38,80,35,46,34
"065320902",377,337,714,215,312,210
"065470101",51,46,97,35,74,33
"065470301",50,47,97,32,47,32
"065470402",83,79,162,58,100,56
"065470603",134,108,242,80,156,80
"067701606",13,7,20,8,14,8
"067701901",4,1,5,4,8,4
"067701902",5,2,7,3,7,3
"065740201",26,11,37,14,27,14
"065740804",41,29,70,23,48,23
"065740902",45,41,86,25,45,25
"065600912",169,162,331,99,101,79
"065601010",726,731,1457,403,401,383
"065601104",469,460,929,244,254,233
"065393001",817,855,1672,451,479,444
"065810503",99,133,232,123,455,122
"065810912",15,5,20,9,15,9
"065393006",555,486,1041,261,226,204
"065601112",692,681,1373,374,388,333
"065880601",85,61,146,59,125,58
"065880701",61,47,108,49,79,42
"065881003",22,13,35,17,24,15
"068190102",46,32,78,29,54,29
"065881607",0,0,0,0,1,0
"065951101",65,42,107,45,74,42
"065951501",71,60,131,50,89,50
"065951604",176,147,323,90,114,89
"065952002",18,16,34,13,20,12
"065393008",465,464,929,232,247,224
"065393009",651,655,1306,370,395,360
"066020202",84,79,163,52,79,51
"066020306",48,25,73,32,68,31
"066020601",18,2,20,12,44,11
"065393012",571,550,1121,299,290,262
"066020902",32,14,46,28,89,27
"066021002",7,4,11,6,16,6
"068331601",23,15,38,14,21,10
"065393101",689,696,1385,375,377,334
"065393102",821,763,1584,395,417,385
"065393106",823,800,1623,429,431,400
"066090503",69,40,109,37,56,35
"066090606",41,42,83,25,54,24
"066091306",33,29,62,24,49,24
"066091601",14,6,20,7,23,7
"066091603",27,18,45,16,37,16
"066231001",9,7,16,7,19,7
"066231404",93,99,192,65,77,64
"066231701",36,23,59,19,39,19
"066232401",29,21,50,20,33,19
"066232502",28,21,49,17,30,17
"066232503",16,13,29,11,21,11
"068541302",55,37,92,38,97,38
"068751001",44,17,61,27,70,27
"066480408",9,7,16,7,11,7
"066510303",9,6,15,6,21,6
"066510609",12,9,21,7,7,7
"066510713",22,10,32,11,25,11
"066510817",15,12,27,15,19,15
"065393114",464,476,940,241,223,203
"066511004",6,5,11,4,15,4
"066511307",19,15,34,18,35,18
"066550102",24,23,47,17,35,17
"067600507",553,567,1120,387,434,354
"066651201",0,0,0,0,4,0
"065393117",657,660,1317,379,401,367
"066720202",23,23,46,15,22,15
"066720303",16,10,26,12,21,11
"066720403",64,54,118,40,82,39
"066720501",18,8,26,14,19,14
"066720504",13,7,20,6,9,6
"067841104",5,6,11,3,10,3
"066790404",15,10,25,8,12,8
"066790502",45,40,85,26,34,26
"066790802",49,39,88,31,38,31
"066790902",52,37,89,30,36,30
"066791003",43,28,71,22,37,22
"066791101",32,30,62,18,32,18
"066791103",24,22,46,17,31,16
"066860301",26,19,45,14,35,14
"066860606",19,18,37,18,35,18
"066860703",20,16,36,15,22,15
"065393208",767,747,1514,363,341,313
"066860802",10,6,16,5,14,5
"066860804",11,9,20,8,46,8
"066860902",9,6,15,7,23,6
"066930203",23,24,47,16,34,16
"066930501",24,18,42,16,30,16
"065393303",574,566,1140,295,298,269
"067000202",19,12,31,11,23,10
"067000505",25,19,44,19,32,19
"067000704",13,6,19,8,13,7
"067000705",22,22,44,15,36,14
"067000706",12,8,20,9,18,8
"067000802",7,7,14,6,14,6
"067000803",5,3,8,4,21,4
"067000901",8,6,14,6,15,6
"067070803",69,47,116,47,87,45
"067070901",90,79,169,57,98,56
"067140404",15,6,21,11,22,9
"067140808",19,9,28,14,22,14
"067140505",42,29,71,29,45,29
"067210104",49,37,86,32,52,32
"067280503",17,17,34,15,27,15
"067280301",20,22,42,14,19,14
"067280801",62,52,114,38,63,38
"067281202",34,22,56,21,35,21
"067281406",95,76,171,54,82,54
"067281602",11,10,21,9,13,8
"067350304",24,23,47,16,25,16
"065393310",642,578,1220,301,309,274
"067350401",20,29,49,12,19,12
"067420101",28,26,54,19,19,19
"067420301",40,37,77,27,73,27
"065530311",28,20,48,18,378,18
"067700504",7,4,11,4,7,4
"067631001",26,22,48,17,27,17
"067631002",6,5,11,3,11,3
"067631402",17,11,28,12,32,11
"067631902",15,12,27,7,11,7
"067632101",14,2,16,10,28,10
"067700401",17,12,29,8,22,8
"067700402",10,15,25,4,3,3
"067700902",39,30,69,20,21,17
"067701302",27,18,45,14,27,14
"067701403",8,5,13,4,13,4
"067780901",17,15,32,9,20,9
"067840203",28,21,49,16,29,16
"067840402",23,15,38,13,25,13
"067840801",31,33,64,24,35,24
"067841102",12,8,20,8,14,8
"067841204",18,15,33,6,10,6
"067910503",10,1,11,8,16,8
"067911009",55,36,91,29,46,29
"067911402",70,36,106,47,56,37
"067980503",9,7,16,8,12,8
"067981005",25,21,46,15,31,15
"065470903",591,584,1175,315,332,295
"067601511",555,529,1084,260,207,202
"065530306",120,105,225,82,391,78
"065530308",53,53,106,37,292,37
"065600103",750,756,1506,393,360,342
"065600105",1052,957,2009,488,472,439
"065600904",276,261,537,133,135,122
"065601116",401,370,771,238,300,219
"065600214",724,734,1458,372,416,356
"065601205",571,604,1175,338,339,322
"065600307",1020,983,2003,496,470,448
"065600308",770,698,1468,412,500,401
"065600313",330,365,695,225,244,217
"065600315",723,703,1426,358,369,338
"065600907",264,250,514,108,110,108
"065600419",773,771,1544,403,384,360
"065600501",362,385,747,216,216,205
"065600505",161,164,325,87,89,82
"065600507",624,644,1268,356,354,339
"065600509",138,160,298,79,78,76
"065600514",654,671,1325,349,348,326
"065601216",375,388,763,241,283,240
"065600612",741,724,1465,385,335,335
"065600613",430,455,885,234,199,192
"065601302",746,756,1502,386,299,291
"065600701",435,411,846,244,257,234
"065180609",86,78,164,62,167,61
"065180611",75,72,147,52,178,51
"065810409",281,350,631,240,332,225
"065180714",171,177,348,115,235,114
"065600704",476,511,987,304,298,258
"065681111",320,401,721,259,287,252
"065600707",445,440,885,245,232,207
"065600905",221,210,431,103,103,88
"065601309",516,592,1108,313,327,303
"065250111",638,677,1315,399,449,382
"065250401",746,774,1520,413,441,393
"065250417",813,876,1689,437,464,423
"065250602",229,211,440,116,142,110
"065250603",275,274,549,147,164,138
"065250604",307,293,600,190,214,185
"065250613",483,515,998,303,343,299
"065320201",210,279,489,235,376,233
"065320312",422,347,769,230,249,217
"065321512",644,690,1334,431,476,422
"065321406",271,366,637,276,384,273
"065321504",501,522,1023,304,325,296
"065321506",591,622,1213,341,347,319
"065390102",568,633,1201,361,360,337
"065390203",476,530,1006,277,280,262
"065390214",329,355,684,227,246,218
"065390302",445,530,975,311,354,311
"065390402",613,732,1345,478,490,446
"065390409",599,691,1290,437,462,422
"065390503",648,663,1311,443,454,427
"068052605",73,54,127,52,278,51
"065390812",1507,1541,3048,819,749,711
"065390906",896,865,1761,462,400,386
"065390910",800,752,1552,388,393,376
"065391002",757,763,1520,381,351,336
"065391006",454,470,924,267,254,242
"065391010",909,941,1850,494,462,430
"065391017",223,228,451,112,161,98
"065391103",521,528,1049,301,292,273
"065810305",219,314,533,215,258,189
"067911813",432,462,894,304,333,297
"068400406",414,458,872,262,253,234
"068821701",644,635,1279,353,351,326
"061051406",475,475,950,271,331,268
"067420410",163,145,308,104,120,103
"062100802",409,406,815,265,291,255
"061121108",547,590,1137,336,360,316
"061121204",5,3,8,4,18,4
"061340101",557,500,1057,288,322,280
"061340108",124,104,228,63,103,58
"061470602",206,215,421,125,138,123
"061470603",44,20,64,20,33,20
"061470708",46,31,77,26,47,25
"061540105",36,29,65,21,33,21
"061540610",221,225,446,120,196,56
"061610601",169,170,339,111,124,111
"061610606",41,38,79,28,37,28
"061680501",73,70,143,47,73,45
"062100805",977,930,1907,534,633,516
"062311001",651,665,1316,361,417,358
"062310104",129,141,270,80,99,79
"062241204",133,132,265,102,213,99
"062660508",384,330,714,223,380,215
"062770204",103,90,193,68,99,66
"062660704",182,143,325,107,221,104
"062660705",838,797,1635,458,502,426
"062700101",330,315,645,181,204,181
"062870401",128,101,229,66,98,66
"063430606",5,9,14,4,10,4
"063510403",32,28,60,18,35,17
"063578015",39,13,52,3,4,3
"063850801",60,43,103,33,65,31
"063990302",117,66,183,59,85,56
"064060210",197,203,400,102,144,100
"064131806",24,22,46,17,18,17
"064416801",441,407,848,232,239,217
"064417007",376,328,704,224,372,223
"064480610",107,84,191,63,89,51
"064620802",580,638,1218,327,383,322
"064621205",198,164,362,98,129,91
"064690605",673,677,1350,388,429,337
"064830901",125,117,242,87,244,84
"065320907",200,163,363,116,192,112
"066231102",39,49,88,29,36,28
"066090705",36,32,68,22,39,20
"066232210",237,307,544,170,186,159
"066381402",487,489,976,234,248,230
"066860604",37,31,68,24,81,24
"067070403",425,436,861,271,407,266
"067140301",848,870,1718,618,697,610
"067630904",163,135,298,103,250,100
"067911403",105,81,186,63,94,61
"067980601",106,72,178,77,84,62
"068331001",131,120,251,72,178,64
"068750403",60,64,124,50,86,49
"065681410",420,497,917,363,420,351
"065681605",439,495,934,328,352,325
"065681611",420,481,901,315,334,313
"065681902",496,589,1085,356,400,348
"065682002",263,317,580,239,292,236
"065682101",164,197,361,175,327,173
"065682106",94,125,219,121,360,121
"065682111",116,158,274,119,248,119
"065682207",211,208,419,143,193,141
"065682214",517,540,1057,351,412,345
"065682311",352,388,740,250,259,237
"065682401",528,569,1097,365,381,327
"065682503",473,548,1021,358,375,339
"065682702",665,720,1385,338,363,330
"065682711",492,521,1013,323,329,295
"065682804",430,449,879,257,247,228
"065682907",572,583,1155,334,279,265
"065683002",665,751,1416,440,454,422
"065683009",534,530,1064,314,300,267
"065683010",712,745,1457,429,420,393
"065683101",623,705,1328,416,430,386
"065810101",568,602,1170,359,386,335
"065740406",378,392,770,236,260,228
"065740408",391,438,829,311,366,306
"065740415",489,509,998,278,343,269
"065810110",463,457,920,263,280,251
"065810210",350,368,718,248,259,232
"065810308",287,315,602,208,258,205
"065810406",214,220,434,151,214,150
"068051110",944,1002,1946,487,467,452
"068051304",626,697,1323,403,426,383
"068051408",527,551,1078,295,290,280
"068051409",519,559,1078,333,345,324
"065811306",837,913,1750,522,557,493
"065811309",288,298,586,181,279,180
"065811406",249,278,527,143,162,141
"065811503",270,302,572,194,198,187
"065811505",506,510,1016,301,324,293
"065811601",349,452,801,313,360,284
"065811605",318,344,662,225,273,210
"065811801",371,418,789,292,329,280
"065811807",164,220,384,179,376,174
"065811808",110,161,271,145,380,143
"065811902",66,61,127,40,142,40
"065880204",493,507,1000,333,353,313
"065880905",157,152,309,103,203,103
"065880913",695,688,1383,345,347,323
"065881001",180,173,353,129,151,129
"065881302",28,29,57,21,22,21
"068190404",416,502,918,339,421,337
"065881603",462,466,928,242,270,241
"065950102",372,407,779,244,261,236
"065950103",616,661,1277,400,422,387
"065950104",577,610,1187,367,390,352
"065950107",421,440,861,302,326,275
"065950201",362,408,770,278,360,274
"065950211",242,284,526,217,260,210
"065950213",201,262,463,197,228,190
"065950309",297,300,597,234,282,230
"065950310",493,552,1045,386,451,381
"065950313",279,308,587,221,247,216
"065951607",514,488,1002,262,292,260
"065951609",313,362,675,237,257,235
"065952606",263,289,552,172,335,168
"065952401",329,395,724,285,340,277
"065952503",441,516,957,364,455,360
"065952511",486,470,956,302,331,296
"067071111",321,348,669,231,283,229
"065952608",614,615,1229,323,327,303
"066020801",336,309,645,240,293,238
"066021102",355,339,694,207,290,194
"066090208",676,684,1360,450,496,438
"066021104",420,490,910,325,329,317
"066021402",53,41,94,40,147,39
"066090102",529,604,1133,402,434,388
"066090107",457,489,946,321,334,296
"066090108",334,332,666,215,239,212
"066090109",526,496,1022,297,325,290
"066090201",425,442,867,347,419,339
"066090204",282,368,650,272,342,269
"066090214",396,391,787,257,289,249
"068400405",423,463,886,287,278,240
"066091901",782,832,1614,425,463,413
"066091902",283,307,590,210,240,208
"066091903",468,548,1016,402,463,397
"066160307",227,259,486,188,216,186
"066230107",477,506,983,354,386,340
"066230302",526,601,1127,383,419,377
"066230311",310,316,626,231,270,228
"066230407",393,449,842,332,363,326
"066230503",424,544,968,343,358,335
"066230701",264,257,521,180,224,179
"066231103",220,246,466,159,180,159
"066232008",522,601,1123,396,434,388
"066232107",255,253,508,142,162,142
"066232205",396,504,900,321,337,313
"066232213",264,326,590,201,216,191
"066232306",217,242,459,160,182,159
"068540203",438,477,915,332,400,327
"066232803",258,300,558,174,213,171
"066380102",892,907,1799,473,509,456
"066380103",447,480,927,275,324,268
"066380207",477,484,961,269,272,253
"066380209",547,543,1090,303,298,283
"066380303",710,712,1422,400,363,341
"066380313",714,776,1490,407,456,390
"066380405",1129,1132,2261,556,560,540
"066380505",303,343,646,191,291,183
"066380412",491,537,1028,270,364,266
"066380506",278,272,550,148,229,147
"066380507",388,390,778,216,282,204
"066380510",642,671,1313,364,405,345
"066380511",625,605,1230,350,300,280
"066380513",685,662,1347,307,316,282
"066380604",836,856,1692,413,409,368
"066380608",345,376,721,228,315,224
"066380611",655,708,1363,325,277,269
"066380707",590,597,1187,420,469,371
"066380802",331,404,735,220,399,218
"066380805",243,243,486,152,358,149
"066381802",879,830,1709,435,449,421
"066380815",61,54,115,45,177,45
"066380912",672,691,1363,343,320,304
"066381003",600,658,1258,361,408,351
"066381010",821,801,1622,431,405,392
"066381105",512,553,1065,333,375,314
"066381112",420,419,839,187,205,183
"068612402",537,627,1164,394,400,382
"066381304",381,426,807,239,296,233
"066381513",833,840,1673,465,467,438
"066381514",646,655,1301,341,357,318
"066381607",521,589,1110,393,412,340
"066381807",657,641,1298,336,370,330
"066382002",527,488,1015,262,364,256
"066382008",255,250,505,162,186,155
"068750804",231,277,508,167,218,166
"066440202",136,144,280,95,291,93
"066440204",39,37,76,33,321,33
"066440313",115,134,249,80,131,76
"066440314",49,58,107,21,292,21
"066440401",101,87,188,77,492,77
"066480107",425,487,912,265,280,251
"066440509",114,141,255,99,427,99
"066440606",214,195,409,122,331,117
"066440608",448,475,923,286,367,280
"066440610",356,364,720,194,212,185
"066440614",290,299,589,157,216,136
"066440619",127,130,257,86,407,84
"066480206",552,541,1093,278,329,272
"066480209",618,614,1232,329,348,320
"066480304",648,648,1296,321,320,302
"066480314",195,193,388,111,230,110
"066510801",113,105,218,91,126,90
"066510802",152,167,319,137,174,136
"066511001",85,67,152,52,82,52
"066511309",165,180,345,141,184,140
"066550206",275,258,533,166,202,162
"066550312",224,244,468,209,244,207
"066580109",445,482,927,315,334,299
"066580113",41,38,79,28,35,28
"066580201",197,174,371,103,109,101
"066580209",436,493,929,287,269,252
"066580210",457,464,921,280,291,262
"066580304",431,509,940,299,332,295
"066580305",587,688,1275,386,361,326
"066580310",424,453,877,311,353,309
"066580407",517,523,1040,292,296,273
"066580411",511,560,1071,339,344,305
"066580507",592,640,1232,413,419,368
"066580604",382,435,817,284,353,280
"066580610",519,552,1071,358,385,348
"066580703",364,403,767,275,312,273
"066580810",134,210,344,198,313,197
"066580903",333,383,716,278,422,276
"066580905",136,242,378,208,310,208
"066580912",207,286,493,222,293,219
"066581004",324,377,701,255,318,255
"066581005",496,513,1009,417,470,412
"066581105",188,232,420,162,178,152
"066581207",288,394,682,286,361,283
"066581304",394,442,836,241,231,219
"066581308",419,427,846,235,233,225
"066581310",412,408,820,226,191,187
"066581410",402,400,802,203,214,197
"066581501",365,384,749,254,300,248
"066581512",279,354,633,234,272,231
"066581608",321,343,664,251,267,234
"066581702",337,386,723,268,322,264
"066581708",485,545,1030,380,429,378
"066581803",292,332,624,192,219,187
"066581805",338,402,740,271,319,264
"066582002",321,419,740,319,387,317
"066582008",757,795,1552,386,362,336
"066582010",824,903,1727,510,492,458
"066582011",773,830,1603,441,436,405
"066582107",1138,1122,2260,596,570,547
"066582211",484,578,1062,368,383,346
"066582308",282,316,598,216,212,197
"066582503",413,454,867,304,344,280
"066582505",350,434,784,281,277,246
"066582507",350,400,750,265,294,258
"066582509",299,340,639,231,247,217
"066582512",614,628,1242,329,365,311
"066582602",759,794,1553,463,461,425
"066582608",357,398,755,266,281,241
"066582703",386,375,761,181,176,165
"066582707",550,547,1097,288,222,213
"066582714",466,455,921,233,217,206
"066582715",584,563,1147,291,238,218
"066582802",520,587,1107,359,378,341
"066582804",516,574,1090,368,405,363
"066582805",399,437,836,268,298,259
"066582906",616,638,1254,370,363,335
"066583006",522,569,1091,336,368,329
"066583007",726,730,1456,406,401,375
"066583210",729,790,1519,445,425,413
"066583312",479,517,996,312,324,311
"066583508",671,720,1391,406,413,397
"066583606",412,403,815,243,211,181
"066583607",815,932,1747,522,550,504
"066583707",821,895,1716,447,341,335
"066583801",1076,1029,2105,525,370,354
"066583808",534,516,1050,255,254,247
"066583901",780,814,1594,449,400,385
"066583903",757,723,1480,403,346,337
"066583904",398,421,819,242,243,237
"066584001",906,858,1764,438,415,395
"066584010",380,372,752,172,141,139
"066584102",1289,1313,2602,631,570,548
"066584110",904,918,1822,482,436,409
"066584201",430,462,892,250,246,236
"066584202",458,494,952,283,288,261
"066584204",525,574,1099,338,228,213
"066584205",564,540,1104,288,288,279
"066584210",616,631,1247,386,407,371
"066650308",184,179,363,96,104,95
"066651008",684,685,1369,385,404,366
"066651302",0,0,0,0,1,0
"066721207",455,512,967,380,418,370
"066790604",380,426,806,270,298,258
"066790606",463,451,914,266,290,261
"066860106",324,346,670,267,319,259
"066861303",282,291,573,181,190,164
"066861306",288,309,597,182,210,181
"066930306",267,231,498,184,223,180
"066930316",566,560,1126,315,321,305
"067000101",149,143,292,115,144,115
"067000110",237,256,493,192,231,190
"067140605",495,473,968,302,313,273
"067070112",408,355,763,231,274,223
"067071110",510,548,1058,380,426,361
"067071101",531,593,1124,334,374,326
"067071106",334,420,754,278,338,274
"067071107",320,420,740,304,365,300
"067140114",548,558,1106,298,319,290
"067140615",231,229,460,124,144,121
"067140616",394,393,787,205,211,193
"067281011",343,384,727,228,248,222
"067281022",534,490,1024,289,318,271
"067281401",83,74,157,40,53,39
"067350109",600,661,1261,397,398,356
"067490212",345,381,726,237,261,233
"067490213",325,386,711,262,313,261
"067490510",302,377,679,236,289,234
"067490703",405,479,884,292,319,274
"067490706",432,450,882,304,340,286
"067490808",553,660,1213,378,303,278
"067491001",731,780,1511,482,484,448
"067491114",656,714,1370,393,407,361
"067491205",566,723,1289,417,450,409
"067491210",664,697,1361,377,396,362
"067491313",456,496,952,280,227,214
"067491318",534,552,1086,311,284,273
"067491402",454,485,939,303,290,284
"067491417",1054,1028,2082,467,461,454
"067562305",524,595,1119,344,353,315
"067560101",343,407,750,245,286,245
"067560109",249,289,538,219,211,200
"067560111",235,299,534,198,238,194
"067560117",499,556,1055,344,326,289
"067560207",511,598,1109,331,401,328
"067560306",144,206,350,148,243,148
"067560403",492,544,1036,328,425,321
"067560405",524,545,1069,308,385,305
"067560407",451,492,943,301,359,296
"067560701",311,412,723,280,338,269
"067560705",267,368,635,293,361,287
"067560706",284,400,684,317,453,291
"067560708",306,393,699,252,291,250
"067560806",601,641,1242,418,464,407
"067560908",532,572,1104,389,428,378
"067560910",482,530,1012,337,383,330
"067560914",518,568,1086,356,386,345
"067561003",275,363,638,330,402,315
"067561006",275,435,710,374,455,370
"067561011",455,497,952,317,366,306
"067561201",518,613,1131,409,399,345
"067561203",351,407,758,252,280,248
"060141015",478,487,965,282,286,263
"067561207",149,164,313,167,243,167
"067561209",442,513,955,337,348,315
"067561301",303,327,630,285,318,271
"067561310",456,413,869,272,284,272
"067561408",536,625,1161,348,385,316
"067561507",332,361,693,229,248,216
"067630106",291,325,616,208,314,198
"067561610",336,392,728,200,240,193
"067561705",275,293,568,205,238,194
"067561710",347,372,719,329,413,324
"067561808",75,90,165,62,74,60
"067561907",514,556,1070,376,396,359
"067562005",322,369,691,226,218,209
"067562201",958,1036,1994,608,578,530
"067562203",768,891,1659,471,486,453
"067562206",792,806,1598,391,327,309
"067562302",504,513,1017,274,278,266
"067562408",277,311,588,210,220,202
"067562409",313,369,682,235,245,227
"067562504",217,264,481,171,186,169
"067562510",546,576,1122,352,330,298
"067562601",575,607,1182,388,407,363
"067600110",631,737,1368,400,317,312
"067600201",591,658,1249,426,454,416
"067600205",265,358,623,278,376,272
"067600206",290,425,715,267,423,264
"067600212",403,452,855,283,329,280
"067600502",468,490,958,329,375,311
"067600506",426,458,884,298,351,295
"067600604",432,493,925,291,317,272
"067600704",576,624,1200,397,436,378
"067600705",770,779,1549,436,480,429
"067600812",549,603,1152,382,425,354
"067600901",341,403,744,237,257,233
"067600905",319,380,699,264,340,259
"067600908",319,338,657,222,264,210
"067601104",718,736,1454,431,421,391
"067601111",986,1007,1993,544,526,491
"067601216",646,718,1364,368,334,315
"067601402",526,490,1016,266,222,213
"067601409",644,680,1324,383,378,360
"067601515",347,350,697,201,220,193
"067601608",665,704,1369,368,338,321
"067601809",606,589,1195,304,276,259
"067630203",313,365,678,258,286,237
"067630207",366,419,785,318,415,313
"067630301",378,475,853,342,444,335
"067630307",481,541,1022,379,393,346
"067630405",451,507,958,324,333,309
"067630406",407,463,870,280,283,272
"067630408",487,553,1040,316,326,314
"067630410",302,328,630,214,215,194
"067630507",531,539,1070,335,360,324
"067630518",538,590,1128,305,305,285
"067630614",628,644,1272,347,345,334
"067630702",522,491,1013,256,260,241
"067630807",485,489,974,301,300,280
"067631401",404,457,861,289,317,288
"067631801",561,634,1195,346,366,337
"067631909",411,435,846,283,301,275
"067632003",410,403,813,234,283,225
"067632011",317,323,640,188,195,184
"067700102",370,359,729,196,209,178
"067700207",487,434,921,281,297,265
"067701008",574,626,1200,371,408,343
"067701011",245,265,510,146,177,140
"067701201",791,795,1586,466,481,454
"067780102",313,361,674,233,268,216
"067780104",403,425,828,221,239,212
"067780108",452,462,914,243,284,239
"067780212",361,372,733,212,231,208
"067780407",469,531,1000,309,359,304
"067780604",632,672,1304,338,384,330
"067780911",463,533,996,334,371,311
"067781015",439,456,895,239,279,231
"067840806",332,377,709,235,265,233
"067910205",317,346,663,270,317,262
"067910301",409,478,887,310,349,306
"067910309",513,524,1037,328,371,318
"067910401",274,315,589,225,296,218
"067911006",459,460,919,322,377,312
"067911005",62,56,118,44,66,43
"067911201",455,427,882,246,329,244
"067911206",580,650,1230,400,433,371
"067911212",298,340,638,223,252,219
"067911904",333,390,723,303,358,296
"067912108",320,295,615,232,250,223
"067912110",769,800,1569,373,459,334
"067912113",275,285,560,188,255,188
"068050102",346,339,685,207,245,191
"068050103",417,413,830,221,182,148
"068050311",703,755,1458,381,454,378
"068050401",389,395,784,225,312,217
"068050412",1288,1354,2642,687,735,687
"068050503",580,691,1271,412,446,395
"068050612",431,541,972,351,465,345
"068050701",227,256,483,161,329,155
"068050805",259,271,530,186,323,171
"068050812",446,457,903,239,253,232
"068050905",1151,1236,2387,611,775,596
"068051003",479,543,1022,302,312,298
"068051006",668,741,1409,429,412,382
"068051009",956,1008,1964,485,483,451
"068051105",699,758,1457,405,436,403
"068051208",370,413,783,255,276,249
"068051212",563,651,1214,429,492,416
"068051214",446,483,929,272,314,272
"068051314",543,588,1131,352,344,312
"068051415",648,700,1348,353,361,343
"068051502",419,431,850,285,311,277
"068051504",520,592,1112,336,350,324
"068051506",816,871,1687,503,481,432
"068051607",620,615,1235,361,367,346
"068051611",624,612,1236,384,384,349
"068051708",740,809,1549,469,460,428
"068051802",419,423,842,249,250,227
"068051805",562,590,1152,351,404,330
"068051812",923,861,1784,431,230,213
"068260117",236,264,500,165,179,159
"068052103",979,981,1960,506,515,495
"068052302",825,836,1661,411,404,373
"068052401",702,774,1476,415,473,404
"068190406",460,483,943,326,381,320
"068260107",386,490,876,313,371,307
"068260111",246,255,501,200,230,193
"068260112",264,280,544,204,225,202
"068260114",249,271,520,196,220,192
"068261604",134,153,287,89,97,87
"068261608",605,613,1218,394,478,391
"068261911",259,267,526,194,212,178
"068331803",133,133,266,105,462,103
"068331805",118,95,213,97,453,93
"068331811",67,77,144,58,406,58
"068331913",589,642,1231,373,498,364
"068331914",220,248,468,110,116,107
"068400101",236,215,451,121,123,117
"068400113",937,977,1914,572,605,567
"068400211",460,500,960,303,310,283
"068400302",650,697,1347,427,437,396
"068400404",386,423,809,247,256,231
"068400411",508,557,1065,311,313,298
"068400417",694,700,1394,406,416,396
"068400512",652,690,1342,418,420,393
"068400603",411,455,866,266,221,214
"068400609",305,361,666,223,201,172
"068400702",550,634,1184,402,447,389
"068400806",339,364,703,231,246,210
"068400907",355,398,753,287,298,281
"068401008",254,315,569,258,317,256
"068401210",422,485,907,320,338,312
"068401211",523,546,1069,358,393,349
"068401303",523,614,1137,403,431,392
"068401501",306,305,611,214,377,209
"068401505",474,532,1006,388,482,375
"068401506",467,523,990,381,447,365
"068401613",382,387,769,325,393,320
"068401706",580,615,1195,419,492,395
"068401808",549,612,1161,398,415,355
"068401814",337,408,745,275,310,267
"068401903",424,493,917,338,422,335
"068401904",596,633,1229,480,549,433
"068402101",350,407,757,271,270,216
"068402103",211,255,466,176,188,157
"068402208",585,664,1249,407,369,346
"068402406",458,467,925,280,179,165
"068402409",352,406,758,279,234,212
"068402507",257,242,499,123,122,90
"068402602",1708,1940,3648,1015,995,951
"068402704",555,573,1128,363,354,301
"068402706",182,212,394,145,127,104
"068402808",334,374,708,232,258,225
"068402810",335,410,745,245,246,221
"068402907",456,531,987,315,351,305
"068403012",195,276,471,189,231,178
"068403102",470,515,985,343,325,269
"068403106",479,557,1036,352,400,323
"068470103",503,516,1019,331,349,312
"068470105",322,353,675,270,325,269
"068120202",19,12,31,9,17,9
"068190202",47,38,85,31,57,30
"068540105",385,461,846,309,356,304
"068540107",278,365,643,270,358,267
"068190409",102,84,186,68,97,66
"068540113",631,663,1294,353,380,347
"068190908",32,18,50,12,21,12
"068260401",33,14,47,19,32,19
"068260502",20,14,34,12,17,12
"068260705",38,34,72,25,53,25
"068261201",39,27,66,23,25,9
"068330302",9,6,15,6,13,6
"068330402",26,21,47,22,44,22
"068330602",3,3,6,3,8,3
"068540208",300,402,702,281,329,273
"068330705",38,25,63,21,50,20
"068331402",56,48,104,34,51,34
"068331603",9,5,14,6,14,6
"068331902",126,120,246,73,116,73
"068541203",49,33,82,29,72,29
"068541403",92,66,158,62,127,62
"068821501",64,43,107,39,76,39
"068610101",336,363,699,243,297,236
"068610103",282,307,589,250,320,247
"068610108",336,409,745,261,302,254
"068610406",295,343,638,284,358,279
"068610408",193,219,412,214,280,185
"068610501",271,334,605,252,336,247
"068610506",0,0,0,0,1,0
"068610702",209,292,501,250,334,249
"068610705",338,413,751,310,372,308
"068610802",347,439,786,306,359,298
"068610804",368,443,811,288,297,272
"068610909",142,165,307,126,198,125
"068610910",312,367,679,277,328,273
"068611008",433,493,926,337,391,329
"068611009",370,410,780,280,315,278
"068611102",354,385,739,243,256,224
"068611202",358,378,736,264,308,257
"068611204",265,281,546,189,212,164
"068611209",401,449,850,281,315,272
"068611407",392,476,868,322,394,318
"068611510",505,515,1020,322,391,314
"068611705",361,373,734,254,284,250
"068611913",295,347,642,267,291,257
"068612007",355,435,790,306,352,296
"068612109",353,411,764,284,339,278
"068612202",458,517,975,332,360,305
"068612403",353,387,740,251,278,248
"068612404",320,380,700,237,258,234
"068612501",311,353,664,230,251,226
"068612601",496,605,1101,396,456,391
"068612608",572,608,1180,412,448,405
"068612706",407,430,837,292,324,287
"068612903",458,497,955,349,367,328
"068613009",690,790,1480,453,403,366
"068613305",442,484,926,357,420,342
"068680101",912,872,1784,489,503,468
"068680109",469,466,935,284,340,277
"068680110",438,452,890,278,314,258
"068680305",152,174,326,112,210,109
"068680311",40,43,83,33,361,32
"068680506",93,71,164,68,560,63
"068680509",191,148,339,119,528,117
"068680510",104,74,178,71,512,71
"068680608",31,32,63,29,321,27
"068680706",143,159,302,107,341,105
"068680805",32,20,52,24,311,24
"068750805",211,209,420,137,182,137
"068751610",675,643,1318,386,419,383
"068751612",366,346,712,207,235,200
"068820105",878,880,1758,496,403,374
"068820213",455,494,949,321,345,296
"068820301",104,100,204,59,70,56
"068820303",589,614,1203,376,413,358
"068820306",488,520,1008,342,348,301
"068820812",315,394,709,315,465,313
"068820903",627,671,1298,368,376,342
"068820909",446,457,903,275,274,257
"068821005",356,399,755,254,245,229
"068821601",490,549,1039,346,350,302
"065601405",850,793,1643,399,361,351
"065601414",686,658,1344,343,317,297
"065601501",565,544,1109,293,283,268
"066581305",227,250,477,136,130,124
"065601504",583,577,1160,285,274,267
"065601516",633,660,1293,409,461,345
"065601604",608,655,1263,329,356,310
"065601605",610,636,1246,331,296,277
"065601607",621,673,1294,330,319,289
"065601702",662,610,1272,327,347,293
"065601709",89,105,194,53,147,53
"065601710",173,191,364,117,263,114
"065601719",758,749,1507,380,382,346
"065601720",396,427,823,231,252,209
"065601721",395,380,775,217,247,212
"065601904",566,593,1159,308,346,301
"065601905",353,345,698,200,241,189
"065601912",419,404,823,234,280,218
"065601920",360,348,708,202,257,193
"065602004",718,732,1450,393,359,329
"065602112",441,479,920,229,224,216
"065602304",668,696,1364,418,427,407
"065602307",452,519,971,347,413,327
"065602308",369,461,830,207,250,192
"065602404",354,430,784,287,322,277
"067910218",563,621,1184,453,465,424
"065602414",295,338,633,222,252,220
"065680206",472,480,952,348,376,331
"065602514",570,619,1189,346,366,327
"065680205",412,415,827,297,317,290
"065680209",691,653,1344,451,380,360
"065680212",397,422,819,271,282,258
"065680308",459,484,943,314,309,290
"065680309",480,501,981,324,312,300
"065680312",480,508,988,337,375,328
"065680316",739,723,1462,330,303,298
"065680409",502,580,1082,381,417,350
"065680507",432,464,896,338,371,313
"065680601",593,649,1242,400,453,393
"065680607",460,554,1014,391,494,390
"065680808",487,544,1031,345,381,334
"065680902",337,394,731,251,280,249
"065681209",324,339,663,238,264,233
"065681401",348,383,731,191,185,182
"065881009",7,2,9,4,8,4
"066510705",3,5,8,4,16,4
"060070202",12,5,17,7,8,7
"060070509",7,10,17,6,13,6
"060070703",10,5,15,6,16,6
"064904810",326,371,697,258,294,253
"064904908",245,275,520,191,200,186
"064905105",620,683,1303,416,420,369
"064905109",371,430,801,279,301,265
"066583409",459,512,971,288,296,263
"066583504",633,691,1324,378,387,349
"064970110",386,399,785,253,285,243
"065152012",395,435,830,242,233,221
"065151908",736,781,1517,396,363,347
"065151910",831,847,1678,448,434,421
"064970404",307,347,654,218,186,166
"064970408",1201,220,1421,103,157,94
"064970607",600,665,1265,361,406,354
"064970610",391,401,792,205,259,201
"064970810",480,501,981,298,317,291
"064970812",828,842,1670,502,510,480
"064970813",318,316,634,205,211,200
"064971202",738,683,1421,419,436,404
"064971401",655,742,1397,419,445,395
"064971402",611,647,1258,394,388,357
"065810408",320,383,703,261,346,254
"065151913",308,284,592,151,163,146
"066651311",614,626,1240,381,415,369
"065152010",837,832,1669,466,444,418
"065050303",93,97,190,62,153,60
"065050314",443,467,910,265,282,244
"065152105",462,470,932,255,259,229
"065152108",512,512,1024,274,253,244
"065180114",215,238,453,144,170,142
"065150102",1,1,2,1,1,1
"065250112",358,308,666,190,181,171
"065150202",535,574,1109,318,317,276
"065150301",661,703,1364,368,312,289
"065150306",570,567,1137,291,291,276
"065150312",547,587,1134,306,289,266
"065150314",471,473,944,289,297,273
"065150402",555,551,1106,319,231,225
"065150509",584,612,1196,339,325,307
"065150605",306,340,646,194,164,158
"065150613",306,318,624,194,182,166
"065150614",476,544,1020,310,251,221
"065150810",604,608,1212,348,303,291
"065150812",501,513,1014,318,347,295
"065150907",347,413,760,209,232,208
"060283907",583,533,1116,273,261,250
"060283909",910,886,1796,454,438,415
"060350306",481,555,1036,363,366,354
"060490402",157,140,297,89,144,84
"060560901",266,365,631,309,426,308
"065151009",611,588,1199,322,321,308
"060561408",254,339,593,305,399,301
"060562406",713,732,1445,434,456,424
"065151101",528,586,1114,354,390,348
"065151103",611,674,1285,393,381,351
"065151112",444,480,924,249,235,221
"060912303",389,422,811,248,275,242
"060980704",401,450,851,293,330,287
"065151203",602,609,1211,286,229,221
"061260512",781,785,1566,394,391,369
"061260915",340,340,680,165,170,150
"060070601",217,224,441,165,206,164
"061820210",344,389,733,277,327,254
"060140301",110,102,212,56,77,55
"060141004",272,274,546,183,208,181
"060352613",395,393,788,207,180,180
"060141011",338,417,755,307,368,302
"060210606",331,422,753,294,345,291
"060280103",592,622,1214,326,331,312
"060280108",843,809,1652,428,369,354
"060280114",519,574,1093,294,314,292
"060280115",684,699,1383,426,436,392
"060280304",448,439,887,216,219,212
"060280401",959,916,1875,459,364,357
"060280412",832,893,1725,474,436,418
"060280505",48,50,98,24,20,19
"060280512",55,77,132,36,30,29
"060280803",41,44,85,20,15,15
"060280809",54,60,114,32,28,27
"060280812",483,564,1047,359,365,345
"060280903",505,557,1062,281,283,277
"060280908",647,678,1325,364,344,332
"060281002",352,373,725,229,230,219
"060281009",487,548,1035,280,278,266
"060281108",191,218,409,131,131,106
"060281201",571,636,1207,416,428,376
"060281204",400,473,873,321,391,318
"060281304",832,819,1651,465,436,421
"060281305",497,577,1074,339,340,300
"060281313",375,385,760,218,208,197
"060350109",239,237,476,142,113,104
"060281507",649,747,1396,445,466,426
"060281508",384,389,773,232,251,219
"060281511",366,381,747,220,211,194
"060281604",533,588,1121,309,304,290
"060281802",423,516,939,301,296,273
"060281807",674,638,1312,302,295,281
"060281810",601,606,1207,315,292,287
"060282202",451,473,924,292,303,269
"060282206",759,756,1515,406,402,374
"060282211",416,463,879,286,294,267
"060282215",385,385,770,217,221,199
"060282303",379,415,794,265,262,234
"060282310",399,423,822,268,272,251
"060282313",289,323,612,203,232,200
"062030804",520,583,1103,356,368,324
"060282407",582,601,1183,381,420,364
"060282505",430,521,951,356,471,351
"060282702",467,476,943,289,320,281
"060282706",745,752,1497,347,319,304
"060282803",687,666,1353,380,372,353
"060282912",546,561,1107,301,268,254
"060283002",417,423,840,232,228,221
"060283205",300,372,672,225,255,220
"060283208",641,660,1301,386,384,356
"060283209",698,756,1454,453,476,423
"060283303",394,434,828,250,247,226
"060283311",539,556,1095,354,379,334
"060283412",539,624,1163,368,393,351
"060283506",725,732,1457,373,358,341
"060283508",499,548,1047,309,342,299
"060283601",357,351,708,199,219,194
"060283604",680,700,1380,441,475,424
"060283609",473,476,949,268,284,258
"060283706",746,758,1504,368,357,337
"065151215",492,483,975,278,245,238
"060350309",258,282,540,180,183,178
"060350310",329,341,670,223,235,221
"060350313",499,550,1049,334,341,312
"060350401",685,732,1417,406,322,311
"060350404",661,701,1362,365,288,272
"060350509",418,458,876,319,335,295
"060350510",383,469,852,295,309,265
"060350604",363,432,795,269,279,244
"060350607",284,305,589,207,259,204
"060350710",192,211,403,138,320,123
"060350804",459,565,1024,321,340,316
"060350813",646,671,1317,344,296,284
"060351609",437,470,907,325,388,318
"060350903",300,292,592,159,139,119
"060350909",284,340,624,193,195,182
"060351004",457,510,967,310,322,305
"060351101",293,286,579,203,194,154
"060351109",225,336,561,275,373,273
"060351303",327,419,746,291,345,271
"060351307",299,339,638,219,259,199
"060351405",287,348,635,246,295,245
"060351501",377,402,779,207,206,194
"060351504",377,394,771,277,263,202
"060351505",485,533,1018,256,254,242
"060351605",388,415,803,264,302,251
"060351803",367,386,753,264,276,244
"060351902",460,512,972,333,357,316
"060351908",391,441,832,273,302,269
"060352001",461,531,992,365,409,335
"060352009",411,461,872,312,309,280
"060352202",303,347,650,262,289,256
"060352206",327,384,711,275,345,269
"060352209",276,333,609,227,286,223
"060352404",481,528,1009,347,354,325
"060352601",658,729,1387,410,418,374
"060352704",1173,1161,2334,611,532,526
"060352801",500,572,1072,354,382,337
"060352906",394,441,835,296,337,293
"060352907",328,426,754,263,301,259
"060353007",505,507,1012,341,351,305
"060353009",410,451,861,284,298,275
"060353204",392,448,840,301,337,291
"060561010",225,284,509,230,304,228
"060353501",497,560,1057,332,332,306
"060353502",428,444,872,288,305,273
"060353505",745,806,1551,463,454,420
"060421902",420,455,875,300,330,288
"060421903",583,634,1217,367,393,350
"060421904",366,441,807,311,368,303
"060490101",267,351,618,219,259,210
"060490111",405,402,807,253,271,233
"060490112",249,253,502,163,175,153
"060490205",656,688,1344,360,370,344
"060490503",268,312,580,236,289,226
"060490504",572,625,1197,414,461,404
"060490508",523,585,1108,382,440,371
"060490601",400,447,847,317,315,306
"060490605",327,383,710,268,300,264
"060490607",518,508,1026,345,380,331
"062450107",344,405,749,259,303,257
"060490611",607,599,1206,335,360,326
"060490614",488,492,980,291,320,281
"060491003",251,266,517,188,226,187
"063572009",88,109,197,92,334,88
"060560406",504,611,1115,439,520,427
"060492506",369,367,736,249,306,244
"060560107",190,204,394,239,324,212
"060560115",247,273,520,229,293,226
"060560208",423,469,892,364,441,349
"060560301",170,201,371,181,228,178
"060560305",138,168,306,123,153,121
"060560306",313,363,676,335,449,324
"060560311",434,506,940,363,398,352
"060560402",353,390,743,233,253,231
"063573803",165,208,373,212,765,207
"060560410",207,227,434,150,172,142
"065151305",695,744,1439,487,518,463
"060560509",545,622,1167,373,411,369
"060560609",614,582,1196,361,393,353
"060560807",415,441,856,248,258,237
"060560815",412,394,806,202,230,190
"060560906",343,485,828,326,381,319
"060560911",290,304,594,208,227,203
"060561103",137,187,324,148,228,147
"060561205",205,286,491,284,400,279
"060561206",174,277,451,265,368,245
"060561304",155,170,325,172,240,156
"060561403",256,298,554,261,336,261
"060561420",75,115,190,114,167,111
"060561501",513,506,1019,302,348,298
"060561511",335,381,716,236,245,230
"060561514",568,620,1188,341,369,332
"060561517",287,286,573,173,179,168
"060561606",206,219,425,171,201,171
"060561701",401,479,880,344,388,340
"060561702",406,440,846,331,380,318
"060561706",359,421,780,311,377,301
"060562008",244,269,513,189,219,183
"060562009",262,282,544,193,227,190
"060562010",281,307,588,204,227,199
"060562202",445,503,948,345,386,336
"060562204",610,634,1244,410,415,378
"060562213",510,567,1077,295,315,292
"060562302",471,473,944,280,294,264
"060562308",422,457,879,292,308,282
"060562311",282,281,563,179,197,159
"060562402",871,838,1709,473,491,454
"060562405",609,592,1201,325,338,316
"060562410",444,455,899,267,270,254
"063573901",132,214,346,206,705,206
"060562513",367,370,737,289,316,278
"060562515",308,372,680,259,297,253
"060562614",645,634,1279,375,461,372
"060562608",470,475,945,309,374,305
"067000210",237,263,500,216,264,213
"060630115",590,547,1137,351,386,338
"060630101",495,501,996,286,279,267
"060630701",832,787,1619,430,459,411
"060630703",531,545,1076,314,332,306
"060630704",412,429,841,258,252,211
"060630705",312,270,582,178,194,171
"060631306",408,437,845,282,340,279
"060631307",530,559,1089,372,408,354
"060700111",190,221,411,151,180,148
"062700905",571,560,1131,302,317,292
"060700801",206,173,379,135,185,135
"063573906",119,179,298,93,265,93
"060770109",382,418,800,293,356,287
"063572103",207,266,473,214,317,212
"060771405",293,342,635,249,339,243
"060840706",343,360,703,285,320,281
"062741005",417,468,885,237,242,229
"060840904",204,188,392,138,176,137
"060910301",466,552,1018,400,432,379
"060841205",355,415,770,233,250,226
"060910110",485,493,978,271,195,170
"060910203",286,292,578,212,253,212
"060910207",311,340,651,224,267,219
"064410410",234,284,518,272,346,257
"060910409",1001,1049,2050,518,491,463
"060910701",589,667,1256,374,368,341
"060910710",710,674,1384,390,404,368
"060910902",570,659,1229,402,441,384
"060911001",490,527,1017,354,365,337
"060911102",631,723,1354,453,463,422
"060911307",513,543,1056,298,299,283
"060911310",711,724,1435,413,389,364
"060911312",467,479,946,277,265,256
"060911402",744,776,1520,400,397,379
"060911412",523,512,1035,305,312,290
"060911711",661,646,1307,361,321,311
"060911513",406,407,813,246,256,236
"060911604",720,741,1461,416,389,364
"060911605",703,841,1544,437,416,384
"060911606",493,491,984,261,256,241
"060911612",413,426,839,234,229,201
"060911613",721,820,1541,432,443,410
"060911712",598,650,1248,363,346,329
"060911810",395,382,777,225,242,210
"060911903",613,631,1244,349,334,318
"060911906",294,314,608,196,236,189
"062800401",309,362,671,250,454,241
"062800402",67,83,150,56,222,54
"063573907",277,323,600,209,441,191
"060912012",396,444,840,227,275,220
"060912115",472,519,991,281,276,263
"060912207",571,578,1149,309,282,269
"060912209",400,373,773,224,232,217
"062801007",54,96,150,64,323,64
"060912311",598,635,1233,322,329,305
"060912404",791,760,1551,403,447,378
"060980201",371,440,811,283,320,275
"060980205",444,493,937,321,328,298
"060980307",397,432,829,258,284,251
"060980508",440,445,885,264,255,233
"062870404",295,295,590,178,196,164
"062870405",387,427,814,291,333,287
"060980502",591,632,1223,370,361,336
"060980615",396,437,833,254,261,231
"060980616",560,552,1112,309,340,302
"060980809",297,280,577,242,284,233
"061050104",415,509,924,378,485,376
"061050106",269,341,610,253,322,250
"061050207",428,507,935,365,418,300
"062940804",155,157,312,126,140,118
"061051302",182,181,363,128,148,126
"061051403",286,300,586,182,218,180
"061051404",305,282,587,195,243,189
"061051410",467,476,943,314,366,312
"061120102",503,552,1055,365,417,357
"061120107",302,370,672,271,322,265
"061120109",587,620,1207,409,422,390
"061120203",604,607,1211,395,436,381
"061120207",331,359,690,274,288,266
"063150103",310,320,630,180,211,170
"063571603",295,388,683,288,374,268
"061121405",315,376,691,299,341,271
"061121409",314,419,733,272,333,268
"064411808",290,359,649,290,376,279
"061190301",323,427,750,296,350,284
"061190407",472,481,953,321,387,311
"061190409",396,395,791,246,306,239
"061260201",830,806,1636,393,327,314
"061260204",547,558,1105,324,344,310
"061260311",428,449,877,308,343,288
"061260514",484,456,940,246,268,227
"061260609",173,170,343,108,382,106
"061260702",495,545,1040,296,287,258
"061260708",612,588,1200,328,312,299
"061260802",278,264,542,182,239,158
"061260804",341,432,773,273,394,264
"061340102",284,260,544,152,182,148
"061340107",279,300,579,183,241,180
"061340110",250,246,496,145,224,141
"061340111",241,187,428,124,198,121
"061340114",72,67,139,42,63,41
"061340301",898,990,1888,550,598,524
"061340308",738,745,1483,463,495,449
"061340406",365,248,613,158,210,150
"061340910",510,472,982,280,291,265
"061341003",639,569,1208,319,350,292
"061341010",628,689,1317,405,433,388
"061400305",417,494,911,326,385,317
"061400316",584,613,1197,338,351,317
"063572603",193,290,483,264,740,263
"061470105",297,362,659,291,337,285
"063573601",199,279,478,247,578,245
"063573604",188,257,445,253,936,247
"061470801",274,268,542,185,252,183
"061471001",119,105,224,73,104,71
"061540612",347,376,723,249,280,245
"061471208",488,535,1023,365,433,360
"061540604",155,167,322,137,168,134
"061540607",332,372,704,235,260,227
"061610109",367,440,807,275,338,271
"061610110",314,303,617,182,196,176
"061610114",324,341,665,217,252,211
"061610404",156,141,297,85,99,84
"061610801",71,51,122,41,62,40
"063572108",177,273,450,216,386,214
"063576112",165,178,343,84,93,84
"063572201",201,221,422,194,388,193
"061750402",547,538,1085,335,352,324
"061750408",443,489,932,370,397,345
"061750410",404,478,882,324,364,314
"061750411",217,241,458,198,214,194
"061750415",252,260,512,164,219,162
"061750610",540,535,1075,301,315,296
"061820108",277,331,608,203,218,202
"061820207",316,372,688,272,349,263
"061820310",22,24,46,18,26,18
"061820606",676,691,1367,403,407,371
"061820608",567,570,1137,317,347,304
"061820708",413,464,877,276,306,265
"061820709",474,444,918,281,315,272
"061820710",574,586,1160,371,416,351
"061820901",153,119,272,96,432,88
"061821107",292,319,611,199,223,195
"063572203",195,232,427,193,529,191
"061960105",188,173,361,98,113,97
"061960102",477,524,1001,311,328,299
"061960205",387,498,885,357,408,322
"062030202",273,309,582,226,274,226
"062030214",35,27,62,26,40,26
"062031401",219,215,434,152,316,144
"062031607",488,545,1033,322,382,318
"062031608",444,466,910,306,348,299
"062031612",371,359,730,274,336,271
"062100116",361,434,795,303,362,286
"063711311",453,469,922,329,379,312
"062100205",235,296,531,212,254,206
"062100605",119,166,285,117,141,116
"062100809",483,434,917,285,306,277
"062101308",606,651,1257,419,468,404
"062170409",302,292,594,175,262,173
"062170415",361,379,740,244,266,232
"062240112",343,429,772,339,442,335
"062171002",632,674,1306,440,458,417
"062240117",360,389,749,237,284,230
"062240209",398,402,800,273,277,257
"062240402",568,622,1190,433,473,406
"062240408",241,344,585,268,371,266
"062242009",121,114,235,79,101,79
"062241103",91,110,201,68,91,68
"062242010",185,188,373,134,163,134
"062242001",136,158,294,117,178,117
"062311204",421,482,903,324,369,318
"062380111",316,339,655,227,244,213
"062380114",211,231,442,156,181,152
"062380211",163,168,331,90,92,86
"062380214",292,311,603,176,193,172
"062380604",457,431,888,260,300,258
"063572801",190,255,445,246,894,238
"062380609",247,280,527,140,155,136
"062450103",592,636,1228,420,442,409
"062450106",661,779,1440,424,452,415
"062450108",388,427,815,290,348,282
"062450109",337,375,712,262,307,257
"062450202",431,414,845,248,256,231
"062450209",547,599,1146,356,334,299
"062450212",759,770,1529,417,411,375
"062450215",452,467,919,242,228,196
"062450303",535,572,1107,366,385,337
"062450402",242,230,472,145,219,137
"062450406",300,320,620,191,216,186
"064100905",582,667,1249,417,384,319
"062450415",828,892,1720,453,492,445
"062450505",804,861,1665,529,559,481
"062520111",281,338,619,236,289,231
"062520114",401,472,873,267,275,235
"062520216",576,582,1158,291,295,283
"062520412",1042,984,2026,535,494,459
"062520505",365,426,791,288,349,264
"062520605",606,592,1198,327,350,304
"062520809",155,156,311,85,112,85
"062520901",1579,1593,3172,841,985,836
"062520906",675,645,1320,337,319,301
"062520907",610,615,1225,331,330,298
"062520913",1319,1386,2705,637,653,617
"062520914",994,939,1933,504,462,412
"062521004",626,660,1286,343,351,293
"064121306",832,884,1716,458,460,445
"062521006",542,560,1102,322,324,299
"062521007",559,571,1130,286,283,247
"062521008",466,462,928,218,293,173
"062521017",334,348,682,205,275,201
"062521103",329,323,652,234,271,226
"062521202",979,945,1924,520,529,482
"062600517",452,464,916,283,287,262
"062521306",581,576,1157,318,315,287
"062521409",517,581,1098,336,380,336
"062521413",1250,1194,2444,590,559,531
"062600102",658,629,1287,359,387,330
"064131101",103,89,192,47,56,47
"062600204",809,792,1601,388,371,354
"062600209",865,844,1709,443,411,400
"062600316",774,775,1549,409,391,369
"062600401",449,499,948,277,235,227
"062600408",592,595,1187,364,373,346
"062600602",464,466,930,295,266,241
"062600712",396,431,827,305,364,303
"062600713",380,473,853,332,371,239
"062600802",788,827,1615,440,451,412
"062600811",742,772,1514,390,408,376
"062600913",816,827,1643,425,391,352
"062600914",539,543,1082,314,353,300
"062601003",571,602,1173,367,381,344
"062601006",1743,1918,3661,1270,1259,920
"064200205",29,34,63,23,257,21
"062601014",548,509,1057,258,276,245
"062601106",237,292,529,189,212,189
"064200213",314,330,644,197,306,191
"062601110",623,682,1305,389,407,371
"062601206",506,560,1066,353,404,343
"062601303",477,546,1023,360,426,353
"062601306",464,550,1014,344,385,329
"062601412",332,393,725,249,246,223
"062601604",567,545,1112,306,261,238
"062601703",1763,1624,3387,1223,574,411
"062601710",143,170,313,107,259,105
"062660305",202,201,403,114,128,99
"062660311",450,438,888,271,291,258
"062660401",113,104,217,53,74,52
"062660507",47,57,104,39,90,35
"062660607",92,87,179,65,241,63
"062660709",612,635,1247,403,440,382
"062700105",210,256,466,169,204,159
"062700209",924,914,1838,464,462,419
"062700212",830,812,1642,429,465,419
"062740909",339,368,707,204,219,200
"062700304",984,953,1937,506,526,486
"062700501",454,487,941,294,338,292
"062700507",635,665,1300,384,426,375
"062700603",145,159,304,111,260,111
"062700705",632,638,1270,337,335,309
"062700713",563,529,1092,273,285,265
"062741702",391,435,826,244,247,216
"062700807",110,110,220,72,129,71
"062700912",494,478,972,280,300,271
"062700913",550,523,1073,297,332,283
"062700902",788,726,1514,385,418,367
"062700906",685,723,1408,369,303,265
"064272014",1329,1435,2764,684,427,377
"062740101",672,683,1355,374,354,336
"062740107",386,437,823,253,259,243
"063573003",70,90,160,77,150,77
"062740210",588,634,1222,298,296,290
"062740309",499,517,1016,269,242,232
"062740315",478,504,982,272,397,238
"062740408",413,430,843,243,257,235
"062740507",647,644,1291,322,323,311
"062740601",719,776,1495,405,401,379
"062740604",491,514,1005,293,313,282
"062740607",484,485,969,255,228,221
"062740610",439,463,902,279,304,266
"062740620",795,809,1604,364,364,342
"062740708",824,802,1626,417,430,395
"062740713",712,742,1454,357,351,324
"062740810",692,657,1349,301,299,285
"065151603",414,441,855,235,273,230
"062740814",641,620,1261,323,321,300
"062740815",597,609,1206,329,329,303
"062740820",716,695,1411,340,334,316
"062741102",578,609,1187,342,331,307
"062741111",508,512,1020,271,323,260
"062741205",312,323,635,211,232,204
"062741216",664,597,1261,331,347,324
"062741301",656,669,1325,393,418,379
"062741518",704,743,1447,428,443,397
"062741614",563,545,1108,299,270,259
"062741601",783,754,1537,373,359,336
"062741603",788,744,1532,374,399,355
"062741605",435,463,898,269,256,244
"062741706",613,611,1224,322,299,284
"062741807",828,852,1680,390,365,358
"062741905",1050,976,2026,489,494,465
"062742002",787,815,1602,396,360,348
"062742120",422,407,829,234,231,219
"062742201",484,465,949,253,263,233
"062742203",821,871,1692,447,428,407
"062742210",622,633,1255,345,381,311
"062770107",387,396,783,260,312,255
"062770110",391,397,788,243,261,239
"062770112",241,295,536,219,278,216
"062800105",282,268,550,145,168,142
"062800110",316,300,616,171,210,168
"062800410",138,142,280,99,163,89
"063573102",172,256,428,213,392,212
"063573103",138,185,323,179,320,176
"064276801",522,560,1082,288,270,255
"062800901",49,47,96,36,97,36
"064277613",451,485,936,239,270,220
"062801004",142,158,300,118,388,118
"062801101",410,375,785,238,272,226
"062801105",197,248,445,174,228,155
"062870407",331,344,675,248,289,244
"062940401",334,369,703,233,258,232
"063010513",583,669,1252,401,462,389
"063010806",357,386,743,276,452,270
"063080501",142,156,298,101,116,100
"063080601",153,173,326,131,154,129
"063150101",350,360,710,234,246,212
"063150102",492,625,1117,386,442,378
"063150105",393,506,899,321,402,314
"063150114",644,680,1324,372,412,359
"064279608",949,940,1889,477,457,389
"064340104",444,465,909,337,311,259
"063220614",287,333,620,177,197,176
"063290317",231,267,498,147,149,138
"063290501",136,124,260,95,115,89
"063573201",233,325,558,243,374,242
"063570101",451,421,872,260,272,229
"063570303",172,169,341,129,246,124
"063570406",235,316,551,187,251,185
"063570503",322,377,699,251,288,243
"063570510",467,461,928,306,429,303
"063570511",219,235,454,171,262,169
"063570605",373,420,793,260,273,247
"063570610",457,492,949,313,358,310
"063570702",539,525,1064,346,398,329
"063570703",411,455,866,261,298,255
"063570705",604,681,1285,379,415,371
"063570802",446,481,927,281,267,237
"063570808",348,398,746,262,291,259
"063570809",485,521,1006,350,408,343
"063570902",607,611,1218,318,296,278
"063570909",512,574,1086,304,320,279
"063570910",676,704,1380,379,386,347
"063570913",519,518,1037,308,311,275
"063571001",373,340,713,228,257,222
"063571007",607,549,1156,286,258,240
"063571008",826,776,1602,406,407,378
"063571207",561,551,1112,327,327,282
"063571304",676,744,1420,472,519,456
"063571402",411,489,900,328,373,299
"063571403",603,671,1274,422,463,400
"063571409",374,477,851,319,387,306
"063571508",423,486,909,361,431,350
"063571510",393,446,839,303,372,292
"063571608",271,335,606,218,283,210
"063571610",173,214,387,166,228,164
"063571801",327,372,699,282,394,277
"063571808",355,479,834,310,398,298
"063571901",323,397,720,288,456,285
"063571907",305,370,675,234,368,225
"063571911",152,186,338,146,512,145
"063572001",177,243,420,178,371,175
"063572006",97,114,211,112,344,110
"063572304",127,163,290,166,421,166
"063572306",145,169,314,176,741,175
"064411707",233,260,493,193,210,177
"063572403",115,145,260,156,714,155
"063573204",236,366,602,311,459,310
"063573206",151,242,393,219,343,218
"063573208",89,139,228,117,214,117
"063573210",171,253,424,200,329,197
"063573304",287,362,649,306,445,303
"063573405",161,225,386,176,275,174
"063573505",235,314,549,269,456,269
"063573506",161,249,410,217,404,216
"063574104",176,213,389,207,1000,205
"063574105",142,183,325,208,1051,206
"063574207",131,196,327,93,233,93
"063574402",103,130,233,74,131,73
"063574506",316,401,717,315,470,305
"063574515",160,210,370,162,402,162
"063574807",225,311,536,199,243,197
"063574810",360,445,805,321,429,319
"063574905",363,427,790,287,386,282
"063574908",283,326,609,246,324,237
"063575002",430,428,858,310,369,298
"063575009",959,1114,2073,624,640,602
"063575014",254,303,557,201,241,187
"063575103",453,563,1016,358,402,354
"063575107",623,617,1240,360,383,357
"063575201",879,866,1745,432,452,416
"063575207",609,617,1226,382,401,349
"063575209",482,484,966,243,264,238
"063575303",567,624,1191,378,436,366
"063575308",593,577,1170,346,363,324
"063575309",681,718,1399,413,460,394
"063575403",520,643,1163,369,396,353
"063575404",564,628,1192,401,463,384
"063575405",388,434,822,280,320,271
"063575408",315,355,670,232,257,228
"063575505",259,277,536,185,207,175
"063575605",344,393,737,288,356,285
"063575608",414,497,911,322,379,314
"063575612",339,421,760,287,344,281
"063575803",313,377,690,280,331,276
"063576006",446,491,937,337,393,332
"063576011",355,382,737,230,258,229
"063576102",485,567,1052,388,447,374
"063576202",285,296,581,188,201,184
"063576205",357,418,775,276,335,271
"063576206",349,470,819,267,335,254
"063576302",106,113,219,56,277,54
"063576304",171,201,372,124,341,118
"063576403",336,346,682,201,273,199
"063576409",107,116,223,81,257,78
"063576605",373,420,793,263,291,258
"063576503",7,1,8,3,3,3
"063576505",320,342,662,216,247,202
"063576511",284,291,575,199,297,186
"063576514",139,136,275,98,337,94
"063576603",575,696,1271,408,430,387
"063576701",287,295,582,186,219,184
"063576809",426,448,874,280,274,242
"063577002",500,503,1003,341,349,302
"063577013",435,499,934,267,270,259
"064414708",554,595,1149,340,298,279
"064414906",301,345,646,264,293,246
"063577209",660,672,1332,371,401,358
"063710501",448,481,929,331,248,221
"063577405",443,422,865,224,247,214
"063577406",776,746,1522,389,420,370
"063577411",203,228,431,131,200,128
"063577413",333,306,639,211,358,202
"063577510",138,157,295,73,185,73
"063577511",157,165,322,112,264,112
"063577604",137,140,277,103,301,101
"063577812",824,809,1633,428,439,398
"063577814",673,677,1350,342,338,323
"063577905",456,419,875,225,264,221
"063577914",727,751,1478,427,450,399
"063577915",1019,1030,2049,560,556,525
"063578006",564,558,1122,326,375,316
"063578009",247,235,482,129,155,127
"063578112",267,295,562,168,217,165
"063578204",322,277,599,175,218,175
"063578302",248,261,509,141,165,136
"063640107",395,417,812,220,238,211
"063640108",458,488,946,257,261,247
"063640111",419,455,874,274,294,263
"063640114",683,678,1361,411,423,385
"063710506",513,611,1124,379,346,313
"063640212",150,160,310,100,165,97
"063640311",213,264,477,136,459,135
"063640709",549,623,1172,397,439,382
"063640715",389,396,785,227,244,218
"063640805",499,466,965,284,298,248
"063640806",389,391,780,208,237,182
"063710309",518,622,1140,292,292,290
"063710314",307,355,662,230,238,221
"063710402",515,583,1098,386,413,383
"063710403",379,407,786,249,232,218
"063710404",290,338,628,211,228,206
"063710604",340,353,693,235,245,212
"063710608",422,415,837,246,177,173
"063710612",432,490,922,324,311,276
"063710703",605,646,1251,335,273,262
"063710711",336,368,704,228,219,209
"063710713",369,437,806,276,318,261
"063710804",461,512,973,317,343,302
"063710811",430,485,915,326,374,323
"063710904",301,367,668,219,230,210
"063710913",354,377,731,238,261,228
"063711006",543,575,1118,361,399,348
"063711014",385,458,843,304,319,284
"063711110",566,598,1164,402,430,381
"063711310",570,611,1181,396,426,371
"063711401",578,670,1248,403,389,349
"063711407",454,425,879,197,191,180
"063711408",537,520,1057,254,244,231
"063711413",366,408,774,268,298,255
"063711511",644,669,1313,381,378,370
"063711612",140,171,311,128,149,113
"063711703",441,493,934,323,357,305
"063711705",371,406,777,288,327,275
"063711708",399,455,854,304,323,289
"063711802",280,351,631,244,290,235
"063711803",440,502,942,382,467,375
"063711812",328,386,714,227,232,218
"063711906",375,435,810,242,247,234
"063712103",267,315,582,251,337,235
"063712105",591,646,1237,421,479,396
"063712112",289,351,640,200,229,198
"063712115",429,553,982,343,455,319
"063712202",348,382,730,259,345,254
"063712210",193,256,449,189,246,187
"063712305",219,285,504,239,310,238
"063712307",314,389,703,274,342,273
"063712315",595,685,1280,433,468,423
"063712407",304,342,646,235,272,230
"063712408",287,318,605,217,247,213
"063712505",494,532,1026,340,368,305
"063712903",285,344,629,204,257,196
"063712701",330,356,686,245,271,244
"063712702",482,543,1025,339,361,316
"063712808",473,556,1029,321,297,276
"063712906",239,300,539,178,202,172
"063713009",407,426,833,234,261,228
"063713107",394,455,849,288,308,263
"063713302",807,838,1645,420,390,369
"063713307",523,513,1036,317,321,282
"063713502",343,369,712,221,200,190
"063713506",560,595,1155,370,409,358
"063713507",81,72,153,35,20,18
"063713606",560,521,1081,299,297,276
"063713609",762,858,1620,496,451,417
"063713707",800,809,1609,450,395,365
"063850106",289,283,572,184,214,179
"063850201",158,169,327,117,151,117
"063850707",385,465,850,327,386,324
"063920115",438,441,879,262,307,248
"063920501",10,8,18,6,12,6
"063921202",525,466,991,290,297,276
"063990107",208,196,404,130,146,120
"063990108",229,231,460,178,200,173
"064060203",396,394,790,307,364,305
"064080102",365,439,804,288,294,275
"064080104",506,589,1095,394,413,378
"064080105",616,634,1250,367,390,363
"064080108",685,723,1408,425,395,378
"064080210",690,756,1446,447,459,417
"064080306",575,568,1143,335,339,308
"064080408",1001,1047,2048,563,467,431
"064080602",290,299,589,177,197,177
"064080605",519,555,1074,372,410,359
"064080703",449,477,926,263,216,207
"064080903",419,464,883,282,282,257
"064904906",476,562,1038,360,382,353
"064081007",644,686,1330,415,435,395
"064081106",503,569,1072,321,345,300
"064081302",542,585,1127,294,290,276
"064081306",635,675,1310,385,374,354
"064081402",573,639,1212,399,394,348
"064081404",661,748,1409,445,436,394
"064081504",579,644,1223,342,341,331
"064081508",373,392,765,235,237,207
"064081510",305,321,626,212,222,201
"064100105",432,442,874,258,264,235
"064100106",371,367,738,231,316,227
"064100110",615,648,1263,339,407,328
"064100203",373,367,740,226,343,220
"064100304",600,603,1203,342,327,302
"064100312",253,255,508,155,188,150
"064100413",515,517,1032,286,287,261
"064100414",648,678,1326,375,403,364
"064100510",619,696,1315,372,349,326
"064100608",622,698,1320,440,454,415
"064100613",654,756,1410,440,461,416
"064100614",551,579,1130,391,429,383
"064100710",610,636,1246,417,445,400
"064100713",589,661,1250,394,416,370
"064100904",561,580,1141,376,429,363
"064101009",494,583,1077,350,334,301
"064101212",474,497,971,300,290,271
"064101302",363,409,772,256,285,253
"064101305",373,416,789,256,265,236
"064120102",289,278,567,177,263,168
"064120106",538,497,1035,299,383,293
"065150104",872,829,1701,462,385,371
"064120117",932,913,1845,433,428,393
"064120118",991,892,1883,445,404,391
"064120204",761,773,1534,401,392,374
"064120307",669,699,1368,419,447,403
"064120502",508,559,1067,356,390,347
"064120506",324,357,681,212,243,208
"064120602",394,485,879,283,322,279
"064120702",730,767,1497,372,363,339
"064120811",509,584,1093,293,263,245
"064120911",850,805,1655,381,368,348
"064121017",1003,1040,2043,516,508,484
"064121103",909,926,1835,496,481,454
"064121105",781,821,1602,402,391,378
"064121304",491,480,971,267,273,252
"064121305",893,963,1856,470,401,383
"064121308",809,801,1610,424,386,370
"064121408",793,836,1629,407,404,402
"064121409",613,616,1229,341,333,303
"064121411",689,730,1419,378,390,365
"064121506",561,537,1098,299,305,272
"064130103",469,472,941,295,305,281
"064130207",577,706,1283,368,438,362
"064130308",394,398,792,217,223,206
"064130403",350,456,806,324,406,319
"064130404",473,555,1028,403,438,389
"064130408",548,631,1179,439,471,414
"064130504",342,432,774,318,370,304
"064130507",452,547,999,384,423,365
"064130508",288,357,645,271,355,264
"064130510",289,299,588,210,219,199
"064130512",395,478,873,339,370,330
"064130604",435,529,964,373,433,354
"064130607",479,556,1035,378,441,369
"064130608",376,385,761,250,276,246
"064130612",402,404,806,246,252,232
"064130704",62,60,122,32,32,32
"064131309",400,373,773,217,228,202
"064131405",359,2,361,1,1,1
"064131904",72,69,141,46,89,45
"064132105",366,419,785,287,313,279
"064132201",281,207,488,118,138,111
"064200107",83,82,165,59,280,59
"064200111",142,152,294,121,380,118
"065151704",325,277,602,173,268,172
"064200113",74,83,157,63,390,63
"064200116",244,239,483,171,479,165
"064200301",94,106,200,76,550,73
"064200302",87,111,198,78,325,76
"064200313",45,55,100,40,173,40
"064200401",58,58,116,53,549,52
"064200412",158,155,313,103,296,102
"065250415",525,573,1098,263,290,260
"064200605",53,60,113,50,366,50
"064200608",89,100,189,77,384,75
"064200609",84,87,171,66,398,66
"064200701",65,51,116,55,536,55
"064200902",306,274,580,163,203,157
"064200907",118,110,228,86,446,79
"064201005",176,186,362,122,497,120
"064201108",44,52,96,39,281,37
"064201213",67,76,143,49,325,49
"064201214",224,208,432,110,91,30
"064201310",97,88,185,77,459,76
"064201410",28,28,56,25,333,25
"064201505",27,26,53,26,386,25
"064201603",37,32,69,30,500,30
"064201702",11,14,25,5,46,5
"064201706",27,27,54,27,364,27
"064201707",47,55,102,44,284,43
"064201812",265,253,518,174,617,173
"064201904",194,215,409,133,526,130
"064201908",93,91,184,79,291,79
"065321509",571,558,1129,363,390,325
"064202211",75,83,158,59,302,59
"064202213",89,81,170,64,350,62
"064270110",366,432,798,307,389,300
"065390212",368,400,768,256,270,238
"064270205",222,267,489,226,325,225
"064270218",364,437,801,310,360,296
"064270301",258,343,601,253,269,247
"064270304",274,319,593,233,274,229
"064270408",513,549,1062,355,366,334
"064270503",427,447,874,269,293,248
"064270509",326,383,709,240,250,225
"064270601",520,591,1111,346,317,297
"064270609",536,600,1136,386,414,367
"064270709",436,483,919,326,350,293
"064270713",525,519,1044,296,258,231
"064270811",627,700,1327,409,418,385
"064270911",570,609,1179,343,271,261
"064271102",547,631,1178,377,366,335
"064271203",258,285,543,174,235,172
"064271209",348,421,769,240,246,215
"064271403",619,651,1270,318,203,192
"064271412",445,448,893,219,124,115
"064271514",605,569,1174,324,218,196
"064271609",665,736,1401,386,364,352
"064271704",421,495,916,246,219,200
"065392204",547,602,1149,373,364,335
"064272311",865,931,1796,589,543,496
"064272403",1142,1126,2268,411,161,154
"064272503",564,595,1159,391,395,366
"064272505",1083,1086,2169,511,372,356
"064272508",236,273,509,153,157,143
"064272509",543,570,1113,387,419,377
"064272602",505,539,1044,310,309,277
"064272605",512,559,1071,332,331,310
"064272607",740,849,1589,511,453,429
"064272609",575,626,1201,381,377,353
"064272610",473,537,1010,361,366,325
"064272702",282,304,586,195,205,189
"064272707",558,619,1177,412,421,362
"064272807",511,585,1096,395,477,367
"064272808",427,457,884,305,361,296
"064272910",277,304,581,215,246,198
"064272912",601,697,1298,432,466,409
"064273003",317,378,695,281,395,261
"064273105",583,693,1276,429,491,418
"064273206",373,394,767,287,326,283
"064273301",328,362,690,242,282,225
"064273304",180,210,390,150,170,148
"064273305",293,319,612,211,231,207
"064273311",458,515,973,327,357,315
"064273408",439,519,958,336,378,325
"064273414",451,490,941,308,328,295
"064273502",354,421,775,238,294,234
"064273505",463,564,1027,326,331,303
"064273701",280,281,561,188,226,187
"064273706",814,922,1736,598,723,542
"064273708",592,576,1168,375,393,350
"064273801",654,741,1395,363,333,314
"064273807",648,725,1373,422,381,356
"064273905",720,764,1484,397,344,325
"064274004",809,887,1696,446,408,392
"064274009",378,381,759,215,235,210
"064274012",447,449,896,237,238,222
"064274102",1200,1313,2513,659,501,464
"064274110",675,615,1290,323,268,253
"064274202",826,928,1754,476,414,408
"064274203",1130,1146,2276,604,497,478
"064274204",1028,1124,2152,584,579,531
"064274307",551,669,1220,382,335,295
"064274410",472,527,999,310,322,275
"064274502",595,626,1221,373,394,355
"064274511",570,612,1182,364,387,355
"064274701",487,497,984,301,275,256
"064274707",665,606,1271,222,36,33
"064274711",454,502,956,295,245,231
"064274803",848,909,1757,473,428,403
"064274804",665,679,1344,379,365,343
"064274909",1065,1064,2129,537,465,449
"064275004",632,680,1312,412,402,369
"064275011",641,699,1340,399,376,327
"064275104",500,540,1040,314,328,286
"066582605",371,403,774,273,292,272
"064275210",645,678,1323,297,242,232
"064275402",1075,1166,2241,560,461,444
"064275404",572,630,1202,305,228,224
"064275407",824,798,1622,415,358,346
"064275409",894,849,1743,467,467,417
"064275506",783,808,1591,461,400,347
"064275509",584,618,1202,310,286,269
"064275603",2787,3108,5895,1157,321,299
"064275606",834,837,1671,488,476,451
"064275611",530,607,1137,373,390,353
"064275612",639,776,1415,433,462,417
"064275706",727,813,1540,433,378,357
"064275707",742,767,1509,452,413,398
"064275802",774,782,1556,434,393,364
"064275901",991,991,1982,543,434,390
"064276007",971,1041,2012,518,403,388
"064276014",386,380,766,258,218,202
"064276111",519,522,1041,301,280,267
"064276114",682,690,1372,387,394,372
"064276202",759,882,1641,425,340,321
"064276307",657,734,1391,364,310,283
"064276309",973,1139,2112,551,446,419
"064276504",1120,1142,2262,529,386,382
"064276610",638,657,1295,346,317,299
"064276709",581,570,1151,282,230,217
"064276713",649,688,1337,306,266,252
"064276714",636,605,1241,279,271,231
"064276805",439,458,897,267,315,261
"064276902",757,796,1553,370,318,310
"064276904",755,793,1548,379,329,319
"064276905",1452,1444,2896,654,394,382
"064276913",804,818,1622,459,449,414
"064277013",441,432,873,256,228,222
"064277112",922,905,1827,494,462,433
"064277202",542,550,1092,279,282,263
"064277302",1021,1027,2048,507,448,420
"064277305",772,806,1578,397,309,290
"064277409",477,547,1024,276,254,241
"064277418",2272,2412,4684,1043,733,709
"064277617",580,573,1153,276,278,250
"064277711",652,679,1331,355,317,303
"064277803",799,779,1578,416,314,292
"064277804",622,652,1274,342,289,273
"064278003",1004,991,1995,465,419,411
"064278005",807,829,1636,411,273,255
"064278006",974,904,1878,470,432,412
"064278212",586,576,1162,301,251,239
"064278305",1029,1088,2117,506,224,191
"064278306",791,819,1610,401,339,329
"064278411",968,948,1916,454,454,429
"064278414",467,425,892,243,282,237
"064278507",796,867,1663,431,346,315
"064278606",519,570,1089,309,303,279
"064278614",722,748,1470,374,340,325
"064278808",811,857,1668,440,404,382
"064278809",828,798,1626,427,394,375
"064278811",365,386,751,203,200,187
"064279218",450,429,879,228,210,202
"064279014",696,693,1389,333,311,294
"065680501",395,420,815,300,332,283
"064279116",153,143,296,87,180,86
"065680707",423,410,833,302,341,287
"065151710",608,622,1230,334,360,315
"064279404",993,1034,2027,470,458,440
"064279408",610,612,1222,310,321,285
"064279504",1236,1210,2446,575,537,513
"064279507",2395,2346,4741,940,732,708
"064279512",1103,1128,2231,566,514,498
"064279609",1037,1017,2054,514,534,478
"064279710",443,439,882,225,262,217
"065151810",576,602,1178,319,264,243
"064279720",729,715,1444,358,367,337
"064279721",628,588,1216,328,378,303
"064340106",497,568,1065,380,414,368
"064340206",355,444,799,294,349,288
"064340310",449,480,929,326,375,309
"064340403",356,402,758,293,352,291
"064340409",258,291,549,200,219,179
"064340507",476,567,1043,355,397,343
"064340603",515,559,1074,335,339,299
"064340816",637,724,1361,404,412,385
"064340917",373,377,750,211,196,184
"064341008",502,570,1072,366,393,361
"064341009",560,591,1151,350,370,339
"064341105",363,443,806,249,277,242
"064341108",357,417,774,220,219,198
"064341113",550,609,1159,370,406,353
"064341203",436,517,953,342,373,323
"064341305",496,570,1066,367,391,339
"064341306",345,420,765,278,320,276
"064341514",325,351,676,244,336,241
"064341601",433,480,913,317,334,303
"064341603",380,467,847,300,367,299
"064341607",302,348,650,254,314,239
"064341708",331,389,720,270,304,254
"064341710",147,184,331,131,155,130
"064341809",211,279,490,198,250,178
"064341908",315,370,685,234,283,230
"064341909",363,406,769,279,334,277
"064342010",375,454,829,295,287,270
"064342408",663,688,1351,401,378,355
"064342301",595,589,1184,371,343,309
"064342302",492,515,1007,284,268,254
"064342304",722,764,1486,438,302,286
"064342305",697,696,1393,394,370,352
"064342313",22,21,43,14,11,9
"065810711",225,255,480,173,201,169
"064342512",341,366,707,225,216,203
"064342607",370,345,715,186,147,142
"064342618",656,649,1305,342,273,258
"064342619",658,705,1363,368,293,279
"064342701",423,448,871,295,308,270
"064342801",568,626,1194,362,323,292
"064343101",509,557,1066,367,417,341
"064343209",469,519,988,349,396,338
"064343210",457,477,934,334,374,326
"064343211",329,366,695,248,299,246
"064343402",512,587,1099,376,416,364
"064343403",416,465,881,283,301,260
"064343412",811,910,1721,492,460,414
"064343507",409,432,841,265,271,255
"064343705",458,471,929,320,365,315
"064343707",412,435,847,295,340,287
"064343802",405,474,879,308,359,299
"064343805",270,322,592,267,349,262
"064343808",393,522,915,334,384,319
"064343901",336,368,704,271,343,270
"064344004",207,218,425,158,198,138
"064344107",270,292,562,178,198,177
"064344201",539,607,1146,330,319,286
"064344202",504,580,1084,343,320,265
"064344206",451,468,919,273,303,262
"065811710",192,239,431,179,303,176
"064344403",410,446,856,271,257,245
"064344405",618,628,1246,297,282,255
"064344507",590,624,1214,310,306,296
"065880108",315,351,666,230,249,218
"064410110",433,500,933,340,444,317
"064410111",261,300,561,195,232,161
"064410206",300,590,890,305,338,295
"064410207",341,366,707,412,445,368
"064410210",424,451,875,382,422,374
"064410301",275,301,576,214,225,210
"064410307",384,454,838,365,401,362
"064410413",218,277,495,208,282,196
"064410505",170,176,346,176,246,171
"064410508",205,240,445,210,279,195
"064410801",289,339,628,316,459,309
"064410802",181,268,449,256,319,224
"064410906",296,357,653,266,369,260
"064410907",274,303,577,247,335,241
"064411005",185,250,435,179,222,178
"064411006",423,485,908,312,401,308
"064411102",264,346,610,275,361,262
"064411111",281,378,659,298,369,276
"064411204",169,252,421,217,363,216
"064411205",268,392,660,308,443,305
"064411404",198,306,504,262,413,254
"064411511",226,250,476,247,294,220
"064411609",293,353,646,220,284,218
"064411711",242,286,528,205,228,166
"064411804",174,220,394,179,241,173
"064412115",411,442,853,350,448,344
"064412306",256,285,541,227,273,221
"064412613",241,287,528,216,255,208
"064412801",283,303,586,232,277,218
"064412805",249,304,553,213,268,210
"065151812",787,757,1544,402,358,342
"064412908",258,286,544,191,223,190
"064412909",331,408,739,303,373,298
"064413001",489,550,1039,316,296,262
"064413004",502,576,1078,367,418,357
"064413102",351,350,701,231,243,220
"064413211",604,612,1216,379,411,348
"064413304",314,324,638,223,252,213
"064413306",635,663,1298,433,462,394
"064413310",426,470,896,314,380,305
"064413403",649,635,1284,379,401,354
"064413408",453,518,971,358,377,347
"064413412",265,270,535,165,190,162
"064413505",567,605,1172,377,396,358
"064413513",480,541,1021,369,398,353
"064413608",371,382,753,264,300,260
"064413701",601,605,1206,338,348,309
"064413704",418,419,837,209,215,198
"064413904",391,432,823,268,281,249
"064413907",422,476,898,238,227,215
"064414013",814,803,1617,431,424,401
"064414102",661,653,1314,336,361,330
"066021404",56,49,105,41,195,38
"064414107",504,519,1023,293,300,271
"064414108",774,795,1569,446,454,415
"064414110",552,589,1141,288,292,274
"064414204",633,614,1247,341,321,305
"064414406",495,500,995,294,306,277
"064414502",415,454,869,264,294,249
"064414504",662,651,1313,347,339,321
"064414602",578,620,1198,355,352,331
"064414804",589,669,1258,417,430,391
"064414806",449,457,906,283,314,275
"064414910",217,262,479,201,236,194
"064415007",218,251,469,179,213,176
"064415105",579,609,1188,402,441,391
"064415206",269,294,563,171,214,160
"064415414",404,439,843,245,277,239
"064415418",443,512,955,318,340,295
"064415506",532,551,1083,335,384,329
"066230205",257,313,570,232,314,228
"064415706",679,681,1360,410,421,354
"064415802",326,384,710,243,284,238
"064416006",366,379,745,247,279,237
"064416007",520,513,1033,290,313,272
"064416107",426,421,847,264,336,258
"064416203",351,357,708,228,271,215
"064416401",645,669,1314,402,468,391
"064416402",211,249,460,140,166,136
"064416414",269,283,552,164,220,160
"066300203",257,284,541,173,220,171
"064416606",485,454,939,261,272,243
"064416618",513,544,1057,293,356,276
"064416905",533,512,1045,310,309,291
"064416912",209,191,400,115,142,108
"064417003",402,408,810,224,224,204
"064417005",608,661,1269,346,367,338
"064480606",505,560,1065,333,401,325
"064550103",268,401,669,251,323,247
"064550112",272,285,557,186,218,176
"064550115",249,270,519,154,181,151
"065151905",605,614,1219,300,271,261
"064551402",772,819,1591,427,472,422
"064620702",352,412,764,292,356,284
"064620704",493,472,965,302,339,298
"064690201",292,395,687,280,353,278
"064690202",422,474,896,345,402,337
"064690210",389,450,839,279,316,269
"066381806",644,604,1248,341,353,319
"066382006",333,338,671,173,210,168
"064691507",102,82,184,68,76,68
"064691508",410,399,809,274,339,271
"064760107",360,419,779,265,298,255
"064761406",257,295,552,208,241,206
"064830105",329,412,741,277,331,272
"064830111",355,365,720,257,285,243
"064830113",350,371,721,243,267,232
"064830116",338,366,704,224,247,212
"064830408",344,379,723,259,278,250
"064830411",245,292,537,201,213,193
"064830908",142,127,269,85,242,83
"064900101",416,407,823,196,194,182
"064900113",301,271,572,147,147,141
"064900205",641,690,1331,372,363,352
"064900206",677,695,1372,376,325,303
"064900308",392,433,825,236,203,197
"064900508",712,740,1452,427,387,356
"064900405",663,653,1316,344,310,303
"064900408",674,663,1337,345,235,229
"064900504",370,459,829,242,200,193
"064900601",380,399,779,252,283,250
"064900609",363,435,798,246,208,181
"064900710",487,506,993,308,299,270
"064900714",392,438,830,262,246,236
"064900803",568,616,1184,408,429,390
"064900903",302,322,624,205,218,190
"064901008",387,408,795,292,324,276
"064901014",346,388,734,243,278,228
"064901109",190,245,435,210,285,208
"064901118",306,389,695,252,304,247
"064901205",237,277,514,198,221,188
"064901302",511,530,1041,350,353,333
"066580204",619,547,1166,290,285,264
"064901411",541,587,1128,319,278,266
"064901506",298,362,660,169,76,73
"064901608",467,526,993,318,321,286
"064901609",514,597,1111,355,364,323
"064901702",694,652,1346,353,299,290
"064901809",520,594,1114,354,364,340
"064901814",686,747,1433,432,426,385
"064902402",377,470,847,345,435,344
"064902404",350,489,839,379,512,373
"064902405",343,376,719,281,355,280
"064902606",427,486,913,327,364,322
"066581011",495,549,1044,353,378,335
"064902610",538,552,1090,378,421,367
"064902704",344,372,716,262,303,257
"064902709",389,481,870,300,291,270
"064902712",650,697,1347,419,432,400
"064902803",519,617,1136,407,393,361
"064902809",298,297,595,189,193,186
"064902902",756,808,1564,481,462,427
"064902907",743,745,1488,424,416,398
"064903001",474,462,936,268,253,237
"064903102",514,519,1033,280,257,246
"064903104",774,759,1533,392,361,349
"064903404",689,729,1418,364,321,309
"064903705",546,519,1065,291,259,248
"064903709",990,1005,1995,544,558,517
"064903807",679,699,1378,350,284,270
"064903815",310,387,697,228,193,170
"064903817",1002,1001,2003,520,419,401
"064903901",614,578,1192,388,326,303
"064903903",1688,1669,3357,898,789,754
"064903904",913,947,1860,408,385,383
"064903905",955,904,1859,473,426,407
"064903907",373,395,768,212,156,151
"064904004",960,934,1894,469,376,365
"066582514",204,220,424,141,150,129
"064904405",695,738,1433,411,391,368
"064904501",404,467,871,264,267,248
"064904503",583,563,1146,325,342,317
"064904508",326,352,678,231,256,226
"064904607",393,460,853,304,348,294
"064904610",35,930,965,25,27,25
"064904704",283,325,608,230,260,221
"064904707",452,522,974,346,385,333
"064904708",411,448,859,292,314,283
"064904711",409,465,874,306,371,301
"064904806",199,250,449,143,177,141
"065391215",516,518,1034,291,264,252
"065391412",518,516,1034,271,259,233
"065391413",532,509,1041,272,249,242
"065391416",449,472,921,265,281,256
"065391501",273,334,607,233,271,228
"060700304",123,105,228,78,114,77
"061680103",18,13,31,12,20,12
"061680406",3,1,4,2,7,2
"060070206",17,17,34,15,15,15
"060070507",5,6,11,4,7,4
"060070514",13,13,26,8,37,8
"060070604",1,0,1,1,8,1
"060070607",1,0,1,1,6,1
"060070704",6,4,10,5,13,5
"065391605",234,271,505,213,359,200
"060071002",3,2,5,3,12,3
"060071008",4,2,6,2,14,2
"060071011",12,14,26,9,13,9
"060071103",7,6,13,6,11,6
"060071106",3,3,6,3,10,3
"060071108",14,6,20,6,12,6
"060071110",9,8,17,6,11,5
"060071111",10,9,19,6,7,6
"060140201",23,13,36,11,19,11
"060140901",20,20,40,15,36,15
"061890203",4,5,9,3,18,3
"060210102",7,6,13,6,22,6
"060210402",5,9,14,6,19,6
"060211001",15,13,28,11,16,11
"061960709",32,27,59,19,31,19
"062031304",19,22,41,12,25,12
"062240504",6,3,9,4,14,4
"060420401",65,57,122,41,68,41
"060421501",59,49,108,37,74,35
"060421801",39,22,61,18,18,15
"060491101",40,41,81,32,61,31
"060491201",63,43,106,42,57,42
"060491701",61,40,101,40,56,40
"060491901",100,60,160,56,103,54
"065600716",961,951,1912,538,470,429
"060492201",164,80,244,79,129,79
"060562801",28,23,51,22,59,22
"065600801",578,575,1153,347,357,314
"060630303",86,59,145,48,71,42
"060630405",25,23,48,12,21,11
"060630601",71,39,110,43,91,41
"060630605",43,39,82,30,56,30
"060700303",189,133,322,75,103,70
"060700601",24,23,47,16,36,16
"060701101",11,7,18,5,9,3
"065391715",315,342,657,224,243,219
"065391716",225,252,477,191,228,186
"060770201",35,29,64,22,35,22
"060770202",33,24,57,17,37,17
"060770404",14,8,22,11,26,11
"060770507",22,18,40,12,21,11
"060771103",15,17,32,11,23,11
"060840102",27,19,46,16,38,16
"060840202",21,20,41,13,29,13
"060841101",11,9,20,8,41,8
"060841102",50,43,93,33,71,33
"060841201",120,94,214,75,134,75
"060980707",19,5,24,13,36,13
"062940503",7,5,12,5,34,5
"065391808",729,743,1472,402,383,368
"061050601",93,79,172,65,121,64
"061050807",53,52,105,38,68,38
"061050808",84,56,140,57,105,55
"061120305",23,16,39,12,20,11
"061120401",10,14,24,6,10,6
"063080604",5,3,8,4,11,4
"061120503",5,3,8,4,6,4
"061120704",13,9,22,10,28,10
"061120804",11,7,18,6,11,6
"061120904",16,15,31,14,15,14
"061121202",5,5,10,5,10,5
"061190603",45,40,85,26,38,26
"061190704",19,13,32,12,31,12
"061190903",30,24,54,17,26,15
"065391905",581,628,1209,343,349,320
"061340113",61,60,121,33,48,32
"061340403",94,71,165,55,118,55
"061340601",78,51,129,45,64,45
"061341011",102,112,214,73,109,72
"065392004",484,542,1026,287,270,260
"061400311",30,23,53,17,30,17
"061470709",13,13,26,8,25,8
"061470805",34,27,61,20,26,20
"061540405",23,23,46,17,15,15
"061540502",20,13,33,12,21,12
"061540902",26,17,43,11,20,11
"061680203",18,14,32,13,20,13
"061680302",6,0,6,3,12,3
"061680401",10,3,13,6,12,6
"061680602",10,5,15,5,24,5
"061680701",11,10,21,10,27,10
"061750103",18,17,35,12,18,12
"061890504",8,7,15,5,16,5
"065392103",610,685,1295,426,442,366
"061891402",8,3,11,2,14,2
"061891405",4,6,10,4,12,4
"061891508",11,2,13,9,13,9
"065392104",684,761,1445,459,487,432
"065392105",417,443,860,248,256,233
"061891709",19,10,29,11,18,11
"061960301",12,14,26,9,24,9
"061960306",15,10,25,10,12,8
"061960704",7,7,14,6,12,6
"061960708",59,50,109,34,64,33
"061961002",9,7,16,9,15,9
"061961004",6,6,12,5,5,5
"061961103",18,3,21,12,26,12
"065392205",653,739,1392,418,449,405
"061961204",4,4,8,2,9,2
"061961401",12,4,16,5,7,5
"061961504",8,5,13,6,24,6
"062030304",20,13,33,14,28,14
"062030503",14,13,27,10,16,10
"062030504",22,18,40,14,26,14
"062030707",8,2,10,4,20,4
"065392301",522,480,1002,279,291,268
"065392302",693,653,1346,360,356,340
"065392307",536,587,1123,289,267,260
"062030711",8,5,13,5,15,5
"062030901",10,9,19,9,22,9
"062030904",10,8,18,4,10,4
"062031101",14,11,25,12,14,12
"062031106",12,4,16,3,2,2
"062031205",17,10,27,13,21,12
"062031501",5,4,9,4,7,4
"062031502",30,30,60,17,34,14
"062100806",390,331,721,208,244,200
"062100903",99,89,188,65,120,63
"062101201",121,104,225,81,136,78
"062170204",32,26,58,23,41,23
"062170401",214,210,424,146,193,143
"065392403",426,453,879,251,237,212
"065392412",506,501,1007,258,231,226
"062171008",34,23,57,21,47,21
"065392501",796,840,1636,457,475,442
"063921002",22,18,40,11,20,10
"063990601",73,70,143,51,126,51
"064060308",67,37,104,37,43,33
"062240601",32,20,52,19,33,19
"062241101",54,43,97,33,55,33
"062241202",15,13,28,10,27,10
"062241503",17,17,34,10,27,10
"062241602",10,6,16,7,17,5
"062310202",30,32,62,21,29,21
"062310204",16,10,26,8,28,8
"062310402",11,7,18,7,13,7
"062310502",17,19,36,10,26,10
"062310601",4,1,5,3,15,3
"062310802",2,1,3,2,15,2
"062310804",3,2,5,2,11,2
"062310901",26,17,43,16,41,16
"065392610",642,648,1290,345,343,324
"062380501",72,73,145,51,83,51
"062380901",62,47,109,43,57,43
"062381101",42,24,66,27,48,27
"065392614",523,506,1029,259,248,236
"064131602",NA,NA,NA,NA,NA,NA
"062700509",25,15,40,11,13,11
"062700812",45,30,75,28,32,28
"062701105",19,16,35,13,21,13
"062770203",47,36,83,29,48,29
"062770205",21,11,32,11,20,10
"065600802",544,565,1109,321,346,302
"062800904",40,22,62,11,43,11
"062940201",8,3,11,6,16,6
"062940506",37,33,70,26,58,26
"062940706",0,0,0,0,14,0
"062940811",4,6,10,3,11,3
"062940815",13,13,26,12,28,12
"063010301",67,36,103,44,61,43
"063080201",28,21,49,16,36,16
"065392709",695,720,1415,369,314,309
"063220204",12,9,21,7,25,7
"063220404",9,1,10,6,13,6
"063220501",9,10,19,10,17,10
"063220503",12,7,19,9,23,9
"065392710",579,613,1192,316,292,281
"063221003",9,12,21,9,15,9
"063290203",60,58,118,30,50,30
"063290302",79,75,154,44,71,44
"063290504",50,37,87,25,30,24
"063290602",29,27,56,16,43,16
"063360301",42,32,74,27,44,27
"063430503",55,35,90,32,65,31
"065392807",700,703,1403,360,359,335
"065392808",811,792,1603,437,441,406
"063430603",48,40,88,25,45,25
"063510611",17,12,29,9,20,9
"063510613",20,23,43,15,26,15
"063510701",30,19,49,16,33,16
"063511001",9,10,19,7,9,7
"063577704",66,62,128,43,68,43
"065600804",457,506,963,294,331,276
"063577806",108,71,179,52,67,46
"063850404",18,18,36,10,15,10
"063920402",17,17,34,12,34,12
"063921003",10,9,19,6,11,6
"063921102",32,25,57,20,24,20
"063990602",63,55,118,39,74,39
"064060211",35,29,64,20,46,20
"064060305",31,20,51,16,27,16
"064130904",NA,NA,NA,NA,NA,NA
"064131401",73,64,137,36,44,35
"064131804",4,4,8,3,6,3
"065470701",30,13,43,16,22,16
"064481101",8,9,17,6,20,5
"064551001",49,35,84,25,37,25
"064620202",22,11,33,12,16,12
"064620712",6,4,10,3,6,3
"064690305",15,8,23,10,13,10
"064690306",23,8,31,17,27,16
"064690402",33,23,56,20,44,20
"064690405",24,16,40,12,22,12
"064690703",23,22,45,15,20,15
"064691401",30,17,47,17,33,17
"064760502",44,21,65,26,38,24
"064760503",20,16,36,16,32,15
"065600809",448,455,903,297,335,290
"064760706",8,5,13,6,12,6
"064760709",31,16,47,15,25,15
"064760903",23,12,35,16,23,16
"064760904",12,10,22,8,28,8
"064760905",11,10,21,7,9,7
"064761202",45,22,67,26,43,26
"064761301",68,40,108,38,44,38
"064830202",63,47,110,33,39,33
"064830304",100,90,190,53,76,52
"064830804",59,42,101,36,66,35
"064831002",85,62,147,47,58,39
"066510704",8,9,17,5,13,5
"066510805",4,3,7,2,10,2
"066511305",13,10,23,9,29,9
"064970206",34,27,61,17,31,16
"065050203",22,10,32,11,26,11
"065050206",78,57,135,44,85,44
"065050403",2282,193,2475,30,49,30
"065110102",16,13,29,10,17,10
"066721213",22,18,40,13,24,13
"065110302",32,22,54,14,21,14
"066791205",7,5,12,2,18,2
"065180104",82,61,143,55,77,55
"065180107",17,7,24,11,19,11
"065180208",53,35,88,35,55,35
"065180406",7,4,11,6,16,5
"067420801",48,40,88,29,29,29
"065250502",1778,86,1864,33,39,33
"065321203",28,27,55,16,25,15
"065320601",12,10,22,7,16,7
"065320802",34,35,69,29,43,29
"067491506",51,29,80,24,46,23
"065470401",11,9,20,11,27,11
"065470703",58,50,108,37,161,37
"065470802",67,48,115,42,89,41
"065530201",8,5,13,5,7,5
"067701503",10,8,18,6,9,6
"067980903",19,13,32,12,20,11
"067980904",23,17,40,15,28,15
"065740101",46,35,81,21,40,21
"065740202",97,90,187,56,77,54
"065740903",58,45,103,39,47,39
"065810702",11,8,19,7,12,7
"065810803",45,48,93,33,92,27
"065392918",557,511,1068,265,256,238
"065810807",4,5,9,2,11,2
"065393002",814,839,1653,427,443,410
"065393005",605,633,1238,307,325,295
"065880305",22,11,33,16,42,16
"065880505",100,72,172,62,78,48
"065881011",13,12,25,9,18,9
"065881201",55,43,98,35,86,35
"065881403",8,6,14,6,19,6
"065881502",20,10,30,11,25,11
"065881504",23,19,42,18,50,17
"065951913",71,82,153,47,73,46
"068261102",41,28,69,23,47,23
"068261302",45,42,87,25,37,25
"068330501",10,11,21,7,19,7
"066020303",17,9,26,14,18,14
"066020401",27,8,35,20,72,20
"068331406",0,0,0,0,3,0
"066090303",12,7,19,5,17,5
"066090403",18,15,33,14,31,14
"066090609",30,33,63,17,41,17
"066090704",7,3,10,5,8,5
"066091004",16,11,27,11,25,11
"066091006",5,6,11,5,14,5
"066091201",18,15,33,14,35,14
"066160109",19,10,29,11,27,11
"066231002",24,18,42,15,28,15
"066231003",11,6,17,6,18,6
"066232303",70,17,87,13,16,12
"066232305",47,41,88,25,67,25
"066232402",10,5,15,6,19,5
"066232602",45,36,81,26,35,25
"066232703",21,22,43,10,28,9
"065393113",651,628,1279,339,354,321
"068751301",22,7,29,18,32,18
"068820403",215,95,310,65,96,65
"066510201",16,19,35,13,54,13
"066510605",5,3,8,3,6,3
"066510707",15,9,24,11,30,11
"066510710",10,3,13,5,12,5
"066510812",4,2,6,3,11,3
"066511201",7,5,12,7,16,7
"066511301",3,5,8,3,14,3
"066511303",19,16,35,15,39,15
"067700501",2,2,4,1,2,1
"066550103",56,51,107,39,91,39
"066550201",61,41,102,36,82,36
"066550306",95,76,171,51,99,50
"066550307",141,64,205,45,102,45
"066650404",28,18,46,18,45,18
"066650601",24,19,43,13,31,13
"066650701",52,48,100,36,44,36
"066650901",49,39,88,26,51,26
"066720201",22,18,40,12,21,11
"066720402",24,17,41,19,29,19
"065393201",829,778,1607,391,366,346
"066791203",26,20,46,20,40,20
"066860207",2,3,5,2,12,2
"066860607",12,9,21,8,18,8
"066860702",57,11,68,10,22,10
"065393210",499,481,980,274,266,256
"066860803",14,14,28,9,21,9
"065393211",809,833,1642,411,393,364
"065393213",469,488,957,225,218,206
"066930301",90,69,159,53,93,49
"066930401",97,87,184,64,101,63
"065393215",855,874,1729,466,432,384
"065393304",460,446,906,227,236,218
"067000203",7,5,12,5,13,5
"067001203",12,10,22,8,14,8
"067001208",2,0,2,2,20,2
"067070301",136,104,240,87,168,87
"067070802",84,66,150,62,85,61
"067070902",104,90,194,67,110,65
"067070903",47,34,81,30,59,29
"067071002",64,31,95,33,46,33
"067140807",18,14,32,8,35,8
"067140202",23,20,43,15,34,14
"067140805",33,16,49,19,29,19
"067140902",20,20,40,13,22,13
"067280802",37,31,68,23,32,23
"067281601",16,7,23,10,18,10
"067350208",23,12,35,14,28,14
"067350602",14,4,18,9,14,9
"067420501",38,40,78,29,98,29
"067420601",14,6,20,10,26,9
"067420702",80,53,133,55,109,55
"065393314",359,340,699,192,203,183
"065393402",727,737,1464,334,318,303
"065393407",768,724,1492,394,340,329
"067491502",144,115,259,75,137,75
"067491507",37,38,75,29,64,26
"065393414",801,772,1573,438,434,403
"067631403",29,21,50,18,36,18
"067631904",35,39,74,21,23,21
"067700304",11,8,19,5,10,5
"067700903",51,45,96,23,29,23
"067701103",81,69,150,48,58,47
"067701305",15,19,34,9,15,9
"067701307",19,13,32,11,13,11
"067701401",12,6,18,7,8,7
"067701504",11,6,17,5,7,5
"067841201",18,16,34,11,18,11
"067780702",32,24,56,17,21,17
"067780703",20,14,34,11,18,11
"067780803",22,27,49,16,19,16
"067840401",8,6,14,3,5,3
"067840813",47,38,85,27,37,27
"067841002",5,3,8,3,7,3
"067841003",16,15,31,11,14,11
"067841004",11,7,18,8,14,8
"067841103",20,19,39,12,12,11
"067910601",114,86,200,71,105,70
"067910801",22,13,35,15,18,15
"067910803",46,22,68,23,40,23
"067911101",35,30,65,27,35,24
"067911404",78,48,126,45,64,44
"067911405",101,64,165,78,67,51
"067911406",57,61,118,41,47,41
"067911506",20,22,42,14,23,14
"067911702",52,37,89,34,59,33
"067981003",21,25,46,17,26,17
"068052606",63,50,113,44,161,44
"065470312",547,631,1178,406,482,391
"065470907",550,603,1153,415,493,410
"065530304",116,119,235,77,242,70
"065600109",715,748,1463,370,377,337
"065600110",592,652,1244,356,371,342
"065600204",964,922,1886,450,438,428
"065600205",700,725,1425,368,349,333
"065600403",936,967,1903,516,511,476
"067630407",319,326,645,198,194,191
"065601209",828,836,1664,491,429,394
"065601211",386,385,771,226,239,206
"065600304",516,555,1071,280,252,239
"065600306",545,561,1106,297,274,266
"065601214",678,724,1402,431,483,403
"065600420",709,699,1408,370,398,356
"065600511",569,574,1143,305,293,273
"065600606",821,804,1625,445,433,412
"065600616",675,649,1324,343,312,309
"065600617",713,671,1384,351,341,325
"065180703",110,101,211,70,188,67
"065180712",299,306,605,189,280,180
"065600711",345,388,733,198,199,191
"065600713",765,705,1470,356,295,275
"065180807",55,53,108,36,194,33
"065180809",149,139,288,113,333,110
"065250101",288,289,577,155,180,148
"065250102",291,297,588,156,167,153
"065320101",1511,985,2496,574,566,534
"065320103",360,410,770,299,326,288
"065320105",355,407,762,295,337,286
"065320110",339,395,734,284,345,282
"065320206",313,340,653,248,291,234
"065320313",326,365,691,192,200,180
"065320909",250,243,493,159,289,157
"065321001",595,598,1193,336,391,319
"065321507",385,414,799,255,295,255
"065390101",752,761,1513,386,407,350
"065390103",482,523,1005,287,259,245
"065390109",467,471,938,261,241,233
"065390111",625,631,1256,369,371,347
"065390112",460,484,944,287,277,258
"065390211",458,479,937,272,310,270
"065390309",387,426,813,278,298,265
"065390311",562,614,1176,411,466,403
"065390406",665,776,1441,483,476,441
"065390505",398,424,822,268,269,258
"065390603",400,429,829,268,259,257
"065390605",348,416,764,256,231,207
"065390606",687,771,1458,428,406,371
"065390702",527,619,1146,344,344,302
"065390703",664,697,1361,438,464,407
"065390705",601,648,1249,357,342,316
"065390706",587,665,1252,353,335,313
"065390811",469,521,990,266,261,250
"065391014",749,724,1473,370,381,363
"065391102",707,724,1431,419,422,395
"065391105",546,537,1083,282,262,256
"064201902",20,18,38,17,384,17
"065180204",449,523,972,332,359,321
"067490702",407,425,832,284,326,279
"068401313",222,242,464,205,310,205
"100070101",22,20,42,15,52,15
"100070102",91,97,188,51,118,50
"100070103",40,43,83,26,44,26
"100070104",160,135,295,92,252,91
"100070105",204,207,411,120,276,118
"100070201",299,314,613,160,230,158
"100070202",160,148,308,83,138,81
"100070203",61,50,111,34,44,32
"100070204",143,146,289,89,144,84
"100070301",248,212,460,113,166,110
"100070302",65,62,127,36,42,30
"100070401",44,33,77,23,42,23
"100070402",56,39,95,31,71,31
"100070403",7,6,13,3,7,3
"100070404",164,140,304,106,312,106
"100070405",29,11,40,13,62,13
"100070406",159,140,299,84,259,76
"100070407",151,146,297,83,242,76
"100070408",118,131,249,82,310,78
"100070409",100,62,162,50,282,49
"100140101",182,207,389,97,121,93
"100140102",46,33,79,23,29,23
"100140103",51,38,89,24,31,24
"100140104",40,38,78,19,21,19
"100140201",193,178,371,92,163,90
"100140202",60,54,114,32,44,30
"100140301",78,59,137,34,53,34
"100140302",20,10,30,10,12,10
"100140303",19,17,36,9,10,9
"100140401",48,39,87,27,56,27
"100140402",46,36,82,27,30,24
"100140501",39,41,80,24,44,24
"100140502",73,55,128,39,39,38
"100140503",80,62,142,46,66,45
"100140601",69,62,131,29,40,28
"100140602",58,50,108,25,27,25
"100140701",133,110,243,59,89,57
"100140702",32,25,57,19,22,19
"100140801",55,47,102,32,38,31
"100140802",67,44,111,31,44,31
"100140803",51,52,103,29,34,28
"100140901",51,41,92,29,29,17
"100140902",72,56,128,30,33,30
"100210101",193,185,378,95,119,88
"100210102",9,7,16,4,10,4
"100210103",857,907,1764,436,457,400
"100210104",592,623,1215,321,370,304
"100210105",502,514,1016,313,365,301
"100210106",427,474,901,268,283,239
"100210107",651,685,1336,330,341,303
"100210108",410,429,839,253,289,232
"100210109",434,438,872,241,272,238
"100210110",514,542,1056,317,352,311
"100210111",654,662,1316,325,385,314
"100210112",420,481,901,236,275,230
"100210113",512,479,991,217,252,214
"100210114",195,198,393,90,184,90
"100210201",11,9,20,6,17,6
"100210202",544,552,1096,273,311,260
"100210301",136,103,239,71,121,71
"100210401",223,184,407,103,152,102
"100210501",65,26,91,27,39,20
"100210601",54,22,76,16,31,16
"100210701",90,74,164,48,56,48
"100210801",156,114,270,51,94,51
"100210901",97,43,140,25,35,24
"100210902",89,87,176,53,70,50
"100211001",345,337,682,153,236,145
"100211002",158,144,302,73,135,72
"100211003",201,165,366,90,199,88
"100211004",210,165,375,91,216,86
"100211005",216,216,432,99,251,97
"100211006",148,154,302,72,286,65
"100280101",153,131,284,75,145,74
"100280201",228,79,307,49,116,49
"100280202",380,350,730,199,371,191
"100280301",27,23,50,18,44,18
"100280302",35,30,65,24,60,24
"100350101",595,581,1176,275,336,265
"100350102",43,49,92,20,35,20
"100350103",507,543,1050,281,341,241
"100350104",353,382,735,203,247,196
"100350105",613,656,1269,357,363,320
"100350106",458,545,1003,314,407,300
"100350107",296,360,656,196,232,187
"100350108",472,491,963,265,272,241
"100350109",369,402,771,218,257,211
"100350110",391,433,824,240,229,191
"100350111",353,384,737,204,253,195
"100350112",656,695,1351,329,353,308
"100350113",476,542,1018,276,306,252
"100350114",419,470,889,201,219,198
"100350115",449,541,990,242,256,225
"100350201",157,174,331,82,109,81
"100350202",50,50,100,29,34,27
"100350203",69,53,122,27,32,27
"100350204",577,587,1164,303,375,298
"100350205",326,323,649,177,223,170
"100350206",322,321,643,173,222,170
"100350301",125,152,277,73,87,65
"100350302",69,83,152,34,52,26
"100350303",140,135,275,75,102,74
"100350304",104,98,202,55,81,49
"100350305",143,119,262,70,58,57
"100350306",380,347,727,160,211,159
"100350307",157,130,287,82,116,81
"100350401",217,204,421,110,146,104
"100350402",100,93,193,43,51,42
"100350501",231,236,467,117,156,116
"100350502",288,287,575,143,188,137
"100350503",403,382,785,190,238,175
"100350504",24,27,51,13,23,13
"100350505",94,94,188,43,46,42
"100350506",128,143,271,58,81,58
"100350507",44,39,83,13,23,13
"100350508",576,628,1204,284,285,194
"100350601",1390,178,1568,63,102,58
"100350602",91,89,180,49,60,47
"100350603",110,112,222,58,104,58
"100350604",118,123,241,59,78,49
"100350605",220,236,456,108,164,99
"100350606",293,252,545,138,149,107
"100350607",340,351,691,119,133,110
"100350608",506,481,987,248,307,232
"100420101",46,34,80,25,44,25
"100420102",138,104,242,58,71,57
"100420103",386,381,767,178,209,172
"100420104",395,428,823,193,218,192
"100420105",475,496,971,228,277,222
"100420106",535,535,1070,254,311,246
"100420107",420,480,900,233,282,233
"100420201",72,67,139,44,73,44
"100420202",318,319,637,165,206,159
"100420203",29,20,49,16,26,15
"100420204",162,60,222,85,84,70
"100420205",178,174,352,78,93,78
"100420206",473,473,946,217,311,215
"100420207",728,742,1470,358,400,346
"100420301",342,311,653,172,227,169
"100420302",439,401,840,194,226,186
"100420303",1059,591,1650,323,426,303
"100420304",104,82,186,51,67,49
"100420305",478,463,941,225,259,213
"100420306",516,494,1010,254,315,231
"100420307",31,46,77,28,33,28
"100420401",214,158,372,100,170,99
"100420402",213,190,403,110,218,108
"100420501",52,39,91,21,62,20
"100420502",158,138,296,85,161,85
"100420601",23,16,39,12,26,12
"100420602",219,227,446,118,160,114
"100420603",74,73,147,39,48,37
"100420604",137,129,266,63,69,51
"100490101",108,108,216,65,74,61
"100490102",937,1004,1941,462,419,358
"100490103",590,678,1268,298,305,295
"100490104",316,362,678,172,242,168
"100490105",605,649,1254,328,342,286
"100490106",551,592,1143,274,291,270
"100490107",461,470,931,222,231,215
"100490108",561,613,1174,243,245,234
"100490109",394,446,840,197,212,191
"100490110",749,829,1578,397,437,381
"100490111",846,858,1704,462,633,457
"100490112",696,851,1547,393,382,347
"100490113",957,1045,2002,442,404,375
"100490114",866,912,1778,370,375,345
"100490115",531,590,1121,299,323,295
"100490201",564,557,1121,282,285,241
"100490202",485,538,1023,262,275,247
"100490203",576,613,1189,304,319,294
"100490204",435,488,923,273,274,244
"100490205",450,500,950,269,320,247
"100490206",313,327,640,198,242,195
"100490207",553,634,1187,384,436,373
"100490208",644,684,1328,371,397,345
"100490209",423,486,909,292,299,276
"100490210",347,405,752,229,254,207
"100490211",322,352,674,187,233,183
"100490212",405,475,880,210,211,205
"100490213",310,368,678,183,194,180
"100490214",344,430,774,219,235,214
"100490215",301,359,660,203,227,202
"100490216",520,638,1158,391,433,362
"100490217",376,470,846,290,300,248
"100490218",373,396,769,224,256,214
"100490219",509,481,990,302,306,253
"100490220",254,268,522,147,211,141
"100490221",288,324,612,182,225,179
"100490301",671,748,1419,356,375,352
"100490302",537,590,1127,265,272,257
"100490303",597,634,1231,306,333,291
"100490304",525,533,1058,277,291,241
"100490305",585,578,1163,258,254,220
"100490306",541,510,1051,255,236,195
"100490307",544,523,1067,227,227,216
"100490308",717,707,1424,317,316,302
"100490309",864,880,1744,425,430,388
"100490310",364,382,746,209,192,168
"100490311",558,623,1181,385,379,327
"100490312",363,397,760,252,237,203
"100490313",316,340,656,204,203,179
"100490314",477,480,957,266,284,245
"100490315",462,536,998,274,288,239
"100490316",248,330,578,187,237,171
"100490317",501,589,1090,374,449,343
"100490318",278,326,604,197,250,172
"100490319",395,486,881,292,376,277
"100490320",445,531,976,320,400,305
"100490321",220,282,502,175,257,168
"100490322",135,180,315,136,197,134
"100490323",181,243,424,176,236,171
"100490324",364,435,799,232,265,197
"100490401",378,405,783,216,220,205
"100490402",356,379,735,204,219,199
"100490403",393,425,818,242,260,240
"100490404",817,836,1653,355,368,338
"100490405",684,691,1375,302,263,246
"100490406",704,715,1419,324,323,291
"100490407",859,855,1714,378,370,347
"100490408",445,484,929,235,199,183
"100490409",666,721,1387,384,429,359
"100490410",473,520,993,274,305,256
"100490411",514,534,1048,289,326,279
"100490412",430,503,933,261,270,237
"100490413",406,477,883,245,271,229
"100490414",450,497,947,246,269,232
"100490415",585,579,1164,286,317,274
"100490416",633,698,1331,372,404,345
"100490417",407,490,897,216,220,211
"100490418",529,532,1061,289,307,274
"100490419",570,594,1164,329,322,286
"100490501",358,415,773,244,348,234
"100490502",256,306,562,207,246,187
"100490503",379,376,755,209,232,191
"100490504",332,376,708,208,235,202
"100490505",514,547,1061,262,276,248
"100490506",412,408,820,212,194,175
"100490507",340,422,762,211,230,181
"100490508",374,494,868,296,337,281
"100490509",303,400,703,236,277,211
"100490510",653,709,1362,344,332,287
"100490511",375,413,788,217,210,179
"100490512",822,853,1675,398,370,338
"100490513",890,942,1832,439,409,383
"100490514",282,298,580,176,161,152
"100490515",922,885,1807,422,389,367
"100490516",828,813,1641,403,459,393
"100490517",358,370,728,167,163,158
"100490601",413,439,852,293,345,284
"100490602",270,324,594,204,268,186
"100490603",236,340,576,211,286,208
"100490604",202,273,475,177,263,163
"100490605",285,376,661,207,259,193
"100490606",362,419,781,264,272,229
"100490607",536,602,1138,321,297,255
"100490608",230,264,494,153,173,136
"100490609",467,497,964,284,312,254
"100490610",384,406,790,239,256,217
"100490611",578,590,1168,305,305,273
"100490612",466,457,923,228,210,196
"100490613",621,700,1321,367,366,342
"100490614",383,397,780,230,247,216
"100490615",735,731,1466,369,325,303
"100490616",619,629,1248,289,292,256
"100490617",401,436,837,192,192,174
"100490618",573,591,1164,292,268,252
"100490619",402,453,855,225,213,203
"100490701",527,536,1063,290,333,273
"100490702",347,404,751,204,261,196
"100490703",419,453,872,251,306,247
"100490704",411,461,872,241,243,212
"100490705",319,338,657,187,207,170
"100490706",723,770,1493,378,383,339
"100490707",795,864,1659,437,420,377
"100490708",529,563,1092,277,274,254
"100490709",549,582,1131,279,288,254
"100490710",598,583,1181,287,269,257
"100490711",601,621,1222,311,281,256
"100490712",720,782,1502,387,419,372
"100490801",342,397,739,168,168,164
"100490802",536,568,1104,260,249,239
"100490803",688,762,1450,347,333,318
"100490804",454,508,962,233,231,220
"100490805",577,580,1157,288,269,246
"100490806",434,436,870,219,182,170
"100490807",525,596,1121,284,312,270
"100490808",917,958,1875,420,425,374
"100490809",507,511,1018,249,275,230
"100490810",742,702,1444,350,308,279
"100490811",598,597,1195,268,251,232
"100490812",458,435,893,191,196,176
"100490813",832,967,1799,438,460,422
"100490901",138,140,278,91,158,89
"100490902",229,213,442,114,119,94
"100490903",440,439,879,230,241,225
"100490904",537,617,1154,256,244,237
"100490905",306,330,636,148,141,140
"100490906",857,957,1814,423,434,414
"100490907",602,581,1183,282,336,265
"100490908",500,581,1081,235,210,183
"100490909",711,720,1431,325,374,318
"100490910",487,479,966,253,291,248
"100490911",427,453,880,219,203,186
"100490912",599,665,1264,303,322,296
"100490913",551,583,1134,269,252,236
"100490914",561,621,1182,306,428,303
"100560101",17,12,29,10,34,10
"100560102",191,185,376,115,293,112
"100560103",67,40,107,38,67,38
"100560104",21,14,35,11,25,11
"100560201",39,26,65,21,39,21
"100560202",27,30,57,18,25,18
"100560203",42,37,79,24,40,24
"100560204",19,18,37,11,22,11
"100560205",393,361,754,212,312,202
"100560301",31,18,49,20,27,20
"100560302",89,89,178,53,76,51
"100560303",74,54,128,46,75,46
"100560304",48,42,90,31,47,31
"100560401",56,64,120,39,50,39
"100560402",35,22,57,15,27,15
"100560403",87,66,153,41,67,41
"100560501",30,34,64,14,13,11
"100560502",178,163,341,92,137,84
"100560503",144,151,295,74,98,74
"100560504",127,93,220,56,62,55
"100560601",59,59,118,35,42,35
"100560602",9,2,11,6,8,6
"100560603",37,33,70,22,32,22
"100560701",80,57,137,38,48,38
"100630101",387,372,759,185,220,174
"100630102",129,118,247,64,82,62
"100630103",134,120,254,73,112,72
"100630201",182,193,375,98,133,95
"100630202",444,433,877,203,223,200
"100630203",287,311,598,163,200,146
"100630204",445,434,879,228,270,220
"100630205",542,604,1146,267,300,254
"100630206",403,428,831,189,199,186
"100630207",386,398,784,197,194,166
"100630208",332,365,697,204,236,183
"100630209",390,387,777,220,263,212
"100630210",385,384,769,202,235,195
"100630211",401,385,786,193,203,173
"100630212",423,425,848,223,241,209
"100630213",652,598,1250,305,362,292
"100630214",11,8,19,5,5,5
"100630215",0,0,0,0,1,0
"100630216",0,0,0,0,1,0
"100630217",0,0,0,0,1,0
"100630218",0,0,0,0,1,0
"100700101",73,33,106,36,34,31
"100700102",91,57,148,42,59,42
"100700103",735,744,1479,378,469,366
"100700104",537,495,1032,291,345,281
"100700105",441,508,949,275,316,253
"100700106",453,430,883,233,243,213
"100700107",611,672,1283,307,327,275
"100700108",608,629,1237,285,299,248
"100700109",372,397,769,243,273,235
"100700110",669,667,1336,387,432,337
"100700111",534,543,1077,296,325,282
"100700112",510,548,1058,290,341,281
"100700113",366,378,744,191,241,177
"100700201",271,233,504,132,179,127
"100700202",184,139,323,90,126,89
"100700203",527,492,1019,273,358,263
"100700204",422,361,783,210,257,201
"100700205",250,243,493,114,165,111
"100700301",496,422,918,266,336,260
"100700302",141,120,261,72,94,72
"100700303",192,180,372,132,172,131
"100700304",63,36,99,24,38,24
"100700305",507,501,1008,278,370,267
"100700306",455,420,875,262,322,253
"100700307",544,522,1066,269,292,247
"100700308",380,389,769,204,265,202
"100700309",109,76,185,53,71,53
"100700401",105,92,197,60,83,60
"100700402",102,70,172,50,67,48
"100700403",186,151,337,72,93,64
"100700404",565,591,1156,278,372,275
"100770101",25,12,37,15,25,15
"100770102",151,171,322,74,88,74
"100770103",103,87,190,52,81,52
"100770104",367,359,726,194,232,187
"100770105",392,387,779,215,277,195
"100770201",103,80,183,45,75,44
"100770202",158,128,286,75,123,74
"100770203",52,45,97,25,45,24
"100770301",127,97,224,58,76,55
"100770401",137,99,236,61,102,59
"100770402",58,55,113,29,36,18
"100770501",33,34,67,22,21,14
"100770502",153,113,266,73,96,60
"100770601",160,147,307,96,283,95
"100770602",87,55,142,43,141,41
"100770603",118,92,210,75,282,73
"100840101",371,290,661,174,204,166
"100840102",26,11,37,12,22,12
"100840103",392,379,771,200,238,196
"100840104",334,338,672,190,222,176
"100840105",361,320,681,185,221,179
"100840106",364,368,732,190,225,186
"100840107",12,2,14,7,16,7
"100840201",53,30,83,24,30,23
"100840202",246,232,478,138,213,137
"100840203",295,288,583,155,222,150
"100840204",247,245,492,137,194,131
"100840301",21,19,40,12,22,12
"100840302",76,61,137,30,40,29
"100840303",259,264,523,139,207,136
"100840304",617,552,1169,287,367,278
"100840305",252,292,544,127,136,123
"100840306",413,396,809,204,238,195
"100840307",527,488,1015,246,270,232
"100840401",467,387,854,176,230,176
"100840402",32,21,53,18,32,18
"100840403",210,218,428,95,110,95
"100910101",6,4,10,5,8,5
"100910102",160,172,332,81,69,58
"100910103",435,447,882,236,246,190
"100910104",443,460,903,263,264,212
"100910105",433,456,889,273,317,231
"100910106",268,348,616,201,234,190
"100910107",494,533,1027,275,307,244
"100910108",782,834,1616,386,435,353
"100910109",506,619,1125,317,351,299
"100910110",461,494,955,273,301,255
"100910111",572,601,1173,293,297,255
"100910112",382,424,806,203,245,173
"100910113",400,415,815,208,241,197
"100910114",491,468,959,216,280,211
"100910115",254,304,558,136,245,136
"100910201",234,241,475,125,179,119
"100910202",114,118,232,53,81,50
"100910301",1,2,3,1,6,1
"100910302",425,424,849,215,278,202
"100910303",456,431,887,219,258,201
"100910401",19,11,30,7,15,7
"100910402",0,0,0,0,1,0
"100910403",757,790,1547,379,441,365
"100910404",210,202,412,117,164,115
"100910405",15,12,27,11,18,11
"100910501",298,291,589,161,301,155
"100910502",349,374,723,182,265,174
"100910503",280,326,606,162,208,153
"100910504",301,338,639,172,219,165
"100910505",454,479,933,257,350,243
"100910506",67,62,129,33,53,32
"100910507",208,201,409,111,213,111
"100910508",134,118,252,76,117,74
"100910509",121,113,234,69,129,66
"100910510",35,33,68,19,53,18
"100910511",1,1,2,1,5,1
"100910601",105,82,187,55,69,54
"100910602",38,43,81,26,33,26
"100910603",70,63,133,44,55,42
"100910604",49,42,91,21,40,21
"100910701",30,24,54,15,40,15
"100910702",110,110,220,62,105,61
"100910703",38,32,70,23,37,22
"100980101",180,165,345,102,140,101
"100980102",404,388,792,210,238,182
"100980103",10,10,20,8,11,8
"100980104",136,103,239,68,85,68
"100980201",76,52,128,34,43,33
"100980202",56,34,90,27,42,27
"100980203",440,390,830,200,237,197
"100980204",102,74,176,51,62,50
"100980205",285,276,561,165,200,159
"100980206",278,257,535,152,210,146
"100980207",171,112,283,70,85,69
"100980208",82,75,157,44,58,42
"100980301",113,98,211,49,47,42
"100980302",47,54,101,31,30,24
"100980303",316,226,542,123,128,121
"100980401",178,134,312,74,81,73
"100980402",419,420,839,225,246,220
"100980403",440,413,853,191,216,186
"100980404",780,763,1543,390,451,371
"100980405",653,602,1255,309,275,238
"100980406",32,24,56,19,25,19
"100980407",374,348,722,169,208,163
"100980408",428,365,793,194,230,187
"100980409",297,306,603,177,226,174
"100980410",26,22,48,14,31,14
"101050101",56,47,103,38,81,38
"101050102",375,363,738,195,239,178
"101050103",285,296,581,147,232,146
"101050104",482,510,992,300,393,280
"101050105",472,513,985,267,314,248
"101050106",363,347,710,179,205,172
"101050107",424,449,873,256,318,255
"101050108",302,323,625,179,199,178
"101050109",384,457,841,263,304,253
"101050110",240,255,495,157,206,156
"101050111",432,407,839,260,324,256
"101050112",506,560,1066,272,330,268
"101050113",302,290,592,153,206,143
"101050114",485,524,1009,306,376,298
"101050115",519,620,1139,288,341,284
"101050201",139,131,270,63,89,63
"101050202",352,343,695,195,272,186
"101050301",28,15,43,8,27,8
"101050302",430,457,887,215,347,210
"101050303",454,452,906,243,349,231
"101050304",506,523,1029,265,315,263
"101050305",320,297,617,177,233,154
"101050306",347,363,710,181,226,177
"101050307",276,268,544,140,199,137
"101050401",235,197,432,120,168,119
"101050402",133,113,246,58,75,56
"101050501",132,106,238,66,95,50
"101050502",27,24,51,18,38,18
"101050601",3,4,7,2,5,1
"101050602",392,298,690,167,216,162
"101050701",216,184,400,87,132,86
"101050702",551,448,999,241,346,237
"101050703",103,80,183,52,43,20
"101050704",50,39,89,25,44,25
"101050705",64,52,116,44,88,39
"101050706",69,64,133,42,81,42
"101050707",163,183,346,82,108,77
"101050708",238,222,460,133,208,132
"101050709",266,266,532,139,194,131
"101050801",72,53,125,34,53,33
"101050802",14,10,24,9,19,8
"101120101",209,214,423,118,147,117
"101120201",72,65,137,42,66,42
"101120202",94,83,177,63,83,61
"101120301",62,44,106,30,33,29
"101120302",201,186,387,99,113,92
"101120303",94,81,175,49,64,48
"101120401",47,55,102,26,39,26
"101120402",344,377,721,199,212,189
"101120403",766,863,1629,389,427,384
"101120404",586,637,1223,339,359,329
"101120405",673,705,1378,342,362,310
"101120406",743,727,1470,337,356,325
"101120407",443,473,916,236,273,226
"101120408",688,743,1431,335,357,319
"101120409",594,686,1280,318,368,304
"101120410",393,448,841,239,272,229
"101120411",325,352,677,196,224,189
"101120501",32,29,61,17,18,16
"101120502",392,394,786,223,241,202
"101120503",529,530,1059,282,272,235
"101120504",480,492,972,240,260,221
"101120505",486,498,984,233,251,216
"101120506",617,605,1222,285,253,233
"101120507",528,495,1023,252,280,234
"101120508",420,414,834,214,242,204
"101120509",600,634,1234,307,362,298
"101120510",587,580,1167,285,334,274
"101120511",480,567,1047,255,255,222
"101120512",426,439,865,220,256,214
"101120513",654,595,1249,293,309,276
"101120514",393,425,818,196,202,183
"101120515",407,441,848,223,247,214
"220070101",741,802,1543,375,413,331
"220070102",920,953,1873,451,532,403
"220070103",553,579,1132,271,341,265
"220070104",392,411,803,209,234,202
"220070201",143,156,299,81,107,24
"220070202",57,43,100,37,66,37
"220070203",95,57,152,48,63,48
"220070204",217,167,384,109,101,94
"220070205",76,63,139,32,36,32
"220070206",153,118,271,77,77,74
"220070207",180,170,350,82,83,80
"220070208",870,936,1806,410,344,256
"220070209",323,311,634,136,172,122
"220070301",70,48,118,32,32,32
"220070302",108,61,169,68,69,68
"220070303",59,38,97,29,29,29
"220070304",183,169,352,99,117,98
"220070401",85,50,135,42,50,42
"220070402",51,27,78,29,35,29
"220070403",38,11,49,28,31,28
"220070404",61,23,84,27,41,20
"220070501",230,158,388,100,112,100
"220070502",437,406,843,194,238,188
"220070503",282,345,627,174,188,159
"220070504",122,78,200,59,72,58
"220070505",118,93,211,58,77,58
"220070506",580,610,1190,270,353,261
"220070507",355,361,716,184,239,180
"220070508",792,766,1558,354,390,340
"220070509",696,733,1429,326,390,322
"220070601",190,143,333,117,112,53
"220070602",170,142,312,89,108,76
"220070603",310,217,527,131,103,86
"220070604",108,93,201,52,61,52
"220070701",593,575,1168,288,388,276
"220070702",665,659,1324,338,472,325
"220070703",260,243,503,147,151,133
"220070704",315,343,658,221,254,213
"220070705",687,745,1432,388,441,371
"220070706",496,499,995,290,349,260
"220070707",489,460,949,242,237,219
"220070708",781,797,1578,385,447,367
"220070801",171,93,264,89,108,89
"220070802",134,88,222,53,61,51
"220070803",138,117,255,67,89,55
"220070804",106,52,158,44,53,35
"220070805",50,13,63,16,18,15
"220070806",58,36,94,34,44,32
"220070807",527,501,1028,233,303,227
"220070901",512,523,1035,274,321,271
"220070902",440,429,869,229,276,225
"220070903",166,152,318,87,89,84
"220070904",381,397,778,203,215,190
"220070905",630,651,1281,322,391,310
"220140101",12,14,26,6,6,6
"220140102",150,136,286,88,77,72
"220140103",324,314,638,168,175,163
"220140201",7,6,13,5,5,5
"220140202",28,28,56,18,26,18
"220140203",33,35,68,25,34,24
"220140301",18,5,23,9,24,9
"220140302",11,2,13,4,8,4
"220140303",13,8,21,8,19,8
"220140304",6,3,9,4,9,4
"220140305",45,41,86,38,38,38
"220140306",42,31,73,27,37,24
"220140307",470,430,900,276,318,264
"220140308",413,420,833,261,309,253
"220140401",486,504,990,305,357,298
"220140402",368,377,745,187,198,171
"220140403",124,114,238,56,74,56
"220140404",136,104,240,67,80,66
"220140405",628,663,1291,337,299,265
"220140406",191,149,340,96,114,93
"220140407",135,132,267,71,77,69
"220140408",427,430,857,258,291,254
"220140409",347,331,678,168,204,166
"220140410",502,521,1023,281,313,281
"220140411",318,339,657,190,206,188
"220140412",684,687,1371,341,351,317
"220140501",485,518,1003,280,320,275
"220140502",620,635,1255,381,415,362
"220140503",443,485,928,292,317,288
"220140504",541,536,1077,315,348,301
"220140505",306,345,651,168,190,158
"220140601",528,561,1089,331,361,307
"220140602",304,334,638,218,245,216
"220140603",345,411,756,248,275,235
"220140604",740,772,1512,404,420,377
"220140605",238,272,510,167,178,163
"220140701",49,38,87,31,40,31
"220140702",246,189,435,105,117,105
"220140703",78,64,142,51,90,51
"220140704",495,455,950,253,298,251
"220140705",410,398,808,219,268,215
"220140801",160,128,288,68,83,67
"220140802",126,116,242,54,64,52
"220140803",213,171,384,96,88,77
"220140804",48,29,77,21,28,21
"220140805",179,172,351,92,98,91
"220140901",25,12,37,16,27,16
"220140902",50,40,90,24,26,24
"220210101",69,54,123,33,42,33
"220210102",90,70,160,43,57,43
"220210201",78,72,150,45,69,45
"220210202",75,67,142,34,37,34
"220210301",34,33,67,18,27,18
"220210302",113,97,210,54,54,52
"220210303",70,62,132,33,36,33
"220210401",159,119,278,64,68,62
"220210402",12,10,22,10,19,10
"220210403",338,325,663,169,168,152
"220210501",101,70,171,47,48,47
"220210502",239,217,456,114,130,113
"220210503",328,289,617,169,177,166
"220210504",282,342,624,203,223,202
"220210505",541,537,1078,230,244,225
"220210506",479,477,956,256,306,253
"220210507",618,669,1287,314,338,309
"220210508",704,711,1415,348,370,343
"220210601",457,271,728,155,164,150
"220210602",99,93,192,47,49,47
"220210603",194,166,360,92,94,89
"220210604",252,253,505,124,128,122
"220210605",575,586,1161,247,375,243
"220210606",333,294,627,165,139,137
"220210607",560,546,1106,265,300,259
"220210608",672,599,1271,279,302,270
"220210701",598,668,1266,294,361,274
"220210702",291,320,611,196,166,152
"220210703",210,258,468,140,154,139
"220210704",1116,1161,2277,571,521,440
"220210705",367,407,774,248,292,216
"220210706",260,307,567,174,186,170
"220210707",284,358,642,178,191,175
"220210708",487,542,1029,332,403,325
"220210709",495,579,1074,312,341,308
"220210710",485,525,1010,243,142,100
"220210711",258,342,600,214,268,210
"220210712",186,236,422,165,188,152
"220210713",630,519,1149,346,393,329
"220210714",330,392,722,254,298,228
"220210715",312,381,693,237,184,159
"220210716",206,257,463,182,223,173
"220210717",182,208,390,151,187,148
"220210718",351,396,747,223,245,216
"220210719",679,765,1444,391,416,383
"220210720",271,316,587,179,225,178
"220210721",483,489,972,246,255,237
"220210722",211,288,499,113,119,111
"220210723",271,299,570,164,184,164
"220210801",667,748,1415,376,430,358
"220210802",654,653,1307,268,290,261
"220210803",689,660,1349,299,320,291
"220210804",461,522,983,287,313,267
"220210805",182,207,389,143,156,131
"220210806",477,525,1002,291,306,269
"220210807",278,395,673,249,275,224
"220210808",586,613,1199,328,349,310
"220210809",465,479,944,255,274,240
"220210810",276,328,604,198,217,197
"220210811",554,522,1076,240,249,228
"220210812",440,440,880,217,226,205
"220210813",484,495,979,239,253,237
"220210814",646,677,1323,296,303,279
"220210815",515,502,1017,207,228,200
"220210816",387,401,788,204,209,199
"220210901",37,27,64,19,25,19
"220210902",86,69,155,37,38,33
"220210903",89,79,168,47,72,46
"220211001",91,70,161,38,38,38
"220211002",95,88,183,48,51,47
"220211003",52,62,114,35,35,34
"220211101",107,86,193,51,67,48
"220211102",31,32,63,18,40,18
"220211103",74,66,140,40,57,38
"220211201",67,49,116,41,53,39
"220211202",145,116,261,64,74,64
"220211301",70,73,143,30,39,30
"220211302",109,73,182,45,65,45
"220211401",57,51,108,35,43,32
"220211402",58,53,111,34,56,34
"220211501",237,297,534,214,248,205
"220211502",243,270,513,185,241,178
"220211503",196,241,437,174,220,162
"220211504",471,472,943,294,325,282
"220211505",430,472,902,277,311,266
"220211506",1623,1586,3209,800,841,711
"220211507",353,364,717,221,245,212
"220211508",631,731,1362,407,423,393
"220211509",484,517,1001,282,296,267
"220211510",478,567,1045,290,323,287
"220211511",656,743,1399,369,384,348
"220211512",540,545,1085,260,296,246
"220211513",142,173,315,146,173,129
"220211601",593,647,1240,300,260,245
"220211602",446,473,919,287,301,266
"220211603",207,258,465,158,192,158
"220211604",314,363,677,212,219,192
"220211605",724,790,1514,369,326,308
"220211606",255,312,567,182,182,170
"220211607",276,370,646,293,338,207
"220211608",368,409,777,262,324,256
"220211609",369,400,769,200,199,188
"220211610",577,575,1152,288,307,274
"220211611",565,624,1189,331,313,287
"220211612",282,394,676,242,207,180
"220211613",364,415,779,307,287,256
"220211614",521,537,1058,260,288,246
"220211615",503,547,1050,247,262,239
"220211616",267,367,634,287,260,202
"220211617",422,445,867,198,205,182
"220211618",651,671,1322,330,361,322
"220211701",292,328,620,213,203,138
"220211702",183,237,420,157,200,154
"220211703",344,406,750,237,268,229
"220211704",172,212,384,144,209,138
"220211705",283,309,592,224,233,166
"220211706",394,443,837,291,305,273
"220211707",503,536,1039,293,287,259
"220211708",373,426,799,211,214,172
"220211709",603,650,1253,360,385,335
"220211710",528,523,1051,314,331,302
"220211711",327,390,717,270,413,195
"220211712",626,636,1262,317,334,274
"220211713",503,540,1043,266,272,253
"220211714",755,766,1521,344,370,327
"220211715",266,308,574,193,205,176
"220211716",436,458,894,248,269,222
"220211717",437,425,862,211,211,176
"220211718",510,486,996,245,265,240
"220280101",501,500,1001,275,277,265
"220280102",753,852,1605,444,483,429
"220280103",404,430,834,272,296,251
"220280104",463,500,963,303,326,291
"220280105",596,626,1222,391,432,375
"220280106",519,600,1119,313,321,286
"220280107",350,460,810,285,308,261
"220280108",317,392,709,231,267,218
"220280109",507,508,1015,297,307,276
"220280110",574,540,1114,293,297,280
"220280111",208,262,470,179,216,179
"220280112",356,407,763,255,299,248
"220280113",632,652,1284,352,329,305
"220280114",494,521,1015,330,381,326
"220280115",589,628,1217,342,345,314
"220280116",734,763,1497,336,338,318
"220280117",615,674,1289,362,416,358
"220280118",578,615,1193,316,312,290
"220280201",381,335,716,171,167,162
"220280202",145,127,272,63,63,62
"220280203",363,305,668,168,184,167
"220280301",357,342,699,178,151,99
"220280302",262,248,510,141,147,141
"220280303",97,66,163,44,54,44
"220280304",109,109,218,55,60,54
"220280305",132,117,249,68,76,67
"220280306",390,408,798,207,228,203
"220280307",438,524,962,279,307,277
"220280308",423,405,828,233,244,226
"220280309",699,778,1477,385,425,336
"220280310",684,727,1411,320,375,310
"220280311",719,717,1436,329,354,313
"220280401",76,56,132,42,41,41
"220280402",67,46,113,29,28,28
"220280403",74,53,127,42,49,41
"220280501",245,236,481,106,124,105
"220280502",32,25,57,18,19,18
"220280503",84,69,153,40,43,39
"220360101",536,554,1090,267,317,259
"220360102",523,589,1112,291,333,290
"220360103",156,195,351,113,126,113
"220360104",292,342,634,182,212,178
"220360105",538,549,1087,316,374,313
"220360106",626,682,1308,385,441,374
"220360107",308,342,650,237,318,230
"220360108",443,453,896,253,279,250
"220360109",317,337,654,174,212,173
"220360110",605,619,1224,303,333,285
"220360111",399,433,832,217,236,215
"220360112",518,514,1032,293,322,281
"220360113",596,651,1247,284,310,280
"220360114",484,441,925,232,253,222
"220360201",131,96,227,61,61,57
"220360202",189,171,360,79,85,77
"220360203",138,131,269,69,73,69
"220360204",49,40,89,26,31,26
"220360301",2,1,3,2,2,2
"220360302",345,311,656,159,167,154
"220360303",73,65,138,35,31,30
"220360304",354,274,628,145,143,143
"220360305",123,100,223,64,69,63
"220360401",52,34,86,28,39,21
"220360402",40,32,72,20,23,16
"220360403",178,155,333,87,100,78
"220360404",48,49,97,26,29,17
"220360405",208,215,423,118,144,113
"220360406",45,40,85,31,34,23
"220360501",30,15,45,17,25,15
"220360502",56,47,103,41,33,33
"220360601",75,32,107,31,37,30
"220360602",43,27,70,26,26,25
"220360603",239,215,454,124,125,107
"220360604",56,31,87,35,43,34
"220360701",82,19,101,29,29,29
"220360702",36,23,59,25,28,25
"220360801",19,3,22,16,16,16
"220360802",4,1,5,4,5,4
"220360803",12,2,14,6,13,6
"220360804",9,7,16,7,8,7
"220360805",5,3,8,2,6,2
"220360901",823,786,1609,446,502,380
"220360902",329,320,649,145,156,143
"220360903",5,7,12,4,4,4
"220360904",53,50,103,25,31,25
"220360905",40,20,60,23,29,23
"220360906",368,358,726,189,240,186
"220360907",656,644,1300,329,360,323
"220390101",220,221,441,110,160,107
"220390102",100,77,177,50,79,50
"220390103",25,18,43,14,21,14
"220390104",18,19,37,14,18,14
"220390105",258,255,513,138,176,137
"220390106",521,561,1082,277,311,270
"220390107",313,320,633,234,248,222
"220390108",415,440,855,192,169,133
"220390109",551,541,1092,298,332,289
"220390110",287,347,634,221,245,215
"220390111",376,379,755,218,247,214
"220390201",64,57,121,31,37,31
"220390202",64,49,113,34,47,34
"220390203",70,47,117,32,38,32
"220390204",85,80,165,51,57,50
"220390301",40,30,70,26,29,26
"220390302",13,4,17,9,9,9
"220390303",83,66,149,43,57,43
"220390304",65,59,124,34,42,34
"220390305",170,124,294,95,98,94
"220430101",383,416,799,262,278,251
"220430102",273,317,590,208,224,204
"220430103",620,614,1234,312,399,298
"220430104",493,495,988,239,255,222
"220430105",416,399,815,240,266,236
"220430106",426,413,839,268,284,257
"220430201",267,308,575,142,155,139
"220430202",164,126,290,82,106,81
"220430203",231,176,407,100,120,98
"220430204",87,71,158,45,72,45
"220430205",744,768,1512,351,394,348
"220430301",27,24,51,16,19,12
"220430302",291,241,532,146,145,144
"220430303",302,291,593,152,118,114
"220430304",356,303,659,175,177,170
"220430305",536,421,957,237,272,221
"220430401",29,27,56,18,26,18
"220430402",170,106,276,92,82,77
"220430403",85,51,136,37,38,35
"220430501",55,44,99,31,31,31
"220430502",120,81,201,58,68,58
"220430503",28,31,59,18,25,18
"220490101",396,438,834,266,280,237
"220490102",517,539,1056,268,290,261
"220490103",553,599,1152,302,341,297
"220490104",468,463,931,283,318,252
"220490201",38,33,71,23,22,22
"220490202",44,26,70,24,32,24
"220490203",9,3,12,4,19,4
"220490301",103,74,177,40,44,40
"220490302",98,72,170,44,51,44
"220490303",68,66,134,43,53,43
"220490304",1009,991,2000,454,532,438
"220490305",44,48,92,21,31,18
"220490306",53,32,85,25,39,25
"220490307",377,413,790,180,194,166
"220490308",251,232,483,145,160,126
"220490309",559,552,1111,282,318,268
"220490310",369,407,776,174,208,172
"220490311",881,872,1753,407,483,401
"220490401",64,43,107,29,48,29
"220490402",25,15,40,16,24,16
"220490403",90,54,144,48,67,48
"220560101",656,715,1371,401,439,387
"220560102",853,862,1715,456,484,434
"220560201",619,617,1236,329,400,323
"220560202",53,27,80,27,38,26
"220560203",84,51,135,38,55,37
"220560204",5,7,12,2,3,2
"220560301",99,77,176,49,59,48
"220560302",122,92,214,52,55,49
"220560303",189,161,350,88,103,88
"220560304",108,119,227,52,59,52
"220560305",421,467,888,241,251,234
"220560306",455,456,911,265,272,246
"220560307",32,31,63,19,20,19
"220560308",24,12,36,11,14,10
"220560309",476,433,909,227,252,225
"220560310",502,471,973,284,307,282
"220560311",631,614,1245,322,326,311
"220560312",187,185,372,105,103,90
"220560313",707,719,1426,385,419,376
"220560314",540,529,1069,314,324,306
"220560401",24,18,42,14,17,14
"220560402",29,11,40,17,23,17
"220630101",455,480,935,262,294,246
"220630102",426,486,912,301,353,290
"220630103",282,351,633,200,232,186
"220630104",349,394,743,243,260,238
"220630105",346,421,767,242,271,223
"220630106",373,445,818,250,273,223
"220630107",448,472,920,297,334,276
"220630108",496,492,988,283,326,279
"220630109",313,381,694,230,239,207
"220630202",686,615,1301,365,392,348
"220630203",608,502,1110,283,286,279
"220630204",302,270,572,126,131,125
"220630205",38,47,85,19,22,19
"220630206",186,143,329,84,88,84
"220630207",144,108,252,56,62,56
"220630208",609,497,1106,266,247,226
"220630209",244,184,428,87,89,83
"220630210",452,505,957,273,397,265
"220630211",210,139,349,64,65,64
"220630212",452,403,855,218,197,187
"220630213",193,143,336,71,73,71
"220630214",727,764,1491,367,464,355
"220630215",493,550,1043,257,389,256
"220630216",129,132,261,76,278,75
"220630301",462,343,805,208,212,204
"220630302",414,322,736,192,241,191
"220630303",213,192,405,94,94,91
"220630304",467,399,866,203,202,201
"220630305",495,441,936,209,191,186
"220630306",573,543,1116,277,276,275
"220630307",283,230,513,155,155,152
"220630308",255,199,454,114,124,110
"220630309",765,803,1568,427,501,400
"220630310",909,844,1753,433,573,430
"220630311",708,708,1416,394,426,357
"220630401",792,686,1478,362,221,179
"220630402",81,62,143,46,46,46
"220630403",157,90,247,81,95,80
"220630404",679,697,1376,337,505,330
"220630501",160,143,303,69,69,69
"220630502",128,120,248,54,22,20
"220630503",416,373,789,152,95,90
"220630504",260,199,459,103,107,101
"220630505",479,408,887,200,194,184
"220630506",426,347,773,169,201,167
"220630507",358,357,715,156,153,147
"220630508",907,878,1785,424,482,381
"220630509",838,751,1589,346,355,327
"220630601",45,49,94,16,19,16
"220630602",655,556,1211,254,276,253
"220630603",486,415,901,223,231,218
"220630604",6,6,12,3,3,3
"220630605",626,635,1261,331,354,317
"220630701",251,292,543,149,193,144
"220630702",948,923,1871,510,319,306
"220630703",289,230,519,132,149,131
"220630704",23,24,47,16,15,11
"220630705",798,839,1637,469,558,429
"220630801",877,861,1738,384,415,370
"220630814",382,389,771,221,244,218
"220630816",687,676,1363,323,385,317
"220630817",603,636,1239,336,376,330
"220630818",241,293,534,144,174,141
"220630824",460,387,847,208,246,207
"220630825",284,299,583,170,197,168
"220630826",189,230,419,122,156,121
"220630827",275,277,552,148,172,146
"220630915",706,748,1454,360,396,332
"220630919",787,751,1538,357,394,342
"220630920",707,734,1441,345,385,328
"220630921",737,773,1510,385,460,366
"220630922",271,324,595,163,182,162
"220630923",525,531,1056,261,307,253
"220630928",308,342,650,180,190,176
"220630929",361,347,708,191,226,189
"220630930",409,421,830,209,230,195
"220630931",511,539,1050,283,306,278
"220630932",459,454,913,225,256,219
"220700101",501,571,1072,291,335,286
"220700102",463,433,896,262,299,255
"220700103",791,836,1627,366,400,353
"220700104",716,698,1414,365,394,346
"220700105",498,504,1002,251,274,246
"220700201",109,97,206,49,62,48
"220700202",755,753,1508,350,419,343
"220700203",50,53,103,28,30,26
"220700204",53,30,83,25,31,25
"220700205",325,324,649,142,182,141
"220700206",943,974,1917,386,428,378
"220700301",641,703,1344,296,335,290
"220700302",133,134,267,64,145,60
"220700303",120,78,198,53,49,46
"220700304",127,58,185,56,60,54
"220700305",132,117,249,48,47,47
"220700306",188,112,300,68,77,65
"220700307",705,739,1444,332,377,328
"220700308",451,487,938,250,294,245
"220700309",387,421,808,217,239,208
"220700310",291,325,616,130,150,126
"220700311",433,462,895,194,230,191
"220700401",620,701,1321,298,288,218
"220700402",129,126,255,63,85,61
"220700403",135,124,259,73,85,73
"220700404",51,50,101,33,45,32
"220700405",147,119,266,72,78,67
"220700406",643,697,1340,356,455,349
"220700501",149,111,260,67,83,67
"220700502",72,46,118,33,43,30
"220700503",36,27,63,14,17,14
"220700504",19,23,42,9,13,9
"220700601",140,98,238,63,76,61
"220700602",86,61,147,40,42,40
"220700603",152,128,280,73,87,73
"220770101",516,532,1048,282,290,266
"220770102",272,326,598,166,166,158
"220770103",751,821,1572,405,429,394
"220770104",498,483,981,260,285,250
"220770105",422,467,889,248,261,239
"220770106",378,435,813,218,229,208
"220770107",627,603,1230,296,309,281
"220770201",136,113,249,75,105,74
"220770202",422,367,789,216,257,208
"220770203",94,80,174,47,51,42
"220770204",39,46,85,24,32,23
"220770205",49,49,98,33,42,32
"220770206",221,208,429,116,122,112
"220770207",60,57,117,37,48,36
"220770208",147,118,265,78,116,75
"220770301",129,121,250,71,80,69
"220770302",528,574,1102,266,270,240
"220770303",362,332,694,166,185,164
"220770304",221,175,396,120,145,117
"220770305",67,48,115,32,52,32
"220770306",18,15,33,11,14,11
"220770307",47,37,84,25,36,25
"220770308",16,14,30,10,16,10
"220770401",14,13,27,6,9,6
"220770402",27,16,43,15,22,15
"220770403",24,23,47,14,21,14
"220840101",817,872,1689,501,508,483
"220840102",512,499,1011,250,244,240
"220840103",499,519,1018,284,280,274
"220840104",442,455,897,279,290,271
"220840105",869,806,1675,406,403,396
"220840201",41,23,64,19,20,19
"220840202",257,202,459,111,122,109
"220840203",635,538,1173,255,273,251
"220840204",363,285,648,160,176,159
"220840205",1495,1318,2813,588,599,574
"220840206",316,310,626,140,130,123
"220840207",200,177,377,85,95,85
"220840208",409,431,840,225,242,224
"220840209",752,751,1503,398,440,380
"220840301",23,20,43,18,23,18
"220840302",57,47,104,26,32,26
"220840303",246,248,494,92,36,32
"220840401",183,166,349,108,137,107
"220840402",188,154,342,92,128,92
"220840403",87,61,148,47,62,47
"220840404",72,71,143,39,52,39
"220840501",457,462,919,267,296,263
"220840502",543,565,1108,281,317,271
"220840503",557,526,1083,288,322,271
"220840504",541,550,1091,277,295,272
"220840601",576,631,1207,308,341,296
"220840602",55,51,106,30,30,29
"220840603",123,89,212,51,68,51
"220840604",195,138,333,120,140,119
"220840605",408,378,786,208,222,204
"220840606",38,19,57,18,26,18
"220840607",8,4,12,7,15,7
"220840701",274,212,486,143,178,141
"220840702",17,11,28,13,15,13
"220840703",40,28,68,22,47,22
"220840704",36,26,62,18,22,18
"220840705",38,39,77,27,38,27
"220840706",76,71,147,38,42,37
"220840707",127,97,224,64,85,64
"220840801",286,248,534,148,195,138
"220840802",149,114,263,72,118,72
"220840803",211,175,386,110,146,109
"220840804",485,424,909,214,243,211
"220840805",284,242,526,136,160,136
"220840901",26,21,47,15,22,15
"220840902",18,15,33,13,31,13
"220840903",131,86,217,79,110,79
"220840904",67,66,133,39,62,39
"220841001",175,136,311,88,96,87
"220841002",542,466,1008,283,305,276
"220841003",22,10,32,13,25,13
"220841004",241,250,491,143,168,141
"220841005",549,547,1096,303,330,288
"220841006",325,290,615,167,195,134
"220841101",773,681,1454,368,394,363
"220841102",227,280,507,175,260,174
"220841103",210,227,437,135,149,129
"220841104",472,511,983,278,208,190
"220841105",504,558,1062,259,291,256
"220841106",423,466,889,269,275,258
"220841107",308,366,674,240,286,230
"220841108",379,464,843,274,265,243
"220841109",279,261,540,157,175,153
"220841110",655,725,1380,392,431,385
"220841111",528,588,1116,259,243,234
"220841112",478,495,973,248,259,238
"220841201",762,804,1566,421,482,414
"220841202",501,604,1105,335,358,310
"220841203",412,430,842,217,226,205
"220841204",500,490,990,264,261,257
"220841205",295,331,626,244,279,233
"220841206",285,321,606,207,258,189
"220841207",440,510,950,308,343,294
"220841208",313,340,653,195,206,191
"220841209",377,400,777,210,220,206
"220841210",603,604,1207,260,266,255
"220841211",728,737,1465,361,405,354
"220841212",538,523,1061,239,225,213
"220841213",456,471,927,258,269,257
"220841214",529,518,1047,256,283,249
"220841215",475,508,983,265,305,262
"220841216",801,859,1660,391,418,382
"220841217",409,392,801,186,208,182
"220910101",585,593,1178,339,393,329
"220910102",346,415,761,252,275,243
"220910103",643,715,1358,389,403,368
"220910104",369,448,817,269,306,261
"220910105",383,408,791,234,234,216
"220910201",106,77,183,47,56,47
"220910202",207,162,369,79,78,78
"220910203",202,158,360,73,78,73
"220910204",165,157,322,89,99,89
"220910301",251,214,465,115,132,114
"220910302",359,307,666,133,140,131
"220910303",465,419,884,183,195,177
"220910304",120,87,207,61,72,60
"220910401",207,169,376,96,111,96
"220910402",295,247,542,135,139,126
"220910403",299,281,580,130,138,130
"220910404",121,98,219,61,65,61
"220910501",1049,998,2047,445,461,416
"220910502",537,522,1059,254,281,249
"220910503",188,166,354,104,123,104
"220910504",202,183,385,110,111,108
"220910505",119,104,223,62,67,58
"220910506",202,196,398,100,124,100
"220910507",554,539,1093,277,295,247
"220910508",891,854,1745,444,471,425
"220910509",809,800,1609,348,377,323
"220910510",691,717,1408,283,278,261
"220910511",449,499,948,223,246,214
"220910512",502,578,1080,270,296,266
"220910513",524,558,1082,277,326,272
"220910601",92,52,144,44,48,44
"220910602",242,181,423,119,123,119
"220910701",87,72,159,44,61,44
"220910702",101,88,189,44,47,44
"220910703",262,227,489,111,109,109
"220910704",201,174,375,102,114,101
"220980101",445,525,970,287,291,263
"220980102",366,328,694,163,188,161
"220980103",862,959,1821,516,577,480
"220980104",560,624,1184,272,282,262
"220980105",505,531,1036,300,318,285
"220980106",436,487,923,276,305,267
"220980107",396,460,856,284,297,280
"220980108",323,362,685,241,287,232
"220980109",333,380,713,246,271,240
"220980110",532,617,1149,311,308,278
"220980111",557,607,1164,375,423,357
"220980112",247,256,503,163,181,158
"220980113",156,185,341,118,146,113
"220980114",148,180,328,133,160,132
"220980115",218,238,456,167,187,156
"220980116",184,223,407,161,193,158
"220980117",256,305,561,205,240,201
"220980118",327,347,674,184,214,180
"220980119",542,663,1205,334,311,289
"220980120",412,462,874,269,290,267
"220980121",661,643,1304,331,346,305
"220980122",422,483,905,254,258,238
"220980123",448,482,930,264,290,261
"220980201",93,88,181,57,55,46
"220980202",292,260,552,135,95,70
"220980203",28,26,54,12,15,10
"220980204",51,45,96,25,34,25
"220980205",89,82,171,45,55,44
"220980206",73,58,131,44,64,44
"220980207",156,135,291,77,94,77
"220980208",76,77,153,46,46,44
"220980209",128,108,236,69,80,69
"220980210",44,45,89,25,37,24
"220980211",135,122,257,81,115,80
"220980212",96,75,171,43,57,43
"220980213",110,98,208,60,52,30
"220980214",478,432,910,209,226,198
"220980301",267,309,576,163,173,159
"220980302",465,513,978,291,281,261
"220980303",470,477,947,278,303,272
"220980304",306,342,648,206,224,199
"220980305",394,442,836,266,289,257
"220980306",386,427,813,217,239,209
"220980307",425,447,872,213,234,209
"220980401",435,416,851,217,189,174
"220980402",68,55,123,36,48,36
"220980403",72,61,133,37,50,35
"220980404",43,37,80,25,35,25
"220980405",54,34,88,28,38,28
"220980406",643,616,1259,289,259,227
"220980407",187,170,357,114,127,111
"220980408",565,600,1165,303,332,296
"220980501",136,120,256,75,102,75
"220980502",101,57,158,53,49,42
"220980503",84,51,135,39,46,38
"220980601",252,263,515,130,126,112
"220980602",123,111,234,59,39,26
"220980603",119,90,209,66,89,66
"220980604",30,26,56,11,13,11
"220980605",74,83,157,40,50,40
"220980701",763,833,1596,436,484,419
"220980702",781,761,1542,409,409,377
"220980703",299,346,645,197,191,181
"220980704",271,335,606,202,233,195
"220980705",232,262,494,195,255,160
"220980706",458,560,1018,298,321,275
"220980707",917,874,1791,467,502,438
"220980708",844,887,1731,427,429,394
"220980709",574,609,1183,356,390,344
"220980710",401,429,830,261,296,260
"220980711",138,147,285,83,97,79
"220980712",295,324,619,170,171,160
"220980713",274,274,548,151,156,148
"220980714",419,451,870,223,237,209
"220980715",773,781,1554,398,396,363
"220980716",60,58,118,27,38,27
"220980717",607,648,1255,321,326,298
"220980718",994,1116,2110,563,494,427
"220980719",221,187,408,99,112,98
"220980720",614,634,1248,274,298,261
"221050101",336,329,665,184,191,176
"221050102",352,377,729,200,214,192
"221050103",271,310,581,191,223,183
"221050104",237,281,518,173,202,162
"221050105",210,268,478,165,198,162
"221050106",381,397,778,265,281,255
"221050107",522,546,1068,326,362,317
"221050108",620,621,1241,357,398,348
"221050109",480,525,1005,317,334,302
"221050110",268,310,578,217,224,197
"221050111",284,378,662,228,246,205
"221050112",345,397,742,246,264,241
"221050113",261,284,545,171,197,170
"221050114",453,480,933,232,244,224
"221050115",313,304,617,160,178,159
"221050201",254,182,436,113,125,101
"221050202",198,178,376,84,77,74
"221050203",351,270,621,153,152,150
"221050204",117,106,223,45,53,45
"221050205",214,190,404,115,122,113
"221050301",1072,1139,2211,555,602,514
"221050302",72,65,137,35,27,22
"221050303",774,779,1553,347,374,326
"221050304",217,188,405,104,129,104
"221050305",148,137,285,70,91,68
"221050306",342,275,617,150,146,132
"221050307",141,129,270,67,71,67
"221050308",82,68,150,37,46,36
"221050309",130,117,247,66,71,63
"221050310",195,171,366,95,113,94
"221050311",721,778,1499,416,478,409
"221050312",749,807,1556,415,469,393
"221050313",32,20,52,16,20,16
"221050314",712,740,1452,327,357,305
"221050315",651,616,1267,286,285,250
"221050316",508,585,1093,328,374,317
"221050317",585,597,1182,278,323,267
"221050401",41,42,83,21,25,18
"221050402",45,33,78,26,42,26
"221050403",146,115,261,71,73,69
"221050404",227,189,416,97,104,96
"221050405",93,82,175,49,60,48
"221120101",623,661,1284,359,383,342
"221120102",406,454,860,286,314,266
"221120103",830,854,1684,425,467,405
"221120104",692,790,1482,383,409,358
"221120105",810,890,1700,413,457,403
"221120106",985,1020,2005,486,558,473
"221120201",0,0,0,0,1,0
"221120202",106,83,189,50,59,48
"221120203",43,26,69,19,24,19
"221120301",413,437,850,230,273,228
"221120302",948,979,1927,437,497,425
"221120303",72,38,110,34,50,34
"221120304",49,40,89,24,33,24
"221120305",62,67,129,33,43,30
"221120306",284,321,605,191,220,183
"221120401",345,375,720,199,222,195
"221120402",400,411,811,175,191,170
"221120403",230,209,439,107,109,106
"221120404",359,295,654,142,160,139
"221120405",77,58,135,31,35,31
"221120406",74,74,148,40,52,40
"221120407",709,713,1422,311,329,301
"221120408",71,78,149,49,99,49
"221120501",35,24,59,19,37,18
"221120502",36,27,63,26,62,26
"221120503",32,21,53,18,28,18
"221120504",51,61,112,32,46,31
"221120505",72,77,149,41,32,31
"221120601",22,11,33,15,33,15
"221120602",67,42,109,32,72,31
"221120603",79,60,139,39,52,38
"221120701",82,67,149,42,64,41
"221120702",53,41,94,33,46,33
"221120801",123,128,251,56,59,53
"221120802",109,110,219,67,96,67
"221120803",175,153,328,78,98,76
"221120901",63,59,122,35,38,35
"221120902",47,40,87,26,36,26
"221120903",64,65,129,40,60,39
"221121001",185,180,365,90,121,84
"221121002",83,74,157,55,83,55
"221121003",28,24,52,16,27,16
"221190101",356,386,742,229,255,223
"221190102",551,567,1118,318,355,305
"221190103",636,719,1355,384,350,314
"221190104",704,779,1483,402,425,380
"221190105",410,456,866,228,240,218
"221190106",627,690,1317,348,369,340
"221190107",592,623,1215,293,316,285
"221190108",528,571,1099,289,295,271
"221190201",329,300,629,161,142,117
"221190202",398,398,796,200,191,176
"221190203",178,149,327,104,122,104
"221190204",167,164,331,89,100,87
"221190205",311,296,607,164,175,158
"221190206",110,95,205,57,60,57
"221190207",44,38,82,23,29,22
"221190208",64,51,115,41,41,41
"221190301",75,48,123,47,55,47
"221190302",19,11,30,13,18,13
"221190303",41,18,59,26,36,26
"221260101",550,606,1156,283,302,279
"221260102",311,318,629,203,221,199
"221260103",254,245,499,160,181,157
"221260104",436,400,836,238,242,214
"221260105",330,364,694,193,199,175
"221260201",51,21,72,25,39,23
"221260202",190,144,334,111,150,107
"221260203",78,74,152,49,67,45
"221260204",80,84,164,46,56,43
"221260301",480,437,917,250,273,243
"221260302",92,73,165,48,62,48
"221260303",162,144,306,100,158,93
"221260304",269,312,581,172,252,167
"221260305",474,463,937,231,294,225
"221260306",37,38,75,25,47,25
"221260307",40,20,60,16,28,16
"221260308",36,28,64,19,30,19
"221260309",17,19,36,11,15,11
"221260310",29,29,58,18,23,17
"221260311",92,73,165,56,82,56
"221260312",389,406,795,206,211,202
"221260313",288,338,626,179,221,176
"221260314",450,520,970,303,352,297
"221260315",16,15,31,12,19,12
"221330101",414,427,841,218,217,197
"221330102",461,540,1001,305,321,276
"221330103",570,610,1180,318,336,312
"221330104",547,600,1147,327,342,317
"221330105",226,258,484,170,169,164
"221330106",520,572,1092,337,365,328
"221330107",251,249,500,170,196,166
"221330108",962,1027,1989,456,476,444
"221330109",757,772,1529,371,384,357
"221330110",325,362,687,186,188,176
"221330111",559,550,1109,272,273,257
"221330112",395,380,775,217,216,199
"221330113",335,335,670,178,209,177
"221330114",860,802,1662,376,387,365
"221330115",674,691,1365,347,384,342
"221330116",243,299,542,174,182,165
"221330117",261,265,526,145,160,144
"221330118",427,444,871,238,248,226
"221330119",567,554,1121,282,291,266
"221330120",380,443,823,249,269,235
"221330201",97,102,199,52,50,50
"221330202",243,201,444,105,120,100
"221330203",275,215,490,113,114,112
"221330204",46,51,97,23,25,23
"221330205",175,171,346,83,84,82
"221330206",196,160,356,81,86,81
"221330207",426,453,879,217,253,217
"221330208",110,117,227,53,83,51
"221330301",160,158,318,85,88,84
"221330302",220,237,457,110,125,109
"221330303",140,118,258,65,68,65
"221330304",155,137,292,59,71,59
"221330305",126,94,220,69,94,68
"221330306",83,67,150,44,56,43
"221330307",69,74,143,43,45,42
"221330308",153,117,270,65,66,62
"221330309",221,200,421,97,115,96
"221330401",193,170,363,101,121,94
"221330402",143,114,257,66,73,65
"221330403",86,60,146,43,47,43
"221330404",122,91,213,60,82,58
"221330405",169,133,302,77,81,77
"221330406",85,54,139,38,46,38
"221330407",10,8,18,5,7,4
"221330408",133,103,236,57,65,57
"221330409",6,7,13,5,9,5
"221330410",13,16,29,7,6,6
"221330411",233,199,432,121,128,113
"221330412",779,838,1617,353,344,331
"221330413",617,642,1259,312,337,306
"221330414",343,435,778,211,225,207
"221330415",296,288,584,134,137,128
"221330501",90,69,159,48,61,48
"221330502",662,641,1303,272,55,44
"221330503",126,108,234,57,57,57
"221330504",56,47,103,32,36,32
"221330505",122,110,232,53,64,52
"221330506",19,18,37,17,19,15
"221330507",35,34,69,18,21,18
"221330508",43,34,77,22,30,21
"221400101",264,270,534,133,110,93
"221400102",930,908,1838,407,396,380
"221400103",242,291,533,174,179,159
"221400104",429,488,917,310,332,297
"221400105",386,390,776,237,236,212
"221400106",641,613,1254,288,274,263
"221400107",662,678,1340,358,336,308
"221400108",194,186,380,123,133,119
"221400109",568,550,1118,292,302,284
"221400110",343,392,735,202,206,188
"221400111",626,721,1347,381,381,358
"221400112",449,463,912,258,264,240
"221400113",483,454,937,239,237,228
"221400114",191,179,370,111,124,99
"221400115",364,406,770,230,234,218
"221400116",397,393,790,200,206,197
"221400117",495,491,986,238,238,230
"221400118",391,392,783,217,216,187
"221400201",318,396,714,237,275,225
"221400202",314,403,717,268,304,253
"221400203",441,520,961,294,314,272
"221400204",571,650,1221,335,350,314
"221400205",332,370,702,224,256,219
"221400206",574,635,1209,368,415,354
"221400207",687,667,1354,355,360,342
"221400208",583,600,1183,302,309,273
"221400209",381,397,778,219,205,183
"221400210",577,612,1189,339,348,315
"221400211",509,487,996,270,290,264
"221400301",264,336,600,207,280,200
"221400302",253,320,573,201,269,189
"221400303",312,408,720,281,347,257
"221400304",306,344,650,251,397,251
"221400305",314,399,713,272,351,269
"221400306",262,357,619,214,258,207
"221400307",258,315,573,202,249,194
"221400308",345,396,741,232,277,230
"221400309",400,478,878,250,254,231
"221400310",289,358,647,209,219,193
"221400311",377,434,811,234,264,222
"221400312",658,637,1295,335,357,324
"221400313",774,786,1560,367,369,346
"221400401",175,195,370,128,237,126
"221400402",251,289,540,185,236,172
"221400403",249,288,537,228,337,220
"221400404",302,337,639,273,347,263
"221400405",319,389,708,270,321,249
"221400406",266,348,614,224,336,221
"221400407",322,388,710,267,325,254
"221400408",296,368,664,204,320,189
"221400409",366,499,865,288,307,260
"221400410",323,367,690,219,235,197
"221400411",472,525,997,291,271,245
"221400412",464,519,983,294,312,277
"221400413",214,243,457,163,160,126
"221400414",451,447,898,255,266,242
"221400415",211,247,458,139,150,130
"221400416",289,330,619,201,218,189
"221400417",106,111,217,71,82,68
"221400418",215,241,456,136,140,125
"221400501",335,376,711,236,250,210
"221400502",436,523,959,217,218,189
"221400503",302,346,648,228,269,221
"221400504",326,412,738,241,182,165
"221400505",715,801,1516,402,327,305
"221400506",428,457,885,277,242,203
"221400507",488,502,990,296,303,274
"221400508",672,658,1330,338,336,311
"221400509",362,378,740,211,218,203
"221400510",422,448,870,246,257,218
"221400511",421,457,878,233,237,222
"221400512",572,586,1158,302,246,226
"221400513",657,679,1336,312,307,290
"221400514",504,522,1026,256,262,250
"221400601",746,727,1473,377,418,353
"221400602",357,406,763,253,269,245
"221400603",444,437,881,279,296,270
"221400604",354,397,751,241,244,227
"221400605",574,585,1159,308,312,294
"221400606",691,740,1431,387,367,350
"221400607",348,381,729,211,218,200
"221400608",749,874,1623,405,397,386
"221400609",703,737,1440,375,372,363
"221400610",626,704,1330,337,333,326
"221400611",511,538,1049,283,282,268
"221400612",332,336,668,165,184,158
"221400701",380,391,771,257,273,250
"221400702",508,577,1085,329,309,295
"221400703",469,477,946,299,280,272
"221400704",436,448,884,240,230,220
"221400705",388,439,827,234,221,210
"221400706",536,608,1144,335,295,288
"221400707",313,368,681,211,200,188
"221400708",454,482,936,265,255,244
"221400709",417,429,846,209,126,120
"221400710",419,458,877,234,224,220
"221400711",383,411,794,214,209,197
"221400712",326,373,699,195,192,182
"221400713",251,328,579,180,172,165
"221400714",553,592,1145,295,239,235
"221400715",298,328,626,193,206,169
"221400716",470,544,1014,287,307,263
"221400717",285,290,575,164,158,145
"221400718",539,586,1125,302,283,269
"221400719",401,454,855,219,233,212
"221400720",424,393,817,208,215,201
"221400721",475,461,936,255,258,239
"221400722",13,12,25,10,16,10
"221400723",522,534,1056,251,255,232
"221400724",614,651,1265,328,309,294
"221400725",415,434,849,250,219,203
"221400726",446,471,917,243,249,235
"221400727",592,581,1173,269,272,259
"221400728",387,393,780,193,196,181
"221400729",267,282,549,153,164,148
"221400801",236,344,580,260,454,251
"221400802",334,451,785,255,323,242
"221400803",438,524,962,256,311,230
"221400804",152,191,343,122,172,120
"221400805",276,310,586,205,224,178
"221400806",236,261,497,214,297,198
"221400807",295,371,666,259,356,251
"221400808",324,431,755,308,337,283
"221400809",148,174,322,148,209,143
"221400810",476,539,1015,289,292,267
"221400811",445,480,925,238,218,203
"221400812",169,228,397,177,201,151
"221400813",269,332,601,239,266,227
"221400814",357,432,789,293,367,288
"221400815",275,359,634,281,349,268
"221400816",157,183,340,120,149,118
"221400817",208,221,429,184,244,181
"221400818",141,138,279,167,268,166
"221400901",314,337,651,232,308,226
"221400902",784,847,1631,397,415,374
"221400903",968,564,1532,322,325,307
"221400904",530,580,1110,331,325,289
"221400905",451,389,840,308,312,254
"221400906",579,644,1223,359,369,354
"221400907",509,534,1043,270,284,259
"221400908",493,493,986,257,276,248
"221400909",485,517,1002,275,276,261
"221400910",617,697,1314,358,384,347
"221400911",405,447,852,253,274,249
"221400912",307,357,664,182,184,172
"221400913",572,641,1213,352,379,346
"221400914",603,646,1249,399,467,391
"221400915",563,609,1172,353,380,342
"221400916",402,556,958,341,307,268
"221400917",466,461,927,222,216,210
"221400918",424,476,900,226,242,220
"221401001",524,579,1103,306,303,267
"221401002",338,348,686,200,198,174
"221401003",515,544,1059,283,283,263
"221401004",631,680,1311,366,384,345
"221401005",440,546,986,306,341,300
"221401006",623,610,1233,329,325,305
"221401007",686,690,1376,369,397,360
"221401008",455,468,923,259,261,237
"221401009",725,766,1491,386,396,363
"221401010",402,469,871,259,245,218
"221401011",450,507,957,265,285,262
"221401012",433,426,859,248,227,218
"221401013",432,443,875,264,347,257
"221401014",511,498,1009,275,312,268
"221401015",510,500,1010,260,275,254
"221401017",568,582,1150,277,286,270
"221401018",511,530,1041,263,276,231
"221401019",403,372,775,205,210,199
"221401020",626,645,1271,287,296,282
"221401021",420,440,860,220,244,217
"221401022",466,479,945,235,259,235
"221401101",243,333,576,261,292,243
"221401102",275,353,628,303,335,293
"221401103",297,373,670,266,341,263
"221401104",559,617,1176,412,413,381
"221401105",307,356,663,224,264,205
"221401106",309,392,701,205,209,188
"221401107",315,374,689,247,253,224
"221401108",276,309,585,209,257,208
"221401109",281,321,602,168,155,134
"221401110",306,314,620,198,228,193
"221401111",473,583,1056,299,321,262
"221401112",323,371,694,285,344,275
"221401113",244,296,540,182,211,177
"221401114",313,351,664,220,252,212
"221401115",295,322,617,220,221,188
"221401201",182,252,434,178,227,176
"221401202",233,300,533,189,278,187
"221401203",213,330,543,224,350,212
"221401204",283,356,639,247,322,235
"221401205",251,369,620,206,261,198
"221401206",305,366,671,264,343,260
"221401207",289,378,667,249,308,241
"221401208",388,512,900,345,376,322
"221401209",224,270,494,159,193,148
"221401210",427,548,975,373,470,368
"221401211",521,605,1126,349,404,332
"221401212",279,311,590,186,199,178
"221401213",560,649,1209,394,414,379
"221401214",347,384,731,210,233,195
"221401215",735,798,1533,432,454,404
"221401216",157,207,364,159,192,122
"221401217",641,708,1349,360,386,356
"221401301",306,316,622,213,229,190
"221401302",334,409,743,265,305,258
"221401303",314,382,696,254,285,234
"221401304",339,413,752,250,226,205
"221401305",468,490,958,275,266,238
"221401306",284,338,622,212,255,200
"221401307",385,465,850,283,296,259
"221401308",609,682,1291,393,392,360
"221401309",248,277,525,162,168,158
"221401310",275,341,616,178,190,165
"221401311",375,398,773,214,209,201
"221401312",303,362,665,191,174,160
"221401313",455,477,932,229,219,214
"221401314",350,406,756,204,192,180
"221401315",87,75,162,61,490,49
"221401401",236,254,490,141,163,139
"221401402",336,357,693,219,224,205
"221401403",417,541,958,292,304,275
"221401404",404,463,867,266,299,258
"221401405",357,343,700,191,209,189
"221401406",562,620,1182,366,378,355
"221401407",379,422,801,230,194,179
"221401408",345,398,743,214,226,199
"221401409",270,354,624,193,206,189
"221401410",288,326,614,181,201,174
"221401411",452,475,927,244,198,181
"221401412",150,198,348,101,122,99
"221401413",257,293,550,171,181,166
"221401501",451,523,974,312,330,304
"221401502",394,527,921,233,110,97
"221401503",383,470,853,304,360,299
"221401504",387,463,850,260,268,246
"221401505",285,328,613,197,211,172
"221401506",562,669,1231,364,390,352
"221401507",449,546,995,283,300,275
"221401508",424,478,902,277,277,232
"221401509",295,351,646,192,217,186
"221401510",517,645,1162,342,365,330
"221401601",532,497,1029,254,267,232
"221401602",169,197,366,108,122,103
"221401603",299,411,710,219,223,190
"221401604",539,606,1145,379,304,288
"221401605",470,525,995,302,288,267
"221401606",505,528,1033,295,283,275
"221401607",253,326,579,246,222,210
"221401608",343,364,707,191,217,185
"221401609",713,711,1424,392,433,378
"221401610",453,502,955,277,263,198
"221401611",204,221,425,125,134,118
"221401612",361,422,783,220,226,220
"221401613",258,273,531,158,177,138
"221401614",224,269,493,129,145,128
"221401615",306,342,648,215,237,213
"221401616",512,530,1042,285,307,276
"221401617",438,446,884,235,243,226
"221401618",529,607,1136,300,337,292
"221401619",444,504,948,258,280,253
"221401620",478,499,977,223,232,216
"221401621",554,560,1114,284,294,280
"221401622",79,91,170,52,63,48
"221401623",129,163,292,79,82,77
"221401624",99,104,203,61,65,56
"221401625",330,341,671,186,214,183
"221401701",297,284,581,165,173,155
"221401702",491,511,1002,307,327,294
"221401703",689,696,1385,370,399,338
"221401704",438,429,867,262,273,243
"221401705",653,666,1319,379,406,369
"221401706",700,780,1480,347,359,325
"221401707",465,451,916,229,224,215
"221401708",462,396,858,194,191,180
"221401709",315,318,633,189,197,182
"221401710",402,403,805,187,199,184
"221401801",427,465,892,254,254,247
"221401802",586,709,1295,328,343,326
"221401803",467,467,934,215,213,205
"221401804",519,519,1038,253,244,229
"221401805",405,438,843,222,225,214
"221401806",615,626,1241,317,314,306
"221401807",550,641,1191,333,329,304
"221401808",476,456,932,264,270,248
"221401809",422,461,883,240,252,231
"221401810",500,523,1023,257,260,245
"221401811",483,507,990,239,230,212
"221401812",343,354,697,199,189,181
"221401813",394,416,810,234,230,217
"221401814",386,458,844,229,220,216
"221401815",400,395,795,203,204,186
"221401816",874,882,1756,396,395,368
"221401817",314,311,625,186,193,179
"221401818",9,8,17,9,23,9
"221401819",563,545,1108,270,279,265
"221401820",409,438,847,250,281,242
"221401821",362,382,744,193,207,187
"221401901",651,709,1360,386,407,368
"221401902",138,125,263,84,81,73
"221401903",313,378,691,208,205,187
"221401904",599,658,1257,349,380,339
"221401905",248,297,545,164,196,154
"221401906",349,389,738,213,217,201
"221401907",545,618,1163,339,357,317
"221401908",364,355,719,199,201,190
"221401909",338,392,730,225,217,203
"221401910",247,300,547,160,175,153
"221401911",305,360,665,214,221,196
"221401912",372,424,796,229,235,212
"221401913",383,421,804,212,217,197
"221401914",319,354,673,165,182,161
"221401915",318,354,672,196,204,191
"221401916",372,420,792,221,237,211
"221402001",382,388,770,230,242,212
"221402002",513,568,1081,306,309,282
"221402003",279,346,625,195,190,183
"221402004",491,519,1010,276,278,265
"221402005",740,736,1476,394,383,367
"221402006",674,675,1349,359,372,353
"221402007",503,491,994,254,245,230
"221402008",432,453,885,237,228,217
"221402009",459,531,990,269,287,260
"221402010",363,390,753,213,226,210
"221402011",356,365,721,199,207,194
"221402101",577,608,1185,301,303,293
"221402102",479,492,971,266,262,257
"221402103",460,506,966,268,273,223
"221402104",255,254,509,144,147,137
"221402105",693,700,1393,379,385,367
"221402106",961,999,1960,502,491,444
"221402107",158,129,287,64,59,56
"221402108",520,487,1007,255,277,248
"221402109",104,89,193,44,44,44
"221402201",41,26,67,25,45,25
"221402202",56,34,90,33,46,33
"221402203",110,101,211,59,84,58
"221402204",25,15,40,17,20,17
"221402205",95,61,156,45,49,45
"221402206",75,40,115,41,43,41
"221402301",12,5,17,5,10,5
"221402302",5,4,9,2,3,2
"221402303",35,17,52,16,24,16
"221402304",238,208,446,117,144,117
"221402305",30,21,51,19,21,19
"221402401",347,327,674,199,217,189
"221402402",18,18,36,10,12,9
"221402403",42,39,81,29,35,29
"221402404",415,458,873,257,275,243
"221402405",87,78,165,50,72,49
"221402406",164,178,342,90,101,88
"221402407",2,0,2,2,4,2
"221402408",14,7,21,6,10,6
"221402409",120,98,218,58,62,56
"221402410",157,155,312,78,93,77
"221402411",350,345,695,176,193,173
"221402501",672,719,1391,306,315,293
"221402502",528,598,1126,286,308,283
"221402503",819,794,1613,434,470,396
"221402504",626,651,1277,355,400,343
"221402505",938,959,1897,494,580,483
"221402506",483,416,899,202,230,201
"221402507",155,110,265,87,123,84
"221402508",743,719,1462,332,325,308
"221402509",570,604,1174,277,246,237
"221402510",655,664,1319,340,372,335
"221402511",885,878,1763,430,437,417
"221402512",715,718,1433,360,402,347
"221402513",267,265,532,153,187,148
"221402514",135,132,267,70,62,57
"221402515",226,230,456,130,154,130
"221402516",367,366,733,164,166,156
"221402517",191,194,385,117,132,115
"221402518",427,467,894,236,245,214
"221402601",438,430,868,218,225,213
"221402602",626,617,1243,311,294,273
"221402603",570,611,1181,310,311,298
"221402604",499,483,982,264,228,194
"221402605",502,489,991,256,261,244
"221402606",447,472,919,220,233,207
"221402607",712,745,1457,363,416,360
"221402608",676,714,1390,349,369,346
"221402609",314,310,624,171,183,166
"221402701",559,582,1141,322,342,311
"221402702",547,610,1157,333,358,327
"221402703",512,528,1040,247,243,224
"221402704",674,643,1317,291,276,260
"221402705",660,648,1308,311,289,268
"221402706",505,519,1024,226,207,202
"221402707",838,911,1749,388,374,357
"221402708",548,599,1147,264,261,253
"221402709",504,530,1034,233,244,225
"221402710",282,344,626,179,189,177
"221402711",615,618,1233,322,321,289
"221402712",398,454,852,243,264,242
"221402713",437,481,918,242,252,239
"221402714",897,977,1874,466,463,440
"221402715",562,653,1215,316,296,281
"221402716",730,816,1546,371,378,354
"221402717",666,670,1336,352,363,345
"221402718",609,645,1254,334,347,329
"221402719",707,741,1448,356,352,325
"221402720",455,419,874,255,288,230
"221402721",432,462,894,242,263,236
"221402722",505,489,994,284,355,277
"221402723",414,390,804,219,240,213
"221402724",277,278,555,152,138,131
"221402725",318,341,659,199,246,181
"221402726",424,405,829,205,180,156
"221402801",559,628,1187,331,359,320
"221402802",533,612,1145,316,296,285
"221402803",369,397,766,217,230,212
"221402804",455,526,981,285,261,248
"221402805",718,792,1510,392,421,382
"221402806",364,365,729,202,243,200
"221402807",292,333,625,134,137,132
"221402808",879,963,1842,405,389,376
"221402809",464,502,966,249,263,247
"221402810",571,659,1230,359,392,339
"221402811",538,622,1160,300,300,279
"221402901",332,341,673,186,192,171
"221402902",402,399,801,223,258,212
"221402903",477,440,917,251,275,246
"221402904",528,542,1070,280,294,276
"221402905",500,486,986,270,291,267
"221402906",1033,541,1574,281,286,257
"221402907",234,218,452,118,139,110
"221402908",523,587,1110,289,310,280
"221402909",583,681,1264,339,342,325
"221402910",746,811,1557,386,411,376
"221402911",605,625,1230,321,329,309
"221402912",284,321,605,161,175,159
"221402913",425,486,911,249,266,245
"221402914",505,559,1064,289,265,230
"221402915",556,544,1100,272,288,264
"221402916",380,385,765,207,166,154
"221402919",336,336,672,188,160,154
"221402920",414,416,830,224,222,199
"221403001",436,452,888,242,269,239
"221403002",407,411,818,227,230,209
"221403003",828,750,1578,381,357,321
"221403004",439,483,922,221,222,216
"221403005",823,852,1675,396,390,363
"221403006",263,312,575,163,185,159
"221403007",667,762,1429,402,430,383
"221403008",226,216,442,117,115,108
"221403009",695,635,1330,337,326,313
"221403010",274,291,565,145,152,140
"221403011",499,524,1023,232,240,224
"221403012",377,380,757,198,202,181
"221403013",267,257,524,130,156,128
"221470101",139,116,255,62,59,54
"221470102",39,31,70,17,23,13
"221470103",81,59,140,41,46,41
"221470104",128,90,218,65,75,65
"221470105",224,195,419,112,98,90
"221470106",258,210,468,133,132,122
"221470107",81,72,153,44,53,44
"221470108",84,55,139,45,46,45
"221470201",644,685,1329,365,397,337
"221470202",266,330,596,191,235,181
"221470203",513,524,1037,306,363,306
"221470204",325,350,675,175,202,170
"221470205",260,256,516,167,167,143
"221470206",542,592,1134,296,325,291
"221470301",777,767,1544,391,465,374
"221470302",89,73,162,50,61,48
"221470303",218,176,394,101,106,96
"221470304",66,59,125,39,43,36
"221470305",931,1012,1943,471,541,444
"221470306",704,746,1450,365,405,349
"221470307",177,166,343,85,91,72
"221470401",498,504,1002,281,314,273
"221470402",159,168,327,99,110,99
"221470403",98,58,156,54,45,29
"221470404",60,47,107,37,47,37
"221540101",640,623,1263,365,435,356
"221540102",523,433,956,256,277,212
"221540103",229,160,389,104,124,104
"221540104",261,261,522,153,193,148
"221540105",523,576,1099,320,380,315
"221540106",245,242,487,119,140,119
"221540201",513,539,1052,273,323,242
"221540202",584,612,1196,353,412,351
"221540203",65,48,113,30,33,30
"221540204",320,226,546,165,185,165
"221540205",69,57,126,37,47,34
"221540206",524,510,1034,265,225,192
"221540301",427,439,866,242,269,237
"221540302",688,692,1380,345,393,334
"221540303",191,174,365,100,103,86
"221540304",132,116,248,61,54,47
"221540305",250,241,491,124,110,81
"221540306",57,36,93,30,46,30
"221540307",638,666,1304,367,432,353
"221540308",186,166,352,95,98,73
"221540309",331,318,649,201,245,200
"221540310",200,136,336,106,139,104
"221540311",519,503,1022,256,284,255
"221610101",83,55,138,51,53,51
"221610102",83,72,155,50,38,23
"221610103",30,22,52,18,26,18
"221610201",659,664,1323,342,372,333
"221610202",124,82,206,66,90,62
"221610203",51,43,94,29,64,29
"221610301",745,774,1519,399,505,398
"221610302",130,112,242,64,75,62
"221610303",29,20,49,15,34,15
"221610304",37,9,46,21,48,21
"221610305",54,28,82,30,49,30
"221610401",89,80,169,61,91,61
"221610402",12,10,22,10,29,10
"221680101",459,551,1010,341,380,333
"221680102",376,432,808,258,283,248
"221680103",585,581,1166,265,287,256
"221680104",552,540,1092,291,300,269
"221680105",381,411,792,266,291,258
"221680106",395,445,840,277,300,267
"221680107",1047,1087,2134,547,512,454
"221680108",693,656,1349,304,350,301
"221680109",607,624,1231,289,307,282
"221680110",620,659,1279,334,344,319
"221680111",323,350,673,158,193,156
"221680112",600,595,1195,325,343,315
"221680113",611,681,1292,334,366,320
"221680114",579,576,1155,275,281,247
"221680115",492,465,957,224,255,216
"221680116",417,394,811,188,205,186
"221680117",352,402,754,201,214,198
"221680201",111,104,215,52,47,47
"221680202",173,131,304,80,82,80
"221680203",76,65,141,42,55,41
"221680204",82,73,155,41,43,40
"221680205",136,120,256,66,70,66
"221680206",45,37,82,23,30,23
"221680207",137,118,255,64,35,30
"221680301",125,90,215,60,63,59
"221680302",194,150,344,93,64,57
"221680303",52,55,107,18,18,18
"221680304",85,60,145,40,55,40
"221680305",61,50,111,34,45,34
"221680306",124,92,216,63,81,63
"221680307",78,73,151,51,75,50
"221680308",78,68,146,51,60,50
"221680309",746,742,1488,392,225,192
"221680310",1005,977,1982,493,420,348
"221680401",196,184,380,82,67,53
"221680402",414,344,758,158,173,153
"221680403",358,320,678,140,143,140
"221680404",146,126,272,60,81,60
"221680405",162,165,327,69,74,69
"221680406",167,136,303,89,93,89
"221680407",95,75,170,48,26,26
"221680408",122,82,204,59,69,59
"221680409",634,638,1272,287,258,246
"260070101",59,16,75,29,29,18
"260070201",91,36,127,42,65,40
"260070202",308,257,565,156,153,150
"260070301",83,23,106,56,36,23
"260070302",14,1,15,11,21,11
"260070303",30,24,54,27,71,27
"260070304",320,306,626,203,200,128
"260070401",497,589,1086,295,504,281
"260070402",374,338,712,235,253,219
"260070403",358,335,693,268,302,255
"260070404",432,421,853,275,277,244
"260070405",572,558,1130,336,345,309
"260070406",447,443,890,227,209,194
"260070407",760,739,1499,433,488,430
"260070408",187,185,372,106,119,103
"260070409",362,364,726,235,259,230
"260070410",307,332,639,210,261,208
"260070411",292,315,607,200,184,158
"260070412",634,684,1318,362,401,328
"260070413",46,22,68,30,90,29
"260070414",15,14,29,11,34,10
"260070501",701,665,1366,327,293,273
"260070502",523,516,1039,285,282,264
"260070503",676,686,1362,324,288,272
"260070504",370,370,740,206,224,170
"260070505",496,521,1017,231,186,165
"260070506",482,486,968,238,253,231
"260070507",486,533,1019,249,255,243
"260070508",590,571,1161,272,250,225
"260070509",504,474,978,266,239,227
"260070510",794,771,1565,391,365,356
"260070511",524,535,1059,275,256,238
"260070601",623,646,1269,356,356,331
"260070602",338,379,717,229,251,228
"260070603",451,402,853,285,291,273
"260070604",617,644,1261,377,406,364
"260070605",734,717,1451,397,410,372
"260070606",377,407,784,225,205,181
"260070607",585,598,1183,306,308,292
"260070608",652,653,1305,340,340,304
"260070609",671,676,1347,389,366,333
"260070610",588,623,1211,344,385,324
"260070611",255,251,506,136,130,119
"260070612",584,629,1213,403,484,396
"260070613",295,366,661,185,320,182
"260070614",392,427,819,307,397,298
"260070615",542,554,1096,364,398,332
"260070701",133,131,264,75,86,73
"260070702",416,458,874,232,240,226
"260070703",579,577,1156,255,257,246
"260070704",753,703,1456,348,346,324
"260070705",539,549,1088,287,313,265
"260070706",395,379,774,193,224,188
"260070707",767,701,1468,354,362,319
"260070708",763,759,1522,343,364,338
"260070709",656,642,1298,324,318,308
"260070710",567,638,1205,281,280,265
"260070711",483,511,994,239,242,236
"260070712",493,418,911,249,273,248
"260070801",388,413,801,260,303,255
"260070802",705,758,1463,455,487,434
"260070803",405,395,800,250,293,246
"260070804",574,549,1123,330,383,318
"260070805",513,496,1009,294,339,282
"260070806",769,715,1484,457,505,435
"260070807",352,341,693,206,216,195
"260070808",379,334,713,218,267,204
"260070809",367,347,714,210,245,209
"260070810",363,360,723,217,291,215
"260070811",678,693,1371,422,477,418
"260070812",631,656,1287,339,373,325
"260070813",428,424,852,271,296,258
"260070901",437,496,933,335,406,328
"260070902",387,431,818,319,405,316
"260070903",614,681,1295,445,512,435
"260070904",414,441,855,301,342,293
"260070905",365,421,786,315,368,311
"260070906",351,374,725,280,336,276
"260070907",459,452,911,320,415,314
"260070908",457,476,933,317,431,315
"260070909",223,235,458,156,223,156
"260070910",321,331,652,214,265,213
"260071001",151,149,300,88,186,88
"260071002",436,460,896,345,520,342
"260071003",139,143,282,133,265,131
"260071004",269,292,561,182,277,179
"260071005",318,335,653,253,329,245
"260071006",331,345,676,249,295,246
"260071007",336,390,726,283,370,275
"260071008",280,313,593,211,321,207
"260071009",317,361,678,231,313,223
"260071010",562,597,1159,376,476,344
"260071011",294,297,591,233,327,232
"260071012",244,274,518,182,242,182
"260071013",347,354,701,140,208,139
"260140101",49,18,67,47,49,47
"260140102",45,31,76,37,41,37
"260140103",119,134,253,74,103,72
"260140104",390,409,799,237,268,227
"260140105",425,463,888,286,329,276
"260140106",402,439,841,246,293,240
"260140107",384,399,783,197,212,191
"260140108",344,356,700,237,292,234
"260140201",6,5,11,3,7,3
"260140202",75,41,116,22,19,13
"260140203",11,7,18,7,10,7
"260140204",6,1,7,6,6,6
"260140205",4,1,5,3,8,2
"260140206",0,3,3,1,5,1
"260140207",10,4,14,10,10,10
"260140208",5,4,9,4,10,4
"260140209",10,5,15,5,7,5
"260140301",126,91,217,77,93,76
"260140302",68,58,126,46,51,46
"260140303",354,386,740,227,289,226
"260140304",27,25,52,26,37,24
"260140305",79,68,147,55,79,55
"260140306",53,42,95,42,62,42
"260140307",73,76,149,45,46,36
"260140401",71,49,120,55,84,54
"260140501",12,13,25,10,31,10
"260140601",27,12,39,18,15,8
"260140701",25,17,42,21,36,20
"260140702",63,46,109,50,64,50
"260140703",6,4,10,3,5,3
"260140704",51,39,90,43,40,17
"260140705",575,608,1183,373,454,327
"260140801",312,258,570,189,283,183
"260140802",50,16,66,28,52,13
"260140803",457,456,913,268,352,262
"260140804",365,380,745,247,311,241
"260140901",1480,1429,2909,945,839,598
"260140902",63,31,94,27,36,27
"260140903",386,408,794,230,262,221
"260140904",391,412,803,254,328,249
"260140905",354,357,711,236,299,232
"260140906",399,422,821,255,350,239
"260141001",114,76,190,65,112,64
"260141002",67,51,118,47,59,39
"260141003",207,185,392,145,131,96
"260141004",493,545,1038,327,288,232
"260141101",24,35,59,25,21,17
"260141102",765,705,1470,462,603,440
"260141103",425,421,846,272,344,269
"260141104",315,316,631,179,230,177
"260210101",53,7,60,32,53,31
"260210102",29,36,65,22,28,21
"260210103",61,13,74,27,33,27
"260210104",16,9,25,13,90,13
"260210201",34,33,67,26,15,15
"260210202",67,12,79,50,63,42
"260210203",16,5,21,13,13,13
"260210204",672,645,1317,375,392,365
"260210301",103,14,117,29,42,28
"260210302",14,2,16,9,15,9
"260210401",2,0,2,2,7,2
"260210402",109,116,225,67,93,63
"260210403",125,136,261,82,137,81
"260210404",455,452,907,281,324,277
"260210405",419,434,853,274,349,268
"260210406",475,487,962,317,382,312
"260210407",605,638,1243,347,359,327
"260210408",371,370,741,220,267,212
"260210409",368,367,735,241,262,228
"260210410",353,375,728,245,309,239
"260210411",261,261,522,196,258,193
"260210412",297,292,589,193,233,185
"260210413",325,324,649,232,327,226
"260210414",341,342,683,215,249,202
"260210501",16,9,25,12,13,10
"260210502",428,424,852,228,237,223
"260210503",216,199,415,111,123,111
"260210504",5,2,7,2,2,2
"260210505",552,554,1106,312,319,289
"260210506",446,479,925,288,326,280
"260210507",373,369,742,245,252,228
"260210508",199,208,407,133,153,127
"260210509",378,404,782,207,235,205
"260210510",491,474,965,248,249,240
"260210511",501,586,1087,276,276,268
"260210512",598,620,1218,320,349,308
"260210513",762,752,1514,442,456,407
"260210514",807,819,1626,473,462,399
"260210515",774,637,1411,407,416,390
"260210516",453,496,949,237,241,228
"260210517",476,501,977,242,247,231
"260210518",572,543,1115,293,335,287
"260210601",182,159,341,108,135,105
"260210602",329,268,597,194,372,189
"260210603",191,130,321,73,77,71
"260210604",475,483,958,277,303,272
"260210605",612,563,1175,367,397,353
"260210606",488,474,962,279,300,274
"260210607",557,580,1137,334,374,329
"260210608",813,809,1622,449,505,436
"260210609",697,655,1352,336,345,321
"260210610",709,707,1416,384,378,355
"260210611",530,501,1031,351,394,337
"260210612",401,399,800,279,335,268
"260210613",284,306,590,196,241,194
"260210614",391,399,790,267,325,254
"260210615",351,338,689,251,467,245
"260210701",48,32,80,39,36,20
"260210702",382,289,671,241,315,236
"260210703",154,137,291,83,79,78
"260210704",796,770,1566,440,465,425
"260210705",186,173,359,106,123,105
"260210706",391,380,771,230,233,215
"260210707",421,455,876,251,255,228
"260210708",412,369,781,220,247,209
"260210709",627,608,1235,337,303,290
"260210710",530,505,1035,278,282,264
"260210711",318,311,629,178,178,162
"260210712",468,492,960,271,268,257
"260210801",41,48,89,30,35,30
"260210802",613,635,1248,442,484,408
"260210803",64,76,140,48,56,44
"260210804",261,262,523,141,166,134
"260210805",315,329,644,225,229,197
"260210806",276,298,574,207,242,203
"260210807",495,487,982,372,438,359
"260210808",354,378,732,267,329,264
"260210809",231,241,472,147,180,144
"260210810",482,460,942,301,352,294
"260210811",185,149,334,53,40,32
"260210812",520,530,1050,321,318,285
"260210813",189,193,382,114,128,113
"260210814",611,655,1266,390,443,369
"260210815",612,637,1249,402,418,365
"260210901",445,422,867,307,306,243
"260210902",210,253,463,212,267,206
"260210903",288,292,580,215,317,212
"260210904",138,146,284,126,259,125
"260210905",247,280,527,186,269,183
"260210906",145,183,328,152,234,151
"260210907",235,265,500,203,300,188
"260210908",288,291,579,256,379,247
"260210909",377,368,745,223,272,217
"260210910",189,211,400,147,201,145
"260210911",363,368,731,287,381,285
"260210912",200,211,411,154,187,148
"260210913",152,175,327,128,180,120
"260210914",228,241,469,185,249,182
"260211001",463,399,862,336,454,333
"260211002",331,293,624,272,443,262
"260211003",372,384,756,326,448,322
"260211004",290,286,576,235,310,227
"260211005",187,209,396,149,164,139
"260211006",258,298,556,190,194,155
"260211007",274,250,524,177,210,164
"260211008",286,285,571,206,245,195
"260211009",242,221,463,170,214,164
"260211010",304,312,616,215,262,202
"260211011",184,222,406,105,147,104
"260211012",536,534,1070,476,637,472
"260211013",414,400,814,316,368,305
"260211101",285,258,543,140,174,139
"260211102",415,437,852,264,269,248
"260211103",186,183,369,138,140,135
"260211104",715,552,1267,371,346,329
"260211105",259,269,528,179,186,158
"260211106",345,374,719,215,212,197
"260211107",607,583,1190,327,345,308
"260211108",603,648,1251,396,382,337
"260211109",412,477,889,303,332,288
"260211110",492,484,976,315,340,306
"260211111",434,435,869,279,299,272
"260211112",250,260,510,181,226,180
"260211113",503,500,1003,322,276,255
"260211114",340,361,701,235,258,229
"260211115",302,308,610,188,201,176
"260211116",360,388,748,245,289,243
"260211117",312,331,643,219,240,208
"260211201",656,618,1274,323,280,255
"260211202",421,422,843,231,212,201
"260211203",620,586,1206,334,308,283
"260211204",635,615,1250,367,385,357
"260211205",317,288,605,178,161,147
"260211206",545,561,1106,341,308,276
"260211207",547,569,1116,347,332,284
"260211208",483,442,925,277,305,268
"260211209",540,504,1044,319,263,241
"260211210",261,230,491,170,149,136
"260211301",544,517,1061,325,339,319
"260211302",745,725,1470,410,354,328
"260211303",378,389,767,236,238,230
"260211304",353,385,738,231,248,218
"260211305",621,613,1234,379,341,310
"260211306",386,368,754,265,254,230
"260211307",314,317,631,194,182,168
"260211308",337,373,710,218,227,216
"260211309",477,436,913,271,266,255
"260211310",412,386,798,271,252,234
"260211311",318,304,622,209,193,161
"260211312",612,632,1244,424,432,392
"260211401",566,606,1172,397,429,366
"260211402",384,454,838,297,316,280
"260211403",344,360,704,232,248,226
"260211404",533,515,1048,356,379,331
"260211405",354,360,714,240,279,233
"260211406",408,460,868,332,343,306
"260211407",567,647,1214,419,497,415
"260211408",301,357,658,244,269,237
"260211409",393,400,793,235,274,223
"260211410",254,269,523,178,203,172
"260211411",373,373,746,255,269,242
"260211412",390,432,822,298,368,292
"260211413",555,492,1047,339,334,305
"260211501",382,387,769,234,219,210
"260211502",569,579,1148,321,292,284
"260211503",558,559,1117,331,329,320
"260211504",454,518,972,306,292,272
"260211505",408,418,826,236,181,177
"260211506",475,504,979,284,272,256
"260211507",360,380,740,239,223,205
"260211508",372,403,775,233,228,224
"260211509",339,341,680,225,227,214
"260211510",604,574,1178,287,293,283
"260211511",693,680,1373,340,262,250
"260211601",709,665,1374,352,360,329
"260211602",197,194,391,111,112,107
"260211603",365,340,705,198,192,175
"260211604",384,366,750,203,170,166
"260211605",618,601,1219,335,281,269
"260211606",504,441,945,257,207,203
"260211607",496,453,949,289,284,258
"260211608",570,515,1085,285,271,257
"260211609",643,665,1308,324,315,301
"260211610",752,750,1502,381,399,360
"260211611",409,451,860,256,281,247
"260211612",376,364,740,210,235,205
"260211613",728,722,1450,391,398,374
"260211614",350,361,711,190,190,183
"260211615",424,401,825,216,272,207
"260211701",133,108,241,77,109,76
"260211702",636,572,1208,309,339,295
"260211703",318,263,581,179,211,157
"260211704",494,466,960,261,299,244
"260211705",574,578,1152,286,282,246
"260211706",504,520,1024,294,336,276
"260211707",384,398,782,210,244,203
"260211708",615,618,1233,303,342,286
"260211709",812,804,1616,407,372,332
"260211710",490,525,1015,264,309,252
"260211711",810,710,1520,420,387,373
"260211712",602,575,1177,295,280,243
"260211713",359,321,680,157,167,152
"260211714",593,633,1226,327,328,310
"260211801",299,250,549,188,353,182
"260211802",378,330,708,219,325,211
"260211803",523,512,1035,265,325,256
"260211804",510,538,1048,280,285,268
"260211805",514,497,1011,246,239,218
"260211806",397,362,759,191,166,155
"260211807",347,321,668,183,192,168
"260211808",598,571,1169,304,262,245
"260211809",632,622,1254,375,403,353
"260211810",364,341,705,231,249,228
"260211811",443,452,895,302,317,288
"260211812",368,366,734,221,260,219
"260211813",348,355,703,223,245,221
"260211901",319,283,602,196,212,189
"260211902",435,471,906,303,314,281
"260211903",628,558,1186,373,398,354
"260211904",256,301,557,185,219,181
"260211905",456,444,900,257,276,251
"260211906",363,357,720,237,255,222
"260211907",346,415,761,252,270,231
"260211908",481,428,909,262,264,242
"260211909",471,397,868,259,262,218
"260211910",398,472,870,260,269,234
"260211911",478,446,924,278,279,245
"260211912",612,610,1222,320,336,283
"260211913",572,567,1139,301,284,234
"260211914",334,240,574,170,216,155
"260211915",456,455,911,268,307,262
"260211916",386,336,722,227,249,209
"260280101",49,14,63,25,24,24
"260280102",9,1,10,4,11,2
"260280201",117,18,135,33,40,30
"260280301",69,5,74,13,13,13
"260280302",40,9,49,24,29,19
"260280303",639,657,1296,380,531,372
"260350101",87,58,145,51,51,34
"260350102",60,28,88,25,35,16
"260350201",248,122,370,127,137,80
"260350202",36,9,45,31,48,21
"260350301",239,217,456,138,178,125
"260350302",286,316,602,190,211,188
"260350303",345,365,710,217,226,209
"260350304",353,369,722,246,281,236
"260350305",333,355,688,249,289,238
"260350306",261,329,590,211,251,205
"260350307",325,384,709,273,335,270
"260350308",172,206,378,137,168,119
"260350309",356,445,801,311,368,297
"260350310",198,211,409,140,155,139
"260350311",459,528,987,371,415,348
"260350312",438,424,862,242,258,235
"260350313",410,392,802,216,230,216
"260350401",7,3,10,7,11,4
"260350402",41,15,56,32,26,19
"260350403",133,134,267,88,29,21
"260350404",933,887,1820,587,657,500
"260350405",21,3,24,21,8,8
"260350501",8,10,18,9,15,5
"260350502",80,64,144,56,120,40
"260350503",45,27,72,29,37,20
"260350504",40,14,54,32,40,32
"260350505",246,257,503,187,125,75
"260350506",51,29,80,34,54,34
"260350507",218,241,459,150,194,144
"260350508",134,91,225,83,113,59
"260350509",427,481,908,273,314,261
"260350510",602,644,1246,409,462,403
"260350511",238,239,477,163,212,160
"260350512",280,281,561,179,225,155
"260350513",479,458,937,280,347,277
"260350514",438,471,909,291,296,265
"260350515",638,677,1315,318,349,318
"260350601",518,577,1095,330,338,316
"260350602",405,435,840,252,258,238
"260350603",448,480,928,265,268,245
"260350604",320,331,651,193,218,191
"260350605",350,402,752,220,236,215
"260350606",263,296,559,181,190,176
"260350607",215,247,462,182,212,179
"260350608",274,347,621,214,289,213
"260350609",187,239,426,174,217,170
"260350610",267,300,567,236,260,214
"260350611",319,375,694,260,304,253
"260350612",278,312,590,234,263,231
"260350613",390,317,707,207,239,204
"260350614",305,321,626,215,251,211
"260350615",393,458,851,284,310,279
"260350701",409,449,858,300,321,271
"260350702",518,543,1061,293,299,279
"260350703",717,689,1406,366,376,349
"260350704",374,373,747,247,280,246
"260350705",513,517,1030,348,401,342
"260350706",317,381,698,244,268,234
"260350707",566,636,1202,386,377,350
"260350708",600,684,1284,331,348,322
"260350709",624,673,1297,317,333,310
"260350710",631,652,1283,349,385,331
"260350711",241,258,499,173,204,164
"260350712",720,710,1430,363,394,355
"260350713",216,247,463,173,211,169
"260420101",20,4,24,14,22,14
"260420102",50,12,62,26,45,26
"260420103",43,1,44,9,10,9
"260420201",58,4,62,37,32,32
"260420301",96,67,163,59,78,57
"260420302",33,19,52,17,14,9
"260420401",2,1,3,1,2,1
"260420402",7,3,10,5,10,5
"260420403",192,175,367,110,139,109
"260420404",166,147,313,33,57,32
"260420405",62,45,107,37,57,37
"260420406",68,37,105,46,97,45
"260420407",79,80,159,57,89,56
"260420408",88,68,156,53,93,53
"260420409",205,160,365,130,196,129
"260420410",542,588,1130,312,269,220
"260420411",253,214,467,153,208,151
"260420412",123,97,220,68,102,64
"260420413",845,767,1612,528,645,488
"260420414",629,646,1275,397,441,379
"260420415",751,714,1465,392,412,366
"260420416",380,417,797,296,341,292
"260420417",532,527,1059,336,362,327
"260420418",551,573,1124,392,481,378
"260490101",53,26,79,39,52,39
"260490102",74,14,88,25,52,25
"260490103",73,59,132,49,73,40
"260490104",44,27,71,37,44,29
"260490105",135,118,253,88,107,68
"260490106",311,291,602,181,248,176
"260490201",9,4,13,5,7,5
"260490202",36,15,51,28,27,13
"260490203",86,52,138,60,53,26
"260560101",46,34,80,36,40,20
"260560102",17,10,27,18,30,18
"260560103",24,9,33,20,17,12
"260560104",148,103,251,101,151,99
"260560105",30,13,43,28,52,20
"260560106",42,24,66,33,41,22
"260560107",144,124,268,90,82,55
"260560108",238,234,472,157,188,154
"260560201",36,11,47,18,27,17
"260560202",96,40,136,49,74,49
"260560203",6,2,8,5,13,5
"260560204",16,7,23,12,14,11
"260560205",54,10,64,14,26,14
"260560206",645,592,1237,392,448,373
"260560301",166,164,330,100,134,88
"260630101",27,8,35,8,11,8
"260630102",33,5,38,13,30,13
"260630103",33,24,57,21,36,21
"260630201",41,18,59,26,27,16
"260630202",34,10,44,25,38,18
"260630203",234,246,480,160,191,150
"260630301",30,5,35,17,30,17
"260630401",28,2,30,17,24,17
"260700101",42,28,70,26,29,24
"260700102",60,5,65,25,30,25
"260700103",24,1,25,15,25,15
"260700104",172,86,258,106,172,105
"260700105",38,12,50,29,43,29
"260700106",23,12,35,18,33,18
"260700107",13,4,17,10,18,10
"260700108",623,641,1264,377,470,365
"260700201",21,7,28,18,28,18
"260700202",46,9,55,25,49,24
"260770101",107,22,129,3,4,3
"260770102",12,5,17,13,27,13
"260770103",11,4,15,10,18,10
"260770104",24,4,28,18,41,15
"260770201",27,9,36,22,44,22
"260770202",2,1,3,2,8,2
"260770203",50,26,76,51,286,45
"260770204",105,101,206,58,68,56
"260770301",151,157,308,115,187,113
"260770302",267,283,550,231,442,224
"260770303",237,231,468,171,279,162
"260770304",400,458,858,208,212,205
"260770305",491,535,1026,295,381,288
"260770306",319,357,676,215,284,199
"260770307",198,216,414,174,296,172
"260770308",118,149,267,106,249,106
"260770309",99,83,182,75,223,75
"260770310",166,174,340,132,236,131
"260770311",141,131,272,108,219,107
"260770312",122,135,257,105,205,104
"260770313",140,139,279,123,252,117
"260770314",140,137,277,109,247,107
"260770315",187,168,355,146,307,145
"260770316",139,107,246,88,128,87
"260770401",170,150,320,113,233,110
"260770402",94,81,175,60,84,60
"260770403",274,229,503,167,241,161
"260770404",343,267,610,211,302,210
"260770405",133,94,227,83,122,83
"260770501",525,14,539,3,2,2
"260770502",608,576,1184,285,294,269
"260770503",391,428,819,202,193,189
"260770504",477,452,929,219,228,214
"260770505",504,471,975,252,267,242
"260770506",472,469,941,250,262,244
"260770507",410,416,826,229,239,225
"260770508",317,352,669,171,185,168
"260770509",389,383,772,214,207,198
"260770510",513,536,1049,321,335,312
"260770511",343,352,695,214,224,207
"260770512",353,333,686,199,185,173
"260770513",327,315,642,183,185,172
"260770514",365,382,747,228,245,226
"260770515",359,374,733,232,256,224
"260770516",337,336,673,213,234,207
"260770517",320,333,653,201,188,180
"260770518",462,432,894,239,277,230
"260770519",358,344,702,184,181,159
"260770520",176,171,347,116,188,114
"260770601",246,245,491,202,238,202
"260770602",328,345,673,273,308,248
"260770603",346,400,746,275,310,271
"260770604",266,313,579,181,197,179
"260770605",566,523,1089,326,335,310
"260770606",479,571,1050,323,335,304
"260770607",283,284,567,170,182,159
"260770608",511,477,988,317,373,311
"260770609",375,381,756,281,362,274
"260770610",269,299,568,170,214,165
"260770611",381,421,802,267,295,252
"260770612",283,340,623,214,231,189
"260770701",758,825,1583,482,522,464
"260770702",490,533,1023,298,299,294
"260770703",684,773,1457,397,425,390
"260770704",868,925,1793,465,519,454
"260770705",571,557,1128,299,308,277
"260770706",430,445,875,211,226,207
"260770707",655,682,1337,350,293,277
"260770708",397,407,804,212,237,209
"260770709",737,687,1424,403,387,370
"260770710",533,526,1059,317,309,292
"260770711",322,314,636,188,178,170
"260770712",546,608,1154,346,331,309
"260770713",485,524,1009,306,314,285
"260770714",373,404,777,223,216,206
"260770715",276,303,579,198,208,188
"260770801",597,531,1128,319,342,309
"260770802",521,552,1073,307,317,303
"260770803",663,738,1401,393,381,352
"260770804",371,422,793,265,285,255
"260770805",361,435,796,255,269,247
"260770806",599,637,1236,403,424,383
"260770807",220,245,465,160,164,147
"260770808",574,611,1185,363,281,255
"260770809",439,454,893,277,249,234
"260770810",386,449,835,277,272,235
"260770811",202,221,423,168,237,158
"260770812",267,300,567,224,259,221
"260770813",438,457,895,322,352,307
"260770814",371,342,713,215,231,211
"260770815",538,513,1051,330,335,325
"260770901",757,841,1598,390,404,383
"260770902",670,606,1276,325,349,317
"260770903",899,864,1763,428,445,419
"260770904",434,401,835,285,297,272
"260770905",518,555,1073,350,374,344
"260770906",569,568,1137,355,373,336
"260770907",379,378,757,240,242,221
"260770908",438,455,893,264,238,226
"260770909",443,427,870,238,241,221
"260770910",629,638,1267,344,340,330
"260770911",724,702,1426,360,346,329
"260770912",808,832,1640,435,436,420
"260771001",421,397,818,245,267,238
"260771002",321,335,656,246,270,243
"260771003",174,201,375,158,176,156
"260771004",311,329,640,237,287,233
"260771005",367,418,785,306,344,274
"260771006",168,189,357,140,185,140
"260771007",209,288,497,189,285,187
"260771008",284,226,510,188,253,186
"260771009",225,253,478,205,296,204
"260771010",230,284,514,213,295,208
"260771011",139,181,320,154,197,153
"260771012",224,222,446,158,231,157
"260771013",376,434,810,315,358,310
"260771014",383,433,816,328,365,320
"260771015",464,498,962,312,342,306
"260771016",758,816,1574,488,508,475
"260771017",622,618,1240,375,406,359
"260771018",386,366,752,218,246,216
"260771101",309,346,655,158,157,154
"260771102",791,849,1640,425,424,412
"260771103",643,679,1322,366,382,312
"260771104",427,437,864,222,227,206
"260771105",535,534,1069,293,303,285
"260771106",443,511,954,288,285,273
"260771107",541,530,1071,366,333,311
"260771108",268,308,576,215,253,210
"260771109",257,304,561,189,231,189
"260771110",144,172,316,163,256,156
"260771111",193,223,416,143,203,138
"260771112",293,336,629,271,366,254
"260771113",450,488,938,339,383,326
"260771114",305,345,650,193,197,185
"260771201",740,844,1584,449,463,444
"260771202",462,507,969,283,307,280
"260771203",543,572,1115,392,409,378
"260771204",383,437,820,285,314,276
"260771205",453,494,947,336,378,325
"260771206",406,435,841,319,385,316
"260771207",441,500,941,356,417,351
"260771208",362,422,784,323,394,315
"260771209",237,274,511,207,236,195
"260771210",364,400,764,320,385,314
"260771211",448,548,996,389,436,378
"260771212",454,495,949,349,385,336
"260771213",375,378,753,281,338,276
"260771214",661,696,1357,378,387,374
"260771215",623,666,1289,363,476,353
"260771301",561,649,1210,336,430,331
"260771302",790,845,1635,446,493,439
"260771303",437,463,900,364,469,356
"260771304",516,597,1113,395,460,386
"260771305",501,558,1059,392,467,384
"260771306",597,646,1243,443,489,408
"260771307",458,556,1014,351,391,351
"260771308",571,641,1212,378,384,351
"260771309",703,773,1476,449,499,447
"260771310",330,336,666,241,253,235
"260771311",423,456,879,293,335,290
"260771312",409,429,838,268,302,266
"260771313",331,349,680,212,262,209
"260771314",210,193,403,130,190,129
"260840101",6,3,9,6,15,6
"260840102",36,12,48,33,71,33
"260840103",53,16,69,42,94,42
"260840104",28,5,33,4,29,4
"260840105",9,3,12,5,12,5
"260840106",62,64,126,43,44,40
"260840107",321,303,624,218,294,217
"260840108",484,462,946,281,345,268
"260840201",104,19,123,68,46,20
"260840202",102,83,185,62,94,61
"260840301",18,8,26,12,10,7
"260840302",19,5,24,9,14,7
"260840303",15,6,21,11,14,11
"260840304",48,9,57,39,49,21
"260840305",821,807,1628,466,531,447
"260840306",373,387,760,270,338,265
"260840307",251,152,403,103,135,100
"260840401",42,14,56,21,26,20
"260840402",28,6,34,29,23,23
"260840403",98,96,194,65,115,62
"260840501",14,5,19,10,23,10
"260840502",32,4,36,18,25,18
"260840503",57,12,69,22,27,19
"260840504",66,16,82,24,35,24
"260840505",118,101,219,70,114,65
"260840506",94,82,176,53,82,53
"260910101",26,7,33,25,44,25
"260910102",51,54,105,34,68,34
"260910201",33,24,57,27,48,27
"260910301",8,4,12,7,11,7
"260910302",9,7,16,9,10,7
"260910303",41,8,49,36,21,15
"260910304",147,119,266,102,98,22
"260910305",194,11,205,4,10,4
"260910306",272,291,563,3,11,3
"260910401",369,320,689,212,272,202
"260910402",292,271,563,152,172,152
"260910403",230,189,419,114,190,112
"260910404",572,513,1085,283,308,278
"260910405",630,626,1256,321,354,315
"260910406",268,265,533,153,183,149
"260910407",254,263,517,180,213,159
"260910408",271,269,540,176,214,176
"260910409",417,420,837,294,352,287
"260910410",377,387,764,273,337,267
"260910411",248,279,527,176,201,163
"260910412",347,351,698,221,257,208
"260910413",424,427,851,232,249,223
"260910414",418,393,811,228,267,224
"260980101",17,1,18,15,15,15
"260980102",33,10,43,27,35,27
"260980103",373,377,750,234,302,222
"260980104",437,425,862,275,350,269
"260980201",23,3,26,20,28,15
"260980202",38,3,41,24,42,24
"260980203",51,5,56,19,29,19
"260980204",0,0,0,0,5,0
"260980205",668,660,1328,432,504,422
"260980206",475,448,923,317,358,303
"260980301",0,0,0,0,3,0
"260980302",2,0,2,1,4,1
"260980303",17,4,21,11,11,4
"260980304",27,9,36,22,25,13
"260980305",151,78,229,56,74,47
"260980306",533,522,1055,340,432,336
"261050101",41,23,64,28,43,26
"261050102",19,8,27,14,25,13
"261050103",68,16,84,49,73,49
"261050104",20,19,39,26,42,25
"261050105",274,270,544,205,286,191
"261050201",34,8,42,27,42,27
"261050202",16,7,23,10,15,10
"261050203",9,7,16,8,16,8
"261050204",76,68,144,53,51,38
"261050205",319,342,661,212,289,204
"141750202",246,211,457,155,248,151
"141470304",211,223,434,125,318,121
"141470302",203,168,371,105,117,44
"140700210",119,124,243,88,139,86
"140280706",142,108,250,79,146,77
"140210103",81,77,158,52,104,52
"140070201",158,147,305,94,192,90
"141820702",119,109,228,76,96,76
"141820202",225,193,418,108,118,106
"141750209",247,202,449,140,197,138
"141750101",68,49,117,35,46,35
"141680309",78,76,154,51,84,51
"141680108",146,122,268,90,131,89
"141610503",156,129,285,92,137,88
"141610407",138,109,247,84,132,83
"141610401",91,82,173,53,83,52
"141540107",60,50,110,34,47,32
"141540102",81,64,145,45,52,39
"141470305",139,119,258,87,224,79
"141470303",227,182,409,129,175,126
"140141310",303,337,640,166,175,151
"140141306",402,395,797,186,202,176
"140141201",506,498,1004,258,248,234
"140141018",326,332,658,198,258,193
"140141001",292,265,557,157,201,156
"140140812",568,464,1032,256,277,239
"140140705",603,614,1217,310,363,298
"140140607",824,874,1698,439,490,388
"140140606",450,457,907,277,316,261
"140140504",835,819,1654,384,325,302
"140140503",522,550,1072,241,209,202
"140140502",722,777,1499,342,306,289
"140140404",516,513,1029,272,280,249
"140140309",719,782,1501,359,361,341
"140140301",227,253,480,127,143,122
"140140101",306,276,582,160,168,154
"140140201",499,475,974,241,250,227
"140070715",126,102,228,77,98,68
"140070704",9,8,17,6,46,6
"140070602",121,128,249,84,124,65
"140910802",126,107,233,74,241,74
"140070407",128,113,241,79,325,77
"140070307",58,32,90,32,95,32
"140910605",28,31,59,21,71,21
"140070107",76,59,135,10,43,10
"140910203",107,94,201,79,123,72
"140770207",96,93,189,56,76,50
"140700206",150,127,277,95,172,92
"140490213",112,93,205,69,107,66
"140490207",106,95,201,52,99,51
"140490202",80,62,142,45,78,45
"140280702",107,91,198,58,85,57
"140280701",100,94,194,56,106,55
"140280602",132,140,272,95,156,95
"140280101",52,32,84,25,32,24
"140210205",179,182,361,97,161,94
"140070703",20,12,32,13,77,13
"140070701",49,33,82,24,38,24
"140070413",89,68,157,25,138,23
"140070103",123,96,219,79,224,79
"140070102",261,233,494,123,207,121
"141470205",729,556,1285,290,354,277
"141470204",417,353,770,215,279,205
"141470202",916,906,1822,510,607,451
"141470201",286,270,556,175,253,155
"141470103",315,305,620,173,226,168
"141470102",354,322,676,183,294,172
"141401705",175,138,313,84,122,81
"141401007",258,219,477,129,110,71
"141401006",245,188,433,127,150,106
"141401002",164,123,287,69,106,66
"141401001",171,128,299,83,145,69
"141400804",407,331,738,177,197,173
"141400801",368,298,666,161,208,157
"141400204",176,155,331,95,117,89
"141330408",217,190,407,129,171,128
"141330405",204,203,407,130,188,127
"141330305",227,204,431,119,167,118
"141400202",168,145,313,99,124,97
"141330204",477,450,927,275,318,264
"141330108",426,444,870,218,253,208
"141260604",197,198,395,110,180,107
"141260304",552,522,1074,267,323,236
"141260302",3,2,5,3,6,3
"141260103",98,69,167,47,82,41
"141190501",133,115,248,82,127,82
"141190301",196,183,379,110,141,107
"141120306",178,171,349,124,157,119
"141120304",325,284,609,188,293,184
"141120309",122,115,237,68,102,68
"141120201",329,272,601,187,233,172
"141050604",202,223,425,113,159,113
"141050410",155,144,299,97,144,93
"141050404",97,74,171,55,105,55
"141050305",210,171,381,109,143,101
"141050303",104,85,189,55,100,55
"141050208",116,109,225,70,103,65
"141050306",96,78,174,44,70,42
"141050110",134,134,268,73,109,73
"141050109",201,182,383,127,168,123
"141050108",151,121,272,86,144,85
"141050106",145,108,253,79,136,79
"141050103",185,186,371,124,173,122
"141050101",129,124,253,82,101,81
"140981106",215,127,342,97,151,97
"140980902",246,201,447,145,196,145
"140980509",83,75,158,50,84,48
"140980203",135,111,246,84,101,78
"140911703",16,16,32,9,36,9
"140911608",232,314,546,140,249,137
"140911309",206,179,385,111,180,105
"140910204",81,75,156,50,76,48
"140910201",161,160,321,92,118,90
"140840404",118,124,242,76,119,75
"140840307",47,45,92,25,34,25
"140770203",250,268,518,124,198,120
"140770202",157,133,290,83,129,83
"140840103",80,55,135,49,70,49
"140700201",75,73,148,47,66,43
"140700103",174,164,338,106,134,95
"140700101",159,144,303,84,94,74
"140630701",146,136,282,100,139,97
"140630303",156,153,309,108,176,106
"140630211",50,38,88,29,85,28
"140630209",41,35,76,24,62,24
"140630104",24,17,41,12,25,12
"140560613",132,92,224,71,90,71
"140560612",128,77,205,70,111,67
"140560611",91,71,162,57,71,57
"140560401",54,43,97,34,54,34
"141820707",222,200,422,128,164,123
"141820705",75,67,142,48,68,48
"140490211",238,229,467,126,173,126
"140490204",177,103,280,81,157,81
"140490201",463,371,834,200,277,196
"140490109",174,164,338,109,160,105
"140420308",313,319,632,187,232,151
"140420209",247,217,464,126,160,116
"140420208",266,205,471,130,168,126
"140350309",80,39,119,47,58,47
"140350307",309,213,522,187,220,183
"140350306",113,90,203,67,86,66
"140350206",164,164,328,103,136,103
"140350106",78,54,132,46,54,46
"140280604",113,105,218,56,81,55
"140280501",413,326,739,163,164,149
"140280104",493,401,894,250,316,235
"141470601",237,212,449,133,260,129
"140280102",294,263,557,143,156,139
"140280103",160,135,295,98,117,92
"141400904",272,240,512,138,185,129
"140210802",338,270,608,152,153,135
"140210607",103,106,209,56,74,55
"141330201",332,267,599,165,249,160
"140210504",117,100,217,64,152,43
"140210502",134,155,289,87,116,81
"140210313",183,180,363,99,108,95
"140210308",189,167,356,108,127,101
"141260607",244,206,450,135,202,133
"141260303",223,237,460,115,205,111
"141260206",438,370,808,223,246,204
"141190506",64,54,118,34,64,32
"141120302",143,137,280,91,140,88
"141120106",126,115,241,86,117,83
"141120104",182,145,327,94,148,94
"141050111",124,108,232,61,77,52
"140980506",354,258,612,135,183,134
"140141617",624,578,1202,321,325,293
"140141611",713,710,1423,330,273,251
"140141603",996,998,1994,455,452,415
"140141601",714,719,1433,349,357,330
"140141610",493,524,1017,254,282,245
"140141520",793,751,1544,424,418,347
"140141403",670,715,1385,343,354,332
"141820802",372,436,808,239,255,229
"141750112",164,153,317,104,163,102
"141610805",184,202,386,160,202,159
"141540212",137,145,282,90,126,90
"141401902",261,334,595,224,257,220
"141400520",587,600,1187,383,428,368
"141050416",146,141,287,85,95,74
"140980210",374,373,747,265,312,262
"140630811",354,280,634,200,235,199
"140490324",383,386,769,167,188,158
"140490305",470,499,969,234,244,216
"140350513",396,417,813,292,324,280
"140149202",225,255,480,174,208,154
"140148004",143,173,316,190,284,182
"140146914",263,314,577,354,578,348
"140146805",102,120,222,120,231,118
"140146602",356,428,784,414,531,326
"140070113",275,274,549,166,245,162
"140140205",321,402,723,227,228,221
"140140111",302,377,679,190,193,172
"140140110",421,454,875,273,334,271
"140140204",459,503,962,282,299,269
"140143608",375,452,827,268,302,257
"140143207",581,652,1233,377,378,357
"140143206",518,594,1112,329,346,310
"140141304",642,684,1326,358,350,328
"140143205",562,631,1193,360,332,314
"140142916",454,558,1012,305,322,285
"140143607",358,397,755,262,304,255
"140142702",538,569,1107,323,349,302
"140140109",725,744,1469,399,401,345
"140140108",379,393,772,233,218,202
"140146002",318,373,691,246,299,242
"140142701",406,489,895,251,247,231
"140145716",74,98,172,107,160,105
"140145715",232,305,537,311,479,307
"140145519",248,281,529,285,451,268
"140145518",160,157,317,136,200,128
"140141407",637,709,1346,390,412,348
"140142616",347,439,786,267,314,239
"140143204",396,408,804,245,243,226
"140144705",221,256,477,192,260,165
"140982704",257,296,553,226,248,224
"141821312",420,434,854,252,274,247
"141821310",242,249,491,184,206,180
"141821309",222,240,462,163,194,161
"141821308",229,225,454,117,127,113
"141821307",445,506,951,283,333,280
"141821306",349,373,722,247,281,246
"141821305",258,289,547,210,257,201
"141821304",389,423,812,293,345,284
"141821303",280,345,625,238,276,232
"141821302",451,493,944,299,355,297
"141821301",467,482,949,320,363,315
"141821211",444,445,889,247,261,244
"141821210",315,337,652,200,232,200
"141821209",329,312,641,194,216,193
"141821208",286,339,625,205,245,203
"141821207",380,400,780,287,336,280
"141821206",594,545,1139,363,360,323
"141821205",344,353,697,236,263,230
"141821204",542,587,1129,331,358,322
"141821203",357,399,756,277,326,272
"141821202",237,242,479,188,210,183
"141821201",342,370,712,214,231,212
"141821110",496,557,1053,357,400,346
"141821109",775,725,1500,388,428,380
"141821108",441,429,870,269,262,245
"141821107",262,307,569,206,223,189
"141821106",437,422,859,272,295,256
"141821105",204,252,456,190,227,189
"141821104",235,311,546,225,300,222
"141821103",214,234,448,159,205,158
"141821102",269,329,598,242,273,234
"141821010",541,570,1111,325,332,304
"141821003",298,306,604,205,216,193
"141820712",190,197,387,138,164,132
"141820711",364,335,699,229,265,226
"141820904",351,370,721,230,260,226
"141820903",560,531,1091,293,290,275
"141820902",612,623,1235,339,355,328
"141820901",454,476,930,294,316,290
"141820811",242,325,567,219,309,213
"141820810",378,470,848,315,384,313
"141820809",402,480,882,332,378,331
"141820808",225,230,455,179,204,177
"141820807",265,331,596,208,242,208
"141820615",390,436,826,313,365,309
"141820509",312,320,632,208,239,200
"141820614",172,199,371,144,216,136
"141820613",298,337,635,228,254,225
"141820612",511,514,1025,325,338,304
"141820611",258,282,540,202,225,201
"141820609",727,795,1522,418,454,414
"141820521",333,341,674,223,258,218
"141820520",299,304,603,224,249,218
"141820519",190,217,407,152,174,151
"141820518",469,513,982,414,418,370
"141820517",228,268,496,169,189,162
"141820516",384,406,790,229,249,226
"141820515",346,352,698,266,301,257
"141820415",456,465,921,319,361,316
"141820414",338,350,688,209,237,208
"141821002",399,411,810,307,358,304
"141820307",466,475,941,312,364,308
"141821001",259,332,591,219,290,215
"141820208",298,282,580,195,237,194
"141820207",387,426,813,248,266,232
"141820206",417,399,816,248,292,245
"141820911",312,402,714,302,354,300
"141820413",504,496,1000,285,327,279
"141820412",366,380,746,216,242,212
"141820806",531,533,1064,316,345,314
"141820805",443,518,961,327,369,319
"141820214",241,229,470,170,208,164
"141820213",530,513,1043,328,362,323
"141820804",311,330,641,231,257,222
"141820115",293,283,576,191,215,188
"141820114",225,212,437,148,178,146
"141820803",470,480,950,277,303,268
"141820910",477,551,1028,361,404,353
"141820113",356,389,745,252,291,250
"141820112",376,365,741,235,281,228
"141820111",267,260,527,193,224,190
"141750212",398,395,793,217,268,209
"141820801",398,390,788,213,237,210
"141820716",359,350,709,247,282,245
"141750114",380,399,779,233,335,229
"141750113",328,367,695,221,323,218
"141750111",343,319,662,188,236,184
"141820909",537,527,1064,309,341,302
"141820715",465,480,945,314,372,310
"141820908",629,628,1257,366,393,356
"141820714",321,349,670,226,280,214
"141820713",260,266,526,180,219,179
"141820907",346,355,701,230,244,224
"141820619",182,191,373,114,146,113
"141680311",650,638,1288,342,354,311
"141820906",290,354,644,241,284,238
"141610815",361,336,697,218,249,210
"141610814",291,364,655,264,317,257
"141610813",211,268,479,197,258,194
"141610811",216,254,470,184,210,181
"141610810",346,414,760,303,351,300
"141610808",294,339,633,210,241,204
"141610807",419,424,843,289,329,281
"141611009",249,303,552,204,245,202
"141610715",617,687,1304,384,425,376
"141610714",390,470,860,266,296,246
"141610713",432,510,942,301,343,299
"141610712",535,560,1095,360,409,350
"141610711",269,294,563,198,230,198
"141610710",325,374,699,245,272,240
"141610709",406,460,866,308,353,303
"141610708",433,458,891,294,346,292
"141610707",321,345,666,222,260,213
"141610706",371,429,800,275,297,269
"141610705",208,245,453,150,171,147
"141610704",198,244,442,152,203,143
"141610703",389,470,859,316,365,310
"141610702",261,279,540,175,216,173
"141610701",327,365,692,242,264,240
"141610614",391,369,760,212,228,204
"141610512",324,319,643,200,231,195
"141610511",348,359,707,232,270,228
"141610510",258,275,533,204,249,201
"141610509",363,392,755,213,237,211
"141610508",277,296,573,189,208,187
"141610507",562,521,1083,339,388,336
"141610506",420,370,790,232,246,224
"141610605",314,315,629,185,246,179
"141610806",266,259,525,178,206,175
"141610310",448,494,942,307,352,305
"141610309",326,325,651,191,245,191
"141610308",268,315,583,194,244,193
"141610307",514,527,1041,325,381,321
"141610306",426,456,882,245,280,240
"141610604",464,467,931,296,343,295
"141610603",550,597,1147,335,360,334
"141610602",474,505,979,291,251,216
"141610601",393,386,779,210,233,203
"141610216",327,324,651,228,278,223
"141610215",280,277,557,212,282,208
"141610214",353,334,687,228,269,226
"141610212",299,284,583,197,226,195
"141610211",290,341,631,238,275,234
"141610210",266,322,588,212,243,208
"141610209",353,392,745,277,331,273
"141610208",331,384,715,239,267,236
"141610804",226,266,492,185,209,181
"141610803",243,293,536,191,220,188
"141610116",348,407,755,265,290,256
"141610115",284,275,559,159,183,155
"141610114",245,250,495,167,188,165
"141610113",412,449,861,296,354,293
"141610112",437,429,866,244,294,240
"141610802",200,206,406,123,139,120
"141610801",324,392,716,220,250,213
"141610207",342,338,680,212,243,206
"141610613",457,430,887,274,296,265
"141610612",305,380,685,257,302,253
"141540209",267,302,569,173,187,152
"141610611",319,370,689,224,263,220
"141540211",466,477,943,278,317,264
"141471015",921,901,1822,460,450,410
"141471014",820,772,1592,447,488,399
"141471013",528,520,1048,293,338,284
"141471012",514,545,1059,276,279,258
"141471011",788,786,1574,441,462,421
"141471009",391,404,795,248,295,248
"141471008",577,631,1208,363,411,350
"141471006",289,311,600,225,291,219
"141471005",399,482,881,320,389,315
"141471004",296,344,640,222,253,219
"141471003",229,349,578,186,210,180
"141471002",432,463,895,273,314,268
"141471001",325,331,656,222,260,216
"141470919",478,511,989,265,286,262
"141470918",389,414,803,225,232,204
"141470917",316,334,650,195,215,183
"141470916",353,390,743,244,264,229
"141470915",335,460,795,267,296,258
"141470914",324,373,697,251,284,236
"141470913",581,655,1236,382,452,376
"141470907",232,281,513,172,198,169
"141470906",527,582,1109,336,371,321
"141470904",361,372,733,213,224,202
"141470903",708,768,1476,413,427,380
"141470902",810,828,1638,413,386,370
"141470901",615,601,1216,319,327,291
"141470817",133,156,289,122,182,122
"141470816",206,275,481,203,306,202
"141470815",297,363,660,238,266,222
"141470814",325,384,709,254,269,244
"141470813",303,387,690,263,331,256
"141470812",597,606,1203,343,400,327
"141611018",462,498,960,289,326,284
"141470802",583,622,1205,323,368,314
"141470801",447,474,921,263,348,257
"141470714",273,259,532,160,317,150
"141470713",84,63,147,46,155,45
"141470711",160,144,304,100,320,90
"141611017",448,517,965,355,398,348
"141470808",400,470,870,298,321,274
"141470807",507,542,1049,297,331,285
"141470806",667,718,1385,400,416,378
"141470805",824,933,1757,470,511,459
"141470610",227,256,483,158,262,158
"141470609",209,210,419,136,231,110
"141470804",444,477,921,241,235,228
"141470608",247,240,487,170,348,154
"141470603",218,212,430,134,328,132
"141470507",160,177,337,114,130,106
"141470605",135,135,270,90,198,89
"141470710",164,158,322,97,277,95
"141470709",90,98,188,61,179,59
"141470412",594,631,1225,351,406,342
"141470411",324,394,718,241,298,238
"141470410",380,412,792,232,249,228
"141470409",253,278,531,176,204,175
"141470408",479,533,1012,334,416,330
"141471010",588,678,1266,387,427,374
"141470912",585,653,1238,361,397,339
"141470314",191,198,389,127,332,124
"141611016",322,389,711,245,294,239
"141470811",329,355,684,232,285,228
"141470309",418,447,865,254,343,246
"141470308",676,648,1324,344,399,320
"141470810",230,276,506,172,213,168
"141470107",582,621,1203,294,301,268
"141470106",438,457,895,254,249,231
"141470105",590,652,1242,366,387,342
"141470104",571,564,1135,318,383,309
"141470809",317,368,685,257,296,252
"141401908",269,283,552,209,220,205
"141401907",273,320,593,203,232,201
"141401906",268,329,597,221,266,216
"141401905",236,245,481,137,153,137
"141401904",217,255,472,189,221,182
"141401903",183,222,405,165,199,163
"141401901",561,568,1129,366,427,355
"141401812",352,357,709,239,244,227
"141401811",322,366,688,254,280,249
"141401810",225,272,497,213,253,210
"141401806",455,483,938,273,278,243
"141401805",391,384,775,227,250,224
"141401804",346,376,722,221,231,218
"141401803",325,345,670,231,255,227
"141401802",442,417,859,254,272,242
"141401801",311,334,645,218,237,216
"141401720",261,274,535,202,226,194
"141401719",400,385,785,258,277,245
"141401718",155,136,291,68,67,63
"141820905",400,392,792,224,244,214
"141680212",474,453,927,239,248,233
"141680210",322,349,671,195,221,192
"141680209",390,419,809,217,242,207
"141821007",334,411,745,282,310,278
"141680208",460,488,948,295,350,282
"141680207",440,473,913,278,293,256
"141680206",264,295,559,198,239,190
"141680114",587,567,1154,312,357,302
"141680113",284,266,550,147,182,142
"141680112",394,442,836,272,310,267
"141680205",233,285,518,161,208,153
"141680204",267,254,521,158,218,157
"141821006",362,336,698,215,232,206
"141820618",186,177,363,124,140,123
"141820617",279,299,578,213,233,209
"141820616",338,354,692,207,239,202
"141680313",662,655,1317,342,359,301
"141611117",371,386,757,223,240,220
"141611116",575,552,1127,318,336,305
"141611115",378,371,749,220,246,219
"141611114",373,388,761,244,279,239
"141611113",323,372,695,261,318,257
"141611112",442,469,911,318,361,313
"141611111",620,609,1229,370,411,359
"141611110",433,411,844,228,256,218
"141611109",232,277,509,173,206,163
"141821005",323,285,608,162,168,154
"141611108",233,275,508,202,236,197
"141611107",277,322,599,219,265,219
"141611106",354,372,726,251,315,244
"141611105",328,356,684,225,251,218
"141611104",448,477,925,308,332,299
"141611103",302,281,583,175,182,166
"141611102",380,405,785,214,237,207
"141611101",636,632,1268,368,455,361
"141611021",418,405,823,245,263,238
"141611020",374,376,750,253,265,248
"141611019",529,546,1075,291,351,286
"141611008",351,383,734,244,273,241
"141611007",464,499,963,358,400,347
"141611004",253,323,576,238,312,235
"141611003",267,363,630,285,322,255
"141611002",346,411,757,290,341,270
"141611001",244,322,566,241,291,236
"141610923",320,341,661,225,253,219
"141610922",507,541,1048,283,300,283
"141610921",497,540,1037,362,394,334
"141610920",263,315,578,218,242,213
"141610919",322,338,660,240,270,233
"141610918",375,450,825,336,381,331
"141610917",295,321,616,225,255,214
"141610916",242,282,524,198,247,197
"141610915",376,446,822,313,368,308
"141610914",257,304,561,218,251,214
"141610912",386,382,768,245,266,240
"141610911",333,436,769,266,292,266
"141610910",270,335,605,214,264,208
"141610909",311,346,657,239,265,236
"141610908",323,368,691,212,240,211
"141610907",387,418,805,245,256,234
"141611012",403,450,853,325,355,322
"141611011",240,276,516,194,231,185
"141611010",195,251,446,177,207,173
"141610906",547,566,1113,287,308,278
"141610905",418,384,802,265,298,258
"141610904",413,399,812,241,276,237
"141610903",440,448,888,262,292,255
"141610902",555,564,1119,301,354,287
"141610901",413,395,808,218,230,213
"141610817",473,478,951,324,385,317
"141610816",279,294,573,195,221,192
"141401717",417,392,809,266,268,248
"141401716",323,323,646,210,223,208
"141401715",538,511,1049,285,302,264
"141401714",475,549,1024,367,423,359
"141401713",208,238,446,174,203,169
"141401712",285,313,598,202,219,200
"141401613",264,281,545,191,208,186
"141401612",319,358,677,231,248,225
"141401611",458,488,946,349,381,343
"141401807",281,317,598,208,243,204
"141401610",573,564,1137,357,391,347
"141401609",377,373,750,244,273,239
"141401608",544,582,1126,362,418,354
"141401607",292,328,620,214,230,207
"141401513",701,722,1423,441,490,421
"141401512",467,468,935,331,370,329
"141401511",369,423,792,285,308,274
"141401510",435,478,913,308,331,300
"141401509",325,356,681,248,277,243
"141401508",287,276,563,177,193,170
"141401507",363,387,750,228,253,216
"141401423",435,432,867,260,278,251
"141401422",299,326,625,194,194,189
"141401421",346,343,689,224,252,216
"141401420",291,320,611,202,217,198
"141401419",529,509,1038,276,277,265
"141401418",392,484,876,302,327,293
"141401417",330,384,714,261,283,251
"141401416",437,477,914,315,337,305
"141401415",458,495,953,316,316,306
"141401414",629,725,1354,389,404,386
"141401413",569,607,1176,381,423,377
"141401412",463,494,957,315,315,307
"141401410",220,259,479,178,216,178
"141401409",213,245,458,179,197,177
"141401408",212,252,464,150,178,149
"141401407",243,282,525,233,317,228
"141401406",237,253,490,194,229,185
"141401405",330,395,725,283,327,277
"141401404",291,342,633,267,326,261
"141401403",359,334,693,241,255,232
"141401402",410,384,794,263,287,252
"141401401",805,541,1346,320,388,312
"141401808",378,436,814,294,335,290
"141401318",388,406,794,233,257,227
"141401317",636,635,1271,324,359,308
"141401316",395,437,832,266,295,259
"141401315",629,601,1230,342,334,304
"141401314",257,294,551,202,244,200
"141401313",375,392,767,283,309,281
"141401312",305,313,618,226,265,223
"141401311",271,331,602,242,280,239
"141401310",284,329,613,226,264,222
"141401309",286,305,591,245,258,233
"141401308",227,262,489,181,229,171
"141401307",271,273,544,192,227,188
"141401306",305,345,650,240,284,238
"141401305",353,418,771,275,305,267
"141401304",339,354,693,254,291,245
"141401303",249,272,521,204,269,198
"141401302",274,286,560,221,284,217
"141401301",316,383,699,212,313,209
"141401219",363,345,708,226,254,217
"141401218",216,281,497,189,245,187
"141401217",246,343,589,271,411,267
"141401216",255,331,586,208,281,204
"141401215",260,307,567,221,305,217
"141401214",261,295,556,213,255,209
"141401213",348,401,749,262,275,253
"141401206",728,728,1456,353,353,333
"141401205",643,664,1307,346,352,330
"141401204",392,371,763,236,249,227
"141401203",493,458,951,243,251,235
"141401202",246,258,504,174,229,172
"141401201",325,334,659,199,274,198
"141401121",470,493,963,335,394,328
"141401120",461,512,973,350,414,348
"141401119",368,417,785,306,368,305
"141401118",341,422,763,323,430,323
"141401117",214,269,483,184,257,182
"141401116",217,270,487,216,257,193
"141401115",235,273,508,196,260,196
"141401114",311,389,700,282,307,254
"141401113",359,386,745,289,331,283
"141401112",220,299,519,219,239,213
"141401111",279,337,616,237,275,236
"141401110",394,439,833,291,335,281
"141401109",400,398,798,242,258,239
"141401108",740,788,1528,455,483,448
"141401107",253,279,532,211,243,207
"141401106",260,280,540,192,219,190
"141401105",368,408,776,299,327,286
"141401104",261,325,586,220,236,208
"141401103",499,520,1019,361,390,351
"141401102",358,326,684,219,293,212
"141401101",240,213,453,136,263,136
"141401016",448,525,973,348,387,337
"141401015",388,418,806,284,309,277
"141401014",298,327,625,215,222,208
"141401013",189,219,408,161,184,156
"141401012",485,557,1042,364,396,357
"141401011",424,460,884,272,287,260
"141401010",413,432,845,274,294,267
"141401009",302,337,639,219,241,215
"141401008",255,259,514,182,202,179
"141400915",470,565,1035,374,408,367
"141400914",522,501,1023,302,314,293
"141400913",340,390,730,272,325,269
"141400912",268,293,561,210,235,206
"141400911",526,521,1047,353,402,341
"141400910",464,477,941,259,271,245
"141400821",454,268,722,179,199,176
"141400820",516,516,1032,355,393,341
"141400819",436,479,915,266,298,259
"141400818",540,551,1091,307,322,298
"141400817",388,467,855,279,318,261
"141400815",356,407,763,249,258,239
"141400809",474,473,947,294,320,283
"141401017",507,530,1037,306,309,272
"141400720",503,519,1022,279,351,272
"141400719",448,484,932,292,311,285
"141400718",444,514,958,347,372,344
"141400717",194,198,392,116,137,116
"141400716",348,423,771,317,361,310
"141400715",414,441,855,284,295,269
"141400714",508,535,1043,285,293,276
"141400713",500,507,1007,347,350,325
"141400712",237,279,516,217,282,212
"141400711",463,446,909,331,373,323
"141400710",691,684,1375,368,410,342
"141400709",360,400,760,233,248,216
"141400708",183,222,405,178,218,174
"141400707",221,261,482,198,210,192
"141400706",609,636,1245,390,406,354
"141400705",666,681,1347,389,416,359
"141400704",261,265,526,198,220,194
"141400703",322,338,660,243,272,239
"141400702",406,480,886,344,381,334
"141400619",481,527,1008,328,354,320
"141400618",200,242,442,184,214,184
"141400616",586,614,1200,378,418,365
"141400615",279,287,566,147,166,145
"141400614",367,378,745,251,290,245
"141400613",223,220,443,115,156,112
"141400612",322,338,660,197,234,193
"141400611",323,378,701,243,272,235
"141400610",577,625,1202,374,422,369
"141400617",238,266,504,189,218,183
"141400516",421,411,832,279,319,268
"141400515",414,449,863,265,299,262
"141400514",375,445,820,292,317,275
"141400513",281,298,579,202,224,193
"140982408",222,329,551,201,298,201
"140982407",155,236,391,189,355,186
"140982406",388,501,889,375,580,357
"140982405",408,459,867,368,486,351
"140982404",400,460,860,328,452,315
"140982403",157,204,361,138,241,137
"140982402",180,260,440,212,353,210
"140982401",309,388,697,295,387,273
"140982314",418,405,823,222,248,216
"140982312",656,694,1350,423,448,405
"140982311",433,433,866,262,298,257
"140982310",429,443,872,254,291,252
"140982309",423,453,876,258,291,252
"140982308",496,534,1030,332,370,324
"140982307",651,319,970,194,213,191
"140982306",342,400,742,267,356,262
"140982305",222,264,486,178,221,169
"140982304",618,652,1270,414,462,404
"140982303",307,371,678,232,265,227
"140982302",396,380,776,265,300,257
"140982301",460,517,977,358,425,354
"141540210",363,381,744,182,209,169
"140982313",532,566,1098,334,382,319
"140982212",431,403,834,230,269,214
"140982211",566,564,1130,299,310,290
"140982210",657,647,1304,357,385,345
"140982209",488,451,939,271,311,261
"140982208",597,566,1163,304,332,292
"140982207",526,648,1174,335,378,326
"140982206",534,541,1075,360,383,355
"140982205",555,627,1182,398,425,388
"140982204",351,366,717,201,199,177
"140982203",529,573,1102,345,387,336
"141400405",270,326,596,213,287,211
"140982202",525,645,1170,397,464,394
"140982201",624,685,1309,399,487,392
"140982114",576,566,1142,340,382,325
"140982113",510,519,1029,287,289,271
"140982112",459,472,931,254,262,237
"140982111",477,527,1004,341,348,316
"140982110",485,525,1010,328,375,312
"140982109",374,465,839,339,430,337
"140982108",404,511,915,347,426,345
"140982105",302,362,664,237,274,228
"140982104",310,375,685,260,325,260
"140982103",556,631,1187,419,491,410
"140982102",299,350,649,188,178,159
"140982101",492,485,977,261,295,261
"140982019",84,134,218,93,213,89
"140982018",330,473,803,349,563,343
"140982017",299,428,727,316,468,309
"141470911",303,327,630,210,217,188
"141470910",293,355,648,209,226,199
"141470909",269,321,590,226,254,207
"141470407",463,536,999,313,356,309
"141470406",232,249,481,139,168,138
"141470313",198,218,416,118,285,115
"141470908",467,503,970,308,339,293
"141470405",262,293,555,166,184,166
"141470310",486,481,967,296,389,287
"140982016",245,337,582,284,451,254
"140982015",164,204,368,155,307,153
"140982014",195,291,486,230,474,228
"140982013",170,273,443,223,423,216
"140982012",218,273,491,211,343,205
"140982011",158,201,359,183,287,181
"140982010",370,390,760,295,363,284
"140982009",318,372,690,229,238,204
"140982007",222,319,541,256,335,242
"140982006",323,453,776,334,444,316
"140982005",119,177,296,139,250,137
"140982004",164,227,391,179,297,169
"140982003",308,380,688,287,460,276
"140982002",255,322,577,230,311,225
"140982001",151,173,324,115,133,114
"140981912",512,529,1041,335,395,323
"141610609",305,339,644,227,249,222
"140981904",459,436,895,232,243,226
"140981903",602,601,1203,335,365,322
"140981902",1201,1140,2341,595,630,581
"140981901",332,352,684,201,233,197
"140981813",519,535,1054,313,362,301
"140981812",457,494,951,305,360,293
"140981811",452,475,927,319,372,317
"140981810",644,675,1319,442,534,432
"140981809",717,777,1494,451,507,448
"141610608",276,310,586,204,240,202
"140981907",419,423,842,223,244,213
"140981808",562,546,1108,331,362,320
"140981807",481,488,969,315,371,312
"140981806",452,534,986,295,348,290
"140981805",617,705,1322,382,418,365
"140981804",664,757,1421,441,520,426
"140981803",738,782,1520,454,494,444
"140981802",598,633,1231,399,465,392
"140981713",403,430,833,276,311,268
"140981711",433,496,929,324,363,316
"140981710",387,397,784,266,297,261
"140981709",413,458,871,249,268,245
"140981707",299,346,645,204,271,201
"140981706",377,380,757,236,281,230
"140981705",567,615,1182,401,488,388
"140981704",336,343,679,208,262,205
"140981703",456,514,970,297,380,292
"140981702",550,538,1088,283,342,279
"140981701",765,792,1557,436,440,420
"140981615",161,229,390,176,314,173
"140981614",173,234,407,197,322,195
"140981612",319,432,751,353,566,344
"140981611",340,419,759,346,514,343
"140981610",571,627,1198,396,493,368
"140981609",688,770,1458,432,488,399
"140981905",390,405,795,213,239,206
"140981605",519,599,1118,399,466,386
"140981604",324,354,678,207,234,202
"140981603",301,314,615,193,225,192
"140981602",666,642,1308,371,390,354
"140981601",491,482,973,283,278,247
"140981515",270,369,639,247,302,244
"140981514",439,529,968,324,363,313
"140981513",532,563,1095,359,400,352
"140981512",301,310,611,165,272,164
"140981511",515,442,957,278,337,275
"140981510",544,559,1103,346,392,329
"140981507",400,416,816,288,350,285
"140981504",489,493,982,289,322,280
"140981503",629,660,1289,355,409,347
"140981502",575,547,1122,321,335,295
"140981501",550,527,1077,323,349,298
"140981410",518,451,969,270,288,264
"140981708",518,547,1065,318,333,290
"140981506",385,396,781,217,241,210
"140981608",342,361,703,193,217,193
"141400404",231,301,532,208,249,204
"140982914",511,506,1017,310,365,306
"140980908",325,349,674,244,278,243
"140980907",288,349,637,261,313,253
"140980905",318,347,665,230,254,225
"140980904",306,362,668,202,238,196
"140981111",379,386,765,275,309,267
"140981110",304,300,604,195,237,194
"140980914",370,390,760,263,318,258
"140980811",151,141,292,106,144,106
"140980810",227,219,446,152,191,147
"140980807",208,260,468,171,351,166
"140980706",46,35,81,31,97,30
"140982913",460,485,945,267,313,255
"140980913",312,380,692,279,306,265
"140980912",532,567,1099,365,413,357
"140980911",168,157,325,118,132,118
"140980910",313,333,646,215,247,213
"140980909",402,388,790,260,300,256
"140980609",72,64,136,36,181,35
"140980605",69,57,126,34,139,34
"140980515",352,365,717,226,254,223
"140980512",455,459,914,292,350,290
"140980511",364,369,733,247,300,246
"140980510",456,454,910,274,352,267
"140982912",400,421,821,217,244,211
"140982911",387,394,781,231,274,223
"140980708",67,70,137,48,227,48
"140980707",77,73,150,55,222,55
"140982910",397,432,829,259,305,254
"140981607",368,385,753,225,240,219
"140980517",401,368,769,298,361,279
"140980208",316,361,677,260,295,259
"140982909",285,294,579,183,218,181
"140980516",202,199,401,202,309,200
"140980311",391,452,843,251,286,247
"140980310",305,305,610,200,221,197
"140980309",316,331,647,208,235,203
"140980308",376,426,802,295,348,292
"140980307",232,320,552,212,246,208
"140980306",382,457,839,312,368,309
"140982908",211,232,443,167,207,161
"140980117",444,475,919,290,348,284
"140980116",292,346,638,247,301,245
"140980115",367,396,763,244,272,243
"140980114",331,335,666,213,253,209
"140980113",273,329,602,245,312,242
"140980112",262,281,543,205,252,200
"140980111",269,337,606,214,231,208
"140980110",431,446,877,256,276,250
"140980109",360,380,740,240,296,236
"140980108",256,259,515,177,186,176
"140980211",464,528,992,306,345,306
"140980209",286,283,569,187,219,183
"140911914",230,232,462,147,306,144
"141610607",441,498,939,282,313,265
"140981211",254,272,526,177,201,174
"140911809",278,232,510,171,401,166
"140981209",267,268,535,187,228,184
"140981208",329,328,657,264,298,259
"140981207",456,427,883,263,295,261
"140911714",236,233,469,161,433,160
"140911712",207,232,439,142,311,140
"140911711",216,243,459,170,418,162
"140911710",222,228,450,149,298,149
"140911709",319,337,656,224,335,217
"140911708",246,263,509,196,299,196
"140982903",220,230,450,163,172,139
"140981313",317,291,608,165,187,162
"140981312",508,543,1051,329,385,325
"140981311",390,377,767,233,276,228
"140911610",126,123,249,84,175,82
"140911609",218,205,423,130,231,129
"140911713",377,390,767,259,450,248
"140981012",302,368,670,219,253,216
"140981011",505,557,1062,307,361,305
"140981010",309,300,609,202,281,197
"140911510",398,436,834,243,272,224
"140911507",382,381,763,209,222,178
"140911505",234,259,493,169,264,161
"141610606",482,513,995,338,367,317
"140911509",360,405,765,218,267,207
"140911508",331,358,689,213,291,208
"140911504",279,321,600,195,255,189
"140911415",299,357,656,169,287,167
"141330505",515,545,1060,238,265,234
"141400213",145,152,297,99,119,96
"141330504",430,446,876,238,223,201
"141400212",372,373,745,234,268,226
"141330308",249,255,504,124,233,123
"141330307",572,638,1210,355,527,330
"141330503",319,370,689,223,270,210
"141330501",518,592,1110,317,340,308
"141330411",269,266,535,175,277,171
"141400211",237,275,512,176,199,173
"141330515",707,742,1449,379,389,349
"141330514",205,217,422,129,144,120
"141330512",865,642,1507,336,352,313
"141330309",344,383,727,215,285,208
"141330216",321,315,636,195,234,179
"141330215",87,97,184,57,95,55
"141330214",368,394,762,241,288,202
"141330213",518,525,1043,348,469,337
"141330614",573,601,1174,325,349,290
"141330212",258,248,506,172,250,170
"141330211",264,295,559,179,273,178
"141330210",102,131,233,70,113,61
"141330209",145,154,299,113,242,112
"141330208",308,313,621,202,345,201
"141330613",551,652,1203,347,357,306
"141330112",511,525,1036,261,275,228
"141330110",470,497,967,271,298,258
"141330511",438,495,933,287,292,238
"141260713",141,141,282,89,176,88
"141330612",269,294,563,177,192,159
"141260711",353,379,732,202,266,188
"141260710",257,258,515,141,209,135
"141260709",298,322,620,200,317,191
"141260708",432,444,876,267,370,247
"141260707",312,342,654,199,274,190
"141260706",270,363,633,216,367,211
"141400407",475,544,1019,333,370,328
"141260705",360,408,768,254,411,250
"141260704",376,386,762,202,275,199
"141260703",229,283,512,159,276,158
"141260702",357,393,750,223,345,211
"141260701",235,284,519,157,300,152
"141330601",360,446,806,291,327,281
"141260609",285,291,576,160,351,159
"141330517",408,427,835,234,238,219
"141260611",67,66,133,36,87,35
"141260610",303,288,591,181,364,176
"141260514",439,393,832,203,229,193
"141260513",305,298,603,147,161,137
"141260512",610,628,1238,370,388,347
"141260507",231,240,471,112,143,103
"141400406",320,386,706,245,308,240
"141260515",210,221,431,122,131,118
"141260312",382,395,777,245,443,231
"141260309",292,296,588,165,290,162
"141260311",387,417,804,260,391,248
"141260310",209,202,411,125,259,122
"141260313",441,418,859,220,290,211
"141330516",391,457,848,263,270,243
"141260518",253,230,483,123,141,123
"141260517",307,335,642,170,165,145
"141260516",413,440,853,206,223,202
"141260109",189,197,386,119,189,116
"141190917",491,527,1018,349,390,339
"141190913",215,260,475,184,222,182
"141190912",538,585,1123,374,415,352
"141190911",418,457,875,295,321,288
"141190910",189,270,459,178,209,158
"141190909",351,421,772,273,295,242
"141190908",295,356,651,241,264,231
"141190907",296,320,616,209,218,195
"141190906",308,353,661,226,250,220
"141190905",361,396,757,256,271,238
"141190904",360,391,751,244,280,240
"141190903",260,277,537,181,187,169
"141190902",463,464,927,287,309,275
"141190901",405,436,841,248,265,242
"141190816",348,384,732,244,269,236
"141190815",594,685,1279,402,420,386
"141190814",428,468,896,298,339,292
"141190813",447,438,885,298,366,291
"141190812",555,549,1104,326,371,313
"141190811",409,450,859,302,362,296
"141190810",438,528,966,331,386,326
"141190809",475,505,980,331,396,320
"141190807",404,425,829,228,247,221
"141190806",384,356,740,215,226,210
"141190805",348,390,738,237,282,235
"141190804",320,359,679,241,288,233
"141190803",304,322,626,193,258,190
"141190802",408,386,794,212,237,208
"141190801",610,572,1182,287,297,244
"141190714",355,374,729,215,247,206
"141190713",493,498,991,271,287,255
"141190712",408,485,893,260,275,253
"141190711",361,392,753,228,281,225
"141190710",470,545,1015,353,386,343
"141190709",546,543,1089,295,344,283
"141190708",569,588,1157,318,331,290
"141190707",404,477,881,306,349,301
"141190705",532,597,1129,342,358,322
"141190704",591,635,1226,363,423,343
"141190703",739,804,1543,444,520,427
"141190702",524,531,1055,303,342,291
"141190701",560,581,1141,304,324,291
"141190621",557,556,1113,289,299,268
"141190620",536,547,1083,287,302,267
"141190619",547,548,1095,295,305,275
"141190618",437,430,867,254,294,248
"141190610",428,484,912,248,263,235
"141190609",360,416,776,255,307,252
"141190608",296,351,647,225,281,218
"141190607",442,455,897,308,353,300
"141190606",697,722,1419,377,405,357
"141190605",689,665,1354,384,417,361
"141190604",342,390,732,248,279,241
"141190603",474,520,994,296,354,292
"141190602",552,593,1145,342,364,327
"141190601",650,678,1328,350,362,326
"141190515",380,379,759,238,265,238
"141190514",500,459,959,299,303,285
"141190513",294,345,639,221,237,217
"141190512",403,442,845,272,308,269
"141190511",443,460,903,272,308,269
"141190617",381,389,770,218,233,215
"141190616",423,439,862,235,258,229
"141190615",336,369,705,220,221,202
"141190614",206,246,452,159,184,156
"141190420",471,447,918,271,282,255
"141190419",337,396,733,280,311,273
"141190418",515,553,1068,389,442,379
"141190417",328,356,684,212,237,205
"141190416",347,360,707,207,228,202
"141190415",311,348,659,233,274,233
"141190414",436,475,911,293,321,288
"141190413",514,507,1021,349,405,343
"141190412",366,376,742,251,285,248
"141190411",605,618,1223,392,396,371
"141190612",469,503,972,283,316,274
"141190316",536,605,1141,337,377,330
"141190215",314,347,661,213,244,211
"141190214",416,403,819,242,260,238
"141190213",487,485,972,317,355,313
"141190310",395,362,757,240,257,230
"141190315",440,491,931,318,352,312
"141400510",151,165,316,103,112,97
"141190115",482,479,961,317,353,316
"141190114",511,532,1043,282,294,274
"141190112",488,491,979,324,374,318
"141190111",356,413,769,255,306,253
"141190110",200,245,445,154,179,152
"141190109",600,619,1219,376,418,366
"141190108",496,562,1058,329,353,322
"141190107",288,342,630,190,223,187
"141190106",275,312,587,205,243,200
"141190309",167,161,328,96,120,95
"141190308",442,461,903,285,334,281
"141120314",111,114,225,66,165,66
"141120312",473,463,936,257,296,247
"141120311",352,356,708,192,239,186
"141050610",607,652,1259,366,399,341
"141050609",452,496,948,300,368,290
"141050608",477,485,962,298,325,292
"141050607",294,335,629,186,205,180
"141050606",307,312,619,173,203,168
"141190306",446,471,917,291,324,285
"141120115",317,337,654,176,265,175
"141120114",180,195,375,113,109,82
"141120113",308,338,646,203,288,196
"141120112",582,597,1179,293,346,287
"141050513",224,241,465,141,156,135
"141050512",385,399,784,225,280,220
"141050511",318,364,682,216,231,193
"141050510",466,533,999,294,331,286
"141050509",418,433,851,211,226,208
"141050508",540,575,1115,301,322,285
"141050507",383,412,795,234,260,230
"141050506",388,420,808,243,309,240
"141050505",652,662,1314,334,340,297
"141190314",580,646,1226,403,431,400
"141050415",401,390,791,244,271,240
"141050414",275,281,556,141,156,136
"141190313",383,367,750,212,220,207
"141190312",349,331,680,199,219,196
"141050308",240,269,509,146,168,143
"141050315",529,581,1110,332,382,321
"141050314",510,567,1077,315,372,311
"141050313",599,605,1204,342,395,330
"141050215",455,483,938,311,327,293
"141050214",395,428,823,254,297,246
"141050213",304,307,611,209,228,193
"141050212",341,353,694,216,232,209
"141050211",409,398,807,247,260,230
"141050210",224,245,469,135,142,132
"141190311",383,385,768,228,244,221
"141120111",184,212,396,134,152,128
"141050515",391,406,797,247,308,244
"141050312",403,428,831,228,252,224
"141610610",385,387,772,266,297,250
"141050311",257,278,535,159,186,153
"141050310",469,501,970,293,305,261
"141050309",599,599,1198,367,423,357
"140982811",307,308,615,187,215,182
"140982810",359,387,746,255,289,252
"140982809",369,412,781,274,312,269
"140982808",218,274,492,182,211,179
"140982807",409,398,807,220,254,208
"140982806",439,418,857,232,256,226
"140982805",325,334,659,211,231,205
"140982804",243,289,532,188,245,185
"140982803",224,275,499,196,235,183
"140982802",460,507,967,326,381,319
"140982801",586,629,1215,383,423,377
"140982708",452,517,969,311,328,310
"140982707",456,491,947,335,367,332
"140982706",352,370,722,258,284,253
"140982703",501,537,1038,367,397,357
"140982702",662,634,1296,381,402,373
"140982701",663,611,1274,368,376,366
"140982613",326,337,663,173,198,172
"140982612",541,566,1107,292,294,274
"140982611",471,486,957,269,276,255
"140982610",480,501,981,257,257,246
"140982609",454,488,942,260,295,256
"140982608",524,566,1090,312,317,294
"140982607",465,511,976,328,356,321
"140982606",385,439,824,251,275,242
"140982605",514,528,1042,291,308,278
"140982604",554,562,1116,383,420,366
"140982603",722,748,1470,447,495,441
"140982602",434,458,892,299,337,284
"140982601",409,464,873,290,354,281
"140982512",775,820,1595,417,435,389
"141400408",618,654,1272,346,356,312
"140982511",768,780,1548,427,462,405
"140982510",348,408,756,244,265,237
"140982509",378,402,780,233,271,231
"140982508",596,635,1231,335,397,324
"140982507",684,669,1353,350,356,323
"140982506",622,672,1294,378,395,358
"140982505",599,654,1253,376,402,362
"140982504",402,485,887,283,301,276
"140982503",407,456,863,290,342,284
"140982502",486,587,1073,378,432,370
"140982501",421,448,869,308,343,289
"140982421",317,369,686,251,302,249
"140982420",426,500,926,356,418,353
"140982418",269,329,598,238,287,228
"140982417",364,433,797,308,426,303
"140982416",319,396,715,290,425,283
"140982415",217,324,541,229,355,220
"140982414",414,479,893,356,423,341
"140982413",378,440,818,327,396,319
"140982412",370,442,812,315,387,314
"140982411",349,447,796,365,590,358
"140982410",325,396,721,298,408,292
"140982409",329,394,723,311,494,309
"141400512",341,370,711,222,250,219
"141400511",534,549,1083,327,351,312
"141400508",387,466,853,311,434,307
"141400413",687,691,1378,376,309,270
"141400412",530,522,1052,342,363,306
"141400411",317,301,618,188,231,177
"141400410",393,389,782,242,248,227
"141400409",599,628,1227,356,377,348
"141611015",247,276,523,200,219,192
"141400403",258,259,517,186,232,181
"141400402",324,351,675,236,247,228
"141400401",279,327,606,219,260,214
"141400313",166,213,379,131,151,124
"141400312",400,422,822,250,273,249
"141400311",293,369,662,232,267,224
"141400310",363,411,774,273,311,269
"141400309",343,343,686,213,222,207
"141400308",532,573,1105,335,365,325
"141400307",457,456,913,296,299,271
"141400306",399,413,812,278,307,269
"141400305",521,516,1037,311,341,307
"141400304",347,355,702,217,233,200
"141400303",302,310,612,215,242,214
"141400302",640,667,1307,396,432,384
"141400301",711,645,1356,350,362,335
"141400112",370,384,754,246,275,243
"141400111",386,368,754,239,269,232
"141400110",274,298,572,183,218,181
"141400109",398,408,806,293,315,288
"141330617",304,345,649,195,261,195
"141330616",372,424,796,239,267,231
"141330615",364,434,798,231,279,224
"141330611",309,356,665,202,204,187
"141330610",344,453,797,287,369,270
"141330609",294,392,686,261,304,236
"141330608",393,387,780,237,285,231
"141330607",615,555,1170,289,289,270
"141330606",274,284,558,177,259,173
"141330605",471,492,963,275,277,248
"141330604",371,421,792,241,288,236
"141330603",410,468,878,285,326,275
"141330602",571,626,1197,406,437,385
"141330510",459,571,1030,355,408,340
"141330509",261,361,622,236,283,226
"141330409",588,601,1189,369,489,356
"141330508",324,422,746,250,314,241
"141330507",327,408,735,273,306,250
"141330506",485,576,1061,316,358,299
"141190916",534,522,1056,308,336,303
"140911502",232,258,490,141,151,113
"140911413",342,403,745,281,351,276
"140911412",321,353,674,209,246,199
"140911410",573,619,1192,364,411,361
"140911409",433,492,925,283,313,275
"140911407",401,439,840,301,377,296
"140911406",245,251,496,139,251,134
"141190915",333,377,710,231,263,220
"140981009",308,274,582,168,202,166
"140911408",310,380,690,237,296,233
"140981606",264,304,568,176,224,156
"140911323",324,301,625,183,341,181
"141190914",441,510,951,319,347,307
"140911318",175,203,378,120,259,112
"140911317",158,183,341,126,254,117
"140911316",146,160,306,101,223,96
"140911315",400,432,832,239,326,224
"140911314",219,206,425,135,231,126
"140911313",423,411,834,243,352,232
"140911312",269,296,565,170,409,165
"140911311",500,512,1012,287,487,271
"140911310",150,137,287,100,128,93
"141190808",540,612,1152,347,373,331
"140911223",349,350,699,173,212,169
"140911222",365,376,741,234,266,206
"140911221",378,410,788,220,270,216
"140911220",328,379,707,221,273,207
"140911219",394,446,840,275,409,255
"140911218",287,299,586,194,359,189
"140911217",270,296,566,184,350,177
"140911216",199,195,394,136,351,134
"140911215",472,462,934,283,370,237
"140911214",431,488,919,273,343,257
"140911213",331,362,693,223,370,217
"140911212",280,303,583,175,334,169
"140911211",467,507,974,280,328,256
"140911210",484,469,953,272,327,264
"140911209",333,355,688,218,236,214
"140911206",280,283,563,192,240,184
"140911205",453,502,955,317,391,300
"140911204",432,493,925,291,343,257
"140911203",345,379,724,262,343,253
"140911201",431,454,885,315,474,309
"140911118",294,299,593,198,288,192
"140911117",265,304,569,121,254,120
"140911116",247,273,520,174,248,173
"140911115",265,294,559,221,328,205
"140911114",236,286,522,186,262,182
"140911113",292,328,620,185,267,178
"140911112",366,375,741,247,362,247
"140911111",132,197,329,157,437,146
"140911110",369,465,834,322,465,297
"140911109",389,513,902,202,379,199
"140911108",233,246,479,200,366,192
"140911107",139,178,317,146,303,145
"140911106",106,130,236,104,252,103
"140911105",470,495,965,287,377,258
"140911104",266,365,631,194,319,193
"140911103",305,345,650,191,281,179
"140911102",230,358,588,158,301,157
"140911101",301,358,659,214,418,210
"140981509",519,576,1095,330,356,312
"140911020",155,158,313,112,197,110
"140911019",245,287,532,181,239,176
"140911018",315,377,692,215,330,209
"140911017",302,371,673,199,289,199
"140911016",297,380,677,192,266,167
"140911015",290,350,640,236,371,232
"140911014",241,253,494,178,235,175
"140911013",393,486,879,274,378,260
"140911012",276,333,609,209,240,193
"140911011",310,352,662,218,337,215
"140911010",355,355,710,238,348,237
"140982902",468,477,945,285,329,277
"140911004",443,571,1014,339,521,329
"140911003",332,381,713,222,396,218
"140911002",320,390,710,212,392,208
"140911001",441,498,939,214,372,207
"140910923",0,0,0,0,401,0
"140910921",793,860,1653,413,423,394
"140910920",400,460,860,255,291,240
"140910919",309,364,673,217,259,210
"140910918",297,295,592,140,284,129
"140910917",400,469,869,241,402,239
"140910915",574,594,1168,328,342,304
"140910914",516,534,1050,300,341,296
"140910912",315,309,624,219,338,218
"140910911",122,169,291,129,340,129
"140910909",396,425,821,236,377,217
"140910908",361,431,792,257,314,246
"140910907",398,419,817,249,258,216
"140910906",504,547,1051,293,337,247
"140910904",618,599,1217,325,466,316
"140910903",278,339,617,155,290,152
"140910902",273,262,535,163,307,160
"140910901",417,437,854,255,390,248
"140911208",605,679,1284,345,339,301
"140910813",555,511,1066,315,465,299
"140910812",492,524,1016,243,438,234
"141821009",378,432,810,287,325,279
"140911005",396,421,817,219,396,214
"140910811",241,296,537,171,350,171
"140910809",315,314,629,214,336,212
"140910808",230,200,430,134,258,131
"140910922",730,786,1516,386,403,369
"140910806",303,326,629,198,306,191
"140910805",255,306,561,166,291,164
"140910913",378,377,755,215,243,196
"140910807",282,288,570,174,354,172
"140910804",169,174,343,99,227,93
"140911207",469,498,967,277,316,266
"140910905",574,626,1200,358,481,343
"140910723",458,466,924,246,264,232
"140910720",614,652,1266,399,448,379
"140910719",265,286,551,189,243,184
"140910718",430,480,910,308,385,295
"140910717",298,287,585,168,250,165
"140982901",411,429,840,254,280,243
"140982022",222,271,493,210,412,209
"140911009",279,319,598,222,356,217
"140910722",584,612,1196,332,373,319
"140910716",349,434,783,288,370,265
"140910505",504,533,1037,281,319,247
"140910504",468,497,965,316,400,300
"140910502",270,280,550,153,211,151
"140910714",423,425,848,251,258,236
"140910611",311,371,682,213,287,206
"140982812",412,423,835,274,303,267
"140910419",334,361,695,202,247,194
"140910418",355,401,756,252,311,241
"141401809",323,398,721,275,317,267
"140910713",638,712,1350,412,469,396
"140910413",445,550,995,357,418,339
"140910412",137,159,296,110,145,106
"140981910",303,368,671,232,265,222
"140910510",341,353,694,200,229,182
"140910408",349,370,719,227,301,219
"140910407",506,610,1116,322,471,305
"140910406",308,387,695,243,339,232
"140910404",454,490,944,263,298,254
"140910403",321,397,718,236,283,230
"140910402",433,512,945,290,313,269
"140910401",522,537,1059,265,301,244
"141821008",210,264,474,178,219,176
"140910310",284,308,592,196,268,184
"140910309",364,454,818,284,355,278
"140910307",369,420,789,203,278,196
"140910306",280,271,551,179,252,178
"140910304",476,514,990,291,400,282
"140910405",310,424,734,265,328,256
"140910311",317,332,649,180,303,176
"140981909",311,360,671,217,251,210
"140910210",440,500,940,250,377,246
"140910209",416,436,852,267,391,253
"140911913",331,333,664,196,345,191
"140911910",358,316,674,195,259,190
"140911909",329,350,679,200,259,197
"140911908",353,326,679,225,584,220
"140911907",256,220,476,126,253,113
"140982907",177,196,373,138,169,136
"140981210",266,293,559,193,217,191
"140911906",300,283,583,195,429,192
"140982906",335,344,679,235,271,230
"140911810",78,53,131,36,189,36
"140982419",182,230,412,169,231,166
"141401212",480,550,1030,303,329,296
"140910211",147,155,302,99,168,95
"140910119",201,229,430,145,247,142
"140910118",335,354,689,232,318,218
"140910117",212,232,444,153,194,151
"140910115",164,181,345,106,146,102
"140910114",409,462,871,247,296,237
"140910113",368,411,779,273,354,269
"140910112",274,290,564,205,287,204
"140910111",250,283,533,175,267,172
"140910110",241,282,523,204,248,198
"140910109",213,244,457,151,215,149
"140910108",281,395,676,247,335,237
"140910107",356,401,757,241,316,226
"140910105",136,143,279,92,140,90
"140981908",446,490,936,268,273,243
"140910104",301,331,632,233,327,224
"140910103",282,335,617,222,273,203
"140910102",206,249,455,119,146,102
"140910101",419,417,836,231,268,215
"140840527",278,279,557,175,200,175
"140840526",342,345,687,209,229,206
"140840525",270,308,578,203,224,202
"140840524",388,377,765,229,253,227
"140840523",390,438,828,260,283,253
"140840522",313,377,690,283,332,281
"140840521",428,492,920,295,348,288
"140840520",249,278,527,189,213,188
"140840519",360,353,713,238,276,234
"140840518",326,366,692,245,263,243
"140840517",267,299,566,214,235,207
"140840515",290,353,643,271,328,266
"140840514",517,551,1068,365,414,361
"140840513",343,382,725,257,297,257
"140840512",477,504,981,311,344,308
"140840508",452,533,985,346,393,343
"140840507",384,401,785,249,293,246
"140840506",374,391,765,245,275,235
"140840505",432,451,883,258,287,248
"140840504",566,569,1135,328,368,316
"140840503",362,379,741,203,222,191
"140840502",324,367,691,197,211,193
"140840501",476,480,956,267,283,258
"140840406",270,314,584,214,250,213
"140840316",250,258,508,157,195,155
"140840315",268,257,525,175,205,173
"140840314",374,346,720,225,261,222
"140840111",541,521,1062,296,315,291
"140840110",411,445,856,283,291,263
"140840109",476,485,961,298,333,287
"140840108",560,551,1111,384,440,379
"140840106",527,537,1064,356,396,350
"140770211",277,318,595,196,286,194
"140770210",333,347,680,230,323,225
"140840409",501,473,974,306,339,302
"140840408",479,478,957,293,336,291
"140840407",307,340,647,231,271,227
"140770110",210,212,422,122,164,109
"140770213",86,85,171,58,101,57
"141401211",628,625,1253,374,395,353
"140770212",88,95,183,56,110,55
"141401210",576,584,1160,334,362,323
"140700212",231,214,445,135,183,135
"140700211",147,156,303,92,135,88
"141401209",337,364,701,261,285,255
"140631314",413,428,841,293,348,289
"140631313",289,287,576,192,230,191
"140631312",295,297,592,203,232,202
"140631311",285,325,610,232,259,232
"140631310",215,226,441,158,197,156
"140631309",386,486,872,343,386,335
"140631308",274,346,620,266,316,264
"140631307",214,228,442,177,219,176
"140631306",339,379,718,284,310,275
"140631305",629,655,1284,424,468,415
"140631304",332,355,687,244,268,240
"140631303",457,491,948,339,368,328
"140631302",338,311,649,205,218,186
"140631301",562,565,1127,351,370,330
"140631215",599,563,1162,319,316,291
"140631214",521,572,1093,328,352,315
"140631213",388,404,792,264,290,259
"140631212",430,457,887,307,324,288
"140631211",464,475,939,288,307,275
"140631210",665,666,1331,354,357,325
"140631209",574,594,1168,341,365,331
"140631208",305,401,706,260,288,252
"140631207",363,417,780,281,312,272
"140631206",467,480,947,319,323,302
"140631205",482,537,1019,360,414,351
"140631204",184,232,416,171,230,170
"140631203",364,366,730,260,305,254
"140631202",272,280,552,207,230,206
"140631201",347,352,699,227,254,224
"140631116",546,544,1090,370,420,367
"140631115",290,297,587,224,246,206
"140631114",229,326,555,241,312,237
"140631113",339,398,737,306,325,247
"140631112",156,250,406,156,202,153
"140631111",281,338,619,254,284,242
"140631109",363,349,712,195,215,193
"140631106",243,262,505,199,229,198
"140631105",474,522,996,374,407,365
"140631104",441,426,867,268,276,245
"140631102",532,527,1059,283,291,273
"140631101",697,672,1369,366,397,356
"140631013",637,655,1292,381,418,369
"140631012",471,520,991,344,384,338
"140631011",276,319,595,238,290,233
"140631010",307,319,626,223,250,218
"140631009",329,350,679,256,303,255
"140631008",262,321,583,235,264,233
"140631007",568,545,1113,356,385,351
"140631006",323,375,698,262,288,250
"140631005",278,262,540,194,224,193
"140631004",324,359,683,229,252,227
"140631003",500,521,1021,353,400,348
"140631002",472,467,939,308,340,303
"140631001",335,296,631,165,165,144
"140630923",287,321,608,189,221,179
"140630916",402,454,856,312,340,289
"140630915",492,494,986,332,390,324
"140630914",517,493,1010,290,313,282
"140630913",277,314,591,185,204,181
"140630912",272,348,620,224,269,224
"140630911",260,300,560,187,222,185
"140630922",568,537,1105,353,399,351
"140630921",455,472,927,301,319,285
"140630920",406,480,886,272,317,268
"140630812",287,281,568,208,238,204
"140630810",308,346,654,239,288,238
"140630809",282,317,599,219,257,217
"140630808",311,361,672,248,314,248
"140630807",231,272,503,151,170,147
"140630711",423,381,804,217,206,179
"140630710",225,217,442,120,117,103
"140630613",417,439,856,293,300,291
"140630612",269,316,585,228,230,227
"140630611",403,462,865,306,312,287
"140630610",308,328,636,252,260,248
"140630609",453,436,889,296,308,293
"140630608",273,305,578,219,241,217
"140630607",371,417,788,291,298,284
"140630517",216,203,419,131,149,129
"140630504",262,265,527,185,221,181
"140630510",616,568,1184,351,359,327
"140630407",474,483,957,322,366,318
"140630309",280,300,580,198,235,195
"140630308",418,397,815,256,284,251
"140630307",314,345,659,247,281,228
"140630306",427,448,875,312,357,309
"140630305",461,412,873,272,297,269
"140630304",430,429,859,249,273,241
"140630513",303,397,700,288,346,286
"140630512",255,245,500,188,217,186
"140630511",337,341,678,221,236,215
"140630509",229,306,535,193,225,189
"140630508",399,401,800,282,319,279
"140630507",278,318,596,231,263,227
"140630215",226,222,448,142,166,141
"140630214",273,310,583,204,241,202
"140630506",418,450,868,276,297,272
"140630505",368,393,761,282,318,279
"140910710",205,247,452,167,222,165
"140910709",427,510,937,335,442,326
"140910708",337,410,747,279,358,268
"140910712",356,417,773,289,401,285
"140910711",381,487,868,288,377,284
"140910707",369,443,812,271,393,265
"140910706",227,229,456,151,208,150
"140982021",189,266,455,236,423,230
"140911008",412,478,890,239,388,235
"140910705",257,303,560,200,276,187
"140910703",464,506,970,337,387,324
"140910702",348,338,686,198,318,196
"140910618",342,321,663,142,203,138
"140911006",428,456,884,290,394,279
"140910617",309,369,678,191,304,175
"140910615",245,281,526,173,256,167
"140910614",287,276,563,197,270,195
"140910613",363,399,762,227,363,222
"140982020",164,235,399,200,334,196
"140910610",462,525,987,325,416,309
"140910609",241,274,515,179,248,175
"140910607",463,519,982,308,355,300
"140910606",428,445,873,254,295,243
"140981911",422,502,924,312,346,293
"140910612",317,325,642,180,249,175
"140910721",696,754,1450,401,440,390
"140910509",295,303,598,191,293,190
"140910508",149,174,323,101,216,95
"140910507",261,300,561,161,223,155
"140910715",491,628,1119,356,446,336
"141821004",504,513,1017,295,314,283
"140630109",380,409,789,278,355,277
"140630515",429,465,894,340,373,330
"140560714",279,288,567,230,254,228
"140560713",561,547,1108,317,381,304
"140560705",275,311,586,198,234,197
"140560704",360,402,762,247,280,241
"140560703",460,517,977,290,316,286
"140560702",313,333,646,218,238,217
"140560701",344,343,687,231,256,228
"140560617",424,435,859,270,300,270
"140560616",361,345,706,229,244,227
"140560615",406,430,836,259,307,257
"140631216",515,538,1053,292,314,285
"140560710",376,381,757,228,255,224
"140630514",333,351,684,261,307,258
"140560509",270,286,556,201,231,198
"140560508",294,281,575,205,231,203
"140560709",568,609,1177,400,447,392
"140560414",420,422,842,290,336,283
"140560413",473,489,962,298,328,288
"140560412",280,312,592,191,222,189
"140560411",311,330,641,237,270,223
"140560410",364,352,716,204,236,198
"140560409",353,359,712,218,240,210
"140560408",250,240,490,152,168,143
"140560407",641,601,1242,382,401,360
"140560708",470,526,996,350,451,346
"141821311",417,417,834,245,274,241
"141821101",200,226,426,149,168,146
"140631108",395,366,761,226,257,221
"141820812",137,168,305,131,186,130
"140560707",283,347,630,213,245,209
"140560706",493,536,1029,340,372,319
"140560320",313,306,619,212,244,209
"140560319",544,544,1088,353,415,351
"140560318",319,304,623,188,219,185
"140560317",293,311,604,184,217,183
"140560316",457,456,913,290,334,283
"140560315",241,292,533,199,238,198
"140560314",366,342,708,261,295,257
"140560313",459,523,982,354,417,351
"140560311",444,471,915,303,357,300
"140630917",213,232,445,129,151,125
"141820610",381,392,773,249,278,246
"141820608",269,289,558,205,247,203
"141820607",448,498,946,334,402,329
"140560206",472,419,891,309,356,300
"140560205",558,577,1135,323,330,299
"140560204",298,296,594,214,225,206
"141820514",272,295,567,213,248,206
"141820513",364,362,726,235,257,226
"141820512",384,365,749,245,275,238
"141820511",442,467,909,312,342,305
"141820510",242,231,473,174,176,164
"140630516",379,427,806,296,335,293
"141401208",381,399,780,271,326,267
"141820411",465,463,928,326,377,323
"141820410",343,362,705,221,238,220
"141820409",358,356,714,242,290,241
"141820408",209,175,384,116,131,112
"140631107",373,347,720,248,294,247
"140560118",358,380,738,248,294,245
"140560117",556,573,1129,360,405,350
"140560116",270,350,620,239,263,232
"140560115",265,262,527,192,245,191
"140560114",303,349,652,227,243,221
"140560113",402,436,838,309,368,303
"140560112",301,323,624,244,284,234
"141820310",591,635,1226,375,434,370
"141820309",216,245,461,174,224,174
"141820308",364,353,717,229,280,229
"140560111",396,398,794,251,285,234
"141820212",282,250,532,167,211,165
"141820211",441,416,857,271,327,267
"141820210",385,433,818,265,306,264
"141820209",430,430,860,266,321,265
"140560110",467,460,927,278,304,267
"140560109",504,500,1004,263,283,252
"140560108",570,570,1140,345,355,325
"140560107",387,401,788,285,330,281
"140560106",581,593,1174,366,414,347
"141820121",276,313,589,224,245,218
"141820120",447,479,926,320,351,318
"141820119",349,418,767,298,332,288
"141820118",354,369,723,271,296,262
"141820117",365,336,701,225,250,218
"141820116",507,496,1003,344,379,334
"140560214",881,818,1699,450,483,438
"140490325",505,505,1010,272,319,263
"140560213",912,864,1776,476,514,461
"140490111",278,279,557,130,156,119
"140490323",406,425,831,211,238,207
"140490322",554,649,1203,326,361,309
"140490314",374,429,803,208,224,190
"140490313",366,446,812,224,271,216
"140490312",454,516,970,265,306,257
"140490311",552,677,1229,329,382,319
"140490310",340,386,726,240,294,226
"140490309",427,499,926,306,366,301
"140490308",423,454,877,237,271,224
"140490307",460,512,972,267,286,259
"140490306",317,327,644,165,176,158
"140420918",311,337,648,237,277,230
"140420917",370,409,779,250,323,244
"140420916",443,478,921,288,317,264
"140420914",330,397,727,328,408,315
"140420913",300,369,669,260,361,241
"140420912",167,249,416,123,233,119
"140420911",212,267,479,200,275,180
"140420910",280,299,579,208,296,206
"140420909",435,536,971,380,474,369
"140420908",254,272,526,206,254,205
"140420907",331,326,657,208,229,200
"140420906",513,549,1062,320,362,313
"140420905",530,525,1055,312,426,309
"140420904",435,443,878,242,265,221
"140420903",340,331,671,252,278,249
"140420902",418,441,859,305,351,299
"140420901",450,472,922,238,262,236
"140420823",352,358,710,242,275,233
"140420822",384,378,762,196,228,191
"140420820",202,281,483,205,311,202
"140420819",719,742,1461,416,477,399
"141680312",443,431,874,224,322,218
"140560712",757,755,1512,409,447,388
"140420818",413,436,849,278,300,274
"140420817",230,259,489,192,222,187
"140420816",529,507,1036,276,321,274
"140420815",499,508,1007,291,329,278
"140420814",313,326,639,254,309,250
"140420813",213,248,461,177,208,175
"140420812",416,448,864,327,378,323
"140420811",245,302,547,228,303,214
"140420810",420,496,916,349,400,318
"140420809",368,388,756,281,315,279
"140420808",248,295,543,214,303,210
"140420807",311,388,699,283,330,279
"140420806",283,363,646,246,289,227
"140560711",535,568,1103,355,385,344
"140420805",336,386,722,302,404,293
"140420804",176,206,382,176,256,172
"140420803",369,436,805,328,502,321
"140420802",146,212,358,161,245,155
"140420801",260,320,580,225,345,220
"140420715",673,688,1361,339,342,306
"140420714",203,235,438,168,263,166
"140420713",347,393,740,249,300,243
"140420712",403,403,806,256,309,253
"140420711",1053,1030,2083,587,607,558
"140420710",637,653,1290,344,347,325
"140420709",488,549,1037,348,339,306
"140420708",443,485,928,311,359,305
"140420707",347,463,810,313,383,309
"140630709",370,443,813,308,368,307
"140630919",239,301,540,214,254,214
"140630918",333,389,722,280,309,273
"140630708",370,397,767,312,374,309
"140630706",389,434,823,280,311,277
"140630615",383,355,738,253,264,249
"140420706",289,375,664,257,315,246
"140420704",315,390,705,294,336,287
"140420703",650,640,1290,408,443,395
"140420702",469,511,980,325,360,315
"140420701",663,620,1283,377,366,336
"140420621",685,693,1378,416,464,398
"140420620",187,226,413,178,305,175
"140420619",170,270,440,178,253,170
"140420618",288,297,585,204,231,202
"140420617",340,414,754,298,365,281
"140420616",592,630,1222,382,429,379
"140420615",608,612,1220,317,348,307
"140420614",309,395,704,297,476,281
"140420613",302,416,718,302,552,299
"140420612",191,236,427,178,302,174
"140420611",328,407,735,301,518,294
"140420610",230,260,490,206,306,204
"140420609",392,436,828,305,360,275
"140420608",530,596,1126,424,519,421
"140420607",251,292,543,242,326,217
"140420606",424,424,848,337,405,329
"140420605",345,381,726,295,391,274
"140420604",385,443,828,309,439,308
"140420603",983,584,1567,341,394,331
"140420602",377,359,736,243,264,230
"140420601",474,458,932,265,302,248
"140420517",537,509,1046,318,324,315
"140420516",286,287,573,197,231,195
"140420510",290,273,563,176,195,172
"141680214",342,368,710,191,224,189
"141680213",363,371,734,224,246,218
"141680211",439,462,901,259,288,248
"140420514",389,372,761,268,285,259
"140420419",349,347,696,200,319,192
"140420418",585,572,1157,291,339,283
"140420409",468,467,935,271,290,254
"140420314",571,590,1161,394,447,390
"140420313",537,602,1139,422,479,418
"140420312",157,197,354,121,135,120
"140420311",350,407,757,266,338,265
"140420310",556,501,1057,326,380,323
"141120313",399,438,837,235,260,223
"141680111",370,384,754,211,239,203
"141680110",181,159,340,97,156,97
"140420408",540,535,1075,325,363,309
"140420407",565,587,1152,338,361,321
"140420406",549,545,1094,330,385,320
"140420405",488,575,1063,377,405,355
"140420404",560,586,1146,389,471,380
"140420403",366,368,734,237,257,228
"140420402",357,344,701,242,265,232
"141611006",328,401,729,287,344,280
"141611005",250,306,556,236,313,229
"140420401",564,583,1147,320,362,312
"141610913",340,429,769,276,306,270
"140420513",340,332,672,214,223,202
"141610812",222,264,486,192,250,188
"141610809",244,257,501,174,214,172
"140420512",384,371,755,222,241,220
"140420112",187,199,386,133,157,133
"140420111",458,433,891,288,303,269
"140420110",279,371,650,233,268,227
"140420109",560,571,1131,354,434,340
"140420511",256,246,502,175,192,171
"140420417",424,426,850,225,236,211
"140420416",322,347,669,211,210,194
"140420415",734,739,1473,388,410,370
"140350514",347,398,745,205,226,189
"140350512",613,597,1210,381,431,369
"140350511",336,388,724,259,313,253
"140350509",345,346,691,213,232,206
"140350508",366,384,750,232,271,229
"140350318",549,541,1090,371,452,358
"140350317",535,532,1067,371,420,366
"140350316",343,368,711,272,292,266
"140350315",453,503,956,295,335,293
"140350314",361,378,739,229,252,227
"140350313",398,414,812,256,298,247
"140350312",389,387,776,281,309,279
"140350311",477,476,953,300,319,290
"140350310",253,251,504,164,193,159
"141610413",349,373,722,230,255,228
"141610412",404,371,775,245,299,241
"141610411",149,164,313,90,122,89
"140350406",554,605,1159,340,382,337
"140350214",389,412,801,280,320,277
"140350213",529,509,1038,346,394,334
"140350212",441,522,963,363,421,359
"140350211",380,374,754,217,269,204
"140420413",597,599,1196,349,384,332
"141610313",241,267,508,170,181,163
"141610312",218,235,453,152,175,149
"141610311",269,289,558,199,229,177
"140350405",449,461,910,262,272,245
"141610213",323,346,669,214,258,214
"141610117",469,477,946,330,390,327
"140350107",190,183,373,120,166,119
"140280606",266,294,560,198,276,193
"140280607",456,487,943,282,428,278
"140420412",460,491,951,298,307,275
"140280511",424,558,982,218,239,209
"140280510",365,393,758,231,266,225
"140280508",500,514,1014,267,280,256
"140280507",563,560,1123,275,277,264
"140280506",563,615,1178,287,292,280
"140280515",196,208,404,114,141,110
"140280514",661,688,1349,394,474,388
"140280513",361,383,744,214,244,208
"140280512",427,411,838,217,246,210
"140280408",405,398,803,211,254,205
"140280407",453,430,883,213,273,209
"140280409",516,517,1033,268,301,264
"140420411",479,542,1021,339,374,333
"141471007",317,409,726,237,280,221
"141470905",365,399,764,224,249,217
"140280312",326,341,667,175,178,149
"140280311",1644,631,2275,304,333,287
"140280310",492,551,1043,294,321,280
"140280309",383,467,850,303,339,287
"140280308",254,326,580,232,359,224
"140280306",283,370,653,240,306,233
"140280304",550,654,1204,365,422,342
"140280303",530,592,1122,324,368,311
"140280302",595,638,1233,326,376,311
"140280301",585,631,1216,296,288,258
"141050316",377,459,836,287,324,282
"140350415",551,518,1069,291,302,288
"140280207",280,362,642,221,277,217
"140280206",259,332,591,201,242,195
"140280205",387,425,812,223,240,213
"141470803",688,659,1347,343,464,331
"140280204",815,888,1703,448,476,438
"140280203",510,550,1060,273,298,256
"140280210",382,457,839,236,241,224
"140280209",434,540,974,304,360,292
"140280208",590,679,1269,337,373,315
"140212120",284,292,576,190,314,187
"140212119",278,259,537,182,259,171
"140212118",690,746,1436,369,386,352
"140212117",268,273,541,173,170,145
"140212111",151,169,320,92,132,90
"141470312",287,272,559,148,222,141
"140212116",490,563,1053,294,307,269
"141470311",330,315,645,195,421,184
"140212108",337,364,701,213,240,202
"140212107",344,377,721,219,238,208
"140212106",500,540,1040,292,307,265
"141470307",250,244,494,151,176,144
"141470213",429,459,888,225,218,190
"141470212",367,372,739,203,224,200
"141470211",384,407,791,234,284,223
"141470210",712,713,1425,355,371,336
"141470209",407,434,841,215,233,210
"141470208",480,462,942,246,301,237
"141470207",586,564,1150,299,330,285
"140350411",226,241,467,188,223,185
"140212114",383,384,767,192,205,186
"140212112",303,303,606,157,222,152
"140212105",472,490,962,272,261,239
"140212018",577,540,1117,273,282,264
"140212104",84,99,183,55,71,52
"140212101",471,478,949,257,341,256
"140212017",338,347,685,194,219,182
"141470114",547,518,1065,295,312,277
"141470113",357,392,749,214,234,198
"141470112",339,403,742,246,263,234
"141470111",496,520,1016,302,277,260
"141470110",607,677,1284,363,379,344
"141470109",800,797,1597,376,398,353
"141470108",346,337,683,166,149,148
"140350410",252,304,556,204,249,202
"140212013",382,425,807,238,276,236
"140212011",286,311,597,185,227,184
"140212010",416,458,874,215,215,198
"140212009",389,410,799,207,214,196
"140212008",424,435,859,233,238,223
"140490304",360,378,738,174,202,159
"140490303",511,635,1146,314,342,297
"140490302",343,348,691,175,184,167
"141190706",552,581,1133,361,428,353
"140490301",355,343,698,172,188,161
"140490215",130,152,282,86,112,83
"140490214",279,271,550,147,164,141
"140560212",579,545,1124,356,382,342
"140560211",531,511,1042,364,400,358
"140560210",498,513,1011,335,386,328
"140560209",409,379,788,251,288,248
"140560208",295,314,609,232,244,228
"140560207",180,212,392,158,219,150
"140490116",659,681,1340,361,421,336
"140490112",222,224,446,122,193,121
"141750218",546,558,1104,353,433,337
"141750217",335,353,688,207,251,200
"141750216",281,276,557,191,240,190
"141750215",386,392,778,257,321,253
"141750214",388,422,810,253,297,244
"141750213",393,453,846,249,323,247
"140421113",293,302,595,203,245,195
"140421112",409,474,883,294,334,290
"140421111",450,473,923,290,324,290
"140421110",400,431,831,289,328,276
"140421109",644,613,1257,364,419,356
"140421108",676,689,1365,401,444,380
"140421107",858,839,1697,438,474,416
"140421106",373,397,770,219,249,209
"140421105",536,506,1042,325,401,317
"140421104",379,432,811,252,262,248
"140421103",430,454,884,258,270,237
"140421102",328,328,656,224,263,222
"140421101",369,417,786,231,278,225
"140421016",536,525,1061,350,401,342
"140421015",363,382,745,270,308,269
"141750110",392,390,782,234,293,227
"140421014",333,310,643,213,237,212
"140421013",295,341,636,216,239,214
"140421012",361,378,739,278,316,274
"140421011",274,240,514,184,191,165
"140421010",425,368,793,236,256,228
"140421008",284,331,615,226,263,222
"140420925",242,287,529,221,308,214
"140420924",240,286,526,213,278,211
"140420923",198,258,456,189,288,189
"140420922",215,249,464,200,231,195
"140420921",456,469,925,268,293,251
"140420920",394,448,842,256,276,252
"140420919",457,480,937,289,340,286
"140212007",596,670,1266,293,296,279
"140212012",331,381,712,251,273,235
"140212005",609,605,1214,307,340,298
"141401911",319,348,667,228,239,217
"141401910",599,636,1235,404,460,399
"141401909",441,435,876,268,313,257
"140212003",580,623,1203,316,356,302
"140212001",364,366,730,182,182,169
"140212006",437,481,918,203,197,188
"140211913",398,402,800,216,251,207
"140211912",368,383,751,203,233,200
"140211911",437,515,952,287,345,279
"140211910",524,566,1090,316,373,300
"140211909",468,521,989,254,290,239
"140211907",266,291,557,170,195,164
"140211906",281,333,614,200,258,196
"140350409",339,376,715,238,270,235
"140211903",306,304,610,178,216,168
"141401711",638,653,1291,365,392,344
"140211902",431,465,896,283,303,263
"140211901",424,424,848,238,283,228
"140211815",497,572,1069,330,404,321
"140211814",295,371,666,227,286,217
"141401615",345,342,687,206,216,204
"141401614",475,486,961,267,278,260
"140211813",713,757,1470,392,418,375
"141401515",156,158,314,101,117,97
"141401514",190,174,364,111,137,110
"140211811",376,456,832,232,245,223
"140280216",634,740,1374,377,430,364
"140211808",548,591,1139,258,242,231
"140211806",455,422,877,215,220,203
"140211805",457,523,980,298,329,285
"141401411",309,323,632,240,272,236
"140212014",663,682,1345,341,361,320
"140211802",447,439,886,217,211,192
"140211801",368,359,727,233,259,228
"140211710",549,556,1105,321,380,315
"140211905",383,420,803,200,232,188
"140211709",778,871,1649,418,462,387
"140211708",766,785,1551,421,445,382
"140211706",529,558,1087,328,399,298
"140211705",326,321,647,194,229,188
"140350408",225,279,504,190,238,190
"140211607",418,420,838,265,301,259
"140211606",611,635,1246,237,286,230
"140211609",382,361,743,223,273,217
"141400916",282,300,582,193,194,179
"141400909",427,446,873,299,331,288
"141400908",408,437,845,283,300,271
"140211605",491,495,986,240,267,225
"141400816",284,337,621,247,276,238
"141400814",399,424,823,213,233,208
"141400813",372,416,788,281,298,257
"141400812",528,576,1104,351,372,339
"141400811",374,360,734,215,220,203
"141400810",574,590,1164,259,246,238
"140211603",339,407,746,218,262,218
"140350407",387,398,785,271,319,263
"140211601",510,491,1001,277,319,269
"140211511",286,315,601,209,244,194
"140211510",303,368,671,203,223,191
"140211509",296,277,573,169,235,160
"140211508",180,190,370,112,174,107
"140420410",433,478,911,292,314,279
"140211503",361,385,746,210,268,197
"141400701",413,386,799,245,255,238
"140211502",367,425,792,256,348,245
"140211904",301,303,604,162,208,159
"140211507",381,399,780,226,234,208
"140211506",381,468,849,285,340,278
"140211504",363,402,765,266,317,254
"140211411",488,528,1016,292,334,276
"141400519",284,320,604,204,237,199
"141400518",285,307,592,203,218,188
"141400517",289,336,625,207,220,186
"140211410",371,412,783,247,281,232
"140211602",579,638,1217,393,451,371
"140211409",327,327,654,204,278,200
"141400509",390,464,854,290,419,284
"140211408",320,365,685,206,271,204
"140211704",407,395,802,224,265,221
"140211404",416,472,888,290,345,288
"140211403",255,268,523,209,238,191
"140211402",221,250,471,166,232,164
"140211401",308,376,684,213,268,206
"140211314",398,426,824,278,342,276
"140211313",341,377,718,260,343,251
"140211312",274,340,614,207,267,199
"140211311",256,324,580,203,239,194
"140211310",327,387,714,238,284,227
"140211309",319,325,644,192,224,177
"140211406",477,442,919,245,271,225
"140211308",549,609,1158,351,383,329
"140211307",283,314,597,173,221,166
"140211306",340,319,659,210,278,196
"140211305",471,490,961,304,393,287
"140211405",451,472,923,285,323,273
"140211304",301,330,631,181,266,169
"140211303",364,388,752,208,282,178
"141400113",104,123,227,64,86,63
"140211407",568,590,1158,374,445,357
"140211302",247,262,509,157,199,154
"140211301",403,408,811,242,366,229
"140211703",348,379,727,209,259,195
"140211702",368,387,755,220,301,218
"140211701",401,403,804,227,290,225
"140211611",656,687,1343,347,418,330
"140211214",384,443,827,267,374,265
"140211211",390,417,807,260,352,250
"140211210",354,392,746,256,330,246
"140211209",188,214,402,137,185,134
"140211204",334,359,693,226,316,222
"141330513",403,479,882,241,269,241
"140211202",287,304,591,164,229,160
"141330502",247,327,574,210,271,208
"140211610",398,390,788,223,264,214
"140211208",211,204,415,139,227,135
"140211207",305,352,657,197,225,194
"140211206",364,361,725,231,276,226
"140211205",404,426,830,245,300,207
"140211116",318,361,679,222,263,218
"140211115",311,370,681,216,241,211
"140211114",383,419,802,223,257,215
"141330410",206,212,418,134,231,132
"140211113",444,510,954,281,320,276
"140211112",593,650,1243,386,420,370
"140211111",357,364,721,211,242,196
"140211110",323,301,624,183,218,177
"140211109",667,678,1345,382,423,371
"140211108",409,475,884,268,307,264
"140211107",409,459,868,256,305,251
"140211106",174,183,357,115,133,114
"140211105",356,393,749,265,296,250
"140211101",409,425,834,231,257,221
"140211016",434,502,936,232,228,222
"140211014",733,809,1542,422,461,414
"140211013",767,783,1550,370,366,339
"140211012",884,855,1739,441,418,402
"140211011",707,697,1404,383,363,331
"140149116",360,394,754,246,250,225
"140149216",396,457,853,292,325,263
"140149115",466,456,922,306,343,295
"140149114",602,673,1275,420,431,388
"140149113",427,517,944,299,339,288
"140149112",429,477,906,328,349,299
"140149111",402,414,816,308,342,275
"140149110",376,410,786,323,407,311
"140149109",210,250,460,196,242,191
"140149108",345,377,722,295,321,262
"140149107",407,400,807,330,409,318
"140149106",424,507,931,346,354,324
"140149105",440,482,922,278,250,206
"140149104",538,596,1134,363,412,349
"140149103",366,417,783,255,273,244
"140149102",458,491,949,310,374,305
"140149101",581,635,1216,384,401,370
"140149015",391,471,862,271,311,265
"140149215",323,343,666,246,301,239
"140149014",366,405,771,244,276,231
"140149013",695,724,1419,354,336,312
"140149012",500,547,1047,295,285,255
"140149011",402,446,848,218,246,209
"140149010",318,370,688,175,220,174
"140149009",332,391,723,261,321,251
"140149008",270,316,586,210,250,205
"140149007",601,624,1225,348,346,322
"140149006",581,600,1181,306,295,263
"140149005",379,417,796,233,248,212
"140149004",283,298,581,197,216,181
"140149003",330,342,672,192,204,170
"140149001",329,343,672,281,279,208
"140148916",791,866,1657,456,404,378
"141190410",603,609,1212,374,382,362
"140149002",492,451,943,256,276,209
"140148915",556,617,1173,377,409,366
"140148914",406,411,817,228,252,223
"140148913",435,471,906,263,280,254
"141190307",444,515,959,284,328,283
"140148911",373,435,808,198,210,191
"140148910",403,443,846,232,250,226
"140148909",387,478,865,276,293,262
"140148908",351,347,698,222,233,207
"140148907",432,464,896,260,278,256
"140148906",451,522,973,322,338,305
"140280201",874,875,1749,411,376,366
"140280111",469,468,937,262,301,253
"140350414",488,518,1006,295,322,289
"141470712",108,95,203,62,378,61
"141470708",87,47,134,36,122,35
"140280215",636,736,1372,362,403,353
"140350413",368,364,732,248,290,246
"140280213",561,593,1154,321,340,304
"140280110",909,840,1749,386,339,339
"140280109",410,390,800,206,263,193
"140280212",516,607,1123,329,370,318
"140280211",578,629,1207,359,393,349
"141470607",163,200,363,123,238,120
"141470606",242,272,514,158,312,150
"141470604",178,184,362,116,279,112
"141470508",344,332,676,196,233,195
"140350412",385,410,795,266,297,258
"141470413",273,245,518,175,187,173
"140148905",327,348,675,228,261,215
"140148904",526,591,1117,367,410,358
"140148903",501,597,1098,396,421,378
"140148902",269,314,583,198,230,194
"140148901",344,393,737,253,288,245
"140148815",552,588,1140,331,383,327
"140148814",725,768,1493,359,360,342
"140148813",537,572,1109,301,335,272
"140148812",495,537,1032,288,287,268
"140148811",599,660,1259,381,393,351
"140148810",411,479,890,281,318,271
"140148809",416,427,843,267,274,250
"140148808",371,414,785,260,283,248
"141190212",274,243,517,148,157,144
"140148807",445,510,955,302,320,291
"140148806",425,491,916,288,298,272
"140148805",193,206,399,130,132,122
"140148804",379,415,794,264,275,242
"140148803",444,486,930,286,308,264
"140148713",293,315,608,177,177,166
"140148712",581,520,1101,293,301,280
"140148711",616,598,1214,292,282,267
"140148710",464,489,953,262,226,215
"140148709",385,387,772,206,213,182
"140148708",745,802,1547,401,394,369
"140148707",456,480,936,246,262,223
"140148706",360,382,742,220,220,198
"140148705",733,712,1445,408,430,382
"140148704",407,408,815,228,253,221
"140148703",336,385,721,191,199,175
"140148702",433,429,862,279,344,266
"140148701",500,532,1032,314,356,297
"140148612",464,476,940,254,237,208
"140148611",416,457,873,236,229,201
"140148608",521,559,1080,264,270,235
"140148607",662,671,1333,349,300,278
"140148606",598,678,1276,313,305,270
"140148605",720,727,1447,368,355,334
"140148604",675,682,1357,317,511,301
"140149314",231,264,495,170,195,168
"140148603",523,509,1032,261,242,219
"140148602",328,332,660,168,155,151
"140148601",507,476,983,216,218,199
"140148516",391,468,859,291,326,283
"140148515",306,340,646,216,256,200
"140148514",590,627,1217,353,370,331
"140148513",612,644,1256,348,336,308
"140148512",556,599,1155,306,307,270
"140148511",664,706,1370,354,366,339
"140148510",609,673,1282,340,366,328
"140148509",741,815,1556,402,404,374
"140148508",682,758,1440,413,420,387
"140148507",316,396,712,240,249,211
"140148506",499,504,1003,330,357,314
"141190113",346,361,707,250,267,237
"140148504",402,445,847,269,281,255
"140148503",309,384,693,219,240,212
"140148502",307,374,681,230,252,222
"140148501",439,472,911,270,286,259
"140148412",306,413,719,259,284,250
"140148411",360,383,743,243,268,216
"140148410",329,367,696,233,272,228
"140148409",378,424,802,249,266,223
"140148408",309,396,705,234,273,221
"140148407",255,282,537,175,185,157
"140148406",276,310,586,187,214,172
"140148405",463,493,956,293,336,259
"140148404",288,343,631,195,200,174
"140148403",393,433,826,276,311,260
"140148401",425,498,923,298,295,264
"140148316",220,266,486,164,194,159
"140148505",451,513,964,311,336,297
"140148314",440,489,929,260,291,253
"140148313",387,426,813,242,251,216
"140148312",483,531,1014,278,315,276
"140148311",405,432,837,236,254,220
"140148310",259,224,483,218,223,177
"140148309",524,416,940,339,393,301
"140148308",316,339,655,181,179,153
"140148307",469,521,990,316,337,280
"140148306",270,346,616,183,191,162
"140148305",324,337,661,225,270,208
"140148304",358,372,730,230,269,228
"140148303",423,466,889,278,323,253
"140148302",436,513,949,300,353,286
"140148301",392,458,850,278,302,259
"140148315",288,359,647,194,209,184
"140148211",195,194,389,219,331,211
"140148210",206,182,388,196,363,193
"140148209",296,303,599,313,502,304
"140148208",549,586,1135,619,899,586
"140148207",271,311,582,354,451,330
"140148206",129,141,270,152,257,149
"140148205",154,198,352,213,320,202
"140148204",417,559,976,540,903,531
"140148203",244,325,569,322,538,317
"140148202",312,378,690,414,593,394
"140148110",204,262,466,196,291,183
"140148109",189,268,457,249,405,239
"140148108",183,297,480,267,442,265
"140148107",184,263,447,234,351,224
"140148106",539,707,1246,680,1172,671
"140148105",400,507,907,528,825,520
"141120310",339,336,675,206,260,197
"140148104",388,556,944,550,999,541
"140148103",418,556,974,598,962,583
"140148102",218,330,548,341,659,297
"140148101",202,281,483,264,410,258
"140148014",286,264,550,141,147,128
"140148012",340,391,731,181,211,175
"140148011",327,376,703,209,245,192
"140148010",199,211,410,239,352,234
"140148009",190,193,383,211,278,195
"140148008",135,168,303,154,276,153
"140148007",139,147,286,156,232,155
"140148006",295,384,679,380,609,372
"140148005",283,248,531,268,377,239
"140148002",176,214,390,223,340,216
"140148001",187,244,431,247,385,243
"140148013",163,230,393,140,177,135
"140147920",350,392,742,267,293,248
"140147919",398,428,826,258,278,224
"140147916",418,467,885,278,318,274
"140147915",571,638,1209,346,370,321
"140147914",330,377,707,195,216,178
"140147913",506,477,983,271,264,229
"140147912",302,340,642,187,180,158
"140147911",487,520,1007,308,300,266
"141120207",273,269,542,137,171,128
"140147910",375,421,796,244,259,223
"140147909",480,576,1056,379,447,374
"140147908",295,377,672,229,257,214
"140147907",485,521,1006,329,383,315
"140147905",287,353,640,229,280,225
"140147904",266,343,609,208,248,199
"140147903",317,396,713,223,253,209
"140147902",384,444,828,290,374,281
"140147901",441,491,932,298,362,297
"140147816",277,317,594,196,207,155
"140147815",221,272,493,184,210,179
"140147814",573,715,1288,426,721,416
"140147813",276,364,640,207,233,199
"140147812",407,498,905,298,306,271
"140147811",488,618,1106,380,438,378
"141120110",337,356,693,197,231,188
"141120109",338,367,705,198,245,195
"140147810",433,465,898,302,334,289
"140147809",531,569,1100,311,302,263
"140147906",399,490,889,309,353,295
"140147808",393,442,835,278,323,271
"140147807",447,466,913,300,310,257
"140147806",203,246,449,138,135,123
"140147805",377,425,802,242,251,225
"140147804",398,455,853,246,258,222
"140147803",355,419,774,238,279,226
"140147802",282,322,604,186,232,177
"140147801",521,568,1089,348,401,328
"140147722",521,565,1086,286,281,247
"140147601",690,737,1427,422,373,321
"140147519",977,992,1969,444,420,382
"140147518",709,707,1416,309,310,294
"140147517",531,589,1120,334,337,287
"140147516",505,520,1025,284,276,236
"140147515",740,787,1527,424,422,386
"140147514",877,913,1790,441,418,378
"140147513",878,860,1738,448,448,412
"140147511",600,603,1203,345,363,304
"140147510",586,693,1279,357,373,315
"140147509",699,664,1363,324,292,277
"140147508",523,512,1035,253,254,225
"140147507",696,746,1442,335,324,310
"140147506",620,686,1306,324,303,293
"140147505",527,572,1099,243,259,222
"140147504",504,507,1011,238,232,209
"140147503",517,525,1042,275,252,242
"140147502",498,534,1032,253,202,190
"140147501",751,748,1499,336,340,323
"140147417",356,404,760,261,288,254
"140147416",337,361,698,220,241,207
"140147415",481,522,1003,312,327,280
"140147414",403,460,863,285,318,275
"140147413",343,453,796,244,320,235
"140147412",499,621,1120,341,379,326
"141050514",699,742,1441,392,426,384
"140147411",620,643,1263,340,362,308
"140147410",357,437,794,262,290,236
"140147409",360,446,806,250,260,235
"140147405",421,425,846,249,264,226
"140147404",366,386,752,223,255,212
"140147403",408,428,836,217,231,195
"140147402",504,510,1014,264,268,242
"140147401",584,641,1225,314,282,256
"140147310",261,304,565,193,227,182
"140147309",441,538,979,310,360,285
"140147308",316,343,659,225,269,219
"140147307",307,429,736,187,160,153
"140147306",363,423,786,269,315,249
"140147305",306,388,694,223,273,220
"140147304",309,434,743,243,303,226
"140147303",290,355,645,196,239,191
"140147302",314,382,696,215,261,207
"140147301",347,384,731,221,253,181
"140147313",326,377,703,223,277,212
"140147312",267,315,582,208,300,202
"140147207",451,657,1108,698,1069,670
"140147206",438,554,992,587,947,579
"140210613",436,478,914,259,300,248
"140210612",628,691,1319,371,410,359
"140210611",794,827,1621,417,483,399
"141330207",192,206,398,126,163,120
"140210610",290,306,596,175,182,159
"140210609",449,478,927,290,331,281
"140210608",483,468,951,252,231,223
"141330111",620,627,1247,315,341,310
"140210811",459,418,877,231,241,217
"140210508",434,428,862,234,288,232
"140210507",399,425,824,219,296,217
"140210506",230,262,492,121,145,121
"140210810",462,495,957,258,237,207
"140210809",801,806,1607,396,382,346
"141260712",419,445,864,258,330,255
"140210315",537,464,1001,250,273,229
"140210314",544,565,1109,275,271,259
"141260608",289,333,622,186,321,183
"140210808",464,503,967,233,240,221
"140210807",726,745,1471,371,340,295
"140210410",496,486,982,266,276,238
"140210409",639,654,1293,369,404,351
"140210213",253,278,531,146,175,141
"140210408",150,173,323,88,93,83
"140210407",493,518,1011,294,314,283
"140210406",444,470,914,277,300,267
"140210212",173,188,361,125,202,121
"141260511",418,476,894,248,263,237
"141260510",405,428,833,223,245,219
"141260509",665,665,1330,321,347,304
"141260508",425,487,912,233,276,229
"140421009",427,440,867,275,308,271
"140210211",125,109,234,88,219,88
"140210210",204,188,392,121,244,119
"140210208",138,151,289,100,180,98
"141260406",285,260,545,140,257,134
"141260314",558,602,1160,301,347,282
"140210206",119,134,253,87,306,86
"140211104",434,407,841,243,260,236
"141260308",458,483,941,251,349,246
"141260307",401,410,811,191,295,181
"140210806",267,261,528,118,144,118
"140210110",181,195,376,119,268,116
"140210109",280,264,544,179,304,170
"140210108",214,239,453,156,226,154
"140210105",139,125,264,74,112,74
"140210104",204,190,394,112,166,111
"140149913",821,832,1653,444,399,366
"140149912",469,453,922,239,227,199
"140149911",350,419,769,191,198,180
"140149910",608,619,1227,333,331,296
"140149909",546,601,1147,322,336,298
"140149908",756,795,1551,421,436,382
"140149907",397,411,808,233,253,224
"140149906",505,561,1066,307,296,287
"140149905",369,395,764,230,216,204
"140149903",604,679,1283,347,362,330
"140149902",540,579,1119,337,350,315
"140149901",568,613,1181,329,359,306
"140149813",766,818,1584,422,380,339
"140149812",477,479,956,240,209,187
"140149811",401,442,843,239,233,209
"140149810",378,424,802,213,212,185
"140149809",550,575,1125,334,354,303
"140149808",426,468,894,240,248,210
"140149807",789,764,1553,414,390,368
"140149806",456,460,916,256,253,232
"140149805",312,344,656,166,175,147
"140149803",451,475,926,233,210,196
"141260208",322,336,658,165,126,92
"140149802",627,634,1261,370,344,314
"140149801",431,516,947,282,274,249
"140149717",918,970,1888,469,437,416
"140149716",571,586,1157,295,233,210
"140149713",414,410,824,198,193,179
"140149712",504,520,1024,264,260,236
"140149711",744,761,1505,373,342,323
"140149710",628,659,1287,333,329,296
"140149709",759,828,1587,408,366,325
"140149708",777,765,1542,400,373,340
"140149707",682,637,1319,331,306,281
"140149706",845,844,1689,411,400,372
"140149705",374,432,806,234,234,214
"140149704",334,366,700,187,197,177
"140149703",403,468,871,234,241,207
"140149702",377,385,762,197,198,187
"140149714",868,871,1739,472,446,417
"140149701",1016,1019,2035,448,425,400
"140149617",909,862,1771,448,447,417
"140149616",686,673,1359,351,395,316
"140149615",370,367,737,229,250,214
"140149614",377,405,782,238,251,217
"140149613",594,607,1201,336,345,332
"140149612",531,592,1123,318,336,305
"140149611",417,456,873,260,283,246
"140149715",581,628,1209,325,340,301
"140149607",333,369,702,217,242,204
"140149606",361,381,742,214,208,192
"140149605",444,450,894,249,264,229
"140149604",532,641,1173,331,360,312
"140149603",564,607,1171,336,360,315
"140149602",372,377,749,227,242,212
"140149601",390,379,769,238,267,235
"140149514",719,726,1445,386,376,345
"140149513",731,772,1503,373,358,327
"140149512",825,854,1679,369,362,347
"140149511",503,474,977,252,250,221
"140211103",340,341,681,200,218,199
"140149610",561,572,1133,325,351,308
"140149609",460,496,956,267,293,257
"140149608",475,491,966,297,340,279
"140149510",474,593,1067,344,403,332
"140149509",434,487,921,274,287,254
"140149508",736,715,1451,360,344,324
"140149507",608,603,1211,278,257,246
"140149506",568,658,1226,300,296,284
"140149505",662,705,1367,315,312,298
"140149504",655,676,1331,309,276,262
"140149503",335,344,679,205,213,186
"140149501",347,393,740,233,259,218
"140149414",416,438,854,207,205,184
"140149413",514,551,1065,262,258,245
"140149412",555,643,1198,300,278,264
"141190817",423,449,872,241,252,229
"140149411",542,570,1112,275,277,256
"140149410",492,506,998,258,253,225
"140149409",615,610,1225,312,288,270
"140149408",922,961,1883,430,408,394
"140149407",818,829,1647,416,401,377
"140149502",345,360,705,244,256,230
"140149406",482,530,1012,279,280,254
"140149405",629,698,1327,346,360,336
"140149404",919,977,1896,435,438,417
"140149403",371,413,784,224,227,201
"140149402",501,498,999,288,276,240
"140149401",501,594,1095,315,318,280
"140149320",297,326,623,163,163,144
"140149319",554,614,1168,324,311,289
"140149318",411,463,874,306,349,297
"140149317",756,842,1598,435,429,381
"140149316",358,416,774,246,256,230
"140149315",429,444,873,255,263,230
"140149313",347,389,736,229,232,214
"140149312",633,744,1377,413,428,398
"140149311",694,737,1431,403,400,364
"140149310",515,598,1113,349,374,333
"140149309",396,444,840,262,294,249
"140149307",549,555,1104,281,284,268
"140149306",581,652,1233,361,361,337
"140149305",422,476,898,272,307,252
"140149304",666,729,1395,425,409,379
"140149303",527,621,1148,351,378,333
"140149302",361,408,769,250,274,240
"140149301",342,406,748,239,258,233
"140149218",193,243,436,219,306,215
"140149217",410,495,905,300,324,269
"140149214",421,480,901,314,347,297
"140149213",216,260,476,172,204,157
"140149212",426,441,867,331,391,296
"140149210",305,338,643,258,314,247
"140149209",364,440,804,297,348,269
"140149208",316,336,652,202,217,181
"141190613",276,341,617,233,263,222
"141190611",467,506,973,283,312,272
"140149207",284,343,627,189,207,179
"140149206",364,421,785,249,238,214
"140149205",398,443,841,269,268,220
"140149204",458,462,920,254,246,216
"140149203",225,277,502,178,218,176
"140149201",360,428,788,315,375,294
"140149120",294,293,587,234,305,227
"140149119",439,494,933,312,325,296
"140149118",469,514,983,309,325,296
"140149117",419,453,872,265,300,260
"140147205",198,258,456,259,388,235
"140147204",531,529,1060,581,925,565
"140147109",305,456,761,446,693,407
"140147108",197,256,453,256,420,251
"140147107",332,414,746,428,669,417
"140147106",255,367,622,367,604,358
"140147105",215,253,468,291,489,277
"140147104",273,375,648,376,650,374
"140147103",212,326,538,286,453,281
"140147102",280,384,664,382,628,372
"140147101",187,217,404,177,298,176
"140147011",155,235,390,217,321,212
"140147010",230,313,543,345,529,334
"140147009",179,234,413,241,370,235
"140147008",186,314,500,277,407,268
"140147007",188,266,454,254,404,251
"140147006",257,357,614,349,551,338
"140147005",264,319,583,340,590,335
"140147004",227,331,558,195,344,189
"140147003",312,334,646,351,512,326
"140147002",243,270,513,280,397,266
"140147001",209,312,521,297,548,287
"140146913",76,66,142,85,139,85
"140146912",158,189,347,185,273,176
"140146911",478,492,970,474,664,393
"140146910",279,281,560,188,223,175
"140146908",362,388,750,260,246,209
"140146907",277,294,571,208,265,198
"140146906",319,314,633,230,270,207
"140146905",280,290,570,271,353,237
"140146904",175,237,412,218,361,217
"140146903",158,261,419,215,262,162
"140146902",86,126,212,130,194,128
"140146901",163,231,394,230,369,227
"140146814",326,373,699,311,432,251
"140146813",150,145,295,114,140,86
"140146812",209,229,438,181,229,165
"140146811",119,139,258,118,155,105
"140146810",175,209,384,211,381,208
"140146809",220,270,490,276,449,269
"140146808",65,90,155,89,128,81
"140146807",135,177,312,161,265,161
"140146806",233,299,532,255,365,253
"140146804",352,440,792,438,723,430
"140146803",211,294,505,318,557,310
"140146802",122,157,279,139,445,139
"140146801",129,183,312,193,370,189
"140146711",354,486,840,472,789,462
"140146710",185,217,402,233,461,227
"140146709",195,274,469,273,440,262
"140146708",203,256,459,257,462,255
"140146707",143,175,318,202,300,201
"140146705",164,233,397,213,405,206
"140146704",116,224,340,170,277,169
"140146703",298,401,699,359,613,358
"140146702",81,109,190,100,216,99
"140146701",198,278,476,214,471,209
"140146614",310,392,702,369,575,335
"140146613",149,164,313,177,295,164
"140146612",193,240,433,217,385,211
"140146611",92,137,229,134,331,132
"140146610",111,143,254,163,280,160
"140146609",187,230,417,222,396,219
"140146608",63,80,143,77,181,76
"140146607",193,255,448,245,381,240
"140146606",173,227,400,229,409,228
"140146605",152,191,343,193,387,190
"140146604",181,243,424,233,440,232
"140146603",107,149,256,146,233,131
"140146516",467,469,936,310,363,295
"140146515",233,282,515,155,182,147
"140146514",633,706,1339,408,437,365
"140146513",300,347,647,188,221,170
"140146512",398,461,859,307,374,301
"140146511",466,479,945,286,303,260
"140146510",233,299,532,188,222,179
"140146509",238,313,551,191,227,185
"140146508",162,176,338,153,221,144
"140146507",255,276,531,174,195,159
"140146506",333,380,713,276,385,268
"140146505",290,328,618,212,269,207
"140146503",172,248,420,215,327,202
"140146502",340,396,736,322,444,308
"140146501",257,271,528,215,303,209
"140146411",444,481,925,278,300,245
"140146410",519,586,1105,340,369,305
"140146409",449,522,971,326,376,321
"140146408",394,484,878,311,347,296
"140146407",471,506,977,355,439,350
"140146406",222,284,506,216,281,216
"140146405",308,322,630,263,293,232
"140146401",286,315,601,212,265,205
"140146313",325,390,715,227,224,204
"140146312",257,298,555,177,206,168
"140146311",307,328,635,206,232,202
"140146310",325,362,687,219,250,205
"140146309",428,468,896,280,307,266
"140146308",419,493,912,289,316,267
"140146307",375,441,816,285,308,276
"140146305",501,587,1088,375,405,351
"140146304",330,410,740,234,255,221
"140146303",291,305,596,215,231,197
"140146302",288,369,657,224,236,215
"140146301",299,337,636,215,252,209
"140146213",434,507,941,272,286,258
"140146212",590,630,1220,318,320,292
"140146211",871,842,1713,434,421,375
"140146402",469,533,1002,396,483,383
"141050217",533,531,1064,312,344,296
"141050216",556,565,1121,356,396,345
"140146210",474,567,1041,320,352,309
"140146209",475,526,1001,340,372,321
"140146208",449,454,903,271,277,236
"140146207",431,444,875,243,250,229
"140146206",421,448,869,258,290,244
"140146205",328,357,685,216,258,208
"140146204",315,382,697,219,251,214
"140146203",400,438,838,274,293,254
"140146202",371,431,802,283,341,277
"140146201",422,489,911,278,272,239
"140146115",697,684,1381,322,254,239
"140146114",480,514,994,250,233,223
"140146112",917,932,1849,460,470,427
"140146111",564,541,1105,274,272,258
"140146110",407,459,866,231,236,211
"140146109",409,446,855,239,238,221
"141050209",70,64,134,49,68,48
"140146403",278,363,641,306,407,292
"140146108",562,564,1126,284,273,256
"140146107",571,550,1121,254,232,219
"140146106",417,447,864,230,235,218
"140146105",682,619,1301,322,294,284
"140146104",468,447,915,226,208,192
"140146103",499,491,990,243,239,213
"140146101",590,602,1192,311,289,267
"140146018",384,461,845,317,422,304
"140146017",485,535,1020,338,400,326
"140146016",343,422,765,256,288,242
"140146015",418,471,889,335,451,328
"140146014",428,532,960,370,450,358
"140146013",249,305,554,220,274,217
"140146001",389,445,834,291,320,264
"140145912",388,470,858,325,414,314
"140145911",184,228,412,182,212,157
"140145910",203,216,419,214,293,206
"140145909",214,241,455,240,314,208
"140145908",119,146,265,122,188,118
"140145907",190,271,461,218,312,195
"140145906",199,250,449,232,324,216
"140145905",241,279,520,247,309,218
"140145904",261,310,571,273,367,266
"140145903",260,321,581,288,436,284
"140145902",153,159,312,156,250,149
"140145901",438,504,942,305,294,231
"140145813",92,103,195,91,201,90
"140145812",205,271,476,275,376,265
"140145811",264,321,585,302,485,299
"140145810",104,148,252,122,149,117
"140145809",223,285,508,263,424,260
"140145808",240,289,529,301,493,270
"140145807",165,232,397,200,290,192
"140145806",272,377,649,292,399,283
"140145805",265,327,592,280,342,236
"140145804",185,249,434,222,320,219
"140145803",154,199,353,165,237,147
"140144805",260,330,590,237,311,234
"140144804",228,291,519,244,300,240
"140144803",280,313,593,282,344,272
"140144802",255,312,567,269,339,266
"140144801",159,214,373,174,240,174
"140144712",439,613,1052,446,560,417
"140144711",347,389,736,250,267,222
"140144710",222,266,488,192,268,191
"140144709",246,294,540,204,284,187
"140144708",432,460,892,330,426,290
"140144707",412,471,883,286,320,261
"140144702",279,290,569,203,191,159
"140144701",217,236,453,158,169,133
"140144616",499,527,1026,291,258,233
"140144614",580,602,1182,359,341,309
"140144613",228,237,465,150,179,141
"140144612",423,531,954,342,377,248
"140144611",656,665,1321,411,372,296
"140144610",555,597,1152,331,290,258
"140144609",524,578,1102,313,300,276
"140144608",342,431,773,235,263,219
"140144607",383,463,846,250,251,214
"140982107",234,290,524,233,359,230
"140982106",230,273,503,198,271,198
"140144606",432,499,931,281,317,262
"140144605",403,440,843,247,228,202
"140144604",361,374,735,214,229,196
"140144603",458,520,978,296,302,221
"140144602",612,643,1255,381,393,352
"140144601",484,505,989,276,256,232
"140144512",436,479,915,278,288,263
"140144511",453,514,967,285,319,272
"140144510",659,689,1348,395,454,375
"140144509",549,578,1127,330,364,324
"140144508",413,465,878,288,368,286
"140144507",520,588,1108,336,395,326
"140982008",410,517,927,373,458,352
"140144505",477,497,974,318,341,296
"140144504",508,563,1071,331,356,292
"140144503",443,460,903,271,272,239
"140144502",944,947,1891,502,495,428
"140144501",705,686,1391,373,362,325
"140144703",391,498,889,310,351,292
"140144411",715,793,1508,424,462,401
"140144410",395,431,826,259,272,247
"140144409",525,572,1097,283,279,263
"140981906",424,418,842,231,245,219
"140144408",292,326,618,208,236,199
"140144407",540,591,1131,366,344,311
"140144406",764,862,1626,487,519,447
"140144405",353,367,720,225,224,204
"140211010",403,493,896,318,361,300
"140211009",336,384,720,240,296,230
"140211008",429,508,937,301,292,272
"140211007",281,313,594,173,204,169
"140211006",552,572,1124,317,380,309
"140211005",399,442,841,240,241,201
"140211004",575,645,1220,372,422,352
"140211003",420,488,908,321,372,289
"140211002",378,430,808,274,285,265
"140211001",626,702,1328,384,418,380
"140211102",529,511,1040,254,259,245
"140210914",447,508,955,325,358,312
"140210913",420,457,877,306,300,262
"140210912",300,336,636,204,216,190
"140210911",1221,716,1937,403,406,365
"140210910",476,525,1001,288,288,257
"140210909",264,345,609,204,260,194
"140210908",213,244,457,180,225,163
"140210906",455,464,919,275,278,255
"140210905",225,298,523,189,250,182
"140210904",303,334,637,197,214,195
"140210903",355,387,742,216,251,212
"140210902",435,418,853,260,271,237
"140210901",405,406,811,242,283,235
"140210814",643,606,1249,269,283,251
"140210803",893,846,1739,348,351,339
"140210716",315,311,626,156,190,154
"140210715",570,582,1152,266,282,264
"140210714",395,357,752,164,153,146
"140210805",627,630,1257,313,288,271
"140210713",104,93,197,59,67,53
"140210711",474,495,969,248,260,232
"140210705",755,767,1522,372,395,350
"140210704",368,352,720,170,163,147
"140210616",572,584,1156,318,346,305
"140210615",813,795,1608,416,449,402
"140210614",713,800,1513,418,459,413
"140210813",528,558,1086,263,273,236
"140210804",611,595,1206,303,287,263
"140210812",509,473,982,231,250,219
"140147721",367,372,739,202,194,180
"140147719",603,686,1289,281,280,242
"140147718",338,353,691,241,269,229
"140147717",580,590,1170,322,338,292
"140147716",351,432,783,241,235,212
"140147715",534,583,1117,305,309,286
"140147714",455,492,947,251,244,209
"140147713",673,780,1453,405,416,382
"140147712",442,520,962,273,302,260
"140147710",425,466,891,286,341,281
"140147709",363,428,791,265,319,255
"140147708",422,450,872,274,318,270
"140147707",492,580,1072,360,388,345
"140147706",404,479,883,275,283,251
"140147705",474,510,984,295,328,283
"140147704",403,443,846,267,288,252
"140147703",337,396,733,241,295,231
"140147702",386,431,817,244,276,235
"140147701",514,589,1103,348,387,332
"140147617",730,738,1468,350,319,300
"140147616",725,835,1560,380,376,354
"141050613",185,180,365,99,121,98
"141050612",685,712,1397,384,445,369
"141050611",608,622,1230,317,360,309
"140147615",401,466,867,244,277,238
"140147614",504,546,1050,299,287,265
"140147613",398,425,823,236,228,207
"140147612",609,649,1258,329,329,304
"140147611",439,524,963,287,316,281
"140147610",456,471,927,298,339,286
"140147609",550,578,1128,314,329,274
"140147608",418,467,885,254,265,249
"140147607",516,520,1036,279,296,263
"140147606",1162,1278,2440,594,585,540
"140147605",498,528,1026,295,315,275
"140147604",488,527,1015,291,304,273
"140147603",445,465,910,247,275,238
"140147602",493,538,1031,308,320,295
"140144404",287,340,627,208,221,189
"140144403",483,569,1052,293,322,270
"140144402",464,456,920,259,258,239
"140144401",559,609,1168,539,813,519
"140144309",701,686,1387,353,367,322
"140144308",757,738,1495,383,364,336
"140144307",587,615,1202,306,301,274
"140144306",781,872,1653,451,381,355
"140144305",332,346,678,175,165,159
"140144303",642,647,1289,336,317,296
"140144302",797,821,1618,453,505,413
"140144301",529,555,1084,330,382,322
"140981801",610,647,1257,417,480,395
"140981712",679,735,1414,435,462,413
"140144706",276,333,609,229,313,213
"140144513",256,325,581,200,209,188
"140144220",519,554,1073,327,373,320
"140144217",339,394,733,245,283,241
"140144216",510,548,1058,321,339,313
"140144215",313,305,618,201,239,201
"140144214",449,519,968,305,335,299
"140144213",318,397,715,226,269,221
"140144212",369,457,826,277,319,274
"140144211",372,371,743,246,274,237
"140981613",175,229,404,186,302,184
"140144210",295,318,613,195,216,191
"140144209",251,289,540,202,240,199
"140144208",562,614,1176,380,444,373
"140144207",387,472,859,275,308,270
"140144206",313,373,686,229,289,226
"140144205",264,349,613,189,229,183
"140144204",250,297,547,178,214,172
"140144203",179,233,412,139,197,138
"140144202",188,232,420,139,178,136
"140144201",290,376,666,193,255,191
"140144119",335,346,681,217,246,204
"140144118",272,328,600,256,286,223
"140144117",381,457,838,261,332,254
"140144116",271,331,602,198,229,195
"140144115",334,385,719,263,300,251
"140144114",404,484,888,310,362,307
"140144113",366,454,820,294,347,283
"140144112",401,477,878,303,350,290
"140144111",279,353,632,210,224,182
"140144109",299,320,619,222,258,207
"140144108",208,248,456,161,185,157
"140144107",280,359,639,222,285,217
"140144106",314,383,697,244,291,238
"140981508",358,375,733,239,265,236
"140981505",405,381,786,241,264,227
"140144105",240,320,560,214,240,210
"140144104",260,273,533,195,226,193
"140144103",420,506,926,320,374,312
"140144102",253,294,547,210,246,197
"140144101",309,366,675,257,302,251
"140144012",338,363,701,258,296,226
"140144011",319,369,688,224,259,204
"140144010",392,480,872,315,345,227
"140144008",471,513,984,322,373,288
"140144007",1120,405,1525,247,248,225
"140144005",230,245,475,158,216,156
"140144004",297,320,617,200,225,188
"140144003",331,379,710,231,286,223
"140144002",291,343,634,223,270,210
"140144001",307,348,655,251,327,245
"140981409",215,199,414,132,154,129
"140143913",258,293,551,179,210,166
"140143912",384,428,812,324,445,313
"140143910",248,304,552,260,438,256
"140143909",334,414,748,286,398,279
"140143908",300,348,648,261,408,259
"140143907",342,370,712,212,241,197
"140143906",298,344,642,220,293,217
"140143905",276,307,583,191,276,190
"140143904",280,323,603,229,282,208
"140143903",425,531,956,345,492,333
"140143902",509,599,1108,377,500,372
"140144006",159,238,397,178,227,175
"140143901",265,277,542,177,236,171
"140143816",303,340,643,231,313,222
"140143815",301,379,680,248,301,243
"140143814",353,388,741,300,413,294
"140143813",385,435,820,297,336,286
"140143812",350,390,740,225,265,215
"140143811",308,452,760,260,337,255
"140143810",367,471,838,319,375,293
"140143809",336,399,735,254,281,234
"140143808",568,632,1200,368,452,359
"140143807",330,384,714,251,306,249
"140143806",342,381,723,254,300,250
"140143805",323,394,717,235,249,216
"140143804",424,474,898,308,357,299
"140143803",442,539,981,346,380,324
"140143802",463,553,1016,339,378,304
"140143801",544,654,1198,379,419,350
"140143721",242,274,516,163,200,159
"140143720",283,307,590,209,249,201
"140143719",283,315,598,216,262,207
"140143718",211,257,468,166,216,162
"140143717",299,307,606,215,219,185
"140143716",263,302,565,192,212,183
"140143715",306,339,645,217,254,210
"140143714",289,344,633,207,214,180
"140143713",309,394,703,241,274,219
"140143712",392,473,865,244,267,232
"140143711",633,739,1372,428,469,403
"140143710",383,410,793,233,229,211
"140143709",317,367,684,240,282,220
"140143708",500,553,1053,330,360,297
"140143707",516,561,1077,303,315,270
"140143706",538,574,1112,289,229,210
"140143705",440,447,887,266,245,215
"140143704",403,491,894,260,253,223
"140143703",392,423,815,243,238,203
"140143701",657,750,1407,421,394,366
"140143614",318,344,662,208,229,208
"140143613",331,379,710,234,246,206
"140143612",323,419,742,253,296,249
"140143611",377,433,810,259,269,248
"140143606",374,424,798,250,281,237
"140143602",347,388,735,233,257,228
"140143601",353,399,752,245,270,241
"140143514",586,667,1253,385,379,318
"140143512",472,570,1042,305,275,250
"140143511",538,575,1113,328,307,289
"140143510",327,386,713,238,230,212
"140143509",388,429,817,240,276,226
"140981212",331,344,675,214,228,210
"140981206",198,170,368,97,108,96
"140143507",579,669,1248,354,363,335
"140143506",1651,1622,3273,850,704,678
"140146011",448,552,1000,378,477,360
"140143605",447,549,996,313,318,281
"140143604",462,530,992,311,337,298
"140143603",556,622,1178,353,357,311
"140143505",350,343,693,186,559,181
"140981109",406,426,832,252,315,249
"140143504",632,700,1332,403,414,369
"140143503",332,359,691,213,228,202
"140143502",705,788,1493,430,457,417
"140143501",454,454,908,261,265,245
"140143419",296,343,639,202,250,186
"140143418",530,658,1188,363,395,340
"140143415",314,374,688,218,223,197
"140143414",339,396,735,221,227,195
"140143413",337,413,750,244,269,229
"140143412",375,424,799,236,245,226
"140143411",304,320,624,198,215,192
"140143410",315,363,678,208,223,192
"140143408",368,363,731,219,218,193
"140143407",345,365,710,211,228,196
"140143406",281,325,606,176,193,168
"140143405",280,302,582,176,199,167
"140143404",205,200,405,134,156,133
"140143403",378,424,802,257,290,252
"140143402",480,565,1045,294,297,279
"140143401",390,429,819,241,244,218
"140143320",362,383,745,227,236,208
"140143319",493,543,1036,287,319,273
"140143318",598,672,1270,377,395,363
"140143317",516,570,1086,336,362,310
"140143316",335,357,692,218,224,198
"140143315",386,464,850,285,339,267
"140143313",447,513,960,292,290,251
"140142601",400,429,829,238,250,217
"140142518",439,485,924,316,356,308
"140142517",327,415,742,233,250,221
"140142516",504,536,1040,344,361,314
"140142515",468,550,1018,369,402,343
"140142514",293,328,621,211,218,208
"140142513",321,370,691,233,260,231
"140142512",298,397,695,239,267,231
"140142511",357,416,773,255,256,240
"140142510",301,360,661,221,232,186
"140142509",352,382,734,226,210,189
"140142508",256,300,556,185,223,175
"140142507",472,567,1039,334,338,310
"140142506",483,563,1046,347,354,325
"140142505",387,441,828,247,254,230
"140142504",557,662,1219,344,369,318
"140142503",127,150,277,89,105,88
"140142615",405,475,880,309,379,305
"140142501",206,278,484,280,382,269
"140142414",256,342,598,199,234,198
"140142413",276,355,631,220,273,217
"140142412",225,296,521,188,283,183
"140142411",301,339,640,231,253,222
"140142410",190,268,458,194,204,180
"140142408",337,414,751,251,289,244
"140142407",335,391,726,260,295,251
"140142406",402,521,923,311,367,300
"140142405",398,427,825,268,303,255
"140142404",630,657,1287,419,467,412
"140142502",292,333,625,212,188,181
"140142403",397,448,845,301,331,290
"140142402",455,516,971,341,384,330
"140142401",537,578,1115,336,401,331
"140980608",144,132,276,93,219,93
"140980607",108,113,221,75,257,75
"140980606",96,83,179,50,200,50
"140142316",312,322,634,200,252,194
"140142314",433,438,871,254,273,242
"140142313",846,931,1777,450,529,448
"140142312",414,460,874,252,289,245
"140142311",361,379,740,218,271,214
"140980514",283,286,569,201,236,188
"140980513",322,350,672,232,277,225
"140143103",800,862,1662,442,404,385
"140142309",291,310,601,182,191,166
"140142308",614,660,1274,351,412,341
"140142307",396,424,820,262,303,248
"140142306",344,418,762,259,320,255
"140142305",249,287,536,182,220,172
"140142304",236,284,520,186,185,185
"140145802",265,339,604,282,404,258
"140145801",115,151,266,138,205,136
"140145714",177,262,439,262,474,259
"140145713",176,251,427,232,412,223
"140145712",101,143,244,135,261,133
"140145711",143,192,335,172,312,171
"140145710",109,168,277,155,325,147
"140145709",105,168,273,140,241,136
"140145708",57,86,143,71,185,70
"140145707",119,185,304,194,345,193
"140145706",73,126,199,113,174,113
"140145705",154,199,353,152,212,149
"140145704",283,419,702,399,764,387
"140145702",183,258,441,227,361,217
"140145701",294,447,741,383,516,354
"140145619",138,174,312,165,231,164
"140145618",188,282,470,216,378,203
"140145617",151,222,373,179,328,179
"140145616",114,176,290,145,197,130
"140145615",110,157,267,129,225,126
"140145614",97,111,208,126,220,126
"140145613",141,149,290,145,253,143
"140145612",94,107,201,113,146,89
"140145611",271,272,543,279,353,243
"140145610",73,91,164,89,151,87
"140145609",130,170,300,138,239,138
"140145608",123,125,248,122,207,121
"140145607",109,149,258,130,268,123
"140145606",122,189,311,149,256,146
"140145605",186,206,392,160,180,138
"140145604",173,177,350,161,260,158
"140145603",234,264,498,226,434,209
"140145602",238,342,580,219,339,217
"140145601",190,221,411,217,325,199
"140145508",46,68,114,57,140,54
"140145507",115,163,278,150,341,146
"140145506",83,108,191,106,199,105
"140145505",162,151,313,144,222,138
"140145504",104,127,231,122,157,121
"140145503",123,125,248,125,125,80
"141050114",446,518,964,275,339,257
"141050113",392,409,801,196,229,195
"141050112",308,347,655,189,210,183
"140145502",244,216,460,231,344,212
"140145501",256,296,552,227,309,221
"140145416",156,205,361,197,298,195
"140145415",188,235,423,244,402,215
"140145414",192,252,444,257,534,252
"140145413",294,428,722,428,689,397
"140145412",241,248,489,223,360,208
"140145411",139,129,268,114,202,114
"140145410",243,274,517,173,230,152
"140145409",291,331,622,252,387,222
"140145408",163,216,379,194,273,168
"140145407",120,161,281,157,237,150
"140145406",270,325,595,280,405,263
"140145405",171,183,354,144,212,135
"140145404",198,249,447,212,317,205
"140145403",243,235,478,216,328,202
"140145402",223,237,460,205,278,175
"140145401",222,218,440,181,274,146
"140145320",182,212,394,141,161,135
"140145319",318,316,634,211,234,197
"140145318",275,304,579,206,236,197
"140145317",236,285,521,174,204,169
"140145316",227,247,474,161,203,159
"140145315",300,410,710,338,479,336
"140145314",287,285,572,193,227,175
"140145313",212,285,497,190,224,179
"140145312",259,337,596,208,263,202
"140145311",303,360,663,251,311,245
"140145310",302,412,714,285,338,274
"140145309",283,360,643,225,272,218
"140145308",429,492,921,302,352,292
"140145306",265,355,620,273,417,268
"140982905",333,332,665,193,223,188
"140982904",331,323,654,219,240,210
"140145305",209,258,467,182,319,176
"140145509",135,143,278,169,314,139
"140145303",173,233,406,140,179,134
"140145302",304,385,689,222,307,214
"140145301",316,454,770,243,341,240
"140145219",559,582,1141,296,272,252
"140145218",675,692,1367,315,276,263
"140982705",387,400,787,274,298,264
"140145217",471,444,915,231,227,205
"140145216",438,470,908,253,272,226
"140145304",217,259,476,165,230,163
"140145215",351,355,706,197,178,156
"140145214",334,381,715,242,275,236
"140145213",380,432,812,248,260,223
"140145212",561,595,1156,299,311,282
"140145211",259,305,564,163,175,148
"140145210",263,296,559,182,234,182
"140145209",267,277,544,187,228,184
"140145208",273,359,632,213,280,210
"140145207",291,373,664,223,246,216
"140145206",234,293,527,191,227,188
"140145204",790,787,1577,421,425,394
"140145203",333,398,731,232,252,211
"140145202",448,563,1011,340,394,328
"140145201",250,327,577,222,253,221
"140145121",461,528,989,258,267,241
"140145120",1023,1041,2064,532,509,485
"140145119",637,646,1283,359,356,331
"140145118",425,471,896,282,282,248
"140145117",639,721,1360,377,369,323
"140145116",288,298,586,164,156,143
"140145115",387,409,796,204,198,182
"140145114",438,478,916,268,269,245
"140145110",367,423,790,237,263,216
"140145109",478,541,1019,312,336,304
"140145108",401,479,880,268,271,243
"140145107",501,568,1069,320,288,273
"140145106",484,554,1038,326,332,307
"140145105",352,413,765,248,238,223
"140145104",408,487,895,277,275,242
"140145103",279,307,586,203,203,187
"140145102",353,372,725,262,281,231
"140145101",367,405,772,269,296,262
"140145015",354,414,768,275,292,262
"140145014",287,353,640,241,271,237
"140145013",254,293,547,196,237,192
"140145012",336,393,729,228,259,195
"140145011",314,372,686,259,299,255
"140145010",332,397,729,258,289,247
"140145008",294,393,687,246,287,235
"140145007",316,394,710,284,313,273
"140145006",275,308,583,211,252,207
"140145005",340,433,773,218,251,213
"140145004",326,385,711,235,274,220
"140145003",294,314,608,213,247,209
"140145002",434,464,898,293,324,283
"140145001",357,394,751,290,287,250
"140144921",272,329,601,297,407,289
"140144920",197,223,420,199,342,198
"140144919",176,248,424,218,351,217
"140144918",139,162,301,161,222,156
"140144917",116,149,265,153,246,151
"140144916",342,365,707,347,515,345
"140144915",258,324,582,252,376,246
"140144914",241,300,541,232,382,222
"140144913",332,405,737,343,504,330
"140144912",200,237,437,180,248,168
"140144911",136,153,289,124,153,96
"140144909",293,384,677,322,461,310
"140144908",432,471,903,303,383,299
"140144907",515,539,1054,355,434,332
"140144906",204,222,426,148,190,130
"140144905",258,329,587,219,292,206
"140144904",253,305,558,205,206,177
"140144903",208,243,451,148,194,145
"140144902",208,240,448,175,227,168
"140144901",211,227,438,148,202,135
"140144816",325,322,647,268,341,258
"140144815",472,464,936,389,509,372
"140144814",311,342,653,238,287,233
"140144813",294,331,625,266,384,258
"140144812",253,309,562,239,294,223
"140144811",257,317,574,257,336,253
"140144810",399,457,856,335,438,330
"140144809",197,229,426,162,206,158
"140144808",245,301,546,228,284,218
"140144807",339,404,743,308,389,298
"140144806",281,284,565,219,253,189
"140142303",328,373,701,217,258,214
"140142302",452,539,991,332,341,284
"140142301",395,450,845,245,245,200
"140142218",710,815,1525,426,439,393
"140142216",425,468,893,291,730,282
"140142214",404,419,823,257,275,228
"140142213",4,3,7,3,3,3
"140142212",550,547,1097,377,427,289
"140142211",534,565,1099,309,347,278
"140142208",602,621,1223,355,379,335
"140142206",715,742,1457,437,495,415
"140142205",254,306,560,126,181,118
"140142204",399,396,795,207,216,197
"140142310",431,404,835,259,354,256
"140142217",600,581,1181,322,330,298
"140142203",353,379,732,217,339,202
"140142201",353,348,701,198,267,197
"140142917",512,610,1122,341,356,305
"140142105",722,457,1179,213,264,207
"140980409",143,161,304,102,144,101
"140980408",367,370,737,233,267,228
"140980407",353,366,719,207,232,203
"140142103",493,469,962,258,305,252
"140146010",258,302,560,226,289,209
"140142210",504,550,1054,310,319,288
"140142102",543,576,1119,282,342,275
"140142101",470,497,967,274,359,272
"140142015",285,326,611,188,232,185
"140142014",538,581,1119,310,309,275
"140142209",351,440,791,245,267,230
"140142013",476,527,1003,289,320,275
"140142012",483,505,988,299,339,292
"140142011",355,394,749,238,256,220
"140142010",453,461,914,267,291,251
"140142009",333,368,701,228,237,217
"140142008",382,399,781,213,245,204
"140142007",391,446,837,257,286,246
"140142006",430,448,878,253,263,236
"140980305",479,469,948,299,346,297
"140980304",320,358,678,245,294,243
"140142005",610,713,1323,396,409,368
"140142004",551,561,1112,327,348,309
"140143417",281,322,603,196,216,190
"140142003",411,467,878,255,288,251
"140142002",370,392,762,236,284,233
"140142001",488,529,1017,281,290,248
"140141919",475,484,959,244,243,236
"140141918",404,425,829,247,268,236
"140141917",401,424,825,246,243,226
"140141916",686,783,1469,407,431,380
"140141915",777,853,1630,441,430,417
"140141913",697,762,1459,348,334,328
"140141912",541,494,1035,252,235,225
"140141911",543,588,1131,405,426,391
"140141910",441,485,926,205,200,192
"140141909",692,687,1379,318,334,292
"140141914",771,794,1565,348,339,324
"140141908",899,931,1830,433,422,409
"140141907",847,888,1735,417,371,370
"140141906",768,814,1582,366,356,335
"140141905",571,551,1122,268,231,211
"140141904",573,604,1177,306,295,281
"140141903",536,535,1071,267,249,234
"140141902",389,404,793,234,250,229
"140141901",594,690,1284,402,398,360
"140141818",732,688,1420,317,250,244
"140141817",643,614,1257,306,250,243
"140141816",928,937,1865,450,466,420
"140141815",504,549,1053,281,268,251
"140141814",701,705,1406,350,341,326
"140141812",558,602,1160,328,339,305
"140141811",585,663,1248,358,347,329
"140141810",351,391,742,245,307,243
"140141809",624,641,1265,348,340,326
"140141808",834,864,1698,471,532,446
"140141807",422,470,892,229,243,216
"140141806",450,496,946,237,229,213
"140141805",861,846,1707,429,422,386
"140141804",496,532,1028,237,217,212
"140141803",518,540,1058,282,271,263
"140141813",527,555,1082,309,308,296
"140141802",540,569,1109,279,310,263
"140141801",788,807,1595,438,473,381
"140141721",644,654,1298,401,408,371
"140141720",311,344,655,193,220,181
"140141719",531,527,1058,297,300,266
"140141718",652,689,1341,349,386,330
"140141717",851,885,1736,475,470,435
"140141714",459,498,957,266,285,250
"140141713",847,902,1749,466,467,417
"140141712",499,519,1018,276,266,240
"140141711",582,637,1219,336,376,323
"140141710",590,616,1206,344,382,330
"140141709",414,466,880,236,244,220
"140141708",603,638,1241,310,326,295
"140141707",483,490,973,240,292,209
"140141706",824,805,1629,446,456,400
"140141705",569,582,1151,307,356,297
"140141704",678,732,1410,389,410,368
"140141703",578,612,1190,280,270,259
"140141702",590,568,1158,323,321,291
"140141616",939,887,1826,544,579,521
"140141615",435,449,884,232,267,225
"140141614",517,526,1043,253,290,247
"140141613",547,513,1060,268,293,254
"140141608",333,393,726,187,220,171
"140141607",612,671,1283,329,331,291
"140141606",656,680,1336,341,338,303
"140141605",487,554,1041,273,261,248
"140141604",409,369,778,204,190,177
"140141602",922,934,1856,413,414,397
"140911912",61,47,108,42,191,41
"140911911",450,479,929,285,406,273
"140141716",980,962,1942,479,426,405
"140141701",709,704,1413,409,427,387
"140141519",515,495,1010,261,311,246
"140141518",451,511,962,227,290,222
"140143416",382,399,781,249,280,226
"140141516",330,320,650,169,183,155
"140141515",542,494,1036,247,296,243
"140141514",598,646,1244,353,381,333
"140141513",1016,1046,2062,540,514,454
"140141512",289,338,627,191,199,188
"140141715",670,740,1410,390,390,370
"140141511",704,753,1457,410,416,378
"140141510",617,655,1272,324,355,312
"140141509",606,718,1324,395,446,392
"140141508",463,497,960,269,253,235
"140141507",312,358,670,199,213,194
"140141506",777,810,1587,451,509,446
"140141505",491,562,1053,308,325,293
"140141503",315,350,665,198,229,187
"140141502",389,438,827,248,281,241
"140141501",388,386,774,203,241,200
"140911808",309,318,627,194,416,189
"140911807",142,140,282,90,238,79
"140911806",169,167,336,117,470,113
"140141402",1134,1096,2230,503,464,454
"140141401",733,763,1496,364,331,318
"140141309",959,946,1905,445,429,417
"140141307",685,722,1407,337,360,320
"140141204",767,769,1536,376,383,347
"140141203",703,721,1424,350,344,312
"140141202",575,614,1189,341,345,316
"140141111",522,532,1054,295,313,280
"140141110",512,570,1082,270,245,210
"140911715",155,148,303,98,241,98
"140141109",807,839,1646,406,403,384
"140146009",305,331,636,271,368,260
"140141303",510,526,1036,280,288,262
"140141302",686,668,1354,371,372,333
"140141301",215,230,445,138,134,116
"140140106",565,614,1179,344,343,324
"140146007",274,312,586,231,256,202
"140070818",398,428,826,278,320,275
"140140203",527,571,1098,346,415,343
"140140202",670,684,1354,452,623,450
"140070820",316,314,630,197,233,178
"140146006",337,368,705,260,320,252
"140070806",281,290,571,203,243,202
"140070805",543,579,1122,352,471,335
"140070804",94,106,200,69,122,65
"140146005",427,491,918,366,456,347
"140070819",59,59,118,35,135,35
"140070803",411,453,864,275,385,268
"140911202",295,343,638,233,368,229
"140143213",487,519,1006,291,313,271
"140070719",223,267,490,184,326,177
"140070718",37,24,61,28,153,28
"140141010",559,526,1085,357,365,307
"140911007",305,301,606,155,202,154
"140143212",430,469,899,240,229,215
"140070720",26,28,54,19,118,19
"140141009",500,548,1048,331,363,320
"140910916",617,590,1207,346,435,338
"140070616",158,169,327,109,208,109
"140910910",208,281,489,170,293,158
"140143211",510,529,1039,305,287,265
"140070614",411,393,804,250,385,243
"140070609",235,261,496,153,256,151
"140070608",339,348,687,228,382,227
"140143312",442,463,905,257,275,240
"140143311",416,480,896,291,294,263
"140143310",376,452,828,262,277,241
"140143309",393,442,835,266,286,246
"140143308",683,676,1359,347,380,332
"140143307",564,587,1151,307,334,295
"140143306",360,378,738,209,230,196
"140143305",339,385,724,223,229,212
"140143304",389,421,810,241,235,204
"140143303",479,524,1003,271,265,249
"140143302",368,427,795,234,228,208
"140143301",453,512,965,285,288,259
"140143203",372,407,779,229,232,223
"140143202",656,783,1439,417,401,384
"140143201",379,436,815,245,227,216
"140143116",626,652,1278,359,325,305
"140143114",435,497,932,292,303,263
"140143113",465,506,971,285,325,266
"140143112",684,735,1419,413,409,343
"140143111",462,534,996,275,256,236
"140143110",495,461,956,266,244,228
"140143109",843,886,1729,450,402,373
"140143108",558,604,1162,324,311,287
"140143107",724,780,1504,425,459,414
"140143106",532,545,1077,264,278,254
"140143105",671,745,1416,367,330,306
"140143104",608,596,1204,310,301,289
"140143102",978,971,1949,478,392,376
"140143101",591,604,1195,296,269,261
"140143015",500,548,1048,285,274,252
"140143014",559,631,1190,333,336,310
"140143013",554,554,1108,319,328,297
"140143012",593,628,1221,331,338,303
"140143011",466,552,1018,302,304,277
"140143010",550,591,1141,316,291,269
"140143009",709,728,1437,399,391,362
"140981014",381,385,766,245,285,240
"140981013",452,485,937,282,334,277
"140143008",628,675,1303,289,287,273
"140143007",353,344,697,173,156,136
"140143006",646,593,1239,309,293,250
"140143005",505,437,942,239,214,186
"140143004",701,754,1455,373,359,315
"140143003",498,517,1015,275,281,241
"140143002",660,759,1419,404,430,378
"140143001",404,431,835,269,300,259
"140142919",417,461,878,237,234,208
"140142918",458,462,920,249,241,214
"140142915",636,685,1321,418,407,382
"140142914",440,532,972,290,316,272
"140142913",380,417,797,267,268,246
"140142912",526,571,1097,282,268,246
"140142911",403,435,838,237,225,200
"140142910",535,560,1095,299,298,259
"140142909",600,621,1221,325,306,282
"140142908",403,473,876,283,285,260
"140142906",480,612,1092,376,405,363
"140142905",606,681,1287,371,322,309
"140142904",626,645,1271,330,307,279
"140142903",587,637,1224,317,296,274
"140142902",505,523,1028,270,278,261
"140142901",572,582,1154,315,328,304
"140142816",927,949,1876,465,438,418
"140142815",431,504,935,269,265,246
"140142814",863,872,1735,347,333,311
"140142813",781,816,1597,398,370,339
"140980906",364,396,760,265,322,262
"140142812",418,511,929,258,258,238
"140142811",510,560,1070,294,296,270
"140142810",615,648,1263,344,353,308
"140142809",478,528,1006,304,321,284
"140142808",586,690,1276,394,391,363
"140142807",336,395,731,238,228,224
"140142806",387,451,838,261,266,252
"140142805",565,628,1193,352,332,310
"140142804",636,698,1334,442,418,398
"140142803",547,652,1199,381,388,360
"140142802",493,504,997,328,356,307
"140142801",612,655,1267,400,404,381
"140142712",293,356,649,214,245,205
"140142711",415,448,863,272,296,252
"140142710",449,487,936,301,312,277
"140142709",319,402,721,225,218,197
"140142708",445,556,1001,324,336,295
"140142707",408,501,909,302,317,275
"140142706",394,431,825,238,252,219
"140142705",288,350,638,195,202,179
"140142704",450,507,957,300,265,243
"140142703",613,688,1301,357,350,316
"140142613",329,335,664,215,245,202
"140142612",362,443,805,280,346,276
"140142611",600,613,1213,376,434,361
"140980809",297,309,606,205,247,193
"140980808",361,406,767,280,346,265
"140142610",280,322,602,203,230,194
"140142609",354,428,782,275,365,264
"140142608",518,592,1110,370,464,342
"140142607",340,401,741,247,250,226
"140142606",347,408,755,252,276,229
"140142605",208,269,477,179,213,172
"140142604",228,293,521,173,230,166
"140142603",424,474,898,267,261,225
"140142602",307,357,664,199,223,175
"140070605",87,85,172,68,233,65
"140143210",611,738,1349,433,438,413
"140146004",389,431,820,300,418,288
"140141008",811,810,1621,501,512,438
"140070516",200,193,393,125,223,117
"140070514",283,304,587,179,290,173
"140070513",365,395,760,259,439,248
"140140313",704,713,1417,409,365,330
"140070615",224,193,417,140,356,136
"140910810",375,398,773,230,342,225
"140070512",402,428,830,299,408,276
"140070511",379,459,838,304,409,298
"140070507",334,324,658,173,260,156
"140070506",434,451,885,227,380,220
"140143209",407,434,841,243,233,225
"140140211",321,337,658,189,199,179
"140070505",241,256,497,182,321,180
"140070504",267,255,522,168,287,150
"140070503",244,253,497,169,332,166
"140070502",178,178,356,118,295,113
"140070501",331,334,665,206,434,205
"140143208",598,590,1188,285,330,250
"140140210",378,433,811,265,282,255
"140070415",97,86,183,58,103,56
"140140209",364,418,782,268,259,237
"140070416",202,224,426,133,296,129
"140140208",394,440,834,279,290,279
"140140207",504,577,1081,358,400,350
"140141007",220,269,489,157,182,152
"140140206",287,277,564,183,221,180
"140140811",706,733,1439,386,351,320
"140910704",330,369,699,228,363,224
"140910616",240,279,519,165,286,163
"140146003",264,319,583,212,260,204
"140140810",739,768,1507,380,377,331
"140070216",160,143,303,77,113,77
"140070213",225,236,461,179,263,174
"140070212",230,261,491,184,271,182
"140070211",465,449,914,302,366,281
"140140808",435,441,876,198,199,176
"140140113",592,606,1198,349,320,314
"140070210",179,232,411,157,237,153
"140070209",318,358,676,206,292,196
"140910608",578,556,1134,296,354,282
"140070208",474,506,980,293,365,264
"140143609",308,345,653,227,254,204
"140070207",382,425,807,273,344,264
"140070206",492,539,1031,321,427,312
"140070205",246,237,483,157,271,154
"140140112",434,516,950,315,331,306
"140070111",346,302,648,190,397,179
"140910506",306,385,691,202,262,200
"140910503",358,410,768,244,297,218
"140910420",521,525,1046,294,304,273
"140910417",608,710,1318,327,377,323
"140910416",259,279,538,178,209,167
"140910415",430,443,873,247,284,235
"140910414",267,318,585,230,290,228
"140910411",411,509,920,319,403,315
"140910410",182,264,446,147,152,140
"140910409",413,524,937,345,463,340
"140144704",195,214,409,158,209,157
"140910308",385,374,759,224,298,216
"140910305",330,356,686,224,327,222
"140910303",422,446,868,218,333,217
"140910116",308,329,637,215,287,211
"140910106",288,369,657,224,297,208
"140145517",252,339,591,342,641,338
"140840516",324,422,746,312,405,308
"140840511",335,387,722,286,383,280
"140840510",248,289,537,217,279,215
"140840509",307,341,648,256,292,246
"140141108",574,571,1145,275,259,247
"140141107",449,476,925,236,236,218
"140141106",426,434,860,239,246,226
"140141105",448,468,916,278,288,265
"140141104",347,389,736,200,219,195
"140141103",510,492,1002,276,300,259
"140141102",481,466,947,243,244,224
"140141406",671,678,1349,369,360,328
"140141209",548,561,1109,321,347,316
"140141208",512,576,1088,329,358,315
"140141017",380,389,769,225,274,225
"140141015",421,473,894,221,225,213
"140911707",273,287,560,159,232,155
"140911706",403,410,813,236,375,230
"140141014",318,308,626,193,215,186
"140146008",192,250,442,190,273,181
"140141002",784,841,1625,449,501,440
"140140914",515,542,1057,268,253,238
"140141207",463,532,995,283,303,256
"140140913",625,646,1271,316,351,306
"140140912",1018,1029,2047,481,485,439
"140140911",776,783,1559,415,427,385
"140140907",265,275,540,140,145,134
"140140906",467,513,980,256,222,203
"140140904",484,498,982,265,246,225
"140141405",443,443,886,254,270,238
"140141206",466,491,957,274,255,240
"140141205",792,869,1661,415,396,374
"140140903",626,586,1212,291,291,276
"140140807",484,500,984,291,313,280
"140140806",403,481,884,249,283,233
"140140805",828,831,1659,452,513,443
"140140804",615,604,1219,303,349,285
"140140802",459,434,893,206,220,202
"140141013",521,539,1060,300,305,275
"140140704",549,535,1084,260,275,249
"140140702",415,428,843,245,226,211
"140140608",321,303,624,156,155,144
"140911506",273,304,577,209,249,179
"140141012",351,381,732,229,267,224
"140140707",458,437,895,204,203,182
"140911503",362,352,714,201,292,192
"140141404",367,409,776,205,215,190
"140140515",699,725,1424,385,394,376
"140140514",758,779,1537,340,323,304
"140140513",670,746,1416,350,348,326
"140140512",583,628,1211,319,306,291
"140140511",576,606,1182,311,313,300
"140140510",689,750,1439,396,428,375
"140140509",451,474,925,260,239,213
"140140508",718,711,1429,384,368,356
"140140506",412,434,846,221,195,181
"140140505",818,893,1711,442,413,398
"140911414",293,406,699,250,364,232
"140911411",291,336,627,191,246,185
"140140410",723,774,1497,385,359,333
"140140409",516,556,1072,293,338,283
"140140408",749,805,1554,437,476,413
"140140407",483,499,982,299,329,282
"140140406",865,871,1736,428,410,393
"140140708",652,674,1326,300,314,280
"140140405",951,993,1944,473,464,447
"140140402",665,637,1302,295,286,257
"140140401",807,795,1602,394,405,373
"140141305",427,443,870,213,222,206
"140140312",558,655,1213,365,397,352
"140140311",374,425,799,273,284,262
"140140310",423,483,906,270,290,248
"140140308",603,647,1250,333,335,310
"140140307",362,389,751,230,238,210
"140140306",440,440,880,237,247,221
"140140305",560,569,1129,310,283,259
"140140304",732,718,1450,358,386,332
"140143610",282,338,620,202,228,192
"140141011",731,804,1535,432,420,378
"140140303",749,771,1520,421,431,386
"140140302",1038,1094,2132,547,513,491
"140140215",568,654,1222,381,372,350
"140140214",552,624,1176,368,368,318
"140140213",527,598,1125,360,383,342
"140140212",413,416,829,239,271,229
"140140107",362,397,759,248,259,225
"140140105",458,487,945,302,335,298
"140140104",403,408,811,212,225,199
"140140103",641,642,1283,362,357,330
"140140102",639,599,1238,313,303,264
"140911322",124,131,255,84,206,83
"140911321",152,139,291,89,276,89
"140911320",147,157,304,104,301,103
"140911319",146,175,321,107,173,104
"140840313",301,297,598,212,239,209
"140145516",185,204,389,202,326,198
"140840210",430,395,825,281,312,276
"140840209",179,194,373,123,137,122
"140840107",300,343,643,264,301,264
"140145515",65,70,135,91,137,81
"140145514",141,186,327,151,218,139
"140145513",180,218,398,128,256,125
"140700213",412,454,866,280,365,276
"140631110",518,545,1063,355,365,339
"140631103",343,341,684,214,228,213
"140630910",251,267,518,191,211,188
"140630707",342,370,712,263,280,245
"140630614",249,234,483,142,84,60
"140560618",275,284,559,189,213,180
"140560415",389,444,833,274,319,267
"140560312",366,407,773,289,320,288
"140560105",669,698,1367,389,417,385
"140560104",609,670,1279,381,410,368
"140490321",388,392,780,215,233,208
"140490320",470,538,1008,300,350,285
"140490319",499,619,1118,358,409,349
"140490318",296,372,668,229,275,218
"140490317",279,330,609,196,228,190
"140490316",308,372,680,216,231,208
"140490315",152,182,334,121,179,120
"140630415",360,369,729,212,224,210
"140630414",346,396,742,263,277,245
"140630413",448,468,916,332,365,313
"140630412",225,243,468,167,196,163
"140630411",252,273,525,193,213,191
"140630410",231,273,504,196,231,196
"140630409",231,282,513,191,221,186
"140630408",334,408,742,266,304,261
"140630311",478,498,976,283,308,280
"140630310",276,304,580,222,238,211
"140630213",371,403,774,268,332,263
"140630212",472,500,972,335,384,330
"140490115",400,434,834,182,256,179
"140490114",370,397,767,231,274,223
"140490113",526,625,1151,315,382,302
"140420915",299,351,650,253,325,247
"140420821",211,221,432,184,285,183
"140420705",410,511,921,374,500,371
"140420414",421,426,847,242,254,219
"140420309",415,426,841,277,310,257
"140420210",327,350,677,225,269,220
"140350510",357,366,723,221,250,220
"140350404",368,360,728,218,245,215
"140350215",503,493,996,320,358,307
"140350210",334,323,657,206,247,199
"140350110",441,407,848,224,264,214
"140350109",459,485,944,299,359,295
"140350108",574,612,1186,365,449,357
"140280509",276,365,641,223,261,219
"140280505",504,497,1001,249,301,242
"140280410",464,443,907,223,251,214
"140280406",357,398,755,197,246,191
"140280307",346,391,737,255,304,245
"140280305",554,598,1152,343,353,313
"140280214",492,634,1126,314,354,306
"140280202",469,484,953,267,295,258
"140211816",530,577,1107,319,344,297
"140211812",587,687,1274,385,410,373
"140211810",484,575,1059,305,300,275
"140211809",537,561,1098,282,284,260
"140211807",484,504,988,245,253,216
"140211804",362,442,804,292,332,276
"140211803",321,357,678,195,207,181
"140211707",555,589,1144,299,361,294
"140211608",354,393,747,245,294,239
"140211604",505,499,1004,249,274,239
"140211505",310,332,642,212,226,193
"140211501",304,334,638,212,315,207
"140211412",380,432,812,224,268,215
"140211213",323,332,655,198,291,192
"140211212",370,356,726,187,241,181
"140211203",449,475,924,274,389,268
"140211201",314,300,614,188,265,181
"140211119",452,502,954,300,328,291
"140211118",527,590,1117,351,367,337
"140211117",365,429,794,266,301,263
"140211015",250,254,504,126,130,120
"140210316",465,462,927,214,224,199
"140210209",287,271,558,201,344,199
"140210207",218,227,445,152,252,149
"140212115",321,340,661,192,185,171
"140212113",531,551,1082,274,283,260
"140212110",653,638,1291,311,357,294
"140212109",344,365,709,209,209,189
"140212103",383,346,729,184,211,176
"140212102",356,346,702,189,194,170
"140212016",325,335,660,190,204,183
"140212015",425,505,930,309,360,296
"140212004",497,490,987,240,252,231
"140212002",351,352,703,176,218,170
"140211908",279,291,570,158,180,151
"140210107",260,272,532,156,333,154
"140210106",289,262,551,177,285,175
"140149904",379,398,777,235,230,205
"140149804",455,452,907,245,232,219
"140149321",430,483,913,288,378,264
"140149308",620,718,1338,412,445,389
"140149211",373,407,780,295,294,238
"140148912",454,499,953,248,227,214
"140148802",489,492,981,301,332,290
"140148801",347,397,744,242,261,232
"140148610",720,765,1485,387,361,335
"140148609",552,541,1093,265,270,253
"140148402",425,502,927,287,274,254
"140145703",190,282,472,248,371,241
"140210907",246,311,557,205,249,193
"140210712",400,404,804,200,206,187
"140210710",399,408,807,200,193,187
"140210709",513,516,1029,243,230,225
"140210708",576,618,1194,277,290,260
"140210707",634,643,1277,289,314,266
"140210706",614,646,1260,305,338,289
"140145307",268,328,596,220,275,215
"140145205",210,246,456,161,191,157
"140145113",484,504,988,308,307,295
"140145112",518,597,1115,340,346,318
"140145111",388,414,802,250,279,243
"140145009",376,511,887,358,428,357
"140144910",157,151,308,148,242,147
"140144615",466,527,993,320,317,271
"140144506",361,387,748,298,366,294
"140143409",375,403,778,250,275,245
"140143314",402,465,867,237,254,215
"140143115",411,454,865,254,244,224
"140148201",257,292,549,315,549,306
"140148003",150,183,333,190,301,180
"140147918",376,424,800,256,267,229
"140147917",397,427,824,283,329,277
"140147720",582,633,1215,340,345,309
"140147711",322,367,689,223,238,210
"140147512",540,588,1128,301,242,217
"140147418",393,470,863,264,314,245
"140147408",501,567,1068,302,291,277
"140147407",483,539,1022,286,302,259
"140147406",698,738,1436,361,352,318
"140147203",495,607,1102,662,1009,632
"140147202",559,784,1343,717,1114,707
"140147201",513,621,1134,626,1100,606
"140147111",192,293,485,267,428,256
"140147110",297,394,691,409,838,405
"140146706",223,354,577,308,538,304
"140146601",293,372,665,352,519,303
"140146504",162,164,326,162,189,143
"140146306",465,485,950,313,351,287
"140146113",801,810,1611,373,371,334
"140146102",528,533,1061,280,274,255
"140142907",319,382,701,232,259,223
"140142614",362,433,795,259,300,239
"140142409",420,502,922,314,358,287
"140142315",417,444,861,271,316,263
"140142215",475,559,1034,322,358,307
"140142207",368,400,768,204,240,201
"140141618",902,926,1828,403,399,380
"140141612",537,541,1078,267,305,247
"140141609",489,487,976,261,240,191
"140141517",604,609,1213,323,358,302
"140141504",481,558,1039,292,291,247
"140144311",426,481,907,280,329,274
"140144310",377,397,774,226,245,221
"140144304",714,742,1456,353,349,325
"140144219",556,634,1190,321,367,319
"140144218",533,547,1080,282,274,239
"140144110",357,428,785,291,342,285
"140144009",287,309,596,237,292,214
"140143911",235,313,548,243,336,237
"140143702",316,332,648,193,174,152
"140143513",451,483,934,268,217,209
"140143508",470,523,993,278,265,254
"140141308",645,667,1312,312,290,274
"140141101",245,208,453,110,120,104
"140141016",508,543,1051,271,280,264
"140141006",527,564,1091,373,401,352
"140141005",330,340,670,205,218,189
"140141004",339,451,790,259,266,247
"140141003",301,356,657,220,244,215
"140140910",623,692,1315,346,374,328
"140140909",693,709,1402,389,445,369
"140140908",820,819,1639,387,413,350
"140140905",757,797,1554,401,388,363
"140140902",666,682,1348,330,362,308
"140140809",938,958,1896,466,429,408
"140140803",179,208,387,114,121,111
"140140715",573,571,1144,240,240,231
"140140714",678,710,1388,287,269,262
"140140713",589,554,1143,251,260,244
"140140711",415,426,841,171,173,167
"140140709",782,742,1524,359,377,354
"140140703",318,331,649,179,186,168
"140140701",651,638,1289,359,363,329
"140140610",530,558,1088,313,319,288
"140140609",615,615,1230,309,335,295
"140140507",618,605,1223,257,212,203
"140140411",793,774,1567,417,422,378
"140070908",160,142,302,100,184,90
"140142202",573,646,1219,322,349,318
"140142104",762,810,1572,383,456,378
"140142016",644,687,1331,385,404,367
"140070904",347,352,699,249,465,243
"140070817",499,512,1011,340,416,334
"140070816",369,390,759,210,260,210
"140070815",467,524,991,337,392,333
"140070814",541,521,1062,334,363,330
"140070809",977,1002,1979,254,317,246
"140070808",368,423,791,295,388,288
"140070807",413,453,866,281,330,270
"140070706",430,443,873,288,376,279
"140070613",191,211,402,126,349,125
"140070612",250,241,491,167,280,163
"140070611",325,376,701,219,359,214
"140070610",234,225,459,137,380,132
"140070607",378,391,769,260,498,255
"140070606",80,94,174,63,167,62
"140070518",518,463,981,248,254,199
"140070517",525,516,1041,284,353,280
"140070515",328,330,658,195,269,175
"140070510",454,479,933,328,437,327
"140070509",335,367,702,267,391,263
"140070508",307,285,592,153,255,149
"140070414",576,521,1097,280,368,223
"140070312",418,455,873,253,297,247
"140070311",428,455,883,248,294,240
"140070310",301,334,635,202,233,199
"140070309",461,465,926,270,322,266
"140070308",132,128,260,74,123,73
"140070215",282,301,583,184,248,174
"140070214",330,325,655,198,277,195
"140070112",264,242,506,170,387,166
"140070110",238,209,447,134,343,133
"141401207",407,427,834,290,325,286
"140420515",302,303,605,187,212,182
"140147311",273,325,598,229,318,222
"141611014",242,326,568,211,261,207
"140146909",202,199,401,170,234,169
"140146404",314,400,714,327,406,322
"140146012",178,228,406,163,244,161
"141611013",255,315,570,207,268,202
"140145512",139,178,317,155,253,143
"140145511",196,231,427,217,372,206
"140145510",127,158,285,158,294,154
"141820304",89,51,140,41,78,41
"141820303",388,214,602,69,108,69
"141820302",38,34,72,18,31,18
"141750201",231,194,425,158,266,155
"141540104",178,175,353,89,108,80
"141540103",181,156,337,102,143,97
"141470301",77,43,120,33,41,29
"141120206",110,70,180,52,55,51
"140700204",57,38,95,30,32,29
"140700203",167,126,293,92,145,91
"140280705",35,24,59,24,36,23
"140280704",25,16,41,13,87,13
"140210602",55,43,98,26,53,25
"140210601",109,83,192,66,101,66
"140070902",38,30,68,25,52,25
"141050605",186,162,348,90,135,81
"141120308",60,39,99,36,48,36
"141050602",138,148,286,80,114,79
"141050601",115,95,210,68,102,67
"141050504",388,254,642,166,231,166
"141050503",439,360,799,248,290,242
"141050502",197,168,365,102,135,99
"141050501",78,61,139,43,68,43
"141050413",56,44,100,31,41,28
"141050412",84,76,160,42,92,42
"141050411",42,41,83,23,37,22
"141050409",69,70,139,40,61,39
"141050408",51,45,96,27,54,27
"141050407",127,125,252,64,83,63
"141050406",115,84,199,52,82,49
"141050405",99,62,161,44,73,44
"141050403",42,35,77,21,48,21
"141050402",92,69,161,50,89,50
"141050304",33,36,69,23,30,23
"141050307",72,43,115,38,72,38
"141050302",84,71,155,44,67,40
"141050301",31,27,58,17,44,17
"141050205",148,127,275,71,114,71
"141050204",56,49,105,33,58,33
"141050203",133,107,240,63,89,54
"141050202",26,32,58,16,21,16
"141050207",39,33,72,27,61,27
"141050107",74,72,146,56,89,56
"141050206",127,87,214,64,89,56
"141050105",26,24,50,20,35,20
"141050104",66,51,117,34,67,34
"141050102",57,65,122,35,55,34
"141050401",21,18,39,13,28,13
"140981408",90,20,110,31,50,31
"140981406",71,55,126,40,65,40
"140981107",108,87,195,66,116,66
"140981104",33,21,54,22,49,22
"140981307",18,9,27,14,53,14
"140981103",37,28,65,22,55,22
"140981306",53,25,78,29,44,29
"140981102",161,122,283,93,128,87
"140981305",58,27,85,35,65,35
"140981203",229,182,411,113,158,112
"140981202",161,113,274,87,137,86
"140981201",140,111,251,74,107,70
"140981101",148,109,257,86,140,86
"140981007",104,93,197,56,97,56
"140981003",318,294,612,178,214,172
"140981002",33,25,58,19,34,17
"140981001",19,20,39,12,20,12
"140980903",111,74,185,61,110,60
"140981008",114,96,210,64,94,63
"140980901",78,61,139,46,72,46
"140981108",72,43,115,38,85,38
"140980805",32,18,50,20,37,20
"140980804",130,84,214,72,136,72
"140980803",105,94,199,68,103,67
"140980703",77,67,144,49,77,46
"140980603",81,60,141,45,81,45
"140981304",76,55,131,42,106,42
"140980806",121,97,218,71,121,71
"140980508",35,24,59,20,32,20
"140980802",94,64,158,49,75,49
"140980507",71,48,119,39,70,34
"140980504",17,12,29,12,29,12
"140980503",36,36,72,23,26,23
"140980502",100,83,183,63,86,63
"140981303",72,71,143,41,89,41
"140980501",32,21,53,17,42,17
"140980406",73,69,142,46,95,46
"140980404",32,25,57,20,51,19
"140980403",47,33,80,24,61,24
"140980402",97,78,175,49,89,48
"140980401",43,24,67,22,54,21
"140980301",32,23,55,19,44,19
"140980207",27,30,57,19,47,18
"140980205",56,44,100,37,69,37
"140981302",86,49,135,48,92,48
"140980302",51,42,93,26,74,26
"140980204",76,66,142,45,77,45
"140980202",62,47,109,36,68,36
"140980107",19,22,41,17,38,17
"140981301",91,50,141,49,86,49
"140980106",35,28,63,18,32,18
"140980105",20,17,37,13,47,13
"140980103",59,44,103,33,57,33
"140980102",32,25,57,18,38,17
"140980101",8,6,14,6,33,6
"140980104",50,30,80,25,51,23
"140911904",54,25,79,14,15,13
"140911903",1,1,2,1,2,1
"140911805",93,88,181,54,66,51
"140911803",27,21,48,11,28,11
"140911902",45,49,94,34,39,30
"140981205",68,50,118,35,67,35
"140911704",1,2,3,2,15,1
"140981204",249,172,421,134,217,130
"140981401",106,89,195,58,96,57
"140911702",5,3,8,2,10,2
"140911901",76,74,150,41,56,37
"140911603",4,6,10,3,4,3
"140981308",64,46,110,32,112,32
"140911602",26,17,43,18,45,18
"140911607",9,13,22,5,10,5
"140911501",10,8,18,5,7,5
"140911405",59,39,98,32,61,32
"140911403",16,15,31,10,14,10
"140981403",82,29,111,50,103,44
"140911402",36,41,77,22,28,21
"140911401",24,18,42,14,37,14
"140911307",9,9,18,6,11,6
"140911305",6,10,16,7,11,7
"140911304",7,8,15,5,6,5
"140981402",83,43,126,46,70,42
"140911306",14,11,25,9,20,9
"140910803",10,6,16,4,10,4
"140910602",196,203,399,103,121,100
"140910501",10,8,18,5,7,5
"140910302",34,24,58,15,21,11
"140910212",3,2,5,4,21,4
"140910208",15,10,25,6,9,6
"140910205",11,7,18,4,8,4
"140910202",82,58,140,39,49,37
"140840405",158,126,284,88,105,87
"140840403",24,21,45,14,46,14
"140840402",105,69,174,54,82,54
"140840401",66,29,95,41,59,41
"140840312",44,34,78,33,75,33
"140840311",29,25,54,18,43,18
"140840310",40,22,62,22,50,22
"140840309",45,23,68,29,53,29
"140840308",59,27,86,30,54,28
"140840306",44,35,79,22,31,22
"140840305",74,56,130,42,71,42
"140840304",43,34,77,26,49,26
"140840303",44,44,88,27,46,27
"140840302",101,76,177,48,85,48
"140840208",69,53,122,38,74,37
"140840206",95,84,179,58,71,55
"140840205",48,30,78,28,44,28
"140840204",79,68,147,46,72,46
"140840203",32,38,70,24,33,24
"140840202",45,25,70,27,42,27
"140560405",67,49,116,38,54,36
"140560304",121,81,202,59,77,56
"140560309",64,51,115,42,54,39
"141820706",68,35,103,35,55,35
"141820704",44,25,69,26,38,26
"141820703",87,59,146,47,76,46
"140560303",155,96,251,64,94,61
"140560301",9,7,16,6,15,6
"141820701",47,25,72,25,41,25
"140560203",13,9,22,9,23,9
"141820606",8,11,19,6,29,6
"141820605",66,49,115,41,79,41
"140560202",27,27,54,20,37,20
"141820603",43,30,73,28,62,27
"141820602",79,59,138,47,104,46
"141820601",44,31,75,27,88,27
"140560102",113,88,201,67,106,64
"140490212",56,50,106,28,39,28
"141820507",27,28,55,17,74,15
"141820505",125,102,227,66,111,65
"141820504",38,28,66,20,40,20
"141820502",46,39,85,27,69,27
"141820501",59,33,92,26,54,26
"141820407",73,57,130,40,99,40
"141820406",107,85,192,58,117,58
"140560201",72,43,115,38,52,36
"140490208",14,8,22,9,21,9
"141820404",57,45,102,31,47,31
"140490206",41,29,70,26,40,26
"141820401",69,58,127,37,76,35
"140490205",47,33,80,24,53,24
"141820306",115,93,208,57,83,55
"141820301",110,86,196,58,115,58
"140560103",88,89,177,56,79,56
"140560404",23,13,36,12,30,10
"140560403",17,12,29,11,29,11
"140490203",45,35,80,34,49,34
"141820204",62,52,114,39,56,37
"141820203",191,141,332,89,126,88
"141820201",136,103,239,64,103,61
"140630207",53,55,108,29,44,27
"140560101",114,75,189,70,89,68
"141401703",72,60,132,38,52,38
"141401702",153,126,279,66,84,60
"141401701",123,94,217,59,85,56
"141401606",171,136,307,77,117,75
"141401605",176,151,327,86,128,84
"141401604",19,18,37,11,35,11
"141401603",100,72,172,51,148,48
"141401602",114,96,210,59,114,56
"141401506",93,79,172,49,73,49
"141401505",180,139,319,84,119,77
"141401504",196,153,349,79,117,74
"141401503",118,108,226,67,118,64
"141401502",115,80,195,56,75,55
"141401501",145,116,261,74,99,73
"141401601",82,54,136,40,93,37
"141401005",88,74,162,39,67,39
"141401004",94,73,167,47,87,45
"141401003",176,133,309,71,110,66
"141400907",82,58,140,38,71,38
"141400906",194,169,363,84,141,82
"141400905",126,99,225,59,66,54
"141400903",153,127,280,75,107,68
"141400902",67,54,121,29,44,29
"141400901",147,122,269,64,69,63
"141400808",171,137,308,80,114,75
"141400807",189,157,346,81,85,74
"141400806",76,69,145,38,52,38
"141400805",183,151,334,73,73,62
"141400803",341,297,638,144,200,137
"141400802",231,191,422,98,183,94
"141400608",90,67,157,46,75,43
"141400607",83,85,168,44,82,42
"141400606",84,83,167,47,80,46
"141400605",143,131,274,68,103,63
"141400604",180,139,319,89,111,85
"141400603",37,25,62,20,33,19
"141400602",60,46,106,28,55,28
"141400601",25,20,45,16,21,13
"141400507",28,13,41,10,19,10
"141400506",123,85,208,51,92,50
"141400505",145,109,254,60,77,54
"141400504",102,54,156,43,91,41
"141400503",65,53,118,35,48,35
"141400502",171,144,315,89,113,85
"141400209",123,70,193,48,55,44
"141400208",134,99,233,60,79,59
"141400207",56,40,96,24,35,24
"141400206",180,144,324,84,118,82
"141400205",68,61,129,30,37,30
"141400203",120,98,218,55,74,49
"141400108",101,62,163,47,59,45
"141400107",52,39,91,28,32,26
"141400106",36,33,69,17,27,17
"141400105",50,41,91,29,42,29
"141400104",66,52,118,39,44,39
"141400201",90,56,146,46,63,38
"141400103",211,178,389,115,137,101
"141400102",80,79,159,40,60,37
"141400101",104,74,178,41,46,38
"141330406",87,91,178,55,83,54
"141330404",109,100,209,62,99,60
"141330402",99,82,181,44,64,44
"141330401",41,31,72,24,40,24
"141330304",285,208,493,147,164,136
"141330403",85,93,178,49,88,46
"141330302",207,205,412,125,160,123
"141400210",60,47,107,25,40,23
"141330203",111,119,230,63,97,60
"141330206",152,135,287,74,98,72
"141330202",124,114,238,76,100,73
"141330205",154,156,310,86,79,69
"141330107",58,65,123,40,59,40
"141330103",251,257,508,132,140,123
"141330102",181,178,359,99,114,98
"141330101",39,34,73,21,39,21
"141260605",237,229,466,125,238,124
"141260603",197,221,418,116,195,111
"141260601",118,95,213,68,98,64
"141260506",121,142,263,63,78,59
"141260505",189,174,363,94,116,84
"141260503",8,5,13,6,17,6
"141260502",194,162,356,98,122,96
"141260504",207,228,435,106,127,96
"141260405",66,71,137,42,83,40
"141260404",205,180,385,103,144,102
"141260306",72,58,130,40,83,40
"141260305",82,71,153,46,90,46
"141260301",31,25,56,16,22,16
"141260205",41,34,75,24,27,23
"141260204",122,117,239,60,70,60
"141260203",64,50,114,33,32,25
"141260202",14,12,26,9,12,9
"141260106",60,43,103,32,46,32
"141260201",84,82,166,47,52,45
"141260108",89,105,194,53,69,52
"141260101",68,65,133,44,65,43
"141190510",34,27,61,16,30,16
"141190509",30,17,47,16,54,16
"141190508",72,49,121,37,41,36
"141190507",16,9,25,11,30,11
"141190505",62,52,114,38,53,38
"141190504",111,101,212,71,144,71
"141190503",113,106,219,65,111,63
"141190502",27,26,53,15,29,14
"141190409",262,186,448,120,144,118
"141190408",111,104,215,55,106,54
"141190407",122,101,223,62,94,51
"141190406",74,77,151,39,81,33
"141190405",40,24,64,20,53,20
"141190404",58,41,99,29,74,26
"141190403",32,17,49,18,54,18
"141190402",52,44,96,30,47,30
"141190401",29,19,48,13,27,13
"141190304",76,62,138,40,56,36
"141190303",133,118,251,71,117,67
"141190302",186,142,328,89,139,88
"141190305",64,63,127,32,64,30
"141190211",49,47,96,27,62,26
"141190210",24,23,47,15,47,15
"141190209",48,38,86,23,69,23
"141190208",8,8,16,4,6,4
"141190207",4,2,6,4,8,4
"141190205",96,63,159,55,69,54
"141190204",22,16,38,16,23,16
"141190203",22,12,34,14,38,14
"141190202",46,35,81,21,49,21
"141190201",22,20,42,14,22,13
"141190105",51,41,92,26,41,25
"141190104",33,24,57,17,36,17
"141190103",88,90,178,52,82,50
"141190101",544,489,1033,272,337,253
"141190102",134,112,246,73,139,73
"141120307",100,95,195,68,71,68
"141120305",137,111,248,72,90,70
"141120303",67,64,131,39,53,38
"141120107",56,39,95,24,59,24
"141120105",84,78,162,44,78,42
"141120205",42,29,71,20,22,19
"141120103",68,69,137,46,68,46
"141120204",43,25,68,19,26,19
"141120102",69,68,137,40,50,39
"141820109",87,66,153,46,74,46
"141820108",153,104,257,79,122,77
"141820107",126,100,226,70,104,70
"140490108",109,101,210,59,105,58
"140490107",46,30,76,25,40,24
"141820103",86,69,155,45,78,45
"140490106",51,35,86,23,28,23
"141750219",1,0,1,1,3,1
"140490103",124,101,225,62,89,61
"140490102",62,62,124,46,73,46
"140490101",56,49,105,40,43,39
"141750207",69,52,121,35,54,32
"140421007",50,35,85,27,48,27
"140421006",59,36,95,26,38,25
"140421005",64,59,123,39,60,39
"140421004",55,45,100,27,72,26
"140421003",4,2,6,3,9,3
"140421002",82,76,158,46,77,44
"140421001",106,78,184,52,71,49
"141750107",112,89,201,76,117,76
"141750105",83,65,148,55,85,54
"141750104",42,29,71,29,38,27
"141750102",45,29,74,27,43,27
"141680310",91,68,159,53,90,53
"140420509",118,98,216,55,73,54
"140420508",155,112,267,80,104,75
"140420507",85,58,143,40,60,40
"141680304",92,67,159,37,62,32
"141680303",160,139,299,94,204,94
"141680302",101,100,201,61,109,61
"140420506",65,47,112,33,37,29
"140420505",53,57,110,30,45,28
"140420504",79,59,138,43,59,38
"140420502",45,44,89,24,55,24
"140420501",55,36,91,26,29,23
"140420307",317,267,584,165,158,134
"140420304",87,85,172,53,79,52
"140420303",108,98,206,58,66,57
"141680104",19,17,36,15,31,15
"140420302",168,153,321,80,107,79
"141680101",85,68,153,46,75,46
"140420301",175,135,310,97,104,93
"140420207",81,56,137,44,54,43
"140420204",73,48,121,31,49,29
"140420306",17,11,28,10,14,10
"140420203",98,69,167,48,60,46
"140420202",115,103,218,64,98,62
"140420201",77,54,131,35,53,35
"140420108",177,131,308,85,106,82
"140420105",180,153,333,96,111,89
"140420104",71,57,128,36,48,36
"140420103",112,89,201,59,71,57
"140420107",136,102,238,64,79,63
"140350507",33,13,46,17,27,16
"140350506",71,38,109,36,49,35
"140350505",64,44,108,38,67,38
"141610408",31,21,52,18,34,17
"140350305",137,93,230,79,86,75
"140350209",31,17,48,22,45,22
"140350208",87,47,134,35,49,35
"140350207",37,30,67,23,40,22
"140350205",26,19,45,20,32,19
"140350304",126,94,220,74,111,72
"140350203",30,24,54,21,43,20
"140350403",119,87,206,73,140,73
"140350303",230,120,350,84,121,84
"141610301",158,121,279,92,131,92
"140350202",49,34,83,34,45,34
"140350302",33,19,52,18,44,18
"140350301",75,48,123,38,64,38
"140350201",50,34,84,28,30,23
"140350204",34,22,56,18,30,18
"141610201",71,63,134,50,123,48
"140350105",53,26,79,24,35,24
"140350104",53,16,69,31,58,31
"140280605",30,37,67,19,31,19
"140350402",99,66,165,58,81,57
"141610108",61,47,108,31,57,30
"140350102",27,11,38,14,23,14
"140350101",32,9,41,19,20,19
"140280603",210,220,430,145,197,144
"141610103",86,68,154,48,88,47
"141610102",58,67,125,35,88,35
"140350103",94,57,151,50,68,50
"140280601",42,32,74,21,34,21
"140280405",174,152,326,78,136,77
"141540205",50,28,78,28,45,28
"141540204",176,107,283,55,85,53
"140350502",85,18,103,46,63,46
"140280404",212,202,414,119,174,117
"140280403",279,268,547,110,126,110
"140350501",21,3,24,13,20,13
"140280402",194,150,344,101,129,99
"140280401",50,31,81,24,39,24
"140350401",51,29,80,28,53,28
"140280108",191,180,371,103,143,101
"141470707",56,51,107,30,117,30
"141470706",53,45,98,28,45,25
"141470704",104,55,159,47,104,47
"141470703",24,21,45,17,40,17
"141470702",39,15,54,12,60,12
"141470701",57,39,96,27,129,27
"140280106",150,152,302,71,92,69
"140280105",308,342,650,166,205,161
"141470602",247,190,437,72,171,70
"141470501",52,39,91,30,44,30
"141470403",122,93,215,62,86,60
"141470402",59,54,113,39,107,39
"141400609",61,52,113,26,44,25
"141400501",111,109,220,70,135,67
"141330407",133,131,264,72,103,69
"140210801",87,70,157,43,51,42
"140210703",160,144,304,89,95,87
"140210702",330,295,625,178,196,157
"140210701",132,108,240,62,99,62
"141330306",207,160,367,92,147,92
"141330303",121,131,252,66,81,65
"141330301",155,139,294,79,128,79
"140210606",32,32,64,18,19,18
"140210604",74,78,152,49,85,48
"140210603",40,40,80,24,47,24
"141330109",226,169,395,90,93,80
"141330106",40,34,74,23,41,23
"141330105",491,523,1014,268,310,265
"141330104",228,212,440,120,138,117
"140210605",170,174,344,90,95,79
"140210505",105,98,203,55,82,48
"140210501",90,81,171,45,67,43
"140210312",214,205,419,116,128,110
"140210311",229,198,427,125,135,116
"140210310",188,160,348,108,142,100
"140210309",293,346,639,174,192,166
"140210307",86,58,144,44,53,44
"141260606",48,42,90,7,10,7
"140210405",181,152,333,86,95,85
"140210305",202,209,411,126,148,119
"141260602",59,29,88,27,42,26
"140210301",85,99,184,48,69,46
"141260501",20,15,35,17,37,17
"141260403",54,51,105,34,62,34
"141260402",64,53,117,35,48,35
"141260401",161,140,301,96,156,94
"140210404",165,175,340,97,120,93
"140141408",92,111,203,50,26,10
"140911802",10,10,20,5,15,5
"140911801",24,21,45,7,28,7
"140911705",10,8,18,4,6,4
"140140915",32,32,64,13,15,13
"140911701",2,1,3,2,16,2
"140140901",24,18,42,11,11,10
"140140801",16,26,42,3,3,3
"140140712",274,230,504,130,134,116
"140911606",42,45,87,25,41,25
"140911605",112,87,199,62,74,61
"140911604",10,8,18,8,12,7
"140140710",105,103,208,59,62,59
"140911601",12,6,18,7,14,7
"140140605",493,440,933,252,260,213
"140140604",449,408,857,221,253,209
"140140603",119,120,239,66,72,62
"140140602",81,93,174,43,55,43
"140140601",411,399,810,225,253,202
"140140706",18,11,29,15,16,13
"140140501",449,450,899,248,260,240
"140140403",190,186,376,101,123,92
"140911404",46,26,72,17,34,17
"140070905",26,12,38,14,36,14
"140070813",24,20,44,16,34,16
"140070812",18,18,36,15,45,15
"140070811",23,18,41,14,30,14
"140911308",8,7,15,7,21,7
"140070810",61,42,103,34,60,34
"140911303",43,36,79,28,52,28
"140911302",28,16,44,9,9,8
"140911301",8,3,11,5,8,5
"140070801",17,14,31,12,17,10
"140070717",15,10,25,8,37,8
"140070716",17,17,34,13,48,13
"140070709",16,10,26,6,14,6
"140070601",17,15,32,13,38,13
"140070410",20,8,28,9,22,9
"140070408",39,31,70,20,41,20
"140910801",10,5,15,11,34,11
"140070405",82,75,157,47,117,47
"140070404",5,2,7,2,10,2
"140070306",48,46,94,28,58,28
"140070304",29,34,63,17,52,17
"141680103",47,46,93,29,32,26
"141680102",78,63,141,52,93,52
"141680105",40,21,61,18,42,17
"141610505",79,58,137,47,87,47
"141610504",41,40,81,24,45,24
"141610502",41,36,77,25,41,24
"141610501",38,37,75,24,45,24
"141610410",116,88,204,55,82,55
"141610409",90,76,166,52,71,51
"141610406",91,78,169,51,76,51
"141610405",139,110,249,71,96,65
"141610403",47,30,77,24,46,24
"141610402",68,65,133,34,52,33
"141610305",235,215,450,122,184,116
"141610304",179,143,322,63,83,62
"141610303",81,65,146,43,88,42
"141610302",569,330,899,41,74,40
"141610404",67,53,120,34,56,32
"141610206",56,47,103,35,84,35
"141610205",30,22,52,19,35,19
"141610204",38,34,72,21,58,21
"141610203",33,24,57,21,35,21
"141610202",70,54,124,44,81,44
"141610111",62,39,101,37,110,37
"141610110",106,84,190,61,106,61
"141610109",67,64,131,37,65,37
"141610107",59,43,102,31,77,31
"141610106",43,37,80,25,46,24
"141540207",56,43,99,36,56,32
"141540206",38,38,76,24,37,24
"141540208",61,55,116,36,51,36
"141540203",44,46,90,28,36,27
"141610104",136,102,238,70,127,66
"141610101",41,41,82,28,50,28
"141540202",14,7,21,5,6,5
"141540201",95,81,176,47,52,47
"141540106",13,6,19,7,12,6
"141540105",43,16,59,21,28,21
"141610105",134,102,236,64,91,59
"141540101",55,36,91,31,41,31
"141470705",5,4,9,2,7,2
"141470506",23,17,40,11,39,11
"141470505",36,24,60,21,65,21
"141470504",99,50,149,49,98,49
"141470503",66,57,123,44,74,43
"141470502",47,34,81,28,56,28
"141470401",102,93,195,54,73,53
"141470404",19,13,32,12,40,12
"141470306",37,30,67,23,30,23
"141470206",96,82,178,58,83,57
"141470203",2483,307,2790,51,79,49
"141470101",48,43,91,29,120,27
"141401710",144,103,247,73,110,64
"141401709",181,181,362,107,119,101
"141401708",178,110,288,73,134,69
"141401707",42,30,72,21,31,20
"141401706",98,86,184,49,91,49
"141401704",47,34,81,23,73,23
"140840201",42,26,68,24,35,24
"140840207",86,60,146,45,85,45
"140770209",47,30,77,34,53,34
"140840105",43,18,61,22,38,21
"140840104",39,22,61,19,33,19
"140770109",65,54,119,31,34,30
"140770108",59,40,99,26,34,26
"140770107",71,63,134,44,62,43
"140770205",79,69,148,55,92,55
"140770106",88,79,167,46,54,46
"140770103",69,65,134,44,51,43
"140770101",28,16,44,13,20,13
"140700207",112,132,244,63,101,63
"140770206",26,22,48,18,35,18
"140700205",98,83,181,80,128,80
"140700105",179,148,327,106,144,106
"140840101",71,56,127,50,52,50
"140700104",71,48,119,39,46,36
"140840301",49,38,87,31,52,31
"140770104",55,38,93,24,26,21
"140630909",86,66,152,56,73,56
"140630908",69,58,127,37,54,37
"140630907",61,40,101,32,47,32
"140630906",29,37,66,21,35,20
"140630905",73,65,138,30,51,30
"140630904",95,82,177,66,98,64
"140630903",108,93,201,73,107,72
"140630902",62,54,116,38,48,36
"140630901",35,28,63,21,38,21
"140630806",37,17,54,21,45,20
"140630805",31,24,55,20,30,20
"140630804",99,84,183,55,114,55
"140630803",70,46,116,44,83,44
"140630802",54,34,88,31,64,31
"140630801",42,38,80,24,56,24
"140630705",71,51,122,41,61,39
"140630703",52,50,102,35,64,34
"140630702",74,67,141,50,65,49
"140630606",48,42,90,31,61,31
"140630605",39,37,76,20,19,18
"140630604",59,52,111,38,66,38
"140630603",72,57,129,44,111,43
"140630602",6,7,13,4,25,4
"140630601",9,7,16,5,16,5
"140630502",74,56,130,52,76,52
"140630503",33,20,53,27,56,27
"140630501",112,67,179,66,109,64
"140630406",20,17,37,9,14,9
"140630405",75,45,120,30,33,30
"140630403",18,16,34,14,47,13
"140630402",33,30,63,23,43,23
"140630302",64,50,114,37,92,37
"140630401",17,19,36,12,40,12
"140630301",24,19,43,14,14,13
"140630404",37,31,68,23,37,23
"140630210",66,46,112,37,75,37
"140630208",50,49,99,33,45,33
"140630203",60,44,104,30,56,29
"140630201",60,34,94,31,72,29
"140630108",35,29,64,19,59,19
"140630107",29,28,57,17,40,17
"140630204",58,45,103,30,63,30
"140630106",60,46,106,37,80,36
"140630105",28,19,47,18,33,18
"140630103",31,20,51,23,50,21
"140560614",31,28,59,22,35,22
"140560610",77,56,133,42,59,42
"140560609",140,117,257,82,136,81
"140560608",88,68,156,51,65,51
"140560607",53,42,95,28,54,28
"140560606",46,24,70,24,41,24
"140560605",47,40,87,30,53,30
"140560604",34,28,62,20,42,19
"140560602",61,51,112,38,57,37
"140560601",110,81,191,65,84,62
"140560507",89,57,146,58,85,58
"140560506",109,111,220,66,77,62
"140560505",18,11,29,10,18,10
"140560504",83,51,134,47,65,47
"140560503",25,20,45,17,17,16
"140560502",37,23,60,21,48,21
"140560501",36,28,64,26,30,26
"140560406",49,34,83,24,40,24
"140560402",73,52,125,46,69,46
"140560308",47,39,86,29,42,27
"140560307",17,12,29,11,17,11
"140560306",22,20,42,12,22,12
"140560305",63,57,120,38,65,38
"140070301",31,20,51,18,43,16
"140910701",49,51,100,13,17,13
"140910604",29,31,60,18,26,16
"140910603",38,31,69,23,22,21
"140070203",117,122,239,35,54,31
"140070202",60,49,109,31,47,31
"140910601",2,2,4,1,8,1
"140070105",137,131,268,72,158,70
"140910301",12,12,24,6,19,6
"140910207",4,2,6,4,8,4
"140910206",47,35,82,24,33,24
"140840102",90,68,158,49,96,49
"140770208",93,69,162,58,81,55
"140770204",396,335,731,190,248,183
"140770201",96,68,164,50,83,50
"140770105",86,102,188,45,54,45
"140770102",14,10,24,8,13,8
"140700209",70,65,135,48,68,45
"140700208",69,64,133,37,48,36
"140700202",77,67,144,38,53,37
"140700102",66,67,133,35,52,35
"140630704",54,30,84,28,58,28
"140630206",48,49,97,33,82,32
"140630205",29,22,51,16,32,16
"140630202",124,116,240,70,114,70
"140630102",44,36,80,29,59,29
"140630101",49,53,102,30,65,29
"140560603",51,36,87,29,42,21
"140560310",100,101,201,48,62,47
"140560302",58,38,96,34,53,31
"140490210",72,48,120,50,128,49
"140490209",32,25,57,25,99,25
"140490110",37,28,65,18,26,18
"140490105",89,61,150,51,64,49
"140490104",72,59,131,37,59,37
"140420206",64,45,109,30,39,29
"140420205",170,139,309,90,116,86
"140420106",91,63,154,41,58,39
"140420102",56,53,109,30,50,30
"140420101",79,58,137,42,72,41
"140350504",74,47,121,47,68,47
"140350503",48,24,72,34,54,33
"140350308",78,55,133,43,59,42
"140280703",81,50,131,32,47,32
"140280504",229,149,378,116,162,113
"140280503",77,65,142,48,72,46
"140280502",280,242,522,134,153,134
"141820710",64,43,107,42,68,41
"141820709",77,58,135,45,55,45
"141820708",102,70,172,53,94,50
"141820604",78,76,154,36,48,36
"141820508",51,41,92,32,72,32
"141820506",36,30,66,24,60,24
"141820503",11,9,20,9,34,8
"141820405",59,46,105,34,68,34
"141820403",132,137,269,83,134,79
"141820402",207,175,382,111,198,109
"141820305",64,46,110,33,36,30
"141820205",57,47,104,31,41,31
"141820106",196,153,349,90,107,85
"141820105",123,103,226,64,74,57
"141820104",99,70,169,47,58,41
"141820102",119,90,209,60,66,53
"141820101",105,80,185,53,86,48
"141820110",173,132,305,125,198,122
"141750211",104,89,193,65,104,64
"141750210",116,86,202,65,73,54
"141750208",128,91,219,66,88,66
"141750204",117,85,202,88,157,88
"141750203",98,68,166,65,107,64
"141750109",81,54,135,51,82,50
"141750205",62,47,109,45,98,44
"141750108",67,49,116,42,71,42
"141750106",47,39,86,22,36,22
"141750103",84,79,163,53,81,53
"141680307",94,81,175,56,78,52
"141680306",44,36,80,27,41,26
"141680305",117,112,229,57,85,57
"141680301",41,37,78,27,43,27
"141680308",33,29,62,20,37,19
"141750206",114,93,207,61,86,61
"141680203",59,43,102,27,52,25
"141680201",106,66,172,47,66,46
"141680109",41,44,85,27,45,26
"141680202",141,150,291,82,110,82
"141680107",69,43,112,37,67,35
"141680106",72,50,122,48,80,45
"140210403",234,248,482,112,122,110
"140210204",88,62,150,51,82,49
"140210401",146,143,289,93,106,88
"140210203",24,22,46,16,31,16
"140210202",39,37,76,26,44,26
"141260207",62,51,113,34,49,34
"141260107",67,50,117,44,64,44
"141260105",20,19,39,12,19,12
"141260104",93,86,179,52,63,51
"141260102",79,73,152,47,82,44
"141190206",12,10,22,8,20,8
"141120301",55,49,104,34,78,34
"141120203",45,39,84,20,25,20
"141120202",44,14,58,23,32,23
"141120108",87,92,179,48,60,37
"141120101",45,34,79,16,19,16
"141050603",109,97,206,57,104,55
"141050201",44,32,76,26,47,26
"140981407",71,33,104,38,79,38
"140981405",99,68,167,55,97,53
"140981404",99,73,172,55,94,55
"140981310",97,50,147,67,100,64
"140981309",104,40,144,65,71,42
"140981105",51,50,101,32,82,32
"140981006",64,38,102,38,75,38
"140981005",76,73,149,47,67,45
"140981004",82,70,152,51,77,51
"140980801",90,60,150,49,111,49
"140980705",29,26,55,20,28,20
"140980704",134,102,236,70,108,69
"140980702",85,62,147,50,87,49
"140980701",48,29,77,27,99,27
"140980604",61,44,105,45,125,45
"140980602",108,72,180,72,107,66
"140980601",38,32,70,25,58,25
"140980505",183,171,354,109,147,107
"140980405",34,31,65,21,60,21
"140980303",21,13,34,16,29,16
"140980206",33,20,53,18,27,18
"140980201",20,11,31,10,40,10
"140911905",20,11,31,11,18,11
"140911804",193,170,363,69,115,67
"140280107",53,44,97,26,48,26
"140210503",28,16,44,13,21,13
"140210402",139,122,261,83,106,78
"140210306",207,189,396,110,124,108
"140210304",419,419,838,225,234,210
"140210303",357,329,686,191,198,175
"140210302",198,198,396,122,137,115
"140210201",29,21,50,16,29,15
"140210102",47,38,85,28,41,27
"140210101",37,24,61,25,51,23
"140420503",34,26,60,22,47,22
"140420305",101,85,186,56,78,55
"140070907",26,12,38,12,24,12
"140070906",39,31,70,27,71,27
"140070903",28,19,47,14,39,14
"140070901",44,7,51,10,20,10
"140070802",97,89,186,62,114,62
"140070714",12,4,16,6,22,6
"140070713",57,36,93,29,55,27
"140070712",25,21,46,14,30,14
"140070711",25,14,39,12,19,12
"140070710",23,10,33,12,15,12
"140070708",27,18,45,14,41,14
"140070707",32,18,50,14,31,13
"140070705",42,42,84,29,66,29
"140070702",37,31,68,26,48,26
"140070604",28,31,59,20,59,18
"140070603",74,63,137,47,115,45
"140070403",56,37,93,24,58,24
"140070402",44,21,65,7,20,7
"140070401",26,28,54,21,59,15
"140070305",164,137,301,86,144,84
"140070303",13,7,20,5,27,5
"140070302",27,29,56,17,47,17
"140070204",257,227,484,151,279,139
"140070108",202,155,357,114,158,111
"140070106",51,32,83,33,57,31
"140070104",45,32,77,24,46,23
"140070101",40,28,68,17,31,17
"140070412",59,47,106,33,53,32
"140070411",33,24,57,19,30,19
"140070409",16,8,24,13,29,13
"140070406",106,113,219,67,116,64
"180070101",658,647,1305,330,355,308
"180070102",314,326,640,168,177,162
"180070103",519,522,1041,257,263,243
"180070104",370,424,794,218,242,210
"180070105",482,501,983,263,287,245
"180070106",551,562,1113,303,352,294
"180070107",253,321,574,183,201,178
"180070108",404,467,871,292,274,233
"180070109",525,540,1065,267,287,260
"180070110",371,422,793,229,231,213
"180070111",414,416,830,233,237,221
"180070112",414,447,861,255,265,243
"180070113",472,515,987,323,343,307
"180070114",451,437,888,240,247,225
"180070115",592,613,1205,284,295,272
"180070116",528,505,1033,272,285,268
"180070117",460,498,958,262,287,247
"180070118",409,432,841,237,245,223
"180070119",490,514,1004,261,265,242
"180070120",412,401,813,242,254,227
"180070121",413,440,853,254,267,246
"180070122",490,519,1009,279,263,242
"180070123",410,462,872,235,249,233
"180070124",462,526,988,271,286,262
"180070125",525,534,1059,282,287,267
"180070201",158,147,305,74,91,74
"180070202",115,90,205,53,57,53
"180070203",210,187,397,96,112,91
"180070204",196,179,375,98,110,92
"180070205",133,110,243,72,87,70
"180070206",140,140,280,77,94,73
"180070207",148,132,280,70,82,68
"180070208",155,158,313,79,97,76
"180070209",152,154,306,72,73,69
"180070210",42,45,87,19,24,19
"180070211",132,115,247,59,67,59
"180070212",143,140,283,78,87,76
"180070213",539,542,1081,266,271,262
"180070214",860,890,1750,390,382,365
"180070215",556,598,1154,267,273,262
"180070216",399,371,770,167,170,146
"180070217",336,340,676,156,159,150
"180070218",319,354,673,153,149,146
"180070301",440,357,797,217,282,215
"180070302",87,77,164,38,43,36
"180070303",86,77,163,35,37,33
"180070304",236,211,447,116,126,114
"180070305",217,202,419,113,146,112
"180070401",52,51,103,26,27,26
"180070501",68,56,124,38,45,38
"180070502",37,36,73,19,22,18
"180070503",14,9,23,9,11,9
"180070504",59,51,110,31,33,27
"180070505",47,48,95,27,33,26
"180070506",101,79,180,39,48,39
"180070601",270,248,518,141,165,141
"180070602",224,189,413,104,115,104
"180070701",134,114,248,63,65,56
"180070702",255,194,449,104,126,101
"180070801",8,2,10,6,13,6
"180070802",25,15,40,11,12,11
"180140101",203,212,415,120,154,118
"180140102",216,229,445,137,167,131
"180140103",288,263,551,147,187,147
"180140201",81,74,155,51,67,49
"180140202",20,13,33,12,20,12
"180140203",15,6,21,8,11,8
"180140301",154,167,321,61,72,58
"180140302",45,37,82,28,35,28
"180140303",103,80,183,42,69,42
"180140401",107,104,211,55,78,55
"180140402",28,16,44,15,22,14
"180140501",0,0,0,0,1,0
"180140502",0,0,0,0,1,0
"180210101",536,680,1216,454,410,350
"180210102",371,472,843,312,330,240
"180210103",499,660,1159,403,434,328
"180210104",365,450,815,294,337,287
"180210105",326,384,710,259,323,247
"180210106",390,460,850,306,377,299
"180210107",292,392,684,234,304,217
"180210108",229,336,565,202,260,195
"180210109",284,395,679,274,398,250
"180210110",264,307,571,203,291,194
"180210111",267,317,584,221,241,215
"180210112",212,279,491,137,161,133
"180210113",576,697,1273,451,495,411
"180210114",501,553,1054,357,429,348
"180210115",889,688,1577,413,539,403
"180210116",262,334,596,224,300,223
"180210117",511,655,1166,405,546,385
"180210118",443,554,997,333,403,308
"180210201",503,539,1042,442,463,346
"180210202",311,383,694,255,276,240
"180210203",399,461,860,364,428,302
"180210204",244,316,560,215,263,211
"180210205",283,385,668,266,362,249
"180210206",307,409,716,284,351,274
"180210207",414,482,896,400,416,310
"180210208",343,467,810,348,433,338
"180210209",307,367,674,280,318,270
"180210210",375,519,894,290,427,282
"180210211",292,395,687,258,346,251
"180210212",270,362,632,236,312,229
"180210213",265,316,581,206,298,200
"180210214",435,560,995,428,603,415
"180210215",286,364,650,293,405,282
"180210216",322,359,681,291,418,275
"180210217",443,509,952,340,518,332
"180210218",204,235,439,154,250,149
"180210301",594,628,1222,272,262,251
"180210302",529,557,1086,288,276,238
"180210303",794,883,1677,442,509,421
"180210304",1183,1097,2280,485,451,436
"180210305",807,809,1616,409,383,371
"180210306",532,558,1090,293,252,244
"180210307",531,567,1098,255,226,223
"180210308",632,605,1237,311,281,271
"180210309",647,668,1315,300,301,287
"180210310",564,568,1132,291,277,269
"180210311",411,443,854,252,233,222
"180210312",522,595,1117,293,211,193
"180210313",399,376,775,208,177,171
"180210314",693,706,1399,337,313,286
"180210315",640,719,1359,365,371,334
"180210316",562,661,1223,334,309,271
"180210317",835,903,1738,502,417,388
"180210318",343,383,726,256,262,201
"180210319",392,424,816,323,301,240
"180210320",436,506,942,314,357,287
"180210321",312,375,687,230,236,212
"180210401",898,906,1804,444,490,405
"180210402",393,393,786,220,238,216
"180210403",965,999,1964,506,533,478
"180210404",822,856,1678,362,359,337
"180210405",527,540,1067,255,254,237
"180210406",838,820,1658,385,379,364
"180210407",896,894,1790,403,376,342
"180210408",484,496,980,244,273,238
"180210409",642,695,1337,323,321,293
"180210410",618,670,1288,321,312,284
"180210411",946,961,1907,505,501,448
"180210412",416,450,866,244,221,196
"180210413",534,531,1065,268,265,244
"180210414",566,623,1189,330,371,307
"180210415",463,495,958,240,246,233
"180210416",354,382,736,249,317,243
"180210417",466,525,991,328,260,239
"180210418",338,382,720,225,279,217
"180210419",152,215,367,200,225,145
"180210420",170,231,401,166,229,157
"180210421",488,500,988,369,502,340
"180210422",406,445,851,258,232,203
"180210501",274,323,597,241,348,237
"180210502",361,398,759,255,257,192
"180210503",404,569,973,411,510,355
"180210504",446,555,1001,319,341,281
"180210505",304,319,623,179,204,161
"180210506",537,567,1104,299,310,264
"180210507",605,656,1261,331,361,296
"180210508",323,364,687,203,193,162
"180210509",467,549,1016,286,274,234
"180210510",460,571,1031,244,262,223
"180210511",522,537,1059,315,299,233
"180210512",631,730,1361,454,513,401
"180210513",492,630,1122,348,337,282
"180210514",453,480,933,250,236,203
"180210515",325,406,731,207,202,166
"180210516",327,369,696,199,171,141
"180210601",386,417,803,233,230,192
"180210602",423,476,899,241,206,188
"180210603",512,580,1092,317,285,243
"180210604",720,785,1505,382,380,343
"180210605",610,692,1302,348,331,305
"180210606",1099,1127,2226,581,562,518
"180210607",496,524,1020,268,295,255
"180210608",472,528,1000,259,245,233
"180210609",667,711,1378,336,342,320
"180210610",519,533,1052,260,278,252
"180210611",357,386,743,198,213,191
"180210612",652,708,1360,344,316,303
"180210613",610,613,1223,349,330,313
"180210614",710,743,1453,366,335,303
"180210615",567,636,1203,284,234,215
"180210616",583,643,1226,331,280,258
"180210701",752,796,1548,340,308,287
"180210702",528,569,1097,268,225,199
"180210703",1030,1001,2031,482,376,342
"180210704",608,678,1286,346,350,327
"180210705",540,601,1141,296,294,281
"180210706",394,459,853,207,216,198
"180210707",773,822,1595,422,445,405
"180210708",1106,1205,2311,565,524,489
"180210709",658,698,1356,322,322,285
"180210710",779,830,1609,370,341,325
"180210711",884,930,1814,416,425,403
"180210712",754,770,1524,344,297,280
"180210713",592,672,1264,303,297,291
"180210714",523,575,1098,264,266,253
"180210715",618,613,1231,285,276,253
"180210716",434,457,891,236,234,216
"180210801",292,326,618,198,220,175
"180210802",535,562,1097,269,267,240
"180210803",400,453,853,284,321,260
"180210804",294,347,641,204,244,182
"180210805",304,393,697,255,310,246
"180210806",413,457,870,274,330,258
"180210807",262,366,628,217,267,206
"180210808",295,338,633,216,229,172
"180210809",636,778,1414,398,442,347
"180210810",565,676,1241,381,412,326
"180210811",886,1002,1888,524,462,403
"180210812",403,432,835,214,171,150
"180210813",448,491,939,231,200,181
"180210901",287,334,621,188,265,163
"180210902",290,415,705,208,261,181
"180210903",337,474,811,291,383,264
"180210904",280,352,632,240,332,231
"180210905",517,559,1076,273,265,223
"180210906",655,751,1406,446,478,385
"180210907",658,767,1425,435,528,402
"180210908",546,647,1193,432,504,380
"180210909",330,461,791,323,466,301
"180210910",295,381,676,296,376,283
"180210911",240,322,562,207,238,153
"180210912",519,650,1169,427,477,338
"180210913",266,359,625,224,263,213
"180210914",393,482,875,317,331,248
"180210915",339,418,757,238,277,229
"180211001",493,575,1068,280,250,225
"180211002",556,646,1202,292,312,279
"180211003",573,599,1172,303,296,291
"180211004",620,632,1252,321,339,305
"180211005",513,512,1025,253,246,229
"180211006",939,1029,1968,480,456,430
"180211007",620,701,1321,325,362,311
"180211101",657,644,1301,304,399,291
"180211102",91,40,131,23,33,23
"180211103",292,311,603,154,192,144
"180211104",195,162,357,114,245,101
"180211105",305,302,607,151,185,140
"180211106",695,701,1396,356,347,288
"180211107",643,695,1338,312,319,283
"180211108",465,521,986,231,231,202
"180211109",598,577,1175,268,290,252
"180211110",375,413,788,217,278,214
"180211201",56,47,103,27,51,26
"180211202",86,84,170,46,66,44
"180211203",63,70,133,35,45,34
"180211204",420,78,498,48,70,46
"180211205",368,352,720,187,205,173
"180211206",281,290,571,148,173,141
"180211207",275,220,495,145,154,139
"180211208",663,716,1379,331,340,302
"180211209",937,998,1935,432,399,366
"180211210",686,750,1436,324,339,319
"180211211",636,649,1285,270,264,260
"180211212",680,696,1376,348,346,323
"180211213",224,189,413,98,114,98
"180211301",675,667,1342,319,356,299
"180211302",320,300,620,170,223,169
"180211303",108,90,198,51,60,48
"180211304",30,18,48,16,31,16
"180211305",222,235,457,118,137,115
"180211306",381,399,780,190,223,183
"180211307",383,390,773,225,290,212
"180211401",4,2,6,5,5,5
"180211402",18,19,37,10,10,10
"180211501",558,625,1183,297,261,243
"180211502",358,428,786,256,247,211
"180211503",188,240,428,118,131,112
"180211504",196,260,456,128,142,127
"180211505",422,467,889,286,303,276
"180211506",361,431,792,221,205,193
"180211507",394,456,850,237,220,196
"180211508",431,506,937,238,215,205
"180211509",354,397,751,194,193,183
"180211510",281,328,609,177,188,170
"180211511",669,806,1475,421,392,352
"180211512",416,465,881,244,268,236
"180211513",419,477,896,231,264,222
"180211514",445,494,939,246,248,232
"180211515",357,409,766,199,209,196
"180211516",835,939,1774,468,408,393
"180211601",370,412,782,183,169,155
"180211602",419,396,815,197,202,193
"180211603",722,806,1528,369,359,330
"180211604",889,1057,1946,504,430,399
"180211605",322,356,678,170,162,155
"180211606",337,392,729,196,220,191
"180211607",356,436,792,233,256,220
"180211608",396,510,906,242,234,226
"180211609",484,498,982,290,359,276
"180211610",365,381,746,182,199,176
"180211611",499,509,1008,268,302,266
"180211612",419,474,893,213,214,199
"180211613",560,534,1094,242,234,217
"180211614",513,545,1058,292,274,261
"180211615",654,684,1338,345,351,313
"180211616",710,727,1437,345,357,324
"180211701",489,445,934,302,305,273
"180211702",675,718,1393,339,290,275
"180211703",889,876,1765,404,356,332
"180211704",567,642,1209,330,336,288
"180211705",404,497,901,262,227,208
"180211706",781,832,1613,426,391,370
"180211707",360,446,806,250,318,244
"180211708",540,571,1111,293,254,240
"180211709",585,585,1170,272,255,244
"180211710",573,603,1176,318,313,297
"180211711",505,566,1071,291,306,276
"180211712",345,430,775,213,217,204
"180211713",627,670,1297,299,268,245
"180211714",393,441,834,219,224,210
"180211715",501,529,1030,266,261,244
"180211716",398,442,840,216,216,203
"180211717",517,511,1028,225,224,212
"180211718",871,894,1765,398,392,367
"180211801",837,939,1776,429,452,410
"180211802",528,647,1175,292,291,272
"180211803",799,870,1669,424,407,367
"180211804",927,1023,1950,487,514,451
"180211805",544,544,1088,261,232,211
"180211806",519,572,1091,260,233,214
"180211807",802,837,1639,417,401,369
"180211808",836,920,1756,386,360,355
"180211809",1150,1217,2367,517,529,492
"180211810",497,494,991,261,299,258
"180211811",683,741,1424,331,365,326
"180211812",1006,1075,2081,448,471,415
"180211813",834,904,1738,421,446,401
"180211901",403,433,836,262,283,212
"180211902",470,542,1012,306,278,247
"180211903",315,364,679,233,282,229
"180211904",236,281,517,202,257,198
"180211905",660,669,1329,297,254,245
"180211906",499,516,1015,257,234,221
"180211907",525,497,1022,226,205,189
"180211908",766,836,1602,405,342,328
"180211909",468,521,989,332,323,257
"180211910",125,192,317,127,168,126
"180211911",451,514,965,296,305,253
"180211912",775,861,1636,514,462,400
"180211913",407,407,814,196,196,179
"180211914",417,527,944,232,225,208
"180211915",552,565,1117,297,294,261
"180211916",337,427,764,234,254,221
"180211917",340,355,695,181,222,173
"180211918",550,568,1118,314,281,262
"180212001",665,698,1363,396,346,287
"180212002",799,832,1631,429,431,377
"180212003",764,808,1572,477,548,426
"180212004",585,599,1184,300,275,259
"180212005",537,526,1063,251,242,221
"180212006",656,731,1387,368,343,313
"180212007",532,573,1105,308,342,294
"180212008",409,531,940,283,356,269
"180212009",555,592,1147,288,288,246
"180212010",641,672,1313,338,308,284
"180212011",825,866,1691,446,372,347
"180212012",529,601,1130,302,292,273
"180212013",626,727,1353,364,353,316
"180212101",590,638,1228,334,346,294
"180212102",412,438,850,253,243,212
"180212103",753,884,1637,392,333,308
"180212104",534,598,1132,334,371,313
"180212105",219,312,531,177,179,148
"180212106",1110,1065,2175,438,391,363
"180212107",672,727,1399,353,368,330
"180212108",794,819,1613,375,386,344
"180212109",498,525,1023,282,285,241
"180212110",777,801,1578,407,355,334
"180212111",764,825,1589,400,342,324
"180212112",885,878,1763,409,339,328
"180212201",292,301,593,175,185,165
"180212202",503,556,1059,275,256,241
"180212203",726,794,1520,369,360,351
"180212204",1005,1035,2040,474,457,443
"180212205",743,713,1456,309,296,289
"180212206",719,678,1397,310,297,278
"180212207",1085,1087,2172,486,501,472
"180212208",601,592,1193,274,272,244
"180212209",760,839,1599,400,387,367
"180212210",632,668,1300,329,335,301
"180212211",792,809,1601,368,369,348
"180212212",943,1022,1965,486,491,462
"180212301",1054,1024,2078,462,446,426
"180212302",761,855,1616,400,391,367
"180212303",826,873,1699,404,411,388
"180212304",648,721,1369,323,345,314
"180212305",885,1037,1922,413,387,363
"180212306",572,635,1207,273,300,270
"180212307",775,843,1618,365,331,318
"180212308",635,664,1299,298,305,292
"180212309",732,788,1520,351,328,306
"180212310",848,853,1701,352,368,341
"180212311",849,861,1710,392,410,374
"180212312",847,926,1773,406,431,387
"180212313",792,861,1653,401,436,399
"180212314",250,266,516,116,124,114
"180280101",834,771,1605,413,458,395
"180280102",289,332,621,183,247,182
"180280103",545,556,1101,297,345,293
"180280201",62,20,82,21,33,21
"180280202",58,58,116,27,37,26
"180280301",1202,1102,2304,560,584,510
"180280302",29,16,45,15,24,15
"180280303",172,158,330,85,92,84
"180280304",11,5,16,5,12,5
"180280305",46,27,73,18,25,18
"180280306",108,95,203,36,36,36
"180280307",97,75,172,39,41,39
"180280308",380,368,748,171,191,170
"180280309",858,784,1642,374,401,352
"180280310",526,527,1053,268,301,265
"180280311",648,685,1333,337,366,311
"180280312",1152,1168,2320,538,568,517
"180280401",453,463,916,235,285,230
"180280402",57,31,88,21,24,21
"180280403",110,106,216,45,47,45
"180280404",23,7,30,6,8,6
"180280405",322,287,609,138,158,133
"180280406",329,296,625,143,161,142
"180280407",256,237,493,123,138,123
"180280408",156,147,303,79,81,75
"180280409",204,197,401,94,110,93
"180280410",84,60,144,36,39,36
"180280411",126,114,240,67,70,63
"180280412",355,376,731,161,172,159
"180280413",289,275,564,126,150,126
"180280501",42,21,63,19,32,19
"180280502",55,8,63,22,25,22
"180280503",41,30,71,17,22,17
"180280601",57,31,88,25,32,25
"180280602",20,2,22,4,6,4
"180280603",30,29,59,22,25,22
"180280604",167,160,327,85,103,83
"180280605",22,20,42,12,24,12
"180280606",47,17,64,20,30,20
"180280701",103,102,205,64,71,64
"180280702",330,345,675,149,160,146
"180280703",36,31,67,23,25,23
"180280704",37,21,58,16,16,16
"180280705",46,31,77,26,33,21
"180280706",40,20,60,24,28,23
"180280707",27,21,48,16,22,16
"180350101",512,534,1046,294,299,279
"180350102",387,391,778,206,204,191
"180350103",636,665,1301,342,372,332
"180350104",481,495,976,300,336,280
"180350105",393,481,874,321,349,302
"180350106",188,238,426,155,201,153
"180350107",263,314,577,189,214,183
"180350108",224,265,489,171,214,162
"180350109",346,446,792,232,259,218
"180350110",339,352,691,212,227,201
"180350111",599,609,1208,294,300,268
"180350112",389,439,828,220,240,209
"180350113",329,394,723,232,244,218
"180350114",7,5,12,6,7,6
"180350115",448,470,918,225,228,218
"180350116",404,408,812,201,227,192
"180350201",83,42,125,34,35,34
"180350301",103,60,163,50,66,50
"180350302",70,64,134,33,43,33
"180350303",81,41,122,41,58,41
"180350401",69,15,84,17,21,16
"180350402",71,28,99,33,44,33
"180350501",175,167,342,114,144,110
"180350502",134,118,252,78,98,78
"180350503",40,14,54,12,12,12
"180350601",44,18,62,30,38,28
"180350602",55,20,75,25,41,25
"180350603",234,222,456,114,124,111
"180350701",101,57,158,41,47,41
"180350702",50,26,76,19,31,19
"180350801",41,30,71,21,24,21
"180350802",122,111,233,73,78,72
"180350901",66,8,74,18,20,18
"180350902",54,47,101,30,33,30
"180351001",27,18,45,16,25,16
"180351002",21,3,24,6,12,6
"180351101",294,262,556,147,186,141
"180351102",65,43,108,36,46,36
"180351201",82,70,152,44,51,44
"180351202",29,26,55,15,20,15
"180351203",54,31,85,24,30,23
"180351301",114,83,197,70,79,70
"180351302",35,26,61,25,31,24
"180351303",141,138,279,74,88,74
"180351401",270,279,549,147,185,146
"180351402",83,73,156,39,58,39
"180351501",542,609,1151,308,339,302
"180351502",619,559,1178,291,322,278
"180351503",54,48,102,29,32,29
"180351504",55,61,116,30,44,29
"180351505",58,23,81,26,31,23
"180351506",229,201,430,110,126,108
"180351507",15,10,25,9,12,9
"180351508",43,34,77,26,39,26
"180351509",60,46,106,27,42,27
"180351510",386,414,800,229,249,217
"180351511",386,388,774,202,227,194
"180351601",35,32,67,20,37,20
"180351602",68,19,87,20,21,17
"180351701",25,9,34,12,15,12
"180351702",26,11,37,11,16,11
"180351801",695,827,1522,357,369,350
"180351802",682,732,1414,377,396,352
"180351803",304,342,646,182,244,180
"180351804",366,383,749,216,234,204
"180351805",477,571,1048,326,315,284
"180351806",246,300,546,173,195,171
"180351807",456,546,1002,310,318,299
"180351808",618,738,1356,343,353,334
"180351809",569,574,1143,285,317,269
"180351810",612,672,1284,308,330,292
"180351811",367,364,731,173,206,173
"180351901",220,262,482,119,133,114
"180351902",390,468,858,223,250,217
"180351903",645,739,1384,347,362,338
"180351904",609,648,1257,356,366,326
"180351905",508,572,1080,302,320,289
"180351906",234,287,521,200,222,192
"180351907",223,285,508,177,197,172
"180351908",205,250,455,140,151,127
"180351909",282,334,616,202,213,196
"180351910",412,451,863,224,225,210
"180351911",219,265,484,172,226,172
"180351912",358,440,798,269,310,261
"180351913",568,605,1173,289,303,259
"180420101",462,453,915,240,273,235
"180420102",588,658,1246,328,386,322
"180420103",369,422,791,218,263,199
"180420104",660,712,1372,361,430,358
"180420105",427,453,880,209,231,193
"180420106",480,469,949,243,280,222
"180420107",520,571,1091,296,366,283
"180420108",482,522,1004,295,347,282
"180420109",426,455,881,234,270,230
"180420201",23,17,40,8,17,8
"180420202",118,112,230,67,86,67
"180420203",19,13,32,8,9,8
"180420204",62,57,119,36,50,36
"180420301",214,206,420,107,132,106
"180420302",43,28,71,25,31,24
"180420303",38,45,83,28,35,27
"180420304",247,240,487,132,172,129
"180420305",79,91,170,55,58,53
"180420306",124,100,224,54,57,54
"180420307",310,293,603,160,170,149
"180420308",46,36,82,22,19,16
"180420401",86,83,169,43,51,43
"180420402",24,21,45,14,23,14
"180420403",89,96,185,50,56,46
"180420404",51,36,87,21,21,21
"180420405",47,60,107,30,24,24
"180420501",161,178,339,93,103,86
"180420502",109,135,244,67,86,67
"180420503",138,120,258,70,86,68
"180420504",291,225,516,147,166,146
"180420505",54,56,110,34,39,34
"180420506",339,360,699,190,215,190
"180420507",301,299,600,157,190,152
"180420601",4,0,4,2,3,2
"180420602",36,20,56,11,11,11
"180420603",0,0,0,0,1,0
"180490101",480,497,977,240,246,231
"180490102",485,509,994,248,271,241
"180490103",810,820,1630,397,436,389
"180490104",730,739,1469,378,408,359
"180490105",305,333,638,188,225,185
"180490106",242,287,529,169,197,167
"180490107",342,409,751,270,317,263
"180490108",255,320,575,207,244,199
"180490109",488,584,1072,305,361,302
"180490110",436,542,978,328,407,310
"180490111",308,344,652,191,215,177
"180490112",313,370,683,214,235,195
"180490113",784,865,1649,377,416,367
"180490114",411,452,863,219,213,201
"180490115",407,433,840,192,225,190
"180490116",666,721,1387,388,422,375
"180490117",544,592,1136,301,337,295
"180490118",339,328,667,171,177,165
"180490201",71,69,140,30,33,30
"180490202",250,236,486,129,169,128
"180490203",135,141,276,59,73,58
"180490204",51,32,83,21,26,21
"180490205",28,26,54,16,21,16
"180490206",14,10,24,9,12,9
"180490207",421,433,854,217,230,215
"180490301",561,523,1084,284,334,280
"180490302",12,9,21,6,10,6
"180490303",45,40,85,25,36,25
"180490304",83,66,149,36,44,35
"180490305",79,93,172,35,36,35
"180490306",423,364,787,200,189,179
"180490307",192,162,354,98,109,90
"180490308",459,473,932,254,314,254
"180490401",152,112,264,70,95,70
"180490402",118,137,255,72,73,70
"180490403",53,56,109,29,47,25
"180490404",73,56,129,39,34,34
"180490405",92,88,180,44,37,32
"180490501",151,158,309,73,78,66
"180490502",31,24,55,16,22,16
"180490503",4,0,4,4,6,4
"180490601",28,27,55,16,22,16
"180490602",21,13,34,11,12,11
"180490603",37,33,70,16,19,16
"180490701",1282,1363,2645,629,647,552
"180490702",235,256,491,117,131,110
"180490703",309,280,589,150,166,145
"180490704",432,402,834,217,237,212
"180490705",28,27,55,16,19,16
"180490801",73,91,164,43,50,43
"180490802",148,137,285,61,71,61
"180490901",23,19,42,9,9,9
"180490902",119,115,234,46,54,45
"180490903",51,37,88,17,18,16
"180490904",54,36,90,19,20,19
"180491001",268,263,531,116,123,116
"180491002",90,85,175,45,46,43
"180491003",30,29,59,14,17,14
"180491101",40,25,65,17,30,17
"180560101",433,442,875,254,296,235
"180560102",364,389,753,239,247,215
"180560103",555,615,1170,325,338,313
"180560104",507,558,1065,314,362,311
"180560105",266,297,563,162,191,161
"180560106",199,234,433,160,186,155
"180560107",217,238,455,156,213,154
"180560108",220,232,452,140,169,140
"180560109",214,248,462,156,228,155
"180560110",204,221,425,118,120,95
"180560201",178,153,331,87,113,83
"180560202",71,40,111,35,54,34
"180560301",146,160,306,71,83,70
"180560302",34,14,48,18,40,18
"180560303",31,21,52,15,23,15
"180560401",65,51,116,39,56,39
"180560402",21,15,36,16,17,15
"180560403",21,18,39,12,15,12
"180560404",7,4,11,6,10,6
"180560501",24,12,36,10,23,9
"180560502",17,5,22,10,16,9
"180560503",34,22,56,17,18,17
"180560504",7,6,13,5,4,4
"180560601",14,6,20,5,13,5
"180560602",6,1,7,2,11,2
"180560603",5,1,6,3,14,3
"180560604",55,4,59,10,20,10
"180560605",4,0,4,2,5,2
"180630101",758,866,1624,485,491,418
"180630102",571,688,1259,364,416,353
"180630103",390,436,826,230,262,226
"180630104",490,539,1029,272,285,252
"180630201",375,330,705,196,216,184
"180630202",563,601,1164,340,418,332
"180630203",64,54,118,32,81,30
"180630204",253,249,502,138,154,129
"180630205",350,369,719,201,225,194
"180630206",468,463,931,230,257,226
"180630301",277,226,503,138,165,137
"180630302",49,34,83,20,28,20
"180630303",124,103,227,64,74,64
"180630304",62,64,126,42,35,31
"180630401",175,183,358,123,142,121
"180630402",56,54,110,32,47,32
"180630403",14,16,30,6,8,6
"180630404",33,33,66,22,29,21
"180630405",8,3,11,3,8,3
"180630406",72,61,133,37,42,37
"180630407",24,9,33,6,6,6
"180630408",18,16,34,8,9,8
"180630501",79,62,141,36,42,36
"180630502",83,73,156,44,55,43
"180630503",129,103,232,55,59,54
"180630504",37,29,66,16,18,16
"180630601",44,35,79,26,32,26
"180630602",64,40,104,27,33,27
"180630603",8,10,18,8,10,8
"180630701",242,248,490,137,162,134
"180630702",57,52,109,31,45,30
"180630703",118,96,214,52,56,52
"180630704",173,181,354,97,109,95
"180630705",169,173,342,87,106,79
"180630706",81,75,156,38,39,38
"180630801",53,53,106,28,32,27
"180630802",170,150,320,76,80,75
"180630803",91,83,174,56,60,53
"180630804",210,170,380,111,126,110
"180630805",152,143,295,73,90,71
"180630806",250,258,508,131,148,129
"180630901",1,0,1,1,6,1
"180700101",377,431,808,259,281,249
"180700102",348,420,768,253,314,248
"180700103",398,433,831,284,317,277
"180700104",316,390,706,213,239,205
"180700105",349,402,751,233,234,225
"180700106",389,454,843,273,312,267
"180700107",336,411,747,266,295,259
"180700108",330,375,705,241,265,220
"180700109",344,387,731,229,238,212
"180700110",462,507,969,243,260,230
"180700111",523,624,1147,333,340,313
"180700112",397,447,844,234,236,217
"180700113",406,434,840,219,211,206
"180700114",328,427,755,256,270,241
"180700115",503,544,1047,300,308,278
"180700116",353,394,747,205,209,192
"180700117",375,411,786,232,248,221
"180700118",186,205,391,91,93,86
"180700201",287,294,581,173,203,169
"180700202",412,380,792,173,207,162
"180700203",314,294,608,148,164,142
"180700204",151,155,306,92,136,91
"180700205",49,53,102,30,43,29
"180700206",75,74,149,33,38,31
"180700207",49,56,105,27,27,27
"180700208",6,5,11,5,8,5
"180700209",111,99,210,52,56,51
"180700210",9,3,12,3,12,3
"180700301",330,325,655,185,206,185
"180700302",196,199,395,107,127,107
"180700303",59,58,117,40,46,40
"180700401",48,46,94,30,39,28
"180700402",70,79,149,40,46,40
"180700403",43,35,78,22,36,22
"180700404",51,43,94,24,30,24
"180700501",129,144,273,61,67,60
"180700502",71,74,145,37,37,37
"180700503",15,9,24,10,13,10
"180700601",52,60,112,25,32,25
"180700602",22,14,36,12,21,12
"180700603",64,59,123,31,31,31
"180700701",50,54,104,30,38,30
"180700702",11,13,24,7,10,7
"180700703",43,25,68,13,16,13
"180700801",136,111,247,56,61,56
"180700802",139,106,245,47,55,46
"180700803",133,124,257,58,72,57
"180700804",178,172,350,79,86,76
"180700901",93,85,178,50,64,50
"180700902",111,125,236,61,66,58
"180701001",54,52,106,31,34,29
"180701002",110,93,203,53,61,53
"180701003",254,217,471,115,129,110
"180701004",114,102,216,43,51,40
"180701005",280,266,546,111,119,111
"180701101",207,192,399,85,86,83
"180701102",244,234,478,103,111,103
"180701201",383,329,712,186,212,184
"180701202",159,162,321,70,75,67
"180701203",99,85,184,50,69,50
"180701204",184,173,357,96,109,95
"180701301",235,190,425,104,117,103
"180701302",84,73,157,34,45,32
"180701303",348,347,695,167,194,164
"180701304",29,19,48,17,20,17
"180701401",228,237,465,106,134,105
"180701402",201,209,410,92,94,92
"180701403",263,243,506,124,142,121
"180701404",138,154,292,72,101,71
"180701501",131,126,257,62,68,62
"180701502",136,126,262,67,78,67
"180701503",231,208,439,111,126,111
"180701504",23,20,43,13,17,13
"180701505",74,72,146,33,34,32
"180701506",639,753,1392,331,330,326
"180701507",551,662,1213,292,300,276
"180701508",797,787,1584,383,381,355
"180701509",651,739,1390,350,371,343
"180701601",176,161,337,82,91,77
"180701602",75,56,131,40,40,40
"180701603",84,91,175,59,65,57
"180701604",129,114,243,60,71,59
"180701605",114,106,220,64,62,61
"180701606",112,115,227,71,82,70
"180701607",149,179,328,93,93,85
"180701701",113,105,218,62,75,62
"180701702",27,26,53,16,22,16
"180701703",111,106,217,64,70,62
"180701704",34,30,64,23,27,22
"180701801",116,117,233,65,77,65
"180701802",147,128,275,75,87,73
"180701803",141,140,281,81,126,81
"180701901",12,6,18,5,6,5
"180701902",333,318,651,145,176,142
"180701903",17,15,32,6,6,6
"180701904",32,30,62,13,13,13
"180701905",37,28,65,14,14,14
"180701906",0,0,0,0,4,0
"180701907",8,8,16,4,6,4
"180701908",6,5,11,3,3,3
"180701909",49,31,80,25,25,25
"180702001",397,445,842,231,177,161
"180702002",362,403,765,221,231,204
"180702003",310,409,719,212,200,179
"180702004",586,641,1227,353,350,322
"180702005",447,510,957,286,315,278
"180702006",446,497,943,298,345,285
"180702007",378,455,833,260,281,243
"180702008",498,573,1071,346,392,342
"180702009",354,433,787,268,310,263
"180702010",355,408,763,222,239,210
"180702011",262,342,604,217,272,210
"180702012",329,400,729,242,304,232
"180702013",360,457,817,264,288,244
"180702014",260,303,563,211,239,192
"180702015",268,307,575,192,226,190
"180702016",325,392,717,271,283,194
"180702101",334,394,728,200,195,182
"180702102",28,37,65,19,24,19
"180702103",732,837,1569,386,385,367
"180702104",654,684,1338,336,344,314
"180702105",508,566,1074,319,333,302
"180702106",372,431,803,238,256,229
"180702107",170,181,351,87,92,86
"180702108",390,379,769,182,191,177
"180702109",558,622,1180,305,311,292
"180702110",451,484,935,259,234,220
"180702111",411,451,862,245,249,218
"180702112",549,600,1149,264,259,254
"180702113",717,759,1476,362,360,348
"180702114",409,438,847,234,240,207
"180702115",732,813,1545,370,345,327
"180702116",571,629,1200,313,335,304
"180702117",570,562,1132,259,244,228
"180702201",848,832,1680,384,378,356
"180702202",662,714,1376,343,363,337
"180702203",463,562,1025,311,282,248
"180702204",712,838,1550,421,396,364
"180702205",418,416,834,214,155,147
"180702206",596,613,1209,343,354,331
"180702207",321,377,698,225,241,221
"180702208",487,486,973,251,253,235
"180702209",364,414,778,205,218,202
"180702210",832,893,1725,456,429,402
"180702211",59,57,116,24,23,21
"180702212",617,729,1346,382,403,371
"180702213",569,660,1229,323,329,317
"180702214",538,596,1134,261,277,247
"180702215",897,867,1764,357,355,346
"180702216",648,650,1298,287,299,277
"180702217",497,591,1088,273,257,236
"180702218",597,654,1251,316,329,306
"180770101",388,391,779,199,212,196
"180770102",274,292,566,161,207,155
"180770103",536,629,1165,320,363,307
"180770104",519,565,1084,314,355,294
"180770105",358,385,743,209,251,201
"180770106",402,481,883,216,256,210
"180770201",357,321,678,168,201,168
"180770202",130,145,275,86,109,82
"180770203",110,112,222,68,76,68
"180770204",211,157,368,94,109,91
"180770205",135,124,259,67,86,61
"180770206",21,19,40,13,15,13
"180770207",29,29,58,14,16,14
"180770208",320,332,652,146,166,146
"180770301",317,272,589,165,183,164
"180770302",116,115,231,56,69,56
"180770401",42,40,82,23,35,23
"180770402",157,131,288,76,85,75
"180770501",42,43,85,23,25,23
"180770502",66,39,105,32,35,32
"180770503",6,12,18,5,8,5
"180770601",0,0,0,0,1,0
"180770602",1,0,1,1,1,1
"180770603",0,0,0,0,1,0
"180840101",684,721,1405,346,475,335
"180840102",410,433,843,222,452,212
"180840103",446,445,891,244,275,222
"180840104",302,358,660,190,220,176
"180840105",372,397,769,227,259,222
"180840106",483,480,963,247,268,243
"180840107",719,739,1458,374,356,310
"180840108",540,556,1096,297,308,272
"180840109",350,375,725,238,309,225
"180840110",348,398,746,224,289,212
"180840111",332,400,732,246,301,235
"180840112",533,530,1063,303,343,297
"180840113",381,388,769,221,286,203
"180840114",476,564,1040,311,331,291
"180840115",518,570,1088,306,328,298
"180840116",578,604,1182,326,349,311
"180840117",193,212,405,128,261,125
"180840118",904,953,1857,445,492,421
"180840201",663,613,1276,293,331,282
"180840202",44,23,67,14,14,14
"180840203",138,139,277,71,213,68
"180840204",299,291,590,134,155,116
"180840205",514,484,998,234,291,228
"180840206",14,9,23,7,12,7
"180840301",152,132,284,71,83,70
"180840302",42,15,57,21,15,12
"180840303",9,2,11,6,10,6
"180840304",17,6,23,10,16,10
"180840305",9,3,12,6,13,6
"180840306",56,21,77,36,54,34
"180840401",4,0,4,3,10,3
"180840402",16,4,20,4,5,4
"180840403",43,30,73,24,186,24
"180840404",15,18,33,8,13,8
"180840501",88,55,143,36,50,28
"180840502",75,23,98,47,40,33
"180840503",75,24,99,30,33,25
"180840601",38,32,70,19,29,19
"180840602",24,7,31,15,15,15
"180840603",30,16,46,19,29,19
"180840701",71,51,122,27,30,26
"180840702",22,13,35,10,19,10
"180840703",30,14,44,13,57,10
"180840801",8,5,13,6,12,6
"180840802",35,30,65,18,19,17
"180840901",51,26,77,23,27,23
"180840902",45,22,67,23,35,23
"180840903",67,27,94,32,40,32
"180841001",322,323,645,173,196,171
"180841002",418,398,816,201,222,193
"180841003",368,335,703,178,194,170
"180841004",215,203,418,97,93,80
"180841005",78,58,136,39,87,38
"180841006",20,18,38,13,15,13
"180841007",138,131,269,77,94,75
"180841008",26,7,33,17,38,17
"180841009",8,12,20,8,14,8
"180841101",460,524,984,265,298,256
"180841102",139,139,278,75,68,62
"180841103",57,44,101,28,42,28
"180841104",155,152,307,81,93,81
"180841105",289,269,558,136,175,136
"180841106",40,29,69,19,27,18
"180841107",24,20,44,15,17,14
"180841108",66,65,131,37,40,33
"180841109",640,641,1281,312,337,306
"180841201",536,488,1024,229,288,225
"180841202",69,50,119,45,52,45
"180841203",280,258,538,126,124,122
"180841204",75,34,109,38,43,37
"180841205",8,0,8,3,2,2
"180841206",0,0,0,0,1,0
"180841207",0,0,0,0,1,0
"180910101",597,623,1220,311,333,303
"180910102",343,400,743,224,263,219
"180910103",264,284,548,173,203,166
"180910104",492,472,964,242,255,226
"180910105",609,635,1244,311,321,296
"180910106",577,628,1205,301,320,298
"180910107",546,530,1076,276,294,272
"180910108",417,481,898,245,283,243
"180910109",426,406,832,225,242,207
"180910110",936,929,1865,455,482,449
"180910201",327,343,670,194,209,192
"180910202",234,202,436,103,124,101
"180910203",510,497,1007,236,264,230
"180910204",257,249,506,134,141,133
"180910205",33,30,63,17,21,17
"180910206",294,251,545,131,143,130
"180910207",355,327,682,169,181,166
"180910208",362,327,689,194,217,192
"180910209",521,536,1057,260,289,257
"180910210",278,256,534,136,181,135
"180910211",269,239,508,125,139,120
"180910212",133,128,261,59,70,59
"180910301",298,288,586,152,179,148
"180910302",182,169,351,93,100,93
"180910303",241,188,429,106,120,104
"180910304",60,66,126,33,37,31
"180910305",126,123,249,64,68,63
"180910401",274,265,539,132,165,132
"180910402",181,162,343,84,93,83
"180910403",144,126,270,69,73,67
"180910404",141,135,276,63,70,63
"180910405",241,238,479,114,131,114
"180910406",96,86,182,50,39,33
"180910407",52,32,84,23,25,22
"180910501",50,42,92,15,18,15
"180910502",33,29,62,19,27,19
"180910503",144,138,282,74,86,72
"180910504",87,77,164,37,52,37
"180910505",27,14,41,11,13,11
"180910506",27,25,52,14,17,14
"180910601",27,14,41,10,15,10
"180910602",18,11,29,7,9,7
"180910603",23,13,36,12,20,12
"180910701",318,338,656,187,202,180
"180910702",119,108,227,50,55,49
"180910703",234,200,434,108,120,103
"180910704",313,271,584,129,145,127
"180910705",83,80,163,38,43,38
"180910706",561,543,1104,256,276,248
"180910801",86,57,143,36,40,36
"180910802",429,411,840,200,223,197
"180910803",570,480,1050,274,296,250
"180910804",316,302,618,160,186,155
"180910805",121,84,205,51,58,47
"180910806",239,222,461,116,132,113
"180910901",4,3,7,3,3,3
"180910902",1,0,1,1,1,1
"180910903",0,0,0,0,1,0
"180980101",480,481,961,237,285,232
"180980102",480,508,988,255,306,255
"180980103",658,734,1392,378,490,364
"180980104",300,347,647,211,246,204
"180980105",271,310,581,167,208,163
"180980106",425,446,871,248,326,243
"180980107",413,444,857,233,294,232
"180980201",198,180,378,102,120,100
"180980202",127,116,243,60,82,60
"180980203",369,381,750,183,219,181
"180980301",126,132,258,71,103,71
"180980302",243,220,463,122,151,121
"180980303",91,75,166,47,57,47
"180980304",131,108,239,72,89,71
"180980401",7,2,9,6,21,6
"180980402",43,39,82,25,27,25
"180980403",108,88,196,52,57,52
"180980501",32,25,57,19,30,19
"180980502",33,39,72,18,32,18
"180980503",26,16,42,18,24,18
"181050101",541,540,1081,263,280,244
"181050102",533,534,1067,270,263,247
"181050103",623,655,1278,307,321,289
"181050104",524,554,1078,332,333,297
"181050105",382,404,786,204,225,185
"181050106",660,711,1371,368,408,352
"181050107",842,917,1759,448,483,423
"181050108",225,247,472,123,152,123
"181050109",454,508,962,284,337,275
"181050110",415,445,860,301,340,290
"181050111",202,248,450,152,187,150
"181050112",476,501,977,269,284,248
"181050113",733,755,1488,385,386,345
"181050114",715,723,1438,363,384,349
"181050115",240,309,549,191,236,190
"181050201",26,26,52,14,21,14
"181050202",139,112,251,74,109,74
"181050203",78,54,132,44,51,44
"181050204",595,670,1265,332,367,323
"181050301",40,7,47,7,4,4
"181050302",98,33,131,49,64,49
"181050401",47,21,68,15,15,15
"181050402",13,13,26,6,7,6
"181050501",30,9,39,12,17,12
"181050502",31,20,51,21,25,21
"181050503",23,14,37,12,12,12
"181050601",43,38,81,27,36,27
"181050602",28,30,58,20,25,19
"181050603",22,11,33,14,14,14
"181050701",14,10,24,9,21,9
"181050702",13,6,19,7,14,7
"181050801",57,66,123,33,31,21
"181050802",51,35,86,23,33,21
"181050803",69,42,111,31,100,31
"181050804",30,3,33,3,10,3
"181050805",392,408,800,188,198,188
"181050806",11,7,18,6,6,6
"181050901",407,461,868,246,331,245
"181050902",21,16,37,12,18,12
"181050903",43,26,69,19,20,19
"181050904",482,493,975,261,330,258
"181051001",3,2,5,3,8,3
"181051002",3,0,3,3,11,3
"181051003",153,159,312,88,101,82
"181051101",732,703,1435,405,454,384
"181051102",25,14,39,15,26,15
"181051103",33,25,58,17,26,17
"181051104",16,10,26,10,15,10
"181051201",80,74,154,40,44,30
"181051202",86,74,160,49,58,49
"181051203",42,32,74,27,40,27
"181051204",141,133,274,82,114,82
"181051301",144,164,308,83,94,77
"181051302",41,34,75,25,24,24
"181051303",12,3,15,4,12,4
"181051304",59,54,113,48,74,48
"181051305",49,39,88,25,28,25
"181051306",5,0,5,2,5,2
"181051401",10,4,14,5,5,5
"181051402",14,1,15,6,11,6
"181051403",10,4,14,7,10,7
"181051404",4,7,11,2,2,2
"181051501",15,12,27,9,17,9
"181051502",1,0,1,1,1,1
"181051503",15,0,15,4,9,3
"181051601",164,154,318,83,93,83
"181051602",41,40,81,22,30,22
"181051603",30,29,59,20,22,20
"181051604",24,19,43,18,21,18
"181051605",56,35,91,23,32,23
"181051701",23,1,24,5,5,5
"181051702",22,2,24,7,7,5
"181051801",71,46,117,33,41,33
"181051802",10,3,13,9,11,9
"181051901",37,16,53,15,20,12
"181051902",38,0,38,21,21,21
"181052001",27,2,29,4,4,2
"181052002",27,17,44,11,8,4
"181052003",33,2,35,24,7,5
"181052101",351,353,704,180,183,176
"181052102",760,822,1582,439,479,432
"181052103",540,576,1116,275,298,263
"181052104",450,477,927,233,250,223
"181052105",358,456,814,263,352,260
"181052106",456,501,957,298,353,287
"181052107",720,776,1496,381,419,367
"181052108",453,487,940,289,364,266
"181052109",375,386,761,213,255,206
"181052110",357,370,727,190,212,180
"181052111",603,614,1217,314,350,303
"181052112",799,919,1718,468,502,441
"181052113",714,737,1451,375,396,351
"181052114",476,521,997,254,262,245
"181120101",548,587,1135,280,277,269
"181120102",201,156,357,79,94,77
"181120103",113,121,234,61,82,61
"181120104",508,590,1098,326,361,324
"181120105",352,364,716,218,240,208
"181120106",631,661,1292,326,343,322
"181120107",533,536,1069,283,303,274
"181120108",649,663,1312,348,346,326
"181120109",331,382,713,217,219,202
"181120110",288,302,590,171,192,166
"181120111",219,280,499,189,202,176
"181120112",354,394,748,217,223,203
"181120113",205,232,437,162,193,157
"181120114",588,603,1191,349,384,338
"181120201",45,50,95,24,30,24
"181120202",133,114,247,69,82,69
"181120203",90,99,189,48,56,48
"181120204",53,46,99,32,36,30
"181120205",58,43,101,32,44,32
"181120206",63,66,129,38,49,38
"181120207",43,31,74,23,33,23
"181120208",30,22,52,15,15,14
"181120209",50,37,87,28,38,26
"181120210",93,90,183,43,58,43
"181120211",11,7,18,4,5,4
"181120212",260,232,492,119,125,118
"181120301",32,22,54,17,17,17
"181120302",15,13,28,8,8,7
"181120303",39,23,62,18,18,18
"181120304",5,8,13,4,4,4
"181120401",79,80,159,44,56,44
"181120402",29,25,54,19,27,19
"181120403",98,114,212,52,51,46
"181120404",336,284,620,159,191,155
"181120405",61,54,115,35,40,35
"181120406",28,8,36,8,12,8
"181120407",54,55,109,22,22,21
"181120408",13,6,19,6,10,6
"181120409",41,23,64,17,18,17
"181120410",46,40,86,22,23,22
"181120411",14,5,19,10,16,10
"181120501",8,3,11,2,5,2
"181120502",59,25,84,28,40,28
"181120503",47,14,61,20,27,20
"181120504",10,0,10,5,6,5
"181120601",37,31,68,27,32,27
"181120602",101,65,166,58,44,41
"181120603",16,5,21,7,11,7
"181120604",32,16,48,14,21,14
"181120701",628,569,1197,330,355,308
"181120702",195,170,365,100,111,96
"181120703",29,24,53,19,20,18
"181120704",77,72,149,47,48,46
"181120705",42,38,80,24,27,24
"181120706",20,21,41,10,13,10
"181120707",32,6,38,12,17,12
"181120708",20,17,37,11,27,11
"181120709",0,0,0,0,2,0
"181120710",67,58,125,34,45,34
"181120801",103,67,170,55,79,53
"181120802",89,93,182,50,62,50
"181120803",128,116,244,72,84,72
"181120804",148,118,266,87,91,75
"181120805",33,29,62,15,25,15
"181120806",469,437,906,308,326,293
"181120807",416,419,835,291,319,288
"181120808",921,765,1686,489,508,471
"181120809",522,484,1006,259,273,243
"181120810",788,753,1541,405,401,382
"181120901",370,384,754,210,212,200
"181120902",417,408,825,245,264,235
"181120903",319,317,636,216,244,209
"181120904",222,252,474,186,229,186
"181120905",303,316,619,231,274,229
"181120906",230,277,507,194,230,186
"181120907",436,509,945,306,326,283
"181120908",526,573,1099,323,354,298
"181120909",378,412,790,241,259,236
"181120910",449,469,918,253,277,244
"181120911",430,492,922,285,303,274
"181120912",307,356,663,207,225,205
"181120913",909,1004,1913,500,506,474
"181120914",506,508,1014,225,230,214
"181190101",501,448,949,238,261,232
"181190102",457,510,967,244,243,240
"181190103",565,650,1215,352,339,326
"181190104",890,985,1875,497,511,486
"181190105",507,587,1094,316,334,307
"181190106",247,307,554,153,159,148
"181190107",401,408,809,215,198,190
"181190108",469,508,977,285,278,256
"181190109",887,847,1734,423,413,394
"181190110",573,535,1108,269,175,161
"181190111",439,500,939,245,222,205
"181190112",115,131,246,80,81,73
"181190113",303,307,610,146,141,123
"181190114",400,386,786,190,196,186
"181190115",775,835,1610,399,411,370
"181190116",533,559,1092,300,280,256
"181190117",434,468,902,212,207,184
"181190201",18,6,24,10,14,10
"181190202",39,6,45,16,16,14
"181190301",174,154,328,91,116,89
"181190302",158,118,276,100,104,100
"181190303",17,9,26,8,7,7
"181190401",520,509,1029,262,212,149
"181190402",26,25,51,18,21,16
"181190403",56,21,77,22,21,19
"181190404",37,42,79,27,31,27
"181190501",52,39,91,24,5,4
"181190502",39,26,65,20,27,20
"181190601",413,362,775,210,220,200
"181190602",27,9,36,12,13,12
"181190701",19,15,34,15,16,15
"181190702",69,61,130,41,48,40
"181190703",11,11,22,9,9,9
"181190801",16,2,18,8,10,7
"181190802",50,12,62,23,29,23
"181190901",272,244,516,139,166,133
"181190902",13,3,16,7,11,7
"181190903",26,6,32,11,16,10
"181190904",3,0,3,3,4,3
"181190905",39,15,54,13,18,13
"181191001",71,64,135,39,47,39
"181191002",65,42,107,31,30,28
"181191003",41,37,78,22,23,19
"181191101",13,5,18,12,18,12
"181191102",15,9,24,11,19,11
"181191103",27,16,43,17,14,14
"181191201",41,23,64,17,24,17
"181191202",16,7,23,11,18,11
"181191203",21,16,37,13,16,13
"181191301",6,0,6,1,6,1
"181191401",267,238,505,122,140,121
"181191402",484,446,930,212,215,204
"181191403",871,853,1724,378,365,346
"181191404",315,308,623,153,133,121
"181191405",765,834,1599,394,405,387
"181191406",437,454,891,216,244,210
"181191407",630,652,1282,327,373,319
"181191501",523,522,1045,254,221,216
"181191502",357,311,668,164,166,157
"181191503",547,652,1199,365,355,328
"181191504",503,519,1022,298,304,267
"181191505",480,555,1035,327,372,302
"181191506",241,281,522,183,245,161
"181191507",426,473,899,234,207,191
"181191508",555,573,1128,281,275,259
"181191509",401,480,881,206,200,189
"181191510",359,394,753,232,244,221
"181191511",379,478,857,303,384,275
"181191512",262,313,575,206,247,205
"181191513",320,373,693,229,259,217
"181191514",124,132,256,69,95,69
"181191515",594,606,1200,319,325,289
"181191516",236,269,505,168,198,159
"181191517",152,206,358,115,159,111
"181191518",260,248,508,174,210,163
"181191519",643,699,1342,367,399,351
"181191520",590,701,1291,399,405,358
"181191521",469,519,988,267,264,248
"181191522",448,484,932,241,216,197
"181191523",294,346,640,224,209,183
"181260101",600,635,1235,315,343,294
"181260102",532,639,1171,317,357,294
"181260103",432,453,885,251,269,240
"181260104",616,689,1305,347,390,336
"181260105",707,811,1518,368,408,365
"181260106",690,750,1440,390,429,376
"181260107",723,808,1531,415,445,378
"181260108",744,833,1577,378,406,368
"181260109",513,527,1040,277,302,263
"181260201",108,92,200,51,57,50
"181260202",661,623,1284,313,344,309
"181260203",14,10,24,7,18,7
"181260301",334,267,601,135,150,135
"181260302",62,52,114,35,47,35
"181260401",77,80,157,40,48,40
"181260402",69,77,146,31,38,31
"181260501",614,631,1245,301,347,299
"181260502",188,194,382,109,128,103
"181260601",249,256,505,112,123,110
"181260602",46,32,78,18,23,18
"181260603",12,12,24,7,8,7
"181260701",747,767,1514,350,383,348
"181260702",154,159,313,63,78,63
"181260703",265,258,523,131,155,131
"181260801",105,87,192,59,77,59
"181260802",70,40,110,34,49,34
"181260901",580,557,1137,283,353,280
"181260902",711,704,1415,360,422,356
"181260903",204,170,374,81,105,81
"181260904",111,93,204,60,69,60
"181330101",399,414,813,209,228,205
"181330102",231,235,466,145,180,130
"181330103",234,244,478,145,208,139
"181330104",63,76,139,32,32,24
"181330201",88,67,155,41,263,40
"181330202",120,110,230,62,225,58
"181330203",128,99,227,69,107,66
"181330204",246,201,447,123,172,122
"181330205",128,112,240,65,77,64
"181330206",267,290,557,166,363,156
"181330207",272,283,555,167,301,162
"181330208",334,359,693,204,386,186
"181330209",163,136,299,90,293,84
"181330210",161,180,341,88,268,81
"181330211",70,35,105,32,279,32
"181330212",196,191,387,106,300,106
"181330213",167,172,339,90,218,90
"181330214",799,774,1573,359,406,347
"181330215",113,115,228,71,172,70
"181330216",46,32,78,18,24,18
"181330301",533,546,1079,259,310,249
"181330302",287,263,550,142,187,139
"181330303",48,35,83,26,47,26
"181330304",32,31,63,22,27,21
"181330305",2,4,6,2,6,2
"181330401",355,320,675,180,222,177
"181330402",51,50,101,33,49,33
"181330403",145,156,301,77,90,76
"181330501",497,514,1011,277,344,246
"181330502",465,463,928,250,351,244
"181330503",126,126,252,69,57,50
"181330504",120,113,233,67,100,66
"181330505",112,96,208,57,58,46
"181330506",133,160,293,73,94,72
"181330507",111,134,245,64,141,61
"181330601",1,1,2,1,1,1
"181330602",0,0,0,0,2,0
"181330603",1,0,1,1,1,1
"181400101",521,610,1131,274,295,261
"181400102",429,423,852,209,245,203
"181400103",484,531,1015,259,292,247
"181400104",422,475,897,254,271,240
"181400105",537,604,1141,286,297,259
"181400106",684,731,1415,335,356,327
"181400107",517,572,1089,266,306,256
"181400108",441,490,931,259,280,247
"181400109",495,634,1129,275,306,267
"181400110",593,679,1272,303,347,294
"181400201",162,154,316,81,100,79
"181400202",171,151,322,90,118,89
"181400203",894,888,1782,439,480,422
"181400204",78,90,168,41,52,40
"181400205",11,15,26,5,9,5
"181400206",373,387,760,185,191,178
"181400301",59,55,114,28,40,28
"181400302",83,65,148,37,48,37
"181400303",31,24,55,17,19,17
"181400401",27,11,38,13,15,13
"181400402",43,36,79,20,21,19
"181400403",47,29,76,15,16,15
"181400404",54,48,102,22,24,22
"181400405",122,115,237,56,60,54
"181400501",53,46,99,26,35,26
"181400502",38,19,57,15,16,15
"181400503",23,18,41,13,12,12
"181400504",40,32,72,17,17,17
"181400601",134,122,256,58,63,58
"181400602",179,152,331,70,71,70
"181400603",3,3,6,2,11,2
"181400604",13,7,20,7,7,7
"181400701",74,81,155,41,44,41
"181400702",41,26,67,21,31,21
"181400703",140,133,273,71,74,60
"181400704",33,22,55,12,14,12
"181400801",12,16,28,10,19,10
"181400802",55,44,99,32,40,31
"181400803",149,135,284,72,87,71
"181400804",38,45,83,22,26,22
"181400805",76,73,149,36,38,36
"181400806",33,30,63,17,22,17
"181400807",11,6,17,6,7,6
"181400808",2,0,2,1,3,1
"181400809",30,20,50,11,14,11
"181400901",10,7,17,9,14,9
"181400902",61,59,120,40,41,40
"181400903",78,73,151,39,42,39
"181470101",497,565,1062,283,321,279
"181470102",435,563,998,290,327,285
"181470103",471,494,965,273,314,254
"181470104",344,370,714,229,268,225
"181470105",441,496,937,292,329,257
"181470106",632,689,1321,343,391,332
"181470107",390,419,809,229,259,224
"181470201",88,118,206,61,62,50
"181470202",111,116,227,57,66,56
"181470203",58,61,119,35,40,34
"181470204",46,36,82,20,23,20
"181470205",333,366,699,175,191,166
"181470206",437,445,882,239,280,226
"181470207",321,348,669,185,220,185
"181470301",29,19,48,13,19,13
"181470302",28,11,39,19,41,18
"181470303",24,14,38,11,21,11
"181470304",39,24,63,18,26,18
"181470401",42,23,65,20,26,20
"181470402",29,13,42,13,22,13
"181470403",49,7,56,12,11,11
"181470501",15,11,26,11,10,10
"181470502",58,54,112,28,27,25
"181470503",8,4,12,7,6,6
"181470601",4,0,4,4,6,4
"181470602",28,15,43,11,23,11
"181470603",19,13,32,9,9,9
"181470604",8,5,13,3,2,2
"181470701",29,15,44,19,24,18
"181470702",6,3,9,5,8,5
"181470703",8,2,10,4,6,4
"181470801",338,331,669,168,217,168
"181470802",326,312,638,167,222,164
"181470803",42,21,63,17,22,17
"181470804",32,13,45,16,26,16
"181470901",16,12,28,9,11,8
"181470902",57,32,89,30,43,27
"181470903",53,42,95,26,37,26
"181471001",33,11,44,14,18,14
"181471002",17,9,26,12,17,12
"181471003",27,6,33,14,18,14
"181471004",7,1,8,4,6,4
"181471101",15,6,21,7,8,7
"181471102",27,11,38,8,8,8
"181471103",3,0,3,1,2,1
"181471201",215,222,437,104,137,104
"181471202",44,22,66,20,26,20
"181471203",22,16,38,9,11,9
"181471204",240,213,453,117,136,115
"181540101",916,875,1791,416,467,407
"181540102",700,769,1469,360,379,347
"181540103",475,539,1014,249,270,229
"181540201",122,120,242,54,66,54
"181540202",694,705,1399,310,339,304
"181540203",508,517,1025,220,242,217
"181540204",11,8,19,7,11,6
"181540301",50,0,50,2,2,2
"181540302",7,0,7,3,6,3
"181540401",140,134,274,63,69,63
"181540402",134,105,239,38,39,37
"181540501",10,3,13,3,3,2
"181540502",8,10,18,4,4,4
"181540601",47,37,84,32,32,31
"181540602",15,4,19,11,13,11
"181540603",38,22,60,18,24,18
"181540701",381,428,809,233,284,232
"181540702",239,240,479,126,158,126
"181540703",273,286,559,127,158,123
"181540704",464,466,930,252,287,232
"181540801",19,10,29,12,20,12
"181540802",35,8,43,13,19,13
"181540901",0,0,0,0,1,0
"181610101",381,428,809,199,225,195
"181610102",494,517,1011,226,256,225
"181610103",363,414,777,219,234,199
"181610104",380,422,802,234,273,228
"181610105",538,563,1101,287,310,283
"181610106",662,698,1360,363,377,340
"181610107",375,365,740,210,235,207
"181610108",334,389,723,170,185,153
"181610201",215,188,403,97,100,94
"181610202",260,226,486,116,131,116
"181610203",181,147,328,73,89,72
"181610204",130,141,271,60,68,59
"181610205",63,43,106,26,41,26
"181610206",228,212,440,107,108,104
"181610301",220,218,438,94,106,92
"181610302",4,2,6,2,3,2
"181610303",71,79,150,31,31,31
"181610304",8,10,18,2,9,2
"181610401",303,293,596,154,174,153
"181610402",180,153,333,80,86,78
"181610403",23,14,37,12,15,12
"181610404",138,114,252,61,58,53
"181610405",424,473,897,233,269,226
"181610501",60,49,109,31,40,28
"181610502",34,28,62,27,34,26
"181610503",71,44,115,32,37,32
"181610504",546,580,1126,298,344,291
"181610505",647,662,1309,314,387,308
"181610601",526,537,1063,289,332,288
"181610602",147,162,309,73,106,73
"181610603",189,164,353,90,113,89
"181610604",23,17,40,12,18,12
"181610605",270,248,518,131,159,130
"181610606",133,116,249,55,60,55
"181610607",452,577,1029,276,265,231
"181680101",101,92,193,57,57,56
"181680102",434,466,900,270,273,245
"181680103",391,448,839,272,304,261
"181680104",428,479,907,315,333,286
"181680105",316,344,660,228,276,220
"181680106",556,592,1148,291,307,281
"181680107",633,657,1290,308,314,294
"181680108",511,599,1110,317,314,286
"181680109",584,636,1220,346,315,286
"181680110",458,506,964,271,270,249
"181680201",183,185,368,91,104,91
"181680202",125,109,234,60,97,60
"181680301",67,43,110,30,52,30
"181680302",53,29,82,27,45,27
"181680303",33,13,46,15,25,15
"181680401",26,22,48,10,17,10
"181680402",27,9,36,15,24,15
"181680403",29,16,45,14,28,13
"181680501",100,74,174,66,42,36
"181680502",23,11,34,9,9,9
"181680601",17,11,28,7,11,7
"181680602",16,9,25,11,23,11
"181680603",144,81,225,77,134,71
"181680604",23,4,27,24,28,23
"181680701",588,566,1154,265,288,254
"181680702",893,893,1786,460,456,415
"181680703",822,805,1627,442,450,420
"181680704",457,450,907,254,303,251
"181680705",1348,1305,2653,595,611,561
"181680706",852,802,1654,389,380,352
"181680707",453,445,898,204,238,201
"181680708",1,0,1,1,3,1
"181680709",0,0,0,0,2,0
"181680710",14,12,26,9,14,9
"181680711",335,345,680,148,156,121
"181680712",816,844,1660,401,402,369
"181680713",552,528,1080,325,330,269
"181680714",332,327,659,204,196,180
"181680715",465,471,936,250,274,236
"181680716",465,492,957,264,270,249
"181680717",455,468,923,230,228,206
"181680718",793,746,1539,401,417,382
"181680719",643,698,1341,360,314,303
"181680720",603,609,1212,292,296,257
"181680721",439,460,899,242,272,237
"181680722",860,865,1725,440,462,422
"181680723",348,387,735,227,251,224
"181680724",380,401,781,225,251,217
"181680725",963,947,1910,440,465,422
"181680726",9,6,15,3,4,3
"181680727",554,539,1093,253,297,223
"181680801",90,82,172,54,61,54
"181680802",33,5,38,20,18,15
"181680803",3,1,4,2,6,2
"181680804",32,17,49,15,17,15
"181680901",16,4,20,7,9,7
"181680902",5,1,6,2,2,2
"181680903",18,0,18,8,14,8
"181680904",9,7,16,5,9,5
"181681001",5,1,6,2,5,2
"181681002",113,100,213,57,79,57
"181681003",47,39,86,27,33,27
"181681101",8,0,8,5,12,5
"181681102",7,4,11,5,17,5
"181681103",160,131,291,78,106,78
"181681201",196,179,375,110,106,88
"181681202",9,6,15,5,30,5
"181681203",24,26,50,16,15,14
"181681204",25,9,34,9,8,4
"181681301",26,11,37,10,12,10
"181681302",58,59,117,41,51,39
"181681303",321,286,607,161,192,142
"181681304",8,15,23,9,11,9
"181681305",177,83,260,73,106,70
"181681306",341,322,663,161,186,156
"181681307",1029,1119,2148,477,479,449
"181681401",380,401,781,201,228,201
"181681402",109,92,201,58,89,58
"181681403",33,31,64,22,35,22
"181681404",110,110,220,64,61,58
"181681501",139,102,241,53,62,53
"181681502",9,1,10,6,6,6
"181681601",352,307,659,181,216,176
"181681602",138,42,180,109,113,109
"181681603",65,20,85,32,26,16
"181681604",15,3,18,8,9,8
"181681701",666,670,1336,344,371,332
"181681702",318,437,755,311,331,267
"181681703",461,455,916,337,393,303
"181681704",423,420,843,253,264,219
"181681705",311,299,610,216,236,210
"181681706",213,309,522,259,332,255
"181681707",463,545,1008,335,360,300
"181681708",665,687,1352,384,416,368
"181681709",567,603,1170,299,329,275
"181681710",701,748,1449,342,371,332
"181681711",361,403,764,176,195,173
"181681712",637,710,1347,325,290,274
"181681713",421,465,886,279,292,269
"181681714",487,562,1049,256,276,254
"181750101",414,437,851,216,257,211
"181750102",337,380,717,195,229,190
"181750103",319,374,693,227,268,224
"181750104",531,563,1094,289,332,285
"181750105",599,657,1256,326,388,324
"181750106",469,520,989,294,341,288
"181750107",511,604,1115,341,400,340
"181750108",134,165,299,78,79,73
"181750201",32,12,44,12,13,12
"181750202",35,24,59,18,19,18
"181750203",22,18,40,13,19,13
"181750204",49,46,95,30,30,30
"181750301",31,21,52,15,15,10
"181750302",42,25,67,26,39,26
"181750303",71,56,127,25,31,24
"181750401",60,44,104,26,33,26
"181750402",87,84,171,41,52,40
"181750403",119,112,231,58,67,56
"181750501",172,166,338,99,128,98
"181750502",12,14,26,6,9,6
"181750503",64,19,83,18,19,18
"181750601",104,125,229,56,69,53
"181750602",69,95,164,40,54,40
"181750603",16,3,19,8,13,8
"181750604",8,4,12,9,12,9
"181750605",37,25,62,21,30,21
"181750701",15,7,22,3,4,3
"181750702",19,6,25,8,8,8
"181750801",19,8,27,9,22,9
"181750802",21,0,21,7,9,7
"300080101",196,204,400,133,181,127
"300080102",278,269,547,187,347,179
"300080103",270,286,556,184,263,171
"300080104",240,275,515,171,232,169
"300080105",276,293,569,170,176,160
"300080106",265,293,558,192,266,190
"300080107",153,165,318,116,214,115
"300080108",225,258,483,173,238,171
"300080109",272,338,610,209,263,205
"300080110",313,338,651,226,283,219
"300080111",420,449,869,294,349,289
"300080112",274,355,629,219,274,213
"300080113",279,284,563,188,213,181
"300080114",286,298,584,205,253,194
"300080201",196,228,424,150,221,145
"300080202",111,172,283,116,161,115
"300080203",206,260,466,138,217,135
"300080204",236,264,500,204,292,194
"300080205",231,309,540,206,260,205
"300080206",320,410,730,272,331,263
"300080207",500,498,998,334,366,288
"300080208",630,611,1241,329,347,316
"300080209",212,242,454,164,198,162
"300080210",244,276,520,177,224,171
"300080211",247,259,506,171,252,169
"300080212",96,114,210,74,105,72
"300080213",80,86,166,59,101,55
"300080214",145,157,302,106,231,106
"300080215",283,320,603,181,238,175
"300080216",299,331,630,177,223,155
"300080301",77,74,151,50,55,50
"300080302",130,107,237,77,84,76
"300080303",161,137,298,95,107,91
"300080304",144,150,294,90,114,87
"300080305",356,344,700,193,234,192
"300080306",524,547,1071,273,293,260
"300080307",298,292,590,181,231,174
"300080308",405,430,835,260,236,184
"300080309",108,141,249,79,82,74
"300080310",351,369,720,218,256,208
"300080311",413,435,848,239,305,236
"300080312",368,356,724,202,253,193
"300080313",392,374,766,185,216,182
"300080314",168,138,306,102,128,102
"300080315",198,157,355,118,188,113
"300080316",41,37,78,28,38,28
"300080317",108,80,188,60,74,60
"300080318",85,78,163,55,73,55
"300080319",89,66,155,54,78,53
"300080401",280,274,554,166,171,159
"300080402",601,602,1203,362,382,354
"300080403",476,486,962,326,345,318
"300080404",533,512,1045,326,351,302
"300080405",548,559,1107,338,406,325
"300080406",576,573,1149,382,421,372
"300080407",260,262,522,158,178,156
"300080408",358,358,716,247,280,242
"300080409",310,407,717,284,328,271
"300080410",511,488,999,331,385,325
"300080411",408,457,865,273,300,257
"300080412",663,663,1326,426,453,404
"300080413",242,260,502,176,190,167
"300080501",61,60,121,41,52,39
"300080502",123,92,215,69,84,65
"300080503",131,97,228,75,93,74
"300080504",275,262,537,156,158,139
"300080505",98,98,196,55,61,52
"300080506",657,639,1296,352,373,340
"300080507",607,614,1221,336,366,325
"300080508",653,645,1298,351,403,340
"300080509",296,277,573,175,235,171
"300080510",290,315,605,199,164,136
"300080511",112,109,221,70,215,69
"300080601",447,419,866,292,410,285
"300080602",568,555,1123,353,394,346
"300080603",293,290,583,186,213,183
"300080604",414,430,844,295,334,294
"300080605",518,557,1075,367,426,357
"300080606",410,431,841,334,386,322
"300080607",372,435,807,304,329,294
"300080608",530,547,1077,369,425,362
"300080609",235,249,484,182,203,176
"300080610",325,304,629,225,246,216
"300080611",436,492,928,340,367,326
"300080612",377,389,766,265,326,259
"300080701",14,7,21,7,10,7
"300080702",50,49,99,31,45,30
"300080703",164,141,305,97,148,82
"300080704",18,22,40,10,12,10
"300080705",97,90,187,58,71,57
"300080706",26,25,51,16,16,16
"300080707",50,49,99,36,46,36
"300080708",29,20,49,20,32,20
"300080709",35,31,66,23,30,23
"300080710",45,34,79,22,28,22
"300080711",117,126,243,67,117,65
"300080801",27,24,51,17,28,17
"300080802",24,17,41,12,17,12
"300080803",16,12,28,10,18,10
"300080804",59,58,117,36,44,36
"300080805",46,34,80,24,39,22
"300080806",26,19,45,16,24,16
"300080807",159,141,300,90,109,88
"300080808",92,68,160,47,51,47
"300080809",27,23,50,15,25,15
"300080810",69,64,133,45,55,45
"300080811",59,41,100,37,50,37
"300080901",34,43,77,23,31,22
"300080902",35,26,61,23,29,21
"300080903",38,23,61,20,33,20
"300080904",19,15,34,8,13,8
"300080905",48,46,94,30,44,29
"300080906",98,78,176,70,72,55
"300080907",21,18,39,14,17,14
"300080908",9,4,13,5,13,5
"300080909",58,42,100,31,42,30
"300080910",319,351,670,224,369,222
"300081001",49,33,82,27,31,27
"300081002",37,24,61,23,31,23
"300081003",239,250,489,171,207,171
"300081004",27,26,53,17,19,17
"300081005",70,54,124,35,39,34
"300081006",25,18,43,16,23,16
"300081007",224,212,436,134,159,133
"300081008",37,19,56,22,42,22
"300081009",17,7,24,10,17,10
"300081101",56,38,94,34,41,34
"300081102",47,42,89,23,25,23
"300081103",65,34,99,27,37,24
"300081104",40,18,58,16,25,15
"300081105",62,59,121,39,54,39
"300081106",10,4,14,4,8,4
"300081107",33,26,59,23,26,22
"300081108",404,376,780,224,216,198
"300081109",187,157,344,112,112,109
"300081110",835,724,1559,417,386,322
"300081111",274,277,551,134,146,132
"300081201",1,0,1,1,1,1
"300150101",777,719,1496,388,401,378
"300150102",697,744,1441,349,329,321
"300150103",1184,1181,2365,509,474,466
"300150104",997,1015,2012,458,413,400
"300150105",692,706,1398,329,304,292
"300150106",888,861,1749,407,394,368
"300150107",739,715,1454,346,330,322
"300150108",563,590,1153,286,269,263
"300150109",504,568,1072,292,288,278
"300150110",410,440,850,197,172,167
"300150111",991,984,1975,485,469,451
"300150112",735,728,1463,346,345,337
"300150113",847,794,1641,425,431,410
"300150201",760,823,1583,411,427,385
"300150202",482,511,993,271,275,258
"300150203",560,543,1103,274,273,263
"300150204",741,708,1449,337,305,291
"300150205",927,975,1902,477,457,439
"300150206",566,586,1152,337,346,313
"300150207",303,316,619,195,187,176
"300150208",571,603,1174,349,359,332
"300150209",693,725,1418,416,404,374
"300150210",845,834,1679,422,421,380
"300150211",584,652,1236,334,324,292
"300150212",720,726,1446,401,401,368
"300150213",645,731,1376,406,428,385
"300150214",342,368,710,236,269,213
"300150301",437,481,918,281,295,278
"300150302",510,556,1066,354,365,344
"300150303",633,732,1365,424,431,392
"300150304",524,584,1108,349,383,341
"300150305",760,776,1536,380,390,359
"300150306",87,85,172,52,59,49
"300150307",151,164,315,106,119,104
"300150308",670,680,1350,388,429,378
"300150309",690,638,1328,332,323,288
"300150310",406,407,813,228,220,206
"300150401",478,466,944,287,277,253
"300150402",232,297,529,189,198,175
"300150403",461,553,1014,334,365,321
"300150404",455,521,976,309,325,297
"300150405",580,594,1174,322,331,299
"300150406",575,659,1234,386,400,359
"300150407",536,575,1111,328,343,311
"300150408",565,599,1164,312,339,305
"300150409",429,460,889,240,249,232
"300150410",571,592,1163,318,242,213
"300150411",880,890,1770,441,425,387
"300150412",780,833,1613,412,393,375
"300150413",672,723,1395,422,437,407
"300150414",302,356,658,263,308,259
"300150415",170,195,365,119,132,113
"300150416",574,612,1186,441,484,402
"300150501",214,266,480,185,222,183
"300150502",460,615,1075,393,424,378
"300150503",288,348,636,215,233,206
"300150504",274,343,617,206,209,190
"300150505",376,359,735,185,192,181
"300150506",409,461,870,267,275,251
"300150507",479,486,965,256,269,247
"300150508",464,459,923,249,244,231
"300150509",483,485,968,276,281,263
"300150510",269,331,600,188,201,178
"300150511",268,308,576,188,174,156
"300150512",187,243,430,159,174,153
"300150513",199,244,443,166,178,156
"300150514",152,218,370,146,216,144
"300150515",235,313,548,221,254,188
"300150516",216,255,471,185,272,178
"300150517",227,290,517,208,293,207
"300150518",192,223,415,149,178,144
"300150519",216,272,488,197,235,189
"300150520",345,376,721,223,238,207
"300150521",173,182,355,113,120,104
"300150522",690,726,1416,384,370,356
"300150601",756,728,1484,352,348,327
"300150602",387,413,800,206,212,199
"300150603",922,1004,1926,474,428,410
"300150604",692,787,1479,418,412,382
"300150605",218,226,444,150,177,131
"300150606",413,463,876,264,270,241
"300150607",448,539,987,340,366,303
"300150608",294,355,649,245,283,242
"300150609",294,379,673,254,311,244
"300150610",270,320,590,230,296,222
"300150611",175,253,428,171,245,165
"300150612",248,294,542,196,237,192
"300150613",539,596,1135,357,348,312
"300150614",626,755,1381,449,449,417
"300150615",313,375,688,228,240,222
"300150616",440,517,957,301,306,267
"300150617",368,457,825,268,298,252
"300150618",150,190,340,124,157,116
"300150619",241,328,569,213,243,201
"300150620",127,162,289,112,155,110
"300150621",116,159,275,136,208,133
"300150701",486,480,966,269,253,240
"300150702",227,274,501,169,178,157
"300150703",227,266,493,195,224,187
"300150704",173,206,379,154,211,151
"300150705",148,201,349,146,218,144
"300150706",102,155,257,118,150,118
"300150707",185,231,416,168,213,162
"300150708",201,268,469,174,192,153
"300150709",294,330,624,179,187,164
"300150710",525,488,1013,256,237,227
"300150711",358,417,775,229,225,208
"300150712",563,539,1102,247,238,224
"300150713",430,330,760,197,217,185
"300150714",224,294,518,182,191,167
"300150715",310,349,659,183,180,168
"300150716",549,605,1154,284,270,260
"300150717",51,40,91,17,22,15
"300150718",857,812,1669,421,431,395
"300150719",757,820,1577,387,394,368
"300150720",294,267,561,131,144,127
"300150801",173,212,385,161,221,158
"300150802",166,203,369,142,216,138
"300150803",143,202,345,132,182,132
"300150804",151,216,367,149,206,140
"300150805",250,272,522,181,211,175
"300150806",320,334,654,200,200,188
"300150807",461,573,1034,359,378,325
"300150808",256,328,584,217,263,207
"300150809",232,273,505,177,226,173
"300150810",288,346,634,220,262,210
"300150811",287,372,659,221,252,214
"300150812",263,302,565,198,240,195
"300150813",26,17,43,5,6,5
"300150814",581,601,1182,355,393,340
"300150815",145,167,312,93,95,88
"300150901",150,152,302,80,101,79
"300150902",191,180,371,91,131,90
"300150903",47,39,86,23,30,23
"300150904",473,477,950,262,284,248
"300150905",587,623,1210,316,332,307
"300150906",637,604,1241,318,296,277
"300150907",594,635,1229,298,347,296
"300150908",620,619,1239,303,314,301
"300150909",228,218,446,142,166,141
"300150910",205,208,413,124,138,119
"300150911",23,24,47,14,51,14
"300151001",361,342,703,187,200,178
"300151002",709,799,1508,410,438,400
"300151003",349,347,696,183,196,179
"300151004",859,826,1685,472,455,423
"300151005",730,729,1459,394,394,368
"300151006",660,664,1324,303,306,278
"300151007",537,569,1106,307,326,303
"300151008",688,670,1358,335,342,310
"300151009",855,872,1727,416,444,404
"300151010",486,511,997,297,312,291
"300151011",817,812,1629,398,417,392
"300151012",1030,1040,2070,441,442,407
"300151013",633,592,1225,295,300,290
"300151101",443,411,854,238,350,230
"300151102",45,17,62,11,13,11
"300151103",348,346,694,224,261,215
"300151104",314,337,651,181,198,177
"300151105",663,646,1309,349,364,323
"300151106",311,346,657,205,220,195
"300151107",415,435,850,203,236,200
"300151108",495,506,1001,234,255,232
"300151109",89,82,171,54,66,53
"300151110",375,356,731,237,294,234
"300151111",450,317,767,177,197,165
"300151201",125,83,208,59,51,40
"300151202",56,51,107,33,48,29
"300151203",55,65,120,42,38,31
"300151204",88,90,178,42,45,41
"300151205",15,15,30,12,12,12
"300151206",44,48,92,29,34,29
"300151207",29,16,45,16,24,16
"300151208",133,128,261,65,70,64
"300151209",48,31,79,23,22,22
"300151210",71,57,128,48,62,48
"300151211",123,103,226,58,68,57
"300151212",519,522,1041,275,304,263
"300151213",531,495,1026,300,356,296
"300151214",495,518,1013,296,360,287
"300151301",874,172,1046,110,178,107
"300151302",126,22,148,20,27,20
"300151303",20,21,41,17,23,17
"300151304",594,576,1170,306,319,295
"300151305",288,266,554,140,155,134
"300151306",432,76,508,44,54,42
"300151307",81,74,155,50,59,48
"300151308",68,66,134,34,43,34
"300151309",24,18,42,15,19,14
"300151310",580,389,969,224,241,214
"300151311",439,436,875,255,290,242
"300151312",329,339,668,193,202,177
"300151401",19,14,33,11,11,10
"300151402",214,13,227,9,14,9
"300151403",105,69,174,58,58,58
"300151404",123,114,237,59,57,56
"300151405",45,32,77,22,31,22
"300151406",59,35,94,30,35,30
"300151407",57,39,96,32,39,32
"300151408",165,151,316,82,103,76
"300151501",95,94,189,57,73,57
"300151502",158,79,237,54,61,54
"300151503",14,11,25,6,9,6
"300151504",109,107,216,60,68,60
"300151505",98,79,177,57,59,57
"300151506",137,99,236,68,87,67
"300151507",103,86,189,56,76,51
"300151508",89,65,154,43,65,42
"300151509",40,39,79,34,69,34
"300151510",299,279,578,161,111,89
"300151511",432,447,879,236,245,226
"300151512",136,109,245,78,127,78
"300151513",154,149,303,87,145,85
"300151514",184,191,375,102,120,99
"300151515",187,164,351,99,158,96
"300151601",19,13,32,11,32,11
"300151602",109,83,192,51,68,51
"300151603",53,41,94,24,28,24
"300151604",22,16,38,14,16,14
"300151605",48,27,75,25,26,24
"300151606",238,215,453,131,192,129
"300151607",267,249,516,134,145,127
"300210101",367,450,817,261,284,254
"300210102",449,498,947,291,315,279
"300210103",64,68,132,44,76,40
"300210104",425,514,939,313,361,304
"300210105",263,333,596,217,229,195
"300210106",312,386,698,272,288,251
"300210107",450,475,925,283,305,275
"300210108",678,683,1361,351,372,342
"300210109",239,287,526,180,206,178
"300210110",178,223,401,150,169,149
"300210111",213,293,506,172,212,170
"300210112",326,362,688,206,231,199
"300210201",369,374,743,207,240,203
"300210202",178,207,385,146,167,130
"300210203",389,439,828,261,283,251
"300210204",41,38,79,28,35,28
"300210205",241,265,506,127,129,120
"300210206",155,171,326,93,99,89
"300210207",327,367,694,184,193,176
"300210208",260,263,523,168,193,167
"300210209",208,253,461,134,149,131
"300210210",384,479,863,297,347,291
"300210211",402,415,817,248,266,241
"300210212",626,639,1265,358,391,348
"300210301",224,102,326,59,37,35
"300210302",199,174,373,115,134,113
"300210303",215,242,457,170,185,163
"300210304",209,229,438,144,167,141
"300210305",252,254,506,140,167,137
"300210306",50,55,105,39,63,38
"300210307",72,95,167,55,72,53
"300210308",168,174,342,93,111,90
"300210309",277,341,618,160,162,149
"300210310",165,135,300,89,100,87
"300210311",96,74,170,58,70,58
"300210312",54,48,102,41,54,41
"300210401",276,223,499,144,305,144
"300210402",20,24,44,15,20,15
"300210403",151,131,282,79,97,76
"300210404",77,79,156,51,74,50
"300210405",260,260,520,163,193,161
"300210406",186,189,375,113,129,112
"300210407",15,10,25,9,34,9
"300210408",28,31,59,21,157,20
"300210409",95,91,186,59,64,58
"300210410",182,173,355,105,111,96
"300210501",98,99,197,70,218,70
"300210502",121,120,241,74,108,74
"300210503",57,59,116,31,61,31
"300210504",112,85,197,61,70,58
"300210505",374,360,734,266,332,266
"300210506",376,369,745,251,281,237
"300210507",337,333,670,204,237,199
"300210508",50,31,81,27,36,27
"300210509",11,8,19,6,25,6
"300210510",65,59,124,43,52,43
"300210511",87,75,162,46,49,44
"300210512",248,271,519,166,196,162
"300210601",97,77,174,60,69,60
"300210602",109,83,192,57,78,57
"300210603",71,63,134,41,55,39
"300210604",246,268,514,161,204,161
"300210605",61,68,129,40,49,38
"300210606",39,35,74,21,27,21
"300210701",18,22,40,10,11,10
"300210702",30,21,51,17,21,15
"300210703",3,1,4,2,3,2
"300210704",54,54,108,33,35,33
"300210705",15,15,30,16,25,16
"300210706",210,246,456,173,232,169
"300210707",210,213,423,143,174,138
"300210708",328,353,681,218,222,199
"300210709",300,376,676,262,279,238
"300210710",274,402,676,268,318,266
"300210711",263,368,631,24,36,24
"300210712",255,283,538,199,208,186
"300210713",166,200,366,132,153,129
"300210714",251,350,601,248,313,245
"300210715",334,339,673,262,265,228
"300210716",287,304,591,214,228,199
"300210801",23,22,45,14,16,14
"300210802",46,45,91,30,34,29
"300210803",48,47,95,28,37,28
"300210804",187,165,352,110,128,107
"300210805",42,31,73,20,28,17
"300210806",44,43,87,27,35,27
"300210807",63,31,94,34,59,34
"300210808",29,29,58,14,22,14
"300210809",70,63,133,32,36,32
"300210901",138,120,258,71,80,68
"300210902",147,153,300,103,111,99
"300210903",302,318,620,228,251,225
"300210904",179,198,377,141,164,137
"300210905",576,619,1195,402,432,394
"300210906",174,168,342,98,100,95
"300210907",333,354,687,237,242,227
"300210908",236,271,507,188,212,187
"300210909",263,311,574,205,232,199
"300210910",276,287,563,188,207,180
"300210911",347,365,712,216,242,207
"300211001",52,44,96,29,36,28
"300211002",237,268,505,153,178,152
"300211003",122,134,256,82,92,80
"300211004",263,294,557,190,207,181
"300211005",188,192,380,112,118,106
"300211006",330,302,632,194,216,192
"300211007",303,358,661,233,267,229
"300211101",69,65,134,38,48,36
"300211102",46,57,103,34,43,32
"300211103",49,34,83,28,29,25
"300211104",31,33,64,19,30,19
"300211105",22,25,47,16,26,16
"300211201",8,8,16,5,7,5
"300211202",5,9,14,4,5,4
"300211203",50,43,93,23,28,23
"300211204",72,58,130,42,54,42
"300211205",27,27,54,21,31,21
"300211206",52,48,100,31,44,31
"300211207",42,35,77,23,33,19
"300211208",73,77,150,39,55,32
"300211209",58,55,113,32,36,23
"300211210",312,331,643,196,263,195
"300211211",24,21,45,13,14,12
"300211212",69,74,143,38,52,38
"300211301",48,27,75,32,47,32
"300211302",21,8,29,12,19,12
"300280101",287,468,755,86,122,80
"300280102",620,672,1292,323,361,316
"300280103",310,329,639,219,257,204
"300280104",220,249,469,179,229,169
"300280105",624,672,1296,366,348,303
"300280106",717,628,1345,305,306,282
"300280107",419,456,875,256,274,235
"300280108",299,331,630,208,226,195
"300280109",266,350,616,170,191,159
"300280110",623,638,1261,325,351,306
"300280111",225,243,468,156,187,149
"300280112",318,325,643,197,239,188
"300280113",254,234,488,121,123,113
"300280114",96,75,171,49,57,48
"300280201",142,152,294,57,78,54
"300280202",87,98,185,42,46,40
"300280203",590,559,1149,250,255,237
"300280204",776,760,1536,366,334,333
"300280205",708,710,1418,334,313,293
"300280206",594,534,1128,274,309,258
"300280301",76,49,125,44,54,43
"300280302",12,6,18,7,11,7
"300280303",150,134,284,79,100,77
"300280304",10,10,20,7,10,7
"300280305",44,29,73,22,42,22
"300280306",89,80,169,53,63,51
"300280307",9,3,12,3,5,3
"300280308",176,12,188,12,40,12
"300280401",265,279,544,148,157,147
"300280402",464,413,877,257,255,233
"300280403",625,604,1229,336,341,322
"300280404",431,389,820,224,238,220
"300280405",394,386,780,209,217,202
"300280406",466,485,951,279,299,273
"300280407",413,353,766,200,198,186
"300280408",416,434,850,252,273,250
"300280409",271,298,569,160,168,150
"300280410",439,462,901,271,283,255
"300280411",336,319,655,215,231,210
"300280412",326,370,696,233,259,227
"300280413",278,296,574,199,220,197
"300280414",321,340,661,195,215,188
"300280415",327,347,674,207,199,181
"300280416",410,488,898,283,319,275
"300280417",354,383,737,233,233,211
"300280418",449,470,919,265,287,253
"300280419",546,542,1088,281,271,255
"300280501",498,520,1018,245,243,230
"300280502",485,516,1001,286,292,267
"300280503",506,504,1010,277,278,261
"300280504",446,432,878,219,220,196
"300280505",668,631,1299,331,320,302
"300280506",204,233,437,132,144,126
"300280507",413,501,914,267,279,256
"300280508",223,256,479,178,202,177
"300280509",247,316,563,235,256,221
"300280510",177,249,426,172,219,166
"300280511",299,335,634,222,259,213
"300280512",490,509,999,323,353,313
"300280513",244,244,488,156,193,155
"300280514",446,465,911,293,307,282
"300280515",264,316,580,207,240,200
"300280516",171,205,376,142,170,140
"300280517",456,499,955,316,339,308
"300280518",484,535,1019,293,338,284
"300280519",439,414,853,251,286,241
"300280601",154,142,296,83,89,78
"300280602",128,97,225,64,75,64
"300280603",366,347,713,184,255,175
"300280604",88,74,162,42,43,42
"300280605",187,155,342,98,106,97
"300280606",224,238,462,109,119,107
"300280607",218,198,416,118,151,118
"300280608",430,367,797,207,234,194
"300280609",389,335,724,207,337,201
"300280610",58,38,96,25,30,25
"300280611",114,114,228,59,65,59
"300280701",5,0,5,2,2,2
"300280702",9,6,15,3,4,3
"300280703",17,12,29,13,18,13
"300280704",48,47,95,32,34,30
"300280705",5,6,11,3,3,3
"300280706",22,15,37,12,15,12
"300280707",13,9,22,8,10,8
"300280708",226,236,462,101,99,85
"300280709",432,488,920,260,311,258
"300280710",582,628,1210,342,364,332
"300280711",332,399,731,220,250,216
"300280712",401,419,820,200,231,197
"300280801",83,83,166,40,69,40
"300280802",65,54,119,37,36,34
"300280803",125,101,226,60,69,60
"300280804",8,4,12,3,5,3
"300280805",142,99,241,79,87,74
"300280806",86,76,162,50,51,50
"300280807",47,37,84,24,26,24
"300280808",126,117,243,67,75,66
"300280809",636,586,1222,307,303,291
"300280810",297,304,601,186,194,180
"300280811",247,225,472,150,154,143
"300280812",223,202,425,123,127,115
"300280901",114,100,214,60,66,56
"300280902",32,36,68,16,16,16
"300280903",141,93,234,67,107,66
"300280904",107,79,186,54,62,53
"300280905",64,53,117,31,38,31
"300280906",64,41,105,31,173,31
"300280907",454,417,871,237,250,224
"300281001",22,16,38,9,10,9
"300281002",43,16,59,23,30,23
"300281003",11,2,13,7,12,7
"300281004",11,5,16,6,6,6
"300281005",57,41,98,35,37,35
"300281006",24,12,36,6,7,6
"300281007",16,9,25,9,12,9
"300281008",182,153,335,86,87,84
"300281101",40,34,74,19,21,16
"300281102",6,2,8,2,3,2
"300281103",54,31,85,32,36,32
"300281104",78,68,146,37,37,31
"300281105",21,12,33,12,12,12
"300281106",20,7,27,11,14,10
"300281107",313,351,664,180,194,173
"300281108",258,255,513,143,172,143
"300281201",113,90,203,49,51,49
"300281202",3,2,5,2,3,2
"300281203",54,54,108,30,39,29
"300281204",108,87,195,62,70,62
"300281205",56,42,98,29,29,28
"300281206",74,59,133,37,44,36
"300281207",130,102,232,59,60,59
"300281208",411,360,771,214,232,201
"300281209",33,31,64,15,18,14
"300281210",167,143,310,91,99,87
"300281211",106,106,212,52,64,51
"300281212",118,99,217,62,75,62
"300281213",59,39,98,36,47,36
"300281214",74,66,140,46,59,46
"300281215",229,166,395,118,150,115
"300281301",28,13,41,16,26,16
"300281302",24,14,38,12,14,12
"300281303",124,134,258,62,72,59
"300281304",43,45,88,27,26,26
"300281305",19,13,32,8,8,8
"300281306",61,43,104,31,25,25
"300281307",112,92,204,57,66,56
"300281308",17,15,32,10,15,10
"300281309",212,174,386,108,116,105
"300281310",22,18,40,12,13,12
"300350101",414,430,844,203,230,195
"300350102",381,411,792,213,241,205
"300350103",248,281,529,162,184,153
"300350104",732,731,1463,389,412,375
"300350105",550,554,1104,297,336,292
"300350106",480,505,985,244,272,241
"300350107",398,439,837,272,306,263
"300350108",286,328,614,191,225,189
"300350109",215,220,435,134,155,133
"300350110",376,454,830,219,242,213
"300350111",243,251,494,140,159,138
"300350112",487,545,1032,294,324,287
"300350113",341,383,724,275,327,273
"300350114",333,329,662,189,213,185
"300350115",356,426,782,216,218,193
"300350116",553,572,1125,318,363,307
"300350117",474,522,996,309,367,307
"300350118",421,442,863,236,266,233
"300350119",484,480,964,225,242,217
"300350201",68,61,129,29,31,29
"300350202",80,83,163,44,54,43
"300350203",94,98,192,56,65,55
"300350204",344,346,690,174,204,167
"300350205",74,80,154,36,38,35
"300350206",166,164,330,80,85,72
"300350301",9,11,20,4,6,4
"300350302",99,84,183,5,11,5
"300350303",15,14,29,9,14,9
"300350304",24,17,41,12,21,12
"300350305",5,4,9,5,17,5
"300350401",48,26,74,25,37,25
"300350402",15,4,19,8,10,8
"300350403",66,70,136,36,42,36
"300350404",3,2,5,4,4,4
"300350405",44,30,74,21,26,21
"300350406",33,18,51,15,22,15
"300350407",36,44,80,26,37,26
"300350408",62,37,99,34,57,34
"300350409",65,50,115,45,56,45
"300350410",15,9,24,8,12,8
"300350411",22,23,45,12,12,12
"300350412",8,8,16,6,21,6
"300350413",3,0,3,3,5,3
"300350414",200,179,379,97,117,97
"300350501",46,24,70,26,28,26
"300350502",33,29,62,16,20,16
"300350503",7,4,11,4,8,4
"300350504",53,39,92,33,44,33
"300350505",21,15,36,13,28,13
"300350506",29,21,50,14,34,14
"300350507",106,105,211,66,76,65
"300350601",8,4,12,5,7,5
"300350602",14,8,22,7,10,7
"300350603",33,37,70,20,23,19
"300350604",14,16,30,9,11,9
"300350605",40,22,62,25,31,24
"300350606",32,16,48,17,24,16
"300350701",103,96,199,53,64,53
"300350702",62,33,95,30,47,30
"300350703",42,16,58,19,27,19
"300350704",36,24,60,22,32,21
"300350705",31,21,52,24,31,24
"300350706",69,44,113,37,57,37
"300350801",48,19,67,26,29,24
"300350802",73,76,149,39,29,29
"300350803",43,35,78,28,34,28
"300350804",91,69,160,41,48,41
"300350805",51,42,93,27,35,27
"300350901",43,24,67,24,35,24
"300350902",53,37,90,34,40,34
"300350903",14,12,26,10,23,10
"300350904",12,3,15,5,6,5
"300350905",43,40,83,29,37,29
"300350906",23,13,36,10,15,9
"300350907",18,14,32,8,12,8
"300351001",1,3,4,1,3,1
"300351002",6,7,13,4,7,4
"300351003",47,38,85,28,36,28
"300351004",19,21,40,13,18,13
"300351005",152,162,314,86,103,85
"300351006",166,160,326,92,105,89
"300351007",348,351,699,200,243,193
"300351101",25,14,39,18,18,18
"300351102",50,64,114,37,63,36
"300351103",593,577,1170,352,401,349
"300351104",267,318,585,195,233,192
"300351105",331,350,681,207,228,202
"300351106",199,210,409,134,148,134
"300420101",425,438,863,224,245,220
"300420102",520,549,1069,251,282,250
"300420103",397,428,825,214,226,205
"300420104",451,493,944,284,306,271
"300420105",338,349,687,198,212,195
"300420106",463,510,973,270,300,257
"300420107",414,449,863,251,301,248
"300420108",376,409,785,184,205,182
"300420109",267,254,521,131,153,129
"300420110",410,428,838,222,230,210
"300420111",485,493,978,236,269,233
"300420112",364,396,760,184,207,180
"300420201",113,101,214,57,60,54
"300420202",122,122,244,68,82,67
"300420203",82,88,170,44,54,44
"300420204",311,243,554,134,158,133
"300420205",216,211,427,99,85,80
"300420206",181,188,369,92,89,72
"300420301",52,53,105,25,26,24
"300420302",136,121,257,63,83,63
"300420303",153,127,280,72,93,71
"300420304",25,2,27,7,15,7
"300420305",86,67,153,49,52,38
"300420401",30,24,54,15,19,15
"300420402",43,35,78,25,35,25
"300420403",26,24,50,13,14,13
"300420404",91,77,168,49,65,47
"300420405",11,6,17,8,25,8
"300420406",43,36,79,25,33,25
"300420501",23,27,50,17,22,17
"300420502",33,24,57,12,13,12
"300420503",226,220,446,107,135,102
"300420504",85,82,167,41,49,41
"300420601",10,9,19,5,11,5
"300420602",50,41,91,28,33,25
"300420603",59,68,127,33,43,33
"300420604",69,77,146,34,28,18
"300420605",43,21,64,16,18,16
"300420701",31,17,48,20,22,20
"300420702",27,21,48,15,12,12
"300420703",66,72,138,42,56,41
"300420704",173,153,326,85,103,83
"300490101",146,164,310,91,110,89
"300490102",729,770,1499,428,395,358
"300490103",409,400,809,252,306,246
"300490104",246,272,518,155,163,146
"300490105",418,485,903,313,331,288
"300490106",434,505,939,328,377,317
"300490107",453,510,963,301,341,294
"300490108",407,489,896,305,339,293
"300490109",176,217,393,149,177,147
"300490110",243,280,523,188,251,183
"300490111",379,406,785,267,284,251
"300490112",296,345,641,200,222,196
"300490113",215,243,458,155,178,154
"300490114",184,229,413,145,156,143
"300490201",357,384,741,242,264,236
"300490202",581,643,1224,363,388,338
"300490203",382,375,757,210,227,204
"300490204",245,267,512,180,190,166
"300490205",278,328,606,199,230,195
"300490206",325,321,646,194,196,178
"300490207",180,248,428,150,167,136
"300490208",224,275,499,196,230,187
"300490209",324,353,677,227,247,219
"300490210",607,599,1206,340,346,320
"300490211",339,412,751,263,324,257
"300490212",143,181,324,130,173,129
"300490213",276,327,603,230,264,228
"300490214",184,261,445,167,201,162
"300490215",251,182,433,131,155,127
"300490216",224,224,448,123,113,104
"300490217",143,131,274,84,88,82
"300490218",382,437,819,269,298,263
"300490219",294,350,644,269,327,253
"300490220",420,494,914,301,312,275
"300490221",482,473,955,237,218,204
"300490222",432,403,835,222,180,163
"300490301",529,597,1126,389,434,377
"300490302",223,287,510,195,230,190
"300490303",165,186,351,141,191,133
"300490304",215,265,480,181,209,178
"300490305",281,351,632,234,277,229
"300490306",446,529,975,296,335,280
"300490307",443,493,936,258,293,253
"300490308",602,632,1234,349,352,326
"300490309",675,732,1407,386,383,356
"300490310",792,787,1579,385,409,375
"300490311",281,296,577,153,151,134
"300490312",543,536,1079,259,265,242
"300490401",227,219,446,136,212,130
"300490402",172,146,318,100,138,99
"300490403",180,164,344,90,115,86
"300490404",35,33,68,17,21,17
"300490405",40,29,69,21,22,17
"300490406",12,7,19,7,53,7
"300490407",158,171,329,107,147,104
"300490408",68,53,121,42,75,39
"300490409",225,220,445,135,152,126
"300490410",4,2,6,4,10,4
"300490411",293,273,566,166,244,162
"300490412",651,675,1326,357,406,349
"300490413",595,638,1233,320,354,312
"300490414",407,417,824,231,248,221
"300490415",432,430,862,210,221,192
"300490416",5,4,9,3,7,3
"300490417",177,170,347,89,93,82
"300490501",37,43,80,23,24,23
"300490502",31,30,61,15,18,14
"300490503",76,64,140,37,44,36
"300490504",19,19,38,15,20,15
"300490505",27,34,61,22,29,22
"300490506",37,32,69,19,27,19
"300490507",34,35,69,27,38,27
"300490508",58,50,108,34,47,34
"300490509",51,48,99,35,54,35
"300490510",62,73,135,37,49,37
"300490511",220,195,415,118,147,113
"300490512",90,90,180,49,64,48
"300490513",24,23,47,16,22,16
"300490601",42,35,77,27,40,27
"300490602",42,26,68,26,39,21
"300490603",45,26,71,24,34,21
"300490604",27,12,39,16,36,15
"300490605",53,40,93,31,52,31
"300490606",35,25,60,22,34,22
"300490607",15,6,21,10,18,10
"300490608",5,10,15,3,9,3
"300490609",61,47,108,37,54,37
"300490610",27,18,45,15,18,12
"300490611",198,166,364,114,147,112
"300490701",30,23,53,17,37,17
"300490702",100,94,194,56,54,41
"300490703",30,26,56,19,32,19
"300490704",13,6,19,7,17,7
"300490705",12,15,27,11,22,11
"300490706",71,48,119,39,69,39
"300490707",27,28,55,20,37,19
"300490708",47,44,91,32,63,32
"300490709",20,22,42,14,29,14
"300490710",16,16,32,11,14,11
"300490711",31,19,50,15,18,15
"300490712",16,10,26,12,22,12
"300490801",8,2,10,6,6,6
"300490802",44,48,92,28,37,26
"300490803",42,23,65,24,30,24
"300490804",47,34,81,27,27,27
"300490805",44,25,69,28,39,28
"300490806",87,61,148,46,59,43
"300490807",16,7,23,10,17,10
"300490901",55,25,80,31,18,13
"300490902",118,63,181,77,121,37
"300491001",1,1,2,1,5,1
"300491002",18,18,36,10,15,10
"300491003",35,35,70,20,36,20
"300491004",26,23,49,18,26,18
"300491005",137,136,273,79,95,77
"300491006",231,264,495,199,225,194
"300491007",473,461,934,305,350,297
"300491008",262,289,551,184,224,182
"300491009",195,216,411,140,163,140
"300491010",493,506,999,322,382,321
"300491011",564,514,1078,308,351,297
"300560101",532,495,1027,299,309,291
"300560102",501,510,1011,249,248,247
"300560103",684,661,1345,364,370,345
"300560104",471,447,918,309,331,305
"300560105",575,611,1186,373,385,349
"300560106",579,627,1206,365,386,351
"300560107",617,673,1290,379,418,366
"300560108",513,547,1060,342,381,317
"300560109",374,379,753,243,241,216
"300560110",561,599,1160,382,394,361
"300560111",489,508,997,344,368,330
"300560112",179,213,392,155,181,149
"300560113",178,278,456,185,230,183
"300560114",278,324,602,228,243,222
"300560115",551,622,1173,400,429,380
"300560116",492,568,1060,340,340,308
"300560117",389,454,843,290,317,273
"300560118",145,159,304,114,159,113
"300560119",242,291,533,194,210,190
"300560120",250,311,561,227,294,222
"300560121",190,239,429,170,222,166
"300560122",269,349,618,227,285,225
"300560201",422,459,881,274,295,271
"300560202",392,402,794,226,263,224
"300560203",723,760,1483,376,383,340
"300560204",264,275,539,153,164,148
"300560205",799,743,1542,382,409,367
"300560206",683,739,1422,381,390,351
"300560207",349,360,709,235,260,223
"300560208",314,352,666,201,221,195
"300560209",297,356,653,203,243,199
"300560210",267,290,557,197,233,185
"300560211",168,227,395,142,170,141
"300560212",244,274,518,201,233,197
"300560213",253,313,566,214,237,206
"300560214",329,357,686,234,261,228
"300560215",298,336,634,227,263,220
"300560216",472,506,978,292,303,269
"300560217",339,410,749,231,266,213
"300560218",221,278,499,187,231,186
"300560219",200,244,444,169,217,163
"300560220",297,354,651,267,330,258
"300560221",248,279,527,177,236,175
"300560301",73,91,164,76,117,75
"300560302",106,137,243,119,153,105
"300560303",456,474,930,255,330,249
"300560304",173,221,394,181,239,173
"300560305",147,195,342,128,163,127
"300560306",204,254,458,179,219,178
"300560307",247,308,555,214,283,203
"300560308",364,442,806,279,341,241
"300560309",198,254,452,175,210,168
"300560310",245,331,576,243,289,233
"300560311",215,261,476,185,213,184
"300560312",339,352,691,221,246,206
"300560313",586,604,1190,343,361,309
"300560314",425,437,862,272,288,255
"300560315",186,189,375,118,138,110
"300560316",304,326,630,210,243,197
"300560317",515,543,1058,332,367,323
"300560318",594,578,1172,330,339,312
"300560319",234,231,465,125,128,118
"300560401",298,316,614,214,231,209
"300560402",241,301,542,192,213,186
"300560403",177,200,377,142,157,130
"300560404",178,211,389,160,211,150
"300560405",388,491,879,318,350,289
"300560406",292,344,636,241,252,215
"300560407",398,443,841,272,302,251
"300560408",556,585,1141,333,362,312
"300560409",497,541,1038,336,362,323
"300560410",585,596,1181,359,378,350
"300560411",450,525,975,287,293,279
"300560412",587,525,1112,272,275,259
"300560413",462,490,952,245,278,240
"300560414",780,784,1564,386,376,346
"300560415",574,581,1155,306,311,284
"300560416",342,361,703,203,222,199
"300560417",468,513,981,283,332,282
"300560418",476,505,981,257,277,245
"300560501",212,234,446,141,159,137
"300560502",245,271,516,151,163,149
"300560503",246,262,508,145,156,143
"300560504",449,526,975,317,340,313
"300560505",388,385,773,195,213,190
"300560506",226,274,500,158,182,153
"300560507",367,406,773,230,248,230
"300560508",401,434,835,228,249,221
"300560509",331,359,690,198,195,179
"300560510",429,437,866,249,271,241
"300560511",450,456,906,299,317,290
"300560512",294,296,590,186,204,178
"300560513",463,495,958,305,336,300
"300560601",121,90,211,62,90,60
"300560602",216,190,406,120,151,120
"300560603",51,30,81,23,27,23
"300560604",78,81,159,46,63,45
"300560605",801,786,1587,371,367,352
"300560606",531,530,1061,312,326,297
"300560607",187,216,403,119,113,99
"300560608",644,664,1308,349,375,337
"300560609",39,24,63,23,38,23
"300560610",371,366,737,198,184,114
"300560611",118,101,219,67,108,66
"300560612",30,23,53,19,28,19
"300560701",747,707,1454,389,398,380
"300560702",574,613,1187,342,388,328
"300560703",106,99,205,69,140,63
"300560704",45,46,91,33,55,28
"300560705",157,155,312,87,110,85
"300560706",469,471,940,272,321,268
"300560707",80,92,172,53,55,53
"300560801",31,24,55,16,23,16
"300560802",16,19,35,12,25,12
"300560803",1,0,1,1,5,1
"300560804",81,60,141,44,63,44
"300560805",22,14,36,14,16,14
"300560806",22,14,36,11,14,11
"300560807",10,7,17,6,10,6
"300560808",91,56,147,54,70,54
"300560809",28,21,49,27,56,26
"300560810",95,101,196,57,58,43
"300560811",228,232,460,152,200,152
"300560812",179,161,340,100,119,100
"300560901",42,24,66,19,26,19
"300560902",51,56,107,44,55,43
"300560903",10,10,20,7,14,7
"300560904",18,12,30,12,29,12
"300560905",10,10,20,8,15,8
"300560906",31,25,56,23,39,22
"300560907",63,55,118,42,54,41
"300560908",80,77,157,49,56,48
"300560909",66,51,117,36,59,36
"300560910",26,31,57,15,29,15
"300560911",208,179,387,118,168,118
"300560912",15,17,32,9,18,8
"300560913",22,14,36,15,29,15
"300560914",11,4,15,6,9,6
"300560915",235,248,483,147,169,147
"300560916",299,309,608,213,247,212
"300561001",76,71,147,44,73,44
"300561002",8,7,15,5,14,5
"300561003",80,61,141,43,75,43
"300561004",109,91,200,70,110,70
"300561005",57,67,124,37,40,37
"300561006",5,11,16,5,16,5
"300561007",22,15,37,14,47,11
"300561008",38,31,69,23,38,23
"300561009",118,102,220,75,120,75
"300561010",30,19,49,19,34,19
"300561011",77,81,158,52,99,52
"300561101",6,5,11,5,13,5
"300561102",25,14,39,17,36,16
"300561103",30,20,50,17,39,17
"300561104",21,21,42,14,25,14
"300561105",18,21,39,15,21,15
"300561106",28,16,44,20,38,20
"300561107",37,21,58,20,30,19
"300561108",8,5,13,7,11,7
"300561109",32,26,58,19,29,15
"300561110",22,18,40,19,19,19
"300561111",154,144,298,108,155,108
"300561201",116,88,204,72,103,71
"300561202",85,60,145,49,64,49
"300561203",34,17,51,25,41,25
"300561204",64,41,105,42,59,42
"300561205",67,65,132,46,59,46
"300561206",81,59,140,53,76,53
"300561207",63,61,124,39,56,38
"300561208",84,44,128,41,63,41
"300561209",27,23,50,16,17,16
"300561301",10,7,17,7,29,7
"300561302",88,65,153,48,75,45
"300561303",34,22,56,23,37,20
"300561304",13,10,23,11,14,11
"300561305",23,17,40,12,17,12
"300561306",88,81,169,51,63,51
"300561307",32,26,58,18,28,18
"300561308",39,40,79,30,44,30
"300561309",13,6,19,8,10,6
"300561310",36,30,66,24,39,24
"300561401",67,70,137,49,79,49
"300561402",18,14,32,10,15,10
"300561403",23,6,29,17,24,17
"300561404",22,19,41,15,23,15
"300561405",24,28,52,18,23,18
"300561406",365,385,750,225,263,221
"300561501",279,290,569,176,193,172
"300561502",418,375,793,206,236,200
"300561503",385,371,756,224,247,215
"300561504",311,302,613,202,228,197
"300561505",171,192,363,149,176,146
"300561506",310,315,625,216,232,206
"300561507",383,414,797,279,317,278
"300561508",190,212,402,161,175,158
"300561509",288,339,627,255,289,252
"300561510",163,159,322,109,124,105
"300561511",423,421,844,261,301,255
"300561512",312,343,655,242,288,238
"300561513",389,403,792,284,331,280
"300561601",141,112,253,65,73,65
"300561602",69,62,131,48,74,47
"300561603",1,1,2,1,7,1
"300561604",214,186,400,132,142,105
"300561605",27,15,42,17,19,16
"300561701",33,20,53,21,34,21
"300561702",115,103,218,65,93,64
"300561703",292,295,587,159,181,154
"300561704",357,425,782,262,296,257
"300561705",394,422,816,246,270,244
"300561706",212,223,435,134,147,127
"300561707",422,424,846,221,272,218
"300561708",280,321,601,175,190,173
"300561709",241,252,493,166,196,165
"300561710",258,271,529,154,169,152
"300561711",237,291,528,173,193,171
"300561712",273,290,563,174,195,171
"300561801",44,36,80,33,53,33
"300561802",26,22,48,13,12,10
"300561803",13,16,29,8,9,8
"300561804",44,38,82,29,55,29
"300561805",31,21,52,25,44,25
"300561806",26,21,47,21,36,19
"300561807",28,22,50,17,28,16
"300561808",131,62,193,65,133,63
"300561809",110,111,221,77,357,77
"300561810",269,243,512,158,279,146
"300561811",301,276,577,184,295,181
"300561812",183,169,352,130,282,124
"300561813",144,139,283,94,174,92
"300561814",124,142,266,91,188,87
"300561815",26,14,40,21,95,17
"300630101",58,31,89,30,76,30
"300630102",31,23,54,23,25,23
"300630103",188,137,325,100,142,100
"300630104",64,53,117,43,81,43
"300630105",49,61,110,33,52,33
"300630106",15,15,30,11,18,11
"300630107",85,83,168,50,122,48
"300630108",74,45,119,41,104,41
"300630109",14,9,23,6,20,6
"300630110",498,466,964,265,313,260
"300630111",521,455,976,243,283,241
"300630201",64,49,113,37,53,37
"300630202",23,26,49,17,32,15
"300630203",129,106,235,66,89,63
"300630204",520,530,1050,274,305,265
"300630205",599,643,1242,327,363,321
"300630206",490,484,974,293,343,285
"300630207",532,564,1096,274,333,266
"300630301",56,14,70,43,71,43
"300630302",28,29,57,17,33,17
"300630303",52,31,83,28,30,28
"300630304",300,274,574,179,243,174
"300630401",3,0,3,3,4,3
"300630402",1,0,1,1,4,1
"300630403",8,3,11,6,8,6
"300630404",10,9,19,5,21,5
"300630405",25,18,43,14,19,13
"300630406",92,89,181,50,55,49
"300630407",26,17,43,14,18,13
"300630408",25,20,45,16,19,16
"300630409",23,18,41,14,19,14
"300630410",1,0,1,1,2,1
"300630411",3,0,3,3,9,3
"300630412",346,373,719,181,210,178
"300630413",510,501,1011,259,340,256
"300630501",37,20,57,23,36,23
"300630502",65,65,130,39,48,39
"300630503",17,10,27,8,11,8
"300630504",59,60,119,33,51,32
"300630505",118,99,217,76,109,73
"300630506",13,10,23,7,12,7
"300630507",60,58,118,31,47,31
"300630508",204,175,379,128,194,121
"300630509",78,75,153,53,155,52
"300630510",15,16,31,10,17,9
"300630511",24,13,37,14,31,13
"300630512",83,50,133,51,81,48
"300630513",6,3,9,4,32,4
"300630514",2,3,5,1,12,1
"300700101",163,204,367,108,134,98
"300700102",213,240,453,163,200,160
"300700103",205,264,469,147,210,145
"300700104",356,386,742,182,193,163
"300700105",303,332,635,184,200,180
"300700106",517,535,1052,265,265,241
"300700107",258,333,591,208,237,203
"300700108",332,409,741,244,271,224
"300700109",336,434,770,257,308,248
"300700110",311,349,660,191,205,180
"300700111",324,389,713,222,224,197
"300700112",226,298,524,176,197,169
"300700113",442,508,950,297,296,270
"300700114",683,709,1392,372,395,360
"300700115",507,525,1032,317,338,311
"300700201",481,573,1054,272,293,254
"300700202",407,417,824,200,223,196
"300700203",548,539,1087,250,246,237
"300700204",444,470,914,219,244,216
"300700205",332,343,675,159,172,155
"300700206",548,583,1131,264,254,245
"300700207",246,252,498,138,142,134
"300700208",317,327,644,149,152,139
"300700209",463,492,955,211,225,205
"300700210",466,496,962,221,224,214
"300700301",9,7,16,5,6,5
"300700302",124,104,228,60,74,59
"300700303",425,420,845,238,261,229
"300700304",361,418,779,239,276,226
"300700305",205,210,415,107,137,107
"300700306",108,104,212,68,61,39
"300700307",110,99,209,52,63,52
"300700308",369,440,809,246,277,237
"300700309",204,219,423,122,159,122
"300700310",500,525,1025,286,314,268
"300700311",283,308,591,151,224,148
"300700312",152,148,300,74,81,70
"300700313",52,43,95,29,39,29
"300700314",18,8,26,9,9,9
"300700401",123,114,237,54,58,54
"300700402",84,61,145,35,41,33
"300700403",6,5,11,5,14,5
"300700404",22,18,40,15,23,15
"300700405",55,39,94,25,41,25
"300700406",180,143,323,88,87,87
"300700407",92,93,185,43,46,43
"300700408",150,126,276,68,79,68
"300700409",68,56,124,31,32,31
"300700410",3,2,5,3,5,3
"300700411",100,85,185,49,59,49
"300700412",25,29,54,14,18,14
"300700413",76,44,120,35,55,35
"300700414",78,78,156,37,43,37
"300700415",109,102,211,60,65,58
"300700416",43,46,89,21,27,20
"300700501",54,36,90,39,50,36
"300700502",61,46,107,32,37,31
"300700503",81,70,151,37,49,36
"300700504",20,16,36,10,15,10
"300700505",84,70,154,46,55,45
"300700506",72,67,139,42,59,41
"300700507",64,77,141,39,52,39
"300700508",12,8,20,7,19,7
"300700509",55,33,88,29,36,24
"300700510",260,240,500,132,159,131
"300700511",391,434,825,202,220,196
"300700601",13,8,21,8,12,8
"300700602",23,21,44,11,15,11
"300700603",17,16,33,10,11,10
"300700604",45,43,88,21,31,20
"300700605",8,5,13,5,6,5
"300700606",15,15,30,6,6,6
"300700607",38,31,69,19,19,19
"300700608",145,140,285,67,75,67
"300700609",61,37,98,25,32,25
"300700701",109,95,204,57,70,54
"300700702",45,39,84,22,18,15
"300700703",114,93,207,49,53,49
"300700704",41,33,74,20,28,20
"300700705",50,45,95,31,40,29
"300700706",72,72,144,46,60,46
"300700801",40,36,76,13,19,13
"300700802",30,20,50,11,14,11
"300700803",49,43,92,26,39,26
"300700804",28,28,56,16,18,16
"300700805",25,13,38,16,20,16
"300700806",36,35,71,21,31,21
"300700807",27,23,50,16,31,15
"300700808",17,11,28,11,11,11
"300700809",31,26,57,17,15,12
"300700810",236,238,474,133,150,131
"300700901",61,51,112,33,44,33
"300700902",29,13,42,10,15,10
"300700903",127,105,232,68,78,68
"300700904",51,40,91,28,41,28
"300700905",117,95,212,23,36,23
"300700906",10,9,19,5,12,5
"300700907",121,91,212,63,81,63
"300700908",46,38,84,31,57,30
"300700909",136,145,281,77,89,76
"300701001",1,1,2,1,2,1
"300701002",23,11,34,11,15,9
"300701003",210,202,412,111,114,91
"300701004",463,497,960,196,212,192
"300701005",437,457,894,210,225,202
"300701006",217,236,453,130,134,123
"300701007",231,264,495,159,180,152
"300701008",528,569,1097,310,338,302
"300701009",524,548,1072,275,293,268
"300701010",513,518,1031,329,365,292
"300701011",298,351,649,192,200,186
"300701101",276,298,574,193,214,190
"300701102",259,255,514,161,186,157
"300701103",340,381,721,220,241,208
"300701104",596,664,1260,320,345,302
"300701105",346,371,717,182,155,143
"300701106",560,610,1170,358,368,334
"300701107",442,491,933,224,229,221
"300701108",332,407,739,218,227,211
"300701109",437,456,893,214,248,210
"300701110",675,774,1449,343,362,337
"300701111",645,744,1389,331,329,301
"300701112",233,192,425,89,109,87
"300701201",149,119,268,83,111,83
"300701202",38,24,62,21,30,21
"300701203",40,36,76,20,21,20
"300701204",117,121,238,68,88,68
"300701205",38,38,76,25,27,25
"300701206",58,33,91,28,38,27
"300701207",65,56,121,39,53,39
"300701208",50,39,89,25,33,23
"300701209",73,61,134,34,41,34
"300701210",34,33,67,21,21,21
"300701211",0,0,0,0,2,0
"300701212",131,130,261,82,144,80
"300701213",551,550,1101,310,361,304
"300701301",148,154,302,84,95,66
"300701302",156,155,311,93,113,93
"300701303",54,41,95,26,47,25
"300701304",80,68,148,45,59,44
"300701305",19,18,37,12,15,12
"300701306",31,31,62,18,16,16
"300701307",48,28,76,22,27,22
"300701308",93,100,193,58,67,57
"300701309",387,353,740,185,205,168
"300701310",166,166,332,115,135,114
"300701311",307,318,625,175,195,169
"300701312",322,304,626,164,176,152
"300701401",29,19,48,12,19,12
"300701402",25,39,64,18,20,17
"300701403",26,19,45,14,14,14
"300701404",27,29,56,17,17,16
"300701405",695,654,1349,312,317,289
"300701406",351,398,749,227,225,212
"300701407",382,415,797,217,228,202
"300701408",478,515,993,248,248,235
"300701409",352,403,755,225,226,211
"300701410",270,308,578,207,219,199
"300701411",547,613,1160,372,384,364
"300701412",406,401,807,258,264,244
"300701413",692,697,1389,329,328,311
"300701501",11,8,19,4,6,3
"300770101",239,207,446,124,139,117
"300770102",469,499,968,269,292,266
"300770103",283,297,580,179,191,176
"300770104",357,387,744,206,228,194
"300770105",450,427,877,225,252,220
"300770106",324,324,648,191,214,186
"300770107",310,341,651,215,247,212
"300770108",278,303,581,184,211,182
"300770109",337,422,759,228,255,222
"300770110",543,556,1099,351,372,328
"300770111",169,222,391,147,178,147
"300770112",173,163,336,98,105,98
"300770113",437,486,923,306,353,300
"300770114",313,414,727,276,312,273
"300770115",266,341,607,234,266,233
"300770201",373,380,753,227,256,221
"300770202",372,443,815,290,324,283
"300770203",218,219,437,131,145,128
"300770204",255,333,588,210,234,201
"300770205",266,320,586,217,272,214
"300770206",274,344,618,192,219,185
"300770207",343,405,748,238,278,232
"300770208",257,318,575,210,230,202
"300770209",340,316,656,188,196,188
"300770210",417,439,856,249,270,242
"300770211",387,421,808,254,285,238
"300770212",175,190,365,102,115,101
"300770213",483,556,1039,281,288,260
"300770214",352,342,694,182,203,182
"300770215",376,408,784,210,229,208
"300770216",679,681,1360,324,317,306
"300770217",212,230,442,113,115,109
"300770301",23,14,37,18,18,18
"300770302",112,106,218,75,91,75
"300770303",34,38,72,20,24,19
"300770304",158,138,296,84,94,83
"300770305",169,161,330,100,136,100
"300770306",138,150,288,76,83,76
"300770401",20,18,38,14,19,13
"300770402",28,42,70,20,25,20
"300770403",69,54,123,39,50,36
"300770404",55,42,97,27,30,27
"300770405",100,75,175,51,60,49
"300770406",41,60,101,27,31,27
"300770407",54,54,108,28,31,28
"300770408",81,66,147,38,41,35
"300770409",25,27,52,15,21,15
"300770410",59,46,105,31,49,31
"300770411",38,29,67,26,34,25
"300770412",23,26,49,15,19,15
"300770413",10,14,24,9,3,1
"300770414",71,57,128,41,57,40
"300770415",36,41,77,24,27,23
"300770416",63,57,120,32,37,32
"300770417",29,23,52,16,16,15
"300770501",54,57,111,32,46,32
"300770502",10,8,18,5,11,5
"300770503",42,28,70,24,24,23
"300770504",30,24,54,18,22,18
"300770505",88,80,168,48,55,46
"300770506",74,60,134,40,49,39
"300770507",65,73,138,42,48,41
"300770508",31,25,56,21,31,19
"300770509",12,5,17,7,8,7
"300770510",51,45,96,32,41,32
"300770511",15,11,26,10,13,10
"300770512",9,7,16,5,14,5
"300770513",42,31,73,30,33,28
"300770514",61,58,119,33,38,33
"300770515",35,32,67,20,29,20
"300770516",87,73,160,50,52,50
"300770517",47,45,92,29,30,29
"300770518",42,33,75,21,22,20
"300770519",10,5,15,7,14,7
"300770601",81,74,155,46,48,46
"300770602",18,14,32,11,15,11
"300770603",80,56,136,41,46,40
"300770604",9,6,15,6,9,5
"300770605",85,84,169,45,62,45
"300770606",71,54,125,38,45,38
"300770607",55,51,106,35,41,33
"300770608",20,12,32,14,27,14
"300770609",33,21,54,18,29,17
"300770610",64,46,110,30,46,30
"300770611",42,32,74,19,33,19
"300770612",157,150,307,95,119,95
"300770613",11,5,16,5,6,5
"300770701",78,79,157,47,52,46
"300770702",54,46,100,30,41,30
"300770703",27,22,49,16,19,16
"300770704",25,25,50,19,30,18
"300770705",36,27,63,24,34,24
"300770706",350,323,673,235,276,232
"300770707",444,454,898,259,285,254
"300770708",24,20,44,10,16,9
"300770709",47,40,87,25,39,25
"300770710",38,25,63,21,30,20
"300770711",11,8,19,7,16,7
"300770801",141,144,285,89,109,88
"300770802",213,202,415,140,170,140
"300770803",201,209,410,146,191,146
"300770804",170,230,400,170,209,167
"300770805",45,42,87,31,37,31
"300770806",97,81,178,62,79,61
"300770807",7,8,15,6,14,6
"300770901",35,30,65,21,25,21
"300770902",18,26,44,13,22,10
"300770903",34,29,63,25,32,25
"300770904",124,90,214,66,83,46
"300770905",20,12,32,8,16,8
"300770906",134,114,248,95,156,93
"300770907",31,25,56,20,27,20
"300770908",46,32,78,23,33,23
"300771001",43,34,77,27,38,27
"300771002",62,48,110,31,41,31
"300771003",32,27,59,14,18,14
"300771004",16,10,26,9,22,9
"300771005",14,17,31,13,21,13
"300771006",6,5,11,4,6,4
"300771101",51,47,98,36,69,33
"300771102",43,34,77,20,36,20
"300771103",95,83,178,59,87,59
"300771104",35,28,63,23,23,23
"300771105",30,28,58,20,23,20
"300771106",13,10,23,8,15,8
"300771107",5,2,7,3,6,3
"300771108",32,36,68,21,24,20
"300771109",49,39,88,26,33,26
"300771110",64,70,134,33,44,33
"300771111",35,40,75,27,38,25
"300771112",63,53,116,37,47,35
"300771113",58,61,119,38,43,35
"300771114",50,37,87,31,37,31
"300771115",43,26,69,20,32,20
"300771201",499,498,997,295,353,294
"300771202",205,217,422,132,147,121
"300771203",259,321,580,213,230,196
"300771204",239,276,515,199,225,194
"300771205",254,297,551,199,223,195
"300771206",248,261,509,170,211,169
"300771207",338,349,687,236,274,235
"300771208",69,68,137,35,48,35
"300771209",44,44,88,29,36,29
"300771210",17,21,38,14,20,13
"300771211",15,16,31,10,13,10
"300771212",12,15,27,11,21,11
"300771213",5,1,6,2,4,2
"300840101",489,485,974,273,290,266
"300840102",489,492,981,246,250,243
"300840103",188,183,371,105,136,104
"300840104",562,570,1132,294,299,289
"300840105",514,538,1052,276,309,268
"300840106",376,401,777,194,193,176
"300840107",333,337,670,180,196,178
"300840108",764,789,1553,373,395,365
"300840109",215,218,433,116,126,113
"300840110",382,394,776,200,187,176
"300840111",779,778,1557,351,354,337
"300840112",629,642,1271,324,323,300
"300840113",625,693,1318,354,340,322
"300840114",788,797,1585,401,412,387
"300840201",429,411,840,223,230,206
"300840202",207,256,463,170,227,168
"300840203",264,327,591,235,280,228
"300840204",217,272,489,196,271,192
"300840205",374,461,835,326,436,321
"300840206",204,252,456,187,238,185
"300840207",242,242,484,174,201,168
"300840208",624,649,1273,305,284,276
"300840209",268,326,594,232,287,224
"300840210",153,163,316,128,185,126
"300840211",216,312,528,197,240,191
"300840212",253,312,565,250,414,247
"300840213",260,343,603,254,413,248
"300840214",219,240,459,158,191,144
"300840215",310,391,701,251,289,248
"300840216",517,594,1111,326,318,288
"300840217",347,396,743,272,309,251
"300840218",274,351,625,247,291,238
"300840219",266,320,586,223,272,204
"300840220",188,298,486,206,289,201
"300840221",208,261,469,208,301,202
"300840222",150,223,373,168,293,163
"300840223",128,177,305,167,279,166
"300840224",121,204,325,157,290,154
"300840301",383,436,819,335,379,310
"300840302",552,574,1126,298,302,288
"300840303",406,434,840,246,264,225
"300840304",316,379,695,238,256,220
"300840305",804,868,1672,414,423,388
"300840306",303,368,671,266,331,258
"300840307",205,269,474,209,282,209
"300840308",223,320,543,218,279,213
"300840309",260,357,617,268,370,259
"300840310",393,497,890,305,352,293
"300840311",321,382,703,264,309,252
"300840312",239,284,523,219,248,201
"300840313",136,205,341,181,234,154
"300840314",337,465,802,319,400,303
"300840315",225,378,603,143,180,141
"300840316",239,266,505,194,231,186
"300840317",242,321,563,233,270,214
"300840318",426,566,992,426,544,412
"300840319",98,133,231,116,169,105
"300840320",202,296,498,221,303,217
"300840321",172,197,369,175,267,170
"300840322",98,146,244,110,191,109
"300840323",148,206,354,170,265,164
"300840401",601,616,1217,328,317,298
"300840402",542,558,1100,249,260,247
"300840403",174,166,340,112,145,112
"300840404",536,616,1152,370,374,336
"300840405",412,464,876,281,290,270
"300840406",363,427,790,237,222,198
"300840407",268,307,575,197,184,172
"300840408",382,416,798,242,243,226
"300840409",572,638,1210,345,352,315
"300840410",470,469,939,244,247,235
"300840411",690,725,1415,396,379,369
"300840412",658,548,1206,289,315,283
"300840413",365,403,768,231,248,218
"300840414",416,491,907,288,293,279
"300840415",733,741,1474,400,399,378
"300840416",577,704,1281,390,363,341
"300840417",483,557,1040,345,372,324
"300840418",544,555,1099,307,285,262
"300840419",272,280,552,151,150,137
"300840420",376,388,764,231,224,212
"300840421",338,411,749,240,266,234
"300840501",484,603,1087,392,388,343
"300840502",335,405,740,242,271,235
"300840503",412,462,874,257,243,229
"300840504",500,528,1028,339,347,322
"300840505",798,916,1714,508,522,469
"300840506",368,411,779,224,210,194
"300840507",375,396,771,233,235,220
"300840508",535,558,1093,306,312,285
"300840509",320,347,667,184,206,181
"300840510",360,383,743,237,244,222
"300840511",307,321,628,174,190,168
"300840512",551,589,1140,330,336,316
"300840513",387,434,821,227,218,209
"300840514",631,688,1319,370,378,355
"300840515",343,361,704,211,205,194
"300840516",555,601,1156,373,384,351
"300840517",431,461,892,271,293,265
"300840518",314,376,690,235,250,227
"300840519",303,360,663,220,234,205
"300840520",383,465,848,279,279,250
"300840521",265,296,561,214,237,202
"300840522",408,510,918,350,382,333
"300840523",479,574,1053,370,394,345
"300840524",425,555,980,347,374,324
"300840601",267,411,678,332,395,323
"300840602",83,118,201,104,148,104
"300840603",204,252,456,186,233,184
"300840604",352,448,800,309,361,297
"300840605",166,244,410,211,309,205
"300840606",197,259,456,191,267,190
"300840607",171,227,398,186,253,178
"300840608",388,481,869,335,385,318
"300840609",151,185,336,134,172,133
"300840610",57,85,142,81,113,78
"300840611",132,173,305,125,129,115
"300840612",300,434,734,245,305,233
"300840613",184,197,381,164,195,159
"300840614",181,231,412,177,214,165
"300840615",292,414,706,264,315,258
"300840616",364,457,821,303,316,283
"300840617",311,450,761,281,338,276
"300840618",276,357,633,254,367,240
"300840619",362,400,762,281,327,273
"300840620",428,446,874,343,393,330
"300840621",379,474,853,309,305,262
"300840622",308,359,667,219,233,212
"300840623",355,400,755,272,306,263
"300840701",392,474,866,292,332,281
"300840702",282,431,713,273,299,240
"300840703",100,156,256,120,160,109
"300840704",62,136,198,109,131,92
"300840705",135,203,338,154,212,147
"300840706",231,312,543,210,254,201
"300840707",174,280,454,154,198,150
"300840708",350,435,785,325,392,304
"300840709",463,537,1000,380,400,367
"300840710",382,470,852,339,381,313
"300840711",360,499,859,356,435,352
"300840712",381,514,895,326,381,312
"300840713",668,714,1382,330,308,302
"300840714",646,684,1330,390,363,351
"300840715",447,524,971,311,350,298
"300840801",326,360,686,203,206,187
"300840802",513,536,1049,300,315,289
"300840803",382,452,834,240,201,189
"300840804",570,626,1196,351,342,316
"300840805",590,672,1262,385,402,368
"300840806",533,551,1084,300,316,287
"300840807",465,540,1005,332,353,317
"300840808",275,293,568,185,204,177
"300840809",372,390,762,236,251,226
"300840810",517,573,1090,305,299,284
"300840811",408,463,871,298,313,289
"300840812",464,458,922,252,246,233
"300840813",51,33,84,44,8,8
"300840814",487,535,1022,338,334,296
"300840815",482,500,982,293,308,286
"300840816",607,590,1197,317,280,267
"300840817",468,517,985,278,282,256
"300840818",564,608,1172,348,368,334
"300840819",584,642,1226,364,389,350
"300840820",471,526,997,317,325,303
"300840821",629,657,1286,383,410,368
"300840822",576,615,1191,348,381,336
"300840823",287,311,598,184,203,169
"300840901",368,450,818,313,380,309
"300840902",367,419,786,286,309,275
"300840903",180,194,374,137,153,135
"300840904",358,484,842,303,330,280
"300840905",209,277,486,155,170,153
"300840906",325,379,704,237,263,227
"300840907",638,736,1374,435,455,424
"300840908",509,208,717,131,138,131
"300840909",486,517,1003,328,342,318
"300840910",308,392,700,246,255,230
"300840911",476,586,1062,332,345,294
"300840912",420,433,853,270,275,260
"300840913",537,605,1142,366,379,354
"300840914",472,519,991,303,325,289
"300840915",216,221,437,134,141,131
"300840916",482,496,978,270,275,250
"300840917",570,596,1166,361,392,351
"300841001",364,435,799,280,304,268
"300841002",475,480,955,267,262,246
"300841003",411,456,867,263,281,257
"300841004",224,278,502,181,196,173
"300841005",285,314,599,212,224,200
"300841006",304,299,603,216,282,180
"300841007",349,384,733,258,266,240
"300841008",424,487,911,304,329,293
"300841009",528,549,1077,321,330,300
"300841010",291,344,635,222,232,212
"300841011",412,449,861,297,310,281
"300841012",361,399,760,239,253,230
"300841013",380,433,813,243,242,219
"300841014",598,625,1223,351,382,340
"300841015",526,632,1158,319,335,307
"300841016",256,338,594,207,217,197
"300841017",532,533,1065,325,359,318
"300841018",575,644,1219,313,278,254
"300841019",267,240,507,160,184,153
"300841020",624,650,1274,352,349,318
"300841021",467,490,957,292,307,275
"300841101",140,167,307,108,116,106
"300841102",392,446,838,241,258,236
"300841103",600,668,1268,315,341,310
"300841104",515,567,1082,244,250,238
"300841105",195,235,430,121,132,118
"300841106",633,657,1290,320,298,275
"300841107",561,628,1189,376,348,323
"300841108",393,390,783,247,248,234
"300841109",102,120,222,71,72,70
"300841110",738,794,1532,407,399,386
"300841111",460,520,980,273,299,262
"300841112",406,423,829,249,207,186
"300841113",313,343,656,183,173,157
"300841114",574,597,1171,314,348,303
"300841201",142,141,283,79,121,79
"300841202",304,297,601,185,215,179
"300841203",92,79,171,50,68,46
"300841204",83,77,160,53,80,48
"300841205",427,440,867,239,249,220
"300841206",118,112,230,71,98,65
"300841207",332,438,770,290,281,228
"300841208",105,95,200,56,89,55
"300841209",88,70,158,56,77,54
"300841210",270,266,536,137,150,133
"300841211",336,296,632,168,186,168
"300841212",14,20,34,7,18,7
"300841301",607,620,1227,295,299,271
"300841302",344,327,671,190,216,188
"300841303",87,77,164,46,50,44
"300841304",341,320,661,188,199,181
"300841305",111,87,198,42,44,41
"300841306",318,338,656,161,185,157
"300841307",327,308,635,184,182,157
"300841401",464,541,1005,290,279,251
"300841402",563,652,1215,369,397,354
"300841403",486,537,1023,298,324,293
"300841404",572,611,1183,341,358,324
"300841405",629,622,1251,306,322,290
"300841406",692,733,1425,402,408,383
"300841407",577,650,1227,382,428,365
"300841408",342,373,715,237,273,234
"300841409",493,526,1019,305,306,280
"300841410",488,566,1054,273,303,259
"300841411",505,549,1054,302,331,297
"300841412",635,640,1275,349,372,340
"300841413",287,286,573,159,166,156
"300841414",572,617,1189,344,363,323
"300841415",197,217,414,124,131,121
"300841416",506,516,1022,295,313,289
"300841417",632,631,1263,342,361,326
"300841501",448,490,938,276,284,260
"300841502",255,260,515,139,155,134
"300841503",665,699,1364,404,432,394
"300841504",470,513,983,281,288,268
"300841505",248,267,515,144,147,138
"300841506",621,634,1255,347,304,284
"300841507",657,687,1344,355,349,344
"300841508",585,625,1210,349,371,343
"300841509",334,357,691,196,306,190
"300841510",498,457,955,277,276,252
"300841511",257,275,532,161,164,158
"300841512",592,655,1247,334,339,327
"300841513",6,7,13,4,5,4
"300841601",622,623,1245,311,304,281
"300841602",363,390,753,242,259,228
"300841603",455,489,944,293,317,286
"300841604",371,409,780,225,237,220
"300841605",294,323,617,200,216,192
"300841606",485,491,976,298,299,275
"300841607",477,533,1010,336,336,313
"300841608",564,566,1130,350,363,335
"300841609",430,458,888,266,263,235
"300841610",471,484,955,284,317,274
"300841611",556,570,1126,319,357,313
"300841701",243,224,467,122,113,111
"300841702",558,593,1151,286,266,257
"300841703",464,506,970,276,265,245
"300841704",440,488,928,273,311,262
"300841705",390,427,817,246,251,224
"300841706",248,313,561,168,163,151
"300841707",628,689,1317,387,377,342
"300841708",533,590,1123,283,270,251
"300841709",534,584,1118,281,270,258
"300841710",637,680,1317,327,296,281
"300841711",449,461,910,260,258,244
"300841712",393,422,815,223,228,214
"300841713",495,544,1039,315,294,271
"300841714",714,834,1548,404,400,373
"300841715",539,544,1083,265,244,239
"300841716",426,435,861,210,207,202
"300841717",424,404,828,204,208,197
"300841718",412,401,813,195,174,171
"300841719",775,805,1580,355,361,336
"300841801",55,50,105,29,38,28
"300841802",513,556,1069,276,285,255
"300841803",203,238,441,128,157,125
"300841804",178,168,346,97,116,94
"300841901",39,45,84,26,38,26
"300841902",17,13,30,10,12,10
"300841903",7,4,11,4,199,4
"300841904",9,8,17,4,209,4
"300841905",287,308,595,155,181,154
"300841906",267,237,504,136,143,118
"300841907",149,150,299,81,97,80
"300841908",37,35,72,17,213,15
"300841909",183,191,374,109,125,103
"300841910",272,257,529,152,166,143
"300841911",220,210,430,132,181,128
"300841912",70,69,139,49,161,49
"300842001",19,14,33,10,16,10
"300842002",123,106,229,72,137,71
"300842003",84,95,179,57,96,56
"300842004",80,35,115,46,65,46
"300842005",41,32,73,24,70,24
"300842006",32,24,56,24,72,24
"300842007",36,25,61,26,77,26
"300842101",615,581,1196,318,336,307
"300842102",206,189,395,119,145,117
"300842103",299,310,609,159,171,153
"300842104",290,292,582,155,171,152
"300842105",222,198,420,112,123,110
"300842106",839,861,1700,463,485,438
"300842107",397,413,810,243,258,227
"300842108",420,448,868,252,274,247
"300842201",282,253,535,157,219,156
"300842202",192,214,406,130,146,125
"300842203",91,104,195,55,70,54
"300842204",169,164,333,94,120,93
"300842205",142,138,280,73,85,72
"300842206",368,408,776,219,229,207
"300842207",78,61,139,38,52,37
"300842208",35,45,80,20,23,20
"300842301",11,18,29,7,8,7
"300842302",117,110,227,67,83,67
"300842303",9,6,15,5,10,5
"300842304",89,84,173,38,57,19
"300842305",319,339,658,212,268,208
"300842306",335,302,637,247,302,242
"300842307",215,231,446,156,220,154
"300842308",380,304,684,319,392,313
"300842309",411,305,716,307,364,277
"300842310",327,262,589,259,373,229
"300842311",89,70,159,54,92,52
"300842401",71,79,150,49,56,46
"300842402",40,46,86,24,40,23
"300842403",93,102,195,68,77,66
"300842404",66,58,124,36,44,36
"300842405",85,88,173,52,67,51
"300842406",60,56,116,31,36,31
"300842407",141,128,269,76,96,74
"300842408",28,28,56,16,21,14
"300842409",391,382,773,243,280,233
"300842501",14,11,25,6,9,6
"300842502",12,10,22,7,9,7
"300842503",62,61,123,39,53,39
"300842504",64,52,116,37,44,36
"300842505",66,45,111,32,47,32
"300842506",460,433,893,211,214,207
"300842507",458,401,859,248,283,241
"300842508",559,562,1121,333,363,325
"300842509",461,472,933,274,296,267
"300842510",280,297,577,219,257,215
"300842511",343,372,715,233,292,228
"300842512",135,140,275,83,96,82
"300842601",8,2,10,7,11,7
"300842602",8,5,13,6,11,6
"300842603",11,6,17,6,11,6
"300842604",21,17,38,11,16,11
"300842605",40,25,65,14,19,14
"300842606",16,24,40,11,18,10
"300842607",59,29,88,27,38,26
"300842608",30,17,47,14,19,13
"300842609",93,72,165,53,65,50
"300842610",69,56,125,31,40,30
"300842611",37,33,70,18,29,18
"300842612",33,39,72,20,27,19
"300842613",75,73,148,34,40,34
"300842614",24,18,42,9,21,9
"300842615",235,196,431,108,169,108
"300842616",174,197,371,105,140,98
"300842701",36,24,60,19,23,18
"300842702",32,28,60,22,35,22
"300842703",325,394,719,204,238,202
"300842704",404,445,849,284,321,278
"300842705",348,432,780,275,311,271
"300842706",217,197,414,112,120,111
"300842707",528,557,1085,323,347,306
"300842708",489,469,958,230,239,222
"300842801",177,151,328,96,96,87
"300842802",19,12,31,9,13,8
"300842803",38,35,73,24,35,24
"300842804",12,9,21,6,16,6
"300842805",36,32,68,17,23,17
"300842806",36,41,77,22,27,22
"300842807",20,12,32,10,16,10
"300842808",31,23,54,21,32,21
"300842809",29,34,63,25,26,25
"300842810",28,26,54,18,26,18
"300842811",19,20,39,14,15,14
"300842812",36,42,78,24,29,24
"300842813",32,31,63,19,21,19
"300842901",12,9,21,6,11,6
"300842902",17,17,34,9,15,9
"300842903",24,22,46,12,15,12
"300842904",20,16,36,12,14,12
"300842905",12,15,27,7,13,7
"300842906",16,13,29,11,14,11
"300842907",9,7,16,5,6,4
"300842908",4,4,8,2,6,2
"300842909",17,12,29,12,21,12
"300842910",398,368,766,216,218,197
"300843001",54,44,98,24,31,24
"300843002",115,106,221,53,58,49
"300843003",41,34,75,23,29,23
"300843004",11,14,25,9,12,7
"300843005",179,155,334,79,84,77
"300843006",347,348,695,222,230,206
"300843007",350,350,700,199,223,194
"300843008",253,253,506,146,194,146
"300843009",210,226,436,141,157,138
"300843010",188,205,393,123,143,119
"300843011",226,267,493,150,180,148
"300843012",346,419,765,273,316,272
"300843013",411,410,821,225,254,221
"300843014",86,81,167,57,69,57
"300843101",44,41,85,21,25,21
"300843102",70,65,135,36,49,34
"300843103",24,12,36,12,18,12
"300843104",16,6,22,5,5,5
"300843105",37,26,63,17,23,16
"300843106",25,19,44,13,21,13
"300843107",98,74,172,56,78,55
"300843108",30,21,51,14,20,14
"300843109",47,46,93,30,51,30
"300843110",47,38,85,30,38,28
"300843111",37,23,60,17,20,13
"300843112",62,53,115,35,42,35
"300843113",44,32,76,28,45,28
"300843114",23,30,53,17,24,16
"300843115",154,142,296,99,185,97
"300843116",150,152,302,108,133,107
"300843201",47,47,94,22,29,22
"300843202",95,89,184,63,82,62
"300843203",63,61,124,43,53,42
"300843204",64,61,125,46,62,46
"300843205",186,168,354,109,134,108
"300843206",184,146,330,92,122,92
"300843207",126,95,221,70,96,68
"300843208",51,74,125,36,46,33
"300843209",233,270,503,159,188,157
"300843210",47,54,101,31,42,31
"300843211",57,49,106,43,173,42
"300843212",155,151,306,98,264,97
"300843213",135,114,249,82,176,77
"300843301",18,15,33,10,12,10
"300843302",43,39,82,27,33,24
"300843303",28,27,55,16,23,16
"300843304",14,17,31,7,121,7
"300843305",139,120,259,89,109,86
"300843306",486,518,1004,308,339,300
"300843307",503,594,1097,346,373,324
"300843308",517,569,1086,383,466,375
"300843309",355,382,737,217,244,214
"300843310",213,177,390,103,122,98
"300843311",236,241,477,126,145,124
"300843312",275,341,616,220,245,216
"300843313",374,384,758,219,256,215
"300843314",531,571,1102,318,371,317
"300843401",4,0,4,4,6,4
"300843402",31,15,46,16,24,16
"300843403",9,9,18,8,16,8
"300843404",16,17,33,12,22,12
"300843405",26,20,46,11,21,11
"300843406",0,0,0,0,2,0
"300843407",75,71,146,49,65,49
"300843408",93,78,171,49,68,49
"300843409",35,23,58,17,27,17
"300843410",38,28,66,17,31,17
"300843411",25,14,39,14,19,14
"300843412",80,71,151,48,54,47
"300843413",41,39,80,22,32,22
"300843414",56,45,101,32,46,32
"300843415",122,119,241,75,80,75
"300843416",248,247,495,147,187,145
"300843501",21,22,43,12,17,12
"300843502",22,17,39,13,17,13
"300843503",33,29,62,19,18,18
"300843504",16,14,30,8,15,8
"300843505",23,23,46,16,36,16
"300843506",242,256,498,133,137,124
"300843507",186,196,382,118,129,117
"300843508",212,230,442,139,158,135
"300843601",39,20,59,17,27,16
"300843602",30,38,68,20,23,20
"300843603",37,25,62,26,32,26
"300843604",38,31,69,20,21,19
"300843701",321,331,652,192,203,183
"300843702",289,289,578,155,176,147
"300843703",211,183,394,115,133,114
"300843704",553,594,1147,370,386,355
"300843705",242,295,537,189,206,181
"300843706",360,386,746,235,231,212
"300843707",268,312,580,186,209,182
"300843708",216,209,425,134,152,130
"300843709",275,277,552,145,149,142
"300843710",336,361,697,207,214,205
"300843711",345,420,765,257,278,247
"300843712",370,376,746,178,178,168
"300843713",329,321,650,146,194,142
"300843714",424,411,835,265,276,261
"300843715",37,42,79,22,27,22
"300843801",9,6,15,4,8,4
"300843802",23,17,40,14,25,14
"300843803",27,24,51,15,14,14
"300843804",30,24,54,18,17,15
"300843805",51,46,97,34,45,33
"300843806",18,18,36,12,17,12
"300843807",50,41,91,25,31,25
"300843808",46,37,83,26,35,26
"300843809",25,29,54,16,24,14
"300843901",75,111,186,41,68,35
"300843902",53,38,91,26,45,26
"300843903",76,69,145,51,66,51
"300843904",63,65,128,38,51,35
"300843905",10,13,23,9,11,9
"300843906",12,15,27,7,18,7
"300843907",26,27,53,14,30,14
"300843908",51,49,100,30,39,30
"300843909",53,48,101,26,32,26
"300844001",87,76,163,48,49,48
"300844002",42,33,75,22,40,22
"300844003",40,31,71,24,28,23
"300844004",106,105,211,63,66,50
"300844005",39,43,82,24,33,24
"300844006",26,19,45,13,17,13
"300844007",59,53,112,27,29,27
"300844008",91,62,153,42,49,40
"300844009",73,65,138,41,43,41
"300844101",11,11,22,7,14,7
"300844102",24,14,38,15,25,15
"300844103",38,30,68,19,25,19
"300844104",35,27,62,19,26,18
"300844105",388,441,829,293,311,282
"300844106",414,446,860,272,300,270
"300844107",4,2,6,2,5,2
"300844108",458,501,959,325,365,316
"300844109",262,306,568,206,233,199
"300844110",229,244,473,155,185,153
"300844201",15,14,29,8,13,8
"300844202",85,71,156,47,62,45
"300844203",34,26,60,18,25,16
"300844204",84,73,157,50,71,48
"300844205",26,17,43,14,14,14
"300844206",18,11,29,10,15,10
"300844207",37,36,73,22,33,22
"300844208",48,32,80,20,20,19
"300844209",60,65,125,41,45,41
"300844301",548,600,1148,343,362,321
"300844302",299,312,611,192,206,190
"300844303",349,368,717,252,281,243
"300844304",263,322,585,205,237,201
"300844305",351,373,724,260,301,255
"300844306",340,407,747,273,292,262
"300844307",449,462,911,279,293,268
"300844308",302,297,599,207,228,203
"300844309",499,561,1060,368,408,361
"300844310",216,247,463,149,171,144
"300844311",358,369,727,193,200,186
"300844312",373,331,704,205,208,201
"300844313",378,367,745,199,193,184
"300844401",377,441,818,293,312,285
"300844402",123,151,274,88,102,85
"300844403",506,566,1072,368,388,358
"300844404",555,574,1129,359,374,343
"300844405",203,229,432,146,156,138
"300844406",250,292,542,196,217,193
"300844407",406,432,838,296,334,290
"300844408",466,469,935,289,331,284
"300844409",264,248,512,144,214,132
"300844410",459,455,914,275,287,262
"300844411",332,362,694,215,223,204
"300844501",62,66,128,35,39,33
"300844502",51,57,108,30,35,30
"300844503",65,55,120,40,48,39
"300844504",96,82,178,51,55,49
"300844505",82,80,162,50,54,50
"300844506",63,59,122,36,38,33
"300844507",222,208,430,142,170,141
"300844508",189,205,394,126,148,124
"300844509",103,106,209,60,70,55
"300844510",215,219,434,120,132,120
"300844511",42,46,88,33,48,33
"300844601",26,2,28,17,28,17
"300880101",377,405,782,279,274,259
"300880102",372,359,731,271,308,267
"300880103",524,550,1074,364,412,352
"300880104",319,370,689,246,273,241
"300880105",285,304,589,230,243,221
"300880106",421,431,852,275,312,270
"300880107",351,360,711,232,245,222
"300880201",107,84,191,53,65,52
"300880202",73,57,130,38,64,38
"300880203",86,88,174,52,54,51
"300880204",529,519,1048,263,313,256
"300880205",835,791,1626,386,411,375
"300880206",606,623,1229,341,349,327
"300880207",546,598,1144,318,344,314
"300880208",528,554,1082,315,347,307
"300880209",400,373,773,196,214,189
"300880210",202,201,403,108,112,107
"300880301",235,227,462,131,151,129
"300880302",21,12,33,12,16,12
"300880303",5,6,11,6,9,6
"300880304",191,171,362,101,115,101
"300880305",245,276,521,157,167,152
"300880306",386,385,771,236,252,228
"300880307",216,242,458,162,191,159
"300880308",260,271,531,161,175,154
"300880401",9,7,16,5,6,5
"300880402",40,36,76,23,30,23
"300880403",10,10,20,9,11,8
"300880404",24,21,45,17,21,15
"300880405",57,43,100,33,42,33
"300880501",34,31,65,20,24,20
"300880502",9,3,12,5,9,5
"300880503",29,15,44,14,19,14
"300880504",42,25,67,23,29,23
"300880601",2,1,3,2,10,2
"300880602",16,9,25,11,14,11
"300880603",9,11,20,7,11,7
"300880604",15,16,31,11,24,11
"300880605",2,1,3,1,11,1
"300880606",10,11,21,8,9,8
"300880701",53,44,97,33,39,33
"300880702",32,27,59,17,31,17
"300880703",7,11,18,7,11,7
"300880704",35,36,71,23,35,23
"300880705",8,9,17,4,8,4
"300880706",37,36,73,21,28,21
"300880707",54,43,97,30,39,30
"300910101",565,519,1084,277,292,268
"300910102",495,566,1061,314,321,287
"300910103",477,592,1069,385,417,372
"300910104",292,359,651,261,287,241
"300910105",256,308,564,198,216,195
"300910106",208,248,456,188,224,185
"300910107",220,287,507,181,198,177
"300910108",445,460,905,258,288,245
"300910109",422,435,857,288,357,278
"300910110",281,280,561,183,214,180
"300910111",222,310,532,196,220,190
"300910112",223,270,493,170,194,165
"300910113",331,355,686,212,236,203
"300910114",89,100,189,56,73,55
"300910115",302,316,618,175,199,171
"300910116",458,520,978,332,354,317
"300910117",295,319,614,208,239,196
"300910118",416,430,846,239,264,236
"300910201",13,15,28,9,13,9
"300910202",18,18,36,10,17,10
"300910203",92,90,182,56,66,51
"300910204",56,34,90,28,37,25
"300910205",65,75,140,46,107,46
"300910206",20,8,28,6,8,6
"300910207",86,77,163,52,66,50
"300910208",170,139,309,103,147,102
"300910209",39,37,76,20,27,20
"300910301",32,22,54,15,19,15
"300910302",154,140,294,95,133,95
"300910303",30,23,53,20,25,20
"300910304",76,76,152,60,72,60
"300910305",49,43,92,28,32,28
"300910306",78,47,125,39,41,31
"300910307",77,67,144,50,66,49
"300910308",12,7,19,9,12,9
"300910309",34,21,55,24,43,24
"300910401",1,0,1,1,2,1
"300910402",27,27,54,17,24,16
"300910403",55,39,94,37,49,37
"300910404",69,53,122,40,48,37
"300910405",28,27,55,19,35,17
"300910406",21,15,36,11,19,11
"300910407",23,10,33,13,17,13
"300910501",346,308,654,219,256,215
"300910502",340,374,714,258,295,250
"300910503",340,352,692,236,257,226
"300910504",393,398,791,229,254,229
"300910505",167,178,345,138,156,138
"300910506",416,483,899,311,362,294
"300910507",385,427,812,260,315,258
"300910508",476,487,963,232,259,221
"300910509",87,89,176,58,64,55
"300910510",38,37,75,25,33,25
"300910511",21,18,39,11,15,11
"300910512",16,20,36,11,14,11
"300910601",35,25,60,18,25,18
"300910602",16,14,30,12,25,11
"300910603",8,14,22,6,6,6
"300910604",44,43,87,19,20,18
"300910605",14,20,34,9,17,9
"300910606",243,248,491,158,210,155
"300910701",18,15,33,14,27,14
"300910702",100,101,201,74,101,74
"300910703",39,22,61,18,28,18
"300910704",8,5,13,5,13,5
"300910705",8,9,17,7,13,7
"300910706",15,8,23,6,17,6
"300910801",22,20,42,13,21,13
"300910802",32,25,57,17,31,17
"300910803",18,18,36,11,15,11
"300910804",12,7,19,5,11,5
"300910805",12,12,24,10,12,10
"300910806",13,6,19,8,11,8
"300910807",17,14,31,14,21,9
"300910808",122,96,218,65,91,65
"300910901",15,23,38,14,18,14
"300910902",8,9,17,5,5,5
"300910903",52,50,102,35,58,35
"300910904",12,7,19,10,12,9
"300910905",38,24,62,23,26,23
"300910906",5,6,11,4,6,4
"300911001",204,209,413,137,167,134
"300911002",269,256,525,189,227,188
"300911003",251,255,506,171,208,170
"300911004",299,303,602,205,241,201
"300911005",124,126,250,89,124,89
"300911101",13,12,25,9,18,9
"300911102",19,13,32,16,24,16
"300911103",19,16,35,13,18,12
"300911104",9,7,16,7,18,7
"300911105",74,62,136,50,83,50
"300911106",32,24,56,23,36,22
"300980101",744,680,1424,363,336,321
"300980102",448,446,894,278,289,258
"300980103",416,393,809,233,240,221
"300980104",396,423,819,267,296,252
"300980105",402,493,895,268,290,261
"300980106",630,643,1273,370,387,339
"300980107",366,370,736,221,245,213
"300980108",380,382,762,262,271,242
"300980109",447,498,945,347,391,337
"300980110",462,449,911,323,367,313
"300980111",580,565,1145,298,312,286
"300980112",493,556,1049,341,385,330
"300980113",463,551,1014,377,404,365
"300980114",272,309,581,212,235,207
"300980115",360,374,734,264,282,254
"300980116",685,744,1429,435,429,404
"300980117",500,513,1013,296,295,280
"300980118",393,404,797,248,267,235
"300980119",407,401,808,225,234,214
"300980120",255,247,502,161,179,156
"300980201",454,484,938,304,296,278
"300980202",513,534,1047,324,336,296
"300980203",432,495,927,300,307,281
"300980204",385,452,837,322,344,286
"300980205",382,450,832,318,392,306
"300980206",194,196,390,142,165,140
"300980207",287,319,606,206,226,204
"300980208",408,474,882,324,302,267
"300980209",549,598,1147,318,312,291
"300980210",402,403,805,251,269,237
"300980211",544,514,1058,327,343,321
"300980212",566,565,1131,333,364,318
"300980213",359,371,730,230,222,206
"300980214",490,503,993,287,295,273
"300980215",339,353,692,234,257,230
"300980301",214,267,481,160,177,158
"300980302",251,282,533,212,254,200
"300980303",375,492,867,349,447,332
"300980304",382,443,825,331,393,320
"300980305",396,420,816,298,362,280
"300980306",274,321,595,206,238,202
"300980307",263,327,590,231,327,229
"300980308",221,253,474,207,292,205
"300980309",235,285,520,202,256,195
"300980310",172,257,429,194,243,186
"300980311",54,65,119,56,77,55
"300980312",151,267,418,183,234,174
"300980313",159,200,359,133,190,132
"300980314",270,288,558,201,241,191
"300980315",184,178,362,147,170,142
"300980316",361,370,731,277,320,268
"300980317",168,217,385,151,160,135
"300980318",242,304,546,223,266,213
"300980401",239,289,528,182,195,174
"300980402",300,334,634,226,210,204
"300980403",336,375,711,263,264,251
"300980404",180,243,423,178,191,177
"300980405",169,211,380,151,191,148
"300980406",211,291,502,210,270,183
"300980407",157,203,360,146,165,135
"300980408",201,272,473,189,218,179
"300980409",280,331,611,224,235,200
"300980410",518,501,1019,293,290,262
"300980411",434,463,897,289,281,253
"300980412",304,313,617,216,225,208
"300980413",476,494,970,303,318,293
"300980414",369,395,764,247,270,242
"300980415",315,230,545,179,214,170
"300980416",288,294,582,225,244,216
"300980417",287,335,622,249,284,229
"300980418",456,498,954,268,280,245
"300980419",260,254,514,166,176,156
"300980420",189,202,391,167,226,159
"300980421",227,234,461,181,223,174
"300980501",206,191,397,118,97,60
"300980502",268,223,491,153,200,144
"300980503",92,65,157,47,86,47
"300980504",548,576,1124,267,250,233
"300980505",34,47,81,26,35,26
"300980506",625,609,1234,319,258,244
"300980507",423,452,875,235,248,222
"300980508",681,646,1327,319,328,306
"300980509",774,806,1580,379,373,352
"300980510",434,499,933,249,284,246
"300980511",475,575,1050,328,356,321
"300980512",448,479,927,268,264,254
"300980513",462,532,994,223,233,222
"300980514",124,128,252,70,92,67
"300980601",28,22,50,11,13,11
"300980602",101,102,203,57,87,55
"300980603",139,120,259,91,133,84
"300980604",130,136,266,82,68,36
"300980605",407,364,771,229,244,223
"300980606",748,703,1451,365,393,346
"300980607",578,605,1183,298,280,264
"300980608",526,607,1133,343,367,330
"300980609",226,207,433,131,134,128
"300980610",420,409,829,229,240,225
"300980611",578,600,1178,343,353,309
"300980612",66,51,117,37,52,34
"300980613",66,59,125,33,44,33
"300980614",110,78,188,68,100,66
"300980701",504,571,1075,370,420,363
"300980702",147,171,318,90,104,90
"300980703",368,396,764,250,267,245
"300980704",255,306,561,189,209,186
"300980705",197,218,415,115,104,86
"300980706",230,241,471,172,203,169
"300980707",427,478,905,285,310,276
"300980708",233,277,510,187,233,187
"300980709",274,326,600,209,223,205
"300980710",232,276,508,201,232,193
"300980711",270,280,550,175,195,171
"300980712",208,236,444,151,164,148
"300980713",295,308,603,205,218,196
"300980714",275,278,553,174,185,173
"300980715",430,381,811,223,236,218
"300980716",207,190,397,108,113,102
"300980801",21,16,37,13,15,12
"300980802",29,16,45,14,14,14
"300980803",8,8,16,6,8,6
"300980804",19,15,34,12,14,12
"300980805",59,66,125,21,38,21
"300980901",18,13,31,10,25,10
"300980902",20,13,33,9,15,9
"300980903",196,187,383,136,176,135
"300980904",3,7,10,1,6,1
"300980905",11,14,25,7,15,7
"300980906",77,60,137,50,65,47
"300980907",161,159,320,113,138,112
"300980908",171,148,319,101,124,101
"300980909",46,33,79,23,37,22
"300980910",62,40,102,33,52,33
"300980911",21,12,33,12,22,12
"300980912",111,97,208,75,97,75
"300980913",125,114,239,84,119,82
"300980914",85,79,164,55,70,54
"300980915",32,33,65,18,30,18
"300980916",24,17,41,14,20,13
"300980917",28,26,54,20,21,19
"300981001",282,279,561,223,292,222
"300981002",313,313,626,218,291,216
"300981003",67,61,128,44,62,38
"300981004",38,27,65,24,42,24
"300981005",71,63,134,47,54,47
"300981006",25,15,40,11,14,11
"300981007",13,8,21,7,12,7
"300981101",166,180,346,119,153,117
"300981102",186,178,364,120,135,117
"300981103",193,208,401,127,158,126
"300981104",161,155,316,99,112,97
"300981105",21,20,41,16,28,16
"300981106",12,15,27,10,18,10
"300981201",21,17,38,10,15,10
"300981202",11,6,17,6,9,6
"300981203",17,15,32,13,33,13
"300981204",8,4,12,6,13,6
"300981205",11,11,22,9,17,8
"300981206",11,12,23,7,15,7
"300981301",19,13,32,12,13,12
"300981302",11,6,17,7,3,2
"300981303",24,22,46,14,20,14
"300981304",8,10,18,5,12,5
"300981305",27,21,48,13,19,13
"300981306",41,27,68,23,23,23
"300981307",81,60,141,43,53,43
"300981308",37,25,62,22,19,16
"300981309",214,213,427,141,159,140
"300981310",217,240,457,153,187,153
"300981311",171,196,367,130,147,130
"300981312",100,85,185,59,70,58
"300981313",41,27,68,21,25,21
"300981314",36,24,60,18,23,18
"300981401",56,49,105,34,44,34
"300981402",56,43,99,32,51,32
"300981403",61,61,122,37,48,37
"300981404",19,18,37,11,11,6
"300981405",352,344,696,243,282,240
"300981406",57,51,108,39,46,37
"300981407",42,37,79,26,29,26
"300981408",19,11,30,14,27,14
"300981409",481,495,976,327,373,320
"300981410",162,128,290,96,108,92
"300981411",172,131,303,98,120,94
"300981412",32,19,51,20,30,20
"300981413",73,81,154,48,61,48
"300981414",89,66,155,52,57,51
"300981415",44,36,80,28,30,27
"300981416",57,60,117,39,34,34
"300981501",47,49,96,37,37,35
"300981502",150,157,307,94,101,81
"300981503",444,424,868,253,265,248
"300981504",188,185,373,134,154,133
"300981505",37,45,82,33,43,33
"300981506",29,24,53,19,22,19
"300981507",58,62,120,39,52,39
"300981508",70,55,125,44,52,44
"300981509",85,101,186,56,62,56
"300981510",206,215,421,152,184,146
"300981511",322,322,644,200,225,195
"300981512",181,165,346,125,138,124
"300981513",176,175,351,119,147,118
"300981514",24,17,41,14,15,13
"300981515",36,23,59,17,25,16
"300981516",52,41,93,31,48,31
"300981601",10,6,16,5,7,5
"300981602",18,12,30,10,21,10
"300981603",67,61,128,51,59,50
"300981604",123,46,169,49,67,48
"300981605",135,126,261,86,95,86
"300981606",68,53,121,40,51,40
"300981701",38,40,78,28,37,28
"300981702",161,153,314,104,116,103
"300981703",221,193,414,113,116,101
"300981704",171,156,327,109,142,108
"300981705",50,41,91,31,39,31
"300981706",17,17,34,11,16,11
"300981707",29,16,45,13,21,13
"300981708",43,33,76,25,29,23
"300981709",49,47,96,24,26,24
"300981801",3,0,3,3,46,3
"300981802",20,14,34,12,14,12
"301050101",340,360,700,199,214,194
"301050102",321,298,619,156,213,153
"301050103",326,337,663,185,211,174
"301050104",498,522,1020,271,290,253
"301050105",240,257,497,129,144,124
"301050106",195,239,434,122,130,113
"301050107",351,413,764,243,260,217
"301050108",345,394,739,237,265,234
"301050109",313,293,606,168,192,162
"301050110",348,390,738,267,288,249
"301050111",180,214,394,152,169,138
"301050112",182,258,440,160,207,157
"301050201",245,263,508,158,175,138
"301050202",383,401,784,216,228,207
"301050203",373,392,765,221,240,216
"301050204",265,306,571,175,217,173
"301050205",298,321,619,190,223,184
"301050206",345,337,682,208,236,200
"301050207",397,410,807,212,236,208
"301050208",401,393,794,202,239,197
"301050209",384,411,795,269,304,260
"301050210",299,382,681,240,343,239
"301050211",193,265,458,170,198,165
"301050212",256,327,583,205,244,200
"301050213",343,337,680,207,216,189
"301050301",415,438,853,256,313,247
"301050302",51,57,108,37,90,35
"301050303",540,560,1100,371,454,364
"301050304",419,396,815,236,274,231
"301050305",244,303,547,192,237,185
"301050306",391,421,812,296,366,278
"301050307",381,440,821,234,252,219
"301050308",334,386,720,243,290,239
"301050309",321,356,677,209,265,204
"301050310",329,408,737,247,285,234
"301050401",120,185,305,119,147,114
"301050402",169,213,382,132,188,131
"301050403",230,310,540,197,239,193
"301050404",440,461,901,261,293,256
"301050405",265,273,538,176,210,160
"301050406",488,538,1026,291,351,280
"301050407",373,365,738,192,213,181
"301050408",125,134,259,86,108,83
"301050409",502,451,953,268,302,232
"301050410",621,579,1200,314,360,310
"301050501",133,110,243,69,90,66
"301050502",23,16,39,15,22,15
"301050503",117,97,214,63,142,61
"301050504",103,112,215,60,103,60
"301050601",76,56,132,38,46,38
"301050602",32,33,65,29,32,24
"301050603",15,9,24,8,8,8
"301050604",31,28,59,21,41,21
"301050605",98,92,190,55,85,53
"301050606",178,170,348,111,156,111
"301050607",29,17,46,19,35,19
"301050608",16,11,27,13,28,13
"301050609",78,70,148,47,84,46
"301050610",317,280,597,191,215,188
"301050611",68,58,126,35,51,35
"301050612",103,86,189,63,93,63
"301050701",19,16,35,13,19,13
"301050702",40,28,68,29,44,29
"301050703",61,63,124,42,85,41
"301050704",25,13,38,18,21,18
"301050705",44,36,80,29,51,28
"301050706",28,33,61,21,21,21
"301050707",46,32,78,22,30,22
"301050708",94,68,162,42,66,42
"301050709",38,26,64,21,48,21
"301050710",10,1,11,10,26,10
"301050711",212,208,420,136,194,131
"301050712",292,235,527,132,162,129
"301050713",32,25,57,18,25,18
"301050714",19,19,38,12,20,12
"301050715",100,111,211,68,118,68
"301050801",32,0,32,25,37,25
"301050802",26,20,46,13,48,13
"301050803",18,5,23,11,30,10
"301050804",32,18,50,17,11,3
"301050805",43,16,59,21,4,2
"301050806",51,29,80,25,48,25
"301050807",38,18,56,26,64,26
"301050808",37,17,54,22,45,22
"301050809",25,14,39,15,41,15
"301050810",56,30,86,36,113,36
"301050811",51,29,80,25,62,25
"301050812",99,54,153,58,106,58
"301130101",181,182,363,97,138,93
"301130102",1,0,1,1,5,1
"301130103",539,586,1125,272,264,254
"301130104",418,410,828,206,228,194
"301130105",592,648,1240,368,462,339
"301130106",390,438,828,226,231,213
"301130107",277,315,592,181,181,161
"301130108",418,466,884,267,294,257
"301130109",485,562,1047,368,458,365
"301130110",360,412,772,234,235,207
"301130111",442,482,924,274,295,266
"301130112",419,473,892,311,359,293
"301130113",303,331,634,211,223,201
"301130114",258,288,546,201,223,195
"301130115",493,540,1033,316,341,304
"301130116",321,334,655,193,206,187
"301130117",344,344,688,191,215,189
"301130118",407,443,850,258,269,247
"301130119",274,345,619,233,252,214
"301130120",108,157,265,107,129,107
"301130121",186,223,409,168,213,165
"301130122",489,580,1069,329,346,312
"301130123",395,483,878,316,357,305
"301130201",315,399,714,266,318,259
"301130202",127,170,297,111,134,110
"301130203",212,293,505,186,236,182
"301130204",339,372,711,232,217,193
"301130205",304,402,706,264,321,256
"301130206",139,173,312,127,146,118
"301130207",127,186,313,131,160,128
"301130208",251,349,600,217,236,211
"301130209",279,378,657,235,261,229
"301130210",299,331,630,220,265,216
"301130211",479,530,1009,260,291,255
"301130212",492,536,1028,287,304,264
"301130213",246,276,522,130,142,122
"301130214",454,465,919,269,291,256
"301130215",347,397,744,194,202,182
"301130216",377,403,780,191,219,188
"301130301",13,15,28,7,11,7
"301130302",122,98,220,67,76,67
"301130303",365,352,717,183,211,182
"301130304",172,87,259,66,87,66
"301130305",389,403,792,197,200,144
"301130306",97,86,183,58,63,58
"301130307",525,583,1108,308,330,301
"301130308",227,249,476,144,128,121
"301130309",523,495,1018,240,245,233
"301130310",662,685,1347,338,375,328
"301130311",437,411,848,206,213,197
"301130312",30,22,52,13,15,13
"301130401",11,9,20,6,7,6
"301130402",6,3,9,3,4,3
"301130403",16,19,35,12,15,12
"301130404",378,359,737,209,227,205
"301130405",367,407,774,261,301,258
"301130406",621,594,1215,290,346,287
"301130501",21,12,33,10,15,10
"301130502",0,0,0,0,1,0
"301130503",21,13,34,14,17,14
"301130504",335,307,642,157,172,153
"301130505",211,242,453,137,158,133
"301130506",159,195,354,118,140,114
"301130507",168,174,342,101,129,101
"301130601",27,23,50,18,22,18
"301130602",32,25,57,14,23,14
"301130603",127,130,257,64,71,62
"301130604",34,20,54,17,26,17
"301130605",18,16,34,12,17,12
"301130606",235,213,448,120,147,118
"301130607",72,57,129,36,45,35
"301130608",166,118,284,79,100,79
"301130609",82,67,149,38,44,37
"301130610",46,44,90,27,27,27
"301130701",47,22,69,22,25,22
"301130702",152,149,301,97,119,97
"301130703",92,87,179,56,61,54
"301130704",50,43,93,28,36,28
"301130705",83,72,155,56,72,56
"301130706",165,148,313,116,131,113
"301130801",32,30,62,16,24,16
"301130802",20,11,31,6,12,6
"301130803",26,14,40,14,26,14
"301130804",41,29,70,16,23,16
"301130805",86,68,154,38,40,38
"301130806",134,128,262,61,69,61
"301130807",73,60,133,37,40,36
"301130808",66,65,131,41,46,40
"301130809",29,17,46,17,25,17
"301130810",22,14,36,16,28,16
"301130811",27,16,43,12,20,12
"301130812",26,19,45,15,17,15
"301130813",37,23,60,23,41,23
"301130814",38,24,62,17,26,17
"301130815",57,33,90,30,32,29
"301130901",43,30,73,22,26,20
"301130902",34,31,65,19,34,19
"301130903",48,39,87,28,33,28
"301130904",35,28,63,23,25,23
"301130905",32,24,56,20,23,20
"301130906",90,77,167,56,64,56
"301130907",35,34,69,19,20,19
"301130908",23,17,40,13,25,13
"301131001",57,24,81,38,43,38
"301131002",122,90,212,65,88,65
"301131003",58,39,97,30,46,29
"301131004",92,77,169,53,60,53
"301131005",76,75,151,49,50,49
"301131006",31,32,63,24,28,24
"301131007",72,65,137,37,42,37
"301131008",83,84,167,41,50,40
"301131101",19,21,40,11,14,11
"301131102",9,6,15,4,5,4
"301131103",78,72,150,42,44,42
"301131104",87,84,171,47,54,45
"301131105",64,58,122,42,49,39
"301131106",174,139,313,88,108,87
"301131107",24,12,36,11,13,11
"301131108",31,24,55,20,26,20
"301131109",48,32,80,25,39,24
"301131110",65,54,119,37,51,36
"301131201",30,36,66,20,21,20
"301131202",26,20,46,13,17,13
"301131203",192,204,396,125,142,124
"301131204",109,101,210,77,76,76
"301131205",12,17,29,10,11,10
"301131206",50,34,84,27,33,27
"301131207",27,18,45,19,28,19
"301131208",66,53,119,31,34,31
"301131209",67,71,138,47,62,47
"301131301",7,6,13,4,4,4
"301131302",62,55,117,33,34,33
"301131303",27,18,45,11,12,11
"301131304",46,32,78,24,24,24
"301131305",17,11,28,5,5,5
"301131306",35,22,57,16,15,11
"301131307",9,6,15,5,5,5
"301131308",186,178,364,119,131,118
"301131309",144,123,267,74,94,73
"301131401",27,21,48,14,14,14
"301131402",63,43,106,30,33,30
"301131403",17,9,26,7,12,7
"301131404",19,15,34,8,10,8
"301131405",52,54,106,33,39,33
"301131406",17,20,37,17,17,17
"301131407",16,13,29,10,8,6
"301131408",12,10,22,6,7,6
"301131409",12,8,20,8,11,8
"301131410",5,6,11,4,19,4
"301131411",202,197,399,113,143,113
"340070101",256,246,502,83,86,81
"340070102",904,801,1705,307,308,294
"340070201",519,424,943,203,232,200
"340070202",85,52,137,33,41,33
"340070203",430,331,761,192,202,177
"340070204",388,348,736,168,172,146
"340070301",143,103,246,60,45,35
"340070401",129,93,222,59,88,59
"340070402",281,264,545,151,189,139
"340070403",342,266,608,171,186,164
"340070404",247,265,512,138,169,132
"340070405",468,442,910,241,296,238
"340070406",388,363,751,206,278,201
"340070407",242,246,488,135,210,135
"340070408",236,234,470,136,220,133
"340070409",249,211,460,120,157,117
"340070501",366,293,659,197,225,184
"340070502",77,87,164,52,87,51
"340070503",375,314,689,186,154,118
"340070504",74,22,96,50,93,50
"340070505",274,254,528,156,197,125
"340070601",51,29,80,30,37,30
"340070602",204,167,371,97,119,96
"340070603",30,16,46,17,29,17
"340070701",51,32,83,27,46,27
"340070702",326,320,646,145,206,127
"340070703",210,159,369,94,93,85
"340070801",194,125,319,94,102,90
"340140101",641,636,1277,342,265,240
"340140102",450,452,902,248,220,188
"340140103",130,141,271,95,323,88
"340140104",281,355,636,255,341,255
"340140105",329,398,727,238,262,230
"340140106",407,509,916,256,269,248
"340140107",340,401,741,202,206,196
"340140108",715,857,1572,405,418,390
"340140109",577,598,1175,301,253,230
"340140110",711,705,1416,356,297,288
"340140111",323,400,723,215,216,191
"340140112",416,503,919,251,261,242
"340140113",404,496,900,300,302,281
"340140114",416,509,925,292,288,271
"340140115",283,289,572,175,191,168
"340140116",398,476,874,284,272,242
"340140117",407,427,834,247,237,225
"340140118",313,314,627,176,183,148
"340140119",224,247,471,167,195,160
"340140120",462,564,1026,364,368,306
"340140121",210,274,484,170,195,163
"340140122",430,450,880,235,247,221
"340140123",337,442,779,246,288,242
"340140124",364,381,745,218,220,206
"340140125",333,367,700,203,223,199
"340140126",290,293,583,176,209,169
"340140201",774,774,1548,361,373,353
"340140202",557,565,1122,298,290,274
"340140203",509,604,1113,330,384,321
"340140204",315,347,662,186,220,184
"340140205",646,710,1356,345,352,326
"340140206",649,710,1359,299,297,281
"340140207",484,417,901,244,238,230
"340140208",437,501,938,258,285,245
"340140209",585,627,1212,359,369,344
"340140210",341,401,742,238,264,235
"340140211",380,436,816,262,272,239
"340140212",392,433,825,254,239,227
"340140213",244,269,513,188,232,187
"340140214",348,486,834,311,358,308
"340140215",429,410,839,258,304,248
"340140216",272,369,641,227,285,218
"340140217",280,365,645,215,253,202
"340140218",294,363,657,212,244,183
"340140219",313,359,672,185,198,172
"340140220",665,689,1354,370,343,318
"340140221",397,418,815,193,169,163
"340140222",381,410,791,200,185,175
"340140223",524,517,1041,240,196,189
"340140301",372,468,840,274,314,250
"340140302",427,534,961,322,351,309
"340140303",359,461,820,264,319,256
"340140304",352,404,756,281,372,267
"340140305",315,391,706,252,322,224
"340140306",372,416,788,248,285,225
"340140307",496,626,1122,339,356,290
"340140308",514,581,1095,319,253,237
"340140309",374,405,779,176,161,150
"340140310",662,720,1382,353,322,271
"340140311",597,630,1227,282,289,256
"340140312",473,464,937,250,313,245
"340140313",585,598,1183,281,263,248
"340140401",356,358,714,221,224,194
"340140402",262,307,569,189,229,181
"340140403",666,723,1389,382,377,349
"340140404",551,612,1163,367,372,344
"340140405",293,374,667,223,207,200
"340140406",593,709,1302,376,390,323
"340140407",398,515,913,222,231,212
"340140408",364,469,833,285,270,263
"340140409",517,613,1130,350,402,336
"340140410",356,419,775,258,272,246
"340140411",340,394,734,212,220,198
"340140412",445,547,992,262,260,246
"340140413",545,582,1127,306,273,271
"340140414",448,492,940,243,237,232
"340140415",708,769,1477,366,327,314
"340140416",554,597,1151,290,279,270
"340140417",493,500,993,290,267,257
"340140418",415,503,918,245,244,221
"340140419",454,502,956,259,248,235
"340140501",26,21,47,17,22,17
"340140502",697,665,1362,351,349,324
"340140503",24,17,41,14,31,14
"340140504",256,262,518,127,140,116
"340140505",168,182,350,93,103,83
"340140506",381,323,704,167,169,148
"340140601",6,0,6,6,10,6
"340140602",236,242,478,141,178,137
"340140603",237,250,487,115,134,106
"340140604",38,25,63,25,27,21
"340140605",138,131,269,67,68,54
"340140606",110,110,220,64,90,55
"340140607",199,162,361,94,112,94
"340140608",6,0,6,3,278,3
"340140609",0,0,0,0,281,0
"340140701",414,320,734,203,244,185
"340140702",469,418,887,221,275,212
"340140703",442,519,961,196,199,190
"340140704",475,452,927,196,205,192
"340140705",686,735,1421,319,319,301
"340140706",672,679,1351,301,281,274
"340140707",496,571,1067,223,233,223
"340140708",652,675,1327,270,269,255
"340140709",740,764,1504,338,319,292
"340140710",618,622,1240,262,191,182
"340140711",757,783,1540,337,220,213
"340140712",13,13,26,5,297,5
"340140713",538,576,1114,248,278,244
"340140714",655,688,1343,275,284,269
"340140715",712,713,1425,323,292,265
"340140716",229,190,419,126,205,121
"340140717",365,347,712,190,241,185
"340140801",56,24,80,33,59,31
"340140802",32,9,41,16,32,16
"340140803",93,87,180,46,59,34
"340140804",98,95,193,54,89,54
"340140901",235,219,454,115,135,115
"340140902",67,19,86,32,39,31
"340141001",104,96,200,64,78,64
"340141002",11,10,21,7,10,7
"340141003",7,3,10,5,12,5
"340141004",165,187,352,112,127,109
"340141005",284,280,564,156,179,155
"340141101",60,77,137,39,39,39
"340141102",20,9,29,13,18,13
"340141103",89,84,173,59,71,57
"340141104",205,205,410,109,139,108
"340141201",127,100,227,55,68,54
"340141301",71,43,114,48,57,47
"340141302",9,3,12,7,9,7
"340141401",62,57,119,36,54,36
"340141402",86,53,139,52,69,51
"340141403",301,287,588,162,200,161
"340141404",193,177,370,99,111,97
"340141501",711,742,1453,381,368,325
"340141502",460,463,923,228,230,215
"340141503",324,376,700,214,267,202
"340141504",586,741,1327,389,396,374
"340141505",466,526,992,264,243,230
"340141506",516,575,1091,286,282,251
"340141507",744,759,1503,421,381,356
"340141508",588,705,1293,376,373,325
"340141509",542,550,1092,298,263,254
"340141510",396,441,837,212,175,167
"340141511",186,255,441,129,85,83
"340141512",516,643,1159,342,318,281
"340141513",511,579,1090,317,304,287
"340141514",731,810,1541,443,370,327
"340141515",304,346,650,179,191,178
"340141516",471,541,1012,270,284,257
"340141517",486,677,1163,352,381,345
"340141518",437,537,974,283,282,272
"340141519",419,452,871,212,212,199
"340141520",250,266,516,165,187,159
"340141521",434,470,904,215,195,189
"340141522",404,428,832,213,225,209
"340141523",436,492,928,234,244,221
"340141524",343,394,737,213,225,201
"340141525",494,557,1051,284,324,276
"340141526",306,343,649,189,218,188
"340141527",320,386,706,207,237,206
"340141528",489,540,1029,266,250,228
"340141601",424,421,845,205,219,190
"340141602",706,737,1443,370,368,344
"340141603",320,381,701,189,183,172
"340141604",398,445,843,220,213,200
"340141605",670,618,1288,336,320,294
"340141606",601,661,1262,352,324,301
"340141607",437,488,925,235,216,205
"340141608",664,735,1399,369,365,333
"340141609",482,532,1014,292,257,227
"340141610",512,586,1098,303,254,244
"340141611",386,472,858,253,267,242
"340141612",394,426,820,228,221,208
"340141613",407,465,872,239,252,227
"340141614",339,326,665,195,207,190
"340141615",439,524,963,236,241,227
"340141616",527,616,1143,303,292,276
"340141617",474,554,1028,271,222,199
"340141618",357,387,744,176,112,108
"340141619",388,437,825,215,227,209
"340141620",449,500,949,251,251,241
"340141621",606,692,1298,330,317,289
"340141622",951,729,1680,352,335,307
"340141623",475,530,1005,276,282,264
"340141624",362,447,809,213,216,201
"340141625",392,425,817,212,218,206
"340141626",438,411,849,226,228,215
"340141627",409,420,829,202,187,161
"340141628",365,400,765,206,192,167
"340141701",341,329,670,179,172,159
"340141702",411,372,783,204,123,109
"340141703",484,500,984,240,246,231
"340141704",491,540,1031,248,227,208
"340141705",828,850,1678,379,383,362
"340141706",589,649,1238,285,200,181
"340141707",299,294,593,147,129,118
"340141708",544,577,1121,259,226,217
"340141709",434,521,955,230,203,190
"340141710",432,478,910,206,213,201
"340141711",518,541,1059,247,235,218
"340141712",524,514,1038,257,167,148
"340141713",198,168,366,111,111,109
"340141714",507,543,1050,264,281,256
"340141715",341,387,728,189,192,186
"340141716",701,719,1420,328,359,323
"340141717",493,512,1005,252,259,229
"340141801",20,3,23,9,13,9
"340141802",8,4,12,6,8,6
"340141901",57,29,86,32,34,32
"340141902",10,1,11,4,4,4
"340142001",69,49,118,37,46,37
"340142002",628,577,1205,242,243,218
"340142003",35,21,56,18,21,18
"340142004",537,477,1014,260,285,255
"340142005",47,35,82,24,20,14
"340142006",632,630,1262,327,263,224
"340142007",79,50,129,46,54,40
"340142008",7,7,14,5,5,5
"340142009",30,24,54,17,20,17
"340142010",5,2,7,2,5,2
"340142011",57,38,95,27,38,26
"340142012",219,238,457,121,28,21
"340142013",512,554,1066,278,316,264
"340142014",427,457,884,218,249,215
"340142015",690,670,1360,330,354,312
"340142016",584,599,1183,253,262,238
"340142017",465,437,902,225,262,222
"340142018",402,363,765,184,197,177
"340142019",541,507,1048,213,200,188
"340142020",369,372,741,182,207,178
"340142021",0,0,0,0,168,0
"340142022",1,0,1,1,312,1
"340142023",690,681,1371,322,338,310
"340142024",452,440,892,245,208,181
"340142025",507,537,1044,309,328,259
"340142026",519,546,1065,260,287,249
"340142027",664,656,1320,318,333,302
"340142101",386,332,718,184,93,88
"340142102",376,434,810,216,195,179
"340142103",437,487,924,274,286,253
"340142104",525,545,1070,332,310,262
"340142105",212,265,477,157,113,102
"340142106",215,278,493,201,137,94
"340142107",237,320,557,246,305,238
"340142108",255,328,583,229,261,200
"340142109",269,316,585,223,240,207
"340142110",250,295,545,204,221,190
"340142111",350,419,769,228,224,196
"340142112",202,255,457,164,173,156
"340142113",317,370,687,212,165,153
"340142114",340,413,753,243,247,219
"340142115",763,768,1531,406,348,335
"340142116",741,779,1520,391,360,336
"340142117",537,518,1055,289,282,252
"340142118",395,424,819,225,224,209
"340142119",512,540,1052,268,261,250
"340142201",410,468,878,219,232,213
"340142202",546,608,1154,300,329,296
"340142203",340,368,708,177,188,173
"340142204",657,665,1322,330,357,315
"340142205",754,800,1554,380,396,368
"340142206",712,779,1491,377,327,305
"340142207",748,760,1508,358,347,321
"340142208",806,786,1592,369,360,332
"340142209",711,742,1453,348,318,286
"340142210",836,883,1719,375,374,354
"340142211",741,760,1501,323,311,294
"340142212",774,803,1577,376,378,354
"340142213",706,785,1491,352,354,339
"340142214",763,768,1531,363,365,333
"340142215",450,495,945,221,204,190
"340142216",608,626,1234,319,267,245
"340142217",569,588,1157,265,259,244
"340142218",589,601,1190,262,253,243
"340142219",714,712,1426,353,401,342
"340142220",360,408,768,200,211,191
"340142221",387,359,746,182,197,176
"340142222",49,39,88,30,37,30
"340210101",10,8,18,7,10,7
"340210102",55,32,87,26,35,24
"340210201",291,268,559,137,179,137
"340210202",108,91,199,47,44,35
"340210203",15,9,24,9,14,9
"340210204",14,4,18,6,10,6
"340210205",6,6,12,5,13,5
"340210206",83,68,151,50,73,49
"340210207",18,11,29,10,17,10
"340210208",175,156,331,80,133,79
"340210209",48,41,89,34,43,34
"340210210",97,82,179,47,63,46
"340210211",314,316,630,188,188,173
"340210212",380,368,748,203,211,190
"340210213",525,591,1116,280,295,266
"340210214",663,669,1332,302,390,289
"340210215",229,272,501,151,183,142
"340210301",132,95,227,72,103,71
"340210302",280,260,540,129,189,123
"340210303",116,101,217,67,99,65
"340210304",349,354,703,185,240,175
"340210305",341,324,665,164,196,158
"340210306",161,135,296,76,119,75
"340210307",437,444,881,196,232,194
"340210401",27,13,40,11,21,11
"340210402",159,109,268,73,92,70
"340210403",541,515,1056,258,312,246
"340210501",7,5,12,5,7,5
"340210502",232,201,433,127,161,127
"340210601",133,90,223,50,67,50
"340210602",233,209,442,134,165,131
"340210603",349,336,685,205,251,203
"340210604",433,427,860,247,275,241
"340210701",38,19,57,18,30,18
"340210702",21,6,27,14,20,14
"340210703",105,47,152,49,53,49
"340210704",43,19,62,28,38,27
"340210705",11,7,18,7,15,7
"340210706",539,591,1130,327,341,309
"340210707",479,441,920,236,267,219
"340210708",392,360,752,176,197,172
"340210709",183,191,374,102,118,99
"340280101",363,291,654,167,180,161
"340280102",348,346,694,154,209,150
"340280103",557,591,1148,271,335,252
"340280104",421,454,875,243,279,227
"340280105",529,547,1076,277,323,263
"340280106",411,444,855,212,263,204
"340280107",503,522,1025,205,220,191
"340280108",291,313,604,163,194,151
"340280109",598,632,1230,264,312,252
"340280110",325,336,661,140,190,137
"340280111",257,256,513,118,179,116
"340280112",333,389,722,169,204,154
"340280113",513,499,1012,248,333,244
"340280114",345,368,713,191,221,184
"340280115",440,435,875,180,190,161
"340280201",601,580,1181,233,263,229
"340280301",234,183,417,99,107,98
"340280302",69,51,120,29,42,28
"340350101",458,419,877,247,259,212
"340350102",115,72,187,59,71,59
"340350103",290,277,567,154,183,149
"340350104",47,13,60,29,34,29
"340350105",86,55,141,47,61,47
"340350106",375,336,711,157,177,156
"340350107",18,2,20,6,6,6
"340350108",519,488,1007,200,211,196
"340350201",423,367,790,179,193,170
"340350202",121,95,216,71,86,67
"340350203",254,201,455,157,219,155
"340350204",166,133,299,91,125,91
"340350205",45,25,70,24,41,23
"340350206",165,102,267,94,117,93
"340350207",10,10,20,5,7,5
"340350301",503,462,965,206,228,199
"340350302",39,29,68,25,48,24
"340350303",215,150,365,110,136,109
"340350304",14,2,16,11,14,11
"340350401",23,13,36,14,21,14
"340350402",614,528,1142,269,305,260
"340350403",128,61,189,64,73,64
"340350404",63,28,91,26,36,26
"340350405",359,362,721,185,211,182
"340350406",236,206,442,116,125,112
"340350501",880,777,1657,455,525,410
"340350502",46,28,74,29,42,29
"340350503",2,0,2,2,6,2
"340350601",224,187,411,106,134,106
"340350602",325,281,606,166,166,138
"340350603",275,197,472,155,168,137
"340350604",328,355,683,180,209,177
"340350605",246,261,507,143,168,140
"340350606",299,301,600,165,184,149
"340350607",396,371,767,198,227,196
"340350608",282,287,569,171,200,161
"340350609",307,287,594,142,178,141
"340350610",240,241,481,119,187,119
"340350611",527,537,1064,293,363,286
"340350612",554,608,1162,301,344,295
"340350613",368,415,783,217,250,216
"340350614",225,216,441,125,149,122
"340350615",286,309,595,142,177,141
"340350701",287,203,490,111,128,111
"340350702",313,230,543,157,201,157
"340350703",329,233,562,173,207,173
"340350704",504,542,1046,316,349,284
"340350705",412,401,813,236,302,233
"340350706",238,241,479,155,192,155
"340350707",401,380,781,220,254,218
"340350801",219,245,464,123,166,119
"340350802",376,440,816,231,261,216
"340350803",408,437,845,210,266,182
"340350804",413,399,812,246,282,239
"340350805",486,526,1012,281,327,272
"340350806",284,290,574,176,210,174
"340350901",279,287,566,168,194,162
"340350902",327,357,684,200,232,197
"340350903",427,437,864,272,309,260
"340350904",336,389,725,234,291,228
"340350905",264,302,566,169,198,159
"340350906",548,546,1094,310,382,276
"340350907",389,399,788,206,245,191
"340350908",379,401,780,250,277,245
"340350909",527,575,1102,293,359,285
"340350910",284,282,566,155,187,150
"340350911",367,317,684,180,285,178
"340351001",314,322,636,174,197,168
"340351002",514,576,1090,295,329,285
"340351003",340,341,681,215,266,207
"340351004",565,606,1171,323,341,297
"340351005",321,343,664,203,246,193
"340351006",350,339,689,197,241,196
"340351007",241,281,522,156,180,150
"340351101",161,117,278,72,28,26
"340351102",67,47,114,29,30,24
"340351103",506,421,927,223,248,187
"340351104",335,322,657,184,211,170
"340351105",325,278,603,166,201,161
"340351201",563,575,1138,309,338,288
"340351202",528,582,1110,323,356,312
"340351203",413,425,838,265,287,241
"340351204",273,330,603,178,199,169
"340351205",427,472,899,278,288,245
"340351206",450,361,811,200,217,195
"340351207",593,632,1225,284,322,275
"340351208",279,292,571,166,177,157
"340351209",306,305,611,153,201,145
"340351210",180,187,367,97,149,92
"340351301",114,93,207,43,43,43
"340351302",33,20,53,26,34,25
"340351303",48,39,87,24,29,24
"340351401",93,60,153,56,76,56
"340351402",90,65,155,46,65,46
"340351403",62,49,111,33,43,32
"340351501",5,1,6,2,2,2
"340351502",160,153,313,83,106,81
"340351503",196,177,373,104,121,98
"340351601",190,167,357,88,112,85
"340351701",72,25,97,36,48,36
"340351702",44,15,59,19,23,19
"340351703",17,5,22,8,13,8
"340351704",33,10,43,18,20,18
"340351801",314,230,544,134,153,133
"340351802",260,247,507,121,129,121
"340351803",126,83,209,49,60,46
"340351804",95,69,164,49,52,49
"340351805",261,241,502,129,160,112
"340351806",306,304,610,175,188,169
"340351807",264,299,563,155,180,153
"340351808",406,368,774,222,232,190
"340351809",338,328,666,133,113,113
"340351810",257,243,500,134,175,130
"340351811",260,285,545,123,126,118
"340351812",182,175,357,95,99,91
"340351901",83,49,132,42,61,42
"340351902",89,51,140,43,55,43
"340351903",218,148,366,109,110,109
"340351904",350,346,696,179,214,175
"340351905",390,358,748,221,250,213
"340351906",467,444,911,244,319,228
"340351907",281,294,575,121,126,121
"340351908",378,389,767,202,205,173
"340351909",83,99,182,49,74,47
"340352001",117,91,208,64,74,62
"340352002",203,142,345,105,126,105
"340352003",104,81,185,48,63,48
"340352101",67,39,106,35,35,35
"340352102",26,6,32,11,19,9
"340352103",101,59,160,61,72,60
"340420101",81,58,139,39,39,37
"340420102",345,319,664,168,179,165
"340420103",148,111,259,64,74,64
"340420104",330,273,603,157,194,155
"340420105",431,323,754,191,216,189
"340420106",262,242,504,110,117,107
"340420107",239,237,476,125,190,121
"340420108",240,228,468,143,260,141
"340420109",651,667,1318,330,416,329
"340420110",508,518,1026,265,322,258
"340420111",527,598,1125,330,384,319
"340420112",195,183,378,97,103,88
"340420201",34,20,54,14,16,14
"340420202",177,161,338,80,87,79
"340420203",69,55,124,37,40,37
"340420204",575,502,1077,275,357,270
"340420205",443,435,878,241,281,240
"340420301",194,159,353,92,105,90
"340420302",25,13,38,13,17,13
"340420303",357,309,666,165,193,165
"340420304",43,39,82,25,32,25
"340420305",653,596,1249,332,396,328
"340420306",450,492,942,262,333,249
"340420307",325,331,656,150,225,150
"340420401",342,225,567,144,168,144
"340420402",26,15,41,16,22,16
"340420403",20,7,27,13,15,13
"340420501",432,408,840,167,172,166
"340420502",55,33,88,24,25,13
"340420503",13,9,22,10,16,10
"340420504",477,432,909,245,303,240
"340420505",486,480,966,253,292,245
"340420506",372,396,768,217,253,216
"340490101",543,532,1075,245,286,236
"340490102",704,790,1494,374,389,356
"340490103",492,538,1030,276,241,227
"340490104",366,399,765,224,247,204
"340490105",402,432,834,180,200,175
"340490106",547,651,1198,304,331,296
"340490107",392,443,835,229,245,223
"340490108",408,513,921,257,236,219
"340490109",671,791,1462,390,422,377
"340490110",463,501,964,262,246,230
"340490111",358,481,839,255,286,232
"340490112",315,399,714,199,218,189
"340490113",406,546,952,235,247,229
"340490114",860,898,1758,404,379,353
"340490115",716,807,1523,326,319,294
"340490116",469,470,939,249,270,241
"340490117",459,470,929,262,270,244
"340490118",415,442,857,220,213,201
"340490119",608,728,1336,328,312,289
"340490120",565,575,1140,275,303,266
"340490121",634,704,1338,318,341,305
"340490122",615,662,1277,323,330,293
"340490123",445,493,938,239,227,217
"340490124",706,685,1391,307,321,297
"340490125",553,556,1109,260,269,246
"340490126",407,454,861,194,195,185
"340490127",317,311,628,148,151,145
"340490128",364,429,793,237,241,218
"340490201",3,1,4,3,4,3
"340490301",23,5,28,13,22,13
"340490302",318,280,598,148,155,141
"340490303",81,90,171,34,40,34
"340490304",80,90,170,43,47,42
"340490305",90,82,172,43,45,35
"340490306",152,138,290,65,65,64
"340490401",70,42,112,33,44,33
"340490402",60,60,120,31,31,30
"340490403",321,318,639,168,177,161
"340490501",34,18,52,16,19,15
"340490601",204,152,356,101,106,101
"340490602",433,383,816,230,257,205
"340490603",382,307,689,196,223,187
"340490604",185,171,356,104,151,103
"340490605",14,16,30,9,12,9
"340490606",146,135,281,71,70,55
"340490607",33,10,43,16,26,16
"340490608",15,5,20,12,13,12
"340490609",207,168,375,92,74,62
"340490610",564,579,1143,303,364,300
"340490611",258,248,506,164,177,158
"340490612",493,512,1005,254,331,251
"340490613",319,331,650,188,223,188
"340490614",356,390,746,212,252,208
"340490701",435,345,780,230,252,225
"340490702",204,154,358,101,80,73
"340490703",757,705,1462,414,495,405
"340490704",325,319,644,178,164,140
"340490705",77,84,161,39,45,39
"340490706",352,314,666,177,161,149
"340490707",58,46,104,32,33,29
"340490708",332,291,623,163,184,162
"340490709",128,112,240,62,109,62
"340490710",278,308,586,164,210,162
"340490801",456,436,892,236,229,182
"340490802",177,161,338,93,102,93
"340490803",205,189,394,111,126,110
"340490804",1232,1180,2412,569,607,565
"340490805",1129,971,2100,574,638,541
"340490806",477,488,965,294,337,289
"340490807",287,298,585,160,198,158
"340490808",322,353,675,175,205,162
"340490901",269,224,493,118,132,117
"340490902",608,572,1180,306,337,306
"340490903",423,387,810,215,252,213
"340490904",17,13,30,10,16,10
"340491001",12,5,17,6,6,6
"340491002",118,98,216,54,47,32
"340491003",579,548,1127,268,268,243
"340491004",640,681,1321,304,326,294
"340491005",626,688,1314,336,342,327
"340491006",671,742,1413,350,300,275
"340491007",485,540,1025,263,272,254
"340491008",451,548,999,240,243,232
"340491009",443,541,984,258,271,251
"340491010",677,752,1429,353,386,341
"340491011",468,470,938,226,212,191
"340491012",664,664,1328,318,265,244
"340491013",543,574,1117,264,269,251
"340491014",563,553,1116,261,272,246
"340491015",485,496,981,237,232,222
"340491016",560,655,1215,341,333,309
"340491017",437,430,867,210,215,202
"340491018",616,667,1283,280,309,274
"340491019",613,616,1229,276,282,268
"340491020",566,572,1138,273,280,249
"340491021",546,564,1110,261,279,252
"340491022",223,235,458,127,190,78
"340491023",1,0,1,1,200,1
"340491024",69,58,127,36,275,34
"340491101",550,537,1087,296,400,292
"340491102",250,242,492,140,183,136
"340491103",380,377,757,241,292,236
"340491104",464,488,952,239,247,210
"340491105",299,323,622,191,224,186
"340491106",515,570,1085,301,338,294
"340491107",235,256,491,162,266,161
"340491108",195,189,384,114,225,108
"340491109",304,327,631,215,221,200
"340560101",594,626,1220,313,361,307
"340560102",226,202,428,127,156,126
"340560103",441,496,937,270,308,264
"340560104",433,482,915,300,350,299
"340560105",425,412,837,221,248,216
"340560106",585,633,1218,328,361,322
"340560107",332,399,731,260,301,254
"340560108",260,266,526,185,218,178
"340560109",368,449,817,252,314,242
"340560110",425,442,867,239,268,229
"340560111",492,543,1035,291,311,284
"340560112",630,612,1242,313,385,309
"340560113",428,448,876,224,270,218
"340560114",133,143,276,70,281,58
"340560115",325,298,623,144,196,143
"340560116",479,493,972,268,354,267
"340560117",345,363,708,197,325,195
"340560201",5,4,9,3,5,3
"340560202",351,292,643,169,164,154
"340560203",7,7,14,4,7,4
"340560204",13,8,21,9,10,9
"340560205",30,10,40,14,15,14
"340560301",121,96,217,76,94,76
"340560302",40,28,68,21,23,20
"340560303",314,280,594,167,204,165
"340560304",5,5,10,3,7,3
"340560401",15,14,29,11,14,9
"340560402",397,364,761,204,246,204
"340560403",157,139,296,70,80,70
"340560404",31,22,53,19,23,13
"340560405",486,429,915,255,336,251
"340560406",328,373,701,223,228,210
"340560407",302,341,643,198,258,193
"340560408",470,551,1021,314,361,298
"340560409",509,562,1071,303,359,296
"340560501",330,272,602,187,210,182
"340560502",226,187,413,111,128,109
"340560503",180,146,326,88,121,87
"340560504",333,328,661,192,246,180
"340560601",178,136,314,86,87,82
"340560602",126,105,231,71,83,70
"340560603",157,144,301,76,87,76
"340560604",65,58,123,35,42,35
"340560605",182,144,326,85,102,85
"340560701",394,323,717,213,264,209
"340560702",109,98,207,51,66,50
"340560703",43,43,86,29,38,27
"340560704",48,46,94,27,36,27
"340560705",454,453,907,228,266,224
"340560706",381,428,809,223,275,211
"340560707",453,488,941,280,319,261
"340560708",527,582,1109,318,405,315
"340560709",309,297,606,185,223,181
"340560801",102,90,192,47,63,47
"340560802",121,111,232,58,68,58
"340560803",30,19,49,15,21,15
"340560804",47,43,90,24,28,18
"340560805",109,88,197,51,68,51
"340560901",97,75,172,67,84,66
"340560902",114,93,207,45,47,44
"340560903",22,23,45,15,21,15
"340561001",263,224,487,117,138,117
"340561002",75,46,121,32,44,32
"340561003",192,166,358,93,110,91
"340561004",95,103,198,52,56,51
"340561005",49,40,89,30,33,30
"340561101",486,527,1013,268,265,239
"340561102",446,476,922,249,275,244
"340561103",313,341,654,202,252,199
"340561104",447,390,837,208,227,195
"340561105",432,469,901,257,287,251
"340561106",301,328,629,175,180,160
"340561107",329,344,673,198,220,195
"340561108",473,536,1009,285,320,280
"340561109",504,503,1007,232,252,226
"340561110",392,424,816,219,241,214
"340561111",324,398,722,201,217,193
"340561112",440,463,903,257,273,228
"340561113",322,349,671,192,213,190
"340561114",290,318,608,159,180,155
"340561115",359,382,741,215,253,201
"340561116",509,525,1034,234,251,225
"340561117",489,469,958,233,273,232
"340561118",358,389,747,208,273,208
"340561119",527,555,1082,275,384,268
"340561120",285,294,579,192,212,161
"340561121",451,443,894,219,262,217
"340561122",351,340,691,160,263,158
"340561123",247,275,522,123,236,122
"340561201",22,20,42,12,21,12
"340561202",212,205,417,124,124,106
"340561203",15,12,27,9,12,9
"340561301",110,71,181,56,79,54
"340561302",46,45,91,34,34,33
"340561401",180,152,332,88,107,88
"340561402",361,346,707,188,210,186
"340561403",61,50,111,38,45,38
"340561404",42,32,74,22,22,22
"340561405",61,60,121,34,34,34
"340561406",90,80,170,53,57,50
"340561407",107,83,190,60,61,57
"340561408",460,351,811,196,210,195
"340561409",677,614,1291,316,340,304
"340561501",297,230,527,159,172,156
"340561502",50,38,88,28,41,28
"340561503",143,122,265,71,97,69
"340561504",34,15,49,27,28,27
"340561505",11,3,14,7,7,7
"340561506",286,292,578,161,174,159
"340561507",342,340,682,184,221,181
"340561508",455,484,939,255,284,242
"340561509",381,442,823,236,271,233
"340561510",494,506,1000,254,270,246
"340561511",393,414,807,233,256,233
"340561512",519,525,1044,266,295,260
"340561513",394,390,784,212,266,198
"340561601",118,80,198,62,76,60
"340561602",34,22,56,16,23,16
"340561603",36,14,50,20,33,20
"340561604",127,109,236,64,73,63
"340561701",56,43,99,32,39,30
"340561702",72,29,101,34,37,30
"340561801",146,125,271,72,80,67
"340561802",111,83,194,61,65,57
"340561803",27,12,39,14,14,14
"340630101",976,917,1893,373,401,369
"340630102",1294,1226,2520,456,447,432
"340630201",719,667,1386,276,295,270
"340630202",910,854,1764,378,360,345
"340630203",666,514,1180,241,257,234
"340630204",818,835,1653,358,352,326
"340630205",706,750,1456,319,316,304
"340630206",378,364,742,192,248,188
"340630207",550,610,1160,203,257,197
"381120402",74,86,160,49,142,48
"381050402",129,128,257,62,136,57
"381050102",119,138,257,77,181,74
"380980101",141,155,296,65,123,65
"380980501",117,125,242,64,82,62
"380940102",295,295,590,193,299,163
"380840401",82,82,164,42,83,36
"380770202",174,173,347,82,138,64
"380840102",83,101,184,52,122,49
"380560103",113,88,201,65,138,64
"380211303",88,154,242,43,169,41
"380140506",301,252,553,142,226,139
"380070504",108,109,217,79,169,78
"380070303",141,159,300,92,193,86
"380070402",125,149,274,73,147,65
"380560201",273,236,509,144,314,130
"381120111",500,566,1066,264,278,227
"380700205",390,392,782,182,202,171
"380700105",693,664,1357,315,349,309
"380630519",393,458,851,236,257,236
"380630407",586,658,1244,358,341,309
"380420612",422,465,887,210,191,184
"380420501",715,737,1452,350,331,302
"380630616",581,626,1207,294,279,259
"380420409",550,573,1123,263,269,258
"380350616",817,773,1590,355,324,312
"380350613",662,722,1384,331,320,315
"380350610",760,689,1449,351,311,278
"380350606",722,720,1442,361,351,304
"380350604",778,794,1572,381,352,330
"380211519",248,212,460,185,422,185
"380211517",283,289,572,185,385,150
"380211502",321,323,644,182,418,178
"380211419",658,702,1360,285,300,270
"380211418",704,734,1438,315,323,307
"380211414",896,926,1822,415,407,376
"380211411",512,535,1047,240,248,224
"381120109",485,583,1068,281,315,223
"381120108",491,575,1066,268,291,245
"380980204",334,315,649,143,209,112
"381120103",440,492,932,260,260,201
"380211408",919,910,1829,404,277,261
"380211211",494,500,994,275,266,225
"380211204",574,591,1165,294,274,255
"380211115",375,430,805,232,212,187
"380211107",470,526,996,261,260,248
"380211102",500,569,1069,284,306,272
"380210902",326,340,666,219,250,164
"380210811",428,445,873,254,256,213
"380210707",424,577,1001,347,408,343
"380210706",185,272,457,176,265,164
"380210720",372,413,785,245,249,198
"380210613",294,370,664,208,254,193
"380210526",333,386,719,169,161,150
"380210904",204,248,452,140,102,87
"380140305",879,853,1732,368,324,285
"380210606",87,93,180,66,106,60
"380350405",0,0,0,0,212,0
"380350507",569,620,1189,363,357,327
"380350506",493,533,1026,232,221,212
"380350501",649,698,1347,385,373,335
"380350414",634,655,1289,298,236,223
"380350111",607,570,1177,248,273,233
"380350511",257,345,602,196,215,193
"380350211",795,743,1538,378,418,363
"380280412",276,306,582,146,222,126
"380070108",587,657,1244,325,370,283
"380070107",430,422,852,259,341,213
"380210516",508,546,1054,291,350,283
"380210515",500,506,1006,247,233,228
"380210514",741,777,1518,414,323,293
"380210504",765,819,1584,445,426,377
"380210415",504,574,1078,288,334,275
"380210906",899,452,1351,311,264,228
"380210813",361,415,776,229,221,203
"380140714",443,461,904,216,263,209
"380140707",509,529,1038,261,290,256
"380140601",469,570,1039,305,304,263
"381120503",87,94,181,51,116,51
"381050205",275,263,538,179,270,168
"380700505",113,100,213,44,76,43
"380630109",402,356,758,169,284,158
"380630106",637,529,1166,265,289,262
"380420607",794,808,1602,373,358,348
"380211212",498,552,1050,279,280,244
"380350217",579,560,1139,272,302,266
"380070405",82,96,178,42,74,40
"380070105",462,502,964,239,320,216
"380210107",309,353,662,179,237,160
"380140704",111,103,214,59,277,58
"380280401",176,217,393,153,251,138
"380350303",28,45,73,16,16,16
"380350301",56,28,84,41,61,41
"380280402",135,132,267,89,160,87
"380140104",256,203,459,127,107,84
"380980202",29,24,53,15,24,11
"380940603",33,23,56,16,40,16
"380940601",34,27,61,18,20,18
"380560102",307,247,554,153,228,147
"380560101",21,10,31,15,28,15
"380490102",76,105,181,58,102,57
"380420302",98,98,196,39,35,32
"380770102",77,96,173,52,113,51
"380700401",50,31,81,23,27,21
"380140502",373,309,682,190,185,131
"380940103",333,348,681,206,371,195
"380840301",66,95,161,44,56,20
"380770201",73,64,137,54,106,49
"380770101",133,154,287,76,139,73
"380490105",100,121,221,50,73,39
"380420204",149,109,258,73,100,65
"380140105",765,660,1425,328,326,180
"380070401",28,33,61,22,67,22
"380280101",166,170,336,87,214,83
"380210406",397,394,791,217,329,206
"380140303",289,239,528,142,287,138
"380140401",895,787,1682,427,578,337
"380070503",197,215,412,129,158,92
"380140106",157,154,311,83,92,73
"380840101",181,163,344,82,122,71
"380630513",290,314,604,198,213,183
"380210823",454,473,927,251,248,223
"380940405",614,628,1242,315,406,283
"380940505",305,329,634,160,239,147
"380630614",539,561,1100,279,294,274
"380630611",415,431,846,228,234,226
"380630610",179,197,376,97,110,94
"380630606",128,164,292,97,227,94
"380630605",236,253,489,171,321,169
"380630518",422,432,854,211,212,206
"380630515",571,556,1127,315,315,280
"380630507",368,431,799,275,295,272
"380630501",645,657,1302,316,338,309
"380420603",480,534,1014,273,279,251
"380630617",491,527,1018,244,223,206
"380420408",634,644,1278,344,357,321
"380350614",797,812,1609,348,354,334
"380350608",491,481,972,246,254,232
"380280408",227,315,542,173,230,151
"380211511",618,725,1343,383,471,380
"380211510",566,625,1191,312,350,298
"380211503",152,172,324,82,222,82
"380211501",733,779,1512,387,403,373
"380211417",967,1053,2020,461,460,422
"380211404",684,716,1400,315,325,310
"380211322",550,603,1153,276,267,263
"380211315",623,672,1295,321,334,318
"380211313",705,803,1508,383,392,368
"380211219",594,655,1249,349,407,346
"380211216",366,411,777,208,222,202
"380211213",401,398,799,213,194,171
"380211201",531,544,1075,283,296,258
"380211008",508,516,1024,324,361,263
"380211001",555,577,1132,350,368,310
"380210901",571,608,1179,405,372,320
"380210810",428,473,901,234,244,223
"380210721",273,304,577,190,220,190
"380210712",365,409,774,273,281,254
"380210711",516,562,1078,262,224,206
"380210704",499,523,1022,267,220,213
"380210818",593,650,1243,308,261,247
"380210615",279,409,688,252,323,169
"380210610",225,360,585,257,393,244
"380210602",433,506,939,219,210,198
"380210523",572,651,1223,286,284,271
"380210603",730,757,1487,386,421,364
"380140411",678,662,1340,342,304,252
"380140410",635,616,1251,307,241,220
"380140513",550,589,1139,281,270,233
"380350517",304,361,665,212,216,184
"380350412",775,751,1526,362,343,319
"380070111",381,432,813,183,229,173
"380210517",443,465,908,276,294,265
"380210513",662,689,1351,374,303,271
"380210501",463,495,958,282,344,276
"380210419",166,165,331,91,135,89
"380210410",482,493,975,246,248,217
"380210709",368,509,877,235,358,225
"380210110",301,329,630,166,195,164
"380140710",866,882,1748,377,371,357
"380140703",107,111,218,57,227,55
"380140607",561,535,1096,307,204,191
"380140605",623,629,1252,319,264,231
"380140508",675,751,1426,426,440,389
"380210608",514,515,1029,243,228,213
"380700403",610,555,1165,265,283,255
"380630204",241,205,446,106,122,105
"380630107",454,401,855,168,168,144
"380420503",631,638,1269,296,299,262
"380211301",709,729,1438,385,445,374
"380210619",553,565,1118,259,242,232
"380210616",365,428,793,253,371,220
"380210601",393,446,839,275,200,182
"380140406",878,886,1764,396,333,302
"380280505",453,367,820,188,241,186
"380211402",684,763,1447,326,329,311
"380211311",747,750,1497,319,277,270
"380350104",17,12,29,10,14,10
"380210302",30,19,49,18,33,18
"380210301",27,18,45,14,17,12
"380140501",436,409,845,214,309,204
"380070301",56,62,118,60,89,52
"381050203",12,7,19,12,29,8
"380980201",17,19,36,11,12,10
"380980102",33,50,83,39,79,38
"380940302",51,59,110,41,79,39
"380940101",18,20,38,10,30,10
"380560304",14,11,25,12,16,11
"380420202",95,99,194,45,55,44
"380420103",26,19,45,14,23,14
"380840501",23,30,53,14,66,12
"380700602",58,15,73,22,35,22
"380350203",0,0,0,0,1,0
"381120302",225,255,480,147,256,116
"380840403",68,86,154,44,78,40
"380840302",293,329,622,137,207,112
"380350102",162,148,310,66,80,58
"380280203",211,167,378,117,265,117
"380070403",325,302,627,152,263,126
"380070101",276,363,639,165,245,164
"380700207",233,258,491,122,173,116
"380940408",338,352,690,175,229,162
"380940406",372,418,790,227,336,195
"380700106",775,769,1544,367,387,336
"380630612",342,368,710,210,244,207
"380630520",467,455,922,206,215,194
"380630411",365,407,772,225,243,209
"380630402",442,452,894,243,249,234
"380630409",504,528,1032,290,293,255
"380420606",343,408,751,234,260,225
"380420601",435,501,936,236,245,234
"380420513",491,505,996,253,280,232
"380420508",434,468,902,239,224,197
"380420403",628,640,1268,325,328,280
"380420407",735,739,1474,386,359,323
"380420406",416,463,879,236,252,219
"380280406",309,366,675,213,314,186
"380211509",388,392,780,193,339,186
"380211412",605,687,1292,316,325,304
"381120114",327,365,692,221,274,185
"381120110",603,623,1226,316,280,228
"380980404",195,233,428,126,209,124
"380211403",608,700,1308,324,338,316
"380211320",439,487,926,225,227,209
"380211215",506,572,1078,293,329,284
"380211209",510,653,1163,311,309,288
"380211205",528,584,1112,247,221,215
"380211117",524,580,1104,297,316,280
"380211012",439,491,930,270,261,222
"380211004",454,464,918,243,255,217
"380211002",620,751,1371,348,352,320
"380210919",269,295,564,164,172,160
"380210916",893,889,1782,408,373,358
"380210912",754,744,1498,421,365,318
"380210910",577,631,1208,387,294,244
"380210717",576,673,1249,365,379,333
"380210701",576,637,1213,330,397,303
"380140516",429,452,881,241,252,221
"380140412",422,405,827,162,164,122
"380140701",431,407,838,180,187,172
"380350515",723,706,1429,387,367,335
"380350210",519,553,1072,266,277,256
"380350204",352,392,744,205,211,194
"380350107",653,593,1246,269,263,246
"380350212",448,428,876,237,256,228
"380350114",503,455,958,191,201,180
"380210816",746,883,1629,416,335,312
"380210518",399,424,823,212,215,186
"380210510",892,970,1862,439,431,395
"380210506",321,324,645,195,208,167
"380210814",480,479,959,304,289,276
"380210108",681,650,1331,327,509,309
"380210109",100,116,216,72,175,72
"380140711",1223,1225,2448,459,395,373
"380140708",717,703,1420,322,311,300
"380140706",467,445,912,205,226,198
"380140705",426,481,907,193,182,176
"381120112",458,509,967,261,270,201
"380630112",54,55,109,24,31,23
"380560104",351,404,755,203,242,181
"380350618",712,724,1436,345,334,321
"380210815",400,458,858,217,196,175
"380940507",258,272,530,162,268,161
"380940104",310,328,638,154,213,142
"380840502",186,241,427,79,89,56
"380350207",83,62,145,56,283,56
"380280602",179,197,376,116,228,107
"380211305",579,634,1213,305,326,282
"380070204",557,647,1204,274,372,268
"380140616",537,542,1079,288,277,244
"380280502",156,200,356,103,204,81
"380280301",298,257,555,151,225,147
"380280102",104,130,234,69,163,58
"380210306",20,17,37,12,15,12
"380070102",58,65,123,39,147,38
"381120301",51,54,105,40,104,40
"380980401",63,58,121,30,55,29
"380980303",50,30,80,31,59,31
"380940502",82,76,158,42,51,34
"380700601",53,41,94,35,56,33
"380350305",27,2,29,14,21,13
"380700203",335,252,587,164,220,162
"380490202",63,38,101,46,80,45
"380350302",41,32,73,18,19,18
"380770303",100,119,219,80,126,77
"380490301",126,146,272,66,149,60
"380490101",36,38,74,19,38,18
"380420104",306,277,583,162,353,153
"380280201",128,103,231,75,181,75
"380210405",540,495,1035,253,340,239
"380210404",119,110,229,73,105,71
"380140503",632,647,1279,340,531,323
"380140202",32,32,64,19,40,19
"381050301",92,77,169,65,162,64
"380280303",242,266,508,134,196,123
"380630602",545,561,1106,304,322,279
"380630517",379,405,784,209,209,199
"380630403",427,503,930,268,291,258
"380630401",667,673,1340,339,358,334
"380630208",475,491,966,236,248,215
"380630206",666,649,1315,365,382,344
"380630421",479,545,1024,264,276,253
"380630124",729,817,1546,449,403,254
"380420512",691,743,1434,374,367,330
"380420411",600,683,1283,314,340,311
"380630509",562,586,1148,251,260,243
"380420205",516,510,1026,238,242,201
"380350615",648,698,1346,294,302,291
"380280205",83,61,144,39,76,39
"380280404",320,340,660,195,346,184
"380211514",534,589,1123,285,295,281
"380211512",585,626,1211,289,294,276
"380211504",239,261,500,136,328,95
"380211410",492,478,970,215,201,194
"381120205",536,573,1109,259,345,215
"381120204",82,96,178,52,98,50
"380211407",930,957,1887,430,412,399
"380211319",612,666,1278,283,284,275
"380211309",687,704,1391,310,285,279
"380211314",486,499,985,232,213,198
"380211220",735,835,1570,341,330,314
"380211118",253,266,519,140,146,130
"380211110",568,622,1190,392,358,316
"380211109",329,342,671,155,176,149
"380211104",479,495,974,273,221,201
"380211013",461,502,963,292,308,265
"380210911",753,823,1576,482,372,331
"380210903",268,341,609,198,205,180
"380210824",444,420,864,238,234,221
"380210806",598,747,1345,364,347,322
"380210803",222,260,482,169,176,131
"380210819",568,569,1137,293,227,211
"380210621",432,434,866,243,240,223
"380210604",741,751,1492,330,284,283
"380140206",249,248,497,93,102,90
"380350509",267,270,537,173,209,147
"380350406",0,0,0,0,280,0
"380350110",483,447,930,214,236,204
"380350105",645,656,1301,315,330,291
"380280410",553,633,1186,278,372,259
"380140618",653,663,1316,273,207,203
"380140617",625,623,1248,241,203,190
"380210509",504,552,1056,254,224,220
"380210412",559,566,1125,307,367,277
"380210408",176,168,344,92,104,86
"380140716",782,788,1570,358,395,324
"380140715",417,461,878,211,216,206
"380140709",661,698,1359,308,278,264
"380140611",753,771,1524,311,226,222
"380140609",975,1044,2019,457,438,423
"380140606",514,560,1074,312,225,196
"380140603",437,473,910,295,324,250
"381120304",121,90,211,54,111,51
"381120206",83,104,187,51,125,50
"381120116",350,404,754,228,227,187
"381120115",404,508,912,231,249,202
"380770103",154,151,305,81,180,78
"380630111",501,461,962,211,210,204
"380420208",720,764,1484,334,372,330
"380420207",258,269,527,124,147,122
"380350619",409,414,823,210,206,197
"380350617",818,854,1672,413,438,396
"380210913",538,670,1208,357,340,317
"380210618",660,712,1372,273,273,264
"380140407",725,749,1474,377,321,291
"380140115",25,20,45,12,16,12
"380350115",342,347,689,115,122,105
"380280503",325,252,577,173,251,169
"380140102",175,150,325,81,92,47
"380070203",48,51,99,44,122,44
"381120602",68,89,157,51,68,50
"381120501",85,102,187,68,175,68
"381120203",81,81,162,48,103,47
"381050302",44,30,74,24,51,22
"380980403",123,134,257,66,107,64
"380980302",36,40,76,31,53,30
"380980502",33,55,88,32,48,27
"380940403",212,215,427,117,186,106
"380940202",33,29,62,24,54,23
"380700503",26,4,30,18,32,18
"380700303",25,12,37,13,19,13
"380700102",15,5,20,13,18,13
"380560301",10,4,14,7,9,7
"380420201",122,107,229,66,68,59
"380420101",100,68,168,63,82,61
"381120101",155,166,321,92,118,87
"381050101",13,13,26,13,63,13
"380700201",78,27,105,45,77,45
"380210203",11,0,11,4,6,4
"380210102",46,34,80,32,36,32
"381120202",246,256,502,133,251,122
"380940402",498,497,995,255,301,195
"380840201",175,120,295,80,174,78
"380630103",576,529,1105,288,348,285
"380630101",30,20,50,23,28,23
"380560202",389,350,739,216,324,197
"380280202",122,105,227,58,123,58
"380140201",544,461,1005,253,237,182
"380490303",529,143,672,55,73,51
"380940407",344,359,703,178,218,148
"380630613",702,744,1446,368,314,298
"380630603",2,0,2,0,175,0
"380630514",411,487,898,285,285,252
"380630417",337,365,702,241,290,215
"380630416",329,376,705,232,283,218
"380630404",645,708,1353,357,370,325
"380630410",476,486,962,263,266,233
"380420507",438,495,933,265,234,192
"380420414",811,816,1627,374,413,351
"380420402",644,651,1295,346,365,313
"380420412",269,277,546,142,289,137
"380420206",274,258,532,127,136,114
"380420405",471,560,1031,243,240,222
"380350609",473,423,896,209,186,173
"380350607",531,543,1074,278,249,234
"380350601",769,809,1578,342,292,282
"380280204",71,70,141,40,92,40
"380350112",350,378,728,196,211,176
"380211518",716,803,1519,429,470,395
"380211507",496,523,1019,257,307,244
"381120113",553,583,1136,265,266,229
"380211406",788,836,1624,360,226,213
"380211317",553,634,1187,294,299,284
"380211306",447,413,860,237,270,225
"380211221",648,690,1338,348,416,342
"380211218",513,517,1030,240,234,216
"380211108",757,814,1571,434,413,362
"380211106",428,473,901,239,229,224
"380211101",616,719,1335,320,292,282
"380211014",712,728,1440,347,329,309
"380211010",466,584,1050,312,310,282
"380211005",715,736,1451,359,344,305
"380211003",496,599,1095,287,259,241
"380210921",406,449,855,216,193,178
"380210920",446,531,977,286,300,275
"380210827",288,354,642,233,273,220
"380210825",345,396,741,236,234,215
"380210702",323,388,711,204,213,185
"380210524",648,700,1348,398,420,381
"380210521",586,617,1203,337,400,310
"380210520",592,666,1258,354,431,351
"380140515",798,778,1576,335,284,279
"380140511",618,667,1285,351,354,306
"380210605",229,311,540,166,283,148
"380140205",556,541,1097,266,218,201
"380350408",892,843,1735,394,374,350
"380350508",329,371,700,205,206,188
"380350415",403,428,831,202,208,202
"380350209",131,108,239,85,241,84
"380350106",845,767,1612,369,376,339
"380210511",400,470,870,248,241,218
"380210502",479,548,1027,299,294,263
"380210407",89,76,165,45,45,45
"380140702",147,152,299,77,240,75
"380140615",872,834,1706,397,302,283
"380140614",537,547,1084,260,208,185
"380140613",586,557,1143,251,212,203
"380140608",543,538,1081,288,208,189
"380140510",415,491,906,274,301,250
"380840303",601,513,1114,205,247,185
"380840202",107,118,225,66,128,61
"380700504",273,239,512,136,150,109
"380700206",348,368,716,177,238,168
"380700107",232,242,474,119,148,113
"380630203",288,303,591,156,198,147
"380210802",477,521,998,317,316,288
"380210705",573,614,1187,376,390,351
"380210620",362,365,727,178,175,160
"380210617",534,564,1098,240,215,209
"380210609",206,288,494,183,245,170
"380210503",635,660,1295,390,410,373
"380210416",245,273,518,140,160,135
"380140408",633,681,1314,311,211,201
"380350208",102,88,190,58,206,57
"380350206",67,71,138,56,358,56
"380211505",353,394,747,193,298,187
"380070106",377,371,748,196,259,156
"380070104",118,137,255,57,131,55
"380140717",402,367,769,169,196,154
"380280501",37,46,83,33,71,33
"380210403",16,17,33,12,19,12
"380210401",4,4,8,4,19,4
"380140402",523,462,985,258,334,239
"380140301",245,190,435,132,214,131
"380070502",54,70,124,36,79,36
"380140103",365,326,691,143,128,105
"381120603",38,34,72,27,57,27
"381120601",44,63,107,41,65,41
"381120401",24,25,49,19,64,19
"381050303",33,22,55,20,37,20
"381050201",31,19,50,30,47,30
"380980203",243,229,472,148,217,122
"380560303",35,24,59,24,32,24
"380350401",232,192,424,128,275,122
"380940602",40,23,63,20,40,20
"380350201",2,0,2,2,2,1
"381120502",194,208,402,114,313,112
"381120303",155,202,357,116,269,109
"380490302",155,176,331,91,172,89
"380210103",218,210,428,131,254,128
"380140405",633,600,1233,303,510,284
"380770301",235,213,448,142,252,116
"380350101",603,539,1142,283,351,262
"381120604",108,125,233,61,131,59
"380350416",750,750,1500,354,428,339
"380770304",109,134,243,64,130,63
"380940506",329,315,644,180,295,178
"380940503",279,282,561,162,213,142
"380700508",410,429,839,152,153,146
"380700204",879,882,1761,411,457,384
"380630608",0,0,0,0,261,0
"380630607",636,705,1341,335,344,311
"380630604",45,29,74,25,331,24
"380630516",529,560,1089,313,317,293
"380630512",376,470,846,251,285,247
"380630508",526,587,1113,300,300,263
"380630502",751,735,1486,349,378,332
"380630413",720,738,1458,376,359,332
"380630412",434,463,897,233,231,217
"380630418",575,557,1132,279,272,242
"380630209",220,196,416,96,96,89
"380420605",382,422,804,233,250,228
"380420413",495,509,1004,235,291,221
"380350603",714,695,1409,337,437,289
"380280403",413,455,868,221,260,197
"380211515",377,419,796,236,273,234
"380211416",578,579,1157,255,254,235
"380350510",624,563,1187,352,321,274
"380980405",532,589,1121,303,379,274
"381120105",344,421,765,218,311,194
"380980205",134,108,242,62,79,58
"380211405",947,855,1802,347,346,330
"380211312",635,678,1313,323,319,296
"380211307",805,810,1615,408,477,385
"380211210",587,598,1185,310,299,283
"380211203",802,905,1707,403,370,345
"380211202",576,621,1197,359,383,347
"380211111",569,607,1176,294,282,267
"380211006",540,557,1097,284,278,246
"380210915",672,715,1387,320,315,303
"380210914",473,515,988,271,236,223
"380210821",485,531,1016,261,223,212
"380210808",739,784,1523,431,415,369
"380210801",317,352,669,219,254,189
"380210713",290,366,656,220,252,206
"380210703",161,127,288,67,48,43
"380140514",725,773,1498,320,253,245
"380140512",513,572,1085,269,230,202
"380210607",264,363,627,256,401,246
"380350504",731,752,1483,332,304,297
"380350503",633,686,1319,296,291,278
"380350513",384,435,819,254,287,204
"380350413",716,686,1402,295,300,275
"380350409",640,650,1290,338,332,300
"380350214",392,375,767,198,226,188
"380280409",320,363,683,157,192,148
"380210812",594,697,1291,397,403,352
"380070109",569,654,1223,284,323,252
"380210512",503,546,1049,326,309,290
"380210417",542,593,1135,292,317,270
"380210708",296,308,604,186,227,186
"380140712",1118,1100,2218,448,381,363
"380140602",598,648,1246,312,283,252
"380140507",663,651,1314,349,327,291
"381050103",200,216,416,115,217,104
"380490106",175,176,351,90,166,85
"380420609",859,865,1724,404,357,345
"380420105",194,208,402,110,115,104
"380350404",538,524,1062,243,257,232
"380210922",485,505,990,285,269,253
"380210612",270,288,558,160,262,153
"380140116",362,338,700,153,129,121
"380280411",522,596,1118,290,366,273
"380211520",54,51,105,40,41,38
"380210304",47,28,75,25,32,25
"380140505",47,41,88,32,77,29
"380140404",788,625,1413,369,437,361
"380140101",89,82,171,53,64,50
"380940203",19,15,34,11,14,10
"380770203",94,98,192,65,103,59
"380700402",68,48,116,38,41,34
"380700301",53,7,60,27,43,26
"380940301",38,33,71,25,35,19
"380490104",40,57,97,27,44,27
"380350103",19,7,26,3,6,3
"380210305",76,48,124,39,57,38
"381050202",142,116,258,79,160,70
"380980402",146,127,273,69,86,53
"380630104",628,559,1187,292,404,260
"380070404",87,111,198,62,99,62
"380070202",56,68,124,41,79,41
"380140204",465,387,852,221,259,197
"380140203",733,628,1361,324,410,299
"380770302",78,85,163,72,150,69
"380630303",384,254,638,174,224,168
"380630301",278,267,545,126,147,109
"380350403",192,163,355,91,103,72
"380770204",152,134,286,78,116,60
"380700404",687,669,1356,307,350,301
"380630609",275,283,558,151,230,150
"380630601",557,610,1167,287,301,282
"380630510",559,555,1114,270,280,261
"380630506",219,279,498,167,173,155
"380630419",450,471,921,264,270,241
"380630408",374,365,739,196,191,165
"380560105",319,356,675,183,210,171
"380420611",455,485,940,231,203,195
"380420604",568,600,1168,311,336,289
"380420511",447,458,905,230,235,203
"380420509",617,642,1259,354,341,307
"380420505",599,574,1173,263,273,243
"380420504",539,529,1068,271,265,231
"380420502",604,607,1211,287,283,247
"380420410",523,592,1115,261,280,254
"380420404",745,726,1471,354,360,319
"380350612",624,611,1235,282,282,269
"380350611",544,567,1111,267,256,241
"380350605",542,547,1089,272,269,247
"380280103",143,177,320,80,170,77
"380211513",371,430,801,215,253,186
"380211506",437,473,910,226,276,216
"380211413",499,563,1062,220,203,193
"381120107",424,495,919,239,275,225
"381120106",422,462,884,242,256,195
"381120102",376,460,836,238,277,187
"380211401",538,579,1117,285,291,270
"380211321",382,424,806,196,204,194
"380211316",524,591,1115,283,299,280
"380211310",587,632,1219,279,277,254
"380211308",780,848,1628,366,370,351
"380211214",768,829,1597,418,428,370
"380211208",332,422,754,209,228,199
"380211207",710,759,1469,367,340,330
"380211116",430,504,934,289,272,237
"380211114",426,465,891,272,231,204
"380211112",349,422,771,237,252,213
"380211105",610,695,1305,349,355,328
"380210923",231,236,467,127,163,120
"380211113",463,511,974,294,307,264
"380210907",511,577,1088,342,257,227
"380210822",544,602,1146,285,240,217
"380210809",524,522,1046,297,293,256
"380210714",390,462,852,300,291,263
"380210614",545,545,1090,254,263,245
"380210527",378,363,741,200,266,199
"380210525",290,327,617,215,244,173
"380140304",1303,1324,2627,547,547,476
"380350215",335,376,711,206,220,194
"380350109",670,629,1299,279,326,270
"380350213",307,289,596,183,183,159
"380280415",356,377,733,215,263,187
"380280414",239,256,495,145,277,144
"380210507",526,565,1091,305,274,248
"380210505",475,542,1017,276,250,228
"380210418",218,218,436,128,160,117
"380210718",315,406,721,215,220,195
"380210411",554,545,1099,282,325,265
"380210409",757,830,1587,424,430,372
"380210905",588,646,1234,375,355,323
"380210307",624,604,1228,295,336,279
"380140713",776,804,1580,381,318,295
"380140610",435,486,921,221,212,205
"380140604",686,739,1425,394,327,286
"380140517",241,256,497,117,218,115
"381120104",521,592,1113,310,304,229
"381050204",129,134,263,84,148,80
"380700506",743,712,1455,357,343,310
"380630119",871,845,1716,336,214,191
"380630110",517,536,1053,253,260,244
"380560203",93,83,176,55,105,53
"380420608",476,523,999,267,287,250
"380210715",497,635,1132,399,427,370
"380210519",515,510,1025,229,210,202
"380140117",438,426,864,189,213,176
"380350205",359,368,727,219,220,184
"380211304",460,507,967,224,229,220
"380700302",26,9,35,13,18,13
"380350304",28,16,44,14,23,14
"380210303",108,101,209,64,64,36
"380210104",13,12,25,9,20,9
"380210101",22,23,45,21,34,21
"380140108",211,194,405,101,163,100
"380140403",545,445,990,301,402,288
"381050401",35,34,69,17,100,17
"380840402",36,12,48,9,21,8
"380420301",211,189,400,100,151,95
"380420203",4,1,5,3,5,3
"380420102",16,12,28,10,15,10
"380560302",10,5,15,6,12,6
"380280302",116,92,208,100,230,100
"380211302",33,13,46,14,20,11
"380700101",390,315,705,239,202,121
"380940401",121,121,242,81,121,69
"380700502",191,174,365,96,223,76
"380630202",188,145,333,100,189,97
"380630102",122,144,266,105,147,99
"380210105",230,218,448,135,176,132
"380210201",91,96,187,47,59,47
"380140302",577,513,1090,275,362,186
"380070302",58,71,129,48,126,46
"380700501",522,509,1031,218,241,200
"380630201",69,57,126,40,47,35
"380700507",616,600,1216,282,223,202
"380630615",607,697,1304,318,332,308
"380630511",956,912,1868,400,418,389
"380630505",319,408,727,267,322,256
"380630504",333,381,714,250,332,240
"380630503",527,552,1079,262,274,255
"380630414",677,703,1380,327,302,275
"380630205",104,77,181,43,84,43
"380630406",724,716,1440,316,316,289
"380630405",671,688,1359,371,355,321
"380630207",702,652,1354,359,380,337
"380630420",653,640,1293,315,331,309
"380420613",619,616,1235,296,286,269
"380420610",777,816,1593,353,313,301
"380630618",442,501,943,226,242,223
"380420602",511,506,1017,322,317,267
"380420510",462,462,924,266,266,241
"380420506",663,674,1337,315,320,273
"380420401",852,775,1627,388,398,349
"380350602",681,710,1391,354,359,336
"380280407",465,541,1006,246,317,227
"380280405",333,359,692,190,227,175
"380211516",145,158,303,90,469,90
"380211508",527,582,1109,284,320,280
"380211415",787,872,1659,375,350,338
"381120117",542,582,1124,252,353,227
"380211409",811,832,1643,377,369,346
"380211318",374,421,795,204,212,196
"380211217",452,508,960,254,272,237
"380211206",707,749,1456,354,336,305
"380211103",629,635,1264,316,315,266
"380211011",296,384,680,223,248,207
"380211009",560,654,1214,402,406,339
"380211007",669,669,1338,352,331,299
"380210918",656,726,1382,417,419,375
"380210917",602,660,1262,328,292,268
"380210909",355,404,759,245,265,214
"380210908",469,491,960,303,263,234
"380210826",412,479,891,261,218,198
"380210820",288,302,590,143,136,123
"380210807",691,728,1419,394,360,325
"380210805",480,505,985,292,237,213
"380210804",379,408,787,209,223,196
"380210716",631,726,1357,439,439,385
"380210611",477,502,979,256,266,236
"380210817",468,528,996,283,250,229
"380140409",906,938,1844,431,342,309
"380140414",658,663,1321,264,331,259
"380140413",699,722,1421,321,280,224
"380350516",909,932,1841,449,458,426
"380350514",513,573,1086,314,311,273
"380350407",590,588,1178,266,232,213
"380350505",508,509,1017,253,243,237
"380350502",564,630,1194,293,282,271
"380350411",473,504,977,254,242,220
"380350410",640,674,1314,362,294,275
"380350216",300,305,605,165,256,156
"380350512",224,259,483,171,155,121
"380350108",560,516,1076,262,301,215
"380350113",384,400,784,211,213,201
"380280413",477,539,1016,252,305,234
"380140619",633,603,1236,266,218,204
"380070110",293,316,609,173,186,143
"380210719",532,580,1112,294,258,234
"380210710",287,467,754,250,341,203
"380210414",377,411,788,222,276,205
"380210413",642,621,1263,300,301,251
"380140718",278,274,552,105,94,78
"380140612",607,628,1235,276,249,238
"380140509",632,632,1264,315,289,269
"380630415",733,824,1557,402,430,379
"380630108",97,93,190,49,47,36
"380560204",340,373,713,156,137,130
"380350306",380,418,798,193,238,190
"380940504",391,421,812,210,296,191
"380940404",345,351,696,187,231,149
"380210522",538,596,1134,276,255,243
"380210508",482,480,962,250,218,206
"380280504",446,421,867,176,249,173
"380070205",266,310,576,137,257,134
"380070103",32,35,67,19,38,9
"380210106",313,352,665,180,258,172
"380350202",4,4,8,2,4,2
"380280601",41,48,89,40,63,40
"380210204",9,6,15,5,5,5
"380210202",54,51,105,54,78,48
"380140504",113,70,183,78,157,76
"380140109",384,319,703,182,266,174
"380140107",438,348,786,230,405,228
"380070501",120,151,271,79,102,79
"380070201",103,104,207,64,120,62
"381120201",77,109,186,58,108,46
"380980301",80,61,141,49,61,39
"380940201",44,47,91,30,60,30
"380630302",128,99,227,59,70,50
"380490201",68,72,140,38,60,36
"380490103",22,26,48,13,23,13
"380940501",359,371,730,198,272,150
"380700202",286,224,510,169,242,163
"380210402",206,188,394,100,127,95
"421120312",503,416,919,296,412,278
"420560506",189,154,343,124,198,123
"420490103",242,213,455,161,235,138
"421540601",158,131,289,115,146,115
"420280102",25,21,46,20,41,20
"421540517",464,561,1025,241,258,238
"421540504",306,318,624,212,275,207
"421470109",283,314,597,196,236,194
"421400216",247,209,456,166,247,165
"421400215",219,195,414,140,243,139
"421400209",313,343,656,203,240,199
"421400205",275,271,546,174,188,174
"421400203",313,354,667,178,197,172
"421400202",370,356,726,199,259,198
"421330508",381,447,828,283,316,283
"421330503",279,279,558,205,269,199
"421260207",145,144,289,85,90,82
"421260102",326,361,687,241,329,235
"421190101",278,268,546,212,243,206
"421120310",100,54,154,45,115,45
"421120309",379,367,746,181,251,177
"421050808",341,313,654,229,268,219
"421050805",530,532,1062,316,318,301
"421050801",805,870,1675,428,445,423
"421050713",475,477,952,280,273,250
"421050416",161,196,357,154,233,154
"421050414",256,293,549,235,333,231
"421050412",244,263,507,199,229,188
"421050411",251,258,509,212,243,201
"421050501",187,190,377,131,167,128
"420980401",161,140,301,95,129,93
"420700201",501,434,935,354,408,348
"420560516",445,486,931,245,251,241
"420350701",138,153,291,113,153,113
"420350411",201,202,403,141,170,137
"420350407",237,246,483,215,242,197
"420210907",451,482,933,331,355,323
"420210902",327,381,708,301,375,297
"420210823",222,237,459,149,169,146
"420210821",483,560,1043,299,311,294
"420210811",233,252,485,201,234,196
"420210807",295,302,597,259,284,246
"420210723",416,402,818,254,286,239
"420210717",237,289,526,218,248,215
"420210601",351,341,692,209,231,199
"420210509",274,295,569,210,227,207
"420210408",358,375,733,263,301,261
"420210402",359,344,703,225,242,221
"420210310",438,426,864,292,331,287
"420210303",449,420,869,275,361,268
"420210117",244,229,473,119,142,118
"420210112",624,676,1300,276,274,270
"420210111",463,531,994,272,262,260
"420070403",190,215,405,177,208,173
"420700507",379,405,784,282,354,280
"420210610",10,64,74,2,2,2
"420210818",345,379,724,209,216,201
"420210817",344,362,706,212,218,196
"420211006",492,512,1004,272,282,270
"420210614",279,355,634,296,400,284
"420210612",160,213,373,191,310,189
"421330211",317,310,627,180,210,176
"421330212",204,207,411,115,128,113
"421120303",413,391,804,272,310,264
"421051005",434,452,886,309,336,293
"420980106",181,170,351,135,155,131
"420770301",287,310,597,241,329,240
"421470108",29,21,50,15,30,15
"421470210",50,45,95,32,64,31
"421330507",35,28,63,24,54,24
"421330206",39,19,58,19,35,19
"421330103",21,10,31,13,48,13
"421260303",13,7,20,8,26,8
"421260205",187,179,366,109,154,107
"421190309",2,0,2,1,3,1
"421120319",6,2,8,5,6,5
"421120316",20,10,30,9,12,9
"421120201",31,13,44,25,30,25
"420840207",5,3,8,4,8,4
"420350202",138,73,211,78,142,78
"420210208",21,11,32,14,32,14
"420210207",20,15,35,12,20,12
"420070505",19,20,39,15,36,14
"420070408",14,5,19,9,21,9
"420070407",25,15,40,17,33,17
"420770204",24,15,39,17,57,17
"420770107",30,11,41,21,40,20
"420770105",12,12,24,10,19,10
"420700402",88,63,151,51,104,51
"420700103",144,100,244,89,196,89
"420560507",36,22,58,25,32,25
"420420305",2,1,3,1,3,1
"420420104",2,0,2,2,6,2
"421330210",1,0,1,1,5,1
"421050203",81,52,133,51,101,48
"421400223",78,70,148,58,110,56
"420700505",204,196,400,147,218,146
"420210107",35,36,71,28,47,28
"420910105",114,107,221,69,94,69
"420210504",343,358,701,257,288,255
"421540511",298,320,618,224,280,220
"421400204",407,456,863,234,254,232
"421330703",37,33,70,15,21,14
"421330601",301,301,602,185,188,161
"421330505",307,273,580,181,209,176
"421260502",110,118,228,70,87,70
"421260201",431,421,852,273,286,249
"421260111",353,351,704,197,220,192
"421190303",19,13,32,15,33,15
"421190204",376,356,732,246,283,240
"421120308",611,592,1203,286,293,278
"421051012",555,530,1085,348,429,340
"421051011",352,427,779,254,293,250
"421051010",288,275,563,242,312,237
"421051007",346,359,705,181,191,178
"421050711",343,358,701,284,295,264
"421050418",202,230,432,190,232,183
"421050307",171,178,349,155,202,147
"421050101",185,182,367,116,148,116
"420560503",254,288,542,197,209,195
"420350501",97,103,200,75,117,75
"420350413",337,343,680,237,289,237
"420350403",343,380,723,263,320,262
"420350401",302,261,563,178,210,178
"420211002",616,624,1240,337,344,330
"420210912",607,608,1215,367,415,362
"420210904",411,449,860,336,384,328
"420210901",87,144,231,138,192,136
"420210808",384,444,828,339,406,332
"420210802",174,226,400,193,271,193
"420210715",422,430,852,319,331,303
"420210507",458,504,962,372,440,366
"420210502",653,658,1311,366,360,338
"420210405",295,331,626,210,197,176
"420140201",334,351,685,209,225,179
"420070402",327,311,638,269,293,266
"420070201",204,201,405,134,156,132
"420770102",3,0,3,3,13,2
"420700508",259,291,550,214,233,210
"420700503",246,270,516,230,253,222
"420210609",103,179,282,163,226,163
"420211003",367,367,734,196,212,192
"420210705",310,425,735,301,466,296
"421330214",244,268,512,200,239,200
"420980110",294,274,568,190,227,189
"420980108",208,210,418,151,206,149
"420770302",207,193,400,169,221,169
"420070104",32,10,42,20,34,20
"421540102",56,38,94,39,75,39
"421470104",21,13,34,11,47,11
"421400302",95,52,147,54,122,54
"421330102",10,7,17,8,39,8
"421260404",19,8,27,14,19,14
"421190310",4,5,9,3,12,3
"421190208",16,15,31,12,54,12
"421190206",25,20,45,18,35,18
"421120318",4,4,8,3,3,3
"421120317",1,0,1,1,3,1
"421050602",55,40,95,35,68,34
"421050503",94,59,153,50,73,50
"420350503",24,11,35,18,27,17
"420210203",4,3,7,3,10,3
"420210108",35,13,48,19,34,19
"420140205",66,39,105,32,56,31
"420210101",72,38,110,46,92,46
"420070109",24,18,42,16,34,16
"420770406",23,21,44,13,33,13
"420770104",8,5,13,5,13,5
"420700203",2,2,4,1,9,1
"420560402",67,38,105,33,98,33
"420560302",84,45,129,58,128,54
"420560102",60,28,88,36,52,36
"420420303",5,0,5,3,4,3
"420420106",5,3,8,2,5,2
"420350307",13,8,21,8,14,8
"420770209",6,3,9,5,25,5
"421330207",659,637,1296,334,424,327
"420630103",195,165,360,126,213,125
"421050304",271,285,556,234,278,221
"421540513",524,581,1105,294,406,287
"421540301",330,377,707,242,307,241
"421540201",222,200,422,148,179,148
"421330502",219,244,463,189,233,188
"421260208",197,213,410,150,185,150
"421190302",329,384,713,290,351,288
"421190203",352,375,727,295,350,295
"421120306",647,652,1299,321,342,317
"421051008",279,292,571,206,253,200
"421050901",455,434,889,239,271,225
"421050804",666,691,1357,366,373,360
"421050709",411,412,823,301,319,295
"421050419",336,276,612,187,215,182
"421050314",139,213,352,156,215,156
"421050313",191,251,442,192,231,189
"421050311",287,295,582,212,243,202
"420980201",343,346,689,217,287,217
"420770203",193,185,378,146,165,146
"420700104",171,190,361,148,202,148
"420560511",360,406,766,225,238,223
"420560501",329,362,691,301,353,286
"420560401",165,158,323,102,127,102
"420560304",143,129,272,106,135,106
"420560303",445,435,880,295,319,288
"420350601",311,315,626,217,279,216
"420350412",323,352,675,263,303,258
"420350201",236,228,464,143,169,140
"420280302",325,333,658,215,236,210
"420280101",241,250,491,148,193,147
"420211001",599,633,1232,329,342,319
"420210913",354,332,686,263,333,262
"420210819",360,394,754,208,221,201
"420210814",278,341,619,261,322,252
"420210724",304,283,587,185,255,184
"420210815",426,389,815,277,296,264
"420210721",483,471,954,277,298,258
"420210719",459,480,939,298,332,296
"420210718",260,278,538,183,204,183
"420210716",244,254,498,187,208,183
"420210714",339,389,728,291,338,286
"420210605",188,217,405,186,229,171
"420210515",377,439,816,339,419,332
"420210506",488,533,1021,392,437,385
"420210414",348,399,747,314,361,307
"420210409",397,24,421,16,14,13
"420210404",359,380,739,235,239,228
"420210403",291,338,629,200,218,196
"420210311",670,758,1428,349,361,330
"420210209",380,403,783,236,280,230
"420210201",204,188,392,124,156,115
"420070401",372,359,731,272,299,255
"420770202",251,239,490,184,211,184
"420700506",39,54,93,37,38,36
"420140210",329,355,684,235,280,222
"421190211",268,264,532,180,198,177
"420280305",336,329,665,221,236,200
"420210704",229,308,537,275,355,272
"421051001",460,466,926,298,333,293
"421050717",464,488,952,332,384,319
"420980112",60,51,111,24,35,24
"420980103",287,314,601,172,187,169
"420980101",310,304,614,193,235,188
"421260206",10,7,17,8,33,8
"420070410",6,4,10,4,9,4
"420070103",15,4,19,8,14,8
"421540401",58,28,86,38,62,38
"421470106",18,22,40,16,43,16
"421470105",8,5,13,7,31,7
"421470103",3,2,5,3,7,3
"421400303",6,3,9,4,8,4
"421330705",17,15,32,11,28,11
"421330605",13,3,16,8,22,8
"421330603",7,5,12,6,25,6
"421260109",28,22,50,17,23,16
"421260107",40,26,66,20,29,20
"421260104",13,13,26,8,10,8
"421190304",4,2,6,3,6,3
"421190207",8,4,12,5,16,5
"421190104",23,20,43,14,36,14
"421120311",22,15,37,10,17,10
"420910103",43,12,55,32,63,32
"420350304",6,1,7,5,23,5
"420350106",10,10,20,9,25,9
"420210202",32,22,54,19,29,17
"420140206",8,7,15,8,10,8
"420140203",56,25,81,48,157,48
"420140101",21,9,30,13,24,13
"420070506",9,4,13,2,9,2
"420070502",9,6,15,5,7,5
"420070411",12,11,23,10,31,10
"420840202",35,16,51,28,44,27
"420770404",19,7,26,11,30,11
"420700302",44,16,60,28,55,28
"420630104",0,1,1,1,4,1
"420560508",21,8,29,14,26,14
"420630107",155,109,264,98,150,97
"420560505",41,25,66,27,57,27
"421190210",14,9,23,10,20,10
"421050204",45,10,55,13,29,13
"421050202",40,27,67,29,58,28
"421260405",64,40,104,32,53,32
"420280202",172,137,309,101,129,88
"421050410",192,253,445,207,259,204
"420210909",240,248,488,197,247,195
"421540503",303,312,615,236,315,231
"421400214",195,117,312,56,74,55
"421400212",295,330,625,195,247,191
"421470216",273,295,568,215,239,199
"421400210",311,374,685,243,288,234
"421400207",358,343,701,182,214,176
"421330701",358,327,685,244,281,243
"421330501",250,267,517,175,199,173
"421330401",84,93,177,57,72,57
"421330205",283,345,628,269,343,267
"421330203",332,349,681,242,270,236
"421260112",215,228,443,135,130,118
"421190401",423,380,803,283,331,278
"421190202",191,170,361,113,151,109
"421050905",493,522,1015,249,263,246
"421050904",474,552,1026,226,249,226
"421050708",401,394,795,208,215,207
"421050408",279,303,582,222,255,218
"421050403",556,573,1129,282,290,282
"421050402",612,619,1231,319,330,309
"421050312",258,267,525,243,295,235
"421050310",247,227,474,232,283,226
"420770410",232,252,484,191,223,178
"420700106",202,238,440,175,212,175
"420560517",313,256,569,168,189,167
"420560514",268,255,523,200,229,199
"420490102",415,475,890,264,318,259
"420420301",235,178,413,113,128,107
"420350406",206,204,410,180,217,180
"420210914",224,269,493,175,204,172
"420210803",127,207,334,193,297,191
"420210801",161,215,376,170,267,167
"420210510",473,463,936,294,318,266
"420210420",431,418,849,257,332,244
"420210410",156,189,345,141,159,138
"420210407",443,506,949,378,422,375
"420210306",647,636,1283,288,300,276
"420070406",351,338,689,247,299,240
"420070301",153,154,307,100,120,99
"420070207",333,347,680,218,266,217
"420210816",463,465,928,301,315,274
"420211005",497,557,1054,290,299,282
"420210702",169,198,367,162,216,159
"420210616",145,213,358,167,252,165
"420210707",248,338,586,244,320,234
"420700101",219,222,441,186,229,184
"421330213",190,193,383,111,118,110
"421051002",449,466,915,302,318,265
"420980111",297,310,607,190,233,188
"420980105",255,278,533,159,187,157
"420980104",247,285,532,143,190,139
"421470203",29,22,51,14,28,14
"421400221",40,34,74,35,63,35
"420350603",21,9,30,14,30,14
"420070412",0,0,0,0,6,0
"421540202",119,55,174,88,136,88
"421470211",15,7,22,9,46,9
"421470207",8,6,14,7,40,7
"421470205",11,6,17,7,13,7
"421400101",18,8,26,13,25,13
"421260403",20,10,30,12,20,12
"421190405",20,9,29,13,25,13
"421260505",16,4,20,8,27,8
"420980302",147,63,210,67,135,65
"420980113",48,29,77,39,77,35
"420910104",29,18,47,21,33,21
"420910102",69,36,105,40,52,40
"420280103",79,41,120,54,123,54
"420140209",13,7,20,9,20,9
"420140208",0,0,0,0,9,0
"420140102",22,11,33,15,35,15
"420070504",10,9,19,7,7,5
"420070203",37,23,60,22,18,15
"420070106",17,8,25,13,14,13
"420070105",10,4,14,7,17,7
"420770407",5,2,7,3,5,3
"420770305",33,16,49,23,66,23
"420560510",44,28,72,27,35,26
"420420302",18,5,23,14,36,14
"420420105",0,0,0,0,1,0
"420350608",86,71,157,60,92,59
"420350605",38,26,64,23,35,23
"420350502",40,29,69,26,67,26
"421540602",21,7,28,13,32,13
"421050502",16,5,21,11,19,11
"420280402",41,24,65,28,66,28
"420770208",18,12,30,15,34,15
"421540403",75,66,141,56,128,56
"421330704",67,61,128,39,73,39
"420350306",323,305,628,189,271,149
"420210106",54,46,100,33,48,33
"420210105",214,226,440,113,130,109
"421540515",370,411,781,264,286,263
"421540514",331,351,682,215,245,213
"421540508",315,345,660,213,253,213
"421540506",210,273,483,207,287,205
"421470215",443,440,883,291,353,288
"421470101",223,206,429,166,190,164
"421400301",2,1,3,1,4,1
"421400219",233,188,421,139,224,138
"421400217",231,251,482,153,248,153
"421330201",406,419,825,279,330,273
"421330101",148,152,300,102,146,101
"421260509",231,249,480,181,210,180
"421190402",64,56,120,35,40,34
"421190311",361,380,741,276,335,273
"421051006",267,289,556,226,262,223
"421050803",401,467,868,229,238,226
"421050707",163,160,323,108,124,108
"421050703",366,361,727,289,337,282
"421050417",175,237,412,192,231,188
"421050415",211,260,471,185,283,174
"421050413",229,245,474,208,258,204
"421050407",57,67,124,32,36,32
"421050308",207,275,482,215,269,210
"421050303",344,295,639,225,257,217
"421050302",257,267,524,194,210,190
"421050207",265,264,529,177,266,171
"420910101",41,34,75,27,40,27
"420630102",206,217,423,118,136,110
"420560515",541,533,1074,326,335,294
"420560513",225,242,467,132,146,130
"420560101",324,352,676,241,292,238
"420350602",264,266,530,207,239,207
"420280301",431,433,864,275,305,270
"420210917",389,387,776,199,305,170
"420210911",316,326,642,240,279,236
"420210910",242,270,512,207,271,204
"420210820",357,394,751,206,211,189
"420210813",189,230,419,205,263,205
"420210809",308,329,637,254,296,245
"420210804",233,306,539,241,294,238
"420210713",300,378,678,241,260,232
"420210602",335,357,692,215,248,205
"420210516",518,556,1074,434,535,422
"420210421",267,267,534,166,266,163
"420210419",279,304,583,188,226,187
"420210417",268,271,539,217,277,213
"420210415",236,294,530,209,237,203
"420210406",345,398,743,255,294,249
"420210312",660,716,1376,362,378,359
"420210309",377,364,741,241,270,238
"420210307",468,487,955,251,273,245
"420210305",443,403,846,265,280,234
"420140202",39,29,68,7,11,7
"420070413",293,308,601,183,204,182
"420070208",259,282,541,176,193,163
"420070110",273,288,561,188,236,186
"420770201",267,264,531,198,219,198
"420070101",296,313,609,215,239,214
"420210709",222,257,479,199,240,193
"420210703",234,322,556,278,383,273
"421540701",37,32,69,28,49,28
"421470301",263,220,483,162,206,159
"421051003",366,362,728,333,426,331
"420980107",221,231,452,166,208,166
"420350702",11,8,19,8,21,8
"420350301",4,3,7,3,15,3
"420210205",31,24,55,18,37,18
"420210103",30,20,50,21,34,20
"421540404",54,15,69,29,67,29
"421470302",15,11,26,8,27,8
"421470102",5,1,6,2,13,2
"421400102",46,15,61,33,55,33
"421330707",18,6,24,5,22,5
"421330402",28,22,50,18,26,18
"421260406",23,14,37,16,29,16
"421260504",19,7,26,11,21,11
"421190305",20,15,35,16,41,16
"421190209",22,12,34,10,23,10
"421190205",31,31,62,23,39,22
"421120321",9,2,11,4,6,4
"421120320",6,2,8,5,7,5
"421120313",25,4,29,16,27,13
"420350303",11,9,20,8,9,7
"420350103",8,8,16,8,12,8
"420350102",3,1,4,1,1,1
"420350504",26,16,42,16,33,16
"420210204",21,22,43,14,27,12
"420210109",13,6,19,11,21,11
"420070503",3,3,6,2,11,2
"420070303",8,2,10,5,17,5
"420070302",34,20,54,23,49,23
"420070108",39,29,68,23,45,22
"420770408",7,6,13,5,14,5
"420560509",23,26,49,17,39,15
"420560202",24,17,41,16,55,16
"420420304",0,0,0,0,3,0
"420350607",19,17,36,13,26,13
"420210102",16,8,24,13,21,13
"421050103",49,30,79,41,50,40
"421050206",360,290,650,207,707,202
"421540101",125,101,226,70,86,70
"420210615",131,204,335,193,305,191
"421540512",521,502,1023,295,357,290
"421540510",245,284,529,201,237,196
"421540509",369,417,786,233,266,231
"421470214",350,347,697,233,256,229
"421400213",109,102,211,54,112,52
"421400206",332,360,692,212,242,209
"421400211",569,548,1117,312,342,303
"421330702",299,291,590,221,267,221
"421330602",321,314,635,242,274,242
"421330510",335,378,713,196,231,195
"421330509",249,220,469,148,180,148
"421330504",267,264,531,181,209,180
"421260511",177,190,367,140,173,137
"421260402",21,31,52,12,16,12
"421260101",352,380,732,234,275,230
"421190312",329,335,664,256,296,254
"421190301",319,367,686,254,320,240
"421190201",173,170,343,159,179,154
"421190212",495,524,1019,287,330,284
"421120305",509,480,989,310,331,293
"421120302",269,286,555,185,204,176
"421120301",396,352,748,220,243,217
"421051009",214,229,443,168,206,166
"421050903",235,265,500,103,99,99
"421050706",481,498,979,276,300,276
"421050701",425,420,845,290,310,282
"421050404",678,681,1359,349,370,339
"421050401",469,501,970,318,375,315
"421050301",389,420,809,265,331,264
"420840101",104,104,208,68,106,68
"420770306",117,120,237,80,94,80
"420700105",244,273,517,183,201,183
"420560502",332,399,731,301,368,296
"420560301",169,178,347,131,167,131
"420350609",322,322,644,217,266,216
"420350409",235,280,515,182,210,181
"420350404",269,333,602,194,222,194
"420350310",522,556,1078,317,352,315
"420280201",458,483,941,337,358,313
"420210908",540,599,1139,386,409,344
"420210805",276,339,615,303,376,290
"420210418",293,296,589,204,249,202
"420210412",179,231,410,203,247,193
"420210413",268,321,589,284,368,281
"420210308",455,456,911,256,272,243
"420210304",453,451,904,258,327,257
"420210210",257,273,530,155,189,153
"420210118",355,299,654,201,310,200
"420070501",209,195,404,134,158,128
"420070202",202,206,408,161,190,158
"420140211",266,269,535,141,195,139
"420070404",213,234,447,171,208,170
"420070102",218,198,416,146,179,136
"420210611",165,255,420,206,323,203
"420210608",141,180,321,149,218,143
"420210505",497,491,988,300,297,258
"420560504",230,249,479,187,216,183
"420210722",508,501,1009,296,313,278
"420210706",162,260,422,202,313,201
"420210701",190,242,432,190,231,186
"420210708",331,334,665,269,289,267
"420770210",198,205,403,163,221,162
"421260203",192,200,392,134,164,134
"421050715",379,370,749,225,251,222
"421050716",335,342,677,232,268,230
"420980109",265,321,586,216,259,215
"421540302",76,42,118,53,97,52
"421470212",8,9,17,6,19,6
"421470209",30,20,50,16,32,16
"421400103",20,7,27,17,34,17
"421330706",13,7,20,7,32,7
"421260507",6,4,10,4,22,4
"421260301",13,14,27,8,34,8
"421260204",10,9,19,6,31,6
"421260110",37,13,50,23,36,23
"421190308",39,23,62,24,44,23
"421120315",42,27,69,18,32,18
"420980402",131,56,187,98,183,98
"420840206",32,14,46,6,7,6
"420210206",31,26,57,27,57,27
"420140204",0,0,0,0,10,0
"420070206",13,9,22,6,17,6
"420070205",11,5,16,8,23,8
"420070204",59,47,106,37,65,37
"420770403",8,6,14,7,17,7
"420700504",600,547,1147,208,231,206
"420700202",81,46,127,47,107,46
"420490106",87,24,111,38,65,38
"420420308",5,2,7,4,5,4
"420420307",3,1,4,3,5,3
"420420202",79,37,116,55,104,55
"420420107",10,2,12,7,8,6
"420420102",1,0,1,1,1,1
"420420101",4,0,4,2,13,2
"420350703",11,7,18,7,20,7
"420840203",19,5,24,12,33,12
"420630105",7,6,13,7,7,7
"420280401",62,31,93,36,74,35
"421050205",13,7,20,9,37,9
"420770303",9,5,14,9,30,9
"421400222",315,301,616,175,256,146
"421260108",68,52,120,47,72,46
"421330302",22,15,37,13,35,13
"421540516",466,486,952,261,265,239
"421540507",270,296,566,235,310,234
"421540505",358,372,730,286,361,280
"421400208",251,245,496,184,217,179
"421330204",240,251,491,199,244,199
"421330202",161,214,375,152,194,151
"421260510",353,366,719,227,259,221
"421260103",347,368,715,252,302,250
"421120101",178,179,357,108,125,67
"421050906",446,507,953,238,245,234
"421050806",545,551,1096,244,339,243
"421050714",457,459,916,268,281,254
"421050710",290,328,618,255,283,249
"421050705",382,433,815,321,358,311
"421050409",270,324,594,260,308,256
"421050405",444,457,901,306,322,291
"421050306",191,243,434,203,250,182
"421050305",279,280,559,224,259,216
"420770409",280,286,566,208,244,205
"420770402",291,310,601,209,243,207
"420770401",386,397,783,298,351,283
"420700401",235,231,466,179,216,178
"420560601",358,330,688,243,282,238
"420560512",225,198,423,133,197,131
"420490101",283,282,565,170,190,166
"420350410",202,200,402,160,180,156
"420350405",326,348,674,259,306,256
"420350402",270,260,530,172,199,171
"420350309",229,250,479,149,153,139
"420350101",123,96,219,78,90,78
"420280105",241,232,473,151,179,149
"420210916",555,586,1141,322,353,310
"420210915",292,350,642,219,255,216
"420210905",633,654,1287,322,340,308
"420210824",296,291,587,207,239,202
"420210810",403,436,839,295,321,284
"420210806",276,335,611,250,311,246
"420210725",208,211,419,144,216,139
"420210720",465,448,913,265,310,258
"420210710",246,241,487,178,205,178
"420210603",375,421,796,331,373,317
"420210514",285,295,580,207,244,196
"420210513",387,390,777,243,278,238
"420210511",484,456,940,245,260,238
"420210503",563,588,1151,349,387,342
"420210416",209,250,459,184,225,180
"420210401",363,394,757,223,253,220
"420210115",0,0,0,0,329,0
"420210110",60,48,108,37,53,37
"420070508",142,132,274,100,118,99
"420210302",559,558,1117,253,261,226
"420280304",394,387,781,249,314,246
"420210113",554,600,1154,243,251,230
"420770211",189,195,384,154,186,150
"420210613",245,319,564,291,437,283
"421330301",140,132,272,98,115,97
"421050718",424,459,883,216,233,211
"421050201",27,19,46,15,19,15
"420980102",225,216,441,130,214,130
"421050504",27,18,45,15,16,12
"420490104",16,3,19,11,15,11
"421540702",52,32,84,36,74,36
"421540402",54,39,93,24,67,24
"421540103",67,12,79,46,100,46
"421470213",5,2,7,3,18,3
"421470208",10,3,13,9,17,9
"421470204",2,2,4,1,10,1
"421470107",21,17,38,14,58,12
"421400104",2,0,2,2,5,2
"421330506",11,3,14,9,34,9
"421330403",21,15,36,11,22,11
"421260508",6,3,9,4,15,4
"421330208",0,0,0,0,11,0
"421260106",13,7,20,10,17,9
"421190404",20,16,36,15,51,15
"421190307",35,28,63,20,55,20
"421190102",4,4,8,3,7,3
"421120322",6,4,10,4,5,4
"421120102",250,205,455,149,214,149
"420980114",25,15,40,20,41,20
"420350302",18,8,26,10,28,10
"420070107",10,8,18,8,26,8
"420840204",0,0,0,0,3,0
"420840201",19,5,24,16,27,16
"420770304",32,31,63,25,68,25
"420770108",67,32,99,41,107,41
"420770106",8,5,13,8,15,8
"420770103",12,5,17,6,12,6
"420560602",34,20,54,21,56,21
"420420103",3,1,4,1,2,1
"420350705",26,20,46,16,35,16
"420350606",31,19,50,15,26,15
"420350604",22,24,46,20,41,20
"420350308",36,24,60,22,53,22
"421050102",4,2,6,2,9,2
"420630106",63,49,112,31,41,31
"421120314",21,2,23,9,10,9
"420210104",12,9,21,9,32,9
"420700102",8,1,9,7,10,7
"421330604",93,73,166,49,81,49
"420280303",625,611,1236,333,422,329
"420070409",430,433,863,251,320,250
"420630101",168,161,329,93,106,91
"420420201",208,212,420,143,188,138
"421540502",338,347,685,273,353,268
"421540501",143,153,296,90,131,89
"421470202",217,213,430,173,226,172
"421470201",413,396,809,224,249,221
"421400218",214,205,419,144,219,144
"421400201",313,330,643,196,248,194
"421260501",223,225,448,159,216,156
"421260407",289,316,605,170,233,169
"421260401",277,244,521,165,199,164
"421260202",237,242,479,156,201,153
"421120307",386,390,776,243,256,238
"421120304",93,92,185,65,85,63
"421050902",230,235,465,114,127,112
"421050807",642,673,1315,388,442,383
"421050802",305,332,637,178,199,178
"421050712",439,473,912,320,315,292
"421050704",263,316,579,249,293,237
"421050702",273,276,549,205,224,189
"421050601",151,133,284,99,118,97
"421050406",569,588,1157,395,424,388
"421050309",216,259,475,210,240,197
"420980303",293,317,610,203,253,199
"420980301",311,319,630,190,248,189
"420770307",180,163,343,133,152,133
"420700502",311,344,655,283,334,281
"420700501",460,432,892,343,382,335
"420700301",20,19,39,10,16,10
"420560201",98,106,204,53,70,52
"420490108",169,169,338,91,122,89
"420490107",236,213,449,158,176,145
"420350610",205,217,422,164,200,164
"420350408",183,238,421,156,188,151
"420280203",238,252,490,193,241,192
"420210906",381,262,643,136,155,135
"420210903",372,470,842,352,408,345
"420210822",293,336,629,184,191,183
"420210812",223,241,464,189,228,186
"420210712",301,336,637,213,216,200
"420210711",214,222,436,152,188,151
"420210606",151,184,335,178,241,171
"420210604",316,421,737,325,430,323
"420210512",612,613,1225,273,276,258
"420210508",27,10,37,2,2,2
"420210501",435,483,918,231,259,229
"420210411",170,197,367,169,218,168
"420210301",500,571,1071,240,259,234
"420210116",0,0,0,0,376,0
"420210114",256,267,523,177,222,174
"420770101",163,149,312,109,147,108
"420070405",229,255,484,173,208,171
"420210607",222,304,526,236,292,236
"420350505",133,137,270,89,112,89
"420211004",471,549,1020,294,302,292
"421330216",380,345,725,214,234,214
"421330215",282,294,576,212,246,209
"421051004",293,323,616,217,229,208
"420770212",195,195,390,141,164,136
"420490105",94,64,158,54,70,54
"420140207",2,4,6,1,6,1
"421470206",20,8,28,12,28,12
"421400220",118,46,164,80,136,75
"421260506",145,116,261,72,113,72
"421260503",46,31,77,35,106,35
"421260304",9,3,12,7,28,7
"421260302",57,36,93,20,45,20
"421330209",2,0,2,2,14,2
"421260105",32,26,58,17,27,12
"421190403",36,39,75,23,54,23
"421190306",23,19,42,16,34,16
"421190103",17,10,27,9,22,9
"420980202",33,28,61,26,50,26
"420840205",3,0,3,3,4,3
"420350305",9,4,13,3,10,3
"420350105",29,18,47,17,30,17
"420350104",26,9,35,13,30,12
"420280104",38,23,61,28,58,23
"420140103",32,19,51,23,53,23
"420070507",6,4,10,4,11,4
"420840102",53,22,75,45,146,43
"420770405",6,3,9,4,8,4
"420770205",12,8,20,11,28,11
"420420306",10,8,18,9,10,8
"420350704",26,20,46,17,31,17
"420770207",29,15,44,25,55,25
"420770206",28,22,50,17,33,17
"460350202",309,249,558,181,272,178
"460140103",852,795,1647,487,731,484
"460420203",416,439,855,216,290,215
"460420121",625,635,1260,360,393,348
"460420118",672,716,1388,339,319,306
"460420114",592,670,1262,380,438,371
"460420110",778,828,1606,467,512,428
"460420109",699,785,1484,401,412,377
"460420101",942,949,1891,534,597,499
"460141113",552,577,1129,370,498,352
"460141107",500,557,1057,308,377,293
"460141016",688,740,1428,334,279,269
"460141009",443,440,883,228,230,209
"460141007",434,460,894,242,226,212
"460140908",684,765,1449,408,461,408
"460140901",648,605,1253,330,394,324
"460140806",741,725,1466,445,433,364
"460140716",466,433,899,258,381,249
"460140709",539,519,1058,275,361,269
"460140803",620,704,1324,421,464,392
"460140611",395,472,867,282,420,273
"460140601",593,706,1299,387,394,352
"460140418",372,401,773,230,245,208
"460140409",483,555,1038,278,309,263
"461190102",555,572,1127,307,435,306
"461120109",656,765,1421,339,391,337
"460910201",685,758,1443,375,451,362
"460840202",355,359,714,210,259,207
"460840201",440,428,868,256,325,252
"460630101",499,544,1043,304,383,292
"460490203",112,109,221,58,107,57
"460490102",526,537,1063,303,417,301
"460140106",715,692,1407,363,426,356
"460280103",489,524,1013,287,361,278
"460140812",566,575,1141,302,323,280
"461120302",271,214,485,131,172,131
"461120301",339,275,614,182,213,172
"460980105",42,19,61,15,23,15
"460980103",24,15,39,11,15,11
"460840204",123,78,201,69,113,69
"460350203",87,78,165,48,94,48
"460070203",18,17,35,16,39,15
"460420403",249,155,404,127,244,125
"460840102",397,315,712,198,279,194
"460350201",708,660,1368,365,522,358
"460420401",728,639,1367,366,418,338
"460420201",825,843,1668,392,465,376
"460420119",402,405,807,236,277,232
"460490201",422,427,849,244,409,243
"460350107",580,600,1180,378,447,364
"460280202",690,656,1346,338,436,332
"460280201",187,176,363,110,125,102
"460141013",890,871,1761,410,422,384
"460140920",648,674,1322,357,483,352
"460140917",885,994,1879,444,460,437
"460140909",664,679,1343,355,391,323
"460140904",392,458,850,234,279,226
"460140902",421,492,913,320,400,314
"460140801",543,600,1143,373,402,340
"460140707",520,557,1077,268,292,258
"460140706",569,621,1190,273,279,258
"460140702",973,980,1953,487,512,437
"460140515",786,796,1582,363,367,341
"460140507",819,835,1654,397,412,378
"460140504",852,916,1768,431,528,415
"460140414",382,412,794,221,248,217
"460140413",625,656,1281,341,360,327
"460140412",493,516,1009,286,315,254
"460140111",615,651,1266,369,469,367
"461260101",605,625,1230,294,579,283
"461190101",334,313,647,177,297,169
"461050102",404,458,862,207,251,198
"460630103",556,578,1134,324,414,313
"460070109",441,411,852,222,279,218
"460840104",432,411,843,227,266,223
"460420303",421,452,873,247,322,232
"460140906",806,842,1648,431,526,423
"460070108",638,637,1275,345,340,301
"460910101",119,72,191,68,95,68
"460700103",226,170,396,103,142,102
"460560103",188,124,312,96,137,95
"460140201",47,28,75,28,44,26
"460490204",238,204,442,154,268,137
"460420301",1153,1102,2255,562,612,505
"460420105",257,333,590,224,329,214
"460420102",340,332,672,217,276,211
"460350109",681,690,1371,379,426,379
"460350108",838,859,1697,429,490,416
"460280204",414,373,787,193,261,191
"460141106",712,712,1424,384,328,311
"460141101",820,789,1609,390,441,385
"460141005",899,947,1846,444,530,427
"460141006",864,863,1727,394,433,369
"460140905",379,424,803,220,251,213
"460140809",645,693,1338,376,404,338
"460140711",508,510,1018,280,296,271
"460140605",355,417,772,308,555,296
"460140514",742,762,1504,354,347,322
"460140513",682,681,1363,302,332,295
"460140503",487,514,1001,259,305,254
"460140501",399,431,830,239,251,228
"460140415",397,425,822,235,255,231
"460140408",570,661,1231,373,389,348
"460140402",429,500,929,275,306,266
"461260103",528,517,1045,299,559,292
"461120105",467,503,970,277,321,258
"460980104",126,104,230,78,132,78
"460140105",480,488,968,239,302,229
"460070201",564,526,1090,317,409,292
"460070106",178,165,343,97,128,96
"461120103",472,526,998,292,341,278
"460280108",342,357,699,200,249,197
"460141115",739,752,1491,482,638,472
"461120203",84,69,153,45,74,45
"460770103",17,9,26,13,19,11
"460770102",7,4,11,5,12,5
"460630202",37,35,72,26,38,26
"460140302",179,133,312,83,104,83
"460140102",50,33,83,28,33,27
"460700102",540,465,1005,283,378,277
"460420305",395,310,705,205,328,196
"460280106",291,282,573,144,240,134
"460420202",968,820,1788,439,508,421
"460420117",500,491,991,283,308,259
"461120108",700,730,1430,374,432,352
"460350104",1018,1007,2025,529,574,499
"460141111",740,815,1555,428,467,391
"460141110",971,945,1916,477,474,441
"460141108",720,747,1467,403,463,366
"460280105",445,416,861,254,373,246
"460141015",480,529,1009,241,236,216
"460141010",486,545,1031,276,271,246
"460140916",708,719,1427,352,373,327
"460140907",620,746,1366,374,413,366
"460140814",724,769,1493,444,515,435
"460140802",501,547,1048,314,334,287
"460140610",385,497,882,327,430,315
"460140609",313,360,673,241,305,232
"460140608",282,331,613,239,327,215
"460140604",376,451,827,272,315,240
"460140603",264,294,558,209,273,204
"460140517",815,812,1627,423,435,386
"460140516",758,791,1549,361,335,315
"460140512",634,638,1272,278,256,238
"460140511",599,585,1184,271,278,255
"460140509",793,876,1669,417,460,404
"460140505",645,628,1273,332,331,313
"460140502",435,481,916,255,276,233
"460140403",383,441,824,247,274,240
"461120104",681,701,1382,402,460,394
"460770101",402,399,801,214,302,213
"460700101",682,653,1335,359,408,349
"460140108",467,426,893,237,280,228
"460070107",493,468,961,259,303,245
"460070105",524,595,1119,317,335,306
"461120107",481,516,997,314,383,300
"460980102",514,497,1011,283,378,275
"460420302",1195,1179,2374,582,636,553
"460350101",593,642,1235,374,414,356
"460280107",380,377,757,185,211,184
"460141114",687,676,1363,422,494,396
"461260102",44,26,70,29,96,29
"460910202",298,260,558,168,239,168
"460560104",339,317,656,185,248,183
"460420205",409,402,811,193,231,185
"460210105",224,200,424,131,236,121
"460490104",56,48,104,38,80,32
"460070104",631,653,1284,306,336,299
"460070101",612,582,1194,315,347,311
"460420112",683,713,1396,326,346,324
"460420111",494,567,1061,296,336,284
"460420104",399,432,831,266,327,246
"460210106",179,175,354,126,238,125
"460141004",440,403,843,208,263,195
"460141003",515,530,1045,285,293,243
"460140922",649,678,1327,345,589,341
"460140915",896,857,1753,424,441,399
"460140914",706,880,1586,430,483,406
"460140913",429,462,891,278,349,278
"460140804",568,628,1196,436,520,404
"460140708",652,691,1343,333,378,321
"460140705",784,801,1585,432,468,419
"460140701",196,180,376,99,205,94
"460140417",391,445,836,231,259,207
"460140407",443,496,939,250,263,232
"460140401",521,513,1034,287,325,271
"461190104",209,230,439,121,202,114
"461120106",653,663,1316,356,436,344
"460980101",725,665,1390,379,546,370
"460910204",876,886,1762,431,500,417
"460630102",730,796,1526,423,476,410
"460560101",590,574,1164,326,403,319
"460140606",317,402,719,269,401,266
"460140109",1008,975,1983,510,592,490
"460420107",391,402,793,287,357,276
"461120202",551,479,1030,299,413,299
"460140202",165,159,324,103,158,102
"461050103",252,208,460,132,202,132
"460700203",150,121,271,86,120,85
"460490205",128,144,272,77,120,74
"460280203",343,295,638,165,252,161
"460210202",193,193,386,141,282,138
"460070204",401,384,785,183,227,182
"460420304",478,454,932,249,312,235
"460420204",745,731,1476,370,438,359
"460420116",725,708,1433,357,407,344
"460280101",245,271,516,155,185,138
"460210101",435,398,833,223,358,221
"460141011",510,508,1018,251,253,228
"460140911",98,64,162,55,136,54
"460140910",1045,1174,2219,553,592,550
"460140810",663,800,1463,453,494,418
"460140807",723,790,1513,380,352,311
"460140718",331,313,644,177,265,175
"460140717",192,198,390,113,233,111
"460140703",878,848,1726,471,541,462
"460140518",673,699,1372,389,383,345
"461120101",697,713,1410,423,507,405
"460700201",513,504,1017,265,365,261
"460630201",456,447,903,258,331,254
"460630105",374,357,731,196,254,189
"460630104",412,432,844,270,312,261
"460140104",342,365,707,209,260,173
"460140107",836,780,1616,348,392,335
"460070111",734,739,1473,363,401,345
"460140811",719,779,1498,417,418,381
"460140607",323,394,717,276,405,265
"460910203",277,228,505,132,155,132
"460700202",46,38,84,27,43,26
"460560102",508,433,941,260,373,258
"460070102",432,469,901,258,330,242
"460420122",551,615,1166,276,434,272
"460350106",552,568,1120,322,354,304
"460350103",920,978,1898,528,596,509
"460350102",405,436,841,293,341,283
"460280102",516,526,1042,298,378,284
"460141112",551,642,1193,371,412,349
"460141109",630,735,1365,415,468,362
"460141103",468,462,930,218,222,200
"460141018",542,549,1091,295,356,282
"460141105",1001,1039,2040,496,490,451
"460141017",1581,1321,2902,606,651,572
"460141001",564,612,1176,327,333,288
"460140918",687,758,1445,338,470,334
"460140903",364,375,739,218,271,195
"460140813",399,472,871,334,423,320
"460140808",438,445,883,262,248,212
"460140715",559,575,1134,283,298,268
"460420103",425,461,886,277,316,246
"460140704",741,745,1486,389,427,353
"460140519",527,522,1049,316,346,284
"460140508",827,904,1731,427,450,403
"460140506",463,457,920,206,206,196
"460140416",483,491,974,280,310,275
"460140411",789,801,1590,434,466,392
"461120201",363,370,733,200,238,198
"460840206",578,611,1189,338,388,327
"460840205",351,372,723,233,280,228
"460840101",410,442,852,253,318,247
"460770104",439,457,896,252,324,246
"460490101",725,678,1403,393,541,381
"460140406",565,559,1124,300,301,265
"461050101",480,466,946,248,337,245
"460420306",1139,1169,2308,553,615,504
"460420123",627,700,1327,366,409,366
"460420108",498,504,1002,301,346,283
"460280109",279,262,541,134,236,117
"460280104",256,256,512,154,226,149
"460210104",209,209,418,161,241,157
"460140713",813,799,1612,362,381,344
"460140712",671,673,1344,329,361,318
"460140410",321,399,720,258,317,238
"460070112",819,814,1633,424,532,403
"460630106",459,355,814,258,385,244
"460910102",241,244,485,123,193,122
"461190201",244,230,474,134,267,132
"460840103",457,383,840,245,346,234
"460630203",163,140,303,90,130,88
"460490103",331,286,617,189,296,184
"460420206",405,324,729,197,267,179
"460140101",339,280,619,180,359,178
"460070103",680,664,1344,386,433,374
"460420402",833,806,1639,382,512,367
"460420120",1083,1134,2217,600,705,590
"460420115",510,563,1073,315,362,304
"460420113",1308,1396,2704,655,683,638
"460420106",652,756,1408,457,550,432
"460350105",345,357,702,232,259,217
"460210201",199,191,390,128,262,128
"460141104",727,744,1471,353,382,336
"460141102",710,779,1489,388,390,350
"460141014",772,793,1565,394,371,329
"460141012",1265,1343,2608,603,604,571
"460141008",690,754,1444,387,409,361
"460141002",335,301,636,168,156,145
"460140921",579,565,1144,326,436,325
"460140919",762,799,1561,421,453,392
"460140912",711,703,1414,412,498,385
"460140805",504,552,1056,340,320,265
"460140714",837,855,1692,425,423,379
"460140710",580,642,1222,352,417,339
"460140602",405,446,851,286,354,264
"460140510",683,698,1381,346,359,331
"460140405",496,513,1009,257,270,251
"460140404",666,726,1392,394,422,369
"461190103",592,648,1240,348,490,326
"460490202",451,441,892,255,367,250
"460140110",1082,1061,2143,522,623,501
"460070202",202,205,407,111,155,108
"460070110",364,358,722,190,212,180
"461120102",575,540,1115,290,333,281
"460210103",118,126,244,95,166,94
"460210102",602,617,1219,323,436,318
"461050104",99,60,159,56,78,54
"460840203",122,81,203,67,91,66
"460140301",79,49,128,45,62,43
"500980102",1091,969,2060,488,516,426
"500910301",518,450,968,256,300,233
"500840705",596,596,1192,313,325,300
"500840703",323,316,639,168,188,156
"500840702",441,456,897,244,279,234
"500840301",368,379,747,222,246,209
"500770121",410,354,764,191,244,188
"500700414",590,624,1214,314,318,295
"500700209",507,544,1051,304,318,280
"500630703",335,318,653,178,225,147
"500630406",1195,1119,2314,536,597,518
"500560602",523,497,1020,251,300,239
"500560403",738,710,1448,366,397,343
"500490202",132,118,250,70,75,64
"500490201",863,764,1627,406,466,390
"500350501",980,1001,1981,536,550,511
"500350205",582,652,1234,324,331,313
"500350301",891,881,1772,488,535,465
"500350201",650,679,1329,388,445,350
"500350103",513,498,1011,271,283,256
"500281712",1069,1079,2148,541,559,491
"500140701",782,811,1593,422,360,312
"500140601",581,598,1179,335,374,325
"501260315",387,396,783,187,194,168
"501190204",848,732,1580,424,477,409
"501190201",179,125,304,86,320,85
"501051604",487,548,1035,276,291,272
"501051002",566,555,1121,285,355,282
"500980611",655,645,1300,337,351,320
"500980604",604,510,1114,308,329,284
"500491414",377,390,767,194,216,183
"500631008",627,663,1290,364,376,282
"500280412",579,599,1178,268,258,251
"501260312",722,723,1445,382,384,357
"501260310",495,473,968,249,252,239
"501260304",654,707,1361,400,437,387
"501190608",379,453,832,290,364,284
"501190604",571,596,1167,367,389,347
"501051915",326,277,603,157,152,146
"501051911",219,237,456,145,145,131
"501051910",697,727,1424,350,357,342
"501051907",614,651,1265,379,424,375
"501051810",474,515,989,328,342,300
"501051806",366,440,806,297,325,281
"501051801",562,629,1191,348,405,345
"501051713",281,347,628,250,278,236
"501051705",357,413,770,226,222,212
"501051701",572,669,1241,303,301,283
"501051818",589,650,1239,321,307,287
"501051512",293,350,643,181,194,178
"501051505",478,554,1032,300,333,292
"501051409",241,273,514,182,198,175
"501051206",243,256,499,141,168,140
"500701006",709,731,1440,400,493,394
"500700913",385,427,812,179,159,157
"500700904",640,650,1290,369,315,297
"500700811",446,467,913,268,275,254
"500700803",444,494,938,297,288,277
"500700507",470,487,957,270,261,248
"500700424",359,376,735,216,211,188
"500700409",886,953,1839,477,439,421
"500700208",455,560,1015,346,378,322
"500631116",342,410,752,231,247,219
"500631110",198,208,406,128,253,126
"500700117",1005,1018,2023,463,451,420
"500631001",405,422,827,244,382,216
"500630911",315,337,652,192,202,182
"500630908",427,455,882,244,319,224
"500491008",344,332,676,187,412,178
"500491001",858,918,1776,462,466,410
"501050706",503,540,1043,298,329,293
"501050519",288,350,638,189,193,183
"501050514",445,497,942,301,288,253
"501050415",225,293,518,190,236,189
"501050411",493,608,1101,353,369,331
"501050409",349,383,732,229,236,216
"501050503",276,339,615,186,250,185
"501050502",99,159,258,117,171,103
"501051311",144,221,365,119,194,119
"500980905",508,567,1075,321,321,295
"500980902",261,293,554,161,167,155
"500980818",726,798,1524,385,364,353
"500980812",308,346,654,198,210,194
"500980805",843,898,1741,465,449,420
"500980715",918,979,1897,508,533,477
"500910106",344,353,697,224,246,220
"500840805",617,688,1305,390,370,336
"500840216",329,362,691,193,198,185
"500840214",494,567,1061,328,337,312
"500840207",623,636,1259,359,404,345
"500840810",599,667,1266,323,333,307
"500770125",503,499,1002,275,299,272
"500701009",338,359,697,217,209,186
"500490911",593,652,1245,369,409,366
"500490812",832,880,1712,417,397,374
"500490703",429,483,912,232,216,207
"500490702",466,486,952,238,233,220
"500490413",241,252,493,146,213,129
"500490312",410,437,847,265,296,261
"500490221",852,956,1808,412,392,376
"500490203",390,380,770,189,185,175
"500490217",510,509,1019,235,224,211
"500420406",828,832,1660,464,440,373
"500281105",685,659,1344,347,272,259
"500281101",462,501,963,226,201,199
"500280913",500,552,1052,305,305,282
"500281009",373,425,798,246,264,234
"500280902",308,384,692,243,277,238
"500630904",461,509,970,271,350,253
"500630309",603,668,1271,336,312,302
"500630306",641,693,1334,367,330,317
"500630204",342,425,767,239,229,215
"500630113",545,575,1120,305,371,272
"501050512",202,265,467,192,226,190
"500630312",1040,1053,2093,471,631,437
"500630213",377,385,762,239,263,232
"500491303",582,640,1222,267,257,248
"500491302",1038,978,2016,461,453,445
"500491214",289,391,680,232,255,228
"500491212",600,664,1264,341,361,330
"500491312",768,835,1603,438,412,395
"500491205",510,549,1059,310,320,300
"500491118",406,415,821,210,196,190
"500491112",574,643,1217,381,356,337
"500280816",355,380,735,235,253,213
"500280815",505,585,1090,324,340,309
"500280807",412,491,903,286,306,271
"500280705",361,390,751,170,187,159
"500280609",223,211,434,106,98,95
"500280703",440,441,881,233,244,219
"500280314",745,779,1524,422,383,353
"500280309",460,492,952,289,283,245
"500280306",751,740,1491,336,274,251
"500280515",391,397,788,212,220,204
"500280108",365,411,776,265,323,251
"500280103",345,388,733,234,257,219
"500280102",354,457,811,208,231,197
"500211507",328,433,761,298,367,293
"500211406",617,670,1287,330,306,296
"500211405",600,650,1250,315,268,262
"500211403",687,686,1373,347,297,291
"500210804",240,227,467,111,94,91
"500210706",487,504,991,330,359,313
"500210703",470,569,1039,338,352,303
"500210606",525,606,1131,334,357,329
"500210605",529,625,1154,346,365,327
"500630802",460,486,946,275,287,258
"500630801",405,427,832,254,274,233
"500420404",414,428,842,249,275,237
"500350207",537,540,1077,299,299,283
"500282007",463,537,1000,322,352,301
"500282004",291,314,605,179,176,163
"500282001",535,603,1138,354,427,336
"500281909",649,688,1337,367,360,342
"500281906",645,675,1320,334,317,303
"500281901",796,855,1651,414,404,373
"500281806",460,472,932,241,236,222
"500281709",363,367,730,203,195,157
"500281701",387,397,784,193,175,164
"500281609",662,701,1363,423,431,372
"500281607",261,295,556,180,202,179
"500281507",647,667,1314,315,291,279
"500281502",1030,1007,2037,498,550,470
"500281413",452,491,943,288,316,270
"500281216",427,520,947,302,320,292
"500210309",471,565,1036,324,338,306
"500210301",383,460,843,313,390,303
"500210202",391,454,845,240,217,187
"500210109",414,451,865,284,340,278
"500210104",429,517,946,314,328,308
"500210101",305,344,649,208,216,206
"500140613",373,441,814,281,315,275
"500071110",394,459,853,287,327,279
"500071101",303,340,643,210,250,205
"500071017",493,523,1016,311,337,302
"500211310",385,436,821,264,259,242
"501050509",403,464,867,283,269,238
"500211208",539,512,1051,233,212,204
"500211205",594,622,1216,330,322,300
"500211203",278,301,579,167,171,156
"500211111",266,287,553,180,233,177
"500211110",276,321,597,232,322,226
"500211006",565,589,1154,357,369,338
"500210915",265,364,629,332,404,303
"500210907",354,420,774,250,305,237
"500210905",417,494,911,315,359,300
"500210911",456,480,936,320,357,317
"500070708",231,254,485,173,198,159
"500070706",371,413,784,305,424,293
"500070705",283,373,656,248,261,234
"500070702",454,564,1018,346,379,325
"500070608",414,535,949,349,409,338
"500070505",246,265,511,201,240,193
"500070213",394,414,808,311,384,299
"500070212",222,248,470,157,214,152
"500070104",195,324,519,245,296,244
"500070209",405,401,806,304,349,262
"500070208",274,311,585,209,249,194
"501050420",286,341,627,197,211,194
"500700413",832,839,1671,432,382,374
"500630112",248,257,505,133,371,129
"500491411",350,318,668,157,192,134
"500350506",189,211,400,113,123,109
"500281415",401,392,793,218,239,216
"500770124",468,504,972,281,306,248
"500280809",510,586,1096,305,285,267
"500280414",710,659,1369,312,303,279
"500140712",285,373,658,276,362,274
"500491010",455,495,950,284,306,273
"500490918",323,382,705,218,237,203
"500490213",734,761,1495,382,374,350
"500070111",151,198,349,152,279,149
"501050105",443,451,894,255,311,253
"500910205",518,479,997,245,287,233
"500910113",455,423,878,231,261,214
"500770203",37,15,52,19,29,18
"500980203",154,137,291,65,77,64
"500631111",285,322,607,163,227,161
"500630601",62,77,139,30,24,23
"500630217",84,77,161,36,40,35
"500560404",853,767,1620,388,447,373
"500490501",9,3,12,7,14,7
"500490101",11,6,17,4,7,4
"500420301",72,40,112,48,60,47
"500140504",443,415,858,259,314,254
"500140412",247,228,475,151,193,150
"500140305",125,81,206,66,143,66
"500140405",594,496,1090,329,418,317
"501190402",336,292,628,165,193,148
"501120303",211,219,430,117,143,110
"501051601",685,662,1347,388,419,367
"500140403",12,8,20,8,11,8
"500490601",138,24,162,0,1,0
"501051005",126,70,196,47,68,46
"500980104",861,770,1631,389,482,361
"500910302",664,685,1349,348,374,322
"500840706",333,297,630,173,187,161
"500840302",778,815,1593,423,429,400
"500700419",708,652,1360,362,389,334
"500700214",440,443,883,247,247,225
"500700207",965,1039,2004,522,519,476
"500700105",914,956,1870,478,542,437
"500700103",688,739,1427,422,484,394
"500630502",474,453,927,261,580,239
"500630501",609,655,1264,300,331,279
"500630411",1084,1127,2211,535,563,475
"500630402",829,798,1627,389,389,352
"500560604",763,785,1548,397,446,380
"500560501",655,619,1274,293,323,263
"500420101",323,318,641,178,195,170
"500350504",747,740,1487,390,412,361
"500280509",661,650,1311,345,363,316
"500140615",753,789,1542,458,508,454
"500140505",368,357,725,225,262,219
"501260501",1537,1433,2970,758,736,695
"501190613",1053,1138,2191,579,594,566
"501190406",528,531,1059,278,306,254
"501190405",319,308,627,146,161,139
"501190404",308,223,531,123,141,121
"501120201",575,565,1140,312,358,299
"501051208",484,447,931,252,297,251
"501051008",723,718,1441,386,376,353
"501050602",486,507,993,298,354,293
"501050202",729,742,1471,399,474,391
"500980819",605,573,1178,321,318,289
"500770201",307,263,570,183,173,105
"501050607",450,507,957,297,351,291
"500631009",365,350,715,176,167,147
"500631002",277,313,590,169,269,169
"500630218",566,606,1172,275,251,244
"500490307",75,38,113,17,16,16
"500070407",108,208,316,177,360,177
"501051906",864,824,1688,432,449,419
"501051904",412,427,839,241,249,236
"501051714",232,231,463,175,189,167
"501051712",449,562,1011,357,397,351
"501051702",451,491,942,260,262,246
"501051504",309,314,623,204,222,199
"501051412",303,403,706,262,310,262
"501051401",442,492,934,312,350,305
"501051817",296,297,593,184,220,182
"500701003",473,468,941,253,340,247
"500701002",476,496,972,259,272,256
"500701001",660,613,1273,303,302,280
"500700908",631,675,1306,397,387,370
"500700905",353,407,760,223,222,197
"500700903",1430,1445,2875,663,590,576
"500700815",364,413,777,236,223,209
"500700706",824,860,1684,413,391,371
"500700613",458,493,951,254,284,251
"500700609",363,408,771,227,223,213
"500700608",872,883,1755,459,406,383
"500700405",756,750,1506,404,444,373
"500700213",676,690,1366,377,399,364
"500631114",564,602,1166,316,314,303
"500631102",261,276,537,161,248,137
"500631015",342,347,689,194,276,180
"500630914",749,813,1562,399,362,347
"500490915",420,538,958,287,309,277
"501050518",191,237,428,157,206,155
"501050513",344,483,827,326,362,320
"501050421",939,967,1906,522,571,514
"501050405",636,656,1292,363,383,347
"501050404",317,327,644,162,170,158
"501050309",524,540,1064,298,271,250
"501050501",228,281,509,193,279,191
"501050204",794,797,1591,408,439,407
"500980909",726,775,1501,399,376,364
"500980814",297,360,657,215,234,201
"500980709",393,415,808,267,290,260
"500980509",330,358,688,186,152,144
"500980506",665,664,1329,358,356,331
"500980411",447,494,941,292,297,274
"500980404",531,618,1149,361,362,341
"500840812",522,590,1112,372,402,361
"500840811",485,522,1007,299,335,296
"500840809",622,641,1263,352,367,345
"500840804",384,392,776,236,234,221
"500840803",663,664,1327,361,352,334
"500840204",708,840,1548,505,526,484
"500770127",580,553,1133,285,301,273
"500980607",449,444,893,235,230,221
"500840407",410,392,802,239,250,233
"500490810",531,592,1123,304,275,255
"500490803",384,441,825,220,230,205
"500490801",512,557,1069,284,300,269
"500490407",461,521,982,290,379,271
"500490406",314,380,694,225,243,218
"500420411",421,414,835,219,214,196
"500281107",705,708,1413,328,261,256
"500281104",824,896,1720,417,337,314
"500281003",332,364,696,210,210,184
"500281001",470,520,990,314,329,289
"500630903",372,336,708,193,119,86
"500630901",521,517,1038,284,305,267
"500630304",264,261,525,152,211,147
"500630206",237,258,495,161,162,140
"500560603",578,630,1208,361,360,298
"500560405",336,326,662,191,199,182
"500491408",546,599,1145,316,309,292
"500491407",503,591,1094,313,329,307
"500491406",589,655,1244,372,357,338
"500491308",736,746,1482,365,360,343
"500491306",488,468,956,196,182,179
"500491301",555,559,1114,284,254,250
"500491202",478,492,970,261,287,258
"500491114",503,512,1015,241,202,199
"500491113",213,237,450,110,95,89
"500280611",458,505,963,255,217,210
"500280602",353,362,715,195,193,188
"500280519",612,550,1162,284,273,261
"500280415",517,594,1111,326,321,286
"500280310",798,845,1643,468,366,328
"500280214",298,317,615,185,209,182
"500280209",406,480,886,292,326,275
"500280206",474,546,1020,342,373,321
"500280112",248,285,533,175,212,163
"500280111",474,541,1015,345,391,320
"500211603",425,470,895,234,217,210
"500211601",929,916,1845,425,409,398
"500211508",206,242,448,173,199,156
"500211504",228,290,518,188,224,172
"500211605",570,628,1198,289,263,253
"500210802",521,544,1065,233,207,186
"500210613",707,779,1486,365,250,227
"500210601",519,634,1153,374,352,311
"500210508",653,711,1364,413,402,361
"500630812",598,600,1198,335,387,327
"500630705",90,85,175,40,248,40
"500350206",250,290,540,187,191,166
"500350104",393,395,788,221,237,219
"500282010",309,362,671,213,214,192
"500282009",450,535,985,338,405,331
"500281904",652,671,1323,298,303,281
"500281810",484,489,973,286,291,268
"500281707",785,749,1534,405,459,381
"500281610",420,498,918,297,341,292
"500281602",291,338,629,205,233,196
"500281404",354,486,840,308,354,306
"500281312",292,321,613,199,228,186
"500281311",336,392,728,223,235,208
"500281310",460,461,921,286,347,279
"500281305",500,527,1027,301,332,281
"500281304",476,545,1021,318,338,304
"500281219",605,692,1297,377,384,352
"500281212",438,471,909,233,232,228
"500210413",374,438,812,239,273,234
"500210410",235,314,549,211,250,211
"500210405",244,287,531,186,218,181
"501050508",270,314,584,198,223,195
"500210305",234,247,481,179,227,170
"500210214",363,385,748,215,237,204
"500210306",287,323,610,252,320,244
"500210209",392,462,854,295,318,291
"500210203",459,451,910,217,202,195
"500210117",233,259,492,152,162,148
"500210116",630,641,1271,306,291,272
"500210107",1433,1354,2787,656,647,603
"500210106",564,576,1140,281,197,194
"500140611",534,615,1149,373,387,349
"500140609",480,521,1001,312,340,305
"500140602",398,427,825,241,255,229
"500140409",503,555,1058,338,383,332
"501050506",381,424,805,285,310,266
"500071207",114,176,290,135,501,134
"500071201",138,202,340,152,313,150
"500071113",220,280,500,179,174,152
"500071107",366,404,770,257,290,249
"500211305",469,527,996,331,358,312
"500211109",286,401,687,256,328,240
"500211108",203,224,427,203,259,200
"500211103",179,227,406,155,180,143
"500211004",399,477,876,308,342,297
"500211001",372,456,828,260,268,252
"500210806",691,708,1399,327,309,294
"501051309",297,385,682,277,409,272
"500070906",326,346,672,269,341,262
"500070902",252,312,564,190,256,188
"500070807",225,369,594,212,334,208
"500070711",417,507,924,354,464,336
"500070506",361,409,770,299,384,294
"500070202",363,400,763,250,292,244
"500070115",168,243,411,192,284,191
"500070206",494,559,1053,354,427,338
"500070205",363,415,778,239,260,227
"500070408",102,177,279,167,283,163
"500070501",329,336,665,253,286,247
"501190310",640,686,1326,334,340,317
"501051912",560,577,1137,302,302,300
"501051608",116,116,232,66,82,63
"501050907",396,457,853,275,296,244
"501050515",405,434,839,270,275,254
"500700604",319,366,685,212,204,192
"500631103",908,921,1829,401,380,373
"500631007",385,372,757,206,211,193
"500630214",297,406,703,260,358,251
"500630105",332,340,672,187,221,180
"500350213",457,484,941,260,253,241
"500770122",690,677,1367,355,396,344
"500701004",556,539,1095,306,365,302
"500211105",171,197,368,147,192,144
"500210406",354,382,736,230,229,208
"500140411",342,292,634,188,217,183
"500281715",513,521,1034,244,254,220
"501260318",154,136,290,77,92,75
"501051012",409,503,912,255,455,254
"501050806",135,80,215,83,161,79
"501050804",39,29,68,21,29,21
"501050603",86,80,166,50,87,50
"501050601",79,45,124,45,92,45
"501050301",28,7,35,22,21,21
"501050103",525,456,981,282,362,276
"500980302",333,315,648,161,177,152
"500980103",650,517,1167,261,314,244
"500770402",581,348,929,220,321,207
"500770302",136,49,185,39,48,38
"500770401",41,17,58,14,19,14
"500700206",572,549,1121,273,303,258
"500700205",602,537,1139,293,316,271
"500700115",302,284,586,153,140,128
"500630401",587,497,1084,249,314,240
"500560614",155,149,304,73,105,68
"500490313",1005,934,1939,472,515,411
"500350402",284,253,537,135,168,131
"500350102",434,415,849,230,264,219
"500280507",997,961,1958,543,568,493
"500140201",87,43,130,59,93,57
"501260101",211,200,411,107,173,105
"501190101",3,6,9,2,5,2
"501120301",161,171,332,94,129,93
"501050903",482,420,902,229,333,223
"501050802",259,245,504,155,218,150
"501050801",439,385,824,243,287,241
"500770111",72,71,143,46,44,40
"500560507",590,621,1211,265,278,259
"500350502",312,264,576,144,159,128
"500840305",600,578,1178,308,322,282
"500840103",523,465,988,267,320,249
"500840101",656,630,1286,347,343,324
"500770120",466,428,894,267,205,169
"500700417",708,698,1406,382,356,324
"500630301",661,40,701,17,59,17
"500630310",1367,1376,2743,682,683,619
"500560615",582,561,1143,293,359,275
"500491101",10,12,22,7,8,7
"500490502",355,329,684,147,149,135
"500350203",798,845,1643,477,517,461
"500280511",827,816,1643,435,476,417
"500140715",501,518,1019,301,335,298
"500140502",424,440,864,236,250,205
"501190401",769,849,1618,418,423,355
"501190311",514,526,1040,269,304,259
"500980605",629,580,1209,304,338,294
"500560701",362,294,656,175,202,163
"500350214",612,643,1255,344,372,327
"500071309",662,703,1365,333,322,310
"501190303",714,721,1435,428,460,409
"501120204",652,671,1323,383,410,369
"501120102",998,1065,2063,554,555,517
"501051914",628,635,1263,306,286,265
"501051908",607,656,1263,364,381,351
"501051816",328,409,737,246,248,222
"501051814",286,352,638,168,180,163
"501051808",332,343,675,200,234,197
"501051805",434,508,942,333,370,329
"501051707",225,253,478,148,170,147
"501051518",670,701,1371,382,395,364
"501051515",247,278,525,171,179,164
"501051406",209,239,448,168,195,165
"501051301",251,253,504,182,213,180
"500700902",798,775,1573,345,316,313
"500700810",565,637,1202,360,381,351
"500700807",349,405,754,211,210,196
"500700707",417,466,883,273,271,260
"500700705",576,597,1173,312,295,277
"501260319",563,553,1116,306,296,281
"500700601",785,880,1665,451,440,415
"500700513",595,618,1213,320,304,288
"500700410",240,217,457,112,113,100
"500700408",1104,1104,2208,526,462,443
"500700402",572,596,1168,337,341,315
"500700107",314,310,624,148,143,132
"500631106",437,438,875,174,155,142
"500630913",405,440,845,256,245,230
"500630905",692,723,1415,358,324,315
"500491013",349,381,730,231,248,204
"500491003",367,401,768,209,205,164
"501050705",524,554,1078,310,359,308
"501050520",290,315,605,201,214,198
"501050416",321,413,734,251,271,241
"501050413",398,466,864,301,333,298
"501050408",540,593,1133,342,347,316
"501050407",747,741,1488,425,381,362
"501050403",361,414,775,241,249,237
"501050111",477,485,962,294,330,290
"500980906",504,574,1078,308,295,275
"500980903",622,654,1276,378,373,338
"500980809",449,510,959,290,289,266
"500980714",426,469,895,270,290,254
"500980706",375,461,836,295,308,277
"500980511",317,373,690,206,232,197
"500980505",654,692,1346,336,331,309
"500980405",444,499,943,314,313,298
"500910111",663,685,1348,370,364,351
"500910107",360,404,764,254,292,249
"500840808",571,657,1228,430,454,412
"500910109",453,482,935,302,335,293
"500770119",616,587,1203,315,334,300
"500770117",504,530,1034,321,381,312
"500770112",430,486,916,297,337,292
"500701008",318,352,670,207,213,187
"500490816",356,407,763,189,179,173
"500490814",491,578,1069,340,350,328
"500490808",833,815,1648,414,375,365
"500490715",436,465,901,272,300,261
"500490319",536,509,1045,269,241,221
"500490403",525,589,1114,337,369,324
"500490305",606,615,1221,329,332,307
"500490210",654,691,1345,337,335,318
"500490205",592,661,1253,310,306,293
"500420409",392,401,793,202,212,175
"500420408",489,556,1045,288,305,282
"500281206",416,490,906,278,281,271
"500281118",419,474,893,237,206,188
"500281111",344,390,734,212,227,202
"500281106",535,587,1122,273,249,235
"500281102",505,485,990,262,230,223
"500281010",510,535,1045,340,380,320
"500281005",300,321,621,207,209,183
"500281004",589,636,1225,335,347,322
"500280914",259,298,557,175,191,174
"500280910",522,552,1074,342,379,334
"500630205",336,423,759,237,257,216
"500630203",437,500,937,300,394,287
"500630108",327,318,645,182,207,172
"500630104",575,607,1182,320,362,301
"500560616",425,406,831,184,121,112
"500491401",483,515,998,272,329,262
"500281209",492,523,1015,288,287,279
"500280812",450,514,964,308,365,298
"500280805",430,497,927,305,352,282
"500280804",281,331,612,205,228,195
"500280803",280,318,598,200,221,195
"500280709",558,628,1186,325,318,308
"500280606",894,943,1837,470,406,402
"500280409",658,720,1378,362,376,333
"500280404",424,414,838,244,238,223
"500280315",893,974,1867,492,502,466
"500280313",821,820,1641,437,410,371
"500280303",521,516,1037,226,184,180
"500280210",308,372,680,207,225,197
"500280104",254,329,583,177,226,173
"500211408",475,509,984,242,231,223
"500211401",332,311,643,127,125,125
"500210801",603,623,1226,273,253,251
"500210709",484,507,991,283,241,217
"500210707",309,344,653,231,239,219
"500210610",321,350,671,221,222,199
"500210609",315,324,639,195,213,186
"500210608",655,723,1378,400,421,382
"500210607",458,585,1043,318,334,311
"500210603",479,467,946,275,277,256
"500210503",464,472,936,260,253,240
"500630806",250,278,528,137,276,133
"500350216",762,815,1577,453,462,433
"500350211",443,464,907,248,242,236
"500282005",376,440,816,252,248,215
"500281811",492,442,934,259,276,235
"500281805",732,789,1521,387,392,359
"500281706",629,684,1313,376,395,355
"500281608",531,529,1060,346,393,333
"500281309",325,366,691,204,211,191
"500281214",439,487,926,250,244,239
"500281208",312,315,627,180,188,174
"500210909",398,484,882,267,285,255
"500210411",600,664,1264,359,364,343
"500210403",457,523,980,297,300,261
"500210316",232,240,472,182,220,161
"500210219",226,244,470,119,121,115
"500210218",128,128,256,66,70,64
"500210210",277,338,615,218,232,213
"500210207",542,565,1107,318,324,295
"500210114",368,404,772,242,247,233
"500210113",436,466,902,300,313,293
"500210110",318,395,713,244,255,238
"500210105",404,512,916,271,277,259
"500140716",555,653,1208,364,392,356
"500140714",408,431,839,268,285,250
"500140616",531,577,1108,351,402,346
"500140608",237,282,519,199,239,193
"500140304",447,494,941,278,340,277
"500140408",536,571,1107,379,417,372
"500071303",661,653,1314,285,253,248
"500071302",568,556,1124,297,283,279
"500071209",197,282,479,244,531,238
"500071208",148,253,401,192,528,183
"500071205",149,165,314,138,317,137
"500071111",250,325,575,186,225,182
"500071105",372,453,825,310,331,302
"500071018",1373,0,1373,0,0,0
"500211309",500,561,1061,314,311,303
"500211211",398,457,855,279,310,251
"500211106",294,373,667,262,332,248
"500211007",507,621,1128,393,393,360
"500210903",241,288,529,223,377,219
"500210913",356,406,762,246,291,238
"500980811",750,823,1573,435,360,328
"500070801",278,284,562,164,245,164
"500070704",318,351,669,233,268,225
"500070701",317,326,643,212,241,205
"500070605",235,269,504,189,218,183
"500070601",283,329,612,212,226,181
"500070512",147,172,319,123,182,111
"500070313",294,291,585,166,323,141
"500070307",79,139,218,96,246,93
"500070301",346,411,757,258,312,248
"500070201",515,550,1065,365,419,347
"500070107",313,391,704,212,335,196
"500070102",428,454,882,273,302,226
"500070207",372,413,785,233,296,230
"500070405",119,149,268,124,265,124
"501050906",482,492,974,318,405,287
"501050605",273,307,580,194,237,191
"501050308",427,396,823,199,192,188
"500980413",273,373,646,216,231,189
"500700412",724,781,1505,382,312,311
"500631011",521,553,1074,330,381,319
"500491404",245,298,543,145,255,144
"500491213",407,450,857,234,233,220
"500840202",580,612,1192,295,305,282
"500281211",482,476,958,234,451,223
"500490505",965,944,1909,468,534,449
"500490311",304,344,648,202,202,197
"500071202",108,116,224,90,201,89
"500770202",160,146,306,93,135,92
"501260502",657,597,1254,306,325,281
"501051207",188,159,347,90,120,89
"501051102",458,460,918,273,300,266
"501051004",192,154,346,105,147,105
"501050902",28,20,48,14,31,14
"500980601",417,354,771,191,232,168
"500980305",534,527,1061,285,297,252
"500910601",144,114,258,79,123,79
"500910401",63,39,102,42,78,42
"500910102",346,309,655,164,175,137
"500770102",176,109,285,95,107,95
"500700113",504,470,974,232,273,213
"500700112",592,574,1166,294,314,275
"500630701",14,8,22,7,18,7
"500700201",449,379,828,197,236,185
"500630405",637,593,1230,293,309,288
"500210813",294,217,511,143,154,143
"501260205",5,1,6,4,8,4
"501260102",17,5,22,8,18,8
"501190205",739,630,1369,363,458,354
"501190203",113,99,212,52,96,52
"501190202",267,272,539,137,191,137
"501120203",200,233,433,114,141,110
"501051607",369,340,709,185,207,159
"501051605",1150,1011,2161,466,522,453
"501051603",768,743,1511,395,442,384
"500980609",520,453,973,253,264,241
"500700422",520,545,1065,304,291,268
"500770301",416,336,752,228,211,184
"500980101",632,582,1214,326,350,300
"500910303",511,450,961,249,274,224
"500840308",497,469,966,249,313,235
"500840217",187,202,389,104,99,95
"500700425",465,455,920,259,319,249
"500700411",579,570,1149,305,323,296
"500700308",506,492,998,246,245,229
"500700116",1148,1158,2306,560,552,501
"500630409",681,687,1368,358,349,315
"500630311",530,549,1079,287,328,255
"500560406",523,525,1048,270,304,262
"500490603",93,69,162,52,76,52
"500490503",1023,931,1954,445,508,353
"500420412",244,265,509,126,96,76
"500280501",364,362,726,163,158,156
"500280516",985,962,1947,487,459,415
"501260314",702,731,1433,369,405,358
"501190602",178,211,389,102,103,97
"501190409",848,802,1650,453,491,429
"501190403",831,857,1688,442,486,430
"501120103",437,368,805,209,280,205
"501050901",292,270,562,142,189,142
"500980907",1020,1114,2134,528,629,501
"500980820",472,454,926,252,279,242
"501051011",376,354,730,220,250,212
"500560608",479,466,945,247,250,217
"500560401",362,316,678,160,178,153
"500980810",448,526,974,294,296,282
"501260307",438,497,935,285,324,280
"501190611",345,380,725,212,216,208
"501190609",257,308,565,197,225,193
"501190312",333,309,642,198,210,173
"501120305",473,495,968,280,310,271
"501051903",291,331,622,179,190,175
"501051902",629,702,1331,405,490,403
"501051809",378,405,783,236,252,225
"501051410",246,315,561,212,228,208
"501051408",256,307,563,194,229,190
"501051407",245,277,522,164,214,164
"501051403",233,289,522,202,226,199
"501051304",236,278,514,182,219,182
"500700910",444,466,910,238,216,198
"500700909",407,441,848,226,202,194
"500700907",473,533,1006,288,308,265
"500700802",443,496,939,274,291,258
"500700602",858,896,1754,470,449,428
"500700508",427,460,887,283,274,262
"500700506",526,601,1127,326,305,297
"500700501",936,971,1907,519,531,493
"500700108",316,354,670,205,202,188
"500631108",504,547,1051,291,279,262
"500631104",665,628,1293,312,295,216
"500491011",378,431,809,249,274,247
"501050708",362,393,755,236,255,235
"501050417",416,515,931,302,335,298
"501050305",402,420,822,231,207,198
"501050304",1033,1023,2056,562,548,512
"501050108",551,624,1175,358,391,357
"500980904",618,677,1295,368,368,344
"500980806",689,788,1477,455,459,413
"500980803",880,924,1804,414,393,380
"500980718",356,444,800,255,325,253
"500980717",292,363,655,203,230,183
"500980716",584,590,1174,347,380,341
"500980712",324,386,710,227,238,213
"500980707",392,478,870,288,306,278
"500980510",371,343,714,208,208,201
"500980508",793,790,1583,410,375,358
"500980412",352,428,780,260,282,245
"500980410",311,361,672,205,243,204
"500980409",509,577,1086,352,333,297
"500980407",716,724,1440,408,436,388
"500980308",669,677,1346,379,392,360
"500910203",737,728,1465,386,361,334
"500840802",649,707,1356,326,319,304
"500840215",630,621,1251,290,276,273
"500840213",477,524,1001,352,378,327
"500840209",203,297,500,183,234,178
"500840208",317,337,654,227,271,213
"500770123",577,654,1231,347,372,322
"500770118",409,407,816,229,221,185
"500770108",463,469,932,297,361,279
"500701012",596,580,1176,335,398,332
"500701011",260,329,589,199,223,189
"500490912",273,290,563,174,182,168
"500490906",520,551,1071,306,335,287
"500490901",589,618,1207,385,390,356
"500490819",362,410,772,202,200,191
"500490817",572,628,1200,337,343,313
"500490905",532,601,1133,339,350,316
"500490807",635,652,1287,332,324,303
"500490712",436,468,904,261,292,232
"500490710",248,270,518,153,156,142
"500490412",400,445,845,253,268,236
"500490411",516,580,1096,344,386,337
"500490410",428,475,903,274,262,244
"500490405",325,392,717,223,238,217
"500490404",477,557,1034,326,361,315
"500490320",565,573,1138,290,284,265
"500490316",697,693,1390,291,258,254
"501050510",337,453,790,292,346,282
"500490208",562,560,1122,250,240,228
"500281201",780,817,1597,429,451,414
"500281117",433,510,943,271,232,221
"500280912",436,454,890,286,305,274
"500280905",516,560,1076,312,326,304
"500280903",374,468,842,303,335,296
"500980722",403,393,796,218,220,200
"500980721",435,393,828,213,210,203
"500630207",256,321,577,173,179,168
"501051310",306,428,734,282,361,276
"500630201",369,434,803,235,238,229
"500630109",616,666,1282,349,418,336
"500560611",640,665,1305,305,284,273
"500560606",682,728,1410,384,410,376
"500491402",734,781,1515,415,414,377
"500491217",352,381,733,235,246,232
"500491211",264,327,591,169,182,167
"500491206",381,446,827,253,286,247
"500280819",251,246,497,156,199,155
"500280806",425,461,886,289,290,235
"500280711",446,404,850,271,356,270
"500280518",319,309,628,159,153,148
"500280505",420,364,784,175,178,167
"500280502",705,679,1384,348,337,324
"500280413",859,869,1728,385,371,352
"500280408",587,620,1207,261,267,248
"500280405",402,427,829,247,257,228
"500280403",811,824,1635,445,467,402
"500280308",569,582,1151,354,309,292
"500280305",650,642,1292,303,213,208
"500280304",856,840,1696,365,320,305
"500280211",454,464,918,295,336,280
"500280207",322,361,683,235,279,234
"500280204",283,279,562,181,190,175
"500211610",335,351,686,172,155,147
"500211607",675,676,1351,348,310,301
"500211502",341,382,723,301,398,283
"500211407",706,787,1493,368,336,325
"500211402",432,499,931,234,206,201
"500210910",409,481,890,290,314,260
"500210710",239,268,507,161,171,152
"500210705",381,424,805,279,285,243
"500210704",389,408,797,271,275,251
"500210701",357,400,757,268,310,257
"500210602",371,456,827,260,282,249
"500210511",352,397,749,245,251,233
"500210510",395,460,855,271,267,255
"500210509",548,613,1161,364,370,356
"500210501",222,257,479,152,158,145
"500630810",310,340,650,175,188,173
"500630804",550,676,1226,374,355,335
"500420405",233,262,495,177,210,174
"500420410",345,357,702,210,229,202
"500350218",499,567,1066,277,285,273
"500282006",407,468,875,280,315,273
"500282002",386,458,844,250,263,237
"500281907",411,434,845,205,193,176
"500281903",380,407,787,189,210,176
"500281801",511,521,1032,266,277,259
"500281704",358,423,781,229,228,206
"500281703",554,620,1174,345,338,320
"500281601",378,458,836,278,275,243
"500281506",852,802,1654,395,390,357
"500281409",377,461,838,296,315,286
"500281406",409,468,877,252,267,246
"500281403",240,308,548,216,272,211
"500281401",256,279,535,184,226,179
"500210415",340,355,695,175,160,148
"500210119",249,220,469,128,132,124
"500210108",529,556,1085,317,329,306
"500140709",456,490,946,327,312,291
"500140707",421,482,903,300,331,287
"500140606",328,401,729,251,269,250
"500140713",313,338,651,230,275,223
"500140410",473,512,985,320,350,307
"501050505",238,269,507,183,214,181
"500071307",672,664,1336,347,351,334
"500071203",135,214,349,159,338,152
"500071104",370,426,796,294,317,282
"500071022",267,250,517,122,105,102
"500071016",242,234,476,119,115,112
"500070401",405,476,881,227,382,226
"500211308",380,422,802,234,242,223
"500211306",295,340,635,233,245,223
"500211302",269,276,545,176,173,161
"500211210",369,401,770,240,252,234
"500211209",445,496,941,269,293,256
"500211206",519,542,1061,239,182,176
"500211101",245,322,567,203,320,201
"500211009",391,480,871,293,332,286
"500210906",388,415,803,282,315,256
"500210809",323,387,710,201,203,193
"500071013",9,3,12,1,1,1
"500070810",280,351,631,264,312,236
"500070710",396,435,831,297,354,275
"500070607",384,410,794,297,375,282
"500070314",128,182,310,149,387,132
"500070310",216,242,458,169,262,160
"500070309",125,171,296,133,285,131
"500070305",129,137,266,126,205,125
"500070116",220,246,466,113,236,111
"500070113",163,232,395,131,328,126
"500070410",102,159,261,146,243,141
"500070210",330,424,754,255,308,250
"500070406",47,68,115,60,157,59
"501120205",635,678,1313,344,351,319
"501050808",197,222,419,116,131,112
"500980507",404,415,819,257,263,240
"500980416",242,274,516,159,191,154
"500700611",304,375,679,208,207,193
"500700504",394,420,814,234,237,223
"500631013",557,618,1175,334,351,320
"500631006",473,521,994,250,244,239
"500491203",716,745,1461,373,343,333
"500281802",542,575,1117,303,320,297
"500910208",554,651,1205,353,367,339
"500910204",493,576,1069,343,378,341
"500280402",406,420,826,221,227,204
"500071308",577,571,1148,291,278,266
"500490304",635,669,1304,366,352,329
"501051204",143,122,265,84,118,82
"501051201",199,195,394,116,149,112
"501051009",452,457,909,226,275,218
"501050701",16,5,21,8,16,8
"501050113",495,467,962,272,277,263
"500980612",453,429,882,236,267,225
"500980610",317,288,605,154,161,135
"500980501",371,363,734,178,207,169
"500980304",445,470,915,240,268,221
"500770103",324,295,619,159,187,132
"500700306",387,343,730,172,186,157
"500700303",742,708,1450,370,422,340
"500700104",354,373,727,183,182,150
"500700202",742,615,1357,308,338,280
"500630305",668,635,1303,350,515,317
"500560201",532,447,979,300,381,295
"500560502",260,228,488,121,148,118
"500420302",41,29,70,29,39,29
"500420102",138,103,241,78,117,78
"500350303",616,592,1208,351,359,321
"500140303",140,110,250,82,116,81
"501260202",231,191,422,100,117,97
"501190501",231,161,392,80,145,77
"501190206",582,490,1072,265,282,252
"501051606",96,80,176,29,32,29
"501050106",565,648,1213,351,388,323
"500630408",487,437,924,216,272,214
"500140302",187,155,342,95,146,93
"500910304",434,422,856,240,267,227
"500910201",680,672,1352,330,359,303
"500910101",1037,1067,2104,553,579,528
"500840304",626,683,1309,343,356,325
"500840303",444,493,937,266,310,252
"500700304",586,539,1125,292,318,271
"500700211",803,732,1535,389,414,347
"500630410",736,699,1435,376,387,324
"500560610",489,455,944,239,270,218
"500560503",492,481,973,220,225,191
"500491104",308,290,598,160,218,123
"500491102",53,58,111,26,29,25
"500420402",201,224,425,114,136,104
"500350202",602,624,1226,326,366,314
"501260313",451,409,860,234,282,231
"501260309",737,682,1419,356,385,324
"501260303",1058,1038,2096,551,541,484
"501120101",466,424,890,222,273,214
"501051602",730,752,1482,447,491,433
"501051101",598,627,1225,358,365,330
"501051110",441,412,853,244,309,242
"501051001",32,14,46,19,146,19
"501050807",360,267,627,177,234,174
"501050307",475,507,982,288,294,282
"501050104",516,524,1040,294,315,282
"500980606",678,632,1310,320,330,298
"501120105",310,310,620,158,197,144
"501051106",869,840,1709,469,532,450
"500840306",524,498,1022,254,279,239
"500280508",1025,997,2022,492,501,470
"501260306",600,632,1232,375,363,337
"501190610",359,451,810,264,299,259
"501190408",850,851,1701,458,495,438
"501190308",1083,1141,2224,574,563,522
"501190305",655,711,1366,420,429,384
"501051901",297,306,603,191,214,189
"501051815",393,460,853,300,326,290
"501051811",342,403,745,243,269,238
"501051802",182,222,404,129,131,122
"501051711",355,431,786,286,311,277
"501051709",340,450,790,264,255,232
"501051706",425,444,869,217,211,202
"501051704",395,435,830,263,268,246
"501190304",673,722,1395,430,467,422
"501051703",444,444,888,265,272,257
"501051519",555,516,1071,274,290,267
"501051514",396,430,826,245,246,228
"501051501",532,631,1163,378,436,373
"501051312",240,342,582,211,309,210
"501051303",302,358,660,244,280,238
"500701005",284,285,569,151,157,144
"500700901",465,482,947,273,229,211
"500700814",485,530,1015,307,313,288
"500700812",540,614,1154,314,327,298
"500700809",428,405,833,219,220,211
"500700808",479,521,1000,281,298,273
"500700704",348,370,718,187,214,182
"500700610",318,383,701,221,210,203
"500700605",395,418,813,252,263,240
"500700603",727,805,1532,447,473,436
"500700512",701,720,1421,373,320,297
"500700511",576,648,1224,371,354,336
"500700403",726,763,1489,365,374,346
"500700110",1527,1531,3058,804,730,682
"500700106",710,746,1456,431,450,394
"500631105",759,789,1548,346,334,322
"500631101",616,682,1298,376,401,369
"500631016",218,233,451,118,91,77
"500631005",504,535,1039,289,357,269
"500630915",556,634,1190,315,321,299
"500980108",603,602,1205,310,324,296
"500491012",453,564,1017,291,319,289
"500491009",344,392,736,221,220,210
"500491004",244,299,543,166,146,141
"501050606",516,522,1038,287,334,283
"500980910",467,513,980,280,273,259
"500980802",838,846,1684,431,408,387
"500980713",264,296,560,195,208,192
"500980708",257,317,574,185,184,175
"500980705",653,716,1369,344,345,327
"500980703",429,506,935,254,230,224
"500980403",483,582,1065,333,336,314
"500910206",556,589,1145,314,314,294
"500840813",840,801,1641,406,377,363
"500840203",419,457,876,248,259,234
"500770110",428,389,817,271,314,260
"500701010",460,531,991,322,359,313
"500490908",334,333,667,207,284,185
"500490907",432,477,909,277,299,269
"500490904",321,317,638,184,196,174
"500490708",387,447,834,218,183,177
"500490707",376,426,802,213,204,195
"500490701",464,492,956,225,219,205
"500490408",299,357,656,212,349,191
"500490318",457,446,903,228,187,181
"500490306",766,715,1481,355,356,332
"500490216",846,934,1780,385,337,328
"500490212",696,748,1444,351,338,328
"500490206",658,676,1334,318,296,290
"500420407",415,418,833,247,277,244
"500281204",618,681,1299,322,286,279
"500281115",577,617,1194,297,247,235
"500281112",460,547,1007,294,308,278
"500281110",642,684,1326,359,345,320
"500281103",767,815,1582,425,385,357
"500281008",603,684,1287,395,401,365
"500280911",213,259,472,159,202,152
"500280909",384,505,889,284,300,261
"500280907",233,251,484,165,239,165
"500700510",670,733,1403,403,390,351
"500630902",0,0,0,0,208,0
"500630209",289,333,622,191,200,185
"500630110",281,294,575,170,214,167
"500630107",602,603,1205,364,429,326
"500491412",687,664,1351,325,296,282
"500491310",688,717,1405,370,363,330
"500491305",464,469,933,209,205,204
"500491304",641,675,1316,335,279,269
"500491204",347,322,669,204,261,188
"500491201",369,361,730,169,172,158
"500280820",290,298,588,197,231,185
"500280808",483,553,1036,303,293,266
"500280904",229,292,521,179,196,176
"500280802",256,294,550,177,187,169
"500280707",447,534,981,276,303,266
"500280613",511,544,1055,305,279,269
"500280704",575,581,1156,306,353,302
"500280607",657,669,1326,339,296,287
"500280603",353,338,691,203,189,184
"500280517",1090,1133,2223,555,557,517
"500280411",687,739,1426,321,255,250
"500280208",295,348,643,205,255,199
"500280203",389,464,853,256,248,230
"500280107",300,366,666,242,297,235
"500211503",231,259,490,125,177,123
"500211409",591,603,1194,303,210,181
"500211404",447,481,928,238,203,201
"500211314",409,474,883,230,240,219
"500210803",653,723,1376,306,240,238
"500210702",422,510,932,316,347,303
"500210612",485,476,961,269,276,256
"500210419",233,229,462,127,126,121
"500210418",569,613,1182,327,340,308
"500630813",425,453,878,260,305,251
"500630809",673,691,1364,346,358,317
"500630706",35,34,69,25,150,25
"500700711",385,447,832,263,285,252
"500281809",543,585,1128,303,311,293
"500281808",509,496,1005,247,273,245
"500281807",778,792,1570,409,370,347
"500281705",367,395,762,238,244,226
"500281702",461,513,974,284,296,259
"500281603",340,382,722,229,243,212
"500281408",465,485,950,304,324,290
"500281402",269,329,598,212,245,208
"500281307",287,301,588,180,195,164
"500281301",464,498,962,318,352,301
"500281218",380,461,841,268,284,257
"500281215",366,409,775,229,233,224
"500281207",362,401,763,232,240,220
"500210401",608,601,1209,290,284,272
"500210317",275,322,597,217,290,208
"500210315",230,254,484,169,184,152
"500210308",515,583,1098,361,374,323
"500210206",444,487,931,259,254,229
"500140708",512,599,1111,325,320,299
"500140702",597,613,1210,330,340,305
"500140406",540,540,1080,339,364,333
"500071304",589,626,1215,325,280,280
"500280706",561,605,1166,310,322,282
"500071210",234,307,541,233,468,226
"500071206",193,233,426,195,440,194
"500071112",235,275,510,174,203,169
"500071109",315,361,676,230,280,226
"500071108",454,531,985,375,438,370
"500700509",338,336,674,219,209,192
"500211307",587,639,1226,347,341,330
"500211207",702,748,1450,297,245,240
"500211102",53,65,118,46,152,46
"500211010",335,375,710,214,206,187
"500210904",324,384,708,263,313,249
"500210808",545,590,1135,297,298,280
"500071010",646,730,1376,332,261,246
"500071001",592,587,1179,326,385,323
"500070910",311,345,656,263,362,263
"500070908",340,341,681,221,280,209
"500070806",254,317,571,251,352,245
"500070805",233,239,472,173,247,168
"500070707",303,363,666,234,265,227
"500070703",311,403,714,254,265,228
"500070606",607,648,1255,422,481,408
"500070604",272,348,620,215,249,206
"500070603",309,382,691,239,281,228
"500070510",335,432,767,284,414,282
"500070509",357,405,762,265,339,235
"500070507",177,222,399,164,241,149
"500070504",153,199,352,163,191,153
"500070316",175,206,381,156,244,156
"500070311",347,352,699,176,247,170
"500070303",354,389,743,302,410,279
"500070214",367,383,750,270,323,245
"500070203",505,618,1123,349,385,342
"500070106",303,361,664,268,332,256
"501051302",278,319,597,216,228,202
"500630111",258,249,507,151,180,151
"500491405",604,650,1254,341,340,308
"500491110",585,678,1263,387,367,347
"500281803",848,871,1719,410,370,360
"500281606",278,340,618,187,225,186
"500211005",246,279,525,171,183,156
"500490310",283,347,630,188,194,180
"500071006",775,839,1614,413,352,345
"500210307",234,280,514,183,227,178
"501260503",605,545,1150,281,320,275
"501260401",601,530,1131,276,137,98
"501051203",171,173,344,106,136,105
"501051107",811,781,1592,403,482,388
"501051105",1077,1035,2112,572,631,555
"501051109",233,206,439,135,167,132
"501050703",441,443,884,242,306,235
"501050203",509,446,955,268,326,257
"501050110",402,373,775,223,271,214
"500980912",555,519,1074,273,261,249
"500980817",339,362,701,187,192,176
"500980206",70,39,109,41,53,39
"500910104",360,328,688,165,177,143
"500840704",333,316,649,167,192,158
"500840401",145,121,266,60,67,59
"500770101",239,155,394,90,88,82
"500700114",652,603,1255,305,382,288
"500980201",63,40,103,23,28,23
"500980107",304,242,546,135,153,120
"500630504",464,392,856,203,289,196
"500630503",423,352,775,178,295,172
"500700118",466,443,909,248,246,232
"500560505",334,316,650,140,245,136
"500350302",613,640,1253,348,376,335
"501050109",155,182,337,96,108,91
"500560601",251,239,490,121,135,109
"500281714",422,432,854,226,240,204
"500910305",628,617,1245,347,402,340
"500910112",460,423,883,225,257,213
"500910108",617,645,1262,367,383,337
"500910105",667,718,1385,405,428,390
"500700302",1074,1084,2158,563,577,515
"500630407",541,525,1066,283,265,233
"500560506",501,483,984,223,234,203
"500560504",602,600,1202,297,327,274
"500560409",560,564,1124,309,335,299
"500420403",226,211,437,123,163,122
"500210115",857,777,1634,372,333,327
"500140404",453,483,936,281,348,274
"501260317",583,566,1149,278,303,264
"501260301",1670,1543,3213,800,841,761
"501190607",669,789,1458,436,389,298
"501120104",802,721,1523,424,445,404
"501051007",538,556,1094,317,389,310
"501050904",582,605,1187,323,345,299
"501050306",757,773,1530,435,500,415
"501260302",369,381,750,182,180,169
"501190601",489,490,979,260,295,256
"500560612",457,424,881,222,238,204
"501051205",516,517,1033,309,343,301
"500490506",252,226,478,154,354,153
"500210917",255,335,590,179,177,156
"501190407",947,955,1902,508,530,491
"501190309",992,1012,2004,509,472,442
"501190302",641,670,1311,376,390,355
"501190301",804,851,1655,450,446,423
"501051913",472,427,899,254,256,246
"501051813",270,331,601,219,243,214
"501051517",611,621,1232,369,385,359
"501051516",655,342,997,175,188,162
"501051510",381,449,830,245,265,235
"501051506",385,405,790,249,256,237
"501051411",323,347,670,242,270,238
"501051404",244,295,539,209,283,203
"501051402",163,170,333,131,151,129
"500700912",584,598,1182,300,275,260
"500700911",823,794,1617,403,375,343
"500700816",578,600,1178,319,380,312
"500700813",421,430,851,233,230,211
"500700804",556,641,1197,331,347,325
"500700606",478,513,991,302,309,274
"500700407",866,907,1773,468,396,357
"500700109",1349,1268,2617,656,603,585
"500631115",358,401,759,212,229,211
"500631107",278,259,537,122,357,93
"500631004",335,341,676,188,223,166
"500630909",537,567,1104,302,296,268
"500630907",884,867,1751,424,368,346
"500491111",425,478,903,270,238,223
"500491109",342,326,668,196,300,194
"500491108",301,326,627,174,211,172
"500491107",200,221,421,120,276,119
"500491106",345,378,723,199,228,162
"500630212",359,388,747,232,221,204
"500491119",537,530,1067,303,254,240
"500491103",704,699,1403,356,330,316
"500491006",323,381,704,188,185,175
"500490917",374,391,765,232,243,219
"501051413",425,467,892,326,361,319
"501050521",242,300,542,187,195,170
"501050419",748,792,1540,411,393,364
"501050410",402,423,825,217,229,207
"501050402",504,568,1072,314,339,295
"501050401",442,564,1006,306,324,294
"500980911",712,709,1421,327,299,286
"500980710",214,241,455,158,240,143
"500980704",413,497,910,233,235,218
"500980702",600,665,1265,352,325,311
"500980417",623,641,1264,378,439,374
"500980415",664,727,1391,402,417,383
"500980402",484,570,1054,306,300,284
"500840801",359,375,734,214,226,211
"500770115",412,448,860,229,258,223
"500770109",403,412,815,270,337,267
"500701007",382,395,777,219,245,200
"500490910",438,472,910,274,274,259
"500490903",378,386,764,209,196,173
"500490820",401,436,837,240,244,228
"500490818",489,494,983,250,255,234
"500490815",654,687,1341,345,359,316
"500490809",685,738,1423,332,299,291
"500490709",553,527,1080,288,373,243
"500490402",574,616,1190,350,368,326
"500490321",695,650,1345,322,317,294
"500490211",575,588,1163,281,253,246
"500281203",519,591,1110,300,279,271
"500281113",330,341,671,194,210,186
"500281108",596,664,1260,340,284,261
"500281007",624,660,1284,374,407,343
"500280906",565,668,1233,363,373,349
"500280901",528,529,1057,315,340,289
"500630814",623,670,1293,367,399,352
"500630308",418,421,839,220,212,205
"500630208",320,378,698,242,250,208
"500560613",496,485,981,236,235,223
"500491410",650,656,1306,317,309,279
"500491409",419,463,882,260,251,243
"500491307",736,810,1546,381,376,353
"500491313",481,510,991,247,234,221
"500491116",567,614,1181,290,258,249
"500491115",338,372,710,175,166,157
"500280818",233,265,498,147,157,144
"500280712",542,563,1105,318,355,295
"500280710",329,369,698,213,223,202
"500280504",503,481,984,248,258,240
"500280317",495,525,1020,301,326,296
"500280212",424,462,886,322,375,309
"500280105",350,405,755,241,299,230
"500211608",598,666,1264,328,300,293
"500211602",800,889,1689,396,326,325
"500211506",230,304,534,192,219,171
"500211501",530,613,1143,416,501,411
"500211606",780,857,1637,389,342,324
"500211410",562,583,1145,293,306,265
"500211313",595,638,1233,399,431,395
"500210604",476,559,1035,312,340,305
"500210507",421,481,902,292,303,284
"500210505",443,469,912,257,261,242
"500630805",431,510,941,260,244,228
"500630803",462,549,1011,297,302,252
"500490919",261,280,541,173,175,158
"500350210",535,596,1131,356,330,304
"500350209",585,670,1255,415,406,367
"500350208",388,396,784,230,236,221
"500350204",332,389,721,233,238,226
"500282011",380,414,794,242,262,231
"500281905",1069,1079,2148,529,500,475
"500281902",416,460,876,243,244,221
"500281812",425,464,889,225,241,213
"500281710",516,537,1053,291,267,237
"500281611",513,577,1090,357,395,331
"500281604",424,487,911,296,349,283
"500281505",863,933,1796,427,384,368
"500281414",326,322,648,223,291,220
"500281411",289,333,622,232,251,226
"500281302",465,542,1007,317,346,305
"500281213",413,401,814,226,228,215
"500210416",260,302,562,194,221,181
"500210404",438,469,907,322,367,295
"500210313",213,266,479,203,236,196
"500210312",239,279,518,203,252,200
"500210304",429,485,914,316,360,300
"500210302",174,244,418,162,263,156
"500210215",502,552,1054,333,339,305
"500210212",452,541,993,337,368,332
"500210201",449,483,932,268,262,241
"500210111",660,758,1418,379,377,360
"500140710",421,562,983,375,396,339
"500140604",340,452,792,303,384,299
"501050507",355,391,746,232,235,220
"500071103",332,432,764,265,272,234
"500071021",492,534,1026,249,191,183
"500071020",443,405,848,259,318,250
"500070402",153,245,398,196,484,196
"500211311",460,548,1008,334,354,322
"500211202",459,552,1011,317,336,302
"500211201",210,243,453,148,158,141
"500211604",771,784,1555,376,358,347
"500211008",375,398,773,284,332,282
"500210908",180,249,429,151,155,132
"500210901",284,305,589,186,211,177
"500210807",754,845,1599,383,340,325
"500210805",402,447,849,212,186,183
"501051308",176,196,372,152,198,151
"500071011",371,374,745,188,131,127
"500071009",611,648,1259,325,334,294
"500071007",279,333,612,241,290,237
"500071004",787,800,1587,381,306,296
"500070911",291,292,583,217,267,213
"500070909",128,136,264,82,96,80
"500070907",292,355,647,256,339,249
"500070903",247,320,567,199,283,196
"500070808",167,234,401,147,207,137
"500070804",113,164,277,108,177,107
"500070610",418,428,846,343,448,322
"500070609",238,260,498,198,209,170
"500070602",274,307,581,225,264,218
"500070508",333,401,734,265,396,261
"500070306",125,180,305,114,249,111
"500070304",299,338,637,230,281,215
"500070117",192,235,427,162,244,146
"500070109",284,350,634,202,281,184
"500070403",96,134,230,121,319,120
"500070502",319,353,672,260,283,242
"500070412",326,384,710,226,444,219
"501051006",568,598,1166,317,377,315
"501050517",249,301,550,213,278,213
"500980105",543,512,1055,282,291,270
"500700305",1041,1024,2065,567,569,535
"500491403",455,517,972,275,278,260
"500282003",297,346,643,199,213,195
"500281804",600,624,1224,307,329,294
"500840212",418,444,862,260,297,251
"500280410",578,557,1135,249,223,216
"500490813",230,262,492,152,158,146
"500490706",372,390,762,210,215,196
"500490409",624,662,1286,381,387,357
"500490214",595,573,1168,271,231,222
"501260308",305,268,573,161,190,160
"501051108",325,329,654,183,222,179
"501051003",90,66,156,50,85,50
"501050805",12,5,17,8,16,8
"501050803",224,221,445,126,183,126
"501050303",434,426,860,237,249,229
"501050302",380,375,755,222,287,214
"500980205",213,200,413,100,109,95
"500840701",255,216,471,125,151,117
"500840501",170,123,293,80,125,76
"500840405",374,345,719,189,215,173
"500980204",256,252,508,126,149,119
"500770104",187,120,307,90,107,89
"500631112",292,288,580,163,226,160
"500700203",443,399,842,211,243,194
"500630602",84,88,172,47,41,41
"500630303",124,124,248,59,99,51
"500490315",695,634,1329,329,364,312
"500490302",628,578,1206,291,330,287
"500350503",191,178,369,94,112,85
"500350401",237,205,442,119,124,110
"500281713",499,450,949,254,281,242
"500280513",614,650,1264,322,351,297
"500280503",725,686,1411,341,359,325
"500140501",558,552,1110,335,420,320
"500140301",68,54,122,35,54,33
"500140401",344,293,637,188,264,185
"500140407",21,16,37,10,10,10
"500700102",597,611,1208,295,323,270
"500910306",688,656,1344,357,398,349
"500910207",560,559,1119,292,265,250
"500840403",652,610,1262,327,339,300
"500840201",998,930,1928,519,524,468
"500980202",429,381,810,210,258,189
"500700418",590,574,1164,323,357,301
"500700416",763,795,1558,396,409,325
"500700415",416,397,813,217,244,211
"500630702",61,43,104,28,226,28
"500630307",614,688,1302,335,461,316
"500560609",720,680,1400,331,350,305
"500560402",425,424,849,230,259,221
"500490602",65,63,128,46,68,45
"500350505",242,208,450,112,119,103
"500350403",715,697,1412,390,409,365
"500280514",638,615,1253,319,317,286
"501260504",759,702,1461,338,375,331
"501190612",681,708,1389,375,411,368
"501120302",498,453,951,241,283,203
"501051010",77,69,146,44,655,44
"500980603",540,514,1054,266,288,247
"500980608",551,542,1093,305,306,265
"500350507",408,393,801,211,231,199
"500070308",129,153,282,124,314,123
"501260311",605,652,1257,349,328,304
"501260305",559,604,1163,374,407,362
"501190605",337,450,787,257,279,249
"501190603",659,740,1399,385,394,367
"501120304",573,556,1129,306,338,290
"501051909",526,576,1102,300,315,295
"501051812",298,389,687,215,220,209
"501051804",563,689,1252,411,429,406
"501051803",352,379,731,232,235,224
"501051708",341,402,743,244,263,239
"501051513",528,624,1152,342,362,330
"501051511",468,493,961,298,309,286
"501051509",319,384,703,224,254,221
"501051502",299,327,626,184,201,179
"501051405",382,434,816,307,399,306
"500700805",820,854,1674,460,464,385
"500700801",553,558,1111,313,354,284
"500700712",285,300,585,173,180,163
"500700710",241,294,535,171,176,162
"500700703",513,609,1122,311,325,292
"500700701",292,375,667,219,272,215
"500700514",508,559,1067,310,307,260
"500700406",802,841,1643,485,440,417
"500631113",554,577,1131,324,324,299
"500630912",548,540,1088,290,267,247
"500630906",637,753,1390,360,477,328
"500491311",670,701,1371,355,355,326
"500491007",706,721,1427,356,320,312
"500491005",426,471,897,257,277,227
"500491002",567,651,1218,335,336,320
"500490916",553,601,1154,309,287,267
"501050707",356,403,759,228,244,223
"501050608",115,141,256,98,115,98
"501050418",536,649,1185,354,376,350
"501050504",369,506,875,264,372,258
"500980908",617,647,1264,287,264,262
"500980901",368,428,796,258,272,243
"500980821",273,278,551,122,120,117
"500980816",213,278,491,167,214,164
"500980815",291,327,618,209,219,187
"500980813",395,438,833,234,259,232
"500980808",452,555,1007,351,399,339
"500980807",528,592,1120,379,404,357
"500980804",781,830,1611,390,385,370
"500980719",678,710,1388,344,334,322
"500980711",276,314,590,197,238,188
"500980504",641,697,1338,325,332,309
"500980406",597,618,1215,335,360,331
"500840807",340,398,738,243,256,224
"500840806",634,725,1359,427,422,387
"500840406",396,387,783,209,207,193
"500840309",441,481,922,262,258,249
"500840210",394,425,819,233,239,228
"500840104",337,387,724,240,261,235
"500840205",621,648,1269,370,368,351
"500770116",675,796,1471,394,246,211
"500770113",474,503,977,311,354,301
"500770107",307,368,675,235,283,224
"500770106",477,445,922,246,274,233
"500490909",481,520,1001,299,296,277
"500490902",400,402,802,220,224,210
"500490811",717,739,1456,333,306,300
"500490804",605,603,1208,304,316,293
"500490802",544,633,1177,347,357,337
"500490714",239,281,520,172,162,137
"500490705",653,759,1412,361,343,317
"500910110",354,360,714,218,226,213
"500490308",574,569,1143,287,262,252
"500490301",584,609,1193,255,237,205
"500490218",580,589,1169,289,272,260
"500490209",647,666,1313,295,276,263
"500281205",390,486,876,270,256,252
"500281109",549,615,1164,314,305,281
"500280908",493,596,1089,365,397,360
"500980720",237,287,524,187,221,177
"500630216",381,391,772,214,225,199
"500630211",621,606,1227,331,312,299
"500630210",336,357,693,209,222,205
"500630202",532,553,1085,320,353,312
"500630106",297,308,605,171,195,162
"500630103",719,716,1435,382,428,371
"500630102",382,417,799,229,247,223
"500560607",202,241,443,114,112,104
"500560605",708,811,1519,398,406,375
"500560408",323,338,661,192,194,180
"500491309",674,724,1398,357,344,322
"500491216",477,566,1043,331,333,316
"500491208",373,390,763,216,241,204
"500491207",547,606,1153,339,342,324
"500280817",375,379,754,230,255,220
"500280813",543,595,1138,321,324,290
"500280708",426,473,899,264,275,253
"500280702",381,372,753,223,250,221
"500280701",381,391,772,214,233,209
"500280612",190,199,389,102,88,85
"500280610",665,677,1342,321,277,260
"500280605",603,578,1181,274,378,240
"500280506",507,524,1031,266,273,249
"500280406",490,496,986,276,294,260
"500280311",515,582,1097,334,341,313
"500280307",606,639,1245,333,303,280
"500280202",379,384,763,247,264,236
"500280201",348,424,772,271,280,257
"500280109",287,372,659,225,266,216
"500211509",210,249,459,164,184,156
"500210611",470,483,953,270,286,259
"500210512",461,487,948,280,279,262
"500210506",380,471,851,304,305,293
"500210502",390,403,793,221,203,194
"500210420",305,304,609,169,180,161
"500630811",489,533,1022,279,310,275
"500630808",468,524,992,311,288,267
"500630807",375,417,792,237,253,228
"500630707",102,92,194,53,341,53
"500630704",105,83,188,65,447,59
"500700612",725,755,1480,428,400,379
"500350212",399,453,852,271,283,253
"500281910",596,648,1244,333,334,308
"500281908",570,624,1194,326,334,315
"500281508",510,464,974,254,301,246
"500281504",566,560,1126,278,293,240
"500281501",684,678,1362,338,326,298
"500281412",457,539,996,329,349,325
"500281405",411,509,920,313,363,312
"500281306",316,367,683,204,217,187
"500281303",552,625,1177,363,378,347
"500210408",508,558,1066,270,267,256
"500210402",377,399,776,236,250,225
"500210314",261,325,586,234,289,229
"500210311",408,470,878,314,340,282
"500210310",351,379,730,250,299,235
"500210217",583,556,1139,315,263,246
"500210213",484,453,937,269,283,253
"500210208",345,447,792,267,282,265
"500210118",285,339,624,186,187,176
"500210112",331,370,701,205,208,196
"500140614",281,315,596,181,178,160
"500140607",362,390,752,245,269,241
"500140603",307,359,666,244,270,242
"500071306",498,541,1039,242,217,215
"500071301",770,760,1530,403,375,371
"500071102",413,465,878,309,352,305
"500211312",447,472,919,272,286,268
"500211204",372,376,748,226,213,192
"500211112",244,298,542,208,315,203
"500211012",261,270,531,170,179,160
"500211002",395,526,921,317,344,307
"500210916",292,351,643,202,230,191
"500210914",237,285,522,187,222,179
"500210912",340,407,747,256,291,251
"500210812",428,471,899,203,159,153
"500210811",690,778,1468,380,308,289
"500070905",334,363,697,295,398,289
"500070901",262,317,579,223,306,221
"500070809",244,284,528,188,277,185
"500070709",203,249,452,169,192,169
"500070511",222,326,548,238,394,230
"500070503",318,421,739,271,350,263
"500070411",123,192,315,165,231,163
"500070315",170,257,427,209,342,202
"500070215",232,285,517,178,196,165
"500070105",233,338,571,266,326,252
"500070103",290,413,703,313,381,310
"500070101",436,511,947,344,421,337
"500070409",156,236,392,191,374,187
"500070404",131,208,339,181,451,177
"501051905",507,547,1054,271,254,247
"501051807",230,274,504,168,188,165
"501050516",412,485,897,308,314,288
"500631014",297,330,627,182,192,178
"500631010",491,556,1047,329,323,303
"500630403",617,632,1249,308,302,282
"500350101",775,821,1596,430,418,406
"500281503",249,257,506,139,141,131
"500910209",557,602,1159,311,333,304
"500280604",672,725,1397,385,377,355
"500211303",542,610,1152,382,361,339
"500210513",357,408,765,241,250,229
"500071305",348,400,748,217,199,194
"500490317",638,659,1297,306,272,257
"500490303",653,688,1341,322,289,278
"501120601",268,248,516,147,200,134
"501260402",24,22,46,12,28,10
"501051202",232,207,439,125,160,124
"501050704",495,485,980,269,310,262
"501050107",561,570,1131,332,413,319
"500980502",131,97,228,58,66,54
"500840601",107,96,203,48,420,48
"500840404",173,183,356,99,125,99
"500700420",605,607,1212,319,376,302
"500700307",376,318,694,180,221,169
"500700215",272,251,523,119,122,102
"500700212",623,634,1257,337,373,314
"500700111",688,637,1325,321,339,290
"500630404",201,182,383,102,139,96
"500560301",469,390,859,226,265,221
"500560101",563,479,1042,239,344,232
"500490314",904,818,1722,427,428,406
"500420401",107,108,215,68,76,57
"500281716",675,664,1339,325,357,306
"501260204",208,184,392,105,113,101
"501120501",153,99,252,86,134,86
"501120401",417,329,746,197,263,193
"501051609",436,409,845,211,270,201
"500071311",79,69,148,50,30,7
"500980301",502,496,998,264,293,246
"500980106",692,699,1391,399,425,380
"500840206",485,538,1023,284,291,266
"500840105",421,399,820,188,200,178
"500840102",332,312,644,174,204,167
"500700301",900,915,1815,459,471,420
"500700210",765,708,1473,359,380,327
"500700421",647,628,1275,356,354,310
"500700101",555,537,1092,240,263,217
"500560407",980,978,1958,508,521,468
"500350404",289,294,583,155,178,148
"500140703",792,806,1598,472,523,468
"500140503",323,306,629,206,228,193
"501260316",407,417,824,225,234,200
"501190614",857,783,1640,393,382,358
"501120202",483,457,940,250,277,244
"501050102",637,669,1306,343,391,337
"500980602",497,449,946,237,292,232
"500980503",512,513,1025,258,279,247
"500980306",727,758,1485,407,443,387
"500980303",691,699,1390,347,368,324
"500840307",491,478,969,268,278,254
"500630302",481,443,924,224,287,216
"500140506",348,312,660,180,202,151
"501051307",319,391,710,248,285,238
"501051306",218,263,481,191,227,189
"501190606",505,532,1037,238,219,212
"501190307",587,646,1233,353,363,338
"501190306",751,827,1578,442,436,411
"501051710",325,376,701,237,269,228
"501051508",501,535,1036,313,331,310
"501051507",355,384,739,213,231,213
"501051503",352,371,723,222,247,214
"501051103",412,427,839,263,279,252
"500700906",321,318,639,197,180,158
"500700806",547,620,1167,363,375,351
"500700709",266,306,572,178,295,175
"500700708",426,517,943,278,291,271
"500700702",401,547,948,295,343,272
"500700607",539,557,1096,287,261,239
"500700505",575,635,1210,349,347,333
"500700503",292,310,602,165,209,155
"500700502",577,607,1184,301,307,287
"500700423",644,630,1274,335,360,319
"500700404",911,879,1790,467,464,435
"500700401",250,240,490,149,148,134
"500631109",487,544,1031,277,295,249
"500631012",317,349,666,187,201,179
"500631003",484,467,951,256,337,244
"500630910",613,581,1194,295,277,263
"500491105",264,249,513,153,331,145
"500490914",432,503,935,293,319,273
"501050414",424,488,912,286,309,270
"501050412",330,368,698,250,288,231
"501050406",470,522,992,293,313,287
"501050310",408,410,818,239,248,236
"501050422",131,160,291,102,112,98
"500980801",577,601,1178,340,316,303
"500980512",608,671,1279,393,449,380
"500980408",483,519,1002,280,315,279
"500980401",418,438,856,248,214,187
"500910202",976,984,1960,548,541,498
"500840211",454,495,949,308,330,290
"500770128",5,4,9,4,11,4
"500770126",467,526,993,270,285,253
"500770114",814,891,1705,460,492,450
"500770105",497,537,1034,285,315,276
"500701013",405,364,769,199,297,192
"500490913",453,480,933,258,241,220
"500490805",825,790,1615,386,358,347
"500490713",406,484,890,268,296,265
"500490711",435,500,935,263,262,247
"500490704",732,705,1437,349,330,322
"501050511",299,385,684,264,332,254
"500490414",504,555,1059,308,391,290
"500490309",907,884,1791,445,454,428
"500490220",610,629,1239,276,269,254
"500490219",948,941,1889,434,416,398
"500490215",637,708,1345,300,188,185
"500490207",834,875,1709,418,390,373
"500490204",625,599,1224,303,291,279
"500281202",452,536,988,287,273,267
"500281116",389,382,771,214,215,201
"500281114",461,468,929,229,210,196
"500281006",521,586,1107,321,338,301
"500281002",411,417,828,225,226,208
"500630215",358,426,784,272,366,247
"500630101",476,499,975,284,348,269
"500491413",689,724,1413,294,292,284
"500491314",355,359,714,187,186,174
"500491210",394,394,788,222,238,221
"500491209",324,329,653,184,202,182
"500491117",699,779,1478,370,293,284
"500280814",287,310,597,166,184,164
"500280811",573,628,1201,350,351,336
"500280810",408,427,835,239,264,234
"500280801",591,727,1318,282,332,266
"500280614",571,616,1187,350,316,312
"500280608",484,542,1026,271,254,243
"500280601",471,487,958,245,218,216
"500280512",303,322,625,185,193,178
"500280407",487,533,1020,271,275,251
"500280401",380,351,731,213,234,205
"500280316",576,569,1145,254,219,210
"500280312",582,654,1236,366,348,315
"500280302",636,703,1339,352,326,310
"500280301",699,677,1376,351,365,319
"500280213",274,285,559,184,199,175
"500280205",447,520,967,312,308,276
"500280110",396,470,866,300,322,267
"500280106",456,546,1002,345,402,317
"500280101",240,237,477,133,138,115
"500211609",403,425,828,205,183,177
"500211505",225,275,500,193,245,188
"500210708",463,515,978,271,268,249
"500210504",108,104,212,41,44,41
"500350215",395,445,840,249,246,234
"500350217",418,419,837,227,229,220
"500282008",258,332,590,201,221,190
"500281711",252,259,511,135,132,121
"500281708",400,434,834,268,259,240
"500281605",627,617,1244,380,397,360
"500281410",340,402,742,260,266,249
"500281407",490,489,979,280,330,273
"500281308",455,536,991,293,327,284
"500281217",422,479,901,286,302,276
"500281210",670,689,1359,354,332,321
"500210417",407,437,844,234,225,209
"500210414",669,742,1411,334,303,297
"500210412",571,593,1164,366,366,332
"500210409",484,525,1009,307,302,284
"500210407",469,498,967,229,234,207
"500210303",191,241,432,170,219,166
"500210216",662,612,1274,346,342,311
"500210211",311,405,716,244,265,240
"500210205",463,543,1006,249,240,227
"500210204",704,762,1466,348,328,317
"500210103",195,229,424,106,112,106
"500210102",382,462,844,278,289,270
"500140711",349,427,776,266,341,263
"500140706",348,396,744,248,272,246
"500140705",583,654,1237,379,398,364
"500140704",245,260,505,156,167,147
"500140617",399,381,780,253,281,251
"500140612",522,576,1098,343,377,323
"500140610",329,381,710,271,326,262
"500140605",277,347,624,248,324,243
"500071310",4,1,5,0,0,0
"500071204",115,144,259,115,230,114
"500071019",562,628,1190,351,402,347
"500071106",458,561,1019,362,401,346
"500211304",462,511,973,319,330,300
"500211301",291,332,623,198,221,194
"500211107",250,288,538,218,246,207
"500211104",244,276,520,200,244,183
"500211011",233,291,524,179,192,174
"500211003",304,322,626,208,218,200
"500210902",379,425,804,300,341,284
"500210810",420,481,901,269,266,245
"500071015",319,325,644,156,138,132
"500071014",502,555,1057,259,210,205
"500071012",234,349,583,250,287,232
"500071008",574,600,1174,293,262,246
"500071005",610,634,1244,335,276,260
"500071002",354,387,741,242,303,239
"500070912",160,180,340,146,179,140
"500070904",303,397,700,282,401,269
"500070811",138,171,309,142,240,142
"500070802",225,296,521,153,210,140
"500070611",159,199,358,138,188,133
"500070317",64,99,163,96,237,96
"500070312",198,204,402,162,206,134
"500070302",412,429,841,311,383,292
"500070114",182,229,411,163,244,160
"500070112",175,216,391,160,262,159
"500070110",146,176,322,109,160,108
"500070108",293,375,668,239,294,187
"500070211",430,533,963,321,383,312
"500070204",412,464,876,287,311,255
"501051305",191,242,433,160,200,152
"501051209",422,424,846,212,227,206
"501050905",323,328,651,201,234,198
"500491215",621,682,1303,389,396,364
"500211315",296,357,653,223,229,215
"500490806",550,556,1106,289,261,249
"500490507",688,689,1377,376,510,337
"500490504",651,651,1302,361,451,354
"500490401",419,474,893,254,247,229
"500071003",443,478,921,277,309,270
"500070803",434,586,1020,358,413,343
"500420201",93,64,157,49,70,48
"501051104",352,334,686,200,230,195
"501050702",414,363,777,206,271,201
"501050604",2,2,4,2,16,2
"501050205",711,698,1409,406,484,392
"501050201",5,4,9,4,18,3
"501050112",713,745,1458,351,396,344
"501050101",9,1,10,9,16,9
"500980701",338,345,683,166,177,159
"500980307",302,315,617,174,189,163
"500910501",56,25,81,26,36,26
"500910307",514,514,1028,283,301,259
"500910103",346,309,655,158,183,145
"500840402",370,352,722,195,224,187
"500770403",358,160,518,109,161,108
"500700204",648,626,1274,317,331,282
"500631017",694,702,1396,377,513,361
"500350105",589,540,1129,276,285,256
"500280520",381,331,712,186,221,173
"500280510",704,688,1392,370,397,335
"500140402",187,177,364,115,164,113
"500140101",180,124,304,118,181,111
"501260203",196,158,354,84,107,82
"501260201",23,15,38,11,15,10
"500980414",45,38,83,22,21,21
"541050302",486,439,925,265,303,258
"540910710",526,248,774,144,165,144
"540840602",252,220,472,109,114,107
"540840405",466,419,885,217,231,203
"540840402",198,194,392,87,94,85
"540840104",404,376,780,192,205,184
"540770603",264,255,519,165,196,162
"540770306",167,129,296,72,82,71
"540770305",233,214,447,107,108,103
"540700602",361,375,736,209,240,207
"540700105",170,147,317,95,101,93
"540490103",571,518,1089,249,232,185
"540420801",312,270,582,148,199,147
"540420705",56,55,111,29,32,29
"540420603",429,410,839,193,242,192
"540350103",276,243,519,140,155,139
"540210603",254,231,485,131,123,109
"540210602",423,401,824,204,258,193
"540140906",400,332,732,183,189,172
"540070506",209,192,401,100,164,98
"540070503",199,169,368,91,104,91
"540070105",249,251,500,140,173,140
"540911012",44,43,87,23,27,23
"540281204",143,129,272,73,79,71
"541120511",555,617,1172,294,309,285
"541050223",320,348,668,181,207,168
"541050222",380,365,745,202,225,200
"540981212",409,438,847,200,208,195
"540981203",296,301,597,156,183,151
"540981008",444,478,922,262,283,257
"540980908",572,647,1219,314,368,311
"540911308",426,496,922,272,282,262
"540911301",722,679,1401,324,346,317
"540911211",268,281,549,125,130,122
"540911210",415,428,843,240,256,228
"540911209",497,535,1032,251,267,248
"540910718",571,590,1161,328,371,317
"540910515",594,638,1232,328,343,322
"540910514",504,544,1048,227,275,225
"540910511",189,211,400,114,111,109
"540910213",969,1019,1988,513,542,498
"540910114",232,232,464,137,152,134
"540910103",290,344,634,224,250,218
"540910102",353,442,795,272,300,262
"540840606",364,344,708,177,197,171
"540840605",198,205,403,100,112,98
"540840908",323,402,725,249,288,249
"540560611",712,667,1379,352,391,346
"540840108",515,518,1033,275,322,273
"540770802",205,206,411,115,119,115
"540770801",435,480,915,284,320,280
"540770407",424,457,881,265,273,257
"540770110",677,713,1390,370,394,368
"540770108",681,654,1335,386,403,349
"540700801",376,387,763,230,243,225
"540700709",242,287,529,185,191,175
"540700504",388,362,750,214,228,212
"540700309",801,768,1569,397,411,385
"540700307",446,472,918,289,305,281
"540631112",437,500,937,278,306,266
"540631109",439,436,875,227,247,221
"540631104",669,658,1327,394,459,392
"540631014",664,742,1406,387,429,376
"540630912",470,457,927,214,236,211
"540630910",410,434,844,204,204,197
"540630906",428,440,868,254,286,249
"540630801",398,352,750,181,186,177
"540630408",465,419,884,257,272,251
"540630406",711,705,1416,342,361,328
"540560210",500,549,1049,285,290,271
"540490207",322,341,663,189,216,187
"540490108",652,616,1268,331,347,324
"540490105",1204,1124,2328,559,576,555
"540420710",328,336,664,183,199,178
"540420602",785,524,1309,262,277,260
"540420519",370,377,747,211,208,188
"540420510",216,225,441,181,223,177
"540420403",602,615,1217,316,330,304
"540420107",611,605,1216,298,309,292
"540281013",216,306,522,225,305,219
"540281007",285,345,630,195,237,194
"540281002",149,237,386,202,291,199
"540280822",288,282,570,167,169,133
"540280812",823,636,1459,448,448,415
"540280810",694,697,1391,364,372,342
"540280806",568,603,1171,274,270,254
"540280720",488,527,1015,275,274,249
"540280718",307,342,649,227,249,209
"540280714",583,677,1260,353,326,314
"540280616",449,461,910,215,211,210
"540280611",503,534,1037,300,322,292
"540280419",741,819,1560,373,352,338
"540280418",477,489,966,250,264,245
"540280404",224,294,518,199,217,185
"540280403",317,370,687,211,222,192
"540280307",804,831,1635,436,469,428
"540280216",129,135,264,128,188,128
"540210704",469,485,954,261,302,257
"540420413",365,406,771,256,264,245
"540282417",96,95,191,55,302,53
"540282413",336,412,748,215,239,214
"540282405",603,625,1228,267,267,251
"540282308",368,406,774,230,242,227
"540282306",615,617,1232,322,337,299
"540282208",287,341,628,247,266,218
"540282016",608,616,1224,340,308,282
"540282013",479,493,972,237,246,228
"540281925",767,801,1568,382,366,353
"540281923",880,940,1820,525,504,438
"540281912",687,716,1403,412,419,378
"540281811",549,549,1098,312,333,304
"540281808",362,354,716,187,184,176
"540281321",314,326,640,176,340,174
"540281316",544,577,1121,287,306,280
"540210515",438,466,904,257,305,255
"540210510",417,474,891,247,292,240
"540210509",470,535,1005,284,299,261
"540210508",425,504,929,266,267,262
"540140210",505,501,1006,312,338,307
"540140209",538,538,1076,306,306,285
"540140206",264,273,537,158,162,157
"540140204",377,361,738,199,219,196
"540070618",365,365,730,262,322,262
"540070610",285,343,628,226,252,221
"540070107",351,381,732,206,231,202
"540281908",684,816,1500,381,393,374
"540070605",336,388,724,238,269,224
"540070603",492,499,991,278,276,263
"540560612",767,744,1511,375,397,369
"540981006",409,434,843,266,293,260
"540490309",598,628,1226,328,380,303
"540281505",650,697,1347,409,438,391
"540280413",603,658,1261,295,293,280
"540141006",232,221,453,136,146,134
"540070606",478,532,1010,282,308,275
"540280803",619,619,1238,325,335,304
"540560501",657,579,1236,299,313,275
"541190304",234,233,467,130,136,115
"541190101",479,458,937,219,231,219
"541120702",902,709,1611,370,372,337
"541120102",1767,1540,3307,791,951,786
"541050403",238,206,444,128,120,111
"541050208",187,172,359,87,94,85
"541050207",217,239,456,131,155,130
"540980904",470,409,879,234,243,227
"540980301",127,137,264,61,82,60
"540980204",81,74,155,43,50,43
"540980201",65,59,124,27,27,27
"540910505",151,140,291,80,86,78
"540910504",175,164,339,82,89,82
"540560205",589,523,1112,289,311,287
"540490201",203,195,398,113,134,112
"540490112",418,321,739,202,208,199
"540420904",34,22,56,24,27,20
"540420604",79,87,166,40,50,38
"540420102",215,204,419,105,117,102
"540350402",98,90,188,43,52,43
"540350206",23,14,37,11,26,11
"540350106",19,12,31,12,16,12
"540282103",38,29,67,24,35,24
"540282101",11,4,15,6,13,6
"540281401",581,543,1124,312,358,269
"540281203",93,81,174,44,99,42
"540210701",125,90,215,63,84,63
"540141002",314,295,609,149,190,146
"540140802",172,181,353,110,126,110
"540070501",46,26,72,25,35,25
"540070404",67,51,118,28,29,28
"540070307",101,70,171,46,60,46
"540070305",122,96,218,59,72,58
"540070302",194,209,403,115,141,113
"540070301",73,42,115,34,36,30
"540070202",36,33,69,25,29,24
"540840701",76,74,150,37,46,37
"540840603",137,115,252,79,80,74
"540770205",276,241,517,131,144,131
"540770204",23,20,43,11,15,11
"540700501",182,171,353,113,135,112
"540700306",524,509,1033,266,296,256
"540700301",263,226,489,131,138,127
"540700103",39,23,62,21,23,20
"540630903",20,20,40,12,12,12
"540630704",128,103,231,53,56,53
"540630302",186,150,336,80,101,79
"540630104",2,2,4,2,6,2
"540630103",2,2,4,2,3,2
"540560802",1032,908,1940,509,560,484
"540560603",971,902,1873,471,544,465
"540910403",442,402,844,220,235,193
"540910508",191,199,390,108,121,108
"541120701",26,21,47,18,18,18
"540420706",46,32,78,24,32,24
"540350307",35,23,58,16,23,16
"540281303",116,100,216,68,101,67
"540210301",76,54,130,41,45,41
"540911206",161,143,304,84,98,81
"540840204",1,0,1,1,4,1
"540700204",108,85,193,58,72,58
"541120703",1434,1276,2710,659,726,655
"540981004",391,398,789,223,245,219
"540911011",68,79,147,47,55,47
"540770403",114,107,221,65,111,64
"540770101",552,580,1132,296,309,286
"540490203",1338,1118,2456,614,667,601
"540560801",1067,986,2053,527,636,522
"540490202",950,817,1767,478,532,472
"540420704",263,268,531,129,141,129
"540350301",149,146,295,98,110,97
"540281601",919,776,1695,475,437,374
"540281301",215,199,414,110,115,109
"540210401",203,214,417,106,149,102
"540210202",541,513,1054,250,274,246
"540910707",562,517,1079,250,279,245
"540140510",208,208,416,121,130,119
"541050214",362,415,777,255,275,248
"540980515",258,258,516,180,194,162
"540980207",590,608,1198,327,347,323
"540911311",619,591,1210,365,429,360
"540911306",449,476,925,252,259,250
"540911008",265,278,543,154,182,153
"540910715",619,696,1315,373,398,362
"540910714",537,479,1016,269,328,257
"540910512",422,427,849,265,296,262
"540910201",1005,1007,2012,466,466,440
"540910117",640,683,1323,350,373,345
"540910110",224,301,525,203,249,202
"540840906",439,418,857,267,280,258
"540840909",692,698,1390,340,367,335
"540840409",465,462,927,220,235,214
"540631008",593,607,1200,346,360,325
"540560911",325,362,687,214,208,193
"540560902",1030,1024,2054,631,719,622
"540840102",459,499,958,285,310,284
"540770808",173,194,367,114,124,114
"540700705",338,381,719,231,240,225
"540700704",452,467,919,280,309,276
"540700316",394,433,827,238,256,237
"540700315",395,421,816,202,208,199
"540700308",809,758,1567,401,418,389
"540631107",578,677,1255,376,410,359
"540631003",765,758,1523,429,407,373
"540630909",444,422,866,238,273,237
"540490308",366,415,781,227,247,211
"540420614",583,602,1185,317,296,274
"540420611",298,257,555,142,152,140
"540420520",280,325,605,230,271,227
"540420418",536,538,1074,298,322,293
"540420408",296,318,614,178,188,174
"540420405",723,766,1489,416,456,390
"540420308",278,274,552,141,154,139
"540281208",592,580,1172,319,344,312
"540281214",746,874,1620,467,513,464
"540280821",514,516,1030,266,251,246
"540280815",470,489,959,226,217,210
"540280811",416,466,882,269,273,247
"540280716",569,590,1159,340,344,322
"540280610",242,300,542,172,174,165
"540280609",417,464,881,299,326,289
"540280511",466,512,978,287,252,219
"540280510",157,181,338,109,119,100
"540280504",274,326,600,169,181,162
"540280415",373,429,802,252,274,239
"540280409",420,501,921,277,279,254
"540280310",397,441,838,288,338,280
"540280309",305,411,716,245,282,238
"540280304",329,353,682,226,229,209
"540280209",160,210,370,154,185,128
"540280202",200,248,448,230,305,222
"540420317",518,536,1054,285,334,275
"540420312",271,281,552,162,176,161
"540282416",796,775,1571,356,357,286
"540282305",768,856,1624,430,432,411
"540282303",530,565,1095,343,355,320
"540282210",427,487,914,321,344,300
"540282002",846,950,1796,452,449,425
"540281926",631,721,1352,348,374,344
"540281924",968,1019,1987,512,478,466
"540281911",481,607,1088,354,378,352
"540281910",370,438,808,262,285,261
"540281909",645,705,1350,349,361,345
"540281904",629,625,1254,314,333,308
"540281902",311,308,619,173,195,172
"540281818",339,381,720,251,270,244
"540281812",445,470,915,233,258,230
"540281805",391,405,796,209,226,209
"540281312",601,602,1203,342,373,325
"540281307",290,297,587,146,157,125
"540210518",247,212,459,124,142,123
"540280106",149,167,316,105,113,99
"540140807",285,354,639,181,200,181
"540140508",433,484,917,294,312,276
"540140506",419,409,828,227,210,196
"540140202",349,352,701,230,265,228
"540140111",663,705,1368,335,367,332
"540070620",228,205,433,103,107,96
"540070611",371,424,795,260,256,240
"540070602",452,562,1014,296,333,290
"540070102",439,468,907,245,287,243
"540420415",553,513,1066,284,303,278
"540140208",438,491,929,311,307,292
"540770602",735,643,1378,362,405,360
"540700312",328,374,702,198,211,196
"540700208",513,497,1010,251,278,236
"540560613",814,800,1614,398,444,388
"541120704",266,294,560,136,164,135
"541120106",172,178,350,89,117,89
"540981208",623,648,1271,338,343,312
"540490114",642,588,1230,295,304,285
"540421007",235,249,484,108,120,107
"540420513",400,474,874,309,348,302
"540420306",419,538,957,287,299,283
"540280215",182,277,459,196,254,190
"540140512",309,321,630,190,200,189
"540070316",539,562,1101,308,340,302
"540070311",427,496,923,260,234,219
"540070110",332,310,642,145,132,121
"541190603",206,199,405,113,147,108
"541190402",556,487,1043,267,293,264
"541190305",282,293,575,165,184,165
"541190303",477,436,913,267,296,266
"541120601",560,493,1053,230,288,230
"541120505",730,618,1348,340,379,337
"541050402",391,365,756,186,185,143
"541050301",86,67,153,44,57,44
"541050212",114,86,200,56,64,56
"540980906",181,155,336,82,100,82
"540980602",134,108,242,60,77,59
"540980601",131,128,259,69,82,68
"540980508",56,51,107,30,38,30
"540911105",147,131,278,78,90,78
"540911102",165,173,338,82,92,81
"540911013",200,149,349,86,96,86
"540911002",293,267,560,124,143,117
"540911107",149,127,276,65,69,63
"540910808",241,216,457,126,153,125
"540560503",2,1,3,1,1,1
"540560301",931,816,1747,435,461,428
"540560204",285,240,525,142,148,142
"540420707",32,15,47,11,13,11
"540420606",187,151,338,81,84,80
"540420304",116,128,244,76,87,76
"540420202",0,0,0,0,2,0
"540420201",1,0,1,1,1,1
"540420105",48,31,79,22,24,21
"540420103",133,119,252,61,66,61
"540350204",42,44,86,26,38,26
"540350101",143,130,273,67,70,67
"540281502",108,62,170,55,75,55
"540281403",2,4,6,1,4,1
"540210604",100,64,164,37,49,37
"540210203",94,93,187,37,42,37
"540141004",257,228,485,111,117,110
"540140905",165,166,331,83,90,82
"540140304",324,273,597,168,188,162
"540070306",84,60,144,46,81,45
"540070101",66,65,131,39,56,38
"540910302",159,145,304,81,87,79
"540840502",100,81,181,49,47,47
"540840501",68,38,106,34,36,30
"540840308",34,23,57,25,30,24
"540840201",107,92,199,57,75,57
"540770501",334,279,613,125,132,125
"540770303",75,67,142,44,49,43
"540770302",410,394,804,170,203,169
"540770106",94,79,173,44,56,44
"540700404",174,174,348,93,104,93
"540700303",159,160,319,87,97,87
"540700205",430,410,840,227,248,226
"540700203",129,126,255,68,91,68
"540630807",85,66,151,43,51,42
"540630705",59,36,95,25,30,25
"540630701",13,7,20,7,11,7
"540630502",47,30,77,22,25,21
"540630301",93,47,140,59,75,58
"540630105",403,351,754,191,202,186
"540560607",501,449,950,236,266,230
"540560604",1199,1215,2414,585,660,574
"540910402",252,225,477,140,161,140
"541190302",790,690,1480,407,399,385
"540210302",103,75,178,47,56,47
"540140803",96,91,187,52,61,49
"540140403",176,159,335,97,95,83
"540980403",94,82,176,49,37,27
"540560308",486,429,915,235,252,235
"540560202",311,317,628,176,199,176
"541050209",797,821,1618,386,319,288
"540911001",527,513,1040,260,275,258
"540910902",487,427,914,215,220,213
"540910709",226,212,438,113,127,108
"540910705",280,258,538,133,170,133
"540910601",278,258,536,167,183,163
"540770703",670,682,1352,314,326,311
"540770105",664,639,1303,407,535,404
"540421001",628,551,1179,275,301,272
"540281501",123,100,223,78,154,77
"540281305",206,173,379,95,107,92
"540281102",249,176,425,110,129,108
"540210503",57,45,102,39,52,39
"540210501",176,133,309,111,219,109
"540210102",269,248,517,124,103,84
"540630404",113,96,209,64,78,59
"541120504",526,536,1062,253,270,245
"541050216",365,414,779,222,234,217
"540981213",238,296,534,171,194,168
"540981207",411,409,820,230,264,224
"540981206",474,462,936,251,268,248
"540981205",782,773,1555,367,341,312
"540981201",242,285,527,148,157,145
"540981005",367,434,801,235,250,229
"540980518",347,398,745,225,271,224
"540980517",257,238,495,115,135,112
"540980507",416,431,847,212,223,199
"540911304",533,534,1067,265,274,252
"540910713",567,567,1134,273,289,272
"540910516",304,315,619,164,174,161
"540910510",158,144,302,71,78,71
"540910406",338,340,678,188,214,187
"540910214",515,485,1000,242,251,234
"540910212",506,494,1000,264,273,251
"540910208",469,506,975,302,307,293
"540910207",527,556,1083,389,406,344
"540910116",777,857,1634,507,551,501
"540840607",510,449,959,227,261,225
"540840314",290,327,617,200,231,200
"540560909",609,591,1200,285,315,280
"540560610",685,713,1398,355,379,345
"540840907",590,617,1207,364,400,357
"540840304",614,663,1277,356,389,352
"540840101",142,134,276,89,100,88
"540770809",279,320,599,219,233,213
"540770807",348,376,724,239,276,237
"540840910",260,276,536,192,219,187
"540770405",348,357,705,245,275,245
"540840305",245,293,538,193,204,185
"540700806",369,474,843,322,352,312
"540700314",423,391,814,203,204,200
"540700311",569,591,1160,314,348,311
"540630918",279,269,548,167,207,163
"540630917",355,396,751,197,208,193
"540630911",317,379,696,215,249,209
"540630815",750,754,1504,386,500,376
"540630812",568,519,1087,264,262,247
"540630804",303,335,638,164,194,161
"540630802",844,777,1621,442,447,425
"540631010",309,287,596,175,181,168
"540490107",593,588,1181,334,354,329
"540420613",1058,1014,2072,507,478,449
"540631011",442,435,877,227,226,219
"540420503",344,349,693,248,305,245
"540420401",417,418,835,222,224,212
"540420307",491,572,1063,341,374,338
"540420313",306,337,643,182,214,181
"540281211",895,959,1854,424,415,400
"540281201",824,817,1641,440,454,423
"540281004",525,593,1118,396,457,378
"540280813",371,409,780,231,343,221
"540280805",382,402,784,228,248,221
"540280608",409,443,852,235,257,232
"540280505",548,698,1246,255,276,246
"540280302",470,556,1026,298,324,292
"540280208",197,280,477,232,329,227
"540280118",150,217,367,147,182,135
"540280117",214,290,504,206,257,196
"540280102",472,452,924,234,206,199
"540280101",288,329,617,181,203,178
"540210705",438,450,888,252,310,250
"540070317",365,358,723,161,174,157
"540282408",855,881,1736,366,361,340
"540282309",467,516,983,281,272,255
"540282307",407,467,874,273,284,260
"540282212",329,365,694,229,245,212
"540282211",262,326,588,234,263,230
"540282015",580,576,1156,282,287,269
"540282014",381,391,772,213,203,178
"540282011",872,928,1800,472,492,463
"540282009",520,533,1053,290,306,282
"540282003",716,808,1524,445,426,380
"540281906",501,616,1117,358,378,337
"540281822",343,377,720,203,230,198
"540281807",690,680,1370,360,369,337
"540281319",864,883,1747,479,507,453
"540281309",265,307,572,155,159,146
"540210507",450,497,947,264,298,259
"540280108",289,349,638,212,225,201
"540140308",237,213,450,124,138,124
"540140211",671,642,1313,321,326,316
"540070613",542,540,1082,331,378,325
"540070612",363,406,769,223,248,215
"540070313",543,573,1116,301,331,298
"540281216",743,782,1525,381,399,374
"540840313",432,426,858,158,166,153
"540840109",623,640,1263,311,340,310
"541120513",371,409,780,214,234,214
"541120509",527,509,1036,248,304,227
"540560209",291,336,627,186,218,184
"540490311",452,491,943,248,246,218
"540490310",404,416,820,210,262,209
"540350414",497,507,1004,243,269,240
"540282201",341,374,715,205,196,180
"540282006",531,593,1124,312,311,286
"540282005",549,603,1152,358,327,303
"540630405",433,488,921,218,236,215
"540140103",425,493,918,299,333,291
"540281209",694,769,1463,376,398,361
"540281206",560,575,1135,317,357,281
"541190602",356,298,654,188,198,187
"541190506",192,202,394,118,121,115
"541190204",253,223,476,137,131,127
"541120401",1,0,1,1,14,1
"541120201",16,2,18,5,5,5
"541050203",205,166,371,92,93,90
"541050103",375,338,713,185,174,171
"541050101",161,130,291,77,78,76
"540981101",158,138,296,56,60,56
"540980803",239,207,446,118,152,118
"540980605",22,20,42,13,29,13
"540980303",223,199,422,99,106,99
"540980205",67,46,113,31,34,31
"540911204",23,20,43,15,17,15
"540911004",67,57,124,37,36,26
"540910805",295,276,571,148,179,147
"540910603",157,123,280,85,95,85
"540560302",491,451,942,224,192,189
"540560103",457,438,895,230,230,229
"540490401",896,789,1685,423,303,219
"540560203",161,169,330,99,108,98
"540490110",358,267,625,135,134,134
"540421004",46,36,82,21,24,21
"540420902",16,9,25,9,13,9
"540420806",14,9,23,6,13,6
"540350407",17,9,26,11,19,10
"540350308",50,50,100,26,33,26
"540350304",90,79,169,49,59,49
"540350302",9,2,11,6,12,6
"540281304",9,12,21,7,9,7
"540210403",38,20,58,18,23,18
"540210304",76,53,129,37,48,37
"540210201",86,44,130,39,46,39
"540140805",145,110,255,67,69,65
"540140602",524,441,965,267,278,262
"540140402",155,116,271,71,83,66
"540140401",280,218,498,136,147,136
"540070505",12,11,23,6,11,6
"540070402",181,190,371,87,96,71
"540070308",48,54,102,29,38,29
"540070304",184,165,349,104,123,101
"540840801",31,5,36,11,33,11
"540840406",16,17,33,11,11,11
"540840404",65,60,125,38,47,38
"540770206",59,32,91,24,32,24
"540700401",163,158,321,79,84,79
"540700202",266,251,517,152,175,152
"540700102",129,114,243,62,77,62
"540630810",163,134,297,67,77,62
"540630504",107,79,186,42,46,41
"540630202",22,26,48,1,2,1
"540560709",560,495,1055,265,273,260
"540560706",155,129,284,68,75,68
"540560703",95,85,180,53,62,52
"540560606",354,271,625,134,150,134
"540560704",128,97,225,59,62,58
"541190501",207,177,384,96,108,95
"541050306",124,122,246,61,70,61
"540281703",34,31,65,15,15,15
"540140605",257,230,487,112,123,112
"540140603",161,135,296,84,84,83
"540070201",80,71,151,40,52,40
"540910806",59,47,106,32,41,32
"541190403",704,671,1375,417,495,414
"540980701",294,285,579,155,177,154
"540980511",314,278,592,154,171,152
"540980202",731,714,1445,352,398,345
"540911203",225,224,449,111,118,108
"540911005",348,281,629,159,174,146
"540490306",317,311,628,159,184,130
"540490305",514,487,1001,252,304,249
"540490102",1188,1055,2243,531,618,524
"540490101",812,692,1504,369,394,366
"540420702",279,268,547,130,157,125
"540420701",543,543,1086,265,284,262
"540420605",234,217,451,109,116,108
"540281302",138,141,279,70,73,66
"540210502",117,133,250,57,97,57
"540140801",286,315,601,151,163,150
"540140201",263,241,504,119,122,117
"540070403",341,317,658,163,195,163
"540980104",538,555,1093,301,347,299
"540282401",557,581,1138,315,336,306
"540282312",752,744,1496,342,346,332
"541120515",474,501,975,241,257,238
"541120503",403,392,795,224,238,220
"541050215",291,323,614,168,192,164
"541050112",134,157,291,87,91,87
"540981211",321,385,706,231,242,220
"540981011",627,647,1274,298,325,292
"540980903",375,384,759,234,206,182
"540980512",167,159,326,89,100,88
"540911312",603,626,1229,330,359,319
"540910717",565,551,1116,272,276,247
"540910217",255,314,569,206,249,202
"540910203",449,469,918,270,286,265
"540910109",263,323,586,254,310,247
"540910107",624,636,1260,314,311,301
"540630107",477,503,980,274,309,270
"540560614",482,451,933,239,284,239
"540630819",729,749,1478,311,319,303
"540770404",517,556,1073,310,322,300
"540770109",327,373,700,232,249,231
"540700805",350,405,755,228,229,209
"540700802",385,413,798,285,329,281
"540631108",460,475,935,275,295,258
"540631102",1156,1079,2235,384,410,365
"540631013",690,662,1352,348,353,337
"540631007",427,401,828,187,208,186
"540631002",737,718,1455,402,490,395
"540630814",853,839,1692,443,455,425
"540631009",379,385,764,199,199,193
"540490304",441,498,939,253,303,251
"540490106",468,459,927,232,254,229
"540631012",468,499,967,252,272,247
"540420518",425,479,904,274,293,258
"540420517",394,409,803,225,245,222
"540420511",321,386,707,293,399,285
"540420506",356,449,805,271,293,271
"540420410",642,682,1324,319,330,307
"540420407",716,728,1444,353,378,348
"540420406",685,699,1384,414,441,388
"540420404",408,420,828,276,289,265
"540420402",637,629,1266,333,351,320
"540420305",869,889,1758,474,513,467
"540281202",302,353,655,166,211,158
"540281213",1029,1088,2117,458,469,434
"540281015",284,339,623,191,209,189
"540280911",210,253,463,177,232,167
"540280902",251,329,580,227,281,225
"540280910",173,231,404,202,244,199
"540280909",169,224,393,170,231,163
"540280814",464,437,901,246,290,239
"540280804",419,445,864,268,282,250
"540280721",379,434,813,262,272,243
"540280715",424,502,926,261,280,250
"540280709",266,397,663,216,234,215
"540280705",407,452,859,286,337,278
"540280613",563,629,1192,335,345,305
"540280605",452,437,889,217,209,200
"540280502",347,443,790,269,278,250
"540280406",375,450,825,303,379,293
"540280311",648,670,1318,425,404,377
"540280308",744,796,1540,441,455,410
"540280218",122,160,282,135,182,132
"540280207",278,354,632,256,317,254
"540280201",200,278,478,206,220,190
"540280113",242,253,495,179,183,166
"540280112",413,519,932,366,458,336
"540280104",328,365,693,202,209,193
"540350404",388,426,814,250,292,246
"540282207",362,462,824,352,428,331
"540282008",223,230,453,144,158,139
"540281922",589,649,1238,366,390,362
"540281920",645,758,1403,365,393,360
"540281918",570,620,1190,340,342,318
"540281913",851,890,1741,402,359,346
"540281903",570,728,1298,407,433,403
"540281815",639,660,1299,314,330,311
"540281814",707,716,1423,341,343,321
"540281320",312,348,660,181,202,177
"540281317",365,363,728,167,179,160
"540281314",881,892,1773,444,478,431
"540281311",477,537,1014,258,278,253
"540210517",267,291,558,162,164,156
"540280107",417,469,886,295,266,229
"540140203",320,340,660,200,219,197
"540140104",453,456,909,275,302,271
"540070504",411,403,814,246,292,245
"540070509",379,365,744,192,217,192
"540070508",639,644,1283,335,372,321
"540070312",951,960,1911,433,407,337
"540070310",396,392,788,192,206,187
"540700708",505,555,1060,336,363,324
"540700707",420,447,867,301,323,293
"540981210",277,333,610,192,219,183
"540560201",616,639,1255,348,388,337
"540421006",331,320,651,150,167,147
"540421005",516,509,1025,246,245,235
"540420610",571,532,1103,255,241,212
"540282403",609,634,1243,353,409,348
"540281504",695,756,1451,424,429,399
"540281322",695,695,1390,327,351,317
"540210609",457,461,918,247,230,210
"540210608",376,395,771,230,134,94
"540070608",211,257,468,173,193,169
"541190202",660,603,1263,271,272,265
"540911103",45,42,87,22,22,22
"541190401",279,239,518,134,127,121
"541190503",452,407,859,239,262,238
"541120301",12,13,25,6,8,6
"541050204",154,119,273,72,73,72
"541050201",218,168,386,107,98,97
"541050111",12,15,27,9,9,9
"541050110",25,15,40,15,20,15
"541050107",105,81,186,50,58,50
"541050106",13,7,20,5,7,5
"540980905",258,224,482,127,139,122
"540910904",190,190,380,96,105,95
"540911106",294,264,558,135,152,134
"540910809",248,257,505,126,149,125
"540910702",154,129,283,73,80,73
"540910506",190,158,348,99,102,99
"540560309",275,290,565,159,170,146
"540560307",224,196,420,97,110,97
"540560207",275,228,503,131,128,128
"540560106",195,172,367,98,100,98
"540560102",535,454,989,248,261,247
"540350409",39,29,68,26,25,25
"540350406",44,34,78,22,30,21
"540350203",21,19,40,11,18,11
"540350105",3,3,6,1,2,1
"540350102",47,40,87,23,32,23
"540281602",13,12,25,7,22,7
"540210404",8,3,11,4,7,4
"540141005",181,162,343,99,102,99
"540140902",239,201,440,104,123,102
"540140704",386,334,720,183,204,183
"540140703",383,323,706,177,205,177
"540140608",733,684,1417,308,319,307
"540140601",219,178,397,99,106,99
"540140404",538,448,986,259,277,256
"540140305",161,112,273,77,88,76
"540140302",154,145,299,91,94,89
"540070106",23,12,35,6,18,5
"540770503",21,19,40,9,13,8
"540770604",195,178,373,110,130,109
"540630806",52,44,96,26,33,25
"540630203",0,0,0,0,1,0
"540630102",278,264,542,85,90,83
"540910501",99,89,188,63,69,61
"540420104",26,13,39,9,9,9
"540140105",63,73,136,39,43,38
"541050109",7,10,17,6,8,6
"540911201",245,207,452,106,141,106
"540840311",135,138,273,71,78,68
"540700305",504,456,960,243,273,242
"540700104",232,211,443,120,133,119
"540700101",420,353,773,206,209,179
"540630811",241,258,499,114,116,107
"540490111",364,280,644,167,173,161
"540840202",197,180,377,85,97,84
"540770104",496,456,952,271,304,267
"540280110",235,314,549,179,169,151
"540282314",268,308,576,195,211,172
"540420315",423,400,823,208,213,205
"541190508",605,637,1242,363,395,357
"541120502",438,477,915,289,308,274
"540981214",568,595,1163,290,292,254
"540980907",502,527,1029,299,326,296
"540980704",250,264,514,146,133,113
"540980513",380,413,793,209,225,204
"540980506",236,264,500,172,195,170
"540980106",541,588,1129,316,381,312
"540911313",405,436,841,261,261,259
"540910905",496,533,1029,266,292,262
"540910811",366,353,719,170,179,167
"540910719",478,513,991,263,281,262
"540910513",451,450,901,266,281,264
"540910509",872,876,1748,440,455,438
"540910219",500,538,1038,250,258,249
"540910218",559,522,1081,270,289,264
"540910216",314,341,655,215,234,211
"540910204",434,454,888,237,244,235
"540910119",524,570,1094,399,433,395
"540910118",402,306,708,360,559,356
"540910113",246,307,553,225,255,222
"540910111",280,368,648,256,301,220
"540910105",493,538,1031,368,394,366
"540840903",259,285,544,193,230,191
"540910101",358,421,779,269,299,268
"540840312",435,482,917,256,256,233
"540560910",338,392,730,229,259,223
"540560906",364,388,752,221,265,221
"540560905",458,484,942,298,322,288
"540840301",707,708,1415,376,381,366
"540770806",425,492,917,298,321,292
"540770805",717,693,1410,346,338,313
"540770803",377,401,778,277,291,264
"540770309",640,667,1307,354,402,351
"540700808",383,439,822,237,244,232
"540631111",297,338,635,188,178,161
"540631005",411,433,844,245,244,221
"540630915",577,585,1162,260,277,258
"540630908",699,713,1412,334,363,329
"540630907",408,395,803,232,260,225
"540630816",732,674,1406,314,338,311
"540630409",363,362,725,182,223,180
"540560206",502,502,1004,301,331,295
"540490303",565,593,1158,346,404,343
"540490113",525,484,1009,220,235,217
"540421009",421,396,817,169,198,167
"540420515",385,433,818,274,290,263
"540420512",459,457,916,268,288,264
"540420509",307,315,622,231,273,224
"540420504",402,435,837,302,360,280
"540420501",408,434,842,220,235,216
"540420417",399,400,799,238,251,225
"540420409",549,589,1138,290,305,286
"540420318",278,298,576,138,148,138
"540420309",708,769,1477,404,416,387
"540280907",398,504,902,351,456,338
"540280901",254,360,614,244,298,235
"540280816",469,517,986,289,344,282
"540281219",733,802,1535,402,466,399
"540280711",315,344,659,213,243,207
"540280708",360,418,778,255,283,253
"540280707",243,274,517,175,191,171
"540280703",527,591,1118,329,359,316
"540280601",534,573,1107,377,420,371
"540280508",309,375,684,231,294,230
"540280410",697,789,1486,373,309,297
"540280407",388,430,818,290,278,250
"540280206",252,295,547,246,322,236
"540280203",273,403,676,304,375,274
"540280114",210,256,466,174,188,163
"540280103",757,787,1544,372,357,352
"540350411",335,352,687,186,217,180
"540282411",514,546,1060,314,367,312
"540282410",542,630,1172,287,303,282
"540282409",569,583,1152,269,291,266
"540282213",244,315,559,210,238,207
"540282206",452,596,1048,383,426,357
"540282204",468,504,972,292,273,248
"540282203",250,329,579,220,266,213
"540282019",669,708,1377,381,385,325
"540282012",306,337,643,190,207,180
"540281916",611,689,1300,383,420,376
"540281821",454,421,875,232,258,228
"540281820",353,331,684,198,214,189
"540281817",432,394,826,221,237,212
"540281809",440,452,892,231,249,221
"540281318",228,226,454,133,188,118
"540281310",457,455,912,239,257,234
"540281806",300,328,628,169,184,165
"540210513",317,344,661,200,220,197
"540210511",408,413,821,237,272,234
"540210505",642,457,1099,249,284,244
"540140309",383,344,727,169,175,166
"540140212",482,480,962,245,270,238
"540070315",504,532,1036,270,267,240
"540070109",544,550,1094,262,274,254
"540420414",542,517,1059,341,376,332
"540281928",528,599,1127,288,296,281
"540282313",558,590,1148,275,254,244
"540070604",395,411,806,231,245,216
"540910210",443,515,958,321,325,306
"540910115",256,358,614,234,272,232
"540840110",474,443,917,223,247,223
"540840106",423,441,864,248,272,241
"540770704",327,295,622,148,158,146
"540630112",562,578,1140,309,328,289
"540630111",635,591,1226,319,341,318
"541190507",232,254,486,134,160,133
"541050219",354,405,759,257,274,236
"541050113",375,356,731,205,209,202
"540282404",979,1002,1981,405,397,378
"540280706",239,310,549,186,212,185
"540140205",357,381,738,235,268,234
"540560402",12,1,13,3,6,3
"541190601",86,78,164,36,40,34
"541190505",99,76,175,50,54,49
"541190306",131,136,267,74,78,72
"541190301",146,128,274,63,63,63
"541120402",3,0,3,1,12,1
"541050202",203,150,353,91,96,89
"541050102",79,76,155,43,48,42
"540980401",252,237,489,124,143,119
"540911207",193,200,393,89,116,86
"540911010",216,201,417,107,115,106
"540911202",54,53,107,29,32,28
"540911003",99,92,191,55,65,54
"540910903",409,377,786,184,188,178
"540910801",94,84,178,39,47,39
"540910602",235,209,444,128,158,125
"540560502",2,0,2,1,2,1
"540490402",73,58,131,34,35,26
"540421003",176,141,317,77,91,77
"540350408",0,0,0,0,1,0
"540350405",88,84,172,47,64,47
"540350306",9,11,20,7,8,7
"540282102",202,149,351,112,145,110
"540281702",40,28,68,20,28,20
"540210303",41,29,70,24,28,24
"540210103",74,46,120,36,51,36
"540141001",274,252,526,118,123,115
"540140301",157,139,296,96,104,93
"540140101",95,67,162,46,55,45
"540840601",92,62,154,39,51,38
"540840306",50,54,104,26,33,24
"540840203",52,37,89,21,28,21
"540840103",77,76,153,31,41,31
"540770304",302,260,562,140,145,137
"540770203",30,19,49,15,16,15
"540700603",178,143,321,89,89,89
"540700502",245,222,467,138,152,136
"540700207",717,653,1370,363,384,362
"540630809",7,7,14,4,6,4
"540630201",9,10,19,5,5,5
"540560803",525,453,978,218,259,211
"540560705",206,188,394,107,118,107
"540560609",514,436,950,228,243,226
"540560608",937,884,1821,465,522,459
"540910405",223,174,397,94,109,94
"540910304",95,79,174,51,53,51
"541190203",544,485,1029,262,264,259
"541120507",381,343,724,169,162,152
"541120101",1155,955,2110,478,495,457
"540281701",100,90,190,50,71,47
"540980203",295,263,558,128,150,128
"540840702",9,2,11,7,12,7
"540560101",361,322,683,179,190,177
"540981002",1100,991,2091,507,557,501
"540980101",271,266,537,160,199,159
"540910901",555,509,1064,282,350,273
"540770601",280,272,552,152,163,152
"540770202",244,225,469,110,122,110
"540700503",837,873,1710,455,492,452
"540700302",322,321,643,173,197,168
"540630901",392,385,777,164,193,160
"540560601",1228,1106,2334,549,620,536
"540490104",1115,890,2005,510,503,502
"540420803",285,252,537,149,151,125
"540420607",408,389,797,220,241,217
"540420601",645,594,1239,285,280,244
"540350303",30,30,60,17,30,17
"540350201",130,131,261,66,99,65
"540140607",876,812,1688,414,463,412
"540140504",374,363,737,198,168,156
"540981003",451,404,855,221,228,209
"540281005",295,385,680,271,338,270
"540420310",263,316,579,159,169,157
"540281217",533,571,1104,334,444,332
"541190107",865,957,1822,525,544,517
"541050221",394,450,844,230,248,223
"540980504",377,379,756,236,242,218
"540911303",545,560,1105,289,355,288
"540911014",409,386,795,194,217,193
"540910215",541,561,1102,313,345,302
"540910112",457,479,936,339,364,332
"540910108",579,562,1141,493,620,488
"540840904",521,511,1032,307,333,304
"540840408",408,383,791,187,205,187
"540560903",760,780,1540,455,524,448
"541120501",611,664,1275,335,355,328
"540630410",348,387,735,195,212,189
"540840303",339,352,691,191,196,185
"540770406",136,137,273,76,94,76
"540770301",425,442,867,249,285,247
"540770209",563,559,1122,290,304,283
"540770107",509,540,1049,265,275,261
"540770102",745,705,1450,379,414,372
"540700804",379,411,790,238,252,233
"540700706",363,389,752,273,321,270
"540700702",216,249,465,189,201,188
"540700507",252,330,582,209,196,179
"540631001",392,417,809,273,277,224
"540630914",671,698,1369,366,368,342
"540630913",295,301,596,121,126,116
"540490307",377,403,780,205,235,198
"540421008",460,432,892,231,244,227
"540420416",424,428,852,267,289,261
"540281210",824,891,1715,444,476,438
"540281103",292,247,539,134,167,131
"540281012",375,451,826,273,299,270
"540281011",418,478,896,299,359,294
"540280906",269,311,580,203,209,162
"540280818",645,679,1324,362,379,354
"540280719",396,443,839,246,257,223
"540280713",738,740,1478,428,409,364
"540280704",393,439,832,269,298,254
"540280614",405,431,836,244,205,198
"540280612",600,708,1308,389,431,386
"540280603",623,711,1334,434,445,404
"540280507",359,400,759,262,308,246
"540280506",469,569,1038,417,494,402
"540280412",762,796,1558,353,338,326
"540280314",361,401,762,260,280,248
"540280306",409,455,864,241,257,228
"540280305",557,583,1140,311,337,306
"540280214",135,179,314,126,162,123
"540280119",228,288,516,198,221,181
"540280111",333,400,733,270,280,249
"540210610",237,195,432,109,105,78
"540350410",425,411,836,248,273,239
"540282412",846,857,1703,391,413,383
"540282304",607,630,1237,352,335,311
"540282302",401,417,818,254,277,247
"540282007",561,578,1139,313,342,306
"540282001",820,899,1719,418,439,400
"540281921",713,776,1489,394,407,372
"540281919",816,829,1645,407,422,381
"540281914",624,670,1294,345,359,331
"540281907",533,635,1168,375,370,339
"540281905",687,809,1496,414,452,411
"540281901",844,880,1724,417,424,394
"540281816",417,452,869,215,234,209
"540281810",504,554,1058,322,344,309
"540281804",595,602,1197,345,375,326
"540281315",866,840,1706,432,468,418
"540281313",645,699,1344,333,365,329
"540281306",627,633,1260,332,373,328
"540210514",530,534,1064,263,292,260
"540210512",585,633,1218,307,339,305
"540280109",253,253,506,180,214,176
"540210601",475,495,970,287,305,278
"540140505",403,414,817,250,276,247
"540140808",499,517,1016,261,284,257
"540140509",342,370,712,189,195,185
"540140303",542,541,1083,324,349,317
"540140207",262,266,528,134,137,125
"540140109",496,519,1015,299,329,296
"540070619",478,499,977,277,308,275
"540070319",556,540,1096,245,245,225
"540070318",571,607,1178,300,321,296
"540070108",549,600,1149,330,349,321
"540420314",448,490,938,264,290,260
"540631103",487,563,1050,230,250,201
"540630813",722,749,1471,411,427,406
"540490312",402,395,797,220,250,216
"540350413",247,229,476,104,134,102
"540210607",542,549,1091,314,370,310
"541120302",42,48,90,27,27,27
"541120506",623,491,1114,256,279,255
"541120105",80,25,105,39,44,39
"541050404",127,110,237,72,86,70
"541120508",707,648,1355,337,340,284
"541050308",103,81,184,42,46,42
"541050307",181,152,333,87,98,87
"541050305",107,104,211,56,62,56
"541050303",86,86,172,40,50,40
"541050210",51,43,94,33,38,33
"540980703",116,86,202,53,61,51
"540980102",178,150,328,97,112,95
"540980802",297,247,544,121,136,120
"540910804",143,139,282,71,84,71
"540910507",360,333,693,186,204,185
"540560304",256,254,510,131,142,129
"540490302",332,309,641,165,111,105
"540420901",79,60,139,35,52,34
"540420609",32,24,56,17,21,17
"540420106",34,29,63,17,22,17
"540350305",5,5,10,3,7,3
"540350207",55,49,104,27,41,27
"540350205",6,6,12,3,4,3
"540210703",97,83,180,38,49,37
"540210606",46,45,91,23,28,23
"540210101",368,108,476,63,87,62
"540140904",73,67,140,36,45,36
"540140507",264,255,519,140,159,140
"540140306",66,65,131,32,35,32
"540140102",252,212,464,128,173,125
"540070502",141,124,265,70,80,70
"540070406",30,23,53,18,21,18
"540910301",114,96,210,54,71,54
"540840604",85,60,145,35,56,35
"540840310",67,60,127,34,40,32
"540770605",417,396,813,189,221,188
"540700506",163,129,292,84,99,82
"540630808",11,9,20,10,12,10
"540630703",34,25,59,17,28,17
"540630702",4,1,5,3,8,3
"540630505",112,65,177,56,62,55
"540630503",73,52,125,33,36,33
"540630401",56,41,97,23,29,22
"540630501",320,277,597,168,164,163
"540630101",229,187,416,126,144,125
"540910503",198,169,367,101,112,101
"540910305",267,210,477,122,135,122
"540420903",8,4,12,3,4,3
"540070405",19,19,38,10,14,10
"540980801",179,169,348,103,122,103
"540840407",78,81,159,45,48,45
"540770701",101,89,190,42,51,40
"541190105",1174,1084,2258,583,603,577
"541190502",873,851,1724,493,512,467
"541190103",765,686,1451,390,411,383
"541050108",161,164,325,89,85,83
"540981103",344,290,634,142,166,141
"540980902",721,669,1390,353,363,328
"540980510",174,166,340,84,129,84
"540980402",137,133,270,65,61,45
"540980302",269,261,530,148,172,146
"540911101",598,542,1140,250,268,247
"540911006",160,140,300,83,94,82
"540910708",254,238,492,125,153,116
"540910706",312,304,616,164,178,162
"540910703",234,216,450,120,135,114
"540910404",450,397,847,237,268,231
"540840403",606,596,1202,316,341,310
"540840309",312,286,598,151,166,151
"540840307",384,367,751,182,177,139
"540770207",220,218,438,117,139,117
"540700206",365,319,684,176,214,160
"540420302",245,230,475,141,156,131
"540420101",231,249,480,114,137,114
"540140604",434,413,847,209,214,198
"540140502",379,346,725,204,212,201
"540140107",286,279,565,135,135,111
"540070303",625,646,1271,318,359,308
"540070104",178,162,340,95,102,94
"541050401",416,374,790,210,246,203
"540630115",436,394,830,254,318,248
"540420316",421,402,823,228,241,226
"541120514",229,255,484,123,142,121
"541120512",487,459,946,245,246,226
"540981209",399,406,805,231,261,230
"540981204",719,701,1420,305,322,291
"540981202",392,425,817,209,230,203
"540981007",438,442,880,229,247,211
"540980516",710,683,1393,337,348,333
"540980514",308,374,682,210,235,208
"540980505",333,328,661,232,248,223
"540980502",504,566,1070,309,324,303
"540980206",574,604,1178,317,313,299
"540911310",575,588,1163,459,536,452
"540911307",412,385,797,204,230,201
"540911305",365,405,770,216,211,196
"540911302",582,591,1173,250,271,247
"540910712",454,458,912,258,271,246
"540910209",564,608,1172,336,334,294
"540910205",583,602,1185,329,337,318
"540910202",839,856,1695,431,433,422
"540910104",547,632,1179,404,455,400
"540840905",355,350,705,169,194,166
"540840901",561,610,1171,287,327,279
"540630109",747,706,1453,369,408,363
"540630108",423,462,885,212,204,191
"540630106",549,478,1027,268,293,263
"540560908",498,582,1080,301,314,297
"540560710",581,486,1067,266,317,259
"540560711",459,505,964,284,336,274
"540840302",509,557,1066,291,272,252
"540840105",448,438,886,256,302,252
"540770811",305,312,617,190,210,186
"540770810",356,429,785,255,273,249
"540770408",389,430,819,233,259,224
"540770308",445,415,860,195,218,192
"540770213",510,521,1031,269,283,261
"540770212",411,381,792,205,257,201
"540770210",346,374,720,207,228,206
"540770208",738,705,1443,372,396,366
"540700803",597,668,1265,399,421,374
"540700703",318,378,696,257,289,255
"540700701",333,414,747,272,292,265
"540700508",575,545,1120,328,367,325
"540700313",325,374,699,201,211,200
"540700310",444,453,897,233,270,226
"540631101",515,591,1106,238,277,237
"540630904",270,273,543,177,182,173
"540630114",379,362,741,210,292,205
"540490109",665,619,1284,320,345,310
"540630818",318,325,643,194,189,175
"540281212",801,848,1649,378,392,372
"540281014",256,347,603,223,281,222
"540281009",558,663,1221,422,491,416
"540281006",270,320,590,238,265,214
"540281220",451,523,974,273,409,271
"540280820",821,878,1699,421,430,412
"540280819",413,452,865,326,512,324
"540280817",308,341,649,163,167,152
"540280809",741,795,1536,381,390,364
"540280808",783,832,1615,385,332,318
"540280908",312,436,748,279,392,270
"540280618",925,956,1881,497,320,283
"540280606",301,344,645,210,241,202
"540280604",298,300,598,165,176,159
"540280417",629,688,1317,327,320,298
"540280411",495,515,1010,255,254,246
"540280402",726,813,1539,372,335,322
"540280313",392,451,843,269,301,258
"540280312",505,549,1054,299,316,285
"540280701",456,512,968,271,291,269
"540280301",765,846,1611,436,446,406
"540280217",229,344,573,216,305,209
"540280213",167,289,456,214,281,207
"540280211",177,276,453,195,277,193
"540280204",239,346,585,215,308,212
"540280116",6,7,13,5,6,5
"540280105",110,111,221,67,67,57
"540282415",913,857,1770,416,432,399
"540282407",843,924,1767,380,333,311
"540282406",491,512,1003,202,212,200
"540282310",336,397,733,248,271,232
"540282209",542,641,1183,410,404,356
"540282205",248,316,564,238,265,231
"540420311",193,195,388,112,91,79
"540282021",607,635,1242,290,304,282
"540282020",372,390,762,200,283,174
"540282018",418,430,848,231,249,225
"540282017",532,501,1033,229,244,224
"540281917",831,843,1674,396,454,380
"540281819",376,447,823,189,211,189
"540281803",507,516,1023,228,243,223
"540210516",447,516,963,269,301,268
"540210506",374,386,760,210,250,206
"540140511",787,678,1465,369,403,365
"540140307",652,631,1283,303,322,303
"540070617",296,332,628,209,241,207
"540070615",695,696,1391,337,367,323
"540070103",643,702,1345,340,360,309
"540560904",512,551,1063,294,306,292
"541190106",444,477,921,287,302,283
"541050220",347,370,717,187,203,184
"540560208",513,617,1130,336,365,332
"540490206",990,1022,2012,558,649,544
"540490116",527,486,1013,264,293,258
"540490115",444,448,892,212,235,206
"540140806",630,587,1217,284,319,281
"540630407",431,433,864,236,253,234
"540281207",487,526,1013,269,264,235
"540281205",495,578,1073,264,261,243
"541190201",334,306,640,142,139,137
"541190504",326,285,611,158,159,136
"541190102",413,390,803,190,199,190
"541120602",1163,996,2159,509,530,502
"541050304",14,13,27,10,10,10
"541050205",16,13,29,6,7,6
"541050105",167,155,322,81,90,81
"540981102",263,225,488,111,108,92
"541050206",13,18,31,6,9,6
"540980105",112,92,204,56,64,56
"540980103",144,133,277,78,93,75
"540911208",138,113,251,56,56,54
"540911007",66,66,132,34,34,34
"540910807",235,227,462,97,99,97
"540910802",334,295,629,168,179,165
"540910704",138,118,256,66,74,65
"540560305",690,558,1248,314,355,309
"540560105",217,188,405,105,113,105
"540490403",41,29,70,24,28,18
"540421002",86,71,157,34,40,34
"540420708",31,23,54,20,28,16
"540420301",385,355,740,192,219,188
"540350202",21,21,42,13,20,13
"540281503",110,106,216,59,69,59
"540210402",81,62,143,41,44,41
"540141003",127,123,250,68,91,68
"540140903",213,185,398,87,88,86
"540140901",165,152,317,85,99,83
"540140705",304,287,591,142,145,135
"540140702",156,147,303,86,103,86
"540140606",405,321,726,172,177,169
"540070401",101,107,208,55,83,55
"540070309",56,56,112,25,44,25
"540700505",317,263,580,154,187,154
"540630602",43,19,62,22,24,22
"540560702",560,495,1055,269,327,262
"540560701",169,163,332,90,110,90
"540560605",524,469,993,234,249,230
"540560401",1,0,1,1,2,1
"540910502",192,171,363,98,111,97
"540910303",82,68,150,52,68,51
"540350104",46,45,91,21,23,21
"540210305",83,59,142,47,59,46
"540140106",129,102,231,73,93,71
"541050211",36,41,77,20,20,20
"540770502",12,7,19,7,11,7
"540770201",407,367,774,170,184,166
"540630402",26,15,41,20,28,20
"540560306",331,270,601,144,150,143
"541120103",734,566,1300,331,401,327
"540980702",515,486,1001,265,223,189
"540770402",334,309,643,200,233,200
"540770401",796,686,1482,342,391,341
"540770103",529,491,1020,254,262,251
"540700402",667,569,1236,309,321,306
"540630902",162,124,286,82,111,81
"540630805",804,783,1587,399,395,353
"540630403",177,149,326,84,98,82
"540490301",1097,1071,2168,542,641,524
"540420703",210,192,402,92,105,92
"540420303",472,486,958,239,272,236
"540281101",259,229,488,120,131,115
"540140501",268,261,529,152,157,148
"540070507",83,60,143,53,67,52
"541190104",663,649,1312,352,364,349
"541120510",671,701,1372,346,367,331
"541050218",535,612,1147,323,348,320
"541050217",408,496,904,256,269,253
"541050213",400,429,829,221,231,204
"540981010",338,358,696,193,208,184
"540981009",283,307,590,190,218,188
"540980503",379,371,750,247,281,246
"540980501",612,558,1170,315,331,303
"540911309",747,832,1579,445,464,438
"540911009",315,299,614,166,207,166
"540910810",571,664,1235,298,327,294
"540910716",488,448,936,244,253,240
"540910211",458,504,962,265,303,263
"540910206",287,354,641,222,245,216
"540910106",597,690,1287,389,402,362
"540840902",906,871,1777,393,386,368
"540630110",699,712,1411,376,351,332
"540560907",394,422,816,220,229,216
"540560901",539,631,1170,372,417,367
"540840107",609,624,1233,328,345,328
"540770812",295,305,600,190,220,189
"540770804",416,457,873,279,299,272
"540770211",626,568,1194,297,336,294
"540700807",644,655,1299,399,430,384
"540631113",589,602,1191,338,381,333
"540631110",536,487,1023,283,290,261
"540631106",713,727,1440,412,433,397
"540631105",730,733,1463,441,523,429
"540631006",445,420,865,205,219,202
"540631004",671,716,1387,389,438,368
"540630803",224,227,451,169,188,167
"540630817",638,639,1277,246,254,240
"540420612",731,794,1525,328,290,272
"540420516",400,406,806,271,314,265
"540420508",393,442,835,279,346,275
"540420507",371,389,760,245,270,240
"540420505",549,622,1171,335,373,326
"540420502",599,670,1269,369,385,357
"540420420",496,506,1002,284,309,280
"540420419",392,434,826,231,249,221
"540420412",401,399,800,230,253,226
"540420411",785,765,1550,405,439,397
"540281215",450,484,934,274,272,247
"540281010",497,559,1056,327,362,321
"540281008",576,693,1269,443,475,404
"540281003",370,421,791,298,326,261
"540281001",236,292,528,223,251,203
"540280903",192,227,419,130,143,119
"540281218",974,945,1919,474,480,440
"540280807",1030,1005,2035,481,467,450
"540280717",379,438,817,243,228,195
"540280712",522,522,1044,293,312,287
"540280710",421,549,970,322,348,317
"540280617",418,439,857,246,264,239
"540280615",93,102,195,60,66,57
"540280607",481,545,1026,310,331,287
"540280602",440,509,949,321,296,272
"540280509",368,420,788,242,287,232
"540280501",329,419,748,304,347,286
"540280416",330,395,725,254,285,230
"540280702",504,556,1060,293,301,273
"540280414",354,422,776,249,269,244
"540280408",629,723,1352,430,400,330
"540280405",398,468,866,309,353,303
"540280401",581,621,1202,354,353,302
"540280303",597,554,1151,280,285,269
"540280212",128,182,310,120,165,119
"540280210",258,342,600,267,356,252
"540280205",306,320,626,181,325,180
"540210611",120,104,224,61,62,52
"540350412",644,757,1401,346,387,346
"540350403",439,484,923,261,303,261
"540282414",513,553,1066,308,377,307
"540282311",847,889,1736,441,455,426
"540282301",724,792,1516,436,409,385
"540282202",685,720,1405,459,435,371
"540282010",374,398,772,225,246,217
"540282004",839,913,1752,499,544,475
"540281927",488,509,997,242,298,235
"540281915",495,538,1033,284,297,280
"540281813",797,816,1613,374,360,345
"540281802",477,464,941,242,262,238
"540281801",800,802,1602,351,350,337
"540210504",602,638,1240,322,360,314
"540210306",346,338,684,193,241,192
"540140112",154,142,296,87,98,85
"540140110",381,447,828,261,296,260
"540140108",362,398,760,222,232,220
"540070616",721,706,1427,359,385,352
"540070614",255,297,552,200,222,199
"540070601",55,56,111,28,66,28
"540070314",254,257,511,135,147,134
"540070609",197,211,408,156,194,155
"540910306",390,425,815,238,260,231
"540630916",471,441,912,200,225,196
"540630905",489,478,967,246,275,243
"540630113",501,523,1024,255,271,252
"541190307",410,422,832,259,289,257
"540490204",356,384,740,219,244,213
"540420709",164,155,319,91,104,91
"540420514",354,421,775,281,349,279
"540282402",511,537,1048,315,377,313
"540281323",307,317,624,175,352,171
"540281308",517,573,1090,269,285,255
"540140609",338,320,658,157,166,153
"540070607",687,696,1383,354,362,336
"541120202",47,26,73,20,20,20
"541120104",102,74,176,41,48,41
"541050104",129,151,280,72,74,71
"540981001",30,21,51,12,19,12
"540980901",309,265,574,169,189,166
"540980604",48,30,78,25,41,24
"540980603",81,54,135,39,46,38
"540980509",337,282,619,154,181,153
"540911205",210,224,434,90,94,89
"540911104",61,54,115,33,35,29
"540911108",260,263,523,126,141,123
"540910803",402,351,753,191,209,189
"540910711",38,35,73,19,25,19
"540910701",128,109,237,61,91,61
"540560303",1207,1053,2260,567,572,563
"540560104",400,343,743,199,214,198
"540490205",604,513,1117,305,334,302
"540420805",111,91,202,48,60,48
"540420804",10,7,17,6,12,6
"540420802",307,282,589,164,198,163
"540420608",69,59,128,39,57,38
"540420203",63,53,116,35,51,35
"540350401",311,281,592,154,185,152
"540281704",15,22,37,11,17,8
"540281402",0,0,0,0,5,0
"540210702",63,55,118,37,44,37
"540210605",56,33,89,30,34,30
"540140804",147,108,255,63,64,63
"540140701",268,266,534,138,161,137
"540140503",365,288,653,161,142,134
"540840802",144,105,249,70,112,68
"540840401",73,70,143,37,46,37
"540770702",256,257,513,127,142,124
"540770307",8,4,12,6,9,6
"540700601",231,179,410,124,130,124
"540700403",135,116,251,69,69,69
"540700304",569,512,1081,279,302,273
"540630601",1,0,1,1,15,1
"540560708",714,601,1315,338,352,329
"540560707",200,185,385,113,109,102
"540560602",1064,879,1943,466,473,439
"540560403",109,81,190,53,57,53
"540910401",269,239,508,124,145,124
"540700201",162,146,308,80,84,79
"580910205",89,81,170,46,58,44
"580352414",346,344,690,196,218,185
"580351901",333,277,610,210,307,187
"580351812",669,617,1286,399,500,333
"580351619",223,186,409,132,142,128
"580350801",310,339,649,202,229,190
"580770201",215,209,424,135,162,108
"580910312",285,283,568,170,199,165
"580910309",329,295,624,196,241,191
"580560510",250,273,523,207,338,203
"580560505",552,591,1143,353,383,330
"580560503",147,171,318,101,112,99
"580560408",479,492,971,226,233,212
"580560404",281,305,586,211,276,210
"580560309",275,300,575,211,271,200
"580560306",553,532,1085,324,353,319
"580490414",341,372,713,211,232,197
"580560301",287,275,562,187,188,185
"580420206",361,366,727,243,289,240
"580352514",621,616,1237,305,335,291
"580352409",419,426,845,251,308,241
"580352310",352,432,784,264,319,260
"580352212",227,269,496,133,169,130
"580352204",32,27,59,15,32,15
"581120416",190,209,399,130,153,126
"581120403",85,37,122,22,39,16
"581120314",378,416,794,257,301,245
"581120412",314,320,634,199,216,185
"580352114",430,453,883,256,296,248
"580352104",636,611,1247,355,416,352
"580352103",444,484,928,274,276,251
"580352012",791,868,1659,398,407,384
"580352008",728,711,1439,438,478,423
"580351902",531,526,1057,315,329,301
"580351826",439,483,922,235,242,163
"580351821",410,397,807,241,273,236
"580351710",570,535,1105,358,377,326
"580351707",510,516,1026,374,438,374
"580351609",255,206,461,159,194,140
"580351509",471,496,967,313,334,290
"580351505",627,685,1312,435,507,433
"580351416",229,233,462,143,140,116
"580351405",389,430,819,295,370,291
"580350616",203,244,447,193,250,184
"580350501",191,219,410,220,319,217
"580350512",365,160,525,119,149,119
"580352413",405,428,833,208,239,205
"580350402",375,413,788,306,374,283
"580350510",238,314,552,282,407,273
"580350518",136,150,286,133,182,132
"580350413",281,260,541,177,201,173
"580280109",400,443,843,264,320,258
"580140109",894,905,1799,491,575,486
"580350410",479,561,1040,354,351,305
"580351401",278,279,557,186,208,181
"580351211",231,260,491,171,184,169
"580351110",356,353,709,243,307,225
"580351004",374,432,806,294,358,292
"580350822",721,797,1518,363,374,351
"580350821",369,378,747,194,205,187
"580350819",383,428,811,219,235,210
"580350818",309,341,650,180,190,174
"580980104",823,849,1672,461,525,441
"580910324",521,553,1074,286,299,251
"580352112",309,370,679,201,212,195
"580352109",454,500,954,258,267,251
"581120303",702,860,1562,402,390,367
"580351702",329,365,694,272,307,259
"580351506",597,655,1252,404,443,395
"580420216",314,305,619,196,240,192
"580420105",169,182,351,107,135,107
"580352501",656,681,1337,345,386,337
"580352323",408,386,794,189,185,184
"580490205",175,193,368,103,109,97
"581050208",41,19,60,20,20,20
"580420101",187,132,319,92,144,92
"581050207",128,74,202,58,72,56
"580350108",29,30,59,20,32,20
"580210102",63,49,112,36,46,35
"580140111",200,123,323,117,161,111
"580070205",351,397,748,209,246,208
"580630107",35,23,58,14,23,14
"580630101",75,42,117,43,125,43
"580560102",30,18,48,12,17,12
"580490302",37,21,58,25,40,25
"580210108",29,17,46,20,25,20
"581050213",48,47,95,29,40,29
"580910202",19,8,27,13,27,13
"580840107",163,117,280,88,115,87
"581050214",38,34,72,20,33,19
"580560203",42,10,52,12,26,12
"580352007",758,698,1456,422,447,306
"580351914",281,266,547,180,240,174
"580351601",321,274,595,179,211,174
"580350701",60,81,141,55,63,54
"580350204",539,421,960,330,306,240
"580350201",235,218,453,130,155,79
"580910107",698,683,1381,436,507,426
"580700108",324,325,649,199,294,190
"580700107",785,762,1547,434,481,409
"580630113",605,628,1233,333,411,330
"580910320",421,406,827,232,256,224
"580560508",427,469,896,268,285,262
"580560504",252,255,507,174,217,174
"580560407",709,726,1435,420,398,340
"580560406",506,477,983,286,426,282
"580560402",392,399,791,204,200,183
"580490413",528,575,1103,286,291,265
"580490412",360,380,740,189,196,180
"580420202",389,451,840,218,203,182
"580420109",77,105,182,55,72,50
"580352406",483,463,946,256,260,212
"580352405",521,520,1041,250,158,147
"580352326",370,379,749,224,247,221
"580352316",385,387,772,226,220,214
"580352315",349,367,716,210,208,201
"580352311",420,493,913,318,286,269
"580352308",418,412,830,298,320,282
"580352215",239,263,502,187,198,166
"580352214",427,449,876,286,258,238
"580352209",380,424,804,277,293,258
"581120420",419,456,875,307,362,303
"581120407",313,282,595,207,218,185
"581120305",622,617,1239,333,351,320
"581120302",700,760,1460,370,385,361
"581120207",198,162,360,90,120,87
"580352111",485,500,985,271,285,251
"580352108",559,518,1077,271,306,256
"580351819",277,291,568,185,238,182
"580351806",327,344,671,214,231,205
"580351805",522,511,1033,275,295,268
"580351711",601,646,1247,424,447,406
"580351508",486,448,934,294,324,277
"580351502",288,351,639,260,285,254
"580351420",78,63,141,48,81,48
"580351419",504,544,1048,317,252,212
"580351414",615,676,1291,419,438,384
"580350708",700,675,1375,395,310,283
"580350617",253,303,556,239,320,206
"580350609",354,401,755,296,349,294
"580350604",235,302,537,223,258,205
"580350507",221,252,473,196,268,180
"580350419",456,485,941,364,384,277
"580350414",451,518,969,316,344,291
"580352506",274,298,572,166,172,159
"580352412",561,630,1191,315,313,292
"580352410",578,595,1173,281,295,277
"580350509",222,265,487,253,373,251
"580350207",266,216,482,151,183,147
"580350206",59,43,102,45,80,41
"580350205",268,239,507,160,130,116
"580140114",455,417,872,264,406,264
"580350516",294,367,661,322,485,317
"580350515",238,281,519,202,358,202
"580351214",338,364,702,247,286,234
"580351212",313,338,651,249,248,240
"580351117",774,759,1533,386,417,382
"580351113",515,593,1108,309,330,304
"580351106",522,556,1078,374,409,356
"580351018",255,256,511,150,144,133
"580351013",804,913,1717,512,451,397
"580350816",664,683,1347,378,421,356
"580350513",261,323,584,262,314,242
"580910322",441,387,828,245,272,234
"581120405",437,418,855,261,278,254
"580351411",820,848,1668,418,443,403
"580351213",350,352,702,277,311,260
"580350610",281,303,584,223,264,217
"580280116",120,99,219,63,80,62
"580140115",268,250,518,140,172,137
"580352516",492,503,995,277,282,258
"581050212",44,7,51,28,28,28
"580910203",18,10,28,14,26,14
"581120107",58,58,116,25,43,20
"581120104",63,46,109,30,20,7
"581120101",147,115,262,100,141,98
"580352201",335,232,567,184,196,59
"580350101",42,16,58,26,58,26
"580280104",95,94,189,55,59,55
"580210103",119,107,226,78,78,78
"580630104",298,267,565,147,163,145
"580630103",45,30,75,26,38,25
"580560310",224,204,428,114,130,79
"580490204",148,137,285,71,83,69
"580630109",186,114,300,91,121,90
"581050203",35,10,45,12,60,12
"580840104",68,22,90,40,58,40
"581050101",90,71,161,49,78,49
"580770204",181,117,298,81,96,73
"580840102",362,359,721,206,244,205
"580420106",247,191,438,145,175,141
"580351911",646,622,1268,370,359,304
"580351814",239,185,424,142,214,131
"580351811",559,496,1055,286,454,172
"580351606",318,269,587,188,208,179
"580351603",115,97,212,65,94,57
"580070301",167,151,318,111,160,105
"580840116",310,297,607,180,352,179
"581120310",509,615,1124,330,369,324
"580910103",393,389,782,242,309,240
"580840106",447,431,878,252,307,230
"580840103",133,129,262,87,111,87
"580700113",495,480,975,334,460,326
"580700104",303,350,653,200,324,197
"580560507",635,639,1274,366,320,278
"580560410",247,256,503,166,245,164
"580560405",749,756,1505,471,534,450
"580560509",416,445,861,309,386,299
"580560308",634,618,1252,387,435,347
"580490409",428,432,860,269,317,251
"580420204",287,299,586,177,199,171
"580420210",283,312,595,185,234,184
"580352513",512,567,1079,280,284,258
"580352317",454,438,892,257,246,237
"580352313",426,467,893,295,329,291
"580352306",274,238,512,163,183,159
"580352208",489,569,1058,313,322,298
"580352207",416,428,844,272,201,175
"581120208",400,421,821,224,246,220
"581120206",373,387,760,214,267,203
"581050103",426,430,856,215,269,213
"580352009",396,410,806,241,292,239
"580351912",157,160,317,109,164,106
"580351818",405,440,845,273,320,269
"580351817",372,332,704,209,240,206
"580351815",472,479,951,269,290,265
"580351804",277,290,567,180,197,171
"580351617",75,60,135,54,78,52
"580351616",681,645,1326,344,372,338
"580351614",228,229,457,138,202,131
"580351908",559,607,1166,366,433,359
"580351514",475,499,974,301,350,291
"580351503",502,506,1008,355,411,343
"580351421",356,370,726,198,183,152
"580351415",342,333,675,166,167,164
"580351410",628,656,1284,380,406,376
"580351403",510,505,1015,302,320,294
"580350703",379,477,856,323,367,307
"580350602",220,255,475,224,316,217
"580350508",169,203,372,177,217,172
"580352509",319,342,661,205,196,189
"580350405",448,492,940,281,276,242
"580350403",197,236,433,136,167,133
"580350314",101,100,201,64,52,32
"580350306",529,569,1098,348,415,341
"580350214",257,252,509,154,189,150
"580350213",216,194,410,132,172,132
"580350109",11,13,24,13,271,13
"580350412",515,529,1044,352,358,328
"580351215",471,461,932,336,369,310
"580351210",359,362,721,248,220,201
"580351209",480,517,997,349,381,325
"580351120",289,296,585,202,237,196
"580351125",263,274,537,164,189,162
"580351109",165,173,338,103,112,97
"580351014",323,357,680,197,210,192
"580350911",544,556,1100,301,301,276
"580350908",548,577,1125,323,321,301
"580350907",539,619,1158,339,344,329
"580350902",522,513,1035,270,277,258
"580350815",467,491,958,296,261,239
"580350809",465,531,996,306,331,298
"580350303",440,461,901,263,294,262
"580910316",228,208,436,133,157,130
"581120103",205,164,369,98,119,98
"581120304",693,752,1445,375,403,372
"580351810",476,514,990,359,370,315
"580351103",667,681,1348,409,406,387
"580420215",312,347,659,232,285,231
"580910301",104,24,128,25,11,11
"580560204",32,22,54,8,8,8
"580420108",64,54,118,46,79,46
"580280105",38,30,68,25,46,25
"580351618",124,97,221,60,68,58
"580350203",8,11,19,7,14,7
"580210104",66,61,127,42,48,42
"580140112",119,73,192,72,115,61
"580070204",48,41,89,32,50,32
"580070201",166,132,298,93,99,91
"580070105",160,116,276,90,395,89
"580980204",95,66,161,69,105,69
"580630108",59,29,88,35,38,25
"580490103",22,15,37,10,14,10
"580420102",138,62,200,69,47,38
"580560105",197,190,387,121,169,119
"580560101",138,124,262,72,76,71
"580490101",14,4,18,4,3,3
"580351801",5,1,6,4,5,4
"580350106",54,17,71,27,31,27
"580070102",201,111,312,133,181,133
"581120401",298,286,584,175,231,167
"580980202",243,198,441,151,200,149
"580490401",472,472,944,281,371,281
"580352301",101,74,175,55,63,55
"580351402",114,106,220,61,71,60
"580350311",189,215,404,123,145,120
"580280106",23,19,42,16,27,16
"580630105",198,238,436,92,47,38
"580910321",453,407,860,234,256,218
"580700204",191,165,356,102,142,101
"580700110",495,513,1008,175,361,168
"580560515",218,277,495,174,330,169
"580560514",230,253,483,113,199,110
"580560513",273,269,542,139,178,138
"580910317",376,341,717,229,260,199
"580490405",292,338,630,191,215,185
"580420211",547,637,1184,299,339,296
"580420208",422,475,897,277,329,271
"580352401",451,495,946,242,251,232
"580352325",352,364,716,244,245,226
"580352211",647,691,1338,384,367,335
"581120414",194,192,386,114,129,108
"581120410",226,276,502,181,224,181
"581120404",621,667,1288,345,375,334
"581120307",598,622,1220,331,365,324
"581120313",294,326,620,233,298,225
"581050106",842,878,1720,454,524,446
"581050102",202,230,432,128,172,126
"580352115",315,323,638,185,196,171
"580352113",219,220,439,139,185,138
"580352110",522,543,1065,308,356,301
"580352107",450,505,955,346,375,324
"580352106",383,423,806,290,321,267
"580352217",602,673,1275,350,315,286
"580352220",430,478,908,250,245,223
"580351913",364,364,728,182,193,176
"580351903",407,453,860,259,224,193
"580351809",475,513,988,333,378,325
"580351802",449,458,907,275,325,271
"580351910",414,419,833,242,246,219
"580351704",434,455,889,303,347,296
"580352219",532,555,1087,298,277,258
"580351504",391,417,808,272,316,270
"580351413",575,599,1174,415,452,400
"580351412",501,545,1046,343,373,340
"580351406",216,251,467,200,295,181
"580350804",390,385,775,219,219,213
"580350714",406,428,834,251,245,230
"580350711",644,635,1279,361,367,343
"580350710",517,548,1065,314,307,281
"580350707",542,559,1101,310,266,241
"580350706",605,585,1190,333,296,278
"580350704",685,700,1385,409,416,384
"580350709",546,558,1104,329,351,319
"580350601",522,550,1072,383,357,295
"580350519",162,204,366,148,161,141
"580350420",387,438,825,292,348,282
"580350417",300,352,652,290,367,264
"580352508",246,289,535,178,200,169
"580352411",691,687,1378,391,371,337
"580350408",411,465,876,327,346,293
"580350406",366,408,774,287,309,272
"580350316",450,497,947,301,329,294
"580350511",298,344,642,302,399,290
"580350309",435,504,939,345,385,315
"580350308",779,802,1581,436,452,419
"580350307",527,540,1067,376,394,346
"580350208",211,170,381,138,158,102
"580280107",510,502,1012,282,316,280
"580140106",527,471,998,340,381,320
"580140104",428,420,848,278,327,269
"580350411",423,465,888,311,369,296
"580350514",192,270,462,194,274,193
"580351310",581,548,1129,373,396,355
"580351114",479,441,920,246,249,226
"580351107",591,603,1194,408,470,390
"580351104",610,677,1287,452,524,441
"580351016",372,397,769,234,250,228
"580351010",293,287,580,160,221,159
"580350904",642,709,1351,359,369,343
"580350915",447,440,887,247,229,212
"580350820",446,454,900,277,283,244
"580350813",444,459,903,246,238,219
"580350807",600,574,1174,300,297,271
"580351001",319,364,683,178,180,156
"580910315",266,205,471,159,190,137
"580910306",295,241,536,205,251,193
"580351604",274,287,561,170,179,159
"580350104",35,23,58,25,284,20
"580140116",553,548,1101,289,332,274
"580352517",591,579,1170,332,318,295
"580352321",341,317,658,168,167,164
"580630112",806,843,1649,506,568,489
"580980105",154,106,260,93,132,93
"580630102",142,113,255,76,100,76
"580210109",89,72,161,44,48,42
"580210106",20,15,35,13,15,13
"580700101",45,31,76,13,13,13
"580490203",109,99,208,68,84,67
"580490201",34,39,73,16,32,16
"581120102",34,32,66,23,24,23
"580770202",88,100,188,45,65,45
"580352001",156,171,327,116,128,112
"580560411",94,99,193,69,56,38
"580910310",273,227,500,165,209,164
"580910108",537,525,1062,312,377,285
"580770207",370,363,733,220,249,216
"580910325",376,367,743,216,205,190
"580770205",370,385,755,226,301,221
"581120315",212,208,420,145,174,140
"580560502",252,302,554,156,221,139
"580490410",290,305,595,198,214,166
"580560304",517,487,1004,283,306,271
"580352407",461,467,928,287,295,253
"580352319",597,588,1185,334,362,320
"580352309",475,538,1013,347,394,343
"580352305",326,315,641,245,267,235
"580352304",368,417,785,294,322,286
"581120415",502,552,1054,313,326,292
"581120205",372,347,719,207,267,178
"581050104",487,478,965,308,332,294
"580910307",190,156,346,147,211,134
"580352116",351,382,733,195,215,183
"580351803",421,423,844,275,278,203
"580351708",577,546,1123,398,416,382
"580351612",446,413,859,216,253,208
"580351607",208,181,389,103,112,98
"580351605",505,447,952,257,309,252
"580351510",583,580,1163,370,401,361
"580351501",567,619,1186,414,435,398
"580351418",667,698,1365,379,406,360
"580350615",215,276,491,238,320,222
"580352511",429,408,837,234,229,203
"580352503",601,661,1262,337,386,327
"580350407",305,353,658,233,243,195
"580350310",317,403,720,287,303,255
"580350212",217,187,404,143,226,140
"580350211",212,183,395,151,207,138
"580350302",423,442,865,245,253,242
"580350517",176,235,411,206,284,203
"580070305",171,183,354,92,143,91
"580070304",569,573,1142,363,415,350
"580070303",567,585,1152,338,368,333
"580070302",947,948,1895,547,577,499
"580351312",417,438,855,316,344,307
"580351311",347,353,700,259,305,259
"580351203",294,324,618,223,263,207
"580351201",375,426,801,353,403,345
"580351119",319,365,684,218,219,196
"580351111",21,6,27,0,0,0
"580351108",344,350,694,238,266,233
"580351101",386,418,804,254,268,242
"580351012",544,539,1083,299,235,222
"580351009",497,473,970,314,353,312
"580351008",424,506,930,277,306,273
"580350817",514,513,1027,284,291,271
"580700111",523,488,1011,313,360,305
"580700105",649,660,1309,456,496,430
"580630111",960,1035,1995,584,623,553
"580352206",454,482,936,286,303,279
"581120419",537,539,1076,267,325,262
"580352010",517,507,1024,296,326,269
"580352005",53,37,90,20,28,20
"580351507",548,568,1116,357,381,342
"581050205",64,17,81,25,30,14
"580770203",151,135,286,79,91,79
"580490102",92,56,148,52,66,39
"580350105",39,23,62,24,134,21
"580980201",65,19,84,36,46,36
"580350102",147,127,274,95,133,94
"580280103",81,61,142,50,69,50
"580140103",149,91,240,78,105,77
"580140102",217,140,357,131,206,131
"580070103",324,311,635,136,231,134
"580980203",28,8,36,20,22,19
"580980102",7,0,7,3,4,3
"580630110",73,60,133,42,62,31
"580490202",271,231,502,121,138,116
"580700102",106,52,158,32,49,28
"580560202",50,23,73,17,27,17
"580490301",220,159,379,77,120,66
"581120105",124,68,192,70,77,69
"580840114",23,12,35,17,44,16
"580070202",56,39,95,31,70,25
"580070101",0,0,0,0,62,0
"581120108",51,33,84,32,32,27
"581050209",95,87,182,63,90,59
"581120202",185,171,356,95,131,93
"580910102",107,120,227,74,128,74
"580560206",65,40,105,27,183,27
"580420201",372,292,664,229,309,229
"580351825",386,412,798,238,242,202
"580351824",413,388,801,253,254,203
"580350305",587,584,1171,367,385,361
"580840115",1,0,1,0,132,0
"581120308",680,740,1420,332,324,312
"580770210",149,156,305,91,139,89
"580700112",257,233,490,164,208,140
"580700106",375,378,753,273,358,268
"580910318",522,510,1032,304,358,294
"580560403",376,414,790,274,373,271
"580560307",347,316,663,215,251,207
"580490402",270,250,520,122,149,121
"580420207",432,426,858,276,345,269
"580420205",340,346,686,216,251,215
"580420203",392,398,790,214,264,204
"580352515",469,447,916,264,268,247
"580352404",745,765,1510,362,385,352
"580352403",878,907,1785,444,449,419
"580352318",295,290,585,171,152,152
"580352216",273,299,572,177,181,163
"580352213",435,437,872,232,240,222
"581120406",263,259,522,176,186,174
"581120411",270,292,562,198,216,197
"580910305",587,382,969,283,371,265
"580352105",374,390,764,277,280,249
"580352102",504,515,1019,294,300,291
"580351823",410,414,824,205,207,198
"580351701",442,433,875,331,372,321
"580351909",580,602,1182,314,341,297
"580351513",426,413,839,287,294,266
"580351408",454,468,922,350,400,340
"580351407",479,448,927,351,422,349
"580350803",644,700,1344,386,382,353
"580350715",481,521,1002,247,250,230
"580350713",426,433,859,244,238,224
"580350712",674,679,1353,401,377,327
"580350614",288,359,647,285,380,274
"580350607",340,366,706,205,205,191
"580350606",287,321,608,182,198,174
"580350603",261,269,530,208,244,198
"580350502",311,413,724,256,308,249
"580352510",485,518,1003,279,279,266
"580350216",85,73,158,47,55,46
"580350210",397,365,762,245,282,240
"580350522",233,250,483,209,260,200
"580210112",426,397,823,221,283,217
"580140107",406,396,802,211,207,191
"580070104",368,332,700,179,391,170
"580351304",194,202,396,152,179,150
"580351303",138,137,275,120,187,120
"580351301",281,333,614,253,312,223
"580351204",604,601,1205,396,423,386
"580351202",177,236,413,167,193,163
"580351123",314,379,693,198,227,198
"580351118",382,415,797,222,229,215
"580351115",541,518,1059,242,250,238
"580351017",362,383,745,256,288,248
"580351007",340,378,718,247,235,210
"580351003",344,350,694,238,253,224
"580350913",688,771,1459,374,380,360
"580350912",529,547,1076,285,305,275
"580350901",421,384,805,211,225,207
"580350826",452,435,887,218,195,190
"580350825",459,435,894,228,234,217
"580350823",552,571,1123,281,269,259
"580350814",747,748,1495,388,367,343
"580350808",285,339,624,215,215,195
"580350520",141,166,307,124,163,122
"580980205",113,94,207,66,78,64
"580910323",470,450,920,253,339,249
"580770208",651,644,1295,376,505,371
"580700114",531,487,1018,295,311,288
"580350909",616,647,1263,337,356,330
"580490415",303,304,607,185,227,183
"580490403",510,515,1025,261,277,259
"580420214",449,459,908,280,334,275
"580420212",353,360,713,205,225,196
"580350103",21,10,31,18,59,12
"580280102",30,13,43,15,20,15
"580210110",58,48,106,32,32,32
"580140113",114,89,203,70,103,70
"580140105",173,92,265,84,109,84
"580910302",382,197,579,147,113,67
"580910204",13,4,17,9,11,8
"580980101",132,106,238,96,157,96
"580910201",152,13,165,10,16,10
"580910109",92,42,134,55,63,55
"580910106",224,195,419,127,197,126
"580910101",44,21,65,22,40,22
"580770206",155,122,277,92,100,92
"580700203",30,31,61,15,15,15
"580560501",47,22,69,17,24,17
"580352322",11,4,15,9,12,9
"580420104",100,79,179,62,101,62
"580210107",79,65,144,48,48,40
"580840113",6,4,10,3,37,2
"580840111",242,240,482,110,121,99
"580140101",179,104,283,110,129,108
"580070203",176,116,292,78,149,77
"581050210",54,38,92,34,69,34
"581120301",246,268,514,127,161,125
"580840105",269,244,513,133,135,95
"580770104",174,137,311,104,88,56
"580770102",241,220,461,154,170,148
"580351608",241,220,461,155,170,147
"580350304",520,574,1094,374,451,368
"580210111",30,27,57,17,26,17
"580910314",266,229,495,178,221,178
"580910313",283,270,553,176,196,174
"580910311",527,470,997,286,342,268
"581120311",412,402,814,239,268,232
"581120309",479,496,975,294,313,287
"580840109",204,163,367,100,93,76
"580910327",395,392,787,232,262,211
"580700109",319,330,649,194,225,193
"580700103",506,495,1001,325,662,312
"580560512",244,297,541,206,208,168
"580560511",274,315,589,226,309,217
"580560409",308,303,611,197,264,193
"580560305",546,563,1109,344,374,326
"580490407",763,764,1527,462,478,426
"580490406",370,395,765,208,233,196
"580560303",523,499,1022,283,293,275
"580560302",548,530,1078,292,315,290
"580352408",505,504,1009,287,322,278
"580352402",451,500,951,237,250,234
"580352327",334,344,678,171,208,171
"580352320",330,340,670,199,217,196
"581120409",197,223,420,155,208,150
"581050211",378,414,792,213,268,211
"580910308",294,242,536,197,233,190
"580910304",850,653,1503,409,506,406
"580352312",403,440,843,295,271,253
"580351906",472,473,945,330,385,326
"580351816",443,473,916,253,258,239
"580351813",452,466,918,253,212,187
"580351807",514,524,1038,330,388,325
"580351703",197,235,432,157,176,147
"580351620",124,112,236,76,86,76
"580351610",382,355,737,212,253,198
"580351515",323,290,613,190,186,172
"580351907",425,456,881,316,369,304
"580351511",508,533,1041,339,248,216
"580351422",349,381,730,236,252,219
"580351417",569,583,1152,305,306,280
"580351409",442,446,888,311,339,294
"580350802",772,853,1625,480,506,450
"580350702",239,257,496,167,179,161
"580350618",81,97,178,98,147,98
"580350613",275,322,597,301,454,295
"580350612",276,339,615,275,355,267
"580350605",304,350,654,263,334,256
"580350504",149,163,312,195,357,181
"580350503",372,449,821,337,388,310
"580350416",363,383,746,270,293,257
"580352507",376,398,774,215,226,208
"580352505",277,297,574,174,181,165
"580352504",354,393,747,223,233,206
"580352502",591,633,1224,324,359,312
"580350404",769,792,1561,470,452,407
"580350401",245,323,568,258,331,253
"580350215",335,377,712,203,238,196
"580350523",177,234,411,190,252,185
"580280108",231,225,456,103,106,95
"580280117",425,406,831,258,286,254
"580140110",629,627,1256,341,395,330
"580140108",366,363,729,222,267,213
"580350409",400,507,907,347,378,314
"580351316",453,513,966,317,360,313
"580351307",360,331,691,293,341,287
"580351302",212,209,421,153,214,134
"580351207",329,363,692,205,204,189
"580351126",286,265,551,163,234,163
"580351105",314,344,658,246,242,207
"580351005",636,621,1257,396,432,391
"580351002",497,471,968,296,316,293
"580350910",501,576,1077,303,297,269
"580350906",506,515,1021,260,278,252
"580350903",579,612,1191,338,357,333
"580350917",553,584,1137,323,330,317
"580350824",318,329,647,182,225,181
"580350918",550,613,1163,285,325,263
"581120109",61,64,125,38,34,29
"580560516",196,265,461,208,368,205
"581120418",748,800,1548,413,460,399
"580280110",236,269,505,116,192,114
"580420213",306,320,626,183,210,177
"580352324",370,340,710,198,218,193
"580840110",23,8,31,18,21,18
"580700202",99,53,152,65,80,56
"580700201",78,54,132,34,46,34
"580210105",146,85,231,77,80,71
"581120201",148,93,241,77,97,77
"581120203",50,33,83,39,39,27
"581120106",65,35,100,25,18,12
"580352101",198,162,360,112,171,112
"580280101",62,28,90,32,45,32
"580910105",127,13,140,12,27,12
"580840112",33,17,50,20,21,20
"580560205",57,30,87,11,100,11
"580420107",43,49,92,35,50,30
"580280115",52,40,92,37,47,37
"581120417",23,24,47,17,17,17
"581050201",7,2,9,4,7,4
"580840101",16,11,27,15,27,15
"580560401",375,329,704,215,290,204
"580770105",253,223,476,165,261,162
"580770103",312,273,585,190,158,101
"580352006",171,98,269,117,170,90
"580351613",306,292,598,193,245,189
"580351112",551,550,1101,353,445,269
"580840108",183,155,338,111,146,98
"581120312",380,420,800,303,342,297
"580910326",275,263,538,160,215,158
"581120316",338,342,680,228,279,224
"580560517",235,297,532,141,203,139
"580560506",486,430,916,298,355,293
"580910319",427,384,811,250,285,232
"580490411",397,395,792,215,239,214
"580490408",488,473,961,283,331,278
"580490404",429,438,867,314,348,309
"580420209",299,283,582,192,236,188
"580352512",441,502,943,241,257,228
"580352314",432,436,868,267,265,256
"580352307",396,408,804,297,335,294
"580352302",461,475,936,277,288,272
"580352221",440,434,874,216,151,133
"580352210",390,423,813,262,268,240
"580352205",547,532,1079,279,268,210
"580352203",71,50,121,35,36,26
"580352202",368,374,742,198,219,195
"581120413",600,601,1201,358,365,328
"581120408",473,522,995,371,422,365
"581120402",446,459,905,246,292,240
"581120306",432,464,896,252,258,226
"581050105",431,399,830,236,262,219
"580910303",585,435,1020,281,290,254
"580352218",241,258,499,121,128,119
"580352011",505,573,1078,289,299,284
"580352003",63,77,140,52,84,49
"580352002",360,347,707,206,278,200
"580351905",531,560,1091,357,402,341
"580351904",463,491,954,321,342,306
"580351822",324,334,658,200,215,192
"580351820",360,375,735,197,211,191
"580351808",441,464,905,292,329,288
"580351709",578,598,1176,366,414,345
"580351706",308,340,648,223,248,213
"580351705",150,181,331,103,128,103
"580351615",313,286,599,192,282,190
"580351602",417,441,858,248,275,238
"580351512",360,398,758,237,265,230
"580351404",459,482,941,298,325,293
"580350705",521,486,1007,265,264,242
"580350608",504,512,1016,378,395,313
"580350506",227,299,526,252,320,249
"580350505",224,244,468,212,275,203
"580350421",274,300,574,194,212,179
"580350418",282,298,580,299,429,288
"580350415",383,416,799,310,353,295
"580350315",319,296,615,176,227,173
"580350313",450,475,925,268,309,265
"580350301",403,428,831,250,243,215
"580350209",360,382,742,219,233,218
"580350202",285,258,543,147,167,146
"580351315",479,527,1006,373,427,368
"580351314",372,361,733,270,275,236
"580351313",562,607,1169,407,441,382
"580351309",391,471,862,323,377,301
"580351308",244,254,498,205,233,187
"580351306",347,398,745,289,340,277
"580351305",197,222,419,169,187,156
"580351208",349,378,727,262,268,234
"580351206",369,403,772,257,244,225
"580351205",677,733,1410,433,449,405
"580351216",406,411,817,263,272,254
"580351124",227,227,454,111,115,111
"580351122",464,460,924,255,254,240
"580351121",408,412,820,262,298,259
"580351116",294,286,580,177,166,157
"580351102",365,378,743,258,297,255
"580351015",470,490,960,276,248,233
"580351011",401,393,794,265,306,262
"580351006",646,732,1378,434,495,423
"580350905",424,413,837,200,192,186
"580350916",475,519,994,284,305,267
"580350914",538,612,1150,321,347,318
"580350812",349,419,768,239,258,231
"580350811",490,626,1116,348,370,320
"580350810",595,669,1264,350,367,325
"580350806",603,592,1195,327,329,308
"580350805",160,173,333,119,130,119
"580350521",194,250,444,192,244,188
"580980103",737,735,1472,466,527,458
"580770106",428,412,840,237,261,217
"580352303",342,361,703,213,204,192
"581120421",609,624,1233,342,349,331
"580351611",509,482,991,271,297,269
"580350611",293,305,598,233,292,223
"580350312",206,204,410,135,115,104
"580420217",583,606,1189,292,326,281
"580770101",0,0,0,0,8,0
"581050206",21,8,29,11,13,11
"581050204",176,135,311,58,89,58
"580352004",164,145,309,101,118,96
"580910104",46,26,72,26,31,26
"580630106",17,4,21,11,17,11
"580560104",15,12,27,8,9,8
"580420103",141,113,254,75,102,75
"580350107",46,13,59,26,36,26
"581050202",21,16,37,14,33,13
"580210101",45,42,87,33,34,33
"580560201",59,40,99,32,59,19
"620490105",196,116,312,114,123,102
"620420903",495,445,940,256,290,253
"620350111",429,224,653,298,297,216
"620140901",329,282,611,180,249,178
"620070604",666,148,814,117,170,112
"620700106",234,166,400,146,194,145
"620560103",312,191,503,212,251,109
"620421405",555,525,1080,319,433,279
"620420102",96,81,177,57,78,55
"620421213",207,247,454,203,255,200
"620770102",217,237,454,158,186,154
"620630109",384,434,818,294,354,287
"620630106",479,510,989,328,384,321
"620560102",141,141,282,96,129,96
"620424203",299,354,653,256,300,244
"620424202",474,483,957,317,328,302
"620424112",354,386,740,247,275,244
"620424104",150,162,312,123,158,123
"620424103",231,257,488,201,249,199
"620424004",554,570,1124,311,334,298
"620424001",664,379,1043,225,284,222
"620423912",201,272,473,222,305,217
"620423911",311,422,733,243,333,237
"620423906",301,346,647,281,363,276
"620423807",589,272,861,152,152,144
"620423804",308,295,603,216,200,173
"620423707",575,563,1138,315,343,304
"620423701",410,373,783,216,253,213
"620423210",311,326,637,226,244,219
"620423107",637,688,1325,294,269,249
"620423609",350,394,744,241,259,231
"620423007",579,587,1166,348,375,347
"620423006",59,56,115,39,38,35
"620422907",434,389,823,278,330,269
"620422808",413,417,830,202,204,189
"620422807",427,401,828,196,197,190
"620422711",281,290,571,148,152,145
"620422708",403,459,862,310,363,308
"620422706",237,264,501,188,220,187
"620422703",204,249,453,188,210,185
"620422615",183,190,373,147,183,144
"620422614",257,319,576,198,220,194
"620422610",332,311,643,183,190,178
"620422602",418,425,843,237,237,223
"620422601",478,520,998,270,290,264
"620422509",446,452,898,282,290,278
"620422205",616,610,1226,324,364,318
"620422201",646,727,1373,407,437,379
"620422311",522,563,1085,311,335,298
"620422007",344,382,726,243,293,241
"620421904",528,503,1031,260,265,252
"620421903",440,448,888,257,269,249
"620421901",412,455,867,284,288,272
"620421508",231,236,467,119,127,116
"620421412",158,168,326,96,124,93
"620421403",528,496,1024,297,315,275
"620421207",420,460,880,328,399,327
"620421202",564,595,1159,301,302,291
"620421112",416,367,783,224,142,123
"620420905",387,442,829,243,263,239
"620420808",294,342,636,258,338,255
"620420806",340,350,690,231,261,209
"620420605",383,394,777,216,216,202
"620211901",241,287,528,185,189,174
"620211802",348,341,689,248,289,246
"620211801",351,345,696,240,295,238
"620423509",395,451,846,291,335,288
"620423504",246,346,592,225,270,212
"620423503",273,361,634,286,362,274
"620211707",432,448,880,232,242,229
"620211704",361,344,705,201,238,198
"620211511",202,253,455,195,264,185
"620211417",367,329,696,216,273,214
"620211411",561,544,1105,303,330,294
"620211404",692,590,1282,334,383,332
"620422406",251,298,549,188,197,172
"620211307",313,337,650,213,277,208
"620211209",51,37,88,37,158,37
"620211104",354,357,711,194,255,190
"620210908",580,593,1173,394,443,386
"620210906",290,256,546,190,240,170
"620210805",394,437,831,264,263,236
"620210601",153,178,331,108,134,107
"620211601",452,453,905,321,361,314
"620210313",210,271,481,219,302,217
"620210306",90,128,218,116,243,109
"620210304",400,442,842,146,212,146
"620210212",337,329,666,177,234,176
"620210211",537,549,1086,316,356,310
"620420701",690,695,1385,411,470,385
"620420612",186,254,440,165,222,163
"620140202",278,288,566,200,223,198
"620071107",390,366,756,222,239,219
"620071103",589,550,1139,338,377,338
"620071102",251,296,547,185,206,184
"620071003",263,349,612,236,304,235
"620071002",208,241,449,180,243,175
"620071012",295,323,618,218,246,209
"620070814",272,274,546,188,206,185
"620070807",309,359,668,185,197,184
"620070709",209,227,436,137,155,130
"620070510",465,473,938,373,439,368
"620070609",523,560,1083,325,353,319
"620140608",424,439,863,232,264,227
"620424304",222,286,508,196,214,192
"620910307",311,337,648,223,253,214
"620910202",538,531,1069,303,416,296
"620420801",393,413,806,292,417,285
"620211910",293,331,624,192,206,184
"620840203",43,31,74,23,33,22
"620211603",552,613,1165,357,352,326
"620770604",125,123,248,93,250,88
"620770109",380,420,800,273,300,258
"620700101",384,373,757,236,279,231
"620210403",33,26,59,26,61,25
"620770502",21,11,32,14,230,14
"620210103",158,163,321,94,175,94
"620140605",397,345,742,225,256,224
"620770304",135,122,257,77,320,71
"620070507",230,289,519,235,255,210
"620280301",24,21,45,23,58,23
"620140903",27,14,41,17,23,15
"620070601",120,92,212,87,130,85
"620840208",190,81,271,144,213,142
"620210708",204,160,364,128,122,68
"620210502",179,137,316,121,172,76
"620421602",248,233,481,131,156,130
"620421502",369,329,698,219,260,217
"620421410",186,174,360,111,153,106
"620140108",397,314,711,172,249,169
"620630114",165,214,379,152,140,135
"620630113",524,582,1106,316,339,314
"620424309",510,568,1078,335,334,304
"620424207",619,650,1269,414,407,354
"620424107",204,250,454,181,205,150
"620423704",446,442,888,233,252,229
"620423612",350,387,737,230,252,223
"620423310",255,315,570,231,270,226
"620423308",177,205,382,163,189,158
"620423004",379,390,769,254,262,240
"620423011",543,495,1038,291,308,286
"620422909",559,520,1079,294,333,286
"620422905",426,413,839,244,256,230
"620422805",611,623,1234,333,351,318
"620422802",324,337,661,193,211,181
"620422715",305,297,602,165,172,154
"620422710",393,453,846,257,244,227
"620422704",197,253,450,187,210,182
"620422607",302,309,611,176,185,172
"620422504",327,341,668,216,176,160
"620422308",276,281,557,180,183,162
"620422106",352,341,693,184,217,172
"620422006",403,411,814,248,238,226
"620422001",144,117,261,69,76,65
"620421804",373,399,772,247,254,240
"620421803",548,568,1116,316,341,313
"620421802",195,231,426,138,154,136
"620421507",376,436,812,241,252,231
"620421209",278,327,605,231,269,229
"620421201",472,461,933,282,299,278
"620421011",354,353,707,234,274,228
"620421002",402,407,809,246,254,235
"620421001",577,595,1172,326,345,303
"620280407",210,235,445,140,183,140
"620420610",290,320,610,219,248,210
"620280404",493,514,1007,268,265,245
"620211501",304,361,665,147,258,147
"620211508",176,212,388,155,184,146
"620211504",129,182,311,149,221,149
"620211413",307,306,613,192,227,192
"620211204",199,207,406,128,172,121
"620211006",398,428,826,218,222,213
"620211004",329,307,636,191,204,183
"620210909",302,324,626,196,214,191
"620210901",266,318,584,212,304,206
"620423305",304,332,636,228,255,227
"620210808",396,377,773,241,287,240
"620210606",259,276,535,180,232,175
"620210604",269,314,583,232,266,192
"620210905",437,471,908,328,404,325
"620420712",201,178,379,132,193,132
"620420702",795,738,1533,446,468,436
"620420401",625,631,1256,347,372,340
"620210904",580,558,1138,379,415,375
"620210101",244,293,537,119,211,109
"620140402",428,469,897,343,399,331
"620070905",50,36,86,32,198,32
"620070817",190,221,411,154,181,153
"620070816",208,221,429,155,229,154
"620070811",447,460,907,258,286,256
"620070803",50,29,79,32,34,32
"620070802",188,225,413,139,149,135
"620070505",198,231,429,182,220,180
"620910301",312,361,673,221,262,215
"620910104",414,400,814,193,175,173
"620420609",312,375,687,250,297,244
"620910302",234,251,485,153,198,150
"620211911",416,449,865,270,309,258
"620840204",87,81,168,54,87,53
"620840107",313,307,620,175,220,174
"620770605",178,153,331,113,317,111
"620770205",440,409,849,240,272,226
"620770115",185,212,397,139,175,138
"620770114",203,230,433,153,192,148
"620770112",491,494,985,282,318,271
"620910402",85,91,176,51,95,51
"620770103",201,210,411,156,168,153
"620210303",150,182,332,194,250,193
"620141103",296,301,597,172,245,170
"620141102",468,537,1005,300,340,291
"620140407",314,354,668,217,251,209
"620070302",248,257,505,183,223,181
"620421905",149,146,295,89,119,85
"620280103",107,73,180,62,99,61
"620280102",73,34,107,31,88,31
"620210704",228,178,406,128,146,116
"620210703",165,171,336,130,121,101
"620140801",71,24,95,48,68,46
"620070606",70,63,133,51,92,51
"620422107",502,446,948,257,320,244
"620421701",513,471,984,265,378,258
"620421407",428,394,822,278,329,266
"620421109",413,392,805,237,243,221
"620421108",270,243,513,160,189,150
"620420902",600,557,1157,357,446,344
"620350109",58,29,87,38,56,38
"620210201",130,145,275,93,122,93
"620700107",239,162,401,127,194,126
"620210710",207,206,413,140,173,128
"620700203",501,526,1027,298,363,295
"620630117",351,357,708,214,235,203
"620630108",368,358,726,215,220,213
"620630103",249,340,589,220,269,220
"620490101",388,402,790,232,296,227
"620424311",502,501,1003,311,327,309
"620424302",160,175,335,123,148,123
"620424209",533,530,1063,277,295,272
"620424206",601,600,1201,336,338,308
"620424204",374,392,766,271,318,266
"620424305",422,457,879,248,267,246
"620424105",315,335,650,239,261,220
"620424102",256,301,557,236,271,209
"620423910",188,243,431,195,267,194
"620423908",220,252,472,208,252,206
"620423907",361,415,776,309,380,307
"620423903",172,208,380,169,228,168
"620423808",338,362,700,218,265,216
"620423402",712,724,1436,383,405,373
"620423401",390,423,813,228,255,227
"620423211",347,367,714,251,268,233
"620423205",304,302,606,197,183,171
"620423202",356,397,753,228,238,220
"620423103",532,552,1084,265,252,240
"620423010",425,455,880,233,240,216
"620423009",552,580,1132,328,342,312
"620423005",331,344,675,200,214,194
"620422901",408,392,800,235,284,231
"620422707",241,253,494,171,202,161
"620422705",237,264,501,207,238,207
"620422613",356,392,748,247,250,231
"620423307",188,210,398,168,184,145
"620422506",362,378,740,245,270,244
"620422503",614,697,1311,386,389,361
"620422301",434,447,881,246,261,226
"620422011",319,367,686,224,269,218
"620422008",212,239,451,170,181,154
"620421107",440,423,863,232,255,225
"620420910",336,392,728,234,268,230
"620420901",368,370,738,201,203,194
"620420810",233,283,516,249,346,242
"620420201",81,77,158,66,461,65
"620420606",326,351,677,204,201,176
"620350101",288,237,525,161,170,148
"620280402",433,463,896,320,377,317
"620211912",371,377,748,229,268,218
"620420412",426,434,860,232,252,227
"620211903",341,354,695,267,357,260
"620211902",352,359,711,234,289,228
"620211809",450,511,961,280,267,247
"620211808",263,246,509,133,87,74
"620423502",247,341,588,247,297,244
"620211706",468,461,929,239,246,230
"620211505",179,206,385,160,180,158
"620211410",638,546,1184,344,373,340
"620211308",303,305,608,207,261,206
"620211306",292,307,599,219,256,208
"620211310",267,317,584,200,237,192
"620211114",241,211,452,157,221,157
"620211113",308,323,631,224,284,223
"620211415",395,381,776,260,334,254
"620211007",302,310,612,186,213,185
"620210810",582,608,1190,336,365,330
"620210307",104,124,228,116,203,116
"620210204",445,438,883,242,280,235
"620211702",388,396,784,210,224,209
"620210109",251,254,505,170,211,167
"620210108",284,293,577,212,279,206
"620210107",293,314,607,219,286,216
"620420613",267,316,583,189,196,171
"620420603",279,279,558,168,175,159
"620420804",236,271,507,191,202,184
"620420410",371,398,769,249,284,247
"620423301",303,326,629,195,196,180
"620071110",325,342,667,197,226,194
"620071009",187,223,410,167,212,166
"620071005",256,281,537,205,249,201
"620140607",458,412,870,237,257,232
"620070710",85,94,179,57,70,57
"620070705",540,555,1095,339,366,330
"620070704",532,583,1115,330,314,293
"620070611",299,304,603,164,212,158
"620070501",306,305,611,191,200,187
"620140301",572,635,1207,363,375,342
"620421805",421,447,868,240,255,230
"620630201",470,466,936,305,335,302
"620630102",203,239,442,188,218,183
"620424111",306,315,621,224,264,220
"620910102",520,498,1018,240,244,239
"620420717",262,218,480,140,174,140
"620211604",464,490,954,254,268,253
"620840105",264,297,561,167,203,163
"620770111",639,599,1238,305,328,295
"620770110",326,353,679,243,279,225
"620770108",315,286,601,179,201,173
"620910403",57,57,114,30,54,30
"620840103",206,201,407,122,154,121
"620700202",299,285,584,191,253,189
"620211111",428,455,883,258,285,256
"620770411",163,145,308,118,368,115
"620770410",106,122,228,84,305,84
"620770407",59,58,117,38,424,38
"620140110",474,452,926,305,333,294
"620140104",601,581,1182,331,359,325
"620070812",265,270,535,167,182,166
"620070511",251,290,541,241,299,237
"620421408",370,341,711,233,296,228
"620420502",249,215,464,146,186,139
"620420104",46,23,69,31,43,31
"620210503",72,38,110,16,35,15
"620140501",36,7,43,24,57,24
"620420301",24,12,36,19,32,19
"620840209",92,36,128,68,131,62
"620420103",215,233,448,131,162,124
"620840206",47,22,69,34,51,34
"620210402",139,86,225,75,101,70
"620070605",8,3,11,6,29,6
"620422105",406,380,786,215,387,211
"620421902",371,336,707,193,245,176
"620421702",398,311,709,207,226,191
"620421103",293,281,574,179,209,162
"620420708",291,284,575,184,220,175
"620420501",234,215,449,139,175,136
"620210702",183,166,349,121,164,120
"620140109",100,81,181,58,109,57
"620630205",385,318,703,193,308,189
"620770501",37,7,44,34,51,31
"620840201",18,14,32,9,21,9
"620070707",682,761,1443,403,427,394
"620630101",311,373,684,204,239,202
"620424307",441,526,967,291,302,279
"620424108",310,363,673,268,317,264
"620424106",232,295,527,210,233,205
"620424013",192,211,403,129,180,128
"620424012",281,300,581,197,229,195
"620424011",426,435,861,250,271,245
"620424005",295,313,608,183,215,178
"620423814",594,645,1239,316,283,264
"620423806",281,296,577,220,274,208
"620423711",303,347,650,192,429,192
"620423606",237,310,547,190,223,188
"620423403",401,417,818,216,225,213
"620423208",311,311,622,199,234,196
"620423108",425,450,875,244,258,240
"620423001",339,376,715,279,317,277
"620422910",524,490,1014,302,306,274
"620422906",420,474,894,272,323,265
"620422904",494,453,947,312,355,296
"620422902",253,257,510,171,206,166
"620422701",346,349,695,214,244,209
"620422408",415,458,873,344,414,341
"620423306",206,244,450,192,236,188
"620422302",381,383,764,208,229,202
"620422402",318,336,654,218,240,208
"620422010",168,202,370,134,137,121
"620422009",160,205,365,151,189,150
"620422004",184,249,433,191,233,187
"620421210",221,273,494,202,260,201
"620421206",226,230,456,166,190,161
"620421010",449,492,941,273,279,247
"620420909",355,356,711,210,219,204
"620420809",159,238,397,196,236,192
"620420805",220,237,457,164,199,160
"620350105",83,87,170,48,94,48
"620211909",247,254,501,175,204,171
"620211905",304,286,590,197,278,192
"620211807",313,325,638,188,225,188
"620211806",267,267,534,206,219,203
"620423602",286,304,590,234,274,234
"620423507",453,482,935,283,321,277
"620423501",241,282,523,227,278,218
"620211710",416,438,854,249,273,245
"620211705",539,549,1088,291,253,231
"620211510",248,269,517,152,214,148
"620211507",175,194,369,163,203,160
"620211506",343,422,765,281,319,269
"620211409",629,655,1284,379,393,370
"620211406",342,325,667,206,251,203
"620211305",316,332,648,129,180,128
"620211303",298,355,653,222,295,215
"620211208",574,570,1144,316,379,312
"620211205",195,184,379,142,193,142
"620210907",290,327,617,226,270,220
"620210803",347,351,698,258,275,234
"620210709",504,483,987,301,379,289
"620210903",551,581,1132,336,305,266
"620210312",182,215,397,161,208,160
"620210310",306,321,627,159,232,152
"620210209",316,333,649,181,204,176
"620210207",322,378,700,201,211,193
"620140203",341,391,732,240,263,228
"620420715",392,392,784,215,221,193
"620420604",325,349,674,212,223,198
"620420405",488,512,1000,301,343,292
"620140902",187,193,380,121,144,118
"620140409",250,273,523,208,213,188
"620140408",656,634,1290,355,383,342
"620140105",523,503,1026,286,317,273
"620140112",329,320,649,180,187,174
"620071111",587,595,1182,315,343,305
"620071106",334,336,670,188,211,188
"620071101",548,624,1172,331,367,323
"620071013",335,337,672,220,269,217
"620070904",66,53,119,57,335,57
"620070713",448,471,919,249,260,224
"620070712",377,426,803,225,260,221
"620070711",1015,1109,2124,658,472,428
"620070509",194,235,429,166,212,164
"620070502",228,242,470,157,188,155
"620422404",515,572,1087,330,360,316
"620490106",360,320,680,217,282,212
"620423611",372,406,778,231,252,226
"620910203",325,331,656,185,231,185
"620421505",305,320,625,195,200,184
"620420608",241,262,503,184,213,182
"620840104",425,481,906,248,297,241
"620770607",127,104,231,87,280,84
"620211207",307,285,592,204,294,198
"620840101",251,254,505,168,185,156
"620770405",527,526,1053,291,320,279
"620140406",330,369,699,244,260,227
"620070902",117,107,224,78,361,78
"620211302",348,388,736,276,310,266
"620422108",190,211,401,123,149,115
"620421406",223,161,384,114,137,109
"620420101",38,33,71,26,46,24
"620141101",272,224,496,160,215,152
"620421503",442,367,809,236,268,233
"620421409",321,241,562,174,214,173
"620421305",511,435,946,312,375,303
"620421104",406,331,737,231,277,208
"620421102",397,363,760,234,260,222
"620210104",341,318,659,201,318,192
"620070603",363,286,649,204,251,198
"620070101",24,14,38,17,79,17
"620560104",293,137,430,181,176,104
"620423203",348,361,709,203,203,194
"620070614",232,223,455,133,200,127
"620700103",329,365,694,182,219,172
"620700204",256,257,513,181,228,176
"620630110",198,232,430,171,206,170
"620630107",138,116,254,79,86,79
"620560101",259,262,521,148,191,146
"620424310",419,419,838,231,252,224
"620424308",503,516,1019,265,252,244
"620424301",501,498,999,218,252,215
"620424210",322,359,681,244,275,242
"620424208",505,539,1044,316,349,310
"620424101",250,341,591,236,284,232
"620424014",529,572,1101,338,367,325
"620424002",356,323,679,229,310,222
"620423909",195,219,414,189,232,183
"620423902",166,196,362,159,196,157
"620423710",535,580,1115,329,346,322
"620423709",628,668,1296,316,334,306
"620423703",456,500,956,263,308,258
"620423702",339,334,673,193,215,193
"620423605",248,279,527,204,241,193
"620423309",231,288,519,230,264,216
"620423109",546,516,1062,297,260,243
"620423102",766,723,1489,369,355,339
"620422806",623,624,1247,352,400,339
"620422714",364,384,748,237,228,202
"620422709",409,427,836,213,229,211
"620422612",368,372,740,230,259,228
"620422611",243,251,494,155,210,155
"620422608",265,290,555,173,172,148
"620422505",573,593,1166,374,407,365
"620422502",508,487,995,301,323,287
"620422501",533,539,1072,320,355,312
"620422310",280,266,546,170,195,165
"620422303",308,304,612,191,208,175
"620422012",290,305,595,226,255,223
"620422003",174,227,401,151,190,146
"620421601",447,469,916,246,289,241
"620421411",395,393,788,211,223,207
"620421302",594,569,1163,331,371,324
"620421301",436,425,861,233,241,225
"620421004",252,267,519,174,175,158
"620420807",324,381,705,263,332,257
"620280401",498,526,1024,342,377,326
"620422407",227,260,487,185,200,181
"620280405",304,312,616,181,198,176
"620211908",536,536,1072,294,343,290
"620211907",153,149,302,117,174,116
"620211904",374,405,779,244,281,242
"620423508",294,321,615,201,241,198
"620423408",258,263,521,160,227,160
"620423406",253,299,552,166,197,165
"620211509",152,191,343,145,211,144
"620211206",323,308,631,217,264,213
"620211203",223,219,442,164,208,162
"620211112",505,492,997,311,365,308
"620211110",297,289,586,193,232,180
"620211108",224,255,479,174,227,173
"620211003",413,385,798,254,293,248
"620210806",334,342,676,218,240,216
"620210105",172,151,323,101,161,99
"620210208",464,500,964,267,273,253
"620210206",605,587,1192,319,360,310
"620420713",578,598,1176,355,432,351
"620420506",443,489,932,230,241,214
"620420504",348,373,721,191,184,173
"620423304",388,475,863,295,312,276
"620140604",343,348,691,212,220,195
"620140603",310,378,688,214,254,212
"620140403",351,368,719,264,290,249
"620140111",781,625,1406,323,379,321
"620071105",239,197,436,126,139,122
"620071006",214,269,483,212,263,210
"620070901",41,29,70,25,192,25
"620070808",352,363,715,207,211,189
"620070805",563,580,1143,322,348,320
"620070804",473,506,979,279,300,275
"620070801",233,226,459,174,206,170
"620071010",179,216,395,171,198,171
"620070703",309,293,602,198,213,196
"620424109",221,234,455,183,224,178
"620910201",366,403,769,206,268,202
"620421506",321,332,653,185,203,182
"620421003",353,384,737,222,210,195
"620420402",426,388,814,261,302,254
"620350110",383,343,726,191,211,182
"620770606",83,64,147,55,325,52
"620770204",165,181,346,113,141,112
"620770305",229,197,426,153,357,137
"620770107",418,414,832,253,298,247
"620770106",303,306,609,198,235,195
"620770503",47,27,74,35,267,33
"620211101",380,288,668,163,182,161
"620210608",460,485,945,303,322,278
"620770412",166,148,314,113,257,107
"620770406",572,569,1141,320,362,313
"620071104",541,533,1074,266,275,256
"620770302",87,72,159,67,237,59
"620070607",288,242,530,145,163,141
"620770210",437,472,909,275,308,267
"620770209",334,314,648,197,237,193
"620770207",231,170,401,128,258,122
"620630301",37,17,54,18,47,18
"620350106",137,73,210,88,142,87
"620211418",72,64,136,47,101,47
"620210401",89,50,139,40,56,23
"620141001",114,76,190,70,98,70
"620630203",99,77,176,68,99,68
"620350108",39,3,42,26,44,26
"620420709",356,288,644,193,257,190
"620420503",86,77,163,45,65,45
"620210501",463,292,755,203,210,114
"620140102",551,292,843,227,283,219
"620070401",43,4,47,33,122,33
"620630401",103,21,124,56,145,45
"620630202",160,125,285,108,169,108
"620490107",129,73,202,80,134,79
"620421401",412,374,786,224,164,156
"620700205",320,336,656,213,268,210
"620700102",369,434,803,232,297,219
"620630115",339,345,684,191,219,188
"620630112",355,341,696,228,249,223
"620630104",347,373,720,242,309,238
"620424113",267,252,519,190,217,189
"620424006",307,325,632,182,211,178
"620423904",228,287,515,211,269,205
"620423901",254,341,595,268,377,266
"620423805",361,416,777,246,280,242
"620423803",399,398,797,231,196,189
"620423207",304,321,625,205,217,197
"620423204",534,622,1156,384,432,380
"620423201",323,382,705,262,301,262
"620423105",637,712,1349,345,363,338
"620423104",603,644,1247,307,307,292
"620423002",524,550,1074,392,421,381
"620422713",435,461,896,330,373,304
"620422702",346,405,751,263,273,247
"620422609",442,443,885,278,287,270
"620422605",333,325,658,186,183,166
"620422604",303,319,622,172,185,171
"620422103",563,606,1169,295,344,289
"620422101",465,437,902,268,279,258
"620422002",299,344,643,237,255,219
"620421801",343,399,742,245,260,236
"620421501",598,627,1225,380,396,369
"620421402",41,25,66,23,81,18
"620421303",427,463,890,281,299,277
"620421204",359,375,734,235,262,229
"620421212",210,251,461,194,205,183
"620421007",355,357,712,202,217,197
"620421005",390,371,761,256,221,203
"620420908",402,395,797,213,250,209
"620420906",509,514,1023,325,353,321
"620350112",228,209,437,165,309,165
"620420611",232,280,512,212,247,209
"620211906",240,233,473,150,184,149
"620211805",289,302,591,240,241,179
"620211804",246,256,502,179,205,179
"620423601",398,394,792,271,285,256
"620423410",555,564,1119,348,370,332
"620423409",356,342,698,188,235,184
"620211502",248,363,611,133,213,133
"620211416",469,488,957,292,366,287
"620211412",318,388,706,253,282,242
"620211311",307,359,666,247,299,242
"620211202",274,266,540,186,208,184
"620211607",574,546,1120,337,369,314
"620211009",379,373,752,189,192,181
"620210804",229,217,446,156,191,156
"620210809",539,581,1120,344,389,340
"620210807",363,363,726,243,248,213
"620210603",163,200,363,148,212,147
"620210602",243,267,510,184,258,183
"620211602",387,393,780,267,284,262
"620210309",300,294,594,243,338,238
"620210202",246,214,460,148,356,145
"620423303",522,589,1111,373,398,357
"620423302",323,339,662,201,213,198
"620140204",449,475,924,298,327,285
"620420802",395,419,814,288,330,276
"620420711",342,342,684,189,252,186
"620420710",385,382,767,206,226,201
"620420614",284,315,599,198,193,171
"620420404",403,388,791,222,262,220
"620423212",245,280,525,194,200,179
"620140405",312,348,660,211,236,208
"620140106",43,28,71,26,44,26
"620071004",192,240,432,183,217,182
"620071001",193,248,441,177,262,177
"620140606",266,284,550,173,202,168
"620070815",226,246,472,162,199,158
"620070613",184,185,369,110,421,110
"620070504",195,207,402,163,186,162
"620070503",432,423,855,275,347,272
"620070708",682,773,1455,440,488,432
"620421214",119,158,277,128,170,128
"620910308",467,469,936,282,331,279
"620422305",659,673,1332,388,426,377
"620910103",723,714,1437,385,397,381
"620420411",332,340,672,182,215,171
"620840205",19,11,30,14,41,14
"620770202",246,258,504,165,198,163
"620770113",284,283,567,170,196,167
"620770413",318,352,670,154,154,139
"620770105",162,183,345,127,169,118
"620770104",325,336,661,241,285,218
"620211001",447,437,884,293,325,292
"620770601",79,70,149,60,301,59
"620210705",453,421,874,276,335,264
"620140201",428,428,856,261,266,218
"620070702",343,374,717,240,267,236
"620770211",332,411,743,255,293,250
"620770206",239,274,513,165,194,163
"620630302",73,28,101,67,164,66
"620422109",212,159,371,113,131,108
"620420409",191,138,329,124,160,121
"620420406",370,301,671,216,219,207
"620140701",283,39,322,44,66,39
"620140107",0,0,0,0,46,0
"620070301",31,12,43,23,50,23
"620910407",147,67,214,102,104,83
"620420407",143,113,256,81,121,79
"620840207",55,28,83,39,75,39
"620280101",13,2,15,9,33,9
"620770408",17,8,25,12,14,12
"620770402",207,145,352,132,259,113
"620422206",413,394,807,241,289,229
"620421306",617,615,1232,369,413,357
"620421101",377,332,709,211,274,201
"620420707",401,329,730,237,314,212
"620420704",370,355,725,212,232,201
"620141002",268,255,523,163,202,154
"620140303",447,389,836,236,312,231
"620140302",269,231,500,156,216,156
"620700104",335,267,602,217,307,206
"620910406",170,114,284,116,148,114
"620910405",293,105,398,187,259,151
"620420706",226,190,416,117,139,115
"620350103",116,136,252,82,137,81
"620630118",268,254,522,145,161,144
"620630116",176,193,369,150,199,147
"620630105",340,397,737,224,240,213
"620424312",626,626,1252,312,295,282
"620424306",593,663,1256,352,378,346
"620424201",453,441,894,284,304,279
"620424010",238,219,457,146,166,142
"620424009",582,584,1166,318,346,302
"620424008",243,289,532,169,189,165
"620424007",399,437,836,221,229,212
"620424003",592,662,1254,355,367,347
"620423905",382,402,784,272,288,267
"620423812",273,295,568,179,184,164
"620423811",534,562,1096,315,327,302
"620423810",321,389,710,211,227,205
"620423809",327,336,663,203,223,202
"620423802",480,509,989,323,341,308
"620423801",428,496,924,286,292,273
"620423708",181,173,354,108,152,108
"620423706",615,638,1253,331,357,328
"620423705",535,541,1076,291,291,273
"620423404",334,332,666,177,215,174
"620423209",351,355,706,239,256,229
"620423106",514,544,1058,269,277,262
"620423101",667,655,1322,356,336,319
"620423003",321,352,673,247,281,227
"620423012",180,190,370,107,115,105
"620422908",550,533,1083,309,332,295
"620422804",567,620,1187,320,341,313
"620422803",639,681,1320,367,402,363
"620422801",535,553,1088,315,333,309
"620422712",369,351,720,196,202,190
"620422606",364,392,756,212,239,206
"620422603",628,602,1230,312,302,289
"620422507",439,462,901,290,328,289
"620422307",313,297,610,204,227,192
"620422403",345,406,751,222,231,206
"620422104",273,292,565,143,177,139
"620422005",144,192,336,150,191,148
"620421603",336,352,688,201,217,199
"620421806",324,359,683,203,231,201
"620421304",564,533,1097,321,345,311
"620421208",324,388,712,255,299,250
"620421203",515,507,1022,348,357,307
"620421013",218,260,478,188,235,186
"620421012",245,285,530,198,231,191
"620421008",397,377,774,241,254,225
"620421006",385,414,799,252,259,236
"620420904",288,346,634,201,236,197
"620421211",176,227,403,169,220,165
"620350104",135,176,311,85,108,83
"620350102",244,254,498,181,291,177
"620280406",446,483,929,304,340,294
"620420607",447,457,904,282,306,278
"620423506",265,308,573,255,397,253
"620423505",251,318,569,244,330,241
"620423405",488,492,980,295,334,290
"620211708",545,548,1093,314,339,310
"620211703",276,318,594,148,161,146
"620211408",527,518,1045,249,274,244
"620211407",339,294,633,202,254,198
"620211304",284,286,570,153,179,152
"620211201",300,330,630,196,225,196
"620211105",326,324,650,222,239,218
"620211606",524,530,1054,286,269,252
"620211010",354,351,705,184,177,173
"620211008",381,340,721,209,225,208
"620211005",582,620,1202,340,383,332
"620210802",214,235,449,188,217,161
"620210801",237,291,528,204,237,187
"620210902",356,430,786,318,403,312
"620210607",320,368,688,255,313,231
"620210605",184,196,380,136,171,130
"620211605",352,374,726,175,179,171
"620210308",139,157,296,142,259,142
"620210203",536,547,1083,311,448,304
"620210302",97,133,230,149,315,148
"620210106",315,322,637,223,264,191
"620210205",492,480,972,246,280,244
"620420602",569,591,1160,327,372,316
"620420601",480,522,1002,262,277,249
"620211701",384,394,778,246,267,240
"620210102",564,576,1140,331,428,283
"620211414",372,361,733,224,257,224
"620211102",309,298,607,215,273,210
"620140602",395,413,808,252,270,248
"620140601",402,389,791,237,264,233
"620140103",516,528,1044,319,342,314
"620071109",451,484,935,232,248,229
"620071108",403,427,830,194,221,192
"620071008",191,245,436,185,210,164
"620071007",300,321,621,263,389,259
"620070906",100,90,190,58,401,58
"620071011",182,213,395,158,184,156
"620070813",310,332,642,223,270,222
"620070810",428,461,889,309,331,298
"620070809",239,216,455,176,205,176
"620070806",655,670,1325,347,374,336
"620070506",212,284,496,214,271,214
"620070303",177,174,351,116,152,116
"620211608",586,612,1198,331,326,293
"620211403",657,598,1255,347,399,339
"620910306",301,308,609,203,230,198
"620910305",608,635,1243,354,424,347
"620910304",428,438,866,261,327,252
"620910303",386,415,801,266,347,266
"620910101",745,792,1537,395,424,390
"620421106",441,393,834,228,253,224
"620280403",256,311,567,199,227,195
"620770201",489,514,1003,336,385,321
"620770117",366,342,708,197,189,173
"620700201",339,350,689,246,308,231
"620211107",253,273,526,191,228,186
"620770504",53,35,88,36,291,33
"620770409",319,255,574,167,256,164
"620770404",670,623,1293,313,352,305
"620770403",556,564,1120,334,399,326
"620770401",203,178,381,120,198,117
"620770303",83,77,160,68,301,60
"620420703",272,227,499,158,187,156
"620280201",53,17,70,25,50,25
"620280105",217,182,399,126,177,124
"620070602",429,317,746,253,372,241
"620490104",180,121,301,126,213,112
"620422204",146,105,251,80,109,79
"620422203",509,460,969,254,271,235
"620422102",254,236,490,154,173,146
"620421604",381,317,698,199,215,196
"620420705",728,617,1345,383,454,377
"620420202",324,241,565,177,203,167
"620420408",302,201,503,168,214,165
"620280104",425,344,769,224,286,213
"620211401",309,321,630,203,236,202
"620210701",371,325,696,233,340,232
"620070201",47,17,64,38,115,37
"620700105",164,138,302,91,61,42
"620630204",195,189,384,127,217,127
"620210112",204,186,390,121,208,104
"620910404",561,309,870,283,275,273
"620211512",243,258,501,207,266,204
"620770101",328,306,634,211,248,206
"620630111",226,265,491,184,223,184
"620490103",111,106,217,76,83,34
"620490102",498,475,973,278,286,213
"620424303",292,289,581,192,226,188
"620424205",292,297,589,170,165,140
"620424114",241,255,496,179,222,177
"620423813",332,369,701,188,166,149
"620423610",257,290,547,158,166,154
"620423608",410,433,843,243,261,230
"620423607",388,397,785,267,312,265
"620423311",408,458,866,331,407,315
"620423206",323,315,638,205,222,204
"620423008",592,618,1210,350,376,340
"620422903",553,558,1111,312,334,301
"620422510",533,557,1090,332,339,324
"620422508",584,601,1185,412,430,392
"620422309",298,317,615,212,210,193
"620422306",363,382,745,217,216,197
"620422304",357,380,737,220,228,202
"620422401",393,456,849,220,222,209
"620422202",114,125,239,67,71,66
"620422013",397,454,851,244,250,232
"620421807",598,615,1213,301,360,294
"620421404",282,282,564,169,179,157
"620421205",187,217,404,153,191,149
"620421111",265,300,565,166,166,129
"620421110",559,559,1118,299,328,295
"620421105",494,422,916,235,249,224
"620421009",453,489,942,292,318,286
"620420907",542,530,1072,277,300,275
"620420803",331,305,636,212,204,191
"620350114",332,312,644,206,326,204
"620350113",323,253,576,230,374,225
"620211803",329,319,648,218,237,215
"620423604",357,401,758,245,263,230
"620423603",349,388,737,276,330,269
"620423407",253,258,511,159,196,155
"620211709",414,391,805,211,223,206
"620211503",289,369,658,280,361,280
"620211405",685,727,1412,363,383,353
"620211309",170,187,357,124,149,118
"620211402",628,628,1256,347,386,335
"620422405",515,498,1013,315,323,306
"620211109",297,296,593,188,182,145
"620211106",340,375,715,257,307,234
"620211103",400,409,809,279,333,271
"620211011",319,328,647,166,161,151
"620211002",466,482,948,307,339,299
"620210707",687,632,1319,412,482,409
"620210706",533,509,1042,306,346,292
"620210311",176,205,381,171,251,160
"620210111",407,366,773,230,285,216
"620210110",385,337,722,241,295,239
"620210301",438,562,1000,134,248,132
"620210210",418,441,859,240,213,195
"620420716",365,358,723,210,221,204
"620420714",713,685,1398,356,389,349
"620420615",430,498,928,270,275,260
"620420505",300,308,608,185,213,180
"620140609",419,412,831,224,226,210
"620140404",423,481,904,291,321,281
"620071112",654,622,1276,306,328,290
"620070903",22,35,57,30,108,30
"620070818",254,243,497,154,187,153
"620070706",352,329,681,210,174,162
"620070608",657,695,1352,368,386,357
"620070701",267,275,542,194,215,186
"620070612",494,582,1076,308,332,306
"620211609",390,432,822,246,266,245
"620424110",176,223,399,155,182,154
"620420403",323,284,607,172,184,167
"620840202",82,73,155,43,46,43
"620840106",217,236,453,134,179,130
"620770603",107,95,202,79,249,63
"620770602",53,42,95,29,283,29
"620770203",299,304,603,183,222,182
"620770116",271,263,534,181,217,178
"620910401",69,57,126,34,46,22
"620840102",197,218,415,153,195,152
"620211301",224,242,466,185,247,185
"620210305",257,310,567,133,254,131
"620141003",340,347,687,177,225,173
"620770307",236,224,460,156,302,146
"620770306",70,65,135,59,282,58
"620140410",418,494,912,270,289,262
"620140401",631,641,1272,368,458,359
"620140304",603,573,1176,300,333,290
"620070610",407,413,820,210,269,203
"620070508",212,269,481,191,231,188
"620770301",88,91,179,69,301,68
"620770208",468,416,884,227,242,213
"620421504",389,314,703,213,259,209
"620350107",92,57,149,70,127,69
"620140101",90,29,119,15,31,10
"661470307",1148,1108,2256,564,733,539
"661330216",534,496,1030,243,323,233
"661330101",1649,1619,3268,662,627,602
"661260205",459,371,830,246,279,234
"661120201",250,197,447,114,146,103
"661610105",286,299,585,142,210,140
"661330210",188,160,348,98,110,95
"661050202",255,219,474,100,178,100
"660980205",218,199,417,113,165,112
"660980101",356,400,756,178,294,161
"660560603",362,297,659,156,172,154
"660560402",419,430,849,222,195,146
"660420105",299,290,589,138,179,134
"660350202",474,372,846,222,241,168
"660070419",579,610,1189,298,259,234
"661470502",558,519,1077,226,235,221
"661470407",1188,1196,2384,455,436,399
"661470514",625,624,1249,294,290,249
"661400414",636,652,1288,343,312,275
"661400413",372,396,768,243,239,211
"661470314",268,289,557,144,224,123
"661260812",1030,995,2025,379,381,356
"661260803",214,254,468,154,199,151
"661260708",772,744,1516,337,333,297
"661260616",669,654,1323,281,282,261
"661260615",646,590,1236,304,309,272
"661260416",696,750,1446,357,350,307
"661260415",567,615,1182,317,279,248
"661260215",645,694,1339,329,369,323
"661260210",679,680,1359,291,296,279
"661260707",656,681,1337,317,315,296
"661260706",558,582,1140,290,284,254
"661260624",569,531,1100,276,285,255
"661260621",406,378,784,200,223,196
"661120403",271,321,592,172,175,153
"661120311",485,534,1019,214,216,198
"660630110",422,457,879,226,268,205
"660560925",649,641,1290,302,332,294
"660560919",562,547,1109,266,309,261
"660560918",559,637,1196,253,264,245
"660560627",461,454,915,218,241,207
"660560626",712,727,1439,285,281,266
"660560625",287,359,646,156,152,129
"660490305",735,798,1533,372,336,319
"660490107",670,653,1323,329,358,315
"660420209",476,532,1008,250,206,182
"660420207",650,702,1352,336,295,254
"660350122",603,651,1254,322,355,319
"660490405",569,604,1173,320,347,304
"660282814",468,506,974,252,231,216
"660282801",357,424,781,209,229,193
"660282614",1022,1126,2148,460,465,447
"660282613",933,998,1931,435,447,408
"660282512",441,507,948,276,306,272
"660282504",510,508,1018,279,346,274
"660282404",806,880,1686,369,347,338
"660560614",684,728,1412,350,323,297
"660560216",497,484,981,210,244,208
"660560105",638,686,1324,292,332,275
"660560616",1006,955,1961,409,398,369
"660490422",358,385,743,209,201,183
"660490415",518,519,1037,240,213,203
"660282120",673,716,1389,341,323,270
"660282115",724,806,1530,368,370,350
"660282111",422,457,879,232,250,222
"660282019",446,482,928,263,265,244
"660282007",776,794,1570,398,360,317
"660282004",513,563,1076,295,278,253
"660281607",491,601,1092,306,312,273
"660281605",703,803,1506,411,362,318
"660282318",735,769,1504,324,334,313
"660282311",866,913,1779,383,380,364
"660282303",1023,1026,2049,431,380,357
"660282212",726,784,1510,386,398,379
"660281601",757,818,1575,402,350,332
"660281515",738,790,1528,427,366,328
"660281504",758,806,1564,389,335,313
"660281409",630,744,1374,387,307,277
"660281307",521,625,1146,386,458,354
"660281215",538,557,1095,262,233,221
"660281210",421,445,866,253,264,249
"660281907",610,663,1273,326,310,289
"660281902",650,687,1337,317,294,269
"660281814",679,703,1382,342,275,259
"660281813",630,639,1269,298,249,230
"660281811",636,706,1342,386,337,313
"660281807",436,479,915,249,214,180
"660281803",390,510,900,262,235,208
"660281716",671,682,1353,330,285,266
"660281712",754,800,1554,388,270,259
"660281708",667,733,1400,361,343,304
"660281619",1017,1037,2054,472,412,384
"660281617",906,922,1828,437,421,395
"660280609",323,408,731,197,210,186
"660280519",276,325,601,182,207,174
"660280514",372,454,826,232,234,215
"660280501",807,878,1685,394,384,356
"660280420",471,535,1006,209,196,189
"660280419",631,680,1311,294,252,244
"660280414",318,406,724,270,263,223
"660280409",491,619,1110,332,282,262
"660280405",989,950,1939,424,396,369
"660281113",237,332,569,189,443,189
"660281110",218,316,534,221,362,203
"660281005",408,516,924,327,387,286
"660281003",532,636,1168,358,272,253
"660281002",499,594,1093,330,371,292
"660280910",312,377,689,198,194,170
"660280811",425,460,885,235,209,194
"660280711",895,1048,1943,470,390,362
"660281205",197,270,467,154,228,154
"660281406",630,702,1332,419,358,296
"661610205",489,513,1002,262,311,255
"660280112",728,752,1480,401,441,288
"661400115",90,71,161,49,76,46
"660840108",420,423,843,196,214,186
"660280618",308,356,664,195,206,181
"660560811",217,250,467,152,151,137
"660560611",418,387,805,175,208,170
"660560209",264,241,505,101,111,100
"660070413",89,87,176,39,50,39
"660490304",465,430,895,213,251,202
"660350208",388,355,743,163,136,102
"660280903",500,513,1013,254,288,223
"660280108",324,334,658,160,200,146
"660210112",597,596,1193,291,259,217
"660281524",842,872,1714,444,379,344
"660070426",626,567,1193,226,205,182
"660070424",945,918,1863,397,408,372
"661540203",96,107,203,49,61,48
"661540202",37,25,62,22,35,19
"661540103",41,49,90,27,41,26
"661470405",119,85,204,62,98,56
"661470303",18,9,27,12,24,12
"661470301",62,45,107,21,71,21
"661260503",13,9,22,5,5,5
"661260204",59,41,100,35,84,35
"661260101",78,74,152,35,60,35
"660560502",76,27,103,39,28,28
"660560501",65,1,66,18,18,18
"660560202",268,180,448,119,150,118
"660490201",235,181,416,94,207,94
"660490101",52,25,77,24,59,23
"660420101",153,116,269,98,166,96
"661470102",70,89,159,34,46,34
"661330305",392,389,781,168,162,157
"661330303",73,64,137,34,34,34
"661330302",245,179,424,111,132,111
"661330211",154,127,281,70,75,67
"661330209",123,95,218,56,94,56
"660350106",752,645,1397,359,458,342
"660350103",612,384,996,223,286,203
"661610203",161,127,288,75,164,73
"661050103",4,2,6,3,3,3
"660910104",61,70,131,38,59,38
"660770303",157,152,309,105,162,67
"660770201",33,22,55,20,19,12
"660770103",108,87,195,69,99,64
"660700502",8,14,22,5,12,5
"660700105",106,105,211,46,103,45
"660280204",24,19,43,13,24,12
"660070308",53,43,96,20,26,20
"660070306",11,2,13,11,15,11
"661610103",552,603,1155,243,300,238
"660210202",34,15,49,16,25,16
"661120207",81,8,89,30,35,30
"660210102",71,60,131,31,59,28
"660140205",15,13,28,10,15,10
"660630109",30,36,66,23,38,23
"660070503",82,55,137,35,36,35
"660070501",116,59,175,52,53,52
"660350107",79,72,151,33,53,33
"661400113",176,183,359,74,107,68
"660280104",785,723,1508,359,324,295
"660560609",105,87,192,44,40,36
"660560205",264,236,500,118,123,116
"660560103",483,432,915,214,243,208
"660560102",720,668,1388,311,299,227
"660420107",144,116,260,71,105,58
"660420103",521,534,1055,252,323,246
"661470504",642,665,1307,317,309,290
"661400411",540,562,1102,287,281,246
"661400405",552,598,1150,274,270,241
"661260805",346,340,686,200,203,177
"661260722",414,424,838,218,236,211
"661260719",309,337,646,166,179,159
"661260614",785,765,1550,317,324,306
"661260609",1060,945,2005,355,297,280
"661260504",580,563,1143,276,332,257
"661260218",556,561,1117,224,228,205
"661260105",803,627,1430,262,252,222
"661120308",263,325,588,179,213,172
"661260703",744,698,1442,258,238,232
"661120215",531,586,1117,282,303,267
"660770205",644,602,1246,291,347,272
"661470510",751,775,1526,335,294,265
"660561014",292,298,590,159,184,158
"660561013",584,634,1218,289,320,267
"660561012",447,452,899,227,197,186
"660561009",328,341,669,190,200,175
"660560916",645,698,1343,327,326,296
"660560915",737,779,1516,416,426,382
"660560904",434,496,930,269,270,231
"660560808",287,275,562,182,217,165
"660560701",1147,1197,2344,508,534,495
"660560630",294,237,531,124,133,124
"660560624",1419,1322,2741,515,510,459
"660560622",514,524,1038,311,384,299
"660490412",597,565,1162,262,260,235
"660490215",526,539,1065,221,197,188
"660490411",502,547,1049,268,232,220
"660490414",374,420,794,208,209,184
"660420109",561,606,1167,277,262,232
"661120411",515,582,1097,299,335,291
"661050213",555,602,1157,238,263,191
"660350116",702,706,1408,313,305,270
"660350114",625,638,1263,282,279,250
"660350109",973,999,1972,459,390,349
"660282811",710,756,1466,343,355,321
"660282806",842,887,1729,420,431,398
"660282802",336,428,764,198,199,188
"660282714",668,686,1354,316,265,252
"660282620",707,749,1456,334,309,305
"660282410",995,1008,2003,445,444,410
"660560408",424,420,844,228,273,225
"660560218",602,632,1234,319,330,303
"660560212",416,449,865,223,250,222
"660560409",314,329,643,160,186,158
"660560118",583,600,1183,272,334,262
"660560116",315,292,607,122,148,114
"660560110",410,450,860,254,238,204
"660490402",523,530,1053,246,248,228
"660490401",537,582,1119,318,344,310
"660490309",436,426,862,210,235,197
"660282309",887,1007,1894,389,368,359
"660282211",476,542,1018,275,307,268
"660282605",510,559,1069,266,271,233
"660282604",490,498,988,241,280,226
"660282009",740,746,1486,355,291,276
"660282003",392,440,832,246,281,242
"660281915",615,673,1288,298,285,264
"660282316",684,713,1397,302,298,292
"660282312",751,756,1507,291,288,276
"660282302",592,606,1198,267,250,242
"660282214",750,874,1624,396,410,381
"660281525",703,734,1437,354,295,271
"660281518",633,684,1317,326,281,264
"660281517",349,442,791,224,227,213
"660281516",444,522,966,295,307,279
"660281414",416,475,891,248,221,199
"660281305",580,623,1203,392,399,327
"660281405",432,519,951,283,319,237
"660281401",474,588,1062,321,352,277
"660280617",317,412,729,220,245,218
"660281905",783,794,1577,371,369,354
"660281805",487,495,982,265,235,212
"660281703",431,418,849,262,224,203
"660281613",560,544,1104,244,218,200
"660281610",714,766,1480,354,285,263
"661260712",373,378,751,213,223,182
"660280601",604,654,1258,331,355,298
"660280502",350,416,766,202,219,197
"660280415",559,574,1133,302,220,208
"660281114",290,402,692,233,338,219
"660281108",202,306,508,181,342,179
"660281012",366,455,821,242,232,208
"660280908",548,630,1178,313,307,272
"660280907",485,502,987,266,309,256
"660280901",680,753,1433,388,462,374
"660280802",381,433,814,227,196,182
"660280801",162,22,184,0,0,0
"660280713",608,679,1287,312,289,254
"660280207",760,804,1564,399,415,377
"660280410",461,501,962,272,253,236
"660280118",744,784,1528,376,398,331
"661540208",232,205,437,104,152,100
"660140207",308,327,635,186,215,158
"660070620",382,413,795,199,226,194
"660560307",666,615,1281,248,223,218
"660420208",790,782,1572,371,336,315
"660281115",188,270,458,129,254,127
"661330219",270,259,529,128,162,124
"660210110",653,658,1311,303,256,227
"661120110",207,170,377,103,112,92
"661120109",722,698,1420,308,355,291
"660280116",228,214,442,126,120,114
"660070510",447,430,877,193,225,179
"660070108",533,537,1070,233,263,227
"660070106",404,368,772,194,227,186
"660070321",846,805,1651,358,337,303
"660070320",648,671,1319,262,239,219
"660282116",871,997,1868,409,420,395
"660281519",425,470,895,244,193,183
"660070214",437,421,858,204,196,164
"660070207",526,535,1061,249,275,237
"660281103",365,482,847,325,474,317
"661540205",23,13,36,11,28,11
"661470302",105,67,172,47,74,46
"661260606",97,45,142,27,42,27
"661190202",124,121,245,48,63,43
"660560607",85,56,141,41,51,39
"660560403",283,254,537,158,170,156
"660560401",331,269,600,148,96,79
"660490204",77,51,128,46,62,38
"660420202",425,426,851,182,227,162
"660420102",83,60,143,51,67,51
"661400308",25,8,33,15,19,15
"661400304",206,194,400,96,110,94
"661400302",33,39,72,20,26,20
"661330307",127,53,180,49,50,47
"661330217",75,39,114,35,38,34
"661330204",95,60,155,33,38,33
"661330106",597,536,1133,251,220,211
"661610204",101,84,185,50,81,48
"661120104",69,53,122,51,69,51
"661610109",191,209,400,90,222,87
"660840204",42,15,57,21,42,21
"660840203",96,84,180,50,45,35
"660770301",21,9,30,14,31,14
"660700506",36,29,65,18,23,18
"660700504",164,163,327,81,118,80
"660700406",18,17,35,6,60,6
"660070401",46,31,77,26,30,26
"660070304",91,22,113,41,52,37
"660070101",427,286,713,185,205,139
"660070206",25,13,38,15,23,15
"660070103",219,181,400,83,86,76
"660140201",6,9,15,3,7,3
"660070613",15,5,20,9,18,9
"660070611",178,159,337,86,97,85
"660070410",108,106,214,47,51,46
"661330301",409,336,745,188,211,186
"661330208",371,327,698,173,204,167
"661260403",60,47,107,27,32,23
"660280201",401,452,853,268,248,195
"660210103",436,432,868,200,233,184
"660070607",123,104,227,63,77,59
"660980104",60,25,85,31,66,26
"660630107",147,144,291,92,140,89
"660281102",262,271,533,170,230,164
"661470505",477,460,937,225,228,209
"661470409",513,518,1031,277,415,258
"661470408",924,924,1848,371,393,327
"661470315",892,1013,1905,417,434,357
"661610306",441,475,916,231,296,203
"661400121",1006,1092,2098,493,503,464
"661330308",212,220,432,84,111,83
"661400401",522,543,1065,314,314,281
"661400312",274,268,542,145,191,144
"661260823",635,668,1303,291,279,260
"661260806",299,350,649,207,193,182
"661260801",936,891,1827,360,360,347
"661260718",509,522,1031,282,315,255
"661260714",721,707,1428,295,274,258
"661260617",443,449,892,238,261,225
"661260611",1070,1012,2082,386,382,355
"661260506",531,576,1107,225,233,221
"661260505",579,574,1153,253,255,243
"661260418",498,539,1037,229,221,205
"661260211",519,515,1034,291,331,289
"661260209",836,887,1723,439,480,422
"661120412",680,689,1369,345,366,313
"661050211",402,372,774,156,214,148
"660980105",788,776,1564,381,245,189
"661120408",427,429,856,199,198,187
"661120406",439,456,895,248,280,230
"661120304",394,460,854,202,208,180
"661470508",410,479,889,199,218,194
"660561010",582,615,1197,322,363,308
"660560909",935,1003,1938,506,512,450
"660560907",696,697,1393,320,325,303
"660560906",577,561,1138,282,273,254
"660560905",576,571,1147,299,295,270
"660560903",362,406,768,244,247,210
"660560809",281,311,592,190,207,180
"660560715",851,895,1746,376,392,364
"660560708",884,879,1763,409,434,388
"660560803",484,491,975,254,263,242
"660560706",668,735,1403,349,354,336
"660560704",420,460,880,232,255,230
"660560629",382,349,731,181,225,167
"660420210",470,479,949,246,204,181
"660420111",557,570,1127,263,249,227
"661120302",488,511,999,254,271,244
"660282810",867,924,1791,403,399,374
"660282710",533,551,1084,255,219,211
"660282704",746,760,1506,354,273,242
"660282510",725,815,1540,380,391,369
"660282507",520,531,1051,277,395,235
"660282506",415,437,852,242,342,218
"660282501",758,807,1565,444,467,391
"660282406",653,722,1375,298,301,280
"660560620",446,444,890,226,260,220
"660560411",368,337,705,180,201,162
"660560407",157,174,331,88,82,72
"660560117",555,541,1096,248,265,237
"660560108",379,408,787,203,234,195
"660282117",762,778,1540,381,397,365
"660282112",416,452,868,229,243,224
"660282107",481,524,1005,290,311,277
"660282105",870,970,1840,452,434,396
"660282608",913,1009,1922,447,459,435
"660282103",231,236,467,139,139,122
"660282017",772,772,1544,312,277,269
"660282015",677,748,1425,327,307,290
"660282010",483,527,1010,215,189,178
"660282002",589,648,1237,316,351,314
"660282306",803,799,1602,365,337,328
"660282204",961,992,1953,390,393,363
"660282203",746,762,1508,312,321,292
"660282202",359,434,793,219,238,212
"660281510",500,519,1019,269,241,215
"660281411",826,922,1748,481,413,377
"660281408",678,728,1406,386,335,288
"660281306",393,498,891,294,408,280
"660281214",501,558,1059,268,270,239
"660281404",370,445,815,254,336,248
"660281403",482,577,1059,334,347,289
"660280703",578,619,1197,288,219,207
"660280702",697,730,1427,358,317,292
"660280701",628,681,1309,335,300,288
"660281909",558,583,1141,256,242,223
"660281809",433,488,921,275,249,217
"660281713",685,706,1391,333,283,263
"660281711",439,450,889,230,168,160
"660281615",554,599,1153,262,242,222
"660281612",498,598,1096,271,250,239
"660281608",660,671,1331,285,239,226
"660280518",335,401,736,222,253,209
"660280406",940,938,1878,433,395,377
"660281107",272,379,651,211,272,205
"660281105",381,463,844,276,475,268
"660281104",274,366,640,234,320,177
"660281013",304,396,700,206,249,195
"660281010",391,511,902,305,460,280
"660281007",320,383,703,256,335,232
"660281001",383,469,852,255,241,223
"660280916",334,375,709,221,231,207
"660280809",895,953,1848,468,390,374
"660280803",378,478,856,234,166,153
"660280206",519,572,1091,282,340,264
"660280402",736,776,1512,336,345,323
"660282110",184,234,418,178,228,156
"660280113",375,379,754,200,250,188
"660840106",504,438,942,224,265,201
"660140104",267,265,532,127,168,117
"660560305",843,843,1686,232,168,167
"660560214",341,376,717,193,187,178
"660070415",328,353,681,164,193,159
"660420108",489,528,1017,229,206,186
"660280107",424,420,844,209,230,193
"661260408",497,494,991,189,215,181
"660210115",604,597,1201,290,267,225
"661050104",113,117,230,51,69,49
"660280105",607,618,1225,359,414,347
"660070322",575,580,1155,249,210,191
"660282101",317,403,720,252,294,252
"660280604",501,556,1057,318,311,278
"660280912",292,362,654,215,222,198
"660070315",365,393,758,189,215,182
"660070425",577,556,1133,230,248,216
"661540207",78,69,147,54,58,47
"661610107",103,124,227,67,104,67
"661540104",1,2,3,1,2,1
"661540102",187,176,363,69,90,66
"661470404",298,266,564,122,144,109
"661190203",342,341,683,130,140,122
"660630101",47,30,77,22,31,22
"660560610",63,43,106,34,54,34
"660560606",119,113,232,57,52,50
"660560104",38,6,44,23,29,22
"660420204",5,4,9,4,12,4
"661400303",11,5,16,11,14,11
"661400102",66,57,123,35,53,34
"661330218",139,109,248,55,60,53
"660350203",383,307,690,210,371,190
"660350105",314,244,558,144,275,140
"661610301",140,143,283,78,160,75
"661050208",51,8,59,7,12,7
"660910204",124,115,239,58,46,29
"660840104",24,19,43,16,26,11
"660770203",26,12,38,16,25,16
"660700501",7,11,18,9,17,9
"660700404",40,32,72,21,29,17
"660700401",55,70,125,24,26,24
"660700102",219,257,476,106,198,98
"660630106",8,3,11,7,16,7
"660070404",29,15,44,15,19,15
"660070313",31,4,35,24,29,24
"660070311",38,14,52,23,26,20
"661610104",104,109,213,56,183,56
"660070105",162,121,283,86,93,85
"660070102",21,1,22,19,24,19
"661400104",18,9,27,9,15,9
"660700302",22,24,46,11,33,10
"660070610",72,63,135,30,33,30
"660070604",50,41,91,20,24,20
"660560503",215,144,359,86,91,86
"660070412",62,68,130,34,43,33
"661610101",111,111,222,63,89,61
"661260406",245,221,466,108,137,76
"661540204",49,36,85,26,69,26
"660280202",384,396,780,202,204,189
"660070606",112,94,206,47,54,46
"660840102",270,242,512,138,205,136
"660420203",789,790,1579,363,388,328
"661400311",238,224,462,133,194,132
"660280716",648,712,1360,332,269,234
"661400117",744,762,1506,370,401,329
"661400116",583,561,1144,266,316,264
"661330310",509,547,1056,251,316,199
"661400415",605,656,1261,325,315,284
"661330222",253,248,501,139,161,126
"661400402",531,564,1095,301,292,259
"661260723",630,637,1267,289,290,257
"661260412",862,868,1730,380,406,363
"661120213",758,696,1454,347,335,293
"661120212",542,540,1082,277,286,254
"661120211",83,72,155,49,61,49
"661260705",440,426,866,209,200,184
"661260701",885,931,1816,371,358,348
"661260623",258,247,505,136,240,136
"661120413",761,789,1550,360,320,298
"660910205",309,305,614,147,208,133
"660770107",401,398,799,188,220,171
"660700508",374,357,731,179,250,167
"660560911",763,749,1512,408,443,399
"660560813",425,455,880,246,217,189
"660560812",447,519,966,297,303,265
"660560807",209,244,453,128,147,117
"660560806",289,282,571,191,329,171
"660560713",484,508,992,312,309,266
"660560628",500,524,1024,219,227,216
"660560623",327,364,691,190,236,181
"660490306",497,494,991,200,207,187
"660490214",502,538,1040,225,214,206
"660420206",924,898,1822,406,276,238
"660350212",714,801,1515,360,336,312
"661610110",556,595,1151,298,378,266
"660350117",873,900,1773,406,454,380
"660350113",564,610,1174,283,282,252
"660350112",523,561,1084,294,313,272
"660350110",585,615,1200,285,280,249
"660282713",801,861,1662,395,349,327
"660282602",590,678,1268,311,311,281
"660282514",552,629,1181,314,335,310
"660282513",396,438,834,223,257,219
"660282508",743,788,1531,393,463,334
"660282503",437,455,892,237,255,207
"660560612",498,550,1048,253,304,242
"660560306",695,639,1334,330,282,272
"660560215",361,346,707,195,212,182
"660560211",521,480,1001,236,233,213
"660560410",681,643,1324,283,292,259
"660560119",750,757,1507,338,369,327
"660560112",944,974,1918,493,524,440
"660490419",410,402,812,208,221,201
"660490403",874,819,1693,360,327,306
"660282502",437,437,874,243,284,228
"660282118",535,625,1160,327,344,309
"660282113",523,580,1103,240,226,216
"660282611",861,920,1781,394,366,350
"660282014",692,742,1434,321,299,291
"660282001",403,437,840,223,239,214
"660281604",579,607,1186,305,270,249
"660282317",771,830,1601,327,314,307
"660282314",879,897,1776,367,347,331
"660282207",429,477,906,239,238,225
"660282206",449,524,973,253,252,237
"660281506",722,764,1486,326,319,309
"660281412",758,836,1594,420,345,314
"660281410",629,638,1267,342,299,267
"660280615",332,392,724,226,272,217
"660281911",639,695,1334,327,295,282
"660281817",567,595,1162,297,256,224
"660281806",542,582,1124,295,265,237
"660281801",466,594,1060,336,352,292
"660281707",672,723,1395,385,337,299
"660281611",708,735,1443,366,311,284
"660281715",561,579,1140,297,234,222
"660280602",588,646,1234,335,304,278
"660280516",666,792,1458,400,401,360
"660280513",383,454,837,247,257,237
"660280508",625,690,1315,318,302,278
"660280507",607,718,1325,346,331,314
"660280505",545,620,1165,264,265,243
"660280421",430,459,889,240,234,219
"660280416",402,413,815,278,207,171
"660280403",626,643,1269,305,293,276
"660281208",231,283,514,159,183,151
"660281116",110,152,262,98,220,96
"660280913",373,467,840,281,281,254
"660280904",516,597,1113,250,218,206
"660280815",315,397,712,226,215,181
"660280813",440,531,971,289,251,223
"660280807",427,479,906,252,248,201
"660280710",673,755,1428,363,299,271
"660280709",775,772,1547,401,357,311
"660281207",185,243,428,177,236,175
"660281204",275,383,658,216,284,214
"660280411",262,373,635,228,233,199
"661540106",413,410,823,186,273,173
"660980208",418,438,856,211,233,186
"660910105",72,71,143,39,59,34
"660070621",735,687,1422,291,315,273
"660070619",510,546,1056,245,308,217
"660070615",447,403,850,189,205,178
"660070418",619,693,1312,307,339,291
"660560208",329,291,620,122,109,104
"660281413",703,789,1492,423,379,345
"660281008",228,282,510,169,213,150
"661260213",716,747,1463,342,361,336
"660280205",383,364,747,231,253,183
"660070319",463,506,969,258,284,240
"660070317",565,573,1138,264,269,246
"660070210",370,314,684,193,194,169
"660070208",444,434,878,214,240,208
"661540210",646,614,1260,300,351,248
"661470402",394,381,775,180,261,172
"661470104",86,87,173,46,101,43
"661260604",68,30,98,42,71,42
"661260602",123,53,176,70,102,62
"661260202",125,98,223,76,121,75
"661190204",147,182,329,71,92,65
"661190201",39,31,70,18,18,18
"661190104",150,123,273,63,88,62
"661120206",164,130,294,68,86,68
"661120203",11,0,11,9,19,9
"660630104",45,28,73,27,39,27
"660630103",7,4,11,8,16,8
"660560605",143,126,269,68,83,67
"661260402",368,356,724,160,164,155
"660560301",540,483,1023,237,263,222
"660560207",141,10,151,41,47,37
"660490303",62,58,120,31,34,27
"660490206",99,72,171,44,82,36
"660490203",9,4,13,10,16,10
"660350204",26,12,38,15,16,15
"661400305",24,13,37,12,23,12
"661400301",45,33,78,33,74,30
"661400205",97,67,164,58,63,55
"661400105",46,24,70,34,46,34
"661400101",39,22,61,21,30,21
"661330212",155,107,262,72,65,61
"661330201",78,62,140,33,38,33
"661610202",182,191,373,97,142,95
"661610201",181,153,334,93,115,90
"661610106",95,115,210,48,72,48
"661050207",2,1,3,3,6,3
"661050206",8,0,8,5,24,2
"661050205",108,5,113,14,26,9
"661050203",67,83,150,54,108,45
"660980203",142,118,260,71,141,71
"660980201",29,17,46,18,34,18
"660840201",72,57,129,29,29,23
"660770304",64,38,102,37,62,30
"660700407",57,67,124,27,88,27
"660700303",47,48,95,17,41,17
"660700301",56,68,124,34,39,32
"660280301",12,8,20,7,9,7
"660070403",41,12,53,23,34,22
"660070314",25,14,39,14,14,14
"660070310",5,4,9,3,5,3
"660070307",23,8,31,13,19,13
"660070612",106,83,189,49,54,49
"660140102",83,87,170,37,50,37
"660700101",28,48,76,17,41,17
"660070507",23,5,28,10,19,10
"660070506",79,55,134,45,43,43
"660070504",43,55,98,29,36,29
"660070406",34,21,55,22,39,22
"661260601",473,458,931,239,353,228
"661190102",800,871,1671,306,388,293
"660070601",971,935,1906,432,451,369
"660070407",161,161,322,69,88,65
"660560608",720,664,1384,266,256,240
"660560203",744,749,1493,319,309,246
"660490205",159,165,324,86,113,84
"661400412",442,507,949,271,258,223
"661400408",331,375,706,236,280,226
"661330312",565,563,1128,282,336,267
"661330309",477,496,973,231,238,172
"661330224",510,533,1043,238,290,222
"661330223",400,397,797,211,239,194
"661470312",655,740,1395,325,365,303
"661400404",349,380,729,218,216,187
"661400403",419,458,877,273,294,250
"661260816",555,607,1162,327,347,310
"661260815",632,667,1299,316,299,273
"661260814",817,934,1751,390,365,346
"661260720",653,665,1318,287,276,261
"661260717",536,578,1114,296,313,256
"661260613",670,686,1356,302,294,267
"661260610",1035,980,2015,351,361,334
"661260212",520,537,1057,253,245,221
"661120309",414,481,895,223,237,212
"661120210",277,241,518,144,173,137
"661260702",890,886,1776,311,274,267
"661120405",523,600,1123,336,330,281
"661120404",374,442,816,248,312,236
"661120301",634,632,1266,309,257,241
"661050210",372,433,805,173,233,153
"660840109",430,485,915,225,241,213
"660840107",455,419,874,244,272,225
"660770204",460,480,940,252,323,231
"660770108",478,453,931,240,282,232
"660561011",506,623,1129,300,283,264
"660561008",426,460,886,236,256,227
"660560917",977,998,1975,448,444,425
"660560910",447,448,895,216,237,214
"660560801",605,614,1219,292,305,278
"660560714",512,542,1054,272,248,221
"660560712",313,313,626,207,208,170
"660490413",454,493,947,297,357,276
"660490217",684,697,1381,326,341,312
"660490211",426,478,904,223,234,220
"660490409",633,629,1262,307,272,250
"660490105",812,898,1710,374,384,343
"660350120",699,705,1404,287,227,186
"660350111",505,593,1098,277,307,264
"660282805",534,611,1145,330,378,329
"660282709",663,674,1337,289,278,261
"660282706",486,546,1032,244,222,211
"660282701",530,552,1082,253,208,197
"660282619",806,854,1660,368,364,356
"660282612",1084,1187,2271,489,490,477
"660282515",593,724,1317,366,400,361
"660282412",1086,1123,2209,428,401,376
"660282407",463,514,977,212,208,196
"660560618",833,928,1761,427,411,382
"660560217",326,342,668,190,211,185
"660560617",657,619,1276,294,269,257
"660560213",705,754,1459,397,415,364
"660560115",513,563,1076,222,199,170
"660560114",615,683,1298,276,273,256
"660490418",474,492,966,277,271,247
"660490308",399,440,839,231,239,217
"660282210",589,670,1259,332,351,328
"660282109",336,413,749,238,296,227
"660282104",692,771,1463,367,351,317
"660282607",896,990,1886,463,482,453
"660282606",622,640,1262,319,375,294
"660282008",641,606,1247,318,280,267
"660282006",285,342,627,207,284,204
"660282307",823,818,1641,354,324,313
"660282209",531,592,1123,310,343,305
"660282121",752,814,1566,398,382,346
"660281508",570,587,1157,268,238,219
"660281507",840,834,1674,358,301,280
"660281501",446,458,904,227,252,219
"660281308",300,368,668,220,306,181
"660280704",581,619,1200,289,218,212
"660280616",516,636,1152,348,371,340
"660280614",336,388,724,223,257,216
"660282016",749,799,1548,318,306,292
"660281908",530,553,1083,279,265,258
"660281906",602,653,1255,323,294,276
"660281818",558,562,1120,261,249,240
"660281816",532,575,1107,296,271,244
"660281710",411,442,853,211,174,160
"660281704",381,381,762,238,211,180
"660281702",392,433,825,232,279,193
"660281714",901,955,1856,436,342,319
"660281618",901,876,1777,412,436,397
"660281609",635,721,1356,317,293,277
"660280610",430,527,957,298,334,277
"660280606",442,425,867,235,246,220
"660280715",633,615,1248,314,243,227
"660280515",481,523,1004,256,241,234
"660280510",782,809,1591,416,376,342
"660280408",819,890,1709,365,352,338
"660281112",281,398,679,212,376,195
"660281009",384,514,898,291,398,280
"660280906",839,862,1701,405,338,320
"660280902",750,799,1549,436,481,395
"660280814",245,290,535,193,256,182
"660280812",421,448,869,230,200,176
"660280804",439,488,927,284,253,217
"660280714",585,596,1181,315,243,218
"660280708",711,758,1469,368,293,271
"660281206",441,437,878,150,173,146
"660280401",447,495,942,285,257,233
"660280619",510,602,1112,318,297,271
"660280208",458,483,941,277,228,182
"660280119",602,693,1295,329,374,327
"660280117",742,752,1494,367,390,348
"661470507",489,544,1033,258,233,223
"661470313",351,341,692,185,258,167
"661400407",282,357,639,204,219,183
"660280111",472,489,961,235,248,198
"660840205",310,339,649,160,199,155
"660070616",403,402,805,183,193,170
"660561002",774,797,1571,364,389,351
"660560619",374,398,772,229,243,206
"660070416",736,814,1550,399,439,378
"660280909",668,821,1489,405,388,340
"661330220",555,518,1073,251,324,247
"661260819",736,726,1462,325,329,299
"661260711",408,393,801,212,245,186
"661190105",155,154,309,78,97,74
"661120410",398,427,825,182,217,174
"660280120",357,373,730,168,200,156
"660282123",439,506,945,254,234,213
"660282102",275,315,590,225,296,224
"660281309",213,287,500,159,215,143
"660070213",423,402,825,210,208,179
"660070212",569,502,1071,265,282,245
"661540201",82,80,162,61,60,39
"661610102",467,502,969,213,328,199
"661470310",14,10,24,7,16,7
"661470304",15,10,25,9,24,9
"661470203",41,43,84,20,32,17
"661470103",65,77,142,34,47,33
"661260603",461,296,757,222,273,210
"661260607",76,41,117,24,33,24
"661260203",370,352,722,199,461,178
"661120204",65,41,106,39,45,37
"661120107",141,80,221,65,100,61
"660700104",35,28,63,12,18,12
"660560601",37,15,52,26,33,26
"660560404",80,6,86,6,6,5
"660490210",25,18,43,13,26,13
"660490207",32,9,41,18,20,18
"660490103",291,256,547,143,337,142
"661400309",24,21,45,17,24,17
"661400203",82,53,135,41,59,41
"661400202",40,22,62,19,32,19
"661400201",28,10,38,16,29,14
"661330205",58,33,91,28,31,28
"661330203",269,215,484,101,100,96
"660350108",363,332,695,173,224,163
"661610108",89,102,191,52,95,47
"660910203",30,40,70,16,20,16
"660910102",76,93,169,33,96,33
"660910101",26,34,60,15,49,15
"660840202",66,53,119,35,46,34
"660840105",23,17,40,16,27,15
"660840103",24,18,42,12,14,12
"660700204",205,223,428,109,180,104
"660700107",124,132,256,61,127,60
"660700103",42,58,100,19,30,18
"660630203",61,43,104,34,38,24
"660280302",38,17,55,30,45,29
"660280203",29,15,44,25,54,22
"660070204",237,192,429,94,111,84
"660070202",123,55,178,67,68,48
"660070309",26,17,43,13,21,13
"660280103",79,54,133,43,38,33
"660140103",267,237,504,110,141,102
"660140101",319,322,641,129,186,122
"660070508",133,124,257,65,64,64
"660560303",305,235,540,132,88,73
"661400108",196,174,370,102,111,100
"661400107",69,59,128,42,57,42
"661330304",539,465,1004,220,235,214
"661260502",545,584,1129,266,354,263
"661260401",572,558,1130,224,366,215
"661610302",231,239,470,112,197,108
"660280121",264,255,519,132,124,116
"660280102",113,117,230,64,68,62
"660070303",396,357,753,158,186,156
"660700201",115,134,249,68,132,61
"660420104",926,881,1807,442,512,388
"660350102",438,425,863,202,208,126
"660070205",461,402,863,209,206,187
"660070414",223,209,432,104,107,95
"661470503",565,603,1168,219,209,197
"661470511",751,747,1498,354,365,310
"661400118",445,517,962,232,242,226
"661400409",683,766,1449,354,309,265
"661260820",233,261,494,152,160,125
"661260818",1132,1142,2274,521,467,442
"661260811",520,553,1073,231,232,218
"661260810",442,452,894,206,204,194
"661260804",332,349,681,182,206,179
"661260802",471,573,1044,278,259,239
"661260619",891,823,1714,358,384,344
"661260612",693,659,1352,238,225,217
"661260709",1016,1057,2073,455,410,389
"661260414",588,599,1187,266,267,241
"661260411",828,762,1590,331,335,301
"661260410",957,954,1911,460,437,411
"661260409",581,532,1113,180,184,172
"661260304",466,477,943,193,223,187
"661120305",650,626,1276,280,292,257
"661120303",435,409,844,204,230,189
"661120401",782,751,1533,355,369,327
"661120214",838,876,1714,404,414,373
"661120409",937,1007,1944,424,397,377
"660980106",875,961,1836,440,377,310
"661120407",332,377,709,187,212,175
"660700507",290,274,564,140,151,101
"660561007",448,442,890,237,249,230
"660561004",420,461,881,260,287,251
"660561001",436,496,932,234,260,234
"660560922",539,565,1104,274,278,249
"660560914",434,488,922,252,257,225
"660560810",423,441,864,234,234,209
"660560805",303,319,622,215,279,197
"660560711",478,518,996,287,301,262
"660560710",860,889,1749,398,419,359
"660560705",539,586,1125,275,272,254
"660560802",694,678,1372,301,311,289
"660490212",486,490,976,214,193,187
"660490410",1039,1051,2090,445,439,416
"660490408",414,480,894,271,291,247
"660490106",618,602,1220,287,280,251
"660420205",941,918,1859,451,416,360
"660350210",750,779,1529,345,361,321
"660350209",609,604,1213,296,242,229
"660350119",384,429,813,174,196,171
"660350118",533,547,1080,222,253,214
"660350115",395,429,824,212,249,190
"660282617",928,957,1885,449,455,429
"660282511",746,841,1587,384,414,374
"660282509",476,519,995,257,294,244
"660282505",281,294,575,162,254,133
"660282411",938,957,1895,376,387,358
"660282405",791,806,1597,339,325,316
"660560621",619,620,1239,290,261,222
"660560615",816,757,1573,347,348,301
"660560405",636,646,1282,290,340,288
"660560120",410,415,825,168,171,138
"660490421",447,448,895,212,218,200
"660282119",617,684,1301,355,343,316
"660282114",438,425,863,237,235,222
"660282106",726,811,1537,414,424,394
"660282603",622,686,1308,328,350,326
"660282012",729,761,1490,333,305,283
"660282011",798,888,1686,361,345,330
"660281912",402,451,853,220,215,203
"660282310",754,838,1592,344,315,309
"660282308",844,845,1689,354,349,327
"660282305",856,877,1733,380,338,329
"660282205",405,479,884,252,246,225
"660282201",586,626,1212,337,363,326
"660281521",451,479,930,237,208,194
"660281509",508,526,1034,276,218,197
"660281522",650,702,1352,344,297,274
"660281211",1642,779,2421,325,329,299
"660280621",686,818,1504,435,394,326
"660280613",362,379,741,226,236,217
"660281901",746,771,1517,364,393,339
"660281812",461,546,1007,286,286,259
"660281808",391,474,865,249,226,194
"660281804",461,461,922,225,201,181
"660281614",644,710,1354,325,318,303
"660280611",608,719,1327,382,406,366
"660280608",454,565,1019,294,294,257
"660280607",432,488,920,262,267,235
"660280605",630,698,1328,357,357,308
"660280511",414,465,879,252,249,233
"660280509",591,687,1278,300,238,233
"660280503",525,568,1093,241,216,206
"660280423",820,911,1731,460,351,329
"660280407",765,765,1530,323,311,300
"660280404",924,891,1815,415,413,401
"660281209",240,284,524,174,134,98
"660281203",287,338,625,204,252,198
"660281202",295,361,656,225,260,203
"660281111",211,257,468,193,328,186
"660281106",308,421,729,225,342,221
"660281006",510,669,1179,390,439,345
"660280905",776,898,1674,443,401,368
"660280808",457,511,968,253,215,203
"660280712",402,402,804,209,168,155
"660280706",467,545,1012,250,219,200
"660281310",286,374,660,201,236,188
"661470509",507,534,1041,285,284,240
"661470506",505,499,1004,245,245,213
"661470311",707,695,1402,316,332,277
"661400406",347,382,729,211,214,183
"660140206",580,557,1137,295,377,276
"660560111",454,486,940,223,211,193
"660490104",802,778,1580,391,374,339
"660282809",966,1055,2021,505,474,429
"660281303",313,469,782,260,361,253
"660280109",492,479,971,222,248,214
"661330108",916,893,1809,429,513,401
"661260104",490,475,965,193,183,165
"660210108",648,677,1325,289,238,214
"660070107",412,420,832,203,247,198
"660281815",479,495,974,249,217,200
"660281523",492,522,1014,274,181,156
"660070211",552,479,1031,248,268,245
"660070422",420,471,891,246,266,222
"661540211",477,458,935,228,316,188
"661470406",7,8,15,5,11,5
"661470403",212,190,402,97,106,91
"661470401",581,555,1136,301,588,294
"661470305",50,33,83,32,50,32
"661470202",95,79,174,48,71,46
"661330102",1005,997,2002,447,448,427
"661260405",41,30,71,23,23,19
"661120208",325,290,615,159,182,158
"660560201",241,114,355,57,68,56
"660490301",392,310,702,184,222,166
"660490209",64,64,128,27,35,26
"661400307",44,36,80,27,40,27
"661400306",30,6,36,10,17,10
"661400114",99,86,185,53,65,53
"661400111",61,23,84,36,54,36
"661400106",44,16,60,27,53,25
"661330306",530,429,959,235,260,231
"661330213",108,88,196,40,40,39
"661050204",35,31,66,18,35,15
"661050102",0,0,0,0,2,0
"660980204",42,25,67,22,41,22
"660980103",107,69,176,57,147,56
"660910202",38,48,86,26,41,24
"660770202",17,12,29,15,27,13
"660700202",35,40,75,24,59,24
"660630201",66,57,123,35,44,32
"660070405",226,178,404,100,107,84
"660070312",11,1,12,6,11,6
"660070305",44,27,71,28,69,28
"660070402",35,16,51,25,38,25
"660070203",13,6,19,11,12,11
"661330202",62,49,111,28,27,27
"660280101",242,242,484,136,128,79
"660210105",48,39,87,19,28,17
"660210101",179,142,321,85,99,73
"660980206",8,3,11,4,7,4
"660070609",112,87,199,50,64,49
"660070505",124,76,200,53,57,53
"660560604",98,62,160,56,66,55
"660070411",33,12,45,17,22,17
"661190103",288,288,576,162,292,155
"661120105",527,495,1022,253,344,240
"660210106",165,151,316,89,78,47
"660140203",440,413,853,210,285,204
"660560304",379,367,746,171,169,161
"660980102",144,124,268,86,141,84
"660700203",202,226,428,122,226,111
"660560204",818,775,1593,289,305,287
"661470515",526,523,1049,237,232,211
"661400410",605,688,1293,343,347,307
"661400119",587,612,1199,298,280,264
"661330311",516,511,1027,256,317,235
"661470513",627,616,1243,274,279,254
"661470512",262,299,561,173,186,156
"661400416",370,388,758,187,166,149
"661260824",901,927,1828,415,405,365
"661260821",730,726,1456,362,351,321
"661260817",734,676,1410,358,306,286
"661260813",866,870,1736,358,342,320
"661260807",347,381,728,193,181,162
"661260721",548,583,1131,302,324,295
"661260715",406,385,791,199,253,193
"661260710",416,451,867,219,227,198
"661260618",493,485,978,232,242,224
"661260511",640,618,1258,296,240,232
"661260413",752,770,1522,292,297,286
"661260208",565,649,1214,289,306,287
"661260217",1178,1144,2322,469,446,423
"661120307",297,369,666,181,185,164
"661260625",384,373,757,176,195,159
"661120313",460,523,983,267,263,233
"661120312",635,725,1360,346,381,328
"660770104",289,287,576,173,230,164
"661260713",907,872,1779,320,293,287
"660561005",509,578,1087,277,285,256
"660561003",626,640,1266,309,306,289
"660560923",578,601,1179,290,306,284
"660560920",590,578,1168,308,294,266
"660630111",457,455,912,223,270,206
"660560908",770,729,1499,344,363,325
"660560815",729,738,1467,324,333,315
"660560707",104,83,187,46,459,44
"660490216",427,444,871,187,201,179
"660490407",456,405,861,215,203,194
"660350211",540,532,1072,270,284,251
"660350121",458,440,898,189,154,144
"660282812",692,724,1416,296,285,277
"660282804",353,388,741,248,272,219
"660282712",678,697,1375,321,275,259
"660282708",586,607,1193,259,215,209
"660282618",646,705,1351,342,351,334
"660282616",734,749,1483,316,304,301
"660560113",360,368,728,148,150,120
"660560106",835,931,1766,387,418,368
"660490420",373,370,743,194,194,173
"660490417",422,408,830,248,260,230
"660490416",589,606,1195,293,293,257
"660282108",366,433,799,216,239,210
"660282610",1012,1115,2127,463,462,449
"660282013",535,612,1147,230,221,219
"660282005",307,362,669,220,262,214
"660281914",636,684,1320,300,292,272
"660281606",639,729,1368,375,317,280
"660282401",202,181,383,112,96,86
"660282315",809,789,1598,363,294,284
"660282313",871,931,1802,340,334,320
"660282301",846,808,1654,335,317,309
"660282208",510,603,1113,294,328,292
"660282122",584,679,1263,340,356,322
"660281602",1133,1167,2300,569,490,450
"660281520",490,537,1027,273,222,201
"660281514",408,530,938,291,300,260
"660281505",746,839,1585,349,341,327
"660280705",515,527,1042,254,209,188
"660280612",350,452,802,240,260,230
"660281810",512,511,1023,263,249,220
"660281709",621,683,1304,337,313,268
"660281706",361,377,738,221,197,174
"660280517",528,693,1221,354,398,342
"660280506",631,642,1273,302,304,279
"660280413",591,784,1375,444,386,349
"660280412",552,676,1228,432,316,294
"660281201",456,475,931,272,321,268
"660281011",212,338,550,168,251,160
"660281004",484,565,1049,327,274,235
"660280914",476,529,1005,299,306,278
"660280810",476,573,1049,273,274,241
"660280805",401,464,865,261,267,221
"660280707",858,849,1707,411,309,282
"660280620",352,431,783,252,242,215
"661540209",637,639,1276,277,334,247
"660280115",332,369,701,190,239,184
"660070614",680,648,1328,313,356,303
"660560703",614,659,1273,291,319,282
"660560613",637,665,1302,296,315,290
"661260510",665,668,1333,283,218,200
"660210114",678,693,1371,326,370,274
"660210109",594,655,1249,283,242,231
"660210107",502,512,1014,252,279,211
"661050209",658,659,1317,239,314,218
"660210113",538,525,1063,267,275,214
"660070421",324,378,702,195,255,175
"660282408",928,954,1882,387,385,359
"660281701",316,492,808,266,301,241
"660070209",423,362,785,196,202,172
"661540105",358,386,744,163,131,102
"661540101",94,97,191,35,44,35
"661470205",75,64,139,38,71,38
"661330104",224,205,429,116,123,110
"661260501",15,8,23,14,51,14
"661260201",156,105,261,79,202,72
"661190101",139,174,313,54,65,53
"661120209",496,326,822,205,223,201
"660490208",56,24,80,33,43,33
"660490202",45,37,82,25,35,25
"660420201",302,284,586,125,143,97
"660350205",101,59,160,45,83,44
"661400112",63,53,116,36,50,36
"661400110",136,110,246,72,96,71
"661400109",9,4,13,6,12,5
"661400204",81,51,132,45,72,45
"661610303",54,62,116,41,86,40
"661330215",52,43,95,28,34,28
"661330214",268,258,526,163,181,162
"661330207",46,32,78,26,31,26
"661330206",101,58,159,38,41,38
"661330105",154,104,258,64,73,64
"660350104",32,15,47,17,25,16
"660350101",121,101,222,63,67,59
"661120101",122,108,230,65,104,65
"661050201",143,35,178,36,93,36
"661050101",0,0,0,0,14,0
"660910103",73,74,147,32,30,30
"660700505",3,1,4,3,33,3
"660700503",15,7,22,12,40,12
"660700405",6,9,15,7,23,7
"660700106",37,31,68,21,35,21
"660630105",35,22,57,20,26,20
"660280304",39,30,69,25,38,25
"660280303",25,18,43,15,24,15
"660070302",44,10,54,22,33,22
"660140204",142,136,278,83,144,77
"660070608",81,93,174,38,46,37
"660070603",56,28,84,20,23,20
"660070602",46,18,64,13,17,12
"660070509",39,29,68,21,25,21
"660070409",91,56,147,51,63,46
"660350207",189,140,329,91,115,85
"661610304",384,402,786,182,283,182
"661400103",94,59,153,43,67,43
"661330107",939,853,1792,385,404,377
"661120106",249,200,449,105,159,101
"660210104",557,600,1157,263,299,253
"660140202",1292,1230,2522,621,834,598
"660070408",592,676,1268,276,308,262
"660630108",114,130,244,70,97,68
"660560602",179,188,367,79,93,78
"660560302",532,535,1067,233,161,122
"660490302",509,487,996,228,311,223
"660350206",568,580,1148,246,261,235
"660350201",807,817,1624,333,410,324
"660070420",613,640,1253,299,324,275
"661470501",487,494,981,221,249,205
"661470317",836,860,1696,335,364,306
"661470316",719,756,1475,336,341,300
"661400310",240,247,487,132,171,132
"660281407",664,776,1440,396,382,344
"661400120",607,644,1251,291,289,271
"661330221",564,582,1146,273,263,224
"661260822",693,735,1428,358,341,315
"661260809",1022,1019,2041,419,406,373
"661260808",431,425,856,210,188,171
"661260716",241,297,538,191,223,184
"661260620",763,772,1535,353,384,338
"661260508",666,663,1329,315,310,281
"661260507",681,709,1390,359,354,331
"661260417",306,336,642,146,164,146
"661260303",604,611,1215,285,307,273
"661260302",390,372,762,170,177,153
"661260216",509,518,1027,285,345,281
"661260214",570,586,1156,282,305,281
"661260207",498,490,988,236,245,227
"661260206",955,988,1943,402,420,388
"661190205",601,582,1183,261,308,220
"661120306",547,573,1120,283,286,257
"661260704",527,587,1114,272,276,249
"661260622",464,451,915,196,222,192
"661120402",318,386,704,179,194,163
"661120310",732,753,1485,346,375,331
"660770109",330,365,695,183,201,147
"660770106",362,355,717,196,216,136
"660770105",429,428,857,215,252,206
"660980209",482,487,969,227,221,197
"660561006",439,425,864,246,250,227
"660560924",624,624,1248,284,307,280
"660560921",641,416,1057,213,251,210
"660560913",616,610,1226,324,333,300
"660560912",536,499,1035,265,273,245
"660560902",411,422,833,259,296,224
"660560901",142,94,236,57,64,54
"660560814",717,701,1418,303,310,293
"660560804",471,513,984,265,289,254
"660560709",518,528,1046,248,247,227
"660560702",622,673,1295,290,292,272
"660490307",454,532,986,218,215,205
"660490213",786,819,1605,343,330,320
"660490406",423,403,826,216,225,196
"660420110",406,429,835,204,195,148
"660350124",634,676,1310,347,376,341
"661050212",354,356,710,153,202,131
"660350123",675,723,1398,343,370,340
"660282815",474,497,971,228,222,208
"660282813",949,1016,1965,443,409,398
"660282808",564,638,1202,298,302,284
"660282807",653,681,1334,332,332,291
"660282803",405,471,876,238,238,228
"660282715",784,776,1560,348,338,307
"660282711",668,660,1328,309,282,258
"660282707",546,555,1101,237,240,221
"660282705",604,622,1226,298,245,227
"660282703",766,760,1526,335,310,299
"660282702",491,554,1045,254,254,239
"660282615",786,812,1598,333,336,327
"660282601",618,593,1211,300,318,270
"660560505",502,479,981,233,236,210
"660560406",105,135,240,63,67,62
"660560210",607,609,1216,320,348,310
"660560109",586,646,1232,259,247,219
"660560107",517,522,1039,240,273,235
"660490404",576,637,1213,320,304,278
"660282403",654,668,1322,301,288,274
"660282402",369,374,743,201,232,199
"660282609",967,1075,2042,458,454,434
"660282018",1077,1136,2213,467,379,370
"660281913",543,658,1201,338,311,284
"660282304",833,805,1638,346,328,316
"660282213",695,750,1445,332,332,312
"660282124",421,495,916,253,243,230
"660281603",431,502,933,233,206,187
"660281513",594,633,1227,276,257,246
"660281512",763,840,1603,377,346,321
"660281511",823,832,1655,386,365,336
"660281503",901,927,1828,407,389,377
"660281502",883,938,1821,390,391,368
"660281304",244,277,521,173,226,158
"660281302",166,197,363,132,225,123
"660281301",452,583,1035,239,325,224
"660281213",949,1044,1993,480,460,410
"660281212",936,963,1899,462,443,400
"660281402",562,638,1200,363,420,326
"660280622",611,735,1346,435,439,362
"660281910",947,967,1914,427,412,384
"660281904",527,535,1062,266,228,209
"660281903",490,542,1032,253,221,207
"660281802",720,805,1525,434,388,349
"660281705",470,508,978,280,258,230
"660281616",728,708,1436,332,281,267
"660281311",200,264,464,143,213,138
"660280603",585,600,1185,374,393,319
"660280520",347,349,696,214,218,199
"660280512",399,501,900,249,238,222
"660280504",495,519,1014,233,233,205
"660280422",874,974,1848,416,349,327
"660280418",657,699,1356,293,239,235
"660280417",1109,1159,2268,498,431,420
"660281109",207,333,540,185,413,184
"660281101",389,428,817,264,318,230
"660280915",281,358,639,200,219,188
"660280911",296,372,668,194,214,180
"660280806",582,822,1404,284,259,230
"660280717",605,665,1270,317,273,253
"660280114",496,538,1034,247,320,244
"660980207",55,63,118,28,35,27
"660700205",516,554,1070,277,353,232
"660070618",378,398,776,193,221,184
"660070617",538,533,1071,253,279,239
"660561015",371,380,751,198,209,197
"660210116",668,646,1314,317,291,255
"660560504",569,521,1090,234,270,233
"660070427",609,634,1243,263,329,252
"660070417",809,766,1575,326,322,288
"660280110",557,561,1118,265,303,242
"660280106",726,482,1208,274,468,263
"661260509",792,757,1549,378,333,297
"660210111",410,455,865,229,247,201
"661120108",158,139,297,82,88,75
"660282409",790,832,1622,346,331,326
"660070318",760,763,1523,364,359,322
"660070316",707,743,1450,309,280,258
"660070423",485,510,995,269,299,241
"661540206",87,112,199,39,63,39
"661470309",30,33,63,13,17,13
"661470308",15,8,23,7,13,7
"661470306",274,217,491,134,212,134
"661470204",37,24,61,12,21,12
"661470201",57,87,144,31,52,31
"661470105",82,71,153,41,64,39
"661330103",273,224,497,131,122,118
"661260608",13,4,17,8,8,8
"661260605",146,112,258,67,109,66
"661260407",81,47,128,36,51,36
"661260404",123,119,242,51,62,51
"661260301",134,121,255,59,75,56
"661260103",279,224,503,153,181,142
"661260102",841,689,1530,397,445,394
"661120205",181,105,286,85,117,84
"660630102",9,9,18,7,12,6
"660560206",154,121,275,52,52,49
"660560101",71,66,137,32,32,31
"660490102",127,93,220,58,102,57
"660420106",455,399,854,190,226,168
"661470101",68,90,158,28,33,23
"661610305",122,146,268,52,111,50
"661120102",13,7,20,9,21,9
"660980202",4,2,6,2,8,2
"660910201",39,40,79,19,13,13
"660840101",203,156,359,103,126,99
"660770302",12,8,20,9,17,9
"660770102",83,79,162,46,46,43
"660770101",43,19,62,19,19,19
"660700403",19,26,45,15,25,15
"660700402",24,29,53,13,40,13
"660630202",190,131,321,112,156,112
"660070301",8,0,8,5,6,5
"660070201",195,139,334,96,124,88
"660070104",90,53,143,50,46,39
"660210201",6,9,15,5,8,5
"661120202",46,9,55,31,49,31
"661120103",32,28,60,22,38,22
"660070605",37,13,50,19,30,19
"660070502",41,32,73,18,8,5
"700350301",571,583,1154,252,279,251
"700140105",495,495,990,241,273,218
"701330104",142,132,274,85,188,83
"701260205",244,242,486,119,134,112
"700560601",148,142,290,65,169,65
"700560104",466,437,903,207,253,200
"700280907",276,372,648,211,248,206
"700280905",324,420,744,257,328,250
"700280811",261,313,574,184,220,177
"700280713",355,407,762,216,184,166
"700700301",393,366,759,187,218,179
"700560702",831,109,940,57,76,51
"701260103",606,562,1168,248,255,238
"700280709",506,596,1102,322,320,282
"700280610",260,301,561,184,220,174
"700280608",436,543,979,305,335,293
"700280603",310,394,704,214,224,205
"700280516",283,332,615,192,235,190
"700280515",341,363,704,192,222,185
"700280506",469,571,1040,329,378,318
"700280410",417,486,903,248,259,228
"700700107",536,565,1101,266,258,245
"700280409",294,321,615,187,191,163
"700280405",573,639,1212,290,327,279
"700280321",196,295,491,184,253,180
"700350707",586,619,1205,263,271,250
"700350706",407,440,847,207,220,205
"700350704",430,459,889,234,252,226
"700350501",260,224,484,115,146,113
"700350205",281,308,589,175,200,174
"700350105",693,740,1433,344,315,292
"700350104",560,545,1105,271,277,245
"700070204",1004,1016,2020,430,438,408
"700280116",236,316,552,206,287,201
"700280311",313,371,684,198,198,175
"701260201",757,691,1448,340,312,298
"700770801",328,348,676,184,160,144
"700420416",574,613,1187,321,363,318
"700350701",452,454,906,213,196,190
"700350601",51,48,99,24,40,24
"700280716",198,214,412,156,182,141
"700280211",238,317,555,185,208,180
"700280204",313,340,653,178,206,176
"700280113",154,215,369,146,193,128
"700280108",205,272,477,218,320,216
"700280107",186,230,416,158,223,154
"700210404",678,681,1359,325,476,305
"701120101",353,316,669,181,243,178
"701050107",789,769,1558,373,400,353
"700980402",331,420,751,243,288,237
"700980305",608,697,1305,324,297,276
"700980302",589,530,1119,290,277,266
"700980207",694,713,1407,356,386,329
"700980107",609,624,1233,305,261,248
"700980106",822,835,1657,412,375,334
"700910112",644,670,1314,342,329,300
"700910111",314,305,619,150,143,137
"700840215",562,613,1175,318,359,298
"700840210",591,619,1210,334,363,329
"700771011",373,407,780,233,219,186
"700771008",416,460,876,233,216,205
"700771007",697,695,1392,342,327,293
"700770804",506,468,974,242,219,207
"701190207",359,380,739,212,298,209
"700770505",417,460,877,228,215,203
"700770502",719,670,1389,334,346,282
"700770412",584,660,1244,352,346,319
"700770405",416,462,878,264,286,250
"700770313",448,463,911,250,243,217
"700770309",620,609,1229,326,291,272
"700770201",650,691,1341,354,352,323
"700770104",744,707,1451,295,315,267
"700700504",393,395,788,177,277,155
"700700501",699,670,1369,295,306,277
"700700518",374,397,771,206,228,195
"700700207",1032,1126,2158,549,554,499
"700700113",638,630,1268,333,335,300
"700770508",435,439,874,218,260,212
"700700110",296,336,632,202,233,197
"700560105",692,747,1439,347,378,329
"700700108",495,532,1027,264,265,240
"700490203",503,477,980,256,317,244
"700490202",348,351,699,171,261,167
"700420509",582,643,1225,325,318,310
"700420506",699,775,1474,347,335,326
"700420408",630,692,1322,265,198,193
"700420215",416,475,891,220,208,190
"700420208",438,502,940,224,204,190
"700420210",612,658,1270,313,313,296
"700420206",657,674,1331,327,326,294
"700420205",543,538,1081,287,244,232
"700700112",500,548,1048,286,286,263
"700420105",655,683,1338,322,329,316
"700350711",581,584,1165,251,261,237
"700210601",26,8,34,10,16,10
"700210501",76,12,88,11,18,10
"701190205",228,190,418,118,181,115
"701260401",95,78,173,58,63,58
"700350201",473,467,940,232,242,228
"701050106",549,505,1054,240,270,230
"701050104",229,210,439,128,156,124
"700910101",474,432,906,218,240,204
"700280809",436,459,895,327,361,304
"700700103",860,817,1677,402,427,372
"700630202",754,731,1485,326,327,300
"700280707",515,547,1062,309,302,266
"700280703",486,496,982,286,333,268
"700280619",185,254,439,159,158,129
"700280606",272,315,587,174,157,141
"700280505",255,194,449,147,211,139
"700280414",487,549,1036,282,297,261
"700280413",432,453,885,247,273,228
"700280412",477,588,1065,338,343,286
"700280411",257,322,579,176,189,167
"700280318",595,650,1245,293,288,274
"700280301",423,493,916,224,223,209
"700350114",513,600,1113,348,373,344
"700350110",427,458,885,259,269,240
"700350101",736,747,1483,338,313,302
"700280913",232,304,536,171,169,146
"700070303",230,248,478,120,130,111
"700070101",617,671,1288,330,326,307
"700280909",367,461,828,244,265,241
"700280614",317,357,674,217,246,210
"700070203",389,397,786,211,224,192
"700840313",464,477,941,259,265,251
"700700502",460,478,938,244,265,239
"700700115",629,614,1243,334,519,328
"700630203",577,603,1180,302,321,273
"700560204",226,238,464,134,202,122
"700280914",230,285,515,176,192,174
"700070403",641,608,1249,325,330,294
"700280208",298,331,629,187,194,175
"700280115",172,193,365,144,279,143
"700140107",850,897,1747,417,436,393
"700980405",404,440,844,232,246,207
"700980306",516,463,979,251,232,201
"700980116",827,872,1699,428,421,394
"700980204",453,471,924,226,182,145
"700840606",458,533,991,289,304,282
"700840605",391,465,856,259,277,253
"700840602",857,848,1705,417,432,365
"700840318",402,411,813,245,209,197
"700840316",513,549,1062,294,305,274
"700840308",641,662,1303,375,381,349
"700840216",567,575,1142,302,250,232
"700840211",565,690,1255,364,400,350
"700840209",409,474,883,261,293,251
"700840202",446,470,916,207,197,194
"701260208",459,436,895,215,239,206
"701260207",356,362,718,162,153,139
"701260206",436,418,854,215,215,193
"700840204",740,832,1572,337,295,265
"700771002",741,836,1577,420,383,357
"700771001",335,360,695,199,221,186
"700770909",657,614,1271,242,234,229
"700770803",678,772,1450,402,409,376
"700770802",427,401,828,214,166,151
"700840415",418,468,886,245,213,199
"700770410",564,642,1206,359,365,332
"700770403",398,425,823,218,212,194
"700770307",702,734,1436,391,386,363
"700770213",641,642,1283,312,224,215
"700700515",673,655,1328,348,306,280
"700700509",527,577,1104,294,280,265
"700700503",557,573,1130,263,254,240
"700700105",625,629,1254,308,319,286
"701190202",812,880,1692,442,497,414
"700560202",463,495,958,262,274,232
"700560108",300,322,622,143,172,137
"700490204",510,464,974,253,363,240
"700560205",457,513,970,264,286,243
"700420511",442,479,921,252,257,238
"700420419",326,364,690,184,171,161
"700420406",929,951,1880,359,333,323
"700420214",536,562,1098,284,266,248
"700140202",265,271,536,121,150,117
"701190301",142,107,249,67,100,67
"700350204",352,352,704,167,182,156
"700140101",255,221,476,120,128,110
"701050303",936,855,1791,412,447,387
"701050103",222,191,413,100,110,98
"700560102",610,561,1171,270,344,256
"700280804",271,317,588,172,175,157
"700280714",527,581,1108,305,293,254
"700280712",599,648,1247,347,355,316
"700700111",350,397,747,211,232,197
"701260104",711,709,1420,306,384,290
"700280708",501,505,1006,303,334,282
"700280705",415,476,891,289,354,276
"700280617",574,606,1180,301,309,281
"700280601",667,732,1399,310,292,276
"700280613",394,465,859,309,404,285
"700280502",403,494,897,305,378,299
"700280403",286,376,662,228,258,224
"700280401",174,201,375,131,162,130
"700280308",424,471,895,262,290,244
"700350113",455,480,935,253,265,241
"700070307",690,697,1387,309,343,284
"700280117",148,228,376,163,257,161
"700070202",446,468,914,236,249,221
"700070201",621,616,1237,286,332,279
"700070104",430,506,936,263,270,248
"701260106",369,412,781,222,237,216
"701190201",564,595,1159,283,348,266
"700630205",491,483,974,264,257,236
"700210302",510,478,988,250,328,231
"700980113",297,361,658,238,229,208
"700980105",524,555,1079,281,267,246
"700840412",691,722,1413,385,371,328
"700350503",222,182,404,95,120,94
"700280702",272,323,595,243,322,237
"700280205",322,381,703,206,217,190
"700280112",297,384,681,232,412,228
"700280111",214,314,528,207,293,206
"700280104",323,353,676,222,359,217
"700280103",275,344,619,242,356,234
"700210203",572,487,1059,269,347,261
"700980407",264,281,545,162,167,141
"700980308",583,592,1175,308,301,255
"700980301",733,867,1600,429,437,404
"700980206",762,751,1513,366,328,308
"700980202",387,372,759,180,183,168
"700980111",548,604,1152,321,294,268
"700980109",648,654,1302,357,357,327
"700910102",496,476,972,230,241,217
"700840503",1003,1043,2046,428,393,384
"700840502",415,436,851,228,253,223
"700840314",512,550,1062,266,264,243
"700840311",600,708,1308,343,358,335
"700840307",666,771,1437,418,455,378
"700840201",703,660,1363,277,277,262
"700770910",663,685,1348,326,327,294
"701260202",664,585,1249,274,271,258
"700770501",465,543,1008,276,296,270
"700770402",281,353,634,188,199,171
"700770808",532,601,1133,262,221,213
"700770205",654,661,1315,345,298,289
"700770203",679,712,1391,346,281,266
"700700517",673,668,1341,299,390,265
"700560213",311,338,649,188,205,182
"700560209",390,455,845,224,266,211
"700490303",148,177,325,76,178,71
"700420508",593,685,1278,331,310,282
"700420503",458,472,930,253,239,208
"700420414",905,920,1825,410,409,387
"700420404",732,741,1473,359,333,312
"700420418",354,417,771,201,194,183
"700420209",720,772,1492,372,352,338
"700420203",827,843,1670,365,333,321
"700420104",1567,843,2410,375,343,336
"700420201",687,751,1438,371,391,355
"700420106",728,810,1538,384,362,355
"700350502",159,132,291,68,67,65
"701120201",28,10,38,15,18,15
"700140201",153,136,289,74,82,71
"701260204",450,423,873,194,215,181
"700560401",54,30,84,22,32,22
"701260105",431,441,872,192,222,188
"700490201",213,209,422,113,139,109
"701050305",644,553,1197,266,292,252
"701050202",1084,1027,2111,472,498,452
"700560103",353,291,644,163,203,157
"700280906",185,266,451,171,199,147
"700280904",233,300,533,170,198,167
"700280902",355,494,849,293,385,291
"700280805",394,427,821,238,250,217
"700280710",450,524,974,267,271,225
"700700203",638,621,1259,349,379,322
"701190102",195,177,372,90,123,88
"700280704",485,539,1024,331,352,307
"700280605",445,549,994,315,348,299
"700280512",242,320,562,213,301,205
"700280507",270,306,576,183,207,177
"700280404",210,267,477,166,194,148
"700280320",205,245,450,162,215,157
"700280313",509,583,1092,318,348,284
"700280303",595,694,1289,325,341,311
"700350106",570,626,1196,296,295,279
"700070206",619,701,1320,323,282,260
"700070205",863,886,1749,453,459,422
"700070103",579,587,1166,303,444,293
"701330102",1144,1141,2285,533,565,504
"700980412",254,335,589,179,212,169
"700771009",353,410,763,207,200,184
"700770807",462,463,925,223,213,189
"700840411",318,354,672,199,213,185
"700280203",636,667,1303,350,357,327
"700280109",150,202,352,158,240,157
"700280101",390,458,848,285,363,281
"701050301",598,608,1206,307,320,274
"700980406",412,432,844,257,244,204
"700980401",602,757,1359,423,456,411
"700980303",324,339,663,176,182,161
"700980117",344,384,728,188,354,171
"700980103",520,537,1057,261,258,248
"700980101",604,636,1240,290,299,274
"700910114",593,625,1218,290,280,268
"700840611",670,692,1362,296,305,281
"700840607",447,476,923,264,281,262
"700840603",406,453,859,230,222,209
"700840504",1020,1053,2073,559,663,535
"700840315",543,636,1179,323,345,303
"700840312",601,683,1284,345,355,327
"700840309",613,675,1288,356,368,308
"700840212",605,701,1306,390,434,374
"700771004",546,579,1125,305,317,274
"700770908",512,554,1066,250,241,231
"700770906",567,643,1210,270,220,216
"700770814",526,571,1097,293,272,254
"700770805",623,671,1294,319,274,259
"700840414",390,438,828,215,176,149
"700840407",444,492,936,239,204,186
"700630103",767,786,1553,367,395,356
"701190206",388,445,833,236,303,228
"700770504",301,294,595,148,122,108
"700770413",296,342,638,197,219,195
"700770411",359,398,757,208,209,192
"700770409",360,351,711,201,203,185
"700770407",512,533,1045,295,273,242
"700770311",565,639,1204,342,322,290
"700770308",384,479,863,232,241,222
"700770305",499,542,1041,272,258,235
"700770212",492,511,1003,229,204,201
"700700507",626,658,1284,282,283,270
"700700302",465,508,973,236,243,229
"700770512",580,635,1215,299,339,293
"700770510",677,759,1436,327,394,325
"700770509",327,346,673,156,166,151
"700770506",280,304,584,147,116,112
"701120104",513,487,1000,247,261,235
"700560109",337,339,676,176,218,174
"700490207",476,430,906,238,366,229
"700420513",546,627,1173,302,295,270
"700420417",849,858,1707,447,394,370
"700420409",522,535,1057,238,183,174
"700420303",629,653,1282,311,306,267
"700420207",1010,1079,2089,506,485,453
"700420108",545,534,1079,256,243,235
"700420107",404,394,798,209,188,186
"700350202",281,268,549,126,151,121
"700420403",451,476,927,227,201,195
"700770703",317,279,596,144,181,137
"700560501",16,12,28,9,18,9
"700350403",471,482,953,208,228,202
"700210701",216,31,247,9,18,9
"700210405",119,89,208,40,46,39
"700210402",77,76,153,39,76,37
"700210101",194,144,338,88,136,85
"701050304",562,488,1050,199,231,187
"700700201",163,158,321,73,84,65
"700770601",595,600,1195,328,386,306
"700770702",339,326,665,181,226,175
"700770701",462,452,914,227,286,214
"700770602",544,510,1054,276,333,256
"700560301",296,255,551,132,171,125
"700700202",250,232,482,108,129,105
"701050203",484,405,889,202,228,195
"701050201",1030,921,1951,445,490,425
"700910110",171,187,358,87,97,79
"700910104",694,663,1357,307,313,277
"700910103",199,219,418,103,120,100
"700280910",372,462,834,268,326,246
"700280802",325,316,641,191,214,182
"700630104",153,160,313,73,75,60
"700280706",379,415,794,266,279,206
"700280607",385,420,805,239,248,212
"700280602",561,605,1166,292,315,289
"700280514",198,244,442,153,199,148
"700280513",353,375,728,227,246,223
"700280406",345,447,792,301,328,273
"700280319",260,349,609,209,244,198
"700280316",400,451,851,308,389,294
"700280304",590,659,1249,323,326,301
"700350111",478,513,991,312,358,307
"700350109",504,546,1050,262,259,247
"700350107",516,562,1078,231,228,220
"700350103",663,709,1372,317,308,297
"700350102",649,609,1258,301,292,273
"700070207",345,327,672,161,165,151
"700070102",691,716,1407,389,411,355
"700070304",413,361,774,197,191,178
"701050307",566,615,1181,302,327,290
"700560701",277,278,555,158,254,154
"700420103",480,513,993,259,237,230
"700280110",271,338,609,235,356,228
"700280102",277,319,596,240,324,239
"700280202",506,539,1045,291,290,261
"700280201",454,511,965,263,282,251
"700280309",437,468,905,291,318,278
"701050108",723,662,1385,325,326,281
"700980410",292,314,606,178,184,140
"700980403",418,504,922,290,320,272
"700980307",659,663,1322,376,395,343
"700980104",531,580,1111,301,287,273
"700910106",221,221,442,109,121,104
"700840613",357,362,719,184,166,144
"700840601",600,659,1259,323,344,296
"700840604",569,678,1247,333,345,326
"700840320",405,468,873,270,311,259
"700840305",828,851,1679,482,583,468
"700840217",356,439,795,238,253,231
"700840208",558,587,1145,318,357,311
"700840205",533,547,1080,257,269,232
"700771006",576,603,1179,315,279,268
"700770912",493,537,1030,287,263,243
"700770907",548,582,1130,255,237,229
"700770902",393,478,871,257,298,236
"700770901",485,502,987,299,298,258
"700770812",572,615,1187,289,264,257
"700770810",822,883,1705,405,441,388
"700840501",642,644,1286,329,344,303
"701190303",381,359,740,176,251,163
"700770416",426,458,884,208,211,190
"700770408",377,435,812,246,240,218
"700770106",565,526,1091,250,220,211
"700770105",567,567,1134,232,277,231
"700700512",767,817,1584,376,381,350
"700770101",266,294,560,162,165,154
"700700304",580,554,1134,294,296,280
"701120102",714,726,1440,367,436,351
"701120105",641,621,1262,293,346,284
"700700109",439,487,926,268,269,243
"700560206",457,543,1000,266,294,260
"700420510",758,800,1558,428,416,390
"700420504",650,680,1330,315,320,303
"700420413",671,715,1386,360,367,341
"700420407",724,755,1479,334,325,317
"700420216",791,809,1600,365,344,311
"700420111",505,551,1056,203,157,152
"700420110",550,557,1107,273,263,246
"700420109",515,504,1019,248,233,225
"700420101",384,395,779,190,187,176
"700350710",475,449,924,245,241,219
"700350302",575,555,1130,249,259,240
"700490401",2195,55,2250,8,14,8
"700210702",1,0,1,1,10,1
"700210204",140,105,245,54,61,50
"700210202",119,95,214,51,58,48
"700840101",34,25,59,13,16,12
"700140103",706,678,1384,353,359,320
"700350402",508,512,1020,239,241,228
"701050102",373,328,701,170,185,157
"700910108",185,180,365,89,116,83
"700490206",182,162,344,83,111,82
"700280908",548,601,1149,334,346,302
"700280903",278,353,631,212,253,198
"700280810",460,514,974,318,327,279
"700280807",351,414,765,251,284,244
"700280801",427,455,882,226,237,213
"700280711",557,585,1142,316,305,283
"700700204",473,455,928,208,225,190
"701190101",248,80,328,61,80,61
"700280618",576,604,1180,265,254,230
"700280616",240,293,533,144,182,142
"700280609",377,463,840,289,347,263
"700280604",390,434,824,237,253,221
"700280509",282,309,591,185,199,182
"700280503",212,253,465,164,186,157
"700280408",407,497,904,284,331,273
"700280315",184,229,413,153,189,143
"700280314",312,360,672,206,222,190
"700280307",291,335,626,195,223,180
"700490101",200,151,351,98,135,96
"700350703",479,541,1020,246,221,214
"700350702",846,970,1816,451,404,378
"700350112",514,591,1105,320,315,291
"700280916",536,563,1099,307,303,275
"700280915",461,550,1011,304,324,294
"700280912",263,287,550,167,171,148
"700280118",180,242,422,179,310,179
"700070308",551,565,1116,271,235,223
"701330103",815,783,1598,419,394,364
"700490205",343,328,671,168,352,159
"700980114",475,491,966,232,235,212
"700910109",579,573,1152,280,262,249
"700280213",264,295,559,181,195,178
"700280209",350,394,744,233,277,231
"700280206",290,360,650,215,211,200
"700280114",291,399,690,236,385,230
"700280106",319,423,742,248,366,239
"700210401",521,478,999,264,395,257
"700980409",379,399,778,227,255,217
"700980304",581,649,1230,325,298,268
"700980205",822,826,1648,392,412,349
"700980102",508,506,1014,215,274,212
"700840610",1013,995,2008,475,444,428
"700910113",493,505,998,249,255,243
"700840417",385,405,790,213,229,196
"700840310",654,723,1377,359,356,338
"700840304",615,660,1275,327,277,259
"700840301",727,763,1490,363,373,332
"700840207",414,458,872,244,258,235
"700771003",334,380,714,212,230,199
"700770815",551,580,1131,284,274,258
"700770806",827,909,1736,411,377,352
"700840409",627,659,1286,311,273,263
"700840406",343,388,731,193,200,181
"700770904",593,614,1207,318,308,274
"700700104",569,567,1136,288,266,241
"701260101",801,747,1548,362,362,343
"700770401",344,394,738,205,202,182
"700770312",389,455,844,233,207,188
"700770304",643,714,1357,354,338,315
"700770301",436,499,935,262,282,237
"700770210",299,342,641,179,190,174
"700770208",742,887,1629,413,373,362
"700770103",8,10,18,3,297,3
"700700513",640,715,1355,343,326,283
"700700511",960,968,1928,446,404,378
"700700206",1023,1014,2037,529,539,487
"700700102",846,815,1661,399,388,353
"700770511",723,768,1491,375,415,354
"701050306",647,618,1265,325,335,299
"700560203",522,583,1105,307,333,270
"700560201",506,596,1102,258,280,243
"700560106",229,255,484,116,128,115
"700560207",370,441,811,198,220,178
"700420512",532,554,1086,290,287,269
"700420507",826,850,1676,361,355,341
"700420501",719,787,1506,404,379,357
"700420412",687,721,1408,367,384,338
"700420401",582,614,1196,281,410,250
"700420213",691,749,1440,361,342,309
"700420212",880,845,1725,403,369,346
"700420211",418,448,866,218,223,191
"700420202",456,496,952,210,292,189
"700350709",596,570,1166,284,300,278
"700630204",487,506,993,240,251,230
"700350401",248,219,467,104,112,96
"700210205",23,11,34,13,21,13
"700700401",79,73,152,39,65,39
"700700101",548,505,1053,255,278,231
"701050101",220,206,426,101,88,81
"700560101",356,374,730,175,213,164
"700490301",216,185,401,87,136,85
"700140102",299,232,531,140,158,133
"701190302",138,108,246,67,94,65
"701050105",307,278,585,145,211,130
"700280901",461,564,1025,341,460,325
"700280715",345,407,752,252,299,247
"700630101",269,242,511,121,147,111
"700280511",428,499,927,300,317,287
"700280510",328,332,660,200,239,200
"700280508",378,382,760,226,240,206
"700280611",436,484,920,269,270,226
"700280407",313,371,684,240,336,229
"700280306",394,459,853,301,349,274
"700280305",459,489,948,287,305,271
"700350708",468,467,935,221,225,220
"700350705",545,599,1144,308,323,289
"700350108",593,608,1201,300,282,276
"700280302",421,431,852,226,254,194
"700070302",438,447,885,221,232,197
"700980408",267,281,548,151,147,128
"700070306",559,547,1106,258,255,239
"700280612",333,425,758,280,300,264
"700280501",369,477,846,295,330,292
"700280212",195,219,414,138,153,131
"700280207",311,345,656,200,216,195
"700280310",270,340,610,183,206,163
"700210201",556,583,1139,297,362,285
"701050302",979,985,1964,476,425,395
"700980203",523,543,1066,237,190,180
"700980110",613,659,1272,311,297,275
"700840612",607,670,1277,292,287,272
"700840505",551,584,1135,212,240,187
"700840404",340,389,729,223,248,220
"700840403",463,529,992,305,325,295
"700840401",812,911,1723,486,634,440
"700840306",610,649,1259,376,396,343
"700840302",553,620,1173,322,325,292
"700840206",396,421,817,233,258,230
"700840203",539,528,1067,262,280,253
"700771005",550,601,1151,301,327,293
"700770911",580,616,1196,340,323,303
"700770809",707,729,1436,363,332,310
"700840413",337,372,709,208,225,199
"700840408",437,501,938,269,275,257
"700840405",691,745,1436,410,382,327
"700770905",970,1054,2024,398,379,375
"700770503",397,440,837,222,232,207
"700770415",398,461,859,221,185,175
"700770310",608,665,1273,357,368,341
"700770302",425,543,968,283,284,266
"700770206",632,691,1323,344,356,320
"700770204",711,740,1451,376,343,324
"700770202",734,777,1511,374,378,357
"700700514",742,757,1499,379,392,352
"700700505",529,517,1046,235,245,231
"700700205",469,486,955,245,254,229
"700770507",600,576,1176,286,327,278
"700560212",384,407,791,222,272,203
"700560211",561,631,1192,318,339,272
"700560107",200,208,408,97,102,80
"700560208",518,535,1053,284,292,253
"700490302",331,330,661,172,228,166
"700420514",888,864,1752,420,401,364
"700420411",491,496,987,230,238,217
"700420410",516,517,1033,250,249,232
"700420405",668,697,1365,310,283,277
"700420301",663,620,1283,268,232,213
"700420102",818,835,1653,382,368,363
"700420112",466,461,927,206,207,191
"700070305",114,126,240,57,71,56
"701330201",47,1,48,4,23,4
"700210301",198,179,377,97,121,92
"700140301",41,28,69,15,32,15
"700700303",494,453,947,226,265,217
"700630201",79,75,154,44,74,44
"701260102",536,502,1038,245,272,231
"700910201",36,27,63,15,21,15
"700490102",66,49,115,30,40,24
"700350203",508,530,1038,248,281,235
"700140104",461,457,918,217,255,207
"701260301",673,623,1296,270,323,265
"700070402",322,294,616,137,152,128
"700070301",857,880,1737,383,414,363
"701330101",338,320,658,155,310,146
"700910107",335,310,645,137,159,134
"700560302",508,470,978,245,290,242
"700280911",127,175,302,84,97,80
"700280808",284,353,637,196,213,173
"700280806",348,439,787,266,296,264
"700280803",314,376,690,211,241,198
"700700114",850,840,1690,431,515,403
"700630102",398,401,799,181,185,165
"701120103",246,231,477,127,233,126
"700280701",456,537,993,342,387,292
"700280615",421,492,913,249,265,217
"700280504",403,516,919,307,339,288
"700280402",248,312,560,180,203,175
"700280317",248,306,554,188,236,187
"700280312",232,280,512,179,185,155
"701260203",575,594,1169,285,260,239
"700070401",310,322,632,159,183,150
"700770209",524,593,1117,308,314,289
"701260107",559,572,1131,266,261,249
"700840214",339,407,746,217,209,190
"700630106",580,620,1200,269,293,257
"700280210",359,474,833,266,293,258
"700280105",137,193,330,114,195,108
"700140106",550,635,1185,317,353,294
"700210403",536,569,1105,299,426,283
"700980411",388,449,837,220,216,188
"700980404",521,621,1142,331,313,260
"700980201",741,730,1471,343,348,330
"700980118",558,578,1136,294,352,282
"700980115",395,449,844,243,248,223
"700980112",499,539,1038,300,338,270
"700980108",453,502,955,275,301,269
"700840609",530,586,1116,303,262,226
"700840608",479,549,1028,280,304,277
"700840506",504,501,1005,200,285,198
"700840416",365,428,793,226,236,213
"700840402",368,404,772,218,230,213
"700840319",467,491,958,262,285,245
"700840317",475,513,988,242,213,207
"700840303",535,623,1158,302,309,284
"700840213",377,448,825,229,219,211
"700840102",116,131,247,67,64,61
"700771013",688,652,1340,333,323,298
"700771012",431,398,829,212,205,193
"700771010",461,546,1007,308,299,271
"700770903",455,502,957,275,295,251
"700770813",893,886,1779,459,369,330
"700770811",623,610,1233,251,264,233
"700770603",252,268,520,135,145,135
"700840410",402,477,879,267,291,262
"700770414",350,418,768,207,198,171
"700770406",485,569,1054,306,315,284
"700770404",425,480,905,260,273,236
"700770306",650,680,1330,363,354,336
"700770303",499,536,1035,273,273,260
"700770211",497,535,1032,269,287,263
"700770207",631,642,1273,329,328,296
"700770102",997,1017,2014,482,428,423
"700700516",797,828,1625,377,380,361
"700700510",674,664,1338,300,318,294
"700700508",588,602,1190,304,266,256
"700700506",685,694,1379,293,301,284
"700700106",546,574,1120,274,266,245
"701050308",470,495,965,236,247,220
"700420515",476,487,963,251,239,198
"700420505",911,881,1792,399,356,345
"700420502",659,661,1320,330,324,289
"700420415",528,571,1099,289,280,257
"700420402",1108,1115,2223,491,495,469
"700420304",84,82,166,48,70,46
"700420302",663,666,1329,323,344,289
"700420217",745,795,1540,350,324,302
"700420204",1010,1069,2079,482,434,424
"700070501",92,81,173,41,71,39
"700350602",158,141,299,75,71,65
"700700305",232,245,477,129,143,121
"700630105",72,73,145,34,38,33
"701190204",62,65,127,28,39,28
"701190203",123,89,212,56,70,56
"701190103",63,44,107,32,69,32
"700910105",157,131,288,69,93,67
"700560210",147,140,287,58,59,47
"740561902",111,63,174,53,61,49
"740561802",116,104,220,65,87,61
"740561401",203,262,465,230,345,229
"740560716",544,534,1078,303,281,272
"740560203",177,153,330,104,134,103
"740490304",435,419,854,286,416,283
"740630503",216,211,427,141,181,138
"740351210",507,532,1039,337,375,327
"740070507",640,638,1278,374,467,356
"740561509",469,507,976,246,253,240
"740561505",485,466,951,259,243,231
"740561503",680,691,1371,307,314,300
"740561501",885,428,1313,206,199,190
"740561412",340,358,698,234,255,208
"740560905",407,428,835,216,227,215
"740560901",424,472,896,260,250,220
"740560815",359,373,732,236,246,223
"740560808",462,538,1000,271,274,252
"740560804",387,439,826,241,251,235
"740560708",583,645,1228,357,356,342
"740560514",508,508,1016,277,284,253
"740560509",637,679,1316,406,485,400
"740561405",467,561,1028,360,373,302
"740561402",188,273,461,208,296,199
"740561310",309,346,655,213,191,156
"740561309",413,474,887,334,383,318
"740561307",388,412,800,269,324,263
"740561304",235,325,560,219,358,211
"740561218",85,58,143,33,24,24
"740561217",316,289,605,144,144,132
"740561215",826,834,1660,430,339,313
"740561110",210,274,484,206,261,198
"740561016",389,410,799,278,318,262
"740561015",441,470,911,291,319,281
"740561005",621,664,1285,370,335,310
"740560909",420,435,855,246,245,235
"740560907",519,523,1042,246,226,213
"740560505",290,293,583,206,236,203
"740560406",548,519,1067,296,457,263
"740560403",281,264,545,156,297,150
"740560706",999,1062,2061,504,352,332
"740560702",712,732,1444,341,350,324
"740560205",254,242,496,155,116,104
"740490103",227,204,431,115,171,114
"740420403",476,482,958,311,357,298
"740420405",129,144,273,74,86,73
"740420306",676,677,1353,381,461,379
"740420102",106,99,205,46,40,32
"740560711",263,260,523,141,141,132
"740351703",34,34,68,20,28,20
"740351701",119,105,224,60,93,57
"740351601",377,382,759,210,225,203
"740351505",33,7,40,3,5,3
"740280408",436,453,889,268,293,253
"740280405",579,662,1241,376,414,376
"740280402",326,300,626,166,177,152
"740560304",437,406,843,192,189,182
"740490412",326,397,723,218,376,213
"740490411",459,494,953,315,673,295
"740490402",458,498,956,314,402,295
"740350819",581,610,1191,317,338,303
"740280301",218,215,433,129,155,127
"740280205",200,207,407,137,199,135
"740351609",407,435,842,254,267,248
"740351310",509,506,1015,292,283,262
"740351307",67,64,131,41,40,38
"740351303",569,593,1162,351,383,339
"740351216",512,494,1006,235,234,220
"740351109",204,209,413,165,210,162
"740351106",275,324,599,214,311,211
"740351101",113,106,219,61,86,57
"740350908",364,442,806,282,337,273
"740350814",434,495,929,311,360,303
"740350811",778,781,1559,381,376,365
"740350712",379,427,806,263,254,249
"740350707",396,428,824,259,263,238
"740350603",52,33,85,34,48,33
"740350303",34,29,63,20,36,20
"740561803",31,13,44,13,25,13
"740561904",6,4,10,3,3,3
"740561703",13,6,19,11,29,11
"740490213",132,89,221,84,99,83
"740420406",31,20,51,18,29,18
"740420401",34,29,63,20,28,20
"740420101",35,24,59,18,31,18
"740350406",24,18,42,17,24,16
"740280201",121,80,201,73,102,73
"740210302",62,46,108,37,50,37
"740140505",71,54,125,45,66,45
"740350204",33,20,53,21,34,19
"740140402",102,66,168,61,102,60
"740140301",52,39,91,37,47,34
"740140201",21,14,35,15,13,8
"740070203",76,73,149,55,66,54
"740070202",92,65,157,56,71,55
"740490106",105,100,205,46,57,43
"740420103",60,42,102,35,69,35
"740070505",129,111,240,77,119,69
"740630301",266,224,490,159,160,126
"740561514",562,609,1171,246,244,239
"740560315",410,441,851,252,256,242
"740560104",148,124,272,73,92,72
"740210304",422,459,881,281,342,277
"740350901",336,417,753,261,265,189
"740280203",396,426,822,258,473,257
"740561515",230,251,481,118,116,108
"740561511",544,595,1139,277,279,264
"740561510",483,533,1016,225,224,220
"740561417",638,661,1299,355,363,349
"740561408",463,500,963,272,261,244
"740560902",561,556,1117,267,276,261
"740560725",399,392,791,233,223,186
"740561302",218,298,516,157,195,141
"740561212",416,402,818,230,235,214
"740561114",157,223,380,121,169,117
"740561109",235,284,519,174,189,151
"740561014",386,413,799,261,264,250
"740561001",417,442,859,325,375,308
"740560501",285,273,558,157,215,151
"740560407",372,336,708,215,336,208
"740560404",222,250,472,149,333,149
"740560317",0,0,0,0,1,0
"740490306",365,367,732,214,322,213
"740560615",631,679,1310,352,307,279
"740351504",146,135,281,83,139,72
"740351003",321,380,701,231,261,230
"740350708",554,539,1093,299,313,272
"740280404",413,500,913,326,357,321
"740560305",338,388,726,211,248,205
"740560302",278,289,567,207,246,203
"740280309",440,401,841,236,245,218
"740280308",469,473,942,288,309,282
"740280106",341,400,741,250,281,236
"740070410",431,407,838,214,254,208
"740070409",288,317,605,174,215,170
"740351606",536,530,1066,248,151,138
"740351405",416,427,843,217,237,216
"740351402",32,21,53,16,27,16
"740351305",582,612,1194,358,292,258
"740351218",227,219,446,111,119,109
"740351111",652,679,1331,368,365,334
"740351104",378,377,755,237,256,225
"740351019",633,664,1297,357,372,343
"740351018",441,419,860,228,249,218
"740351017",388,388,776,221,193,180
"740350913",345,398,743,274,314,263
"740350905",121,92,213,45,47,45
"740350806",394,382,776,195,213,182
"740350804",789,807,1596,347,380,340
"740350801",558,554,1112,296,271,235
"740210306",458,494,952,269,290,250
"740350815",372,418,790,274,314,269
"740630502",36,19,55,16,38,16
"740420301",9,4,13,6,9,6
"740210407",50,21,71,29,35,28
"740210310",66,39,105,43,65,42
"740630304",99,82,181,60,60,58
"740560408",105,90,195,55,66,53
"740560102",33,29,62,17,20,17
"740490107",12,12,24,10,13,9
"740420602",51,30,81,31,55,30
"740350402",44,22,66,27,49,22
"740280302",134,107,241,73,84,71
"740280110",62,36,98,39,60,38
"740280109",142,117,259,74,109,74
"740140504",22,7,29,14,15,13
"740350302",59,47,106,36,57,36
"740350301",40,34,74,24,48,23
"740350104",31,19,50,18,33,17
"740350101",12,9,21,11,9,9
"740280401",31,28,59,18,31,18
"740140401",43,29,72,32,50,29
"740070411",110,70,180,66,98,63
"740070307",32,16,48,15,21,15
"740070306",78,63,141,43,61,41
"740630305",121,111,232,67,88,66
"740350716",339,379,718,262,289,247
"740490416",416,464,880,268,367,261
"740210303",442,435,877,287,323,276
"740561508",697,654,1351,321,310,296
"740561415",531,646,1177,348,389,341
"740560809",384,447,831,242,244,223
"740560807",460,462,922,247,258,245
"740560805",397,450,847,240,256,239
"740560723",261,280,541,168,182,157
"740561704",40,36,76,18,26,18
"740560507",448,409,857,222,283,210
"740561303",255,325,580,249,364,215
"740561219",377,392,769,210,183,166
"740561213",599,625,1224,332,303,288
"740561211",345,333,678,192,184,173
"740561209",376,374,750,228,195,177
"740561208",272,298,570,187,233,182
"740561121",354,437,791,237,251,224
"740561118",640,650,1290,396,399,323
"740561116",151,201,352,168,253,161
"740561115",159,201,360,158,225,151
"740561113",247,298,545,236,295,229
"740561011",674,658,1332,390,402,334
"740561003",510,535,1045,354,380,343
"740561002",294,332,626,205,227,185
"740560910",540,603,1143,307,323,306
"740560603",424,494,918,248,246,237
"740560512",699,712,1411,397,425,357
"740560713",880,847,1727,431,412,385
"740490401",674,686,1360,431,499,398
"740560705",1074,1052,2126,473,429,400
"740560704",1013,946,1959,473,450,428
"740490208",276,294,570,200,219,185
"740420404",620,611,1231,388,465,383
"740420204",256,224,480,122,143,120
"740351604",347,350,697,230,268,225
"740350103",140,132,272,85,103,84
"740280406",356,352,708,176,193,176
"740280310",436,453,889,274,320,272
"740560312",511,566,1077,310,341,305
"740560307",413,462,875,266,308,265
"740560303",212,230,442,129,142,127
"740560610",667,624,1291,331,319,298
"740490417",365,360,725,200,260,190
"740490415",828,817,1645,466,513,445
"740561013",443,467,910,288,310,274
"740490410",358,435,793,270,406,270
"740280105",275,292,567,176,236,158
"740070508",446,469,915,300,372,292
"740070413",447,469,916,302,364,299
"740350817",566,565,1131,357,369,331
"740351607",381,398,779,238,279,231
"740351409",527,579,1106,285,280,261
"740351408",670,716,1386,365,356,344
"740351406",615,674,1289,372,358,341
"740351306",403,404,807,242,268,241
"740351302",5,0,5,5,1,1
"740351214",738,665,1403,339,294,280
"740351203",363,365,728,209,239,209
"740351112",823,781,1604,370,355,336
"740351107",199,255,454,185,291,174
"740351016",513,564,1077,347,397,327
"740351014",191,218,409,163,183,158
"740351006",657,681,1338,402,420,396
"740350916",400,445,845,265,282,259
"740350813",302,327,629,206,217,195
"740350810",500,532,1032,273,292,253
"740350809",414,482,896,258,284,251
"740350803",3,2,5,2,2,2
"740350706",407,419,826,234,235,210
"740350702",490,495,985,264,212,193
"740070402",586,561,1147,302,314,289
"740210308",668,652,1320,392,411,378
"740210113",29,24,53,15,30,14
"740350818",543,536,1079,306,313,285
"740210102",135,116,251,79,125,78
"740210307",606,628,1234,376,381,331
"740351611",453,496,949,248,254,240
"740561602",110,58,168,60,67,50
"740561702",5,3,8,4,13,4
"740490102",90,79,169,48,54,36
"740420307",82,36,118,53,72,53
"740420303",36,16,52,23,28,23
"740351804",22,10,32,17,26,17
"740351801",94,34,128,52,66,49
"740350605",18,7,25,13,23,13
"740280303",17,9,26,12,22,12
"740210202",62,34,96,42,41,41
"740210112",169,133,302,92,166,89
"740210406",62,38,100,42,58,36
"740280411",27,21,48,16,24,16
"740140501",69,50,119,37,47,37
"740070502",58,42,100,23,32,21
"740490104",124,114,238,73,101,73
"740351008",480,526,1006,284,306,281
"740561201",1069,1043,2112,489,474,440
"740351806",34,23,57,20,25,20
"740280306",393,358,751,235,288,229
"740561513",623,682,1305,310,315,291
"740561418",739,649,1388,316,285,270
"740560904",253,287,540,161,166,160
"740560814",396,428,824,229,218,201
"740560726",547,591,1138,345,355,313
"740560714",489,533,1022,253,259,248
"740560513",559,609,1168,359,387,346
"740561306",182,205,387,136,165,125
"740561301",188,296,484,183,204,173
"740561205",492,480,972,235,235,221
"740561202",722,646,1368,296,255,250
"740561122",589,601,1190,322,277,255
"740561120",432,404,836,216,221,202
"740561107",353,460,813,379,510,348
"740560602",101,109,210,62,65,61
"740560707",278,291,569,141,129,120
"740560701",531,579,1110,273,267,235
"740560614",374,411,785,253,258,244
"740560611",582,595,1177,293,282,278
"740420308",310,321,631,190,214,168
"740560712",599,596,1195,324,324,295
"740420207",686,648,1334,350,395,336
"740350407",353,238,591,167,168,153
"740560311",597,594,1191,351,371,343
"740560310",545,584,1129,332,361,330
"740560309",0,0,0,0,1,0
"740561012",669,756,1425,414,409,370
"740490414",371,396,767,262,295,245
"740560609",483,491,974,303,306,271
"740070510",377,334,711,210,276,207
"740070504",198,181,379,117,156,110
"740070407",341,393,734,220,258,205
"740351403",528,565,1093,304,313,286
"740351401",665,741,1406,389,388,382
"740351308",526,579,1105,347,354,307
"740351213",305,311,616,160,162,148
"740351204",381,352,733,216,235,209
"740351201",415,383,798,283,323,278
"740351114",603,610,1213,316,349,304
"740351010",319,314,633,191,201,186
"740351007",535,584,1119,322,326,316
"740351005",748,746,1494,432,476,431
"740351001",784,850,1634,455,482,449
"740350714",376,391,767,272,319,264
"740350704",383,385,768,206,204,182
"740350701",57,49,106,26,31,25
"740070305",631,630,1261,339,351,301
"740350816",367,393,760,242,254,231
"740351209",615,576,1191,335,305,289
"740630401",188,119,307,119,166,115
"740561705",51,31,82,24,41,23
"740560401",138,104,242,61,104,58
"740560202",161,136,297,85,98,84
"740420205",163,74,237,92,143,90
"740351803",66,30,96,34,41,34
"740351705",93,55,148,55,84,51
"740350405",25,12,37,12,9,9
"740350403",65,37,102,42,81,42
"740350401",48,13,61,23,46,22
"740280204",156,138,294,92,147,87
"740210404",82,65,147,47,59,47
"740210403",53,33,86,26,41,26
"740140203",37,23,60,26,43,25
"740140102",79,74,153,47,55,46
"740070401",254,204,458,127,150,116
"740070301",22,25,47,11,19,11
"740070102",123,99,222,71,87,70
"740420501",39,26,65,28,47,27
"740561701",61,51,112,34,38,32
"740630202",255,232,487,140,161,137
"740351211",191,198,389,147,224,147
"740560402",130,129,259,84,211,79
"740420208",643,656,1299,353,421,351
"740351002",316,342,658,203,241,203
"740280407",456,470,926,288,290,265
"740561506",552,603,1155,312,309,297
"740561504",256,246,502,112,82,82
"740561416",565,643,1208,341,359,334
"740561411",236,288,524,175,198,175
"740560813",445,458,903,239,242,232
"740560810",501,560,1061,301,320,294
"740560802",828,850,1678,343,332,303
"740560801",639,638,1277,270,284,255
"740560721",610,619,1229,391,381,344
"740560717",682,690,1372,331,325,310
"740560715",506,506,1012,247,246,236
"740560510",417,460,877,262,307,257
"740560506",520,549,1069,284,285,237
"740561406",588,628,1216,342,345,277
"740561308",419,486,905,249,275,237
"740561216",803,832,1635,392,356,347
"740561214",610,591,1201,293,259,251
"740561210",342,351,693,206,192,163
"740561017",391,447,838,317,377,306
"740560607",363,387,750,245,253,227
"740560405",208,214,422,146,371,144
"740560318",16,0,16,8,13,8
"740560612",519,555,1074,296,301,264
"740560608",229,253,482,159,180,156
"740490209",352,386,738,255,291,255
"740490204",444,413,857,259,327,252
"740351603",262,303,565,195,237,195
"740351506",10,6,16,7,22,7
"740350404",102,99,201,50,49,37
"740560313",616,648,1264,336,367,334
"740490419",250,297,547,186,358,182
"740490409",315,342,657,200,294,181
"740490405",757,789,1546,459,479,433
"740490404",277,281,558,172,186,166
"740280107",542,570,1112,332,378,326
"740210309",309,350,659,189,210,187
"740070509",390,438,828,265,333,249
"740351410",552,608,1160,339,357,330
"740351404",439,514,953,294,317,290
"740351311",507,517,1024,296,314,282
"740351309",595,609,1204,348,292,270
"740351217",359,318,677,169,168,163
"740351205",400,449,849,320,335,314
"740351202",455,476,931,263,288,260
"740350915",458,474,932,249,266,247
"740350914",440,481,921,299,327,295
"740350906",461,458,919,243,224,199
"740350904",534,541,1075,289,290,274
"740350903",430,472,902,276,284,256
"740350808",385,419,804,261,301,249
"740350713",507,573,1080,372,346,330
"740070304",758,710,1468,372,416,346
"740210106",79,76,155,46,194,46
"740351612",476,479,955,264,272,258
"740140303",63,51,114,47,52,42
"740630101",128,110,238,83,88,83
"740561801",6,4,10,4,6,4
"740561706",10,3,13,5,11,5
"740561601",193,158,351,94,119,91
"740490201",126,107,233,66,81,60
"740490101",54,39,93,29,40,29
"740420201",56,25,81,27,38,23
"740350502",51,11,62,22,34,22
"740280202",316,272,588,177,327,175
"740210311",60,32,92,29,41,29
"740280101",84,64,148,52,73,52
"740140404",294,211,505,157,241,154
"740140302",53,40,93,37,69,37
"740070503",23,16,39,12,20,12
"740070501",50,45,95,23,27,21
"740070412",13,17,30,8,12,8
"740210105",124,88,212,73,184,71
"740070303",92,61,153,46,55,43
"740561901",62,63,125,28,39,27
"740490303",654,661,1315,423,659,386
"740351704",115,84,199,55,69,55
"740630504",184,144,328,119,160,118
"740630402",222,202,424,149,157,143
"740351304",569,624,1193,355,320,279
"740210405",558,569,1127,308,330,282
"740630302",88,93,181,60,72,59
"740561410",190,276,466,183,201,159
"740561409",420,470,890,290,310,275
"740560718",308,339,647,205,206,190
"740561404",393,505,898,344,384,287
"740561312",381,424,805,241,263,229
"740561311",518,558,1076,352,374,325
"740561119",443,422,865,210,166,147
"740561105",272,353,625,262,288,213
"740561104",389,398,787,278,327,260
"740561103",508,592,1100,352,362,298
"740561101",506,502,1008,254,217,207
"740560916",229,240,469,136,168,133
"740560908",586,610,1196,288,292,281
"740561117",248,319,567,225,308,211
"740560613",462,520,982,289,271,258
"740560601",8,5,13,8,224,8
"740490207",360,363,723,215,272,211
"740490205",285,316,601,195,230,192
"740420305",53,29,82,31,49,31
"740420302",111,119,230,67,72,64
"740350304",100,92,192,66,96,64
"740280311",445,426,871,250,280,250
"740560308",416,477,893,283,315,282
"740490413",580,684,1264,367,435,347
"740490408",225,259,484,182,235,181
"740490406",619,694,1313,437,510,429
"740210401",135,140,275,87,129,84
"740070414",547,553,1100,331,434,313
"740351605",335,359,694,192,194,175
"740351407",599,612,1211,315,322,311
"740351301",427,467,894,281,292,279
"740351215",541,540,1081,252,258,242
"740351206",417,495,912,234,239,221
"740351102",473,494,967,217,230,204
"740351020",75,78,153,45,76,42
"740351012",254,305,559,201,151,122
"740351009",441,454,895,257,269,254
"740350907",533,553,1086,360,377,342
"740350902",378,455,833,274,320,272
"740350821",47,56,103,25,29,24
"740350805",797,756,1553,339,332,320
"740350715",277,331,608,205,234,201
"740070405",435,470,905,272,317,258
"740210109",231,210,441,142,385,136
"740210108",114,100,214,75,269,73
"740140503",315,283,598,165,183,155
"740140403",384,355,739,208,393,205
"740210305",690,761,1451,441,474,415
"740561903",11,5,16,5,5,5
"740630501",66,53,119,39,62,30
"740561804",21,11,32,13,16,13
"740561603",70,57,127,47,66,42
"740560201",88,67,155,62,72,57
"740490301",196,162,358,102,144,98
"740420601",26,8,34,23,36,23
"740420502",12,5,17,7,10,7
"740351805",61,38,99,29,49,29
"740280307",39,25,64,23,42,22
"740280305",64,38,102,40,56,40
"740210204",100,96,196,64,103,64
"740210103",65,54,119,48,88,48
"740280410",86,55,141,51,91,50
"740140406",48,19,67,28,48,25
"740140204",26,16,42,14,25,14
"740070506",153,111,264,76,110,76
"740070101",85,62,147,47,67,47
"740560101",54,47,101,34,39,34
"740420402",107,81,188,62,102,61
"740351502",226,208,434,135,182,134
"740210203",231,182,413,113,123,104
"740351212",208,240,448,181,262,176
"740561707",480,477,957,246,265,229
"740561204",808,874,1682,393,308,289
"740561108",266,312,578,259,293,227
"740560314",452,504,956,285,311,285
"740070408",417,481,898,266,314,262
"740630102",357,340,697,224,306,217
"740561507",637,652,1289,314,318,303
"740561502",471,517,988,227,194,187
"740561414",617,642,1259,313,306,276
"740560906",457,495,952,262,281,256
"740560812",525,519,1044,291,298,285
"740560811",282,281,563,177,186,171
"740560803",361,423,784,228,235,209
"740560722",401,414,815,240,224,207
"740560720",485,508,993,308,167,153
"740560709",429,505,934,298,318,294
"740560511",161,152,313,127,187,127
"740560508",523,548,1071,310,377,301
"740561403",385,492,877,302,354,275
"740561207",364,358,722,228,196,170
"740561112",226,348,574,228,312,217
"740561106",243,299,542,265,356,257
"740561010",495,516,1011,301,323,285
"740561007",557,631,1188,320,320,310
"740560915",457,478,935,282,300,275
"740560914",371,416,787,226,255,220
"740560913",119,103,222,67,93,67
"740560912",279,306,585,161,179,160
"740560911",375,406,781,227,238,224
"740560503",178,199,377,102,119,100
"740560605",638,602,1240,362,339,313
"740560604",423,449,872,224,213,207
"740560502",523,570,1093,347,411,340
"740490305",326,339,665,230,360,225
"740560703",52,41,93,25,24,21
"740560616",378,371,749,250,244,217
"740560515",76,57,133,32,27,26
"740490211",240,251,491,132,154,131
"740490210",319,308,627,187,220,178
"740420603",520,520,1040,308,341,292
"740560204",825,845,1670,499,344,296
"740420206",153,147,300,84,97,83
"740420202",177,172,349,106,116,105
"740351602",322,333,655,210,220,193
"740350601",136,113,249,73,101,65
"740350820",319,325,644,193,195,186
"740280403",454,499,953,321,362,314
"740560316",582,631,1213,339,368,334
"740560306",548,571,1119,329,350,320
"740490418",291,339,630,186,274,182
"740560301",15,5,20,9,38,9
"740490407",320,354,674,243,306,234
"740280108",97,95,192,63,73,60
"740070406",397,375,772,224,286,215
"740351208",547,564,1111,278,288,260
"740351113",427,429,856,218,200,187
"740351105",243,267,510,169,197,165
"740351011",409,432,841,289,305,277
"740350917",540,496,1036,275,274,239
"740350910",432,487,919,330,394,323
"740350909",296,331,627,262,322,216
"740350812",381,367,748,212,223,212
"740350711",483,469,952,246,245,235
"740350705",343,349,692,218,191,159
"740350703",535,525,1060,297,297,266
"740070404",456,492,948,248,305,229
"740210110",146,153,299,90,138,89
"740210107",125,121,246,79,296,78
"740140405",277,246,523,182,472,176
"740140304",84,78,162,52,60,51
"740490203",80,71,151,51,76,51
"740490202",137,96,233,59,33,21
"740490105",91,68,159,41,45,40
"740420304",408,405,813,235,265,226
"740420203",32,8,40,19,30,19
"740351503",104,79,183,55,73,53
"740350602",143,118,261,78,110,70
"740350501",57,23,80,35,56,30
"740350305",31,21,52,21,39,21
"740350205",25,22,47,13,20,13
"740350201",16,16,32,10,15,10
"740350102",24,15,39,13,19,13
"740350202",15,9,24,6,16,6
"740140103",40,30,70,26,28,26
"740070302",49,35,84,24,34,24
"740070201",123,95,218,67,81,65
"740560103",73,69,142,56,58,54
"740351610",683,733,1416,358,370,354
"740561006",557,604,1161,321,336,307
"740350203",45,46,91,26,72,24
"740280206",269,281,550,188,272,185
"740561512",607,600,1207,291,304,279
"740561413",386,436,822,285,326,267
"740561407",346,366,712,205,209,187
"740560903",491,532,1023,273,280,270
"740560806",195,195,390,99,102,97
"740560724",354,383,737,224,230,205
"740560719",507,522,1029,286,289,264
"740561305",263,323,586,238,311,218
"740561220",520,451,971,280,224,194
"740561206",476,513,989,241,218,200
"740561203",863,876,1739,426,413,401
"740561111",205,219,424,204,274,198
"740561102",598,638,1236,360,367,342
"740561018",368,496,864,341,376,287
"740561009",248,263,511,133,147,111
"740561008",346,391,737,217,223,213
"740561004",453,451,904,275,274,248
"740560504",309,316,625,212,251,209
"740560606",785,724,1509,413,433,392
"740560617",567,597,1164,384,400,342
"740560206",604,644,1248,334,226,208
"740490206",442,462,904,253,292,246
"740351507",47,27,74,22,22,19
"740280409",92,86,178,66,97,66
"740560710",682,739,1421,376,367,326
"740560105",303,286,589,175,213,170
"740490403",306,303,609,197,289,191
"740280104",275,309,584,175,182,165
"740280103",461,467,928,294,321,277
"740280102",603,584,1187,330,360,317
"740351608",377,381,758,235,240,218
"740351207",473,444,917,246,242,212
"740351110",436,510,946,306,335,298
"740351108",198,222,420,176,216,165
"740351103",445,438,883,263,263,231
"740351015",236,294,530,200,215,194
"740351013",320,373,693,232,179,145
"740350912",296,328,624,247,325,240
"740350911",421,453,874,318,365,295
"740350807",306,291,597,155,147,137
"740350802",344,330,674,157,166,150
"740350710",622,639,1261,343,358,324
"740351004",404,448,852,276,240,196
"740070403",300,312,612,157,168,141
"740210111",158,139,297,84,110,82
"740350709",416,445,861,224,236,218
"740630303",144,110,254,80,98,80
"740630201",153,134,287,74,85,72
"740561805",15,6,21,5,9,5
"740490302",70,52,122,43,59,42
"740490212",74,61,135,44,68,44
"740351802",80,44,124,37,42,37
"740351702",111,77,188,65,105,60
"740351501",16,15,31,11,17,11
"740350604",22,15,37,13,20,12
"740280304",130,94,224,75,110,73
"740210402",22,13,35,12,14,12
"740210301",22,16,38,16,37,16
"740210201",109,79,188,56,60,54
"740210104",41,34,75,26,31,26
"740210101",23,19,42,20,19,16
"740140502",78,66,144,36,40,36
"740140202",33,24,57,20,33,20
"740140101",16,3,19,8,9,8
"780490503",542,374,916,243,378,224
"780420301",477,496,973,307,388,297
"780211116",259,273,532,194,208,178
"780141203",874,802,1676,473,516,455
"780141121",403,408,811,287,295,257
"780141116",425,371,796,282,269,227
"780211201",555,543,1098,381,392,371
"780140903",456,429,885,277,314,271
"780280512",77,76,153,29,48,28
"780280506",312,325,637,101,150,100
"780140218",708,650,1358,382,452,351
"780140203",1022,957,1979,574,572,505
"780211412",387,361,748,221,243,216
"780211410",606,617,1223,355,343,309
"780211320",1121,1067,2188,581,658,550
"780211207",630,638,1268,371,386,353
"780211205",598,639,1237,437,462,420
"780211102",284,280,564,198,267,197
"780211101",310,346,656,246,297,244
"780210805",532,505,1037,327,339,287
"780210803",260,112,372,12,11,11
"780210706",110,115,225,65,162,43
"780211316",76,83,159,55,87,52
"780211315",820,961,1781,446,459,409
"780211310",588,577,1165,322,359,310
"780211220",664,656,1320,386,420,368
"780211218",321,304,625,201,245,200
"780140103",798,728,1526,495,566,448
"780211406",550,558,1108,364,398,340
"780070501",570,516,1086,320,349,304
"780350602",713,632,1345,410,515,398
"780350404",665,609,1274,379,432,357
"780420304",413,404,817,294,432,282
"780420303",160,167,327,126,156,120
"780141110",386,412,798,249,293,245
"780420202",335,353,688,190,225,172
"780490301",142,25,167,20,46,20
"780490101",105,24,129,40,81,39
"780140302",34,9,43,22,58,22
"780140601",28,7,35,17,60,17
"780140201",444,17,461,37,73,34
"780140101",56,6,62,30,63,28
"780210301",89,15,104,88,73,63
"780211204",491,451,942,285,297,277
"780350603",737,671,1408,404,499,390
"780140217",504,471,975,283,326,245
"780141105",216,230,446,170,238,165
"780140505",1084,1044,2128,606,583,512
"780140805",653,652,1305,370,393,345
"780140804",670,599,1269,410,439,375
"780141202",492,545,1037,341,362,328
"780140211",979,947,1926,478,480,452
"780140208",970,945,1915,463,511,389
"780211413",234,232,466,148,169,144
"780211408",535,554,1089,339,352,321
"780211118",382,439,821,235,248,217
"780211117",210,234,444,172,222,169
"780211114",476,431,907,266,312,253
"780211112",507,508,1015,292,313,284
"780211106",333,351,684,257,343,254
"780211104",175,196,371,157,201,154
"780211122",533,523,1056,316,343,303
"780211014",504,501,1005,333,348,316
"780211007",199,211,410,168,214,167
"780211005",235,244,479,182,256,180
"780210902",1126,1038,2164,623,692,573
"780211121",346,329,675,219,207,187
"780210405",707,651,1358,430,860,403
"780210402",79,58,137,49,152,42
"780141124",310,292,602,206,232,202
"780140109",1234,1180,2414,695,648,567
"780140106",1264,1082,2346,626,764,609
"780490103",141,125,266,88,157,88
"780141109",396,429,825,288,339,284
"780350101",16,2,18,15,31,15
"780210201",59,30,89,29,71,29
"780350402",395,318,713,250,341,213
"780070101",24,11,35,19,30,19
"780490201",37,11,48,30,64,30
"780490501",959,901,1860,529,585,507
"780420306",860,859,1719,538,626,523
"780350601",338,303,641,208,234,194
"780280701",484,438,922,198,265,175
"780210705",18,9,27,8,14,7
"780141201",496,474,970,303,340,275
"780140904",375,371,746,247,272,238
"780140216",904,951,1855,454,495,449
"780280402",168,114,282,86,106,81
"780141208",510,535,1045,351,360,311
"780141107",320,322,642,219,267,213
"780140913",633,637,1270,374,445,365
"780140909",547,541,1088,325,354,307
"780140802",665,604,1269,477,544,455
"780140801",325,266,591,214,234,197
"780140304",680,698,1378,357,642,349
"780280507",5,4,9,4,9,4
"780141125",324,339,663,219,250,215
"780140204",777,806,1583,419,403,372
"780211415",456,431,887,278,329,234
"780211404",392,421,813,236,234,217
"780211115",468,475,943,321,373,297
"780211109",436,461,897,298,360,287
"780211108",198,256,454,186,232,163
"780211002",677,601,1278,429,427,395
"780210901",862,783,1645,513,590,452
"780210804",416,377,793,265,295,261
"780210703",49,6,55,7,12,7
"780211314",500,496,996,252,262,231
"780211312",1118,1243,2361,583,652,567
"780211309",611,613,1224,333,362,303
"780211303",356,349,705,176,179,159
"780140104",929,842,1771,514,549,478
"780490102",19,14,33,13,16,7
"780211203",353,343,696,242,237,225
"780280501",43,16,59,22,26,22
"780280502",16,5,21,14,27,14
"780280102",62,10,72,25,24,20
"780140401",33,8,41,28,47,26
"780210501",58,8,66,35,40,34
"780420101",62,11,73,33,48,32
"780211219",386,384,770,216,228,207
"780141122",411,401,812,242,251,234
"780141120",799,744,1543,501,551,471
"780141104",443,428,871,291,358,281
"780140912",755,698,1453,382,423,364
"780140908",845,781,1626,485,509,466
"780140504",468,407,875,201,257,170
"780280103",858,769,1627,481,511,437
"780140305",982,1079,2061,529,592,515
"780140221",811,856,1667,455,581,440
"780140212",990,1039,2029,546,610,537
"780140206",771,750,1521,408,460,391
"780211414",714,697,1411,404,441,381
"780211319",284,277,561,159,148,134
"780211318",290,266,556,188,269,185
"780211210",600,470,1070,229,450,225
"780211209",530,544,1074,325,372,322
"780211206",238,231,469,161,198,152
"780211103",534,554,1088,371,465,368
"780211016",338,346,684,233,271,226
"780211015",228,245,473,192,258,192
"780211012",500,475,975,331,338,310
"780211010",661,663,1324,355,367,329
"780211008",476,483,959,328,383,325
"780211006",281,278,559,228,250,208
"780210807",942,979,1921,483,522,447
"780210801",620,582,1202,350,382,308
"780211307",957,986,1943,486,511,464
"780210404",64,18,82,1,5,1
"780140207",537,541,1078,326,369,308
"780070604",483,514,997,304,375,290
"780350403",706,670,1376,425,528,415
"780280702",496,435,931,296,368,275
"780210701",212,89,301,80,149,58
"780280101",25,10,35,17,19,16
"780210102",30,5,35,22,43,22
"780140502",110,14,124,26,61,25
"780490401",13,5,18,8,28,8
"780280601",20,5,25,19,42,19
"780420305",644,649,1293,422,492,378
"780350604",450,459,909,275,319,267
"780210704",444,233,677,143,92,82
"780141204",480,474,954,276,278,239
"780141117",409,418,827,262,278,247
"780141114",553,540,1093,360,372,327
"780141113",535,528,1063,345,381,327
"780141112",557,575,1132,385,428,371
"780141111",775,732,1507,408,429,366
"780141103",231,200,431,149,175,144
"780141001",473,406,879,251,288,243
"780140914",543,493,1036,324,348,291
"780140507",676,703,1379,382,417,359
"780140403",265,155,420,107,127,104
"780280514",735,717,1452,424,498,400
"780280513",1005,975,1980,612,727,575
"780280511",20,18,38,15,54,14
"780140220",601,536,1137,359,452,343
"780140213",810,754,1564,453,440,401
"780140210",687,704,1391,376,415,359
"780140205",683,696,1379,426,443,406
"780211405",364,376,740,225,224,204
"780211401",708,747,1455,391,387,347
"780211214",394,415,809,257,265,238
"780211213",350,347,697,201,207,192
"780211110",245,295,540,179,206,176
"780211011",556,541,1097,342,371,326
"780211001",390,392,782,244,270,241
"780211306",1042,1090,2132,531,590,501
"780211301",545,525,1070,328,386,283
"780211217",356,431,787,222,233,216
"780210403",62,66,128,47,108,43
"780420203",271,329,600,145,146,140
"780490502",995,726,1721,458,519,448
"780280706",515,538,1053,280,328,274
"780280705",407,437,844,272,279,239
"780070302",19,1,20,14,50,14
"780350301",141,9,150,22,44,15
"780420201",516,31,547,15,27,15
"780420307",564,566,1130,335,370,315
"780350605",192,122,314,104,146,99
"780280504",1351,1297,2648,763,840,718
"780211211",367,375,742,236,256,225
"780140303",131,119,250,74,87,71
"780140222",779,861,1640,411,501,312
"780141207",702,414,1116,300,365,279
"780141205",362,323,685,240,292,223
"780141123",377,362,739,234,264,223
"780141119",313,307,620,226,256,221
"780141118",234,220,454,139,151,131
"780140907",415,399,814,262,258,223
"780140906",770,727,1497,495,519,455
"780140902",812,709,1521,490,538,429
"780140506",588,625,1213,296,305,263
"780280509",75,48,123,40,55,40
"780140209",339,243,582,216,376,195
"780211123",530,538,1068,302,280,262
"780140202",629,571,1200,337,393,329
"780211411",419,438,857,239,209,176
"780211403",480,488,968,269,286,260
"780211322",670,738,1408,360,385,356
"780211321",630,591,1221,338,376,322
"780211105",699,631,1330,401,413,356
"780211313",293,287,580,189,255,175
"780211304",660,664,1324,443,560,423
"780211221",1110,1168,2278,557,584,546
"780210702",175,118,293,90,93,87
"780210406",79,64,143,44,87,40
"780070602",874,896,1770,528,599,504
"780141108",721,629,1350,457,529,408
"780420302",492,543,1035,402,509,390
"780070505",1066,895,1961,517,562,491
"780280401",51,13,64,24,40,24
"780280201",7,4,11,9,14,9
"780210101",255,32,287,77,122,77
"780140701",49,3,52,16,65,16
"780350501",72,7,79,13,12,3
"780141106",297,306,603,234,291,226
"780070504",265,207,472,171,204,166
"780070502",712,728,1440,488,568,467
"780140911",588,569,1157,341,354,323
"780140910",668,599,1267,383,364,322
"780140803",690,591,1281,414,483,379
"780280510",592,592,1184,316,430,277
"780280508",53,25,78,16,52,12
"780280503",703,747,1450,473,677,453
"780141206",559,546,1105,394,435,341
"780211402",574,506,1080,340,358,324
"780211208",604,638,1242,366,387,352
"780211120",423,413,836,285,311,274
"780211119",163,141,304,118,152,116
"780211113",426,464,890,261,264,248
"780211111",319,336,655,244,229,203
"780211004",286,300,586,238,271,229
"780210903",1055,1056,2111,507,512,471
"780210806",663,599,1262,397,421,378
"780211317",931,914,1845,497,574,486
"780211407",643,619,1262,421,443,397
"780211311",530,555,1085,270,271,264
"780211305",857,831,1688,463,521,454
"780211302",399,334,733,213,273,206
"780211216",475,441,916,253,269,234
"780140108",874,787,1661,492,562,458
"780140105",546,479,1025,329,400,317
"780070603",495,465,960,312,385,296
"780070601",351,353,704,249,297,241
"780280703",640,652,1292,363,436,335
"780140301",26,6,32,25,41,23
"780140102",147,11,158,30,74,30
"780070301",14,0,14,12,31,12
"780210601",129,46,175,52,56,50
"780350401",37,10,47,31,54,31
"780350102",23,0,23,14,31,14
"780211202",304,306,610,206,212,195
"780141115",606,569,1175,441,458,388
"780141102",426,463,889,324,385,316
"780141101",766,738,1504,500,479,404
"780140905",533,459,992,375,409,347
"780140901",1036,1062,2098,575,574,521
"780140503",40,18,58,24,68,24
"780140402",182,144,326,102,120,98
"780280505",234,187,421,103,165,97
"780140219",843,778,1621,466,416,322
"780140215",75,16,91,8,8,8
"780140214",525,521,1046,295,392,290
"780211409",522,441,963,294,317,264
"780211215",360,368,728,226,233,208
"780211212",634,621,1255,401,446,384
"780211107",277,282,559,232,355,227
"780211013",334,297,631,222,250,211
"780211009",284,242,526,163,174,158
"780211003",298,338,636,235,257,218
"780210802",1167,1060,2227,631,740,586
"780211308",898,929,1827,448,489,422
"780140107",690,673,1363,396,462,373
"780070503",744,702,1446,455,594,424
"780280704",743,697,1440,498,589,469
"780140501",43,20,63,29,65,29
"780280301",12,1,13,12,27,9
"780070401",115,14,129,61,102,41
"780210401",329,74,403,117,191,92
"780070201",41,18,59,31,50,30
"780350201",417,36,453,21,42,21
"821330608",182,166,348,101,131,97
"821330312",143,109,252,76,89,74
"821120203",502,519,1021,276,332,242
"821050206",126,97,223,58,158,58
"821050108",470,464,934,255,321,183
"821050101",228,210,438,113,150,106
"820910615",314,282,596,177,218,165
"820846801",362,308,670,202,250,173
"820770309",448,415,863,247,373,236
"821120305",58,45,103,31,56,31
"820280208",127,152,279,84,129,83
"820210322",192,146,338,98,170,90
"820840301",272,212,484,136,104,98
"820770202",400,330,730,203,256,201
"820700714",95,90,185,54,92,51
"820910314",650,557,1207,337,396,321
"820560208",324,267,591,185,278,175
"820700505",370,389,759,193,238,177
"820630213",791,760,1551,459,479,391
"820630118",505,464,969,270,313,261
"820846109",854,922,1776,474,442,402
"820846107",752,748,1500,420,361,342
"820846105",363,377,740,247,266,236
"821330631",412,445,857,274,305,264
"821330629",926,944,1870,475,514,459
"821330604",702,817,1519,538,608,527
"821330212",807,792,1599,429,492,413
"821260302",466,522,988,366,411,360
"821260104",426,446,872,321,364,319
"820980409",294,317,611,211,249,202
"820910607",226,283,509,192,224,189
"820910601",835,850,1685,486,486,448
"820910504",453,537,990,361,409,356
"820910112",462,435,897,262,277,254
"820848908",327,266,593,155,157,139
"820848508",381,420,801,274,294,258
"820848501",1173,1092,2265,551,507,494
"820848415",463,435,898,260,293,240
"820848209",1073,1103,2176,579,479,459
"820848208",822,835,1657,468,454,422
"820848204",717,817,1534,371,367,349
"820848011",219,260,479,176,225,174
"820847504",226,238,464,154,162,137
"820846404",582,613,1195,390,412,365
"820845309",628,634,1262,358,358,341
"820845308",694,745,1439,444,451,415
"820845301",311,365,676,256,282,241
"820845214",738,778,1516,451,406,372
"820843307",484,522,1006,314,260,216
"820840421",926,874,1800,542,436,381
"820910308",371,435,806,283,296,278
"820845312",399,479,878,314,327,291
"820770312",317,383,700,255,294,252
"820700704",305,346,651,239,273,232
"820700524",701,719,1420,419,461,396
"820700305",462,523,985,377,442,352
"820700213",516,550,1066,393,434,386
"820630406",7,3,10,5,13,5
"820630307",608,636,1244,365,535,339
"820560401",664,661,1325,436,490,405
"820560218",484,510,994,338,353,328
"821190611",446,495,941,331,383,325
"821190602",361,398,759,269,311,268
"821190312",557,531,1088,304,243,233
"821190308",1211,1216,2427,666,642,611
"821190306",541,536,1077,313,311,290
"821190117",769,764,1533,437,472,415
"821190109",304,283,587,195,244,183
"821190107",275,281,556,183,192,163
"821120401",829,853,1682,446,449,431
"821120312",170,159,329,104,143,101
"821050516",349,365,714,228,255,226
"821050515",301,325,626,224,238,217
"821050506",472,518,990,338,383,329
"821050215",110,115,225,78,67,54
"821050119",421,452,873,288,325,284
"820490615",296,344,640,243,275,235
"820490614",226,295,521,192,226,187
"820280212",417,391,808,266,305,264
"820070215",282,308,590,217,251,214
"820848015",282,344,626,250,310,247
"820910213",81,80,161,50,63,50
"820700515",179,181,360,104,117,103
"820700317",385,455,840,293,328,282
"820700312",322,344,666,255,284,242
"820632909",612,658,1270,348,364,327
"820632705",357,429,786,283,355,279
"820844711",346,376,722,223,164,137
"820842311",344,431,775,405,601,389
"820844524",367,468,835,293,325,287
"820844523",494,577,1071,360,403,351
"820844520",478,488,966,276,283,252
"820844518",568,597,1165,371,388,343
"820844509",509,533,1042,353,364,334
"820844505",277,330,607,209,207,185
"820844703",566,499,1065,288,251,243
"820844701",533,529,1062,295,208,181
"820841909",368,480,848,354,595,351
"820844610",531,516,1047,314,317,299
"820844415",350,398,748,263,302,254
"820844413",366,443,809,316,370,311
"820846215",354,399,753,253,273,239
"820844406",309,437,746,228,307,226
"820844404",504,513,1017,268,281,251
"820844208",546,557,1103,297,195,170
"820844109",538,588,1126,342,333,313
"820844108",478,550,1028,336,385,323
"820844105",0,0,0,0,1,0
"821330414",443,478,921,265,303,259
"820980121",741,702,1443,416,433,383
"820843804",390,462,852,358,499,346
"820910211",310,355,665,205,229,198
"820843704",263,314,577,195,330,194
"820843701",373,476,849,364,455,351
"820842310",175,244,419,222,377,215
"820847602",121,132,253,81,131,79
"820846307",544,659,1203,346,334,320
"820842810",390,491,881,386,530,360
"820843916",167,183,350,162,220,157
"820632114",321,408,729,340,450,325
"820843910",194,230,424,177,242,168
"820843905",430,494,924,410,563,398
"820843902",232,292,524,213,268,201
"820843006",413,452,865,248,226,208
"820633504",327,338,665,230,251,227
"820843120",352,369,721,233,255,223
"820845516",479,480,959,272,260,224
"820845515",458,478,936,227,206,194
"820842104",360,454,814,367,504,346
"820632614",501,546,1047,309,328,293
"820490704",378,392,770,265,282,257
"820770206",843,774,1617,454,531,445
"820700415",782,790,1572,457,486,431
"820842919",306,325,631,240,344,227
"820842917",515,331,846,251,345,248
"820842013",302,333,635,307,403,297
"820842012",246,326,572,217,345,208
"820490409",154,165,319,80,86,78
"820842511",245,322,567,258,293,252
"820421114",317,372,689,283,343,277
"820842509",307,403,710,266,305,255
"820842507",244,324,568,263,318,262
"820842505",222,300,522,244,474,241
"820842502",178,295,473,230,356,207
"820630323",405,400,805,246,295,236
"820842806",23,37,60,29,42,28
"820842804",224,311,535,251,390,226
"820842716",256,332,588,257,399,252
"820630102",25,29,54,23,24,20
"820560212",187,185,372,127,141,107
"820842201",225,295,520,249,396,240
"820841809",241,330,571,264,310,244
"820841807",399,500,899,437,675,429
"820841411",233,261,494,165,177,150
"820842009",263,358,621,295,445,287
"820210106",435,469,904,332,385,324
"820841603",409,503,912,377,480,374
"820841508",326,411,737,245,263,227
"820842003",307,449,756,350,501,347
"820841715",352,423,775,375,575,359
"820841301",436,491,927,315,354,307
"820841221",603,642,1245,342,348,329
"820843508",402,390,792,244,149,118
"820843504",445,532,977,329,373,320
"820841118",440,499,939,325,367,305
"820843417",335,386,721,255,299,247
"820843416",720,761,1481,418,408,383
"820843410",406,432,838,304,371,292
"820843408",484,587,1071,392,413,332
"820843407",403,452,855,330,387,313
"820841110",840,854,1694,495,531,463
"820845202",526,582,1108,310,299,288
"820845112",365,414,779,262,301,250
"820845110",352,405,757,274,304,265
"820845001",448,484,932,311,351,281
"820844911",1453,1276,2729,746,480,426
"820844908",1110,1140,2250,579,558,538
"820843404",704,747,1451,384,281,264
"820845104",388,481,869,309,332,287
"820845111",437,522,959,356,357,305
"820210604",336,407,743,288,339,275
"820210603",308,387,695,292,420,291
"820210601",632,641,1273,334,337,320
"820210514",832,856,1688,446,454,406
"820210512",788,735,1523,399,343,333
"820210505",805,852,1657,507,500,450
"820844815",386,423,809,264,267,253
"820844810",542,578,1120,315,321,291
"820210404",473,517,990,346,375,328
"820210320",150,137,287,107,114,107
"820210304",161,169,330,103,118,100
"820210215",955,1012,1967,600,668,569
"820210503",639,618,1257,391,361,350
"820210408",419,536,955,362,409,343
"820210401",809,826,1635,510,499,468
"820210316",59,46,105,31,32,26
"821190418",319,330,649,234,261,222
"821190402",545,566,1111,308,244,214
"820848816",642,666,1308,388,389,355
"820210105",310,352,662,238,277,231
"820140608",519,528,1047,357,418,333
"820140503",558,624,1182,403,456,401
"820842407",293,298,591,273,395,258
"820848806",771,742,1513,409,278,253
"820845912",510,609,1119,394,444,376
"820140420",341,385,726,276,294,272
"820845805",756,731,1487,476,549,439
"820845803",541,568,1109,380,450,368
"820421106",514,520,1034,355,418,353
"820421015",595,603,1198,363,383,350
"820421010",809,783,1592,422,410,385
"820140506",507,531,1038,367,413,356
"820070410",354,361,715,242,277,233
"820140215",170,251,421,186,213,183
"820140212",262,261,523,177,213,168
"820140203",392,457,849,304,328,288
"820420915",254,314,568,226,253,222
"820421007",468,519,987,339,356,330
"820420926",327,392,719,258,297,254
"820420921",766,743,1509,481,527,464
"820420904",323,334,657,229,254,211
"820842617",183,240,423,194,274,187
"820420811",497,511,1008,296,331,290
"820420810",407,457,864,344,385,336
"820420808",316,383,699,302,435,295
"820420807",292,394,686,266,369,260
"820420714",446,537,983,376,423,351
"820420705",647,735,1382,440,450,425
"820420622",292,341,633,229,265,225
"820420620",501,520,1021,352,434,347
"820420619",552,508,1060,314,392,310
"820420617",377,392,769,233,238,210
"820420606",558,624,1182,400,477,396
"820420918",313,399,712,304,415,298
"820140303",444,552,996,434,491,406
"820420411",217,257,474,159,182,154
"820420408",631,619,1250,390,448,386
"820420406",385,455,840,337,392,330
"820842615",264,303,567,299,404,291
"820848608",493,579,1072,309,280,248
"820420323",429,421,850,287,306,271
"820420317",315,370,685,251,312,250
"820848602",652,722,1374,461,484,432
"821050410",674,625,1299,397,433,381
"820070305",652,682,1334,400,350,320
"820631204",713,723,1436,398,339,314
"820631114",515,588,1103,276,260,231
"820140114",525,541,1066,374,418,367
"820140108",420,416,836,277,299,273
"820070312",542,631,1173,409,494,399
"821050411",286,382,668,270,303,262
"820420108",654,664,1318,439,442,418
"820350210",560,611,1171,375,444,363
"820840602",398,507,905,347,368,328
"820631306",335,375,710,234,265,225
"820631112",429,466,895,234,231,219
"820631203",286,288,574,170,164,157
"820070306",629,612,1241,353,364,331
"820842410",199,234,433,189,232,182
"820631201",541,559,1100,356,370,327
"820420222",464,500,964,310,339,299
"820842402",261,337,598,275,365,254
"820560116",299,297,596,215,249,214
"820631012",306,360,666,210,214,196
"820631005",363,386,749,234,248,227
"820630903",515,613,1128,385,403,355
"820842401",185,218,403,195,320,193
"820842323",242,289,531,225,314,221
"820630809",317,402,719,266,288,258
"820630802",385,500,885,325,352,321
"820630702",328,398,726,248,265,242
"820630603",567,682,1249,419,443,409
"820630601",754,808,1562,405,413,387
"820840412",456,543,999,309,318,293
"820631004",339,401,740,222,210,198
"820840308",852,810,1662,479,482,450
"820840505",796,985,1781,662,531,419
"821050311",344,357,701,234,248,223
"820770314",360,412,772,248,288,235
"820770304",868,926,1794,525,559,490
"820280415",471,543,1014,315,309,289
"820280414",639,672,1311,396,410,381
"821330201",535,517,1052,289,366,286
"821260515",504,563,1067,312,322,308
"820630231",494,555,1049,306,325,287
"820491013",487,487,974,271,292,268
"820491012",615,621,1236,325,356,317
"821050308",617,631,1248,409,455,380
"820630410",1792,2048,3840,1221,870,820
"821330416",531,585,1116,281,290,257
"821260504",344,447,791,320,355,306
"820910402",113,132,245,80,103,80
"820700607",318,312,630,220,264,212
"820490817",104,73,177,48,53,47
"821260508",312,402,714,297,356,292
"820910616",204,233,437,175,207,175
"820841705",290,312,602,226,283,219
"820700104",487,550,1037,329,337,277
"820633412",800,807,1607,445,415,401
"820633405",2810,2954,5764,1517,1444,1377
"820633402",740,744,1484,383,384,366
"820633303",609,615,1224,324,315,297
"820700408",210,281,491,215,274,211
"820700404",505,515,1020,354,387,341
"820633205",702,677,1379,335,333,314
"820633114",613,722,1335,371,358,339
"820841916",185,272,457,197,318,191
"820490708",694,737,1431,435,467,427
"820490706",620,703,1323,430,433,394
"820848301",505,531,1036,352,393,346
"820630204",538,599,1137,333,359,314
"820848305",398,470,868,320,370,304
"820633004",261,296,557,198,225,194
"820633003",273,324,597,219,262,215
"820490608",1382,1272,2654,578,472,450
"821260201",575,578,1153,392,432,384
"820490329",532,553,1085,348,371,335
"820632813",127,23,150,7,10,7
"820632812",9,7,16,4,8,3
"820632510",361,425,786,295,335,279
"820632507",225,293,518,183,202,172
"820632413",185,230,415,179,233,177
"820840903",278,332,610,226,259,222
"820632313",129,196,325,147,205,145
"820632312",337,420,757,283,323,257
"820490301",610,603,1213,344,288,262
"820840807",535,513,1048,359,370,322
"820700715",555,608,1163,376,425,366
"820632307",168,208,376,156,196,155
"820632205",119,158,277,152,236,150
"820632109",368,476,844,354,422,344
"820632012",414,467,881,306,325,287
"820631905",313,340,653,238,271,234
"820631903",534,642,1176,374,400,355
"820631808",337,445,782,347,539,336
"820631807",456,573,1029,474,662,454
"820631711",400,451,851,311,366,306
"820631506",240,268,508,189,216,186
"820631702",629,712,1341,457,519,445
"820631701",403,524,927,355,415,350
"820631610",667,744,1411,378,417,360
"820631401",349,430,779,301,363,291
"820631317",490,560,1050,371,402,358
"820631409",383,479,862,359,430,349
"820631301",400,425,825,272,301,262
"820631215",493,511,1004,251,167,160
"820490124",579,624,1203,394,396,338
"820840724",463,500,963,266,251,237
"820700710",371,383,754,233,258,219
"820848211",727,761,1488,411,403,376
"820840710",285,329,614,215,243,205
"820840702",576,567,1143,330,322,306
"820840623",609,651,1260,322,282,270
"820840612",497,549,1046,372,411,356
"820848112",362,436,798,301,339,283
"820560513",414,442,856,270,330,262
"820630125",540,587,1127,317,329,303
"820848107",356,367,723,260,294,246
"820848102",307,357,664,249,293,243
"820560507",892,898,1790,495,491,452
"820560502",743,832,1575,510,550,500
"820560306",346,394,740,258,313,249
"820848019",312,362,674,267,323,253
"820847803",425,449,874,284,307,277
"820845710",615,649,1264,408,698,385
"820845701",98,88,186,64,93,64
"820845509",411,457,868,279,299,262
"820560118",262,251,513,137,231,102
"820845408",486,479,965,300,313,281
"820845407",322,330,652,192,204,183
"820845319",407,443,850,292,227,196
"820845313",238,284,522,174,184,162
"820845213",568,602,1170,337,314,310
"821190813",498,520,1018,329,310,280
"821190809",359,456,815,287,312,269
"820841107",785,844,1629,475,497,451
"821190807",547,574,1121,337,345,323
"821190806",277,319,596,203,217,189
"821190805",1008,1034,2042,531,344,314
"820490108",731,752,1483,438,454,417
"820841016",235,229,464,160,174,150
"820910102",509,588,1097,383,436,366
"821190708",432,440,872,297,310,285
"821190707",240,300,540,188,214,183
"821190702",763,724,1487,419,426,392
"820421213",415,479,894,316,322,281
"820421211",433,479,912,342,409,338
"820421120",398,411,809,262,296,262
"820847719",469,548,1017,328,349,321
"820846302",774,822,1596,416,405,386
"820421115",391,474,865,317,365,309
"820849010",487,506,993,313,452,300
"820211016",327,380,707,280,314,272
"820846208",583,663,1246,399,373,348
"820846206",798,757,1555,422,385,354
"820846218",859,905,1764,499,461,436
"820280105",919,949,1868,595,648,583
"821190424",533,508,1041,328,315,270
"820210910",262,280,542,191,211,179
"820210909",346,359,705,264,305,249
"820210912",673,658,1331,425,419,396
"820210805",374,433,807,305,333,292
"820210802",350,448,798,342,416,321
"820210725",341,377,718,213,198,185
"820210719",525,456,981,239,236,224
"820210716",63,49,112,29,23,11
"821330523",57,47,104,26,37,26
"821330513",17,2,19,8,12,8
"821330508",11,10,21,7,12,7
"821330504",221,188,409,109,131,107
"821330304",28,17,45,13,17,13
"821330217",28,17,45,18,34,18
"821260215",213,171,384,99,151,98
"821260211",78,54,132,36,63,34
"821260111",96,63,159,53,126,52
"821190914",74,71,145,47,52,41
"821190501",77,62,139,45,74,44
"821120307",130,108,238,77,125,77
"821120216",203,162,365,98,162,96
"821120212",70,52,122,38,87,38
"821120106",93,78,171,49,149,49
"821050207",39,33,72,20,58,20
"821050113",63,44,107,38,79,38
"821050109",386,333,719,199,250,195
"820980308",92,81,173,43,63,42
"820980111",59,60,119,39,51,38
"820980110",53,38,91,30,44,30
"820980105",69,40,109,41,65,41
"820910412",69,71,140,35,67,34
"820910111",187,148,335,88,136,88
"820847707",8,4,12,4,24,4
"820847502",22,15,37,12,21,12
"820630309",492,503,995,325,454,318
"821330515",34,31,65,22,28,19
"821330503",16,15,31,9,12,8
"821120313",145,101,246,83,154,76
"821330622",50,33,83,20,25,19
"820845804",49,45,94,31,27,20
"820700606",135,114,249,74,91,72
"821330317",34,31,65,20,34,20
"820910204",119,85,204,61,120,58
"821330527",41,20,61,19,31,17
"821330526",21,6,27,13,14,13
"820210323",78,88,166,37,67,35
"820140414",8,4,12,5,52,5
"820421102",30,24,54,20,54,20
"820210132",166,149,315,84,123,81
"820420321",53,58,111,29,44,27
"820210117",160,152,312,82,103,70
"820210111",186,143,329,88,103,85
"820280213",21,14,35,15,59,14
"820350204",29,29,58,18,38,16
"820350104",15,13,28,9,30,9
"820350102",491,456,947,249,306,232
"820840213",25,21,46,14,22,14
"820560102",107,93,200,61,105,61
"821330106",6,1,7,3,5,3
"821050106",40,36,76,24,59,23
"820700217",133,105,238,62,81,61
"820490805",16,13,29,10,18,10
"821260214",62,63,125,38,62,36
"820700506",101,86,187,48,82,47
"820490819",156,134,290,80,90,79
"821260113",144,129,273,64,97,60
"820770405",8,5,13,5,10,5
"820630106",193,162,355,102,167,101
"820700518",202,194,396,120,158,117
"820980103",18,10,28,7,11,7
"820490401",89,72,161,42,45,41
"820280115",15,16,31,13,92,12
"820849501",5,4,9,3,7,3
"820429101",21,20,41,15,67,15
"820490315",222,190,412,107,73,69
"821050209",141,109,250,73,149,73
"820847201",89,85,174,48,62,47
"820846901",102,99,201,64,86,59
"820846504",366,367,733,244,552,201
"820630322",580,585,1165,333,631,321
"820560112",228,214,442,141,341,130
"820490803",228,244,472,126,135,119
"820210212",762,720,1482,428,559,394
"820140516",40,29,69,23,95,23
"820350108",202,172,374,100,107,95
"820840201",429,377,806,223,150,116
"820630214",139,123,262,76,109,71
"820700512",463,429,892,256,338,253
"820490308",1459,1375,2834,750,391,335
"820070209",166,138,304,98,173,95
"820350209",603,541,1144,325,546,317
"820490120",28,19,47,16,28,16
"820700102",160,147,307,92,131,90
"820632825",262,240,502,163,339,154
"820490328",185,180,365,113,102,97
"820210701",366,310,676,234,283,230
"820210706",326,341,667,226,253,215
"821330533",592,604,1196,341,401,339
"821330619",954,1037,1991,610,568,482
"821330620",954,987,1941,510,503,444
"821330413",614,552,1166,307,336,302
"821330219",491,504,995,264,316,260
"821260208",671,709,1380,490,549,486
"821260207",627,636,1263,400,413,383
"821260202",464,444,908,331,377,326
"821191007",758,734,1492,399,395,357
"821191002",264,366,630,221,249,210
"821190906",863,861,1724,518,535,479
"821190905",384,380,764,216,168,135
"821120408",412,466,878,342,394,328
"820980118",596,619,1215,422,450,391
"820980117",98,85,183,55,78,54
"820910605",305,373,678,273,316,264
"820910302",429,442,871,303,347,298
"820849002",985,964,1949,523,556,468
"820848909",760,825,1585,432,390,356
"820848503",595,568,1163,317,267,250
"820848416",180,135,315,78,78,76
"820848006",270,310,580,214,272,209
"820848002",453,473,926,361,504,351
"820848014",305,362,667,249,341,242
"820847714",303,328,631,234,246,223
"820847503",189,203,392,135,152,128
"820847204",270,306,576,199,226,198
"820846503",934,1002,1936,576,581,510
"820848013",361,425,786,315,387,311
"820846904",1059,1076,2135,585,638,564
"820845311",284,327,611,223,245,201
"820843605",211,243,454,164,209,164
"820840208",706,786,1492,454,535,438
"820840501",538,666,1204,420,311,252
"820700706",277,320,597,240,263,235
"820700601",779,754,1533,515,554,509
"820840205",441,446,887,265,296,253
"820700307",394,405,799,252,272,248
"820632616",649,634,1283,292,171,157
"820630405",217,181,398,99,64,58
"820630403",194,237,431,135,123,116
"820630612",425,439,864,250,253,237
"820630611",421,477,898,263,236,218
"820630407",658,671,1329,331,267,253
"820633112",712,727,1439,358,362,334
"820560311",742,796,1538,541,608,532
"820560214",243,241,484,147,161,142
"820490914",511,540,1051,303,316,294
"820491002",417,441,858,260,290,256
"821190902",485,469,954,260,152,140
"821190515",953,974,1927,540,622,526
"821190110",714,735,1449,435,599,426
"821120416",401,466,867,299,343,293
"821120414",385,430,815,305,344,302
"821120402",335,387,722,253,277,246
"821120217",488,455,943,270,305,268
"821120205",280,283,563,169,147,108
"821050513",606,630,1236,417,455,406
"821050508",530,522,1052,306,395,298
"821050502",532,539,1071,356,407,344
"821050229",275,321,596,223,271,218
"821050222",581,611,1192,380,416,371
"821050116",437,470,907,278,289,264
"820490512",596,586,1182,309,312,291
"820490515",475,503,978,293,293,267
"820280207",381,404,785,287,337,282
"820490611",383,403,786,290,350,270
"820842702",231,340,571,277,429,276
"820632110",128,124,252,101,130,99
"820700111",719,751,1470,478,528,463
"820632908",559,521,1080,295,300,276
"820845207",830,834,1664,444,456,436
"820845206",728,725,1453,371,368,345
"820844805",473,509,982,280,193,180
"820844802",619,737,1356,392,292,279
"820844801",906,954,1860,539,558,524
"820844715",452,441,893,255,225,205
"820844710",710,777,1487,428,292,274
"820844521",284,302,586,191,204,176
"820844508",324,368,692,241,245,231
"820841818",339,456,795,280,421,269
"820844501",345,442,787,263,260,243
"820844306",308,352,660,256,278,241
"820844207",654,687,1341,374,254,227
"820844112",493,534,1027,295,310,272
"820844103",373,410,783,263,202,156
"820844101",386,432,818,295,354,288
"820844010",367,403,770,301,378,288
"820844005",703,733,1436,381,290,280
"820844002",313,383,696,323,459,321
"821260206",362,367,729,225,237,212
"820980120",375,340,715,252,286,246
"820980119",526,516,1042,280,299,265
"820843806",336,393,729,298,397,295
"820843711",229,289,518,242,320,227
"820843706",318,440,758,352,497,334
"820843204",443,517,960,327,367,318
"820847402",400,396,796,267,285,262
"820846704",407,428,835,273,319,266
"820842307",286,381,667,319,442,318
"820844803",511,580,1091,363,373,347
"820843115",326,388,714,257,289,247
"820842102",363,420,783,303,425,285
"820844015",257,338,595,224,282,221
"820843913",363,428,791,310,382,301
"820842814",142,193,335,160,238,158
"820843912",410,480,890,357,482,354
"821190105",758,771,1529,456,453,421
"820843812",389,371,760,243,208,168
"820842920",246,295,541,222,309,220
"820843007",767,790,1557,438,441,413
"820841307",334,360,694,196,164,135
"820840601",300,370,670,245,242,222
"820842017",122,144,266,118,194,115
"820840211",562,601,1163,309,285,272
"820770402",297,333,630,193,250,193
"820633508",328,408,736,318,413,316
"820633503",427,429,856,236,240,232
"820842912",292,429,721,269,424,263
"820842908",329,403,732,305,429,286
"820842907",310,372,682,303,452,293
"820700207",262,283,545,192,223,188
"820700203",151,159,310,89,92,88
"820700101",423,441,864,288,323,281
"820842609",119,170,289,146,222,146
"820842602",257,372,629,220,296,218
"820842516",94,135,229,78,110,77
"820490201",417,448,865,261,276,249
"820421103",205,168,373,115,143,114
"820842506",289,409,698,343,420,330
"820842504",242,265,507,172,259,171
"820842008",148,236,384,227,339,226
"820842015",118,168,286,128,176,127
"820842905",348,455,803,379,510,366
"820842821",184,254,438,206,345,202
"820630319",780,842,1622,474,474,397
"820842803",141,211,352,187,324,186
"820630215",128,140,268,78,109,78
"820842714",271,308,579,231,347,229
"820560206",554,543,1097,339,353,329
"820842202",197,285,482,260,399,251
"820842115",164,231,395,197,296,193
"820842112",127,166,293,149,225,146
"820280316",304,328,632,229,276,225
"820211004",73,69,142,44,58,44
"820210801",211,266,477,202,286,195
"820210703",63,55,118,45,74,45
"820842207",311,416,727,334,429,320
"820841408",410,479,889,306,328,291
"820841205",499,520,1019,308,323,288
"820841114",588,565,1153,339,238,217
"820843612",825,1007,1832,626,663,607
"820843502",205,229,434,151,136,106
"820841204",739,746,1485,381,339,323
"820841201",697,713,1410,433,386,368
"820843415",490,515,1005,316,247,237
"820843413",247,260,507,174,217,173
"820843401",483,533,1016,306,121,110
"820841923",140,176,316,157,217,116
"820843606",174,217,391,163,229,160
"820843317",747,736,1483,423,367,341
"820845004",602,660,1262,388,400,372
"820844915",568,548,1116,306,280,272
"820843402",689,722,1411,381,367,346
"820844906",321,354,675,204,180,145
"820845108",517,580,1097,380,355,345
"820845101",545,571,1116,380,403,358
"820844806",806,560,1366,269,243,235
"820210510",215,305,520,207,292,200
"820210509",297,347,644,251,339,241
"820210504",434,425,859,277,275,255
"820210317",521,567,1088,373,441,366
"820210309",11,25,36,10,21,10
"820210211",444,494,938,309,309,287
"820210203",479,541,1020,389,394,365
"820848815",469,506,975,262,268,240
"820848814",416,381,797,269,326,253
"820210419",771,739,1510,404,404,386
"820210411",345,444,789,315,347,306
"820210410",175,222,397,160,237,154
"820848804",405,468,873,304,358,293
"820842313",312,390,702,322,468,319
"821050420",368,414,782,272,285,259
"820848801",739,739,1478,394,231,203
"820848712",394,412,806,246,254,231
"820140524",261,259,520,174,214,173
"820845911",757,677,1434,410,354,322
"820845802",649,655,1304,453,553,418
"820848704",447,587,1034,395,472,392
"820421016",924,871,1795,443,447,419
"820421014",313,350,663,228,237,213
"820140510",444,542,986,358,381,343
"820140208",333,383,716,263,314,255
"820420910",193,239,432,194,261,189
"820420925",346,412,758,293,331,289
"820420907",494,566,1060,400,438,393
"820420806",398,505,903,364,402,298
"820420805",418,548,966,410,536,369
"820420803",218,294,512,241,399,237
"820420802",397,507,904,364,495,354
"820420801",385,440,825,297,388,288
"820420716",660,743,1403,441,483,428
"820420713",259,326,585,247,319,245
"820420706",481,573,1054,387,435,375
"820140412",508,559,1067,340,337,308
"820140410",478,489,967,285,287,262
"820140408",608,599,1207,377,357,319
"820140404",488,476,964,328,365,317
"820140403",490,502,992,346,363,338
"820140307",860,829,1689,473,489,432
"820140304",242,302,544,213,241,201
"820140219",440,426,866,261,308,259
"820420416",257,279,536,200,233,197
"820420407",269,306,575,238,257,231
"820420403",870,838,1708,473,490,460
"820848811",681,717,1398,467,510,444
"820848606",803,862,1665,484,504,462
"820848603",535,561,1096,335,358,317
"820420314",506,499,1005,315,353,313
"820420313",787,818,1605,552,567,529
"820420309",224,195,419,157,189,155
"820842404",276,428,704,320,447,294
"821050409",421,476,897,351,433,344
"821050408",259,350,609,250,310,240
"820070304",464,494,958,353,424,346
"820070303",451,536,987,376,502,372
"820070203",396,448,844,304,338,287
"820070202",549,578,1127,379,394,357
"820420215",614,689,1303,448,478,424
"820842612",133,181,314,173,313,169
"820842409",326,364,690,330,525,327
"820070406",393,490,883,297,308,280
"820848510",753,749,1502,421,456,411
"820140112",546,607,1153,410,464,399
"820140106",482,528,1010,371,400,354
"820140101",647,630,1277,428,486,401
"820070414",444,517,961,315,337,308
"820070308",368,392,760,262,292,258
"820420121",145,134,279,98,163,88
"820420112",400,463,863,309,363,302
"820420109",612,587,1199,411,454,403
"820420107",545,547,1092,322,341,315
"820420102",324,324,648,226,264,224
"820848410",914,976,1890,557,524,490
"820840517",437,537,974,355,400,338
"820631307",381,446,827,261,276,244
"820420206",606,576,1182,338,377,322
"821050316",519,585,1104,322,334,302
"820631101",764,816,1580,397,385,369
"820631011",597,649,1246,381,401,364
"820631006",348,429,777,257,274,235
"820630908",455,552,1007,366,383,350
"820630814",315,372,687,225,241,219
"820630813",240,303,543,219,227,198
"820631009",642,607,1249,347,320,298
"820630807",290,345,635,229,256,221
"820630713",532,532,1064,324,343,309
"820630710",379,381,760,275,283,238
"820630709",310,366,676,249,260,232
"820630706",615,697,1312,470,519,460
"820630704",540,644,1184,427,486,418
"820350112",532,538,1070,240,277,231
"820630602",565,565,1130,319,313,296
"820630509",1129,1117,2246,581,579,549
"820840512",237,276,513,181,213,174
"820840418",197,220,417,136,155,134
"820841812",213,262,475,226,309,214
"820630504",606,560,1166,321,298,292
"820840502",1146,1368,2514,876,787,642
"821050313",303,330,633,210,226,204
"820560105",576,597,1173,373,422,336
"820280514",641,652,1293,347,352,329
"820280412",511,555,1066,357,362,336
"820280408",352,396,748,253,288,246
"820280407",411,493,904,343,365,320
"821050309",1032,35,1067,17,18,17
"820630412",881,1015,1896,560,542,514
"821190301",130,129,259,68,48,34
"820630221",768,797,1565,491,512,463
"820280319",204,231,435,152,165,151
"821260503",588,635,1223,384,426,372
"821260319",573,593,1166,358,367,328
"820910319",372,412,784,279,302,264
"821260410",317,380,697,278,321,268
"820633410",406,424,830,250,254,234
"820848306",382,456,838,294,331,282
"820490907",331,380,711,239,254,230
"820700504",261,305,566,200,242,193
"820700416",636,661,1297,440,512,425
"820700410",728,684,1412,550,659,517
"820700409",304,365,669,255,308,250
"820700406",510,517,1027,312,334,297
"820700403",564,579,1143,393,440,373
"820633215",280,332,612,225,282,224
"820633214",415,508,923,287,324,281
"820633211",710,734,1444,396,395,361
"820490713",241,272,513,209,260,204
"820490709",521,641,1162,419,457,410
"820848307",380,420,800,290,317,287
"820630212",562,658,1220,394,427,380
"820490715",737,836,1573,486,526,475
"820490714",324,383,707,235,256,232
"820633011",487,558,1045,357,381,353
"820633008",694,781,1475,468,506,457
"820630126",788,863,1651,515,582,485
"820280301",1248,1169,2417,601,252,207
"820632818",503,512,1015,263,250,214
"820070402",250,282,532,198,242,194
"820632815",286,308,594,164,198,163
"820490331",411,476,887,327,348,318
"820632710",704,790,1494,469,528,457
"820632601",1130,1139,2269,572,550,536
"820632508",219,295,514,199,218,191
"820632506",455,454,909,278,209,169
"820632505",263,298,561,177,210,170
"820632501",356,391,747,206,195,172
"820632414",251,324,575,231,349,226
"820840906",360,427,787,284,316,264
"820840905",395,457,852,327,398,304
"820632513",308,338,646,228,262,218
"820632403",238,400,638,299,441,295
"820632314",348,405,753,305,392,294
"820840911",272,270,542,207,233,194
"820490302",626,631,1257,354,376,339
"820632305",276,344,620,251,341,247
"820632213",238,282,520,240,339,225
"820632202",291,283,574,241,417,237
"820632104",467,619,1086,462,595,446
"820632103",280,400,680,289,439,283
"820630615",395,469,864,282,312,276
"820631912",337,373,710,282,330,276
"820631910",752,775,1527,420,420,392
"820631901",540,555,1095,330,315,296
"820631811",274,417,691,369,496,336
"820631806",246,322,568,261,354,250
"820631804",287,405,692,283,377,264
"820631803",310,398,708,324,431,307
"820631710",365,404,769,291,311,281
"820631709",334,385,719,281,320,277
"820631813",159,211,370,178,261,176
"820631513",292,362,654,252,210,156
"820842318",206,278,484,234,308,230
"820631508",317,375,692,257,297,250
"820631503",374,471,845,297,354,291
"820631501",493,542,1035,357,430,349
"820631608",603,619,1222,373,374,331
"820631316",523,575,1098,398,440,389
"820631315",473,533,1006,362,389,351
"820631302",483,531,1014,356,374,339
"820631311",310,383,693,266,291,256
"820631211",428,475,903,316,240,188
"820840723",453,491,944,289,295,276
"820700712",534,522,1056,348,390,336
"820840718",599,599,1198,382,406,374
"820840709",760,847,1607,525,538,477
"820630105",496,561,1057,386,396,377
"820848109",412,505,917,329,363,325
"820560408",337,386,723,268,331,258
"820560405",492,571,1063,412,480,397
"820848022",302,347,649,340,518,298
"820845702",405,418,823,273,449,265
"820845706",177,171,348,112,181,111
"820845705",442,547,989,334,409,314
"820845505",537,620,1157,420,449,404
"820560202",492,508,1000,339,361,320
"820845413",266,332,598,197,220,195
"820845412",486,498,984,329,380,322
"820845411",487,592,1079,356,384,346
"820845320",314,344,658,209,223,206
"821190909",364,406,770,248,267,241
"821190814",671,710,1381,392,387,356
"821190811",364,390,754,239,225,207
"820280203",196,189,385,140,181,139
"820280201",865,969,1834,592,630,569
"820841102",274,313,587,195,223,186
"820841017",632,695,1327,425,379,305
"820841816",154,181,335,153,228,150
"820841011",1028,1041,2069,572,393,355
"820841010",827,892,1719,470,390,341
"820841008",750,764,1514,479,425,372
"820421208",567,611,1178,415,461,401
"820847720",512,599,1111,377,384,358
"820849012",485,503,988,325,468,309
"820846311",1089,1134,2223,565,508,482
"820421113",326,383,709,265,271,241
"820280102",283,336,619,238,269,235
"820211018",391,437,828,320,339,315
"820846212",564,608,1172,323,271,257
"820846204",458,491,949,280,243,227
"820846203",328,350,678,192,186,169
"820210812",223,281,504,198,240,197
"820210808",417,467,884,271,303,264
"820210804",344,431,775,321,394,307
"821190415",716,780,1496,419,421,385
"820210721",459,471,930,248,247,226
"820210724",458,449,907,255,277,246
"821330613",30,18,48,16,19,16
"821330520",25,16,41,15,22,15
"821330316",47,35,82,17,27,17
"821330315",37,40,77,22,31,20
"821330305",23,21,44,12,26,12
"821330214",74,65,139,40,45,36
"821330308",102,72,174,61,80,61
"821330210",13,10,23,5,9,5
"821330207",74,53,127,37,41,36
"821260305",217,220,437,131,187,120
"821190505",1,1,2,1,2,1
"821120306",87,65,152,47,82,45
"821120102",95,76,171,64,96,62
"820980305",117,96,213,73,99,73
"820980302",317,272,589,161,222,159
"820980116",94,94,188,40,65,40
"820980112",81,69,150,48,54,43
"820980107",29,24,53,15,25,14
"820910105",235,171,406,131,211,126
"820847001",19,15,34,16,66,15
"820846702",29,28,57,17,23,17
"820840101",345,292,637,186,284,173
"820770407",78,51,129,49,61,49
"820700115",142,129,271,84,144,79
"820700216",110,82,192,60,78,56
"820700109",125,111,236,61,113,61
"820630318",22,17,39,10,10,10
"820560314",175,129,304,89,154,88
"820490913",454,441,895,222,240,204
"820490316",20,22,42,12,18,12
"821330607",10,12,22,6,14,5
"820980204",37,28,65,23,43,22
"820280116",31,10,41,21,105,21
"820210128",225,182,407,104,116,96
"820140118",10,10,20,7,36,7
"820490502",167,168,335,76,89,71
"820490321",42,51,93,31,35,31
"820210326",74,66,140,35,64,34
"820210319",140,135,275,68,142,62
"820140124",43,29,72,29,70,26
"820140121",72,60,132,45,82,45
"820420217",166,135,301,100,121,89
"820420120",81,56,137,52,116,51
"820420118",118,87,205,62,83,61
"820140119",39,29,68,23,40,21
"820350205",78,73,151,50,75,49
"820350101",247,127,374,101,139,100
"820770204",354,243,597,179,235,149
"820630308",471,467,938,275,347,269
"820630224",210,233,443,98,111,91
"820700105",193,147,340,104,156,97
"820490808",164,148,312,88,136,88
"820490416",412,416,828,196,213,193
"820490320",35,9,44,23,36,23
"820490319",109,88,197,51,57,49
"820700513",78,71,149,44,59,44
"820490418",218,187,405,108,117,101
"820490413",157,157,314,80,99,80
"820490902",59,54,113,28,48,28
"820630114",162,162,324,100,164,98
"820280310",93,76,169,60,92,56
"820490203",60,45,105,34,44,34
"820490103",307,278,585,157,169,151
"820421215",51,32,83,31,77,30
"820847601",40,31,71,29,46,27
"820421117",152,123,275,91,156,89
"820211011",98,71,169,50,97,45
"820211001",134,118,252,75,98,74
"821260105",242,199,441,126,206,125
"821050504",262,236,498,172,557,168
"821050211",148,113,261,92,180,90
"820910304",911,838,1749,482,491,370
"820847902",97,107,204,43,59,42
"820846402",522,461,983,307,377,299
"820700214",287,280,567,167,213,149
"820630301",297,292,589,177,365,174
"820846401",221,226,447,142,207,138
"821330511",147,130,277,74,98,73
"820847302",202,156,358,108,149,107
"820140505",145,115,260,88,241,83
"820140502",73,61,134,51,165,50
"820280324",523,481,1004,264,331,256
"820630313",379,375,754,227,309,215
"820630226",143,136,279,74,160,71
"820770201",350,320,670,166,213,159
"820070307",189,148,337,97,147,91
"820842315",229,306,535,238,302,231
"820846114",716,705,1421,354,253,243
"820846111",609,708,1317,425,444,396
"820846110",633,695,1328,420,424,390
"820210616",1489,1533,3022,984,1068,929
"820490112",832,834,1666,430,304,267
"820210713",354,336,690,237,256,229
"820210710",385,397,782,269,272,240
"820847704",445,405,850,228,338,172
"821330403",411,452,863,244,262,229
"821330213",538,507,1045,266,321,264
"821260404",536,606,1142,425,493,421
"821260303",484,523,1007,349,414,346
"821260209",441,468,909,362,392,338
"821260109",284,314,598,250,283,246
"821260108",514,572,1086,394,435,379
"821191010",229,283,512,166,194,155
"821191005",363,412,775,281,295,266
"821050228",652,672,1324,379,395,374
"820980404",387,373,760,215,234,202
"820910603",422,484,906,331,392,327
"820910512",344,347,691,198,220,189
"820910506",407,515,922,342,397,335
"820910410",461,496,957,294,356,293
"820848005",338,381,719,277,320,264
"820848003",360,478,838,352,483,343
"820848001",420,510,930,382,445,365
"820847102",138,150,288,94,118,94
"820846505",945,1012,1957,638,1093,619
"820846906",534,561,1095,357,378,339
"820846313",878,862,1740,412,429,399
"820845907",1207,1092,2299,571,529,481
"820845603",46,21,67,23,9,8
"820845518",613,574,1187,303,266,262
"820845513",815,835,1650,445,426,412
"820845306",504,620,1124,386,406,368
"820843306",579,586,1165,359,361,321
"820841922",90,117,207,93,123,72
"820700702",387,425,812,288,320,275
"820632701",417,431,848,232,248,211
"820630327",323,299,622,217,470,211
"820632807",737,746,1483,425,439,404
"820560403",417,544,961,329,361,326
"820630124",438,450,888,271,258,243
"820490607",611,608,1219,291,130,127
"821190519",657,652,1309,406,705,394
"821190311",450,436,886,267,283,251
"821190120",1954,1939,3893,974,945,846
"821190201",603,608,1211,384,424,369
"821120219",375,430,805,297,317,289
"821120218",578,625,1203,361,412,354
"821120202",70,71,141,42,50,41
"821120103",487,510,997,325,386,321
"821050509",364,331,695,218,271,208
"821050505",418,430,848,302,345,293
"821120411",284,329,613,244,278,243
"820490605",573,630,1203,389,415,376
"820490521",309,345,654,209,217,202
"820490612",229,309,538,231,326,229
"820070216",677,645,1322,330,284,272
"820700318",917,949,1866,501,501,465
"820700313",423,453,876,271,291,265
"820847715",258,293,551,196,204,180
"820632905",845,849,1694,436,357,322
"820632804",30,26,56,16,27,15
"820841911",242,296,538,264,363,257
"820841904",179,248,427,189,276,189
"820844504",392,434,826,294,316,278
"820841902",248,303,551,249,331,245
"820841901",282,338,620,285,399,245
"820844418",381,454,835,280,329,274
"820844607",640,705,1345,438,431,382
"820844603",497,489,986,323,337,297
"820844410",340,401,741,273,314,268
"820844409",385,437,822,282,341,273
"821260316",228,266,494,194,208,188
"820844310",304,348,652,236,307,234
"820842816",287,367,654,300,532,294
"820844304",345,379,724,276,344,271
"820844408",353,407,760,221,227,208
"820844106",376,467,843,299,299,258
"820844102",383,448,831,269,287,254
"820842815",280,370,650,295,465,282
"820844011",176,184,360,119,129,116
"820844008",224,238,462,192,241,186
"820843808",229,255,484,193,200,183
"820843213",674,721,1395,425,403,387
"820843208",903,936,1839,519,458,426
"820843801",405,496,901,431,610,417
"820843714",381,432,813,312,410,301
"820848509",512,530,1042,268,271,256
"820843703",295,368,663,283,336,280
"820843203",477,487,964,341,364,318
"820842309",304,391,695,244,341,238
"820846902",501,549,1050,346,368,334
"820844522",346,367,713,244,266,240
"820844506",221,254,475,180,203,176
"820843901",199,267,466,175,228,172
"821120308",20,21,41,15,24,15
"821120204",277,225,502,108,134,104
"820843102",395,456,851,303,329,290
"820843011",353,430,783,250,261,246
"820843004",619,641,1260,423,436,395
"820840609",347,399,746,270,288,262
"820840415",292,363,655,236,268,228
"820633505",271,338,609,223,237,218
"820842911",384,466,850,368,522,362
"820842910",378,423,801,372,531,366
"820842909",230,275,505,221,334,203
"820633006",374,433,807,290,318,283
"820843117",340,396,736,283,324,268
"820560101",508,533,1041,311,376,306
"820842014",225,303,528,246,330,240
"820700219",712,780,1492,485,535,469
"820842918",323,402,725,298,368,296
"820842704",151,214,365,184,268,178
"820842703",170,255,425,176,259,174
"820842608",228,327,555,293,412,273
"820842605",166,218,384,200,347,194
"820842512",484,641,1125,557,593,546
"820421216",464,464,928,345,394,335
"820842503",185,215,400,191,377,189
"820630711",342,402,744,285,292,268
"820842822",187,218,405,205,322,197
"820842722",167,236,403,186,279,181
"820842719",188,243,431,202,281,178
"820560309",362,389,751,269,301,255
"820842117",121,208,329,201,327,200
"820842004",182,229,411,212,295,208
"820841806",227,301,528,232,301,228
"820841805",241,335,576,295,406,257
"820841802",159,186,345,161,237,151
"820841914",142,220,362,174,292,144
"820842419",196,260,456,217,315,211
"820420305",198,152,350,110,115,100
"820842418",225,262,487,249,363,247
"820420202",241,258,499,158,179,153
"820280209",176,173,349,114,144,112
"820210109",62,61,123,36,36,34
"820140603",248,304,552,224,262,219
"820841701",209,227,436,165,224,160
"820841605",411,489,900,353,423,341
"820841509",424,389,813,236,315,212
"820841506",337,403,740,261,341,254
"820841504",375,411,786,268,306,248
"820841312",300,342,642,246,280,224
"820841406",446,513,959,342,373,328
"820841211",707,694,1401,315,279,267
"820841304",1000,989,1989,589,575,551
"820841209",656,631,1287,313,288,277
"820841208",356,378,734,232,246,219
"820841303",731,794,1525,420,338,313
"820841220",513,485,998,261,219,212
"820841202",600,578,1178,305,263,230
"820843412",306,353,659,219,238,206
"820843411",242,287,529,188,216,183
"820843318",604,597,1201,346,351,329
"820841113",298,339,637,181,172,165
"820841913",143,177,320,162,243,154
"820843516",578,549,1127,316,277,243
"820843514",613,668,1281,382,318,284
"820845114",419,437,856,230,140,124
"820844904",553,598,1151,340,345,322
"820844822",789,758,1547,408,405,391
"820844820",586,643,1229,333,325,315
"820845107",585,634,1219,361,293,282
"820841817",155,231,386,198,273,195
"820210614",573,592,1165,380,402,370
"820210611",689,695,1384,350,355,341
"820210608",557,615,1172,400,413,388
"820210511",331,375,706,277,325,244
"820210506",480,506,986,333,365,315
"820845211",793,815,1608,441,377,366
"820210216",523,498,1021,334,352,321
"820210214",460,519,979,343,346,316
"820210207",628,638,1266,399,392,352
"820210206",451,488,939,319,333,310
"820210418",876,804,1680,435,442,416
"820210417",851,904,1755,394,395,375
"820210413",332,372,704,262,318,245
"820210412",285,334,619,247,279,238
"820210409",432,495,927,349,377,327
"821050417",378,388,766,249,261,235
"820210124",623,666,1289,400,508,392
"820845917",892,951,1843,535,575,516
"820848715",316,347,663,208,214,195
"820848714",351,396,747,238,244,223
"820140518",274,306,580,210,242,210
"820140504",469,527,996,364,450,363
"820845915",241,276,517,179,208,176
"820210113",102,85,187,64,65,63
"820421108",351,365,716,236,296,234
"821050413",599,602,1201,355,383,339
"820421009",384,415,799,227,248,216
"820140508",380,461,841,342,385,321
"820420914",347,399,746,279,321,274
"820420912",320,325,645,257,324,253
"820421004",493,583,1076,363,383,347
"820421003",415,479,894,332,365,323
"820420903",751,806,1557,520,594,508
"820420711",500,503,1003,294,317,289
"820420709",307,358,665,269,321,267
"820420703",326,368,694,211,233,200
"820140406",576,635,1211,398,441,382
"820140405",410,441,851,309,366,294
"820140402",444,465,909,331,358,325
"820420418",444,444,888,298,356,292
"820420412",269,312,581,213,219,198
"820420409",335,388,723,286,315,274
"820848607",951,1007,1958,538,457,433
"820420324",280,322,602,223,254,221
"820631205",392,427,819,229,212,205
"820070210",517,498,1015,294,233,223
"820631116",514,501,1015,294,316,277
"820631115",815,822,1637,371,355,334
"821050405",333,346,679,235,246,226
"820848512",739,709,1448,423,425,385
"820848809",413,433,846,266,297,257
"820848511",447,454,901,276,302,258
"820140107",490,536,1026,326,350,318
"821050403",342,411,753,299,339,291
"820848411",807,890,1697,477,512,469
"820840518",560,605,1165,413,445,395
"820420212",409,423,832,282,309,273
"820140209",287,322,609,226,259,222
"820840515",299,328,627,214,260,211
"820631013",737,745,1482,433,428,399
"820631010",518,695,1213,358,397,338
"820630910",452,521,973,348,371,331
"820630904",276,345,621,227,259,222
"820630901",605,651,1256,416,429,392
"820630804",384,407,791,268,321,263
"820630712",338,378,716,292,341,282
"820630705",571,621,1192,423,489,412
"820350111",624,683,1307,381,436,376
"820630610",323,361,684,218,232,211
"820630513",619,650,1269,366,298,288
"820848405",373,429,802,270,284,253
"820840509",422,484,906,307,353,289
"820840409",525,630,1155,404,451,397
"820631002",528,593,1121,390,386,357
"820840408",401,433,834,279,311,276
"820840310",489,521,1010,299,207,187
"820840303",557,581,1138,332,305,297
"820630506",1207,1269,2476,572,544,532
"820840503",523,575,1098,397,386,246
"820560103",534,535,1069,330,386,325
"820491018",685,667,1352,389,440,382
"820630907",310,405,715,243,259,235
"820280512",970,1023,1993,522,505,479
"820280508",721,729,1450,425,444,400
"820280413",586,623,1209,382,412,373
"821050231",478,476,954,275,306,265
"821050307",319,380,699,252,272,247
"821330415",1086,1199,2285,529,526,478
"820700603",364,378,742,238,280,236
"821260506",964,981,1945,566,578,525
"820910318",559,551,1110,335,357,323
"820633413",1622,1643,3265,881,874,824
"820633306",478,531,1009,346,370,320
"820848315",399,466,865,297,321,284
"820633302",542,520,1062,276,267,255
"820633301",736,748,1484,369,212,194
"820633207",883,946,1829,476,491,451
"820490906",946,977,1923,508,535,494
"820633203",823,845,1668,435,411,385
"820490702",424,463,887,322,357,307
"820633103",580,593,1173,345,367,322
"820490517",414,431,845,283,299,258
"820633102",336,330,666,188,201,176
"820630207",534,610,1144,390,426,382
"820700215",68,69,137,41,56,40
"820630906",486,529,1015,340,373,332
"820633012",375,430,805,263,280,252
"820633002",468,568,1036,381,435,373
"820632823",417,398,815,211,277,196
"820070404",339,345,684,213,289,209
"820070403",385,450,835,326,365,313
"820848214",639,662,1301,387,442,378
"820632816",252,227,479,162,289,155
"820632712",760,790,1550,401,385,353
"820632611",369,399,768,252,269,251
"820632418",149,158,307,120,185,101
"820632417",176,269,445,221,331,219
"820632410",273,314,587,232,312,230
"820840901",355,418,773,282,332,276
"820840910",240,285,525,206,224,201
"820841815",229,268,497,223,328,221
"820632301",316,399,715,283,347,277
"820632009",380,406,786,237,266,229
"820632001",366,419,785,310,354,304
"820630110",701,730,1431,369,390,357
"820840801",326,364,690,255,317,248
"820631712",315,335,650,285,349,265
"820631605",288,352,640,229,263,218
"820631602",414,498,912,330,355,318
"820631510",435,531,966,348,381,327
"820490202",466,463,929,316,316,271
"820631609",309,364,673,231,229,220
"820631402",523,589,1112,382,415,370
"820631303",241,249,490,177,191,165
"820631213",560,638,1198,373,264,213
"820631313",485,532,1017,365,431,354
"820631312",407,464,871,300,312,285
"820631310",379,382,761,233,230,213
"820490123",1240,1247,2487,631,684,613
"820490118",645,691,1336,391,402,368
"820631207",599,653,1252,365,393,354
"820631210",552,567,1119,282,249,241
"820700713",408,453,861,295,328,290
"820840722",349,329,678,206,209,169
"820841919",143,189,332,161,220,153
"820840716",296,340,636,217,239,210
"820840711",340,367,707,261,258,222
"820840621",416,487,903,287,293,275
"820840617",486,492,978,297,281,266
"820848116",458,501,959,350,384,322
"820848108",284,365,649,233,264,223
"820560514",444,494,938,320,377,314
"820560508",249,265,514,187,229,180
"820560506",335,372,707,245,266,233
"820560504",344,413,757,279,295,268
"820560503",428,518,946,331,350,321
"820560412",299,311,610,230,247,224
"820560510",502,540,1042,296,298,269
"820848017",351,403,754,305,372,290
"820847804",514,536,1050,344,368,329
"820845712",381,394,775,263,387,257
"820910313",474,485,959,310,316,284
"820980405",427,416,843,263,277,246
"820910310",530,527,1057,374,438,367
"820845416",372,439,811,286,316,277
"821190911",264,269,533,191,233,186
"820845402",332,369,701,242,261,234
"820845322",71,90,161,59,62,59
"820845315",462,506,968,300,337,294
"821190812",248,272,520,182,216,177
"820280204",401,447,848,323,371,319
"820841101",389,397,786,238,271,237
"820841019",2286,2377,4663,1329,1396,1255
"820490109",663,694,1357,360,390,348
"821190709",464,479,943,297,310,281
"821190710",424,445,869,277,283,260
"821190701",625,706,1331,387,412,373
"820280114",443,435,878,294,362,292
"820847717",362,389,751,243,260,230
"820280103",279,314,593,220,253,219
"820846219",378,431,809,287,319,278
"820210908",102,90,192,58,84,56
"820210814",626,629,1255,386,380,357
"820210813",526,553,1079,284,278,255
"820210807",727,726,1453,400,406,374
"820210722",1123,1010,2133,567,580,547
"821190414",1034,1056,2090,554,549,509
"821190413",704,734,1438,369,362,341
"821330624",25,22,47,16,24,16
"821330615",16,12,28,8,14,8
"821330506",5,4,9,2,12,2
"821190116",76,65,141,45,57,40
"821190112",91,69,160,47,98,46
"821120303",295,300,595,179,163,92
"821120201",32,25,57,20,47,20
"821050501",90,75,165,47,74,46
"820980312",242,200,442,109,152,109
"820910510",154,145,299,88,147,87
"820910407",56,58,114,37,82,37
"820910217",235,193,428,125,201,120
"821330205",10,8,18,4,10,4
"820847805",323,284,607,164,207,161
"820846405",169,129,298,82,115,82
"820846002",278,230,508,147,198,144
"820845902",41,45,86,28,41,25
"820632716",232,217,449,132,148,118
"820490404",216,186,402,113,138,111
"820070212",174,142,316,97,215,91
"821120301",100,61,161,52,101,51
"820700107",113,91,204,53,113,46
"820350203",55,43,98,32,39,32
"821120215",30,25,55,20,28,20
"820211003",144,118,262,69,82,63
"820210708",11,12,23,5,9,5
"821330530",33,15,48,15,22,15
"820490503",82,70,152,47,56,46
"820210330",93,73,166,43,73,41
"820210329",117,89,206,49,77,46
"820210325",65,49,114,29,76,28
"820210303",138,129,267,67,92,56
"820210314",183,157,340,98,173,94
"820140413",27,16,43,19,62,19
"820140312",60,46,106,39,84,39
"820140522",17,9,26,9,28,9
"820140512",30,20,50,17,61,17
"820420304",115,101,216,72,123,72
"820420301",103,82,185,67,94,67
"820210127",82,65,147,41,49,39
"820210122",110,98,208,52,63,49
"820210112",299,263,562,145,178,140
"820210108",233,200,433,107,203,93
"820420201",147,85,232,108,82,73
"820420113",88,80,168,54,67,53
"820420101",50,46,96,43,115,43
"820560107",230,132,362,13,18,13
"820350107",41,24,65,28,41,28
"820770403",85,84,169,49,108,46
"820490912",151,118,269,75,95,74
"821330502",51,42,93,22,29,21
"820490909",129,131,260,77,98,75
"820280315",109,88,197,63,84,61
"820490807",154,134,288,76,102,75
"820280219",21,14,35,14,18,14
"820632822",91,93,184,56,65,54
"821260213",122,99,221,66,100,63
"820490417",14,11,25,8,9,7
"820280323",78,77,155,53,85,51
"820630108",154,149,303,79,93,77
"820490323",160,157,317,92,105,92
"820490122",141,117,258,67,56,49
"820490311",398,369,767,208,216,202
"820845714",41,49,90,27,40,27
"821199301",39,28,67,21,51,20
"820421202",114,100,214,74,115,72
"821330603",208,202,410,110,153,107
"821330528",106,107,213,54,66,54
"821330311",229,216,445,122,127,87
"821260301",163,128,291,84,188,83
"820847705",557,542,1099,320,382,307
"820846403",431,408,839,223,215,181
"820700301",323,345,668,210,248,192
"820630317",532,486,1018,314,522,308
"820849001",292,322,614,188,230,188
"820630314",667,635,1302,380,440,330
"820490814",156,150,306,79,78,74
"820910401",263,212,475,130,137,126
"820140201",78,65,143,54,121,51
"820420308",321,264,585,198,241,196
"820140127",52,44,96,32,80,32
"820490116",1570,1629,3199,750,713,676
"820560207",346,301,647,183,212,180
"820846113",407,477,884,287,320,274
"820845924",530,584,1114,311,349,272
"820845923",986,979,1965,499,418,372
"820280107",232,217,449,148,291,134
"820847702",128,118,246,70,105,68
"821190410",510,601,1111,359,370,328
"820421209",179,145,324,120,223,120
"821330412",539,566,1105,354,409,344
"821330409",435,469,904,292,318,272
"821330408",210,245,455,165,230,156
"821260406",553,579,1132,399,473,393
"821260312",281,354,635,261,292,254
"821260311",456,534,990,384,425,375
"821260304",612,580,1192,363,403,350
"821260210",719,737,1456,472,503,450
"821260106",579,615,1194,411,457,404
"821191006",469,472,941,281,225,197
"821050121",382,352,734,205,286,173
"821050103",471,475,946,266,280,237
"821120101",266,288,554,164,183,158
"820980402",513,603,1116,328,361,319
"821120409",326,392,718,287,375,270
"820980410",519,556,1075,291,308,279
"820980316",1644,1696,3340,792,797,735
"821050224",476,548,1024,312,353,312
"820910609",511,567,1078,325,343,304
"820910606",271,338,609,252,288,247
"820910602",431,472,903,322,367,307
"820910513",499,501,1000,325,360,319
"820910509",889,916,1805,489,518,454
"820910508",816,916,1732,527,555,494
"820849005",288,318,606,199,224,192
"820848910",1035,1061,2096,555,512,497
"820848905",703,708,1411,413,398,363
"820848502",833,846,1679,418,397,389
"820848414",706,676,1382,318,316,290
"820910309",279,295,574,206,234,200
"820848203",720,674,1394,380,376,338
"820848202",685,739,1424,379,390,367
"820848010",268,332,600,262,254,162
"820847807",497,549,1046,335,343,312
"820847301",274,257,531,145,175,143
"820846903",471,571,1042,358,379,349
"820847203",593,597,1190,359,437,343
"820847202",602,695,1297,470,427,366
"820847713",603,618,1221,390,390,371
"820846103",431,472,903,260,258,240
"820846102",365,386,751,248,273,242
"820846004",602,636,1238,389,459,375
"820845522",800,820,1620,439,408,382
"820845521",440,486,926,272,258,249
"820845305",338,345,683,187,168,148
"820843303",832,869,1701,487,390,360
"820840203",587,688,1275,368,365,333
"820841921",138,175,313,155,226,153
"820700705",432,482,914,308,343,303
"820700525",721,690,1411,427,495,418
"820700522",346,368,714,255,283,251
"820700310",695,726,1421,467,503,442
"820630613",387,427,814,266,282,263
"820560301",539,559,1098,376,424,372
"820560219",434,468,902,316,313,287
"820491006",765,754,1519,304,265,252
"821190904",390,411,801,267,310,260
"821190715",953,923,1876,499,531,470
"821190612",543,569,1112,372,428,368
"821190608",752,806,1558,522,577,505
"821190503",656,717,1373,450,507,441
"821190502",610,658,1268,401,469,389
"821190313",432,474,906,267,235,225
"821190307",301,351,652,193,147,135
"821190204",444,530,974,348,362,313
"821190108",399,451,850,285,330,275
"821120405",877,885,1762,459,468,432
"821190314",504,527,1031,304,317,288
"821050517",382,385,767,198,326,190
"821190207",239,280,519,204,250,202
"821050512",371,398,769,247,290,243
"820490606",389,488,877,324,367,314
"820490522",547,603,1150,368,365,336
"820490514",1217,1214,2431,607,590,539
"820280322",379,388,767,198,217,193
"820490901",158,154,312,112,119,108
"820280312",204,217,421,111,139,103
"820700209",385,440,825,276,329,274
"820700221",556,534,1090,353,386,350
"820700204",472,516,988,345,359,319
"820700117",270,280,550,207,236,201
"820632906",745,703,1448,353,365,336
"820632902",455,464,919,236,236,220
"820632805",900,943,1843,526,561,513
"820632704",405,499,904,344,396,339
"820841910",322,447,769,357,491,340
"820844705",608,641,1249,380,337,309
"820841907",185,243,428,201,268,174
"820844601",468,495,963,324,353,300
"820844909",605,660,1265,376,386,367
"820844511",541,553,1094,367,389,360
"820844507",366,394,760,261,260,233
"820844614",706,718,1424,397,405,371
"820844613",672,731,1403,387,406,375
"820844611",756,727,1483,377,362,351
"820844606",550,546,1096,356,393,347
"820844605",219,234,453,148,161,144
"820844411",263,340,603,237,275,224
"820844407",379,423,802,289,314,271
"820844405",244,288,532,200,233,194
"820844313",464,538,1002,328,325,283
"820844312",519,576,1095,361,398,346
"820844307",422,471,893,335,422,320
"820844214",242,301,543,163,91,85
"820844111",456,493,949,241,251,231
"820844014",437,463,900,341,428,335
"820844013",300,321,621,209,246,202
"821260511",511,563,1074,402,455,396
"821260307",593,566,1159,390,434,381
"820843918",594,664,1258,438,420,332
"820843209",393,419,812,252,251,216
"820848313",385,405,790,248,260,226
"820846802",817,329,1146,185,216,178
"820842103",262,334,596,296,421,288
"820843113",411,474,885,295,315,281
"820843112",388,503,891,312,340,300
"821120403",232,301,533,208,247,205
"820843313",490,474,964,288,320,283
"820843215",570,535,1105,305,285,269
"820843106",420,457,877,305,327,288
"820843103",389,436,825,290,303,284
"820843101",513,635,1148,385,410,365
"820841006",924,871,1795,496,235,209
"820843002",430,474,904,289,297,277
"820633007",529,698,1227,448,515,438
"820842105",152,201,353,166,259,165
"820842709",121,181,302,116,167,115
"820770103",680,678,1358,379,470,367
"820700609",117,101,218,72,103,68
"820700405",346,408,754,295,336,288
"820842606",192,229,421,170,267,168
"820490406",335,369,704,232,249,227
"820842603",250,383,633,305,474,304
"820842515",156,196,352,188,480,185
"820490128",690,716,1406,375,367,348
"820842510",141,197,338,159,194,152
"820842904",313,380,693,327,481,321
"820842901",466,604,1070,487,720,481
"820842817",275,350,625,318,575,314
"820842802",354,480,834,386,597,374
"820560310",246,285,531,223,244,221
"820560307",404,409,813,287,317,277
"820842114",311,416,727,317,403,316
"820841810",258,330,588,262,301,203
"820841501",339,386,725,252,274,244
"820841924",282,311,593,246,357,244
"820842302",217,266,483,224,307,223
"820280318",523,533,1056,333,355,315
"820280304",434,471,905,329,360,315
"820211014",560,520,1080,358,379,343
"820842209",214,283,497,256,424,247
"820210312",57,56,113,40,47,35
"820210119",814,762,1576,506,556,473
"820210107",372,417,789,293,328,289
"820140517",540,543,1083,389,409,358
"820841718",230,304,534,284,449,283
"820841610",273,293,566,253,316,224
"820841601",361,400,761,319,440,307
"820841503",313,386,699,240,284,234
"820841502",379,434,813,263,304,252
"820841401",394,440,834,284,314,270
"820841716",178,231,409,174,243,171
"820841712",290,350,640,262,330,251
"820841210",502,441,943,263,244,217
"820841218",678,697,1375,400,244,217
"820843610",430,486,916,330,412,322
"820841203",521,552,1073,332,337,296
"820841117",468,524,992,349,395,321
"820843414",389,429,818,294,343,281
"820843406",399,527,926,353,401,335
"820843319",489,514,1003,293,276,250
"820843609",438,482,920,311,364,307
"820843604",393,429,822,287,318,282
"820843603",325,388,713,227,255,224
"820843315",982,992,1974,500,472,453
"820845002",536,572,1108,361,359,325
"820844905",483,470,953,271,261,241
"820844903",561,570,1131,281,265,262
"820845109",461,489,950,317,312,272
"820845102",444,479,923,313,339,292
"820845013",492,537,1029,336,374,321
"820210613",446,444,890,278,298,264
"820210610",596,606,1202,370,575,355
"820210609",656,685,1341,427,443,407
"820210602",429,468,897,362,405,354
"820844817",748,765,1513,430,421,406
"820210321",612,624,1236,427,459,415
"820210305",696,709,1405,444,504,419
"820210213",250,298,548,206,229,202
"820846101",359,369,728,206,221,198
"820210210",482,505,987,364,392,346
"820210501",654,661,1315,319,246,242
"820210422",2076,2127,4203,975,867,825
"820210420",406,395,801,246,260,234
"821050416",563,576,1139,326,329,296
"820210115",298,325,623,231,257,223
"820848901",393,418,811,262,278,235
"820848802",604,637,1241,342,252,234
"820140602",677,716,1393,451,496,422
"820848713",443,495,938,297,296,270
"820140523",325,368,693,269,286,258
"820140519",361,416,777,273,307,267
"820140513",319,337,656,231,259,209
"820845916",209,301,510,186,228,179
"820421110",331,272,603,194,239,193
"820420911",304,374,678,251,306,234
"820421005",478,483,961,262,267,244
"820420804",258,333,591,271,412,270
"820420712",413,466,879,335,425,318
"820420704",677,705,1382,411,426,385
"820420701",489,477,966,283,394,275
"820420608",371,472,843,348,426,342
"820420607",422,475,897,329,370,310
"820420507",408,457,865,335,377,326
"820848610",1203,1268,2471,670,428,410
"820140409",291,322,613,231,255,220
"820140407",414,489,903,290,307,280
"820140401",419,482,901,283,322,277
"820140310",392,415,807,313,332,280
"820420421",548,603,1151,405,444,401
"820420420",55,67,122,37,37,36
"820420415",515,525,1040,341,389,335
"820848605",665,675,1340,403,424,383
"820848514",825,795,1620,409,361,344
"820848513",653,669,1322,355,251,227
"820070206",366,384,750,271,305,265
"820070205",593,608,1201,363,340,328
"820842412",286,373,659,303,413,297
"820631117",433,489,922,260,251,245
"820840607",321,402,723,265,293,262
"820280214",312,329,641,222,258,219
"820140111",520,531,1051,345,375,331
"820140109",567,639,1206,451,502,434
"820070412",635,705,1340,391,417,374
"820842413",328,427,755,318,434,305
"820420306",115,121,236,84,123,83
"820840606",620,658,1278,374,362,324
"820631111",753,763,1516,426,361,350
"820631107",1444,1318,2762,708,620,587
"820631105",610,691,1301,359,409,319
"820560115",445,449,894,261,263,245
"820560111",419,409,828,262,386,256
"820840519",480,564,1044,382,432,372
"820631103",755,757,1512,391,355,351
"820631102",1185,543,1728,304,282,268
"820630812",418,498,916,328,380,318
"820630808",372,429,801,292,328,281
"820630806",355,427,782,258,273,254
"820560108",485,521,1006,299,308,276
"820420221",608,623,1231,425,453,418
"820630607",303,362,665,225,230,213
"820630604",611,671,1282,382,383,349
"820630510",768,853,1621,461,207,191
"820840514",453,534,987,354,394,350
"820840419",94,100,194,72,80,69
"820840417",132,137,269,94,109,90
"820840411",396,457,853,307,334,289
"820840212",598,609,1207,315,306,283
"821050314",365,395,760,242,260,221
"821190419",448,541,989,353,397,331
"821050312",324,409,733,261,301,252
"820770305",799,859,1658,455,539,436
"820280510",304,370,674,230,237,219
"820280504",435,462,897,306,317,292
"820280406",321,383,704,248,282,239
"821260516",554,569,1123,370,374,349
"820280326",871,880,1751,528,537,489
"820491014",1152,1228,2380,630,672,604
"820630411",582,561,1143,301,335,251
"821190304",674,743,1417,491,519,472
"820630408",503,569,1072,297,222,198
"821050301",1206,1177,2383,619,522,416
"820630222",743,765,1508,420,444,387
"820770106",479,514,993,267,308,259
"820280314",231,247,478,173,215,169
"821260507",349,441,790,312,381,305
"821260505",385,456,841,322,363,308
"821260502",468,488,956,305,331,292
"821260315",350,400,750,280,314,273
"820910316",6,10,16,4,5,4
"820841917",326,396,722,296,393,266
"820700501",660,706,1366,397,460,389
"820700418",256,278,534,237,295,231
"820848312",321,376,697,247,263,231
"820700407",290,326,616,233,270,223
"820700402",839,830,1669,567,628,548
"820633216",492,500,992,298,308,277
"820633212",1069,1079,2148,597,609,556
"820633209",706,792,1498,490,479,439
"820490910",177,187,364,123,127,105
"820490908",468,466,934,281,298,277
"820633206",474,452,926,253,267,246
"820490701",542,570,1112,307,316,293
"820633404",491,514,1005,255,265,250
"820848302",541,623,1164,377,392,346
"820633013",656,704,1360,394,422,367
"820630211",382,418,800,263,290,258
"820633110",731,783,1514,376,368,355
"820633109",1169,1194,2363,667,708,639
"820633108",413,442,855,241,221,204
"820490718",1522,1477,2999,747,670,565
"820280305",361,413,774,268,269,256
"820630128",868,816,1684,378,348,324
"820630120",470,521,991,285,308,275
"820632914",278,336,614,215,237,211
"820632913",382,484,866,332,406,326
"820848216",625,667,1292,357,421,349
"820632827",99,93,192,79,187,78
"820632826",296,278,574,198,455,198
"820490408",562,561,1123,310,340,307
"820632819",552,589,1141,359,500,345
"820842408",227,261,488,219,305,213
"820632811",1339,1374,2713,671,695,638
"820632714",813,853,1666,476,513,466
"820632711",636,682,1318,376,428,366
"820632608",460,531,991,332,359,315
"820840904",302,415,717,269,314,265
"820632409",241,342,583,249,338,248
"820632407",134,213,347,136,213,134
"820632810",780,844,1624,467,496,453
"820490305",738,807,1545,468,478,444
"820490304",423,472,895,311,355,303
"820840805",399,485,884,332,376,313
"820632311",209,243,452,157,210,157
"820632310",400,525,925,353,438,346
"820632206",128,145,273,110,261,105
"820632204",121,159,280,134,212,125
"820632107",380,463,843,319,422,311
"820632105",362,451,813,343,430,334
"820631913",1311,1249,2560,636,694,588
"820630109",480,533,1013,297,312,285
"820631906",192,221,413,167,214,153
"820631809",179,239,418,227,356,214
"820631802",415,530,945,392,593,380
"820631801",317,444,761,332,449,320
"820631707",258,327,585,242,300,237
"820631706",428,429,857,311,363,308
"820842809",304,396,700,340,575,335
"820631703",423,421,844,224,214,205
"820631511",477,578,1055,357,331,267
"820631411",352,442,794,326,381,317
"820631406",363,380,743,277,326,266
"820631607",253,305,558,177,202,166
"820490127",364,391,755,204,194,170
"820631404",445,528,973,358,388,330
"820631319",306,334,640,222,226,212
"820631318",327,421,748,267,291,260
"820490125",563,566,1129,315,333,308
"820840708",419,448,867,272,280,260
"820840704",745,779,1524,450,405,392
"820840703",763,785,1548,453,474,438
"820840622",498,597,1095,344,370,329
"820840614",723,797,1520,475,488,451
"820840611",513,541,1054,347,367,335
"820840705",912,1000,1912,619,516,458
"820630101",337,354,691,221,261,219
"820848021",295,334,629,235,276,230
"820560305",637,653,1290,415,442,397
"820845704",354,382,736,249,303,229
"820845508",843,842,1685,459,418,387
"820845708",620,599,1219,415,687,406
"820845404",418,471,889,307,343,285
"820845321",289,314,603,201,210,192
"820845318",735,859,1594,537,557,517
"821191012",441,533,974,367,433,360
"820280205",731,731,1462,490,506,462
"820280124",351,355,706,231,253,225
"820280121",279,345,624,225,258,216
"820841105",517,528,1045,310,331,283
"820841103",457,474,931,300,347,291
"821190802",720,777,1497,466,476,438
"820841014",639,683,1322,398,298,266
"820910101",341,337,678,203,212,189
"821190712",379,443,822,284,320,278
"820841009",831,840,1671,490,420,383
"820421121",334,346,680,220,243,220
"820421119",338,388,726,253,295,246
"820421206",316,374,690,276,309,268
"820421205",385,433,818,298,345,297
"821190511",527,613,1140,363,412,344
"820421204",488,498,986,325,367,315
"820421116",526,528,1054,363,417,359
"820846309",652,626,1278,333,274,266
"820846301",825,794,1619,409,288,208
"820280122",371,408,779,263,301,260
"820846209",779,753,1532,392,391,369
"820211009",560,592,1152,415,480,411
"820846221",525,543,1068,309,293,273
"820846213",729,776,1505,426,426,390
"820210902",469,532,1001,358,403,344
"820210809",484,529,1013,318,323,303
"820210806",276,289,565,205,225,194
"821190422",513,522,1035,340,338,310
"820842416",273,279,552,241,328,237
"821330627",34,19,53,14,34,14
"821330602",161,161,322,74,98,74
"821330518",85,88,173,54,88,52
"821330509",100,98,198,59,76,58
"821330507",7,4,11,4,20,4
"821330301",12,10,22,8,13,8
"821330218",64,49,113,29,40,27
"821190114",2,0,2,2,6,2
"821120211",84,77,161,52,74,50
"820980306",83,78,161,53,97,50
"820980303",17,8,25,15,48,15
"820910216",48,42,90,29,55,27
"820847706",33,20,53,18,32,18
"820847205",147,128,275,76,102,73
"820845903",34,27,61,20,23,19
"820845901",28,18,46,18,24,18
"820700520",122,110,232,67,117,67
"820700205",241,209,450,124,178,112
"820630320",2,0,2,2,2,2
"820490519",6,2,8,4,60,4
"820770401",132,98,230,81,159,81
"821330606",20,13,33,10,11,10
"820630321",0,0,0,0,1,0
"821330510",86,18,104,16,41,16
"821330110",0,0,0,0,1,0
"820910305",443,328,771,199,217,183
"820490210",100,89,189,57,73,56
"820210324",73,55,128,31,64,26
"820490318",42,38,80,22,28,22
"820210306",150,124,274,69,121,64
"820140521",8,6,14,5,19,5
"820421107",55,43,98,34,108,34
"820140123",11,6,17,6,39,6
"820420322",46,27,73,26,61,25
"820420216",159,152,311,106,149,102
"820070101",124,106,230,77,115,64
"820420116",176,142,318,96,149,93
"820420105",46,36,82,35,53,31
"820350109",138,128,266,77,89,74
"820280325",65,43,108,38,54,29
"821330108",50,41,91,24,27,23
"821330105",63,8,71,18,19,17
"821330103",17,7,24,11,16,11
"820630230",43,33,76,28,58,28
"820490804",7,6,13,3,16,3
"820490801",256,249,505,138,172,136
"820980115",43,47,90,32,45,32
"820490813",15,14,29,9,10,9
"820700507",128,103,231,62,92,61
"820632820",7,7,14,5,10,5
"820770102",174,130,304,92,138,92
"820490812",105,98,203,51,72,51
"820490325",75,68,143,35,39,34
"820490324",276,271,547,145,156,137
"820490205",57,61,118,29,39,28
"820490115",103,79,182,44,49,42
"820490104",20,0,20,13,17,13
"820490314",52,47,99,32,57,32
"820490114",206,196,402,93,110,90
"820490113",82,79,161,40,55,39
"821330517",215,218,433,121,154,118
"821260306",146,133,279,91,144,90
"821260103",223,198,421,123,204,118
"821190713",178,139,317,90,138,87
"821190506",129,118,247,69,164,54
"820910104",270,226,496,138,224,128
"820700220",291,277,568,162,215,154
"820560114",106,108,214,80,162,79
"820490403",272,250,522,145,181,144
"820210416",1840,1830,3670,925,791,661
"820630116",44,36,80,30,42,29
"820490806",133,130,263,87,201,84
"820844901",247,245,492,158,135,127
"820844821",901,866,1767,553,460,430
"820280306",760,715,1475,418,484,397
"820420302",266,215,481,169,282,163
"820420106",100,86,186,57,97,56
"820350207",577,520,1097,304,286,215
"820700711",103,90,193,59,90,54
"821190407",638,691,1329,333,334,316
"820490911",198,180,378,104,127,103
"820842314",242,304,546,285,439,279
"820846214",358,394,752,238,242,234
"821190405",122,116,238,70,81,69
"820280110",145,134,279,81,151,80
"820421111",312,296,608,204,336,202
"820211005",87,83,170,52,71,48
"820980203",412,404,816,228,269,223
"820210707",420,443,863,290,299,281
"820846201",400,425,825,232,219,192
"820490101",934,948,1882,434,435,403
"821330630",408,425,833,266,308,263
"821330618",560,561,1121,305,318,286
"821330411",348,400,748,248,281,237
"821330410",685,741,1426,410,428,362
"821330406",476,556,1032,297,327,288
"821330402",528,612,1140,337,355,327
"821330401",763,837,1600,383,398,355
"821260309",567,564,1131,356,371,338
"821260409",809,801,1610,517,554,508
"821191014",254,303,557,215,294,213
"821050220",304,345,649,225,250,224
"820980403",305,363,668,231,262,215
"820910611",449,534,983,373,409,358
"820910610",662,721,1383,430,483,422
"820910502",450,547,997,353,405,352
"820910106",152,147,299,108,140,107
"820848912",1404,1362,2766,715,682,629
"820848911",1639,1620,3259,802,749,720
"820848505",340,407,747,242,267,234
"820848413",897,899,1796,483,389,340
"820848201",887,845,1732,472,523,444
"820847905",422,450,872,313,356,310
"820847710",505,546,1051,338,369,323
"820847708",531,565,1096,356,364,330
"820847206",401,411,812,252,275,243
"820846104",626,615,1241,325,308,288
"820845909",741,677,1418,380,390,351
"820845905",922,908,1830,444,407,371
"820843304",590,604,1194,344,316,296
"820843302",607,613,1220,339,330,296
"820843301",502,493,995,309,308,285
"820840102",796,758,1554,447,536,430
"820840204",757,767,1524,445,447,340
"820770313",563,673,1236,390,451,372
"820700707",465,463,928,308,348,300
"820632617",789,808,1597,446,398,356
"820632615",447,488,935,272,215,197
"820630905",313,377,690,237,258,233
"820842622",113,196,309,169,263,153
"820842621",318,417,735,331,513,315
"821190818",328,379,707,251,270,241
"821190816",456,499,955,334,341,289
"821190417",806,859,1665,515,518,482
"821120417",257,281,538,217,254,214
"821120413",1140,1157,2297,591,581,547
"821120404",431,516,947,383,453,375
"821050503",335,315,650,183,210,183
"821050223",318,343,661,213,243,211
"820490527",903,940,1843,512,516,481
"820490524",779,804,1583,449,445,410
"820490916",396,455,851,295,318,284
"820070213",323,360,683,246,281,245
"820070217",386,358,744,249,275,239
"820070214",295,343,638,232,260,227
"820846220",429,429,858,252,233,219
"820842818",190,261,451,209,356,197
"820700314",454,536,990,342,373,327
"820841918",315,383,698,330,490,325
"820700222",469,494,963,346,380,333
"820700113",49,48,97,37,45,36
"820632702",462,433,895,272,288,255
"820844716",917,948,1865,511,360,339
"820844714",412,453,865,233,145,126
"820842312",270,379,649,320,482,312
"820844707",363,389,752,241,231,212
"820844706",470,509,979,283,283,259
"820841908",269,346,615,309,469,302
"820844602",412,502,914,320,324,271
"820844712",414,442,856,236,216,208
"820844516",594,600,1194,316,240,233
"820844512",442,503,945,327,361,315
"820844502",240,263,503,176,181,163
"820844702",418,427,845,241,234,221
"820844612",335,383,718,210,221,200
"820844412",322,399,721,264,326,249
"820844308",192,237,429,165,208,165
"820844305",309,370,679,234,293,227
"820844302",285,332,617,206,227,196
"820844210",497,569,1066,361,391,342
"820844009",367,409,776,282,306,200
"820844007",293,338,631,268,373,263
"820843920",283,287,570,216,260,193
"820980207",674,736,1410,419,487,410
"820843807",314,345,659,243,306,237
"820910612",746,821,1567,510,555,503
"820843210",602,613,1215,338,217,200
"820844212",480,525,1005,281,265,252
"820843716",239,295,534,253,373,253
"820910109",105,115,220,76,81,70
"820843206",612,663,1275,360,344,323
"820843710",347,422,769,339,453,316
"820848810",488,517,1005,364,397,346
"820843707",263,344,607,279,403,270
"820843202",478,573,1051,333,351,317
"820843702",467,592,1059,403,494,388
"820843211",500,527,1027,318,332,302
"820842308",287,385,672,359,487,326
"820847002",244,253,497,188,238,184
"820846502",497,531,1028,305,362,295
"820842101",293,349,642,272,359,257
"821190604",395,462,857,297,326,293
"820843903",317,379,696,273,371,272
"820842813",214,285,499,234,296,225
"820843310",721,808,1529,438,428,390
"820843813",483,561,1044,348,391,323
"821050218",461,489,950,293,344,290
"821050214",640,694,1334,421,473,408
"820632111",391,618,1009,312,411,300
"821050111",332,340,672,229,255,218
"821050105",414,443,857,299,320,274
"820842812",170,254,424,189,265,185
"820843214",370,423,793,242,241,220
"820843105",229,263,492,172,171,163
"820843104",387,445,832,292,358,283
"820841109",21,36,57,19,24,19
"820840619",368,401,769,223,225,199
"820842913",235,327,562,259,348,252
"820843201",615,693,1308,421,418,406
"820843121",410,480,890,291,312,272
"820491015",894,929,1823,449,470,426
"820842924",320,366,686,281,409,275
"820700521",247,246,493,184,231,178
"820633509",335,394,729,307,378,296
"820490334",522,589,1111,310,314,304
"820490332",495,510,1005,335,367,320
"820842203",245,278,523,237,319,232
"820842903",336,401,737,323,455,311
"820842824",264,322,586,285,484,278
"820842820",269,383,652,282,387,254
"820560205",510,576,1086,389,443,381
"820842111",252,302,554,248,333,215
"820842108",257,282,539,258,429,255
"820842011",209,279,488,228,355,227
"820842301",294,336,630,289,396,283
"820210906",303,400,703,255,295,245
"820842211",351,430,781,325,473,324
"820210302",841,853,1694,545,577,527
"820210301",28,23,51,20,24,20
"820842205",318,410,728,292,373,267
"820841409",292,351,643,241,245,223
"820841719",254,324,578,260,356,253
"820841612",235,281,516,222,327,194
"820841609",419,459,878,372,510,361
"820841606",331,398,729,297,378,289
"820842002",235,311,546,249,367,249
"820841915",209,280,489,245,317,220
"820841403",348,403,751,283,343,271
"820841311",383,447,830,276,315,265
"820841310",443,531,974,345,353,300
"820841216",362,382,744,275,168,137
"820841713",291,375,666,282,374,263
"820841708",158,188,346,147,220,142
"820841706",345,411,756,292,333,258
"820841703",254,307,561,211,307,199
"820843614",322,331,653,231,249,208
"820843611",369,466,835,321,356,298
"820843509",569,650,1219,397,427,381
"820843507",240,303,543,188,213,184
"820843503",338,366,704,245,291,236
"820843501",589,577,1166,330,344,303
"820843419",310,310,620,162,134,129
"820841108",413,418,831,267,300,264
"820845201",873,840,1713,499,472,456
"820845003",452,485,937,321,347,310
"820844913",732,707,1439,384,362,348
"820843403",193,229,422,139,135,131
"820845010",302,334,636,206,207,188
"820210815",540,499,1039,285,281,264
"820210513",1038,986,2024,531,517,493
"820844818",540,522,1062,272,257,257
"820844910",601,610,1211,332,198,186
"820844816",617,665,1282,407,329,298
"820844814",601,594,1195,309,302,287
"820844812",447,466,913,302,337,298
"820210311",356,310,666,202,342,199
"820210308",144,128,272,91,100,88
"820210218",667,650,1317,379,379,345
"821190404",473,507,980,311,338,305
"820210204",557,636,1193,432,466,412
"820848813",613,617,1230,305,315,271
"820210415",459,479,938,331,378,323
"821050418",313,361,674,263,317,252
"820848805",463,538,1001,302,310,285
"820210134",554,562,1116,348,418,326
"820842405",287,428,715,238,340,234
"820140610",16,21,37,16,47,16
"820140607",590,667,1257,431,465,415
"820140605",807,830,1637,459,529,433
"820848711",367,382,749,228,229,209
"820140514",486,510,996,326,383,321
"820845914",443,475,918,304,353,291
"820070409",841,833,1674,466,463,425
"820845910",1016,1041,2057,611,620,556
"820421109",372,448,820,311,387,304
"820070314",356,405,761,243,255,237
"820421012",525,517,1042,313,334,306
"820140216",251,322,573,211,242,197
"820140213",227,279,506,203,238,200
"820421008",777,727,1504,418,451,401
"820421001",372,409,781,269,286,243
"820420923",811,809,1620,518,553,488
"820420922",817,838,1655,417,446,395
"820420717",760,690,1450,408,454,399
"820420708",287,341,628,251,300,241
"820420707",459,515,974,391,464,372
"820420901",770,731,1501,444,509,426
"820848702",361,415,776,274,306,266
"820420604",557,579,1136,382,433,373
"820420509",267,293,560,193,191,176
"820420506",491,514,1005,339,390,335
"820842618",177,215,392,209,360,203
"820140217",276,334,610,234,271,233
"820420401",572,555,1127,418,494,411
"820420315",446,460,906,304,348,303
"820420312",616,589,1205,362,411,354
"820070302",547,615,1162,396,433,374
"820842614",269,364,633,300,477,286
"820420220",471,485,956,336,378,331
"820070204",686,722,1408,370,361,328
"820070103",623,607,1230,401,450,384
"820420123",391,378,769,251,298,250
"820140116",409,426,835,250,261,243
"820140105",365,437,802,293,346,280
"820140102",646,645,1291,419,474,404
"820420122",456,476,932,323,354,319
"820842403",174,231,405,174,230,147
"820631110",923,1015,1938,554,396,369
"820631108",410,430,840,203,211,192
"820842411",188,224,412,178,239,173
"820631119",361,410,771,242,213,199
"820631008",861,866,1727,529,485,456
"820630811",379,434,813,273,292,264
"820630810",383,441,824,303,338,299
"820630708",341,356,697,248,275,240
"820350116",295,293,588,144,255,138
"820350113",590,610,1200,327,396,317
"820840507",448,484,932,336,423,329
"820630508",838,795,1633,400,396,378
"820631001",513,485,998,288,300,264
"820840406",472,497,969,348,403,337
"820840307",1134,1160,2294,620,769,587
"820840302",776,765,1541,395,278,256
"820840210",896,917,1813,507,556,493
"820770317",396,464,860,282,314,270
"820770315",298,279,577,217,264,212
"820770307",481,554,1035,355,404,338
"820770306",588,576,1164,322,355,316
"820491019",1162,1175,2337,552,595,513
"820280506",925,965,1890,553,552,508
"820280503",390,444,834,296,303,275
"820280405",601,609,1210,368,372,344
"820280404",569,585,1154,379,391,360
"820280401",588,578,1166,363,399,343
"821050230",329,356,685,239,269,236
"821260512",572,589,1161,396,441,384
"820491011",834,881,1715,436,438,398
"820491009",603,610,1213,361,383,357
"820491008",712,708,1420,387,396,372
"821190305",322,377,699,231,263,228
"820770203",569,565,1134,334,357,322
"820280313",236,235,471,158,175,155
"820280311",404,472,876,276,314,272
"820280309",1359,1329,2688,729,740,688
"820980408",351,380,731,239,263,230
"820980114",578,679,1257,395,433,387
"820700517",393,431,824,302,329,296
"821260411",731,727,1458,493,568,486
"821260317",664,684,1348,465,501,453
"820633307",449,504,953,308,347,294
"820700511",867,871,1738,601,673,597
"820700510",450,545,995,354,394,346
"820700509",365,379,744,282,340,278
"820700508",680,703,1383,440,492,438
"820700503",560,623,1183,408,455,403
"820700414",483,477,960,318,344,302
"820700413",448,494,942,357,401,337
"820700411",375,415,790,335,478,315
"820700401",1310,1257,2567,639,671,607
"820633204",426,440,866,253,241,231
"820633201",629,680,1309,370,373,333
"820490707",802,903,1705,510,549,492
"820848304",470,580,1050,356,398,350
"820633104",1188,1283,2471,677,712,641
"820280220",325,368,693,267,310,265
"820633009",708,748,1456,457,498,424
"820632915",454,571,1025,346,369,334
"820632911",340,396,736,235,243,226
"821260318",297,351,648,242,262,233
"820280302",489,526,1015,343,351,320
"820632910",454,494,948,291,275,257
"820633113",577,661,1238,373,380,353
"820070315",513,500,1013,323,381,315
"820632609",577,632,1209,392,390,370
"820632606",491,492,983,277,294,270
"820632605",732,738,1470,372,360,338
"820632602",589,635,1224,340,253,232
"820632511",334,397,731,252,285,244
"820632412",293,404,697,259,350,254
"820632411",279,321,600,244,337,242
"820840808",417,499,916,337,354,330
"820700716",389,438,827,273,288,250
"820632309",283,348,631,298,380,277
"820840802",395,432,827,314,378,293
"820632304",387,421,808,329,412,316
"820632212",236,286,522,249,378,236
"820632211",143,217,360,168,244,159
"820632203",187,226,413,194,320,182
"820632102",369,461,830,347,409,326
"820632011",367,394,761,274,297,254
"820630122",553,618,1171,349,395,343
"820631904",250,289,539,188,202,184
"820631810",208,298,506,265,423,260
"820631705",430,484,914,351,399,336
"820631601",393,431,824,304,343,301
"820631502",381,437,818,285,321,282
"820631611",370,420,790,243,243,230
"820631403",443,565,1008,374,415,367
"820631309",901,900,1801,484,411,387
"820490117",584,678,1262,378,365,323
"820840720",425,482,907,329,385,314
"820700612",752,784,1536,475,535,466
"820840719",327,376,703,269,312,264
"820840717",576,540,1116,348,339,316
"820840714",358,420,778,279,293,261
"820840613",562,615,1177,386,420,367
"820848113",261,313,574,235,260,214
"820560515",313,355,668,225,244,220
"820848121",273,317,590,218,244,212
"820560411",389,421,810,317,369,305
"820560512",529,519,1048,305,319,294
"820560406",302,456,758,292,380,289
"820560304",293,332,625,224,243,218
"820560303",891,893,1784,527,552,498
"820560414",810,856,1666,506,537,485
"820848018",296,331,627,223,292,220
"820980407",474,552,1026,297,303,290
"820848020",381,480,861,317,379,311
"820560210",430,496,926,317,336,311
"820845709",206,222,428,135,257,135
"820910311",240,279,519,185,204,174
"820845602",10,2,12,8,8,8
"820845504",482,530,1012,323,339,306
"820846216",653,626,1279,357,358,337
"820845405",340,371,711,228,246,224
"820280123",248,283,531,204,238,194
"820841106",549,535,1084,319,312,290
"820841104",300,353,653,233,263,224
"820841018",888,975,1863,538,387,352
"820841002",872,902,1774,513,439,397
"820849013",397,336,733,243,296,211
"821190704",523,525,1048,331,361,321
"821190518",337,335,672,211,553,210
"821190703",655,680,1335,372,403,364
"821190614",505,498,1003,326,357,316
"820421214",557,611,1168,394,426,388
"820421210",753,785,1538,477,489,461
"821190516",181,169,350,119,374,118
"820280113",459,539,998,360,438,356
"820847722",364,485,849,295,365,283
"820980406",327,377,704,245,269,242
"820846305",395,425,820,235,231,221
"820842611",177,227,404,187,297,184
"820849006",149,172,321,99,144,97
"820848902",799,769,1568,434,349,338
"820846210",692,739,1431,378,357,343
"820211008",649,726,1375,439,462,416
"820210904",884,873,1757,519,589,506
"820210811",463,508,971,368,403,351
"821190416",466,535,1001,308,305,284
"820210709",69,64,133,34,61,31
"820210704",119,86,205,51,116,49
"821190412",458,530,988,297,311,270
"821330626",28,21,49,18,49,18
"821330625",16,11,27,9,19,9
"821330611",11,5,16,8,22,8
"821330532",25,13,38,12,17,12
"821330525",60,43,103,41,41,41
"821330531",21,18,39,13,25,13
"821330519",0,0,0,0,10,0
"821330514",72,50,122,39,48,39
"821330306",1,0,1,1,4,1
"821330216",55,57,112,26,34,24
"821330309",28,23,51,15,38,15
"821330208",8,7,15,5,9,5
"821260403",114,83,197,64,121,61
"821260402",142,105,247,74,144,73
"821260204",177,181,358,80,98,76
"821190606",332,351,683,226,264,212
"821190605",43,26,69,18,69,18
"821190115",70,70,140,40,65,40
"821190315",66,70,136,27,28,27
"821120213",86,69,155,57,93,56
"820910511",254,239,493,141,243,135
"820910415",149,133,282,81,130,80
"820770406",30,20,50,15,22,15
"820700304",291,301,592,179,202,160
"820700208",197,190,387,110,166,107
"820700116",82,85,167,47,83,45
"820700112",144,128,272,79,156,76
"820630304",1,1,2,1,4,1
"820560313",174,141,315,102,153,97
"820490520",3,3,6,1,10,1
"820490415",119,99,218,67,75,66
"820070309",145,124,269,84,138,84
"820980205",282,238,520,166,227,163
"820211010",31,21,52,16,15,15
"820210129",87,73,160,39,44,35
"821330529",15,6,21,10,18,10
"821330521",0,0,0,0,7,0
"820421104",33,33,66,20,43,19
"820140417",90,96,186,56,106,55
"820210130",118,95,213,60,72,51
"820210121",105,87,192,53,74,49
"820420211",197,159,356,107,147,96
"820420204",121,95,216,83,140,75
"820350206",254,216,470,128,162,126
"820770301",260,177,437,144,224,139
"821330109",3,1,4,3,4,3
"821330101",53,32,85,22,23,19
"820630229",35,42,77,25,33,25
"820630228",157,138,295,93,100,80
"820770205",130,92,222,62,71,51
"820770104",276,138,414,138,177,134
"820490816",34,38,72,19,27,17
"820490815",79,60,139,44,50,44
"820490212",26,25,51,25,33,22
"820700516",106,92,198,51,86,48
"820490501",44,44,88,23,31,22
"820700602",212,161,373,98,152,94
"820910414",77,69,146,44,112,43
"820490322",36,32,68,23,29,23
"820490207",15,7,22,11,17,11
"820490204",12,6,18,4,11,4
"820490126",136,84,220,71,101,71
"820700709",185,175,360,106,141,102
"821260112",193,131,324,93,168,89
"821199402",6,5,11,5,12,5
"820910206",214,167,381,134,177,130
"820280202",102,56,158,44,70,44
"820490106",66,43,109,31,39,28
"820845715",35,23,58,16,21,16
"820490313",203,195,398,117,129,117
"820210715",54,37,91,29,48,28
"820210702",1087,1055,2142,530,552,475
"821330303",111,94,205,59,66,53
"821260407",382,357,739,205,319,197
"821190504",136,119,255,81,217,80
"821190101",307,293,600,186,392,182
"821050507",248,225,473,138,182,123
"820847903",60,64,124,31,53,28
"820846601",641,591,1232,298,410,286
"820700302",195,173,368,113,251,109
"820560213",180,164,344,99,130,81
"820490510",1838,1763,3601,804,770,726
"820140415",164,149,313,97,151,93
"820210327",365,316,681,184,272,167
"820630315",492,463,955,254,240,217
"820289201",84,76,160,50,97,49
"820630312",816,797,1613,470,572,420
"820630220",600,604,1204,307,364,286
"820980311",914,901,1815,497,573,490
"820420110",266,243,509,158,301,153
"820842316",228,282,510,242,338,234
"820490905",208,154,362,104,124,102
"820490904",186,149,335,93,129,93
"820630117",66,45,111,33,49,31
"820490110",451,452,903,216,158,146
"820210712",472,475,947,311,374,309
"821190409",796,814,1610,491,509,468
"820280111",74,74,148,50,109,47
"821330621",383,394,777,289,312,277
"821330605",694,745,1439,419,477,407
"821330505",151,115,266,65,71,60
"821330405",459,527,986,349,425,342
"821330404",599,659,1258,375,427,358
"821260308",339,328,667,185,192,176
"821260110",344,358,702,280,292,268
"821260107",565,530,1095,337,353,323
"821260102",134,133,267,78,86,76
"821191009",323,372,695,258,310,239
"821191001",325,339,664,234,267,231
"821190913",940,935,1875,503,451,393
"821050112",455,481,936,279,317,275
"821050102",324,301,625,188,288,187
"820980401",569,585,1154,342,349,309
"820910505",974,1002,1976,662,701,624
"821120407",498,553,1051,340,343,324
"820848907",416,433,849,271,270,256
"820848506",315,324,639,221,236,212
"820848207",593,622,1215,370,364,342
"820848206",508,517,1025,324,320,314
"820848205",495,565,1060,326,319,295
"820848004",324,406,730,349,539,337
"820848009",397,462,859,367,489,347
"820847712",538,590,1128,354,338,322
"820847709",479,505,984,326,355,304
"820847207",515,538,1053,345,404,316
"820846312",531,496,1027,264,205,185
"820845908",458,465,923,267,281,251
"820845904",1045,986,2031,549,475,443
"820845517",443,445,888,252,238,222
"820845304",636,601,1237,376,405,323
"820845303",539,547,1086,336,352,305
"820848012",190,251,441,188,231,180
"820843308",383,435,818,256,259,246
"820840403",493,502,995,345,394,331
"820840402",359,381,740,253,277,248
"820700703",349,432,781,281,341,275
"820700523",703,751,1454,474,531,466
"820700308",399,471,870,328,408,323
"820700306",341,348,689,245,293,239
"820632613",1195,1233,2428,617,473,445
"820630402",620,669,1289,378,372,357
"820630401",38,34,72,19,32,14
"820560415",379,415,794,241,264,238
"820560217",360,366,726,267,311,264
"820560215",725,786,1511,478,520,468
"821190901",56,49,105,30,30,30
"821190801",635,564,1199,330,327,304
"821191011",389,425,814,299,360,293
"821190121",1137,1103,2240,563,543,504
"821190111",435,401,836,266,344,264
"821190106",551,632,1183,399,392,356
"821190104",412,428,840,264,253,234
"821120311",339,388,727,304,340,287
"821050118",354,382,736,248,275,240
"820490511",565,535,1100,340,318,292
"820490604",616,719,1335,476,512,452
"820490601",337,384,721,256,261,249
"820490523",1399,1397,2796,607,173,161
"820280211",493,523,1016,342,380,333
"820490613",384,474,858,309,373,297
"820070310",720,754,1474,488,556,483
"820490610",471,562,1033,381,416,368
"820845406",225,213,438,128,79,71
"820700211",197,228,425,152,202,151
"820632415",232,324,556,222,307,215
"820632907",471,486,957,255,256,244
"820632904",619,679,1298,431,457,407
"820632901",1006,899,1905,519,716,507
"820632806",1046,1092,2138,567,593,557
"820632802",591,640,1231,374,417,366
"820845205",679,700,1379,363,281,277
"820844519",442,487,929,320,365,306
"820844515",362,391,753,258,260,235
"820841903",322,413,735,359,482,352
"820844503",530,588,1118,367,376,360
"820844604",419,484,903,319,359,302
"820844417",368,408,776,279,336,271
"820841704",324,321,645,278,393,276
"820844303",293,365,658,247,298,243
"820844301",333,356,689,255,304,248
"820844203",191,143,334,124,98,85
"820844201",196,246,442,183,204,137
"820844110",742,781,1523,408,401,378
"820844104",429,521,950,288,222,173
"820844004",515,540,1055,328,372,304
"820843917",182,226,408,187,230,182
"820910614",286,324,610,241,258,236
"820910613",324,331,655,199,219,192
"820843212",792,815,1607,393,386,374
"820843805",358,383,741,284,378,281
"820910409",197,222,419,148,198,146
"820910207",261,252,513,105,116,105
"820843802",344,430,774,309,406,308
"820910107",375,386,761,253,280,246
"820848906",309,381,690,236,249,222
"820843709",229,252,481,220,317,211
"820843705",258,327,585,264,334,241
"820843114",427,495,922,270,299,259
"821260101",310,304,614,210,237,209
"821191003",283,331,614,235,273,219
"820843907",377,490,867,346,448,338
"820843906",357,413,770,307,391,302
"821190209",308,352,660,239,260,230
"820843314",500,501,1001,290,269,263
"821120105",468,487,955,290,330,286
"821050310",934,886,1820,489,474,419
"821050212",407,448,855,295,322,282
"820980315",160,169,329,101,124,99
"820842415",180,247,427,226,368,219
"820843013",361,420,781,242,249,229
"820840416",142,178,320,116,126,112
"820840404",577,517,1094,321,352,312
"820843001",381,430,811,259,237,229
"820633506",393,499,892,324,372,318
"820842914",374,373,747,300,412,286
"820842106",42,49,91,43,68,43
"820845511",509,532,1041,293,266,245
"820770316",595,642,1237,308,348,302
"820770302",470,510,980,287,340,281
"820700605",400,412,812,245,277,241
"820842916",216,239,455,186,238,179
"820700108",307,356,663,234,265,229
"820700103",55,51,106,33,46,32
"820842708",224,352,576,296,491,281
"820842601",270,331,601,282,478,266
"820490119",505,488,993,296,302,284
"820842513",319,425,744,334,368,328
"820420924",279,337,616,232,269,229
"820140411",419,471,890,327,368,321
"820632004",71,146,217,0,0,0
"820842823",152,180,332,157,250,144
"820630404",543,691,1234,372,383,364
"820842819",215,292,507,223,295,213
"820842805",117,153,270,107,165,107
"820630225",400,456,856,195,177,164
"820842718",168,222,390,157,205,156
"820140205",374,436,810,297,337,281
"820842006",186,244,430,240,356,239
"820070405",311,419,730,275,318,272
"820070301",399,458,857,302,319,289
"820842110",214,310,524,249,339,244
"820842109",200,282,482,247,403,243
"820841804",466,561,1027,444,587,428
"820841803",130,181,311,173,263,172
"820841801",460,552,1012,417,542,407
"820420419",488,518,1006,273,294,273
"820420316",597,650,1247,440,438,354
"820842417",146,135,281,114,174,112
"820350117",463,455,918,275,300,268
"820842303",322,409,731,300,412,295
"820280502",322,357,679,238,262,235
"820842210",381,459,840,385,539,352
"820841717",210,266,476,177,252,176
"820841604",381,405,786,299,343,287
"820841507",259,285,544,204,220,177
"820841314",471,477,948,281,250,222
"820841308",454,491,945,308,334,277
"820841707",277,315,592,250,330,248
"820841407",373,439,812,291,338,284
"820841212",443,444,887,267,271,242
"820841206",819,824,1643,461,228,205
"820843618",272,310,582,202,212,194
"820841302",945,970,1915,574,456,403
"820841217",407,460,867,281,180,140
"820841115",306,355,661,214,228,203
"820843616",631,675,1306,382,390,380
"820843613",408,417,825,292,366,279
"820843409",616,674,1290,368,353,272
"820490609",169,214,383,128,163,126
"820841112",424,488,912,300,361,295
"820841111",569,587,1156,371,429,363
"820843517",1426,1346,2772,721,648,621
"820843511",685,715,1400,395,257,229
"820844902",489,574,1063,293,306,288
"820845105",392,447,839,302,340,294
"820845011",572,571,1143,366,348,317
"820210615",231,214,445,133,200,119
"820210612",606,637,1243,403,440,380
"820210606",354,428,782,329,381,318
"820210508",462,493,955,365,396,348
"820844811",753,849,1602,473,484,434
"820210208",410,498,908,368,408,355
"820210125",44,46,90,25,30,24
"820210315",111,109,220,65,75,63
"820210133",543,514,1057,360,412,351
"821190403",583,599,1182,357,373,334
"820848817",557,473,1030,295,150,125
"820848803",386,401,787,272,291,257
"820210103",740,731,1471,426,529,415
"820140609",689,703,1392,403,439,393
"820140601",1538,1496,3034,765,782,726
"820848709",532,582,1114,328,362,312
"820140511",504,490,994,328,353,314
"820845913",316,415,731,267,323,257
"820848707",640,737,1377,452,495,442
"820490518",500,528,1028,309,319,296
"820421105",425,447,872,332,404,329
"821050415",484,455,939,284,283,251
"820421011",1316,1370,2686,684,701,666
"820140130",344,393,737,266,301,259
"820420909",446,610,1056,408,483,402
"820420908",303,337,640,253,285,247
"820420809",401,445,846,333,436,323
"820420720",361,376,737,235,244,218
"820420621",357,363,720,246,302,243
"820420609",145,176,321,124,148,124
"820420504",237,269,506,188,215,188
"820420503",767,730,1497,459,491,445
"820140306",169,158,327,94,113,89
"820140218",677,702,1379,398,434,381
"820420501",634,645,1279,422,461,405
"820420417",640,699,1339,477,548,474
"820420615",110,149,259,99,113,97
"820420611",387,494,881,350,425,347
"820848604",498,525,1023,336,356,319
"820420311",447,406,853,284,328,282
"820842414",178,204,382,182,243,165
"820848515",521,500,1021,278,266,252
"821050407",565,599,1164,389,433,373
"820631308",423,420,843,245,224,219
"820420214",671,670,1341,407,444,400
"820140117",420,386,806,278,307,273
"820420319",255,254,509,178,220,176
"820841813",360,406,766,393,562,369
"820840604",870,836,1706,468,373,345
"820350213",531,527,1058,311,338,299
"820631109",466,432,898,255,127,110
"820070408",513,569,1082,335,356,316
"820631202",304,378,682,229,210,192
"820070407",561,539,1100,361,405,330
"820631118",637,570,1207,301,293,276
"820700502",288,304,592,198,231,196
"820420207",317,334,651,247,284,245
"821050315",253,220,473,141,314,134
"820842324",186,228,414,190,232,167
"820630902",343,395,738,251,255,235
"820842808",167,243,410,214,307,208
"820842613",360,423,783,357,527,350
"820630703",265,316,581,200,280,196
"820630609",664,770,1434,442,485,429
"820630606",386,432,818,257,254,245
"820630605",423,449,872,226,211,201
"820840707",550,597,1147,301,308,284
"820840510",361,382,743,246,298,243
"820630614",463,546,1009,331,342,303
"820848403",808,865,1673,491,521,472
"820840305",715,777,1492,472,458,412
"820848402",558,601,1159,342,350,321
"820630503",765,792,1557,400,274,265
"820770308",817,825,1642,419,437,399
"820770303",719,731,1450,405,457,389
"820560104",294,339,633,213,273,211
"820491017",1011,1032,2043,527,541,491
"820280513",779,747,1526,415,419,387
"820280507",487,494,981,309,320,300
"820630310",715,778,1493,417,408,348
"821050225",163,189,352,141,155,140
"821260517",634,685,1319,411,414,390
"821260513",378,432,810,268,331,262
"821260509",589,575,1164,335,323,308
"821190302",878,946,1824,510,499,452
"820630409",1677,1740,3417,874,798,737
"821050306",662,717,1379,411,450,401
"821330417",623,699,1322,374,421,371
"820630311",801,774,1575,417,479,396
"820280320",367,344,711,226,271,224
"820770107",501,497,998,264,320,259
"820280409",403,463,866,327,365,305
"820910403",264,281,545,163,207,157
"820630216",361,390,751,227,251,219
"820910323",277,302,579,225,234,211
"821260314",519,556,1075,344,402,338
"820848309",257,294,551,203,226,200
"820633409",467,499,966,263,273,256
"820848808",475,527,1002,349,416,332
"820633403",833,823,1656,459,467,433
"820633308",582,761,1343,300,310,292
"820633304",542,575,1117,295,285,265
"820700420",287,280,567,195,229,192
"820700419",388,452,840,338,414,318
"820700412",353,408,761,299,347,291
"820633208",593,642,1235,379,380,336
"820633115",867,925,1792,442,381,364
"820490712",532,645,1177,471,560,444
"820490710",343,411,754,280,323,272
"820490705",485,527,1012,270,264,243
"820633101",1007,1023,2030,574,733,560
"820848303",365,416,781,289,324,269
"820630210",359,393,752,272,326,261
"820630208",915,929,1844,493,496,459
"820630205",442,461,903,308,321,289
"820490719",1201,1206,2407,532,473,457
"820633001",392,509,901,330,371,315
"820630127",445,456,901,305,336,298
"820490410",181,200,381,120,134,118
"820632817",356,340,696,240,575,235
"820632828",372,326,698,259,676,256
"820848215",560,546,1106,310,268,251
"820848213",958,953,1911,517,449,406
"820632809",765,768,1533,418,448,399
"820632808",556,594,1150,313,335,301
"820840909",239,299,538,199,270,196
"820840908",435,479,914,316,325,275
"820632713",994,991,1985,478,480,435
"820632709",845,939,1784,508,521,481
"820632607",592,700,1292,416,438,408
"820632603",551,556,1107,303,316,295
"820632509",404,474,878,339,385,316
"820632416",299,335,634,231,297,210
"820632408",219,273,492,230,316,224
"820632406",141,208,349,175,242,171
"820632405",178,224,402,186,305,182
"820632401",263,360,623,301,455,292
"820490303",418,515,933,316,329,299
"820840811",947,896,1843,438,347,326
"820840810",361,427,788,277,326,271
"820700718",402,463,865,305,364,296
"820700717",400,439,839,321,358,316
"820840804",341,453,794,304,353,299
"820632303",310,377,687,262,341,257
"820632214",201,325,526,252,330,224
"820632208",332,418,750,326,475,314
"820632207",285,400,685,327,459,312
"820632008",394,492,886,312,354,302
"820632006",265,320,585,236,286,227
"820632003",254,301,555,206,242,205
"820631911",459,426,885,247,247,239
"820631909",621,653,1274,396,449,387
"820631805",86,122,208,97,162,94
"820631713",379,426,805,326,377,311
"820631708",374,462,836,291,341,288
"820631603",517,572,1089,395,445,384
"820631512",422,505,927,317,340,307
"820631505",394,436,830,310,360,299
"820631504",280,341,621,239,287,235
"820631407",314,352,666,280,336,273
"820631612",349,399,748,256,288,240
"820631606",266,367,633,241,289,232
"820631410",448,510,958,360,393,330
"820842317",160,257,417,172,245,170
"820631214",500,506,1006,269,248,238
"820631304",353,450,803,296,331,290
"820631208",626,710,1336,377,389,359
"820770207",749,798,1547,448,493,421
"820840713",292,313,605,197,196,175
"820840618",415,448,863,301,279,246
"820840616",1118,1091,2209,600,600,550
"820848114",256,327,583,213,236,199
"820840610",544,564,1108,367,402,353
"820630104",480,493,973,286,318,279
"820630103",526,563,1089,332,382,325
"820560516",446,434,880,259,272,246
"820560509",711,723,1434,427,430,397
"820848106",296,345,641,251,294,226
"820848110",437,480,917,318,339,279
"820848103",290,306,596,231,273,223
"820560501",227,227,454,157,242,148
"820842623",209,270,479,224,329,217
"820560511",718,745,1463,430,436,408
"820560407",199,219,418,180,227,174
"820560413",177,252,429,178,225,169
"820910312",796,841,1637,482,498,452
"820845703",465,479,944,297,456,293
"820845601",30,26,56,25,30,15
"820845506",341,367,708,246,274,237
"820560204",509,590,1099,384,410,367
"820560117",491,465,956,314,547,308
"820845503",384,416,800,277,290,261
"820845501",559,576,1135,388,355,325
"820845418",369,429,798,283,328,277
"821190912",336,338,674,223,250,221
"820845317",256,288,544,202,226,196
"821190910",236,258,494,179,199,174
"821190803",493,557,1050,369,385,354
"820841015",359,414,773,247,158,117
"821190711",258,322,580,208,241,204
"821190705",719,722,1441,430,447,405
"820421207",349,422,771,288,327,279
"821190513",402,434,836,267,292,257
"820848008",460,576,1036,432,626,415
"820847721",551,616,1167,378,444,367
"820421203",731,759,1490,455,510,452
"820849011",583,582,1165,373,538,353
"821190426",683,671,1354,351,138,94
"820846306",652,694,1346,403,378,367
"820280108",427,418,845,258,247,232
"820849009",189,217,406,142,169,139
"820849007",905,932,1837,526,622,496
"820211007",504,568,1072,380,420,377
"820280104",687,727,1414,451,500,439
"820211006",615,636,1251,462,506,454
"820210803",339,396,735,270,322,265
"820210726",591,568,1159,305,322,282
"820210723",13,9,22,7,9,7
"820210717",773,747,1520,420,458,395
"820210714",111,87,198,59,89,56
"821330623",41,30,71,23,41,23
"821330614",76,53,129,40,55,40
"821330612",21,16,37,11,21,10
"821330609",20,13,33,10,19,9
"821330302",0,0,0,0,3,0
"821330220",7,5,12,3,12,3
"821199701",3,2,5,2,4,2
"821190613",33,27,60,21,45,21
"821050204",135,113,248,78,176,69
"821050203",48,38,86,32,57,31
"821050202",45,41,86,27,63,27
"821050104",71,72,143,51,89,46
"820980313",89,72,161,43,52,43
"820980309",74,72,146,40,61,40
"820980304",250,199,449,121,197,120
"820910209",169,136,305,92,126,89
"820910110",85,82,167,46,94,43
"820910108",216,199,415,128,232,124
"820847901",10,12,22,8,16,8
"820700114",61,45,106,36,58,34
"820490411",295,228,523,132,160,127
"820280206",60,50,110,39,96,39
"821330310",83,70,153,43,62,43
"820770310",182,100,282,97,168,97
"821330206",171,160,331,85,113,83
"821330616",10,7,17,6,10,6
"821330522",73,46,119,41,61,41
"820210310",277,245,522,137,199,126
"820149001",40,35,75,23,90,22
"820140501",24,15,39,17,64,17
"820420303",98,79,177,71,124,68
"820210131",141,106,247,57,99,56
"820210116",227,158,385,109,129,99
"820210114",103,77,180,53,63,48
"820280215",41,29,70,22,54,21
"820350208",155,148,303,84,116,82
"820560110",216,196,412,108,161,103
"821330501",93,87,180,41,48,39
"821330203",10,12,22,6,12,6
"821330202",48,27,75,26,28,26
"820630223",276,276,552,140,121,96
"820280317",64,53,117,37,71,37
"820630217",50,28,78,28,101,24
"820770105",196,176,372,109,137,103
"820700604",107,98,205,54,86,52
"820490809",225,193,418,88,110,88
"820490310",179,188,367,88,92,85
"820490307",226,176,402,103,109,103
"820910413",67,61,128,30,80,30
"820490507",171,136,307,93,97,90
"820490504",262,253,515,135,144,132
"820490414",19,16,35,10,12,10
"820770101",217,160,377,106,140,106
"820980102",27,21,48,19,23,18
"820980101",45,30,75,24,33,23
"820490402",183,156,339,97,104,95
"820490327",151,134,285,87,102,86
"820490312",81,59,140,36,48,36
"820280217",49,43,92,28,63,28
"820700610",98,87,185,46,89,44
"820847802",197,169,366,109,139,100
"821199401",5,5,10,4,20,4
"820910301",169,122,291,77,114,72
"820280119",68,35,103,42,78,42
"820490105",183,172,355,94,142,87
"820421201",157,116,273,102,145,102
"821120104",346,285,631,177,273,172
"821050210",122,105,227,72,130,71
"820980108",192,178,370,111,156,106
"820910306",715,630,1345,356,435,332
"820910201",119,87,206,68,109,65
"820846905",320,332,652,209,388,185
"820846501",789,752,1541,461,670,430
"820700613",364,287,651,196,288,189
"820700303",706,699,1405,417,626,401
"820490509",509,536,1045,306,380,302
"820910203",268,194,462,145,199,140
"821330215",96,97,193,51,55,50
"820140416",161,143,304,101,137,74
"820844807",1157,1120,2277,633,358,326
"820630302",385,356,741,222,372,217
"820140418",135,118,253,80,156,78
"820845801",45,35,80,27,47,26
"820630219",72,50,122,53,197,45
"820140202",64,49,113,33,69,32
"820140126",79,59,138,49,131,46
"820420218",206,190,396,122,182,119
"820420119",210,152,362,114,143,92
"821190408",572,627,1199,370,380,329
"821190406",540,534,1074,268,242,230
"820632821",116,90,206,56,73,54
"820846112",595,677,1272,341,316,298
"820845922",856,810,1666,430,364,351
"820845920",444,455,899,290,302,274
"820210618",654,711,1365,441,471,423
"820210617",404,384,788,259,281,253
"820847703",177,167,344,100,174,97
"820211013",805,831,1636,450,507,435
"821050110",436,366,802,223,367,220
"821190411",148,154,302,92,95,91
"820846202",306,320,626,181,151,143
"821330407",311,343,654,237,267,232
"821330209",166,158,324,95,110,92
"821260405",530,532,1062,345,389,342
"821260310",313,360,673,259,293,251
"821191008",370,413,783,293,332,279
"821191004",433,456,889,280,296,269
"821190907",389,439,828,275,297,269
"821120410",429,524,953,398,474,395
"820980314",74,68,142,46,63,46
"820980122",686,588,1274,339,353,317
"820980113",369,412,781,284,316,278
"820910604",306,356,662,223,259,218
"820910507",1256,1314,2570,744,804,704
"820910408",457,478,935,329,383,318
"820910214",541,542,1083,320,372,311
"820849004",416,472,888,290,334,277
"820849003",787,821,1608,467,504,440
"820848507",428,436,864,275,281,262
"820848504",486,474,960,253,243,227
"820848210",988,951,1939,496,480,440
"820847906",484,552,1036,336,387,331
"820847806",521,543,1064,321,345,294
"820846005",617,622,1239,366,401,352
"820845807",527,508,1035,397,495,368
"820845523",380,414,794,247,257,232
"820845520",732,747,1479,412,337,316
"820845519",289,328,617,195,206,172
"820845514",694,697,1391,414,426,402
"820845512",610,604,1214,325,278,258
"820845310",547,625,1172,403,430,387
"820845307",550,625,1175,390,414,380
"820845302",398,486,884,318,368,306
"820843305",751,802,1553,469,440,398
"820840422",366,393,759,247,251,235
"820840202",627,606,1233,324,191,166
"820700309",383,392,775,330,425,317
"820630325",597,555,1152,368,453,351
"820630324",655,662,1317,422,643,409
"820632707",375,447,822,310,354,302
"820630306",265,301,566,194,232,188
"820560402",583,623,1206,378,406,368
"820560216",319,343,662,236,249,228
"820490915",581,591,1172,335,362,323
"820491005",715,824,1539,454,465,430
"820491003",494,595,1089,293,294,286
"821190716",630,628,1258,369,379,339
"821190609",591,642,1233,419,447,404
"821190514",602,624,1226,362,405,351
"821190310",307,320,627,170,184,158
"821190309",392,431,823,270,286,259
"821190119",630,624,1254,328,272,256
"821190206",508,529,1037,373,395,352
"821190118",436,462,898,248,257,238
"821190205",516,608,1124,385,433,370
"821190203",672,722,1394,450,430,399
"821120406",728,714,1442,399,385,356
"821120314",643,657,1300,406,454,381
"821190208",307,353,660,236,262,223
"821120412",703,685,1388,452,493,442
"821190122",540,573,1113,287,310,282
"821120108",343,389,732,263,293,260
"821120419",662,675,1337,393,424,380
"821120210",496,536,1032,358,378,339
"821050514",587,657,1244,366,413,359
"821050511",530,515,1045,289,311,279
"821050217",395,429,824,297,328,285
"821050213",664,732,1396,488,539,479
"821050221",571,621,1192,389,418,378
"821050117",351,403,754,304,342,296
"820490602",424,474,898,288,302,281
"820490526",438,488,926,326,331,303
"820490525",477,514,991,311,344,299
"820490616",371,498,869,353,402,336
"820280210",21,33,54,23,37,23
"821260216",90,65,155,44,58,42
"820845314",281,341,622,232,256,221
"820700319",594,629,1223,368,394,348
"820700311",750,773,1523,418,445,402
"820700201",544,554,1098,379,391,353
"820632903",377,447,824,258,292,256
"820632803",719,781,1500,418,447,409
"820632706",486,574,1060,411,476,400
"820845204",614,708,1322,378,385,360
"820844713",396,414,810,236,218,203
"820844517",519,536,1055,328,331,307
"820844513",181,201,382,130,134,121
"820844510",473,513,986,292,313,264
"820844704",956,950,1906,513,305,292
"820844609",1038,1038,2076,541,378,364
"820844403",533,597,1130,361,370,328
"820844402",184,226,410,179,195,160
"820844309",313,371,684,245,301,243
"820844213",751,754,1505,414,322,294
"820844206",176,191,367,114,105,104
"820844205",336,387,723,205,190,172
"820844202",351,324,675,172,118,101
"821260401",638,640,1278,447,507,439
"820980206",495,489,984,284,347,275
"820842811",371,472,843,413,553,410
"820844211",448,477,925,275,197,180
"820910205",16,16,32,10,16,10
"820910103",412,482,894,308,344,294
"820843708",373,469,842,384,534,377
"820848406",422,481,903,282,306,274
"820843619",230,280,510,210,283,202
"820846310",746,798,1544,412,392,375
"820843915",205,271,476,219,322,218
"821190603",800,808,1608,495,526,468
"820843911",291,341,632,233,259,207
"820843908",396,525,921,420,598,412
"820843904",253,308,561,232,275,227
"820843815",289,332,621,233,255,194
"821120304",34,28,62,16,20,16
"820632113",215,279,494,209,303,208
"820843311",750,747,1497,418,380,361
"820632112",317,431,748,346,450,340
"820843814",380,506,886,352,383,347
"820843811",450,599,1049,327,374,313
"820843810",387,453,840,307,350,294
"820843110",430,485,915,303,302,281
"820843014",586,583,1169,367,389,344
"820843008",464,484,948,286,293,269
"820770404",85,84,169,57,74,56
"820633105",54,56,110,30,38,28
"820632612",500,623,1123,356,372,347
"820632402",213,319,532,261,402,255
"820700701",313,378,691,257,280,254
"820842923",174,202,376,156,229,152
"820842016",181,209,390,151,197,151
"820700514",56,69,125,35,51,33
"820700110",294,285,579,186,248,185
"820490603",666,790,1456,480,531,457
"820842707",243,312,555,262,333,223
"820842705",151,218,369,180,308,180
"820842607",243,302,545,282,444,254
"820490405",99,104,203,63,68,62
"820842906",173,216,389,175,245,164
"820842825",169,243,412,222,375,217
"820842801",168,228,396,164,252,150
"820630206",399,539,938,332,359,321
"820842721",225,302,527,251,402,239
"820842720",148,269,417,199,366,195
"820842715",312,379,691,303,454,299
"820842713",217,278,495,232,369,230
"820842007",264,307,571,263,454,260
"820842005",165,209,374,160,217,158
"820841808",250,275,525,247,372,247
"820420219",604,618,1222,380,432,371
"820420210",279,292,571,169,209,168
"820420104",166,186,352,110,146,109
"820842304",195,248,443,189,264,188
"820842010",141,208,349,167,262,161
"820842212",322,432,754,355,525,351
"820280120",220,237,457,173,192,166
"820280117",465,476,941,334,395,326
"820210313",501,501,1002,341,444,336
"820210217",897,898,1795,467,463,443
"820841410",522,521,1043,351,377,336
"820841611",230,284,514,195,222,177
"820841607",395,472,867,447,682,427
"820841402",252,277,529,205,257,200
"820841215",445,504,949,305,334,291
"820841214",459,508,967,336,364,317
"820841213",488,530,1018,293,279,262
"820841714",307,391,698,225,342,215
"820841711",364,434,798,369,551,357
"820841702",279,287,566,239,363,239
"820841404",440,496,936,315,338,290
"820841207",373,387,760,241,246,215
"820841305",346,433,779,272,308,263
"820841116",389,445,834,275,300,270
"820843510",631,691,1322,368,237,207
"820843506",326,397,723,257,284,245
"820843418",202,224,426,154,179,150
"820841119",423,502,925,323,356,312
"820843405",450,481,931,361,433,346
"820843601",301,334,635,250,285,240
"820841912",231,349,580,266,464,264
"820843513",502,476,978,261,264,238
"820845009",291,316,607,195,208,189
"820845007",683,681,1364,391,403,362
"820845005",500,542,1042,346,377,333
"820844907",971,958,1929,473,351,334
"821260203",33,32,65,23,32,23
"820845208",742,764,1506,380,260,247
"820845106",538,627,1165,399,415,385
"820845012",713,741,1454,427,457,409
"820844819",549,495,1044,295,282,275
"820845209",533,548,1081,314,179,162
"820844809",343,366,709,219,197,175
"820844808",383,439,822,231,238,213
"820210403",307,302,609,216,221,209
"820210307",117,109,226,64,72,62
"820210202",489,565,1054,382,398,372
"820210502",704,664,1368,355,290,282
"820210414",365,413,778,320,352,309
"820210405",323,348,671,231,256,230
"820210333",244,244,488,144,167,140
"820210123",140,139,279,88,103,85
"820845918",639,759,1398,438,467,421
"820210104",435,490,925,332,369,319
"820848710",587,638,1225,376,400,369
"820848812",714,706,1420,378,326,301
"820210110",587,582,1169,388,423,367
"820848705",442,451,893,290,305,276
"820070313",370,413,783,264,292,251
"820421013",424,467,891,290,309,269
"820140509",326,331,657,231,252,222
"820842406",223,282,505,226,319,223
"820140214",241,290,531,208,260,196
"820140207",465,510,975,327,360,313
"820420913",305,340,645,243,276,238
"820842619",147,177,324,138,214,137
"820421002",727,730,1457,462,485,429
"820420905",520,549,1069,352,379,344
"820420719",269,309,578,209,228,191
"820420715",855,771,1626,441,497,419
"820420710",415,452,867,334,400,327
"820848703",371,416,787,260,271,240
"820420618",426,443,869,265,285,252
"820420602",455,430,885,269,260,222
"820420508",706,676,1382,456,481,418
"820140309",386,412,798,282,306,269
"820140302",285,398,683,259,301,248
"820420414",348,410,758,262,297,251
"820420413",604,616,1220,380,400,364
"820420402",1034,915,1949,561,587,532
"820420616",346,392,738,262,309,260
"820420613",396,453,849,320,380,316
"820070207",354,359,713,243,276,234
"820070201",456,471,927,332,351,321
"820420213",361,429,790,305,333,300
"820631113",728,750,1478,397,310,299
"820280216",293,317,610,235,276,230
"821050404",291,384,675,256,294,252
"820070411",266,347,613,236,265,233
"820420404",648,688,1336,438,478,422
"820140115",626,694,1320,460,506,443
"820140110",604,634,1238,432,486,424
"820140103",406,430,836,281,300,270
"820070413",564,545,1109,294,316,278
"820070311",406,472,878,324,382,324
"821050401",626,632,1258,355,369,335
"820420405",282,330,612,219,257,216
"820420111",494,517,1011,344,390,340
"820840605",965,926,1891,479,460,436
"820350212",643,640,1283,382,441,360
"820840603",334,421,755,287,308,271
"820420205",501,532,1033,352,403,337
"820631104",385,447,832,251,250,225
"820631305",367,404,771,259,283,246
"820630909",342,441,783,285,325,278
"820631007",755,781,1536,433,415,390
"820630714",278,337,615,216,235,212
"820560109",360,407,767,278,306,273
"820630707",370,434,804,299,339,283
"820630618",297,393,690,234,261,217
"820350114",559,642,1201,348,395,337
"820842322",215,238,453,214,275,188
"820630617",389,475,864,304,344,290
"820630608",297,359,656,212,224,204
"820848408",476,548,1024,317,316,303
"820840508",406,458,864,312,361,301
"820842807",345,443,788,365,547,350
"820840410",332,359,691,246,275,241
"820631003",362,413,775,258,242,228
"820840407",308,317,625,214,242,208
"820840309",539,554,1093,297,312,288
"820840306",773,857,1630,480,432,395
"820840304",606,619,1225,346,295,263
"820841811",346,475,821,341,482,331
"820840214",754,726,1480,435,445,396
"820630507",726,716,1442,360,240,235
"820630505",541,573,1114,290,279,266
"820630501",1162,1107,2269,535,510,501
"820840420",541,634,1175,355,379,333
"820491016",994,973,1967,469,502,443
"820280515",744,791,1535,387,381,357
"820280509",625,654,1279,366,366,337
"820280505",762,762,1524,476,497,453
"820280501",560,599,1159,297,175,155
"820280403",566,594,1160,363,393,347
"820280327",161,149,310,105,137,93
"821330204",256,262,518,155,131,87
"821050226",263,315,578,210,246,208
"821050120",547,565,1112,340,368,328
"821260514",527,486,1013,290,293,270
"820630232",638,656,1294,392,411,372
"820491007",1586,1574,3160,775,753,680
"821050305",355,399,754,290,363,286
"821050303",406,501,907,352,413,340
"821050302",567,596,1163,329,339,315
"820280321",307,326,633,228,267,219
"820280308",437,494,931,327,389,316
"820910404",172,175,347,108,108,102
"820910321",516,547,1063,351,382,328
"820910317",736,779,1515,499,513,475
"821260501",305,336,641,222,262,215
"821260313",744,765,1509,458,506,450
"820633501",454,453,907,237,214,204
"820700320",501,509,1010,325,353,309
"820848311",438,494,932,334,349,317
"820633213",771,841,1612,530,580,520
"820633210",473,511,984,301,302,283
"820490703",305,333,638,226,262,219
"820633106",588,662,1250,329,333,308
"820633111",627,622,1249,311,292,281
"820490716",851,875,1726,424,421,407
"820280221",338,391,729,285,329,281
"820633005",324,368,692,246,236,222
"820630121",332,367,699,220,253,210
"820630119",615,637,1252,407,446,398
"821260114",292,329,621,231,258,225
"820070401",418,392,810,254,286,247
"820490326",1195,1222,2417,638,419,398
"820632604",537,572,1109,307,289,267
"820632502",519,609,1128,370,412,356
"820632912",304,375,679,238,253,224
"820632512",162,197,359,123,126,119
"820490306",520,548,1068,334,335,324
"820632306",543,589,1132,440,573,424
"820632210",198,277,475,208,298,200
"820632115",346,329,675,167,222,163
"820632106",288,420,708,254,308,253
"820632010",451,518,969,313,334,294
"820632007",222,259,481,168,201,163
"820632005",183,233,416,159,192,154
"820630123",386,413,799,255,293,249
"820631908",364,336,700,187,173,169
"820631907",460,577,1037,368,428,356
"820631812",170,258,428,197,288,191
"820631604",301,343,644,251,280,242
"820631405",339,446,785,286,304,276
"820631320",305,364,669,217,241,212
"820631209",569,632,1201,396,435,381
"820840721",904,925,1829,420,193,189
"820841920",159,215,374,198,289,186
"820848119",434,443,877,309,320,294
"820700611",430,487,917,338,384,333
"820841003",369,399,768,225,230,213
"820840715",382,430,812,292,295,268
"820840712",349,383,732,273,332,268
"820848118",372,447,819,277,333,265
"820840620",430,488,918,299,332,292
"820840615",466,474,940,289,152,133
"820848117",341,389,730,271,309,264
"820840706",1186,1275,2461,671,631,618
"820848104",289,335,624,232,289,228
"820848111",260,305,565,228,250,192
"820560410",332,356,688,254,277,248
"820848016",367,401,768,297,406,283
"820845713",422,438,860,280,304,268
"820560209",193,163,356,106,117,105
"820845711",594,578,1172,326,439,308
"820845510",711,670,1381,374,368,341
"820845507",501,533,1034,348,345,320
"820560203",313,326,639,240,276,236
"820845502",569,637,1206,361,376,347
"820845417",360,438,798,260,287,247
"820845415",483,565,1048,346,369,328
"821190815",621,675,1296,403,341,317
"821190810",426,501,927,344,357,320
"821190808",516,610,1126,375,377,354
"820841020",577,574,1151,300,329,287
"820490107",430,435,865,214,189,172
"821190804",424,501,925,333,339,313
"820841001",791,775,1566,420,143,133
"820841004",922,926,1848,498,323,290
"820421212",546,620,1166,390,415,385
"820490102",1264,1275,2539,662,729,649
"821190509",351,397,748,263,318,261
"821190512",349,338,687,218,272,199
"820280112",506,528,1034,360,402,354
"820847725",387,454,841,284,306,278
"820847724",368,437,805,270,244,213
"820847723",665,784,1449,455,500,434
"820847718",1035,975,2010,478,302,277
"820846304",517,534,1051,286,315,265
"820846211",537,566,1103,309,253,239
"820849008",433,420,853,273,417,254
"820211017",480,508,988,367,404,349
"820846207",795,822,1617,449,397,369
"820846217",894,944,1838,485,409,395
"820211002",286,308,594,205,226,204
"820842610",293,376,669,323,540,314
"821190425",374,435,809,274,323,270
"820210907",407,495,902,346,408,332
"820210905",364,364,728,258,262,238
"820210903",499,531,1030,379,404,355
"820210901",509,614,1123,432,503,422
"821190423",420,425,845,237,223,203
"820210914",391,423,814,298,311,279
"820210913",359,402,761,253,272,245
"820210911",598,589,1187,383,384,344
"821190420",480,497,977,294,299,279
"820210718",646,658,1304,357,356,332
"820210711",74,57,131,37,106,34
"820846001",102,90,192,52,64,50
"821330628",20,8,28,9,11,8
"821330524",54,31,85,34,52,34
"821330512",33,29,62,21,33,21
"821330307",59,26,85,39,80,39
"821190610",95,62,157,54,137,53
"821190607",25,22,47,17,34,16
"821190601",168,161,329,98,123,94
"821190113",19,20,39,12,26,11
"821120315",28,21,49,19,36,15
"821120214",35,26,61,18,42,18
"821050510",55,59,114,32,45,30
"821050208",55,57,112,31,70,31
"821050201",110,91,201,56,78,55
"820980307",28,18,46,14,29,14
"820980301",33,15,48,17,39,17
"820980202",54,57,111,40,55,40
"820980201",149,106,255,78,161,77
"820980106",33,28,61,19,25,18
"820910411",157,130,287,79,104,75
"820910210",99,87,186,54,76,53
"820847101",11,11,22,7,29,7
"820847501",17,17,34,10,18,7
"820846703",30,31,61,19,25,19
"820770409",6,7,13,3,8,3
"820700210",274,232,506,145,194,136
"820700206",163,109,272,69,130,65
"820560312",186,138,324,96,174,90
"820490412",259,251,510,134,153,129
"820140515",35,25,60,24,33,23
"821330601",19,17,36,12,11,11
"820632824",1,1,2,2,8,2
"821330107",124,94,218,65,69,64
"821120302",83,58,141,43,80,42
"820490802",148,159,307,64,59,57
"820210328",92,82,174,47,88,43
"820140125",32,17,49,20,92,19
"821190401",96,73,169,43,45,42
"820140520",17,13,30,10,33,10
"820140122",28,28,56,17,53,17
"820420320",42,34,76,27,36,25
"820490317",42,46,88,23,31,23
"820070104",112,120,232,71,134,71
"820210120",177,139,316,78,90,69
"820420209",58,42,100,35,66,34
"820420203",95,85,180,58,97,58
"820420124",181,160,341,112,184,106
"820560201",328,315,643,178,270,173
"820140120",60,50,110,35,46,34
"820420307",80,64,144,46,59,45
"820350201",10,6,16,5,19,5
"820350106",504,458,962,213,277,203
"820350103",121,82,203,64,126,64
"820630218",85,81,166,53,81,49
"820490811",35,4,39,0,0,0
"820630202",62,51,113,37,62,37
"820490407",74,59,133,33,45,33
"820490508",102,98,200,60,79,59
"820630203",34,33,67,22,39,22
"820980104",35,37,72,19,27,19
"820700519",183,193,376,107,137,102
"821199601",2,4,6,2,4,1
"820910218",77,66,143,39,64,38
"820280118",36,32,68,20,37,20
"820490111",120,110,230,68,75,61
"820847701",103,84,187,56,73,51
"820280106",35,19,54,20,106,20
"821330617",575,524,1099,294,357,286
"820560308",413,355,768,215,447,212
"821050115",563,442,1005,307,513,293
"820910202",137,101,238,76,194,75
"820210331",98,86,184,47,99,43
"820846701",209,180,389,134,263,128
"820210126",122,99,221,55,90,52
"820350202",1001,1048,2049,556,813,522
"820140128",101,95,196,64,115,53
"820070102",216,175,391,118,180,117
"820420117",213,212,425,121,158,99
"820846115",1229,1127,2356,586,578,532
"820846108",753,735,1488,389,347,342
"820846106",393,434,827,251,263,227
"820210620",675,736,1411,406,441,391
"820210619",762,789,1551,452,434,386
"821330534",419,429,848,251,277,233
"821260217",587,559,1146,387,428,372
"821260408",404,403,807,294,327,288
"821260205",92,80,172,50,62,50
"820910608",791,870,1661,476,483,431
"820910303",278,284,562,150,180,148
"820910113",487,516,1003,318,326,297
"820848904",643,637,1280,350,346,316
"820848007",285,308,593,250,330,235
"820847711",678,685,1363,379,392,357
"820843309",768,804,1572,460,459,426
"820847716",434,460,894,288,292,272
"820840405",501,602,1103,381,424,362
"820840401",263,271,534,162,171,155
"820840207",398,407,805,252,279,226
"820840103",1084,1060,2144,641,993,620
"820770408",79,67,146,44,50,42
"820700708",810,817,1627,499,514,479
"820840206",1134,1134,2268,598,633,568
"820632708",338,398,736,258,283,254
"820630326",487,517,1004,311,355,211
"820630305",303,318,621,208,313,202
"820560113",204,208,412,133,354,131
"820491004",620,692,1312,349,355,342
"820491001",422,443,865,280,299,265
"821190903",507,488,995,279,297,274
"821191013",401,465,866,278,313,272
"821190714",374,420,794,268,295,263
"821190202",702,763,1465,446,463,438
"821120415",616,700,1316,477,559,472
"821120316",432,483,915,297,324,296
"821120310",170,171,341,106,109,93
"821120207",267,283,550,188,222,186
"821120206",183,177,360,110,129,110
"821190102",1063,1098,2161,595,653,570
"821120209",743,760,1503,463,485,437
"821120208",340,363,703,237,282,223
"821050216",44,35,79,28,35,28
"820490513",482,560,1042,384,435,369
"820560404",331,402,733,271,325,269
"820632610",401,439,840,244,264,243
"820700316",450,479,929,290,323,281
"820700315",860,873,1733,481,489,442
"820632801",457,506,963,314,332,301
"820632703",404,408,812,271,285,262
"820844804",468,501,969,282,220,213
"820844709",353,387,740,236,299,226
"820844708",433,429,862,270,242,221
"820841906",197,250,447,208,333,201
"820841905",191,264,455,197,260,193
"820844514",502,578,1080,354,361,330
"820844608",425,469,894,303,367,294
"820844416",445,501,946,327,353,306
"820844414",322,363,685,242,281,228
"820844401",494,534,1028,373,418,359
"820844314",539,593,1132,375,429,367
"820844311",401,458,859,299,311,267
"820844209",551,599,1150,349,282,253
"820844204",372,385,757,232,245,221
"820844107",517,537,1054,351,414,340
"820844012",105,117,222,74,89,74
"820844006",280,337,617,265,413,261
"820844003",390,434,824,372,504,370
"820844001",398,433,831,345,468,317
"820843919",226,238,464,201,260,198
"820910503",439,476,915,273,301,260
"820910501",438,463,901,296,333,287
"820910406",65,64,129,39,57,38
"820210101",69,82,151,55,62,55
"820843803",332,412,744,299,427,297
"820910208",38,41,79,21,34,19
"820843715",288,329,617,252,377,243
"820843713",394,423,817,327,383,322
"820843712",420,485,905,340,397,322
"820843207",547,543,1090,290,289,262
"820848609",640,674,1314,373,235,228
"820848314",510,616,1126,366,395,351
"820843205",470,530,1000,308,321,289
"820846602",1417,1463,2880,864,894,774
"820846406",342,347,689,198,203,183
"820846308",732,692,1424,379,374,356
"820844615",362,398,760,223,230,211
"820843111",436,515,951,328,356,319
"820843914",166,187,353,149,234,147
"821190706",444,475,919,327,393,320
"820843909",212,281,493,212,277,201
"821120418",434,416,850,240,258,223
"820843312",596,659,1255,396,387,364
"821050219",78,80,158,56,79,56
"821050114",401,419,820,262,299,257
"821050107",244,243,487,145,108,88
"820843809",270,289,559,209,243,183
"820843109",243,307,550,202,213,195
"820843108",389,446,835,269,256,229
"820843107",260,292,552,192,214,188
"820843012",488,486,974,277,275,262
"820843010",580,658,1238,368,352,332
"820843009",606,600,1206,367,360,325
"820843005",454,504,958,319,317,276
"820843003",946,944,1890,613,622,527
"820840414",338,416,754,279,289,253
"820840413",578,640,1218,333,362,316
"820633507",320,405,725,318,432,305
"820633502",422,433,855,268,291,258
"820845921",904,872,1776,494,364,347
"820843119",341,419,760,267,281,237
"820845410",267,258,525,165,153,139
"820843118",348,415,763,271,306,263
"820843116",414,495,909,328,352,315
"820845103",399,461,860,310,366,298
"820842712",333,455,788,353,609,346
"820842711",211,249,460,226,382,224
"820490810",612,532,1144,238,265,231
"820842710",260,332,592,265,393,254
"820842922",170,208,378,151,216,149
"820842921",153,181,334,160,255,156
"820842915",348,339,687,315,438,308
"820842706",144,235,379,151,218,146
"820842701",423,486,909,311,509,308
"820842604",312,418,730,334,468,329
"820490333",610,607,1217,338,268,242
"820842514",69,85,154,86,190,86
"820490121",1309,1270,2579,671,547,521
"820421112",334,316,650,219,251,215
"820842508",303,374,677,337,486,304
"820842501",238,325,563,244,348,243
"820140419",469,522,991,352,384,338
"820842902",298,393,691,359,532,336
"820630303",244,273,517,167,499,164
"820842717",131,183,314,156,205,150
"820140129",80,72,152,46,52,44
"820842116",276,336,612,266,401,263
"820842113",56,80,136,64,100,60
"820842107",255,333,588,294,485,290
"820842001",238,292,530,212,349,210
"820842306",270,330,600,258,368,255
"820842305",287,369,656,276,350,273
"820280303",541,608,1149,359,364,333
"820842213",174,221,395,190,276,185
"820842208",360,458,818,303,431,296
"820210507",297,331,628,242,243,215
"820842206",322,351,673,304,426,300
"820842204",19,1,20,4,4,4
"820841608",211,260,471,215,292,201
"820841602",436,461,897,344,425,329
"820841505",333,366,699,244,276,227
"820841313",696,725,1421,449,441,402
"820841309",302,313,615,212,248,207
"820841306",534,546,1080,328,361,318
"820841710",287,344,631,287,378,252
"820841709",314,409,723,314,418,309
"820841405",354,415,769,270,302,258
"820841219",514,504,1018,240,116,112
"820843617",268,318,586,199,248,195
"820843615",311,320,631,203,210,190
"820843505",444,532,976,323,344,275
"820843608",423,483,906,333,410,322
"820843607",376,414,790,267,320,266
"820843602",353,367,720,240,280,235
"820843515",667,723,1390,416,431,386
"820843512",816,825,1641,467,484,447
"820845203",555,641,1196,392,380,374
"820845113",362,341,703,189,194,172
"820843316",631,653,1284,368,372,345
"820845008",621,645,1266,373,354,337
"820845006",599,632,1231,379,350,324
"820844914",863,806,1669,391,157,138
"820844912",683,718,1401,344,215,208
"820210607",544,627,1171,449,509,444
"820210605",492,553,1045,374,391,350
"820844813",745,782,1527,414,322,307
"820845210",560,569,1129,278,228,223
"820210318",498,531,1029,366,424,355
"820210209",574,598,1172,422,461,386
"820210205",716,764,1480,456,434,410
"820210402",407,451,858,298,312,285
"820210201",597,641,1238,425,428,376
"821050419",720,776,1496,489,541,470
"820848807",973,942,1915,475,444,414
"820210421",311,322,633,207,217,196
"820210407",226,231,457,147,153,139
"820210406",711,690,1401,426,467,423
"820210332",125,137,262,89,106,88
"820210118",373,373,746,249,217,200
"820140606",422,437,859,262,312,248
"820140604",527,557,1084,356,392,344
"820848706",851,878,1729,551,580,532
"821050414",747,707,1454,444,476,419
"820140507",399,425,824,306,333,303
"820848708",650,735,1385,434,442,412
"820420920",536,542,1078,316,324,281
"820140211",282,342,624,240,311,230
"820140210",355,433,788,338,426,330
"820140206",481,505,986,322,357,309
"820140204",817,788,1605,491,522,467
"820420916",794,807,1601,525,556,501
"820421006",381,405,786,261,263,244
"820420906",993,988,1981,545,579,520
"820420721",342,380,722,232,259,225
"820420718",331,391,722,258,301,256
"820420902",475,493,968,292,327,284
"820420702",457,440,897,262,292,254
"820848701",141,162,303,107,119,105
"820420605",449,495,944,328,371,322
"820420603",547,578,1125,384,422,379
"820420601",454,455,909,307,323,291
"820420505",299,398,697,279,294,244
"820420919",685,624,1309,372,389,322
"820420917",625,604,1229,349,375,326
"820140311",426,434,860,298,387,288
"820140308",459,436,895,259,276,254
"820140305",357,425,782,289,312,279
"820140301",265,312,577,228,245,212
"820420502",493,537,1030,375,435,372
"820842616",335,467,802,348,512,340
"820420410",234,288,522,218,260,213
"820848611",631,632,1263,332,187,181
"820420614",328,382,710,262,289,255
"820420612",377,445,822,307,392,300
"820420610",559,595,1154,431,513,429
"820420318",606,612,1218,391,434,377
"820420310",332,352,684,232,271,231
"820848601",441,488,929,275,255,228
"820848516",435,406,841,235,261,232
"820070208",888,841,1729,520,522,475
"821050406",288,381,669,266,342,259
"820840608",351,422,773,294,333,289
"820140113",470,475,945,313,327,299
"820140104",275,343,618,230,267,220
"820848412",1063,1101,2164,586,611,559
"821050412",564,579,1143,409,444,391
"821050402",395,401,796,291,309,272
"820420115",351,347,698,272,302,267
"820420103",389,412,801,283,312,274
"820350211",891,929,1820,546,649,530
"820840516",465,447,912,311,364,304
"820070211",657,682,1339,392,371,352
"820420208",315,342,657,243,266,235
"820848409",880,972,1852,562,569,537
"820631106",1041,1022,2063,634,412,393
"820630805",282,382,664,241,260,232
"820630803",307,396,703,257,283,250
"820630801",290,377,667,241,277,231
"820630701",562,555,1117,302,307,286
"820630512",376,405,781,233,269,223
"820630511",739,699,1438,347,335,320
"820840513",301,339,640,225,256,222
"820840511",438,466,904,297,379,296
"820848407",303,312,615,165,154,140
"820840311",955,875,1830,505,342,304
"820842321",150,163,313,123,214,114
"820630502",849,915,1764,442,389,387
"820840506",439,528,967,334,385,329
"820840504",177,220,397,131,159,128
"820848404",885,899,1784,525,551,494
"820840209",729,786,1515,467,531,442
"820848401",651,633,1284,320,303,283
"820280517",831,879,1710,436,393,386
"820280516",396,404,800,258,258,230
"820280511",686,730,1416,457,491,447
"820280402",396,441,837,283,302,266
"820842320",204,275,479,191,254,191
"821050227",356,365,721,250,298,248
"820630616",424,466,890,291,326,286
"821260510",481,502,983,333,382,324
"820491010",610,594,1204,377,410,364
"821190303",364,420,784,265,293,258
"820630316",673,692,1365,384,399,358
"821050304",276,362,638,248,261,244
"821330313",992,999,1991,504,580,488
"820280411",392,428,820,289,325,287
"820280410",724,807,1531,491,507,464
"820280307",538,593,1131,364,405,352
"820910405",54,48,102,24,25,24
"820842620",178,232,410,198,287,187
"820910322",651,693,1344,438,490,425
"820910320",382,376,758,237,239,223
"820848310",260,296,556,205,227,196
"820700218",573,557,1130,353,376,348
"820842319",206,257,463,218,287,197
"820848308",471,540,1011,364,396,344
"820633411",457,516,973,289,315,276
"820633408",375,382,757,218,233,209
"820633407",419,452,871,264,277,258
"820633406",1027,1106,2133,545,567,529
"820633401",1423,1496,2919,725,751,708
"820633310",499,513,1012,276,275,267
"820633309",417,435,852,226,230,209
"820633305",406,439,845,260,274,239
"820700417",1149,1074,2223,633,703,602
"820633202",534,565,1099,315,314,294
"820490711",306,390,696,264,295,256
"820490516",684,712,1396,419,401,369
"820630209",354,422,776,275,306,271
"820490903",227,215,442,123,138,122
"820633107",684,712,1396,402,444,386
"820490717",833,874,1707,484,512,473
"820633010",612,714,1326,413,432,397
"820630201",157,156,313,95,112,88
"820630129",1021,1050,2071,562,626,541
"820632829",514,497,1011,292,535,284
"820848212",698,763,1461,367,310,281
"820490330",449,460,909,319,348,306
"820632814",847,877,1724,468,573,451
"820632715",678,675,1353,373,380,330
"820840907",1052,1235,2287,720,766,668
"820632504",235,276,511,197,253,189
"820632503",457,577,1034,403,522,396
"820840902",439,484,923,355,424,342
"820632404",201,315,516,236,315,231
"820490213",433,469,902,247,272,235
"820840809",365,444,809,312,366,288
"820840806",427,481,908,314,342,297
"820632308",378,519,897,372,501,358
"820840803",419,504,923,303,357,285
"820632302",340,434,774,314,399,305
"820632209",216,308,524,273,377,252
"820632201",221,287,508,221,310,217
"820632108",290,375,665,258,331,256
"820632101",289,410,699,328,403,319
"820632002",162,179,341,121,147,118
"820630107",452,436,888,299,329,269
"820631902",312,401,713,253,283,243
"820631714",336,460,796,340,364,313
"820631704",229,236,465,173,211,170
"820631509",329,400,729,266,324,264
"820631507",398,436,834,285,330,262
"820631408",369,451,820,312,340,296
"820631314",361,416,777,282,294,274
"820631206",283,276,559,161,115,87
"820631212",361,481,842,302,338,282
"820848120",395,396,791,266,281,259
"820848115",152,173,325,103,128,99
"820840701",455,453,908,268,241,225
"820840624",218,267,485,154,172,147
"820841814",209,258,467,221,303,205
"820848105",286,358,644,224,251,212
"820560505",509,559,1068,382,445,367
"820848101",452,545,997,331,367,314
"820560409",390,491,881,328,379,315
"820845707",320,341,661,220,423,217
"820845419",211,266,477,170,190,168
"820845414",493,558,1051,350,381,322
"820845409",413,466,879,276,297,262
"820845403",274,327,601,209,223,203
"820845401",154,223,377,134,159,130
"820845323",987,992,1979,562,495,458
"820845316",454,452,906,259,292,249
"820845212",549,557,1106,285,281,267
"821190908",324,367,691,241,282,232
"820841013",566,580,1146,347,301,259
"820841012",876,951,1827,507,399,374
"820841007",1322,1260,2582,670,400,380
"820841005",639,609,1248,338,216,197
"821190517",291,338,629,201,254,199
"820421118",429,456,885,307,366,303
"821190510",763,755,1518,417,448,394
"821190508",509,509,1018,300,331,286
"821190507",878,857,1735,468,472,431
"820846303",768,803,1571,401,325,306
"820280109",290,329,619,217,239,213
"820848903",1031,1019,2050,526,523,491
"820280101",721,804,1525,535,596,511
"820211015",517,544,1061,397,442,390
"820211012",128,141,269,80,89,75
"820846205",730,747,1477,412,288,266
"820210810",548,571,1119,364,374,355
"820210720",423,445,868,294,313,280
"820210705",65,52,117,33,63,32
"821330610",44,40,84,21,31,19
"821330516",23,11,34,12,18,12
"821330318",78,67,145,44,60,43
"821330314",117,124,241,66,88,66
"821330211",103,87,190,51,86,50
"821260212",113,83,196,61,101,52
"821190817",108,95,203,59,48,35
"821190103",88,76,164,40,69,38
"821120309",43,38,81,30,61,28
"821120107",131,70,201,57,171,56
"821050205",80,82,162,53,78,49
"820980109",18,16,34,11,18,11
"820910307",224,178,402,98,100,82
"820910212",50,38,88,36,66,35
"820847904",6,3,9,4,19,4
"820847401",150,145,295,96,105,76
"820846003",20,15,35,14,16,11
"820845906",379,398,777,203,221,200
"820845806",13,15,28,7,15,7
"820700212",214,179,393,98,159,94
"820770311",164,99,263,91,149,90
"820700202",283,259,542,164,221,156
"820490208",17,15,32,12,19,12
"820845919",8,13,21,4,6,4
"820140611",39,36,75,27,83,26
"820210102",41,36,77,21,47,19
"820280218",17,20,37,13,27,13
"820560106",180,141,321,109,198,109
"820350115",40,26,66,21,38,21
"820350110",287,271,558,151,185,146
"820350105",21,24,45,16,26,16
"821330104",36,16,52,24,34,24
"821330102",76,41,117,41,65,39
"820630227",141,163,304,84,121,83
"820700106",51,30,81,28,57,28
"820980310",329,304,633,180,248,180
"820490818",263,250,513,138,148,136
"820630115",71,80,151,51,59,50
"820490309",19,12,31,10,49,10
"820910315",316,247,563,149,189,137
"820490506",160,152,312,78,92,75
"820490505",135,158,293,77,83,75
"820490419",6,9,15,3,5,3
"820630113",81,76,157,41,72,37
"820630112",144,119,263,89,180,89
"820490209",60,35,95,28,37,25
"820490206",20,10,30,10,13,9
"820630111",317,249,566,164,188,150
"820700608",207,180,387,113,163,102
"820560211",137,100,237,81,185,80
"821199403",6,2,8,5,12,5
"820560302",226,208,434,149,281,147
"820490211",12,14,26,8,14,8
"820847801",12,9,21,11,22,11
"860351512",446,470,916,216,165,150
"860280206",460,434,894,184,370,182
"860351208",618,634,1252,276,279,266
"861470504",256,273,529,126,155,121
"861750307",478,551,1029,227,256,218
"860770603",317,364,681,217,243,200
"860070107",695,703,1398,361,449,346
"860351313",608,674,1282,299,325,296
"860210208",494,611,1105,269,364,261
"860280305",418,431,849,211,250,179
"860351218",420,427,847,181,191,170
"860351307",861,889,1750,425,433,402
"860351312",532,610,1142,293,294,265
"860351302",706,722,1428,339,355,325
"860351303",845,908,1753,442,462,417
"860351403",948,999,1947,441,453,420
"860351517",557,569,1126,255,269,249
"860351604",604,707,1311,401,455,379
"860490309",631,660,1291,271,287,244
"860490512",665,671,1336,287,253,225
"860420205",461,433,894,233,229,189
"860490310",458,461,919,234,268,207
"860490508",574,657,1231,314,369,309
"860490514",828,927,1755,406,416,379
"860490909",300,408,708,279,430,273
"860490913",241,356,597,209,283,202
"860491115",543,628,1171,322,383,313
"860491202",357,409,766,244,290,229
"860491206",467,542,1009,294,330,291
"860491502",487,513,1000,229,233,214
"860491707",710,731,1441,303,303,285
"860491504",445,558,1003,266,297,249
"860491616",542,594,1136,238,261,231
"860491703",473,566,1039,259,259,240
"860491709",760,792,1552,354,361,317
"860491717",581,600,1181,299,373,287
"860491902",787,794,1581,427,468,409
"860491904",632,724,1356,362,506,360
"860560502",533,527,1060,260,348,257
"860630813",558,538,1096,304,347,294
"860770605",357,405,762,215,222,193
"860770502",668,677,1345,327,344,305
"860770504",451,505,956,194,222,194
"860770506",495,478,973,233,282,231
"860910410",717,675,1392,336,351,275
"860980110",673,669,1342,326,391,322
"860980109",969,1037,2006,476,493,459
"861190415",645,565,1210,229,235,218
"861330504",260,200,460,114,137,113
"861400209",577,589,1166,277,333,267
"861470915",365,451,816,199,260,197
"861470706",304,269,573,164,260,163
"861470815",182,240,422,121,197,115
"861470912",486,577,1063,209,266,199
"861540107",621,597,1218,352,439,335
"861610410",632,646,1278,320,357,301
"861610107",465,467,932,234,304,225
"861610409",638,601,1239,303,334,293
"861190201",271,228,499,108,70,53
"860560203",407,374,781,179,136,133
"860630201",257,248,505,123,115,95
"861890202",363,320,683,161,181,157
"860070102",174,155,329,85,104,84
"860350601",598,637,1235,304,336,294
"860350705",173,142,315,72,82,71
"860210103",301,289,590,147,189,145
"860630301",185,169,354,103,124,100
"860700401",1589,1326,2915,656,658,585
"860910106",412,347,759,192,119,64
"861190502",1000,819,1819,380,189,156
"861260201",381,332,713,183,192,165
"861470702",143,158,301,78,99,76
"861470705",198,184,382,111,136,110
"861540203",288,257,545,150,159,108
"861750301",461,447,908,190,180,141
"861680204",295,273,568,133,141,130
"861890201",554,499,1053,258,289,249
"860491005",512,602,1114,286,297,270
"860491908",648,727,1375,379,435,375
"860350802",134,135,269,73,102,71
"860490521",331,383,714,187,222,186
"860140202",427,284,711,161,105,87
"860140302",21,10,31,10,10,10
"860140101",628,603,1231,252,267,242
"860140701",4,2,6,3,4,2
"860210205",218,170,388,77,88,76
"860280503",258,230,488,100,86,76
"860351103",146,120,266,59,67,57
"860350902",237,215,452,91,93,91
"860490103",151,139,290,66,71,64
"860490302",22,27,49,12,13,9
"860490601",221,168,389,95,110,94
"860630502",91,61,152,34,37,34
"860560401",151,126,277,65,68,63
"860560201",121,95,216,53,52,52
"860700501",326,304,630,128,138,125
"860770404",108,74,182,46,52,37
"860840404",45,41,86,23,38,23
"861610408",126,119,245,48,27,20
"860840304",196,183,379,82,90,81
"860490402",324,247,571,135,146,135
"860980701",71,77,148,33,33,33
"861050301",644,699,1343,335,211,161
"861190302",165,123,288,75,85,66
"861260102",10,9,19,7,13,7
"861260304",50,42,92,32,45,32
"861260306",61,38,99,30,33,30
"861260401",158,123,281,87,105,86
"861330402",106,82,188,44,61,43
"861330406",366,263,629,157,171,108
"860700103",378,312,690,160,176,153
"861400104",138,148,286,69,68,60
"861470101",266,232,498,143,152,140
"861400301",300,258,558,148,128,118
"861470501",414,357,771,184,219,183
"861330101",126,86,212,68,82,68
"861610303",95,74,169,45,55,45
"861610404",422,396,818,204,231,202
"861680102",291,228,519,109,118,107
"861680203",294,312,606,142,141,126
"861750302",122,101,223,54,71,54
"861820203",196,159,355,76,88,74
"861890101",677,608,1285,309,319,285
"861890102",304,258,562,117,104,83
"860491403",566,649,1215,336,391,321
"860351314",620,631,1251,305,330,296
"860630611",484,510,994,270,313,262
"860491408",359,445,804,194,204,186
"860980502",474,446,920,202,128,117
"861190403",101,72,173,43,44,32
"860491215",478,519,997,258,282,240
"860491711",580,662,1242,304,328,287
"860350808",492,481,973,269,291,260
"860351502",460,599,1059,285,315,265
"860351505",496,552,1048,257,286,249
"860351507",468,581,1049,287,314,272
"860070206",514,516,1030,307,353,302
"860490819",444,476,920,233,264,227
"860491515",474,444,918,208,230,202
"861470403",420,418,838,177,156,116
"860980108",791,893,1684,373,436,365
"861050210",660,825,1485,347,398,334
"861610109",622,670,1292,334,454,324
"861610411",429,431,860,201,219,196
"861750204",568,624,1192,266,285,254
"861890303",552,539,1091,266,282,237
"860490511",540,575,1115,230,238,212
"860770601",383,407,790,177,225,171
"860210207",507,521,1028,249,335,242
"860140504",568,551,1119,249,300,244
"860140706",782,793,1575,350,363,308
"860280409",739,736,1475,378,446,368
"860351111",170,178,348,96,510,95
"860351514",624,664,1288,284,316,278
"860351515",591,596,1187,320,357,314
"860420206",819,801,1620,439,395,344
"860420208",580,608,1188,342,381,319
"860490305",658,725,1383,348,352,303
"860490313",251,260,511,148,358,122
"860490504",630,691,1321,315,343,296
"860490506",723,696,1419,316,397,298
"860490510",282,277,559,117,118,111
"860490519",630,689,1319,372,440,363
"860490922",195,267,462,169,236,152
"860491015",392,481,873,268,303,247
"860490911",157,245,402,141,202,137
"860490918",474,539,1013,302,362,291
"860491020",546,610,1156,276,268,252
"860491503",542,652,1194,349,364,323
"860491708",497,495,992,228,247,212
"860491802",751,812,1563,369,399,360
"860491803",690,683,1373,295,336,289
"860491815",631,697,1328,301,325,294
"860630106",395,392,787,202,309,200
"860630802",406,429,835,253,296,246
"860630810",434,536,970,313,363,303
"860630815",647,636,1283,331,372,317
"860770611",474,516,990,233,265,228
"861050211",565,617,1182,265,333,261
"861050205",514,577,1091,296,347,283
"861190103",765,729,1494,340,383,335
"861190413",1111,1143,2254,496,557,487
"861330410",962,985,1947,513,697,504
"861400205",285,323,608,200,229,196
"861470104",360,329,689,159,168,141
"861470803",542,587,1129,297,338,272
"861470909",410,445,855,236,233,192
"861470910",251,275,526,155,171,135
"861540106",501,551,1052,297,318,280
"861610204",504,456,960,218,235,209
"861610413",387,400,787,188,218,185
"860560305",189,136,325,72,104,71
"860070203",80,64,144,45,65,44
"860560501",1253,789,2042,406,424,333
"861190102",1134,1058,2192,459,436,380
"861330103",288,255,543,163,151,86
"861330203",503,436,939,248,353,246
"860770609",393,429,822,214,235,208
"860351612",901,984,1885,435,459,397
"860351607",565,629,1194,335,367,326
"861610312",420,500,920,264,307,255
"860490513",596,594,1190,249,229,213
"860490522",680,741,1421,322,309,285
"860490811",311,359,670,189,221,186
"860350805",760,800,1560,389,433,374
"860491218",418,476,894,220,233,202
"860070104",291,219,510,107,113,106
"860070205",14,9,23,7,18,7
"860070302",42,20,62,23,27,23
"860070304",63,41,104,36,35,34
"860140602",150,149,299,59,54,47
"860280101",230,261,491,95,98,94
"860351202",341,361,702,167,192,165
"860560403",152,124,276,84,98,83
"860350901",385,342,727,154,164,151
"860560205",258,229,487,113,112,111
"860630202",150,112,262,62,61,50
"860630402",88,57,145,43,65,40
"860700102",329,287,616,137,110,89
"860770303",129,100,229,59,78,59
"860700602",197,163,360,86,102,85
"860910408",95,86,181,46,37,34
"860910301",127,108,235,43,31,30
"860910405",352,320,672,202,131,94
"860980105",85,63,148,33,39,32
"860980204",90,79,169,40,50,40
"861050202",104,103,207,44,52,41
"860491301",397,557,954,288,384,274
"861120104",76,61,137,36,43,36
"861120105",82,72,154,47,54,47
"861120202",43,42,85,25,33,25
"861120301",NA,NA,NA,NA,NA,NA
"860140902",156,148,304,89,54,43
"860491310",454,509,963,288,310,268
"860560206",135,114,249,60,65,60
"861260303",145,140,285,93,112,76
"861260403",265,225,490,126,159,126
"861330102",207,157,364,93,95,82
"861400105",259,202,461,144,174,128
"861330501",28,23,51,16,18,14
"861400102",92,96,188,47,57,47
"861470601",325,314,639,148,200,146
"860980106",60,56,116,30,40,30
"861540201",66,44,110,29,41,27
"861540204",23,17,40,10,12,10
"861610306",350,335,685,152,85,54
"860350702",315,270,585,121,132,118
"860491312",268,342,610,212,289,194
"861610103",363,287,650,144,124,83
"861610401",164,130,294,73,63,57
"861680104",174,149,323,87,98,86
"861680201",397,348,745,165,198,159
"861750305",316,319,635,161,190,160
"861890302",600,596,1196,278,281,251
"860491401",300,329,629,187,213,178
"860630602",521,584,1105,288,328,280
"860351211",494,564,1058,274,295,266
"860630608",389,396,785,237,256,229
"860351404",661,667,1328,312,321,302
"860630610",471,492,963,306,369,293
"860491217",556,620,1176,265,264,243
"860491308",685,431,1116,227,239,222
"860491407",442,492,934,212,203,174
"860770512",417,459,876,218,234,212
"860491511",494,519,1013,246,267,241
"860491912",587,623,1210,327,370,322
"860350806",467,497,964,272,295,259
"860351504",724,761,1485,389,419,370
"860351108",830,941,1771,476,517,467
"860491012",429,484,913,304,377,280
"860560404",386,351,737,160,178,144
"861050209",665,732,1397,339,370,314
"861680105",256,283,539,149,191,144
"860351509",379,460,839,262,292,250
"860210206",300,265,565,155,232,154
"860140503",462,499,961,246,314,239
"860140705",672,673,1345,308,344,298
"860280207",593,629,1222,304,399,238
"860280504",698,714,1412,340,461,338
"860351220",485,590,1075,277,307,274
"860490308",586,532,1118,252,304,242
"860351603",465,517,982,291,313,274
"860351605",420,490,910,265,275,248
"860351609",713,760,1473,422,414,360
"860490303",726,770,1496,397,403,350
"860490306",726,764,1490,352,338,279
"860490312",418,445,863,209,463,175
"860490505",404,393,797,195,245,192
"860491002",575,505,1080,256,257,234
"860490517",402,469,871,223,257,201
"860490518",539,615,1154,310,393,306
"860490802",476,497,973,235,247,229
"860490807",304,372,676,197,226,191
"860490903",354,396,750,233,272,223
"860491011",292,342,634,218,245,184
"860491016",434,517,951,291,304,255
"860491106",722,782,1504,354,377,333
"860491205",390,412,802,212,237,204
"860491210",656,684,1340,319,330,311
"860491211",332,346,678,179,181,171
"860491411",441,489,930,257,266,235
"860491514",791,865,1656,390,417,376
"860491601",776,794,1570,369,366,346
"860491606",524,540,1064,269,288,261
"860491610",672,774,1446,308,322,294
"860491715",591,690,1281,313,313,283
"860491812",179,183,362,83,243,83
"860491814",419,433,852,214,250,206
"860491916",602,624,1226,307,518,287
"860560309",524,533,1057,230,290,227
"860630403",354,337,691,162,189,145
"860630809",203,239,442,157,185,151
"860700603",868,828,1696,406,413,343
"860840408",419,432,851,223,271,218
"860910109",654,721,1375,351,370,260
"860980205",564,608,1172,252,289,234
"861190104",1012,1024,2036,450,496,426
"861260313",547,590,1137,284,308,265
"861470806",480,588,1068,267,302,246
"861400208",352,397,749,206,252,201
"861470917",359,393,752,212,272,197
"861470808",595,627,1222,338,369,311
"861470809",524,528,1052,253,273,219
"861470814",544,585,1129,311,339,299
"861470906",317,374,691,190,256,174
"861470911",108,140,248,82,248,78
"861470913",354,375,729,172,187,162
"860910401",83,82,165,40,50,21
"860560402",284,184,468,121,132,112
"860910406",733,735,1468,400,279,176
"860140702",699,575,1274,290,279,259
"860070303",39,31,70,33,38,27
"860351203",476,484,960,204,176,142
"860490501",1490,1559,3049,661,792,642
"860700403",438,396,834,191,204,181
"860980401",532,452,984,221,256,219
"861190301",330,267,597,141,112,99
"861400103",426,410,836,194,249,193
"861470401",1409,1283,2692,567,324,259
"861610314",432,473,905,229,272,224
"861610313",311,362,673,193,235,185
"860491214",379,453,832,241,254,218
"860350803",517,461,978,215,189,168
"860490813",465,517,982,270,252,222
"860070301",18,8,26,8,16,8
"860140103",285,207,492,104,78,78
"860280405",283,245,528,116,87,80
"860350602",376,463,839,198,226,185
"860280202",78,76,154,34,40,32
"860280203",280,222,502,104,124,101
"860280401",237,203,440,97,74,48
"860350303",108,88,196,49,55,48
"860351102",447,398,845,198,199,188
"860420203",31,34,65,15,43,15
"860490602",127,114,241,64,67,63
"860560103",549,525,1074,235,168,156
"860630104",233,172,405,104,114,99
"860630203",187,134,321,76,64,49
"860630204",61,54,115,27,31,27
"860630702",0,0,0,0,1,0
"860770402",382,280,662,150,166,149
"860700601",197,169,366,89,104,88
"860840302",119,116,235,50,63,49
"860910101",288,237,525,131,141,117
"860910202",40,23,63,20,16,14
"860980402",343,290,633,144,173,144
"860980702",35,33,68,18,21,18
"861050303",232,190,422,94,84,71
"860491307",451,502,953,253,256,226
"861120102",158,136,294,69,86,67
"861190304",75,80,155,36,32,32
"861260402",157,142,299,82,95,80
"861330502",44,23,67,23,28,16
"861330503",77,70,147,41,29,21
"861330603",155,142,297,73,87,73
"860840303",210,198,408,87,96,86
"861540302",99,94,193,54,74,54
"860210304",75,76,151,43,58,43
"860491811",440,473,913,212,267,207
"860491313",173,228,401,135,174,131
"861610104",286,239,525,119,133,116
"861610106",484,440,924,222,230,195
"861610201",175,129,304,87,112,45
"861610304",197,169,366,82,76,51
"861610406",242,235,477,127,146,121
"861680101",232,199,431,112,150,110
"861680103",324,302,626,152,193,146
"861750103",257,228,485,120,128,118
"861680302",430,384,814,180,193,180
"861750203",286,290,576,126,136,126
"860351005",266,241,507,119,127,111
"860351210",399,471,870,279,327,278
"860770509",342,368,710,187,233,182
"861610310",465,468,933,243,248,209
"860491006",876,951,1827,389,395,369
"860491007",797,814,1611,340,350,322
"860980112",436,454,890,188,224,184
"861610317",430,436,866,222,265,211
"860491614",468,483,951,227,251,224
"860491909",482,580,1062,292,499,286
"860491914",585,625,1210,335,451,328
"860491915",350,380,730,196,377,194
"860350809",568,605,1173,297,328,283
"860351410",417,522,939,259,306,257
"860770405",511,549,1060,224,233,205
"860351513",719,666,1385,300,312,285
"860351508",195,258,453,160,230,160
"860630601",399,406,805,192,227,190
"860070106",679,660,1339,371,503,360
"860351216",376,434,810,216,246,215
"860351217",481,495,976,259,282,254
"860351219",997,1019,2016,473,513,442
"860420209",694,662,1356,346,352,303
"860490503",599,611,1210,281,309,264
"860490515",498,571,1069,303,330,300
"860490523",199,180,379,120,253,120
"860490804",394,483,877,181,185,160
"860490905",368,428,796,227,296,222
"860490906",276,338,614,236,315,223
"860490916",343,422,765,240,284,227
"860490917",446,508,954,265,305,244
"860491008",683,662,1345,283,319,265
"860491009",412,495,907,291,348,286
"860491018",676,682,1358,312,310,292
"860491019",721,774,1495,314,313,286
"860491108",480,528,1008,317,328,240
"860491112",638,745,1383,377,480,362
"860491203",452,499,951,262,270,255
"860491207",396,433,829,232,264,229
"860491608",402,515,917,280,294,255
"860491716",566,618,1184,274,331,272
"860491801",635,632,1267,293,253,244
"860491805",670,704,1374,348,356,307
"860491816",536,611,1147,298,301,266
"860560306",847,902,1749,393,495,390
"860560307",766,757,1523,365,449,341
"860560503",551,492,1043,255,328,251
"860630205",587,610,1197,295,366,293
"860630615",323,336,659,225,281,219
"860630803",220,251,471,175,220,169
"860630805",327,374,701,207,227,200
"860630808",423,402,825,216,255,208
"860840407",435,486,921,254,321,249
"861050206",542,617,1159,283,328,278
"861190405",318,314,632,130,150,121
"861260307",570,585,1155,307,353,293
"861330407",342,338,680,195,254,190
"861400206",615,725,1340,339,385,329
"861400207",401,447,848,234,313,231
"861470807",685,749,1434,360,375,321
"861470801",643,699,1342,343,365,319
"861470802",596,615,1211,313,350,296
"861470901",456,432,888,230,293,226
"861680207",568,566,1134,305,399,294
"861400202",146,116,262,78,82,47
"861470103",728,667,1395,365,353,275
"860140901",398,361,759,168,117,91
"860420301",191,190,381,114,146,114
"860351204",329,337,666,137,146,126
"860490502",1192,1163,2355,537,640,518
"860700201",635,593,1228,269,316,269
"861470502",595,575,1170,281,326,252
"861890301",364,313,677,164,121,108
"860351114",586,616,1202,324,352,300
"861470903",455,486,941,237,289,226
"860350804",517,582,1099,296,322,285
"861610102",515,441,956,230,130,109
"860490301",30,24,54,11,12,11
"861610307",107,81,188,42,44,39
"860351613",559,560,1119,280,314,267
"860490814",398,449,847,206,201,184
"860490816",478,458,936,213,211,201
"860140201",129,118,247,63,48,48
"860280502",315,299,614,136,125,100
"860140903",149,115,264,64,34,33
"860210101",59,69,128,31,30,30
"860140601",50,44,94,22,22,22
"860210104",216,252,468,126,147,125
"860210301",111,117,228,52,64,52
"860210306",58,45,103,26,33,26
"860280103",132,127,259,70,23,20
"860280303",191,145,336,88,83,52
"860280404",268,256,524,126,125,97
"860350402",304,272,576,128,135,128
"860351104",178,167,345,70,75,67
"860351105",96,89,185,39,52,37
"860351201",197,198,395,96,117,94
"860420102",31,14,45,16,24,15
"860490101",413,365,778,198,206,197
"860490404",81,72,153,36,41,35
"860630401",58,56,114,29,34,29
"860840305",158,160,318,89,106,86
"860840402",35,24,59,22,30,22
"860840403",68,26,94,27,42,26
"860910204",12,13,25,7,11,7
"860980301",143,127,270,67,71,60
"860491305",429,552,981,318,355,300
"861190202",90,24,114,33,37,23
"861260202",65,67,132,39,53,36
"861260203",255,205,460,121,148,120
"861260301",405,371,776,209,254,208
"861260305",132,88,220,58,77,58
"861260404",48,35,83,29,35,29
"861330201",301,282,583,150,123,107
"861400302",157,122,279,71,72,70
"861470301",1985,1948,3933,851,530,239
"861470302",322,301,623,164,240,164
"861540104",100,74,174,45,52,45
"861820204",76,66,142,41,63,41
"860560102",801,729,1530,403,226,200
"861610402",212,175,387,97,85,69
"861750303",384,376,760,166,160,147
"861750202",163,153,316,73,82,72
"861820101",33,18,51,14,15,14
"861820201",139,113,252,57,75,56
"860491314",236,315,551,186,207,170
"860630603",280,291,571,155,343,154
"860630604",416,419,835,203,231,200
"860351209",427,491,918,278,325,276
"860630606",484,511,995,231,262,224
"860980602",141,117,258,53,52,52
"860491907",486,530,1016,300,636,298
"860351506",778,854,1632,370,367,337
"860491219",357,502,859,227,244,214
"860491309",522,664,1186,383,441,350
"860491508",909,932,1841,457,493,434
"860491612",465,560,1025,295,316,273
"860491613",584,694,1278,336,347,314
"860491910",105,122,227,75,379,75
"860350810",932,1041,1973,453,549,445
"860351411",316,414,730,242,293,237
"860351511",830,831,1661,350,355,328
"860210209",562,594,1156,256,359,256
"860351109",927,1022,1949,484,536,475
"860630804",310,375,685,225,266,208
"860491303",328,402,730,248,308,241
"860350203",390,346,736,152,155,137
"860351106",287,347,634,176,518,173
"860351206",442,475,917,232,277,226
"860351301",704,804,1508,377,414,367
"860351304",379,450,829,225,236,214
"860351306",424,461,885,239,252,225
"860351310",589,635,1224,258,168,149
"860490307",619,660,1279,296,319,256
"860351317",439,488,927,240,274,232
"860351606",365,368,733,191,198,179
"860490304",478,531,1009,283,280,240
"860490507",572,560,1132,227,292,224
"860490806",201,281,482,151,223,149
"860490904",430,527,957,272,299,252
"860490915",362,450,812,262,329,255
"860491010",285,339,624,214,236,195
"860491105",472,492,964,241,248,231
"860491113",761,792,1553,372,402,349
"860491208",562,629,1191,303,309,278
"860491209",411,460,871,232,257,221
"860491213",452,550,1002,258,271,253
"860491413",415,491,906,266,301,245
"860491415",592,653,1245,293,297,263
"860491505",358,403,761,199,225,195
"860491607",747,799,1546,328,342,310
"860491705",563,594,1157,279,309,265
"860491808",496,569,1065,277,304,273
"860491817",639,683,1322,289,317,284
"860560311",528,515,1043,254,297,226
"860560312",958,1036,1994,491,645,486
"860560505",565,552,1117,282,367,279
"860630613",516,471,987,252,267,239
"860630614",430,476,906,279,309,264
"860770604",326,340,666,214,288,209
"860770205",680,718,1398,374,453,366
"860770207",428,474,902,227,269,223
"860770507",415,445,860,182,200,181
"860770612",498,516,1014,235,271,231
"860910108",25,29,54,13,19,12
"860980305",880,843,1723,392,442,380
"861190406",984,996,1980,489,374,289
"861190411",585,551,1136,261,164,129
"861260308",614,668,1282,327,365,289
"861260309",830,843,1673,419,358,265
"861470811",509,618,1127,306,355,277
"861470817",322,376,698,168,211,163
"861470914",531,534,1065,228,256,219
"861470918",325,324,649,159,185,154
"861540108",291,317,608,230,249,221
"861610206",533,466,999,222,238,193
"861890103",577,559,1136,257,263,241
"861680206",724,684,1408,376,506,371
"860980503",596,514,1110,278,152,143
"860490202",1106,1060,2166,509,354,308
"860910103",309,318,627,131,46,24
"860140402",165,102,267,57,43,39
"860420202",540,570,1110,257,219,182
"860560303",342,272,614,141,143,120
"860770103",619,594,1213,247,211,166
"860770202",1132,1105,2237,490,477,414
"860910102",79,59,138,42,35,26
"861050201",609,690,1299,324,359,285
"861190401",264,208,472,129,148,127
"861330802",535,461,996,239,295,237
"861470703",379,410,789,232,275,189
"861750101",847,627,1474,323,364,315
"860770610",515,573,1088,246,277,237
"860910411",658,657,1315,315,346,274
"860351101",634,661,1295,328,319,278
"860491004",689,692,1381,280,287,271
"860491003",1227,1172,2399,511,517,468
"861610305",647,620,1267,262,129,99
"860350703",236,224,460,106,109,86
"860070201",18,10,28,9,11,8
"860280104",142,139,281,74,60,41
"860280201",131,107,238,53,63,52
"860280302",338,322,660,144,96,69
"860350101",164,138,302,67,63,59
"860350501",249,296,545,156,169,156
"860420303",55,43,98,28,34,27
"860420103",43,10,53,21,31,19
"860491114",633,689,1322,351,396,337
"860420304",45,16,61,17,22,17
"860490102",360,309,669,165,144,130
"860560302",136,121,257,64,65,63
"860560101",442,363,805,183,189,181
"860560304",228,174,402,117,145,114
"860630102",301,263,564,150,196,148
"860630103",386,353,739,182,166,136
"860630501",163,122,285,70,79,69
"860630703",0,0,0,0,1,0
"860700104",384,346,730,162,185,158
"860770101",762,687,1449,318,308,278
"860840101",99,54,153,26,37,26
"860840102",257,226,483,128,165,124
"860910201",116,105,221,64,64,29
"860910302",55,39,94,27,27,27
"860980107",21,14,35,11,13,11
"860980703",16,14,30,8,8,8
"861050203",778,821,1599,389,413,370
"861120103",74,70,144,44,50,44
"860140102",166,150,316,74,44,44
"860210302",91,81,172,55,67,55
"860280102",190,207,397,108,122,105
"861120302",109,82,191,42,42,42
"860491311",371,469,840,274,369,274
"861400203",135,111,246,67,59,43
"861330301",334,222,556,154,184,153
"861330602",133,100,233,56,66,56
"861470602",265,245,510,127,113,86
"861470603",302,302,604,134,102,79
"861540303",135,116,251,63,83,63
"860351107",1199,1145,2344,518,585,509
"861540301",53,40,93,26,31,26
"861610301",868,824,1692,371,286,261
"861610407",130,135,265,54,52,44
"861680303",161,134,295,65,68,64
"861680301",516,473,989,224,252,223
"861820103",212,183,395,85,86,83
"860491405",451,516,967,275,293,253
"860630605",567,614,1181,335,368,329
"860630609",451,487,938,280,319,277
"860630612",448,494,942,264,277,246
"860491409",294,322,616,168,181,156
"860980501",139,130,269,63,28,26
"860491507",514,525,1039,231,263,223
"860491512",684,671,1355,304,306,268
"860491710",729,737,1466,327,332,294
"860491905",583,700,1283,366,500,361
"860491906",716,780,1496,415,463,398
"860350807",917,1002,1919,454,517,426
"860351412",534,588,1122,322,350,299
"860351414",946,945,1891,420,412,373
"860140603",283,276,559,129,176,127
"860630814",369,376,745,197,232,181
"861330505",641,662,1303,318,415,291
"861470805",321,377,698,203,259,187
"861610412",646,653,1299,308,335,299
"860070105",327,373,700,196,258,195
"860140704",858,839,1697,372,394,345
"860280304",514,531,1045,261,301,235
"860280407",466,459,925,245,255,191
"860351110",1,0,1,1,526,1
"860351315",793,795,1588,337,368,318
"860351316",833,769,1602,349,344,308
"860351318",635,660,1295,296,284,263
"860351319",748,808,1556,386,426,382
"860351402",646,667,1313,284,264,238
"860351601",272,316,588,189,214,183
"860351608",448,491,939,259,275,245
"860420305",240,247,487,135,157,127
"860490311",548,606,1154,300,339,276
"860490314",692,744,1436,402,463,345
"860490815",506,537,1043,238,249,226
"860490516",722,802,1524,374,394,364
"860490520",532,532,1064,273,394,267
"860490803",315,360,675,182,171,160
"860490901",605,609,1214,285,295,271
"860490919",356,429,785,259,275,249
"860491013",246,281,527,176,214,170
"860491111",520,597,1117,337,335,287
"860491412",605,670,1275,339,369,330
"860491605",764,751,1515,343,374,327
"860491702",422,446,868,213,242,209
"860491804",729,724,1453,342,384,336
"860630303",516,526,1042,273,365,269
"860630811",467,539,1006,285,326,277
"860630806",437,454,891,261,290,250
"860770606",307,377,684,175,191,163
"860770501",534,515,1049,218,214,174
"860910409",60,77,137,32,41,32
"860980111",630,649,1279,267,364,262
"861050208",538,625,1163,294,338,288
"861050207",670,682,1352,342,400,341
"861190408",782,910,1692,398,463,373
"861190409",729,747,1476,406,422,364
"861190414",686,692,1378,379,432,373
"861330408",391,387,778,215,272,178
"861470810",398,405,803,191,248,190
"861470905",544,545,1089,259,301,248
"861470916",504,481,985,234,254,214
"861610108",551,554,1105,277,365,261
"861610205",393,388,781,163,184,160
"861610319",448,456,904,235,246,221
"861680205",432,397,829,195,272,191
"860980201",291,294,585,126,140,126
"860070103",284,231,515,146,188,128
"860140502",609,531,1140,306,333,274
"860350102",165,152,317,78,88,75
"860350201",118,108,226,53,49,45
"860350701",204,212,416,99,111,95
"860490201",751,636,1387,346,300,259
"860560104",726,673,1399,402,303,206
"860560202",378,309,687,147,191,120
"860770301",522,441,963,238,249,217
"860700503",546,456,1002,236,182,146
"860770403",370,269,639,152,67,54
"860700505",296,267,563,141,112,90
"860910407",382,381,763,184,148,96
"860840401",134,101,235,56,52,42
"860910403",284,284,568,146,132,96
"861190101",1015,863,1878,395,422,390
"861330403",676,621,1297,348,301,174
"861750201",181,194,375,81,69,59
"860490817",729,792,1521,389,477,363
"861330205",684,679,1363,355,417,326
"861610112",638,650,1288,284,321,276
"860491911",561,601,1162,303,342,299
"860350704",639,650,1289,297,339,294
"860140801",153,129,282,65,69,65
"860350301",88,77,165,40,48,40
"860140203",111,91,202,43,44,43
"860140401",55,20,75,20,23,20
"860210105",57,69,126,37,49,37
"860210203",71,89,160,38,55,38
"860210204",460,454,914,185,224,183
"860210303",38,25,63,18,26,18
"860210305",21,17,38,10,10,10
"860420201",22,19,41,11,12,11
"860351001",923,838,1761,401,458,394
"860490401",181,126,307,83,87,66
"860560301",110,92,202,70,26,26
"860630701",0,0,0,0,1,0
"860700504",115,67,182,39,48,39
"860770401",132,93,225,42,41,41
"860770203",510,442,952,211,145,106
"860770204",225,202,427,102,90,79
"860840103",59,37,96,26,32,26
"860840301",456,466,922,200,172,141
"860910203",199,201,400,77,23,12
"860980403",354,227,581,165,171,155
"861050102",162,120,282,58,65,57
"860491302",309,403,712,213,329,208
"860280205",165,154,319,82,97,73
"861260101",65,63,128,46,55,46
"861330404",687,697,1384,319,379,313
"861330601",120,147,267,76,95,75
"861400201",210,208,418,113,134,90
"860910107",222,188,410,109,68,38
"861400101",187,190,377,109,108,89
"861400303",307,260,567,143,139,126
"861470202",889,867,1756,383,336,278
"861540101",60,34,94,31,46,30
"861540105",70,51,121,31,45,31
"861050101",1231,1148,2379,521,569,494
"861190203",146,106,252,80,31,17
"861680304",289,256,545,119,137,119
"861750102",129,118,247,63,72,62
"861820202",62,69,131,8,15,8
"860491404",441,496,937,248,260,222
"860630607",398,434,832,209,227,206
"860351213",636,679,1315,315,318,260
"860351214",779,820,1599,382,397,380
"860351215",571,592,1163,273,323,269
"860351611",545,560,1105,265,277,250
"860980601",47,41,88,28,30,28
"860980202",28,6,34,12,16,12
"861610315",577,573,1150,242,260,228
"860491713",623,705,1328,294,296,281
"860491809",620,638,1258,334,381,332
"860351407",525,564,1089,232,205,190
"860351415",557,591,1148,265,254,220
"860351510",702,736,1438,364,393,329
"860491014",245,327,572,204,259,200
"860351112",542,628,1170,320,360,316
"860070108",529,529,1058,281,396,280
"860351113",736,813,1549,401,423,349
"860140703",737,753,1490,335,367,315
"860491102",576,617,1193,291,351,283
"860351221",52,57,109,36,95,35
"860351309",503,536,1039,257,262,248
"860351311",481,581,1062,282,312,281
"860351401",1084,1083,2167,494,510,465
"860351516",696,653,1349,331,394,326
"860490509",814,861,1675,349,380,337
"861330409",393,455,848,208,231,175
"860490809",386,480,866,256,259,229
"860491001",704,735,1439,386,371,343
"860490920",144,203,347,145,224,136
"860490908",199,259,458,205,308,197
"860491101",737,754,1491,366,367,326
"860491107",478,445,923,245,274,227
"860491109",645,678,1323,363,432,329
"860491212",328,372,700,177,201,175
"860491410",446,557,1003,281,345,273
"860491602",739,809,1548,363,383,349
"860491609",412,490,902,268,288,265
"860491714",653,662,1315,302,301,283
"860491704",607,626,1233,306,306,282
"860491718",610,667,1277,284,298,260
"860491807",607,592,1199,302,340,290
"860491901",426,465,891,254,418,250
"860560310",431,458,889,213,271,202
"860560313",325,337,662,199,237,196
"860770602",327,372,699,210,237,207
"860630807",481,545,1026,273,300,252
"860630812",383,392,775,178,188,174
"860630801",725,675,1400,337,350,322
"860770206",533,536,1069,248,271,244
"860770503",428,427,855,193,221,181
"860840406",329,340,669,198,287,192
"861050212",614,621,1235,282,346,278
"861190410",791,843,1634,413,297,243
"861260311",455,537,992,304,355,279
"861260312",566,653,1219,327,408,322
"861470902",744,773,1517,359,391,333
"861470813",473,476,949,229,275,223
"861470908",254,269,523,154,240,153
"861470919",448,479,927,202,223,195
"861610110",688,783,1471,345,389,323
"861610111",598,598,1196,283,323,269
"861610318",581,674,1255,323,331,290
"861750306",322,359,681,176,211,171
"861820205",560,560,1120,263,336,258
"860350502",249,205,454,123,151,123
"861470201",413,387,800,194,160,122
"860700402",668,576,1244,291,324,286
"860280204",111,112,223,60,66,57
"860280403",440,426,866,190,195,158
"860630105",80,69,149,40,47,31
"860700202",1006,960,1966,447,484,432
"861540102",133,119,252,76,92,76
"861750304",481,449,930,235,221,169
"861190412",796,804,1600,360,394,338
"861470904",432,437,869,209,260,204
"860491220",416,460,876,216,225,205
"860350801",202,149,351,95,109,86
"861610309",590,594,1184,255,285,250
"860140802",100,65,165,43,43,42
"860070202",65,38,103,28,33,27
"860210102",136,127,263,58,65,57
"860210202",848,788,1636,311,306,273
"860210201",810,831,1641,377,421,373
"860350302",35,25,60,23,25,23
"860350401",298,273,571,144,144,142
"860420101",180,103,283,83,100,78
"860420302",30,15,45,14,21,14
"860420204",16,9,25,11,12,11
"860490403",94,91,185,40,50,33
"860630101",22,26,48,12,14,12
"860630302",75,68,143,40,61,40
"860700302",320,286,606,152,161,150
"860770102",523,444,967,206,210,202
"860770201",313,203,516,115,123,112
"860840201",280,196,476,120,108,89
"860910105",769,780,1549,345,124,87
"860910404",333,296,629,180,140,75
"860980101",140,161,301,71,90,71
"860980104",74,54,128,34,38,34
"860980302",102,66,168,44,35,27
"861610308",923,950,1873,469,513,450
"860491306",396,528,924,313,348,284
"861120101",82,79,161,36,30,27
"861190501",710,667,1377,316,194,178
"861260302",172,159,331,89,133,86
"861330202",156,130,286,68,80,66
"861330701",483,464,947,231,281,227
"861330204",346,331,677,192,231,191
"861330302",181,185,366,85,103,84
"861330702",264,258,522,139,187,139
"861540103",33,25,58,14,20,14
"861610101",375,342,717,154,171,153
"861190503",310,261,571,159,160,159
"861470503",277,248,525,120,128,119
"861610105",723,649,1372,314,378,306
"861610403",260,236,496,119,143,119
"861610405",214,213,427,120,138,118
"861820301",178,123,301,73,90,72
"861890203",20,9,29,9,11,9
"860351002",483,420,903,194,207,193
"860491406",484,586,1070,281,288,249
"860770607",354,365,719,162,194,152
"860980603",36,36,72,15,14,14
"860491216",524,592,1116,286,285,266
"860491402",461,526,987,285,275,236
"861610316",717,743,1460,329,317,273
"860491513",312,330,642,186,211,183
"860491810",581,626,1207,294,335,288
"860491913",289,357,646,186,419,185
"860560315",571,604,1175,272,364,269
"860351406",525,556,1081,273,280,259
"860351503",468,501,969,250,241,223
"860490805",283,355,638,203,260,197
"860490818",413,492,905,205,221,196
"860491201",388,566,954,220,275,215
"860491603",600,645,1245,297,310,275
"860700203",394,422,816,194,240,193
"861120203",245,265,510,164,220,160
"860350707",531,534,1065,255,272,248
"860280410",540,510,1050,249,247,215
"860280408",814,862,1676,419,522,392
"860351205",831,809,1640,416,436,379
"860351207",916,939,1855,424,437,401
"860351305",303,333,636,184,213,180
"860351308",959,1020,1979,453,441,419
"860351602",290,365,655,232,273,227
"860351610",646,789,1435,400,422,351
"860420207",756,735,1491,391,439,372
"860490801",621,637,1258,321,312,278
"860490808",261,314,575,183,197,160
"860490902",399,469,868,218,236,199
"860490921",254,350,604,189,236,184
"860490907",203,277,480,172,182,153
"860490910",132,201,333,117,192,113
"860490912",192,262,454,165,218,162
"860490914",263,336,599,210,294,203
"860491017",845,885,1730,385,367,352
"860491103",696,783,1479,367,385,327
"860491104",415,455,870,218,250,208
"860491110",407,501,908,271,276,246
"860491204",446,468,914,256,322,248
"860491706",600,654,1254,282,272,246
"860560314",449,458,907,217,268,214
"860491414",411,453,864,198,209,186
"860491501",538,573,1111,287,315,277
"860491506",728,778,1506,348,376,316
"860491604",620,702,1322,349,394,339
"860491615",710,741,1451,330,348,325
"860491701",372,358,730,177,173,155
"860491813",386,426,812,233,252,228
"860491903",787,824,1611,433,486,430
"860560308",647,654,1301,305,400,295
"860560504",579,576,1155,267,342,247
"860770510",288,359,647,173,213,168
"860770511",379,386,765,205,243,200
"860770505",733,792,1525,317,431,293
"860770508",546,630,1176,323,376,301
"860840409",341,350,691,203,269,199
"861190407",593,618,1211,296,441,282
"861260310",835,920,1755,494,598,482
"861400210",408,440,848,241,291,239
"861470804",313,336,649,194,230,176
"861470812",479,536,1015,260,284,243
"861470816",344,397,741,206,258,171
"861470907",165,179,344,64,105,64
"861610203",714,698,1412,304,209,174
"861820206",733,731,1464,343,441,339
"860560204",218,166,384,97,93,90
"860770302",424,406,830,205,244,201
"860840405",168,128,296,89,101,69
"861190303",247,208,455,115,113,89
"861190404",778,684,1462,329,267,214
"861330303",304,262,566,138,185,137
"861470102",605,536,1141,307,292,203
"861470402",271,239,510,123,398,119
"861470701",91,78,169,42,62,42
"861470704",450,414,864,237,279,212
"861610202",58,46,104,42,45,41
"860351004",408,380,788,189,166,151
"861610311",365,398,763,206,250,197
"860490810",429,545,974,322,355,316
"860490812",653,802,1455,405,489,377
"860770608",749,784,1533,351,409,345
"860070101",73,84,157,38,38,38
"860140301",131,81,212,59,71,58
"860280501",348,321,669,146,84,64
"860350202",79,71,150,28,28,28
"860280301",428,397,825,181,95,85
"860280402",157,119,276,58,54,29
"860280406",584,541,1125,244,129,126
"860350503",151,144,295,67,84,67
"860700101",361,252,613,118,137,116
"860700301",104,57,161,43,44,43
"860700502",335,267,602,139,152,138
"860840202",127,103,230,47,58,47
"860910402",133,93,226,69,80,58
"860980102",34,18,52,17,21,17
"860980103",288,254,542,122,99,93
"860980303",21,10,31,12,16,12
"860980304",38,14,52,19,20,19
"860980203",98,65,163,40,51,40
"861050302",301,339,640,162,175,161
"861120201",128,86,214,73,86,73
"861050204",867,934,1801,407,460,401
"860070204",8,6,14,6,10,6
"861190402",54,39,93,22,26,20
"861260204",203,184,387,91,117,91
"861330401",159,113,272,58,61,57
"861330304",55,43,98,30,45,30
"861330305",83,93,176,46,75,46
"861330405",99,72,171,53,62,46
"861330801",161,140,301,70,35,31
"860910104",224,137,361,84,57,41
"861400204",289,242,531,127,133,125
"861540202",121,85,206,60,72,59
"860140501",87,48,135,39,48,38
"861610302",681,621,1302,307,215,173
"861680202",462,384,846,205,250,202
"861820102",62,61,123,34,35,34
"861820302",141,132,273,63,71,62
"860351003",121,90,211,52,63,52
"860350706",209,221,430,96,108,93
"860491806",393,456,849,238,269,236
"860491509",559,606,1165,307,328,297
"860491304",435,537,972,309,363,287
"860491510",546,567,1113,272,280,249
"860491611",301,391,692,245,313,243
"860560405",773,744,1517,347,416,341
"860491712",941,1024,1965,449,478,415
"860351405",849,839,1688,366,364,347
"860351408",609,632,1241,305,323,291
"860351409",459,570,1029,289,326,275
"860351413",436,464,900,260,269,242
"860351501",364,460,824,258,292,246
"860351416",502,509,1011,237,246,228
"940071312",491,467,958,293,277,246
"940140413",577,528,1105,326,348,308
"940140506",825,369,1194,168,329,154
"940140606",406,418,824,284,329,280
"940140801",169,108,277,68,80,68
"940071007",575,595,1170,337,337,327
"940071011",589,559,1148,326,343,319
"940071101",442,445,887,308,342,294
"940071103",489,461,950,348,380,334
"940071203",298,265,563,197,203,175
"940071401",628,536,1164,311,327,293
"940071412",583,486,1069,358,498,329
"940140409",508,512,1020,319,336,309
"940140407",505,430,935,294,331,275
"940140504",175,165,340,103,162,99
"940140510",347,330,677,240,280,238
"940140605",580,537,1117,373,425,352
"940140610",537,515,1052,349,398,332
"940140808",544,495,1039,368,400,360
"940140706",255,274,529,142,179,132
"940140813",554,520,1074,319,347,319
"940140103",75,30,105,41,122,39
"940070801",34,10,44,14,16,9
"940071402",707,659,1366,376,384,348
"940071008",459,511,970,279,302,270
"940071210",518,445,963,321,350,294
"940071306",191,192,383,106,218,106
"940071410",493,494,987,288,288,273
"940140401",214,215,429,148,160,136
"940140410",356,365,721,228,264,219
"940140707",529,585,1114,319,474,308
"940140609",547,582,1129,333,346,322
"940140711",636,595,1231,370,419,362
"940140812",473,478,951,294,312,287
"940140102",101,63,164,53,81,45
"940070503",526,507,1033,294,510,280
"940140202",19,5,24,5,6,5
"940070601",59,18,77,31,32,29
"940140502",387,396,783,287,356,285
"940140507",224,212,436,182,249,177
"940140703",494,501,995,320,349,290
"940140709",212,242,454,130,132,121
"940140806",579,575,1154,366,413,354
"940071202",408,415,823,274,314,266
"940071206",564,607,1171,342,340,322
"940071211",341,333,674,232,262,226
"940071302",545,505,1050,343,374,335
"940071314",281,296,577,198,230,194
"940071408",533,479,1012,312,341,308
"940140414",627,587,1214,362,376,335
"940140406",396,336,732,222,250,206
"940140511",329,329,658,214,228,206
"940140608",422,472,894,293,285,262
"940140811",455,451,906,309,324,300
"940140713",520,467,987,307,330,293
"940140705",518,504,1022,306,337,304
"940140101",14,9,23,5,5,5
"940070502",262,233,495,150,222,137
"940071104",685,699,1384,453,523,440
"940071311",465,498,963,311,345,307
"940071308",469,404,873,245,347,241
"940071413",404,347,751,258,334,232
"940140503",419,443,862,300,339,292
"940140509",654,606,1260,398,459,383
"940140704",486,461,947,295,297,266
"940140702",438,436,874,272,309,265
"940140809",380,369,749,248,295,245
"940071403",683,652,1335,352,360,330
"940071406",435,382,817,271,287,254
"940071414",505,406,911,285,306,276
"940071416",161,121,282,96,104,95
"940140710",200,207,407,107,114,107
"940071205",651,640,1291,336,342,332
"940071005",560,562,1122,303,306,285
"940071313",567,552,1119,320,337,304
"940071106",466,410,876,303,284,226
"940071111",580,476,1056,313,322,303
"940071113",541,537,1078,358,350,318
"940071201",357,332,689,249,240,196
"940071212",486,459,945,327,366,305
"940071303",558,588,1146,338,364,326
"940071305",566,477,1043,348,369,262
"940071307",584,556,1140,352,405,321
"940071404",546,508,1054,293,317,266
"940140411",446,420,866,255,269,250
"940140505",458,424,882,270,435,256
"940140405",243,199,442,151,167,147
"940140404",151,139,290,102,119,100
"940140602",552,580,1132,371,380,365
"940140607",493,500,993,300,324,287
"940070505",357,315,672,188,382,175
"940140408",232,236,468,136,144,120
"940070201",45,10,55,12,15,12
"940070901",NA,NA,NA,NA,NA,NA
"940070101",168,29,197,8,11,7
"940071001",675,649,1324,407,342,296
"940071112",498,470,968,329,361,320
"940071204",594,558,1152,339,337,300
"940071209",536,495,1031,336,334,284
"940071411",517,446,963,291,274,248
"940071407",521,520,1041,346,387,338
"940140412",437,444,881,274,306,266
"940140402",409,332,741,244,294,240
"940140415",519,499,1018,296,326,284
"940140603",524,463,987,299,314,296
"940140601",330,333,663,210,215,200
"940140708",444,432,876,248,264,237
"940140805",375,407,782,273,339,268
"940071109",397,373,770,280,275,244
"940071002",246,189,435,119,135,110
"940070401",40,18,58,17,17,10
"940070501",55,17,72,8,8,8
"940071006",554,575,1129,336,340,319
"940071102",468,494,962,308,326,295
"940071105",422,455,877,298,327,284
"940071108",282,231,513,170,190,161
"940071208",563,601,1164,307,320,302
"940071213",439,419,858,312,348,298
"940140416",533,604,1137,318,346,308
"940071309",452,447,899,267,353,243
"940071405",584,539,1123,345,345,288
"940140611",589,508,1097,347,381,341
"940140612",601,515,1116,312,320,297
"940140701",395,385,780,172,198,170
"940140712",536,554,1090,343,382,331
"940140803",192,203,395,89,113,87
"940140807",401,429,830,268,348,258
"940071010",509,497,1006,287,321,283
"940140301",1,0,1,1,1,1
"940070701",36,7,43,28,27,27
"940071415",429,385,814,227,219,198
"940071110",364,316,680,231,221,195
"940071107",281,246,527,210,305,208
"940070504",411,338,749,228,273,213
"940071003",643,654,1297,355,328,303
"940071009",484,542,1026,292,309,286
"940071012",498,489,987,279,281,270
"940071013",484,493,977,290,300,273
"940071207",500,551,1051,296,304,286
"940140508",395,359,754,277,316,270
"940071301",499,516,1015,314,314,298
"940071304",534,528,1062,318,337,298
"940071310",326,306,632,195,171,162
"940071409",622,596,1218,338,337,315
"940140403",207,178,385,137,162,134
"940140501",362,352,714,220,248,213
"940140604",564,569,1133,282,311,274
"940140714",734,707,1441,391,424,379
"940140810",676,668,1344,439,500,437
"940140802",264,281,545,212,267,201
"940140804",349,370,719,220,248,216
"940070301",43,29,72,16,20,15
"940140201",0,0,0,0,1,0
"940140302",32,14,46,14,17,13
"940071004",586,628,1214,334,306,285
"900770404",599,576,1175,286,275,231
"900770202",600,582,1182,287,270,243
"900630412",326,331,657,136,146,131
"900070403",255,237,492,126,147,125
"901050504",993,999,1992,457,489,432
"901050702",542,519,1061,252,251,226
"901050701",1085,1123,2208,511,528,462
"900842408",812,864,1676,394,367,349
"900842406",542,623,1165,344,347,309
"900842220",683,692,1375,326,327,308
"900842107",455,618,1073,366,483,333
"900842414",528,551,1079,283,269,224
"900842412",527,561,1088,298,262,246
"901190508",744,771,1515,369,382,343
"901190506",320,343,663,176,206,162
"901190420",541,587,1128,270,282,244
"901190417",476,526,1002,298,322,283
"901190415",258,268,526,135,145,133
"901190318",409,384,793,186,192,176
"901190317",797,812,1609,443,427,378
"901190316",495,504,999,238,214,192
"901190204",612,647,1259,323,349,318
"901190213",442,498,940,241,245,229
"901120216",548,549,1097,257,280,256
"901190212",289,306,595,157,162,139
"901051017",842,906,1748,430,432,394
"901051016",554,569,1123,270,209,191
"901051012",483,490,973,245,216,195
"901051010",697,687,1384,324,352,304
"901051007",546,582,1128,290,255,223
"901050912",642,656,1298,347,335,311
"901050811",634,640,1274,333,357,326
"901050805",803,741,1544,363,328,309
"901050704",679,705,1384,278,264,252
"901050620",655,683,1338,310,287,270
"901050618",484,550,1034,240,220,208
"901050808",936,1001,1937,477,455,431
"901050617",409,456,865,212,190,182
"900980412",269,274,543,151,587,145
"901050714",457,480,937,254,299,252
"900843006",415,449,864,205,221,198
"900842915",679,680,1359,293,258,254
"900842908",981,1015,1996,437,463,421
"900842907",561,571,1132,256,243,238
"900842903",512,571,1083,276,251,229
"900842823",564,591,1155,308,284,258
"900842822",606,688,1294,337,345,308
"900842807",675,654,1329,275,266,238
"900842804",509,483,992,269,299,248
"900842712",463,470,933,216,196,187
"900842403",610,665,1275,385,336,301
"900842303",257,287,544,159,172,142
"900842222",314,330,644,133,122,116
"900842215",940,977,1917,427,363,338
"900842207",1059,1005,2064,481,440,411
"900842201",840,935,1775,402,353,337
"900842116",283,303,586,166,138,118
"900841801",570,692,1262,447,565,420
"900841710",214,257,471,128,121,108
"900841404",626,700,1326,371,388,316
"900840606",484,512,996,257,234,214
"900841306",317,403,720,331,512,315
"900840315",238,300,538,168,191,155
"900840310",621,713,1334,340,283,265
"900840304",682,724,1406,358,310,290
"900840208",698,767,1465,380,377,348
"900840207",347,383,730,183,198,172
"900840203",601,570,1171,275,267,258
"900840202",693,712,1405,304,290,277
"900840126",710,756,1466,376,408,330
"901050816",462,492,954,241,238,213
"901050813",620,663,1283,361,373,336
"900840113",695,767,1462,379,417,376
"900840104",598,693,1291,343,375,336
"900840110",465,533,998,271,290,262
"900840112",610,672,1282,342,349,321
"900840506",641,663,1304,310,310,285
"900701410",553,594,1147,312,326,295
"900770211",483,521,1004,252,284,250
"900700306",383,388,771,201,237,187
"900701415",610,718,1328,357,393,337
"900630508",532,567,1099,271,254,231
"900630507",811,805,1616,381,372,334
"900630504",541,567,1108,288,297,271
"900770213",520,542,1062,270,295,265
"900630219",624,613,1237,283,243,229
"900630111",740,848,1588,404,448,365
"900841221",269,415,684,294,404,286
"900841220",349,419,768,299,462,293
"900560308",520,565,1085,318,325,296
"900141610",386,411,797,202,216,181
"900141607",460,511,971,253,269,246
"900141405",566,601,1167,285,310,274
"900141206",533,588,1121,251,206,186
"900141205",745,710,1455,338,337,310
"900140711",690,656,1346,293,279,267
"900841403",288,315,603,190,184,160
"900841402",404,484,888,267,289,233
"900841007",440,418,858,173,155,154
"900841019",292,295,587,157,169,152
"900840914",357,444,801,263,295,226
"900840910",326,351,677,200,214,177
"900840903",316,419,735,217,244,212
"900840902",438,520,958,290,323,265
"900840802",397,382,779,194,187,172
"900840711",368,441,809,224,218,194
"900140612",724,698,1422,302,285,277
"900140124",555,596,1151,287,296,268
"900140122",933,1011,1944,442,485,418
"900140110",787,796,1583,376,371,327
"900140115",908,898,1806,432,443,409
"900140114",1002,1085,2087,477,447,410
"900070410",711,697,1408,331,317,276
"900141309",479,470,949,249,226,214
"900140128",573,550,1123,262,260,228
"900140119",570,622,1192,262,276,250
"900842012",291,429,720,268,405,265
"900840218",351,417,768,228,267,224
"900420112",383,442,825,217,236,206
"900350213",640,642,1282,359,429,343
"900420114",510,587,1097,302,304,283
"900841208",426,520,946,357,491,323
"900280102",775,801,1576,350,352,321
"900420103",350,358,708,184,179,165
"900210619",371,417,788,208,211,197
"900210606",677,729,1406,335,289,275
"900210507",760,751,1511,349,352,327
"900210506",422,408,830,210,220,198
"900210708",271,329,600,185,220,180
"900210407",617,584,1201,283,297,265
"900141615",728,742,1470,352,315,294
"900842004",155,222,377,136,266,134
"900841806",459,543,1002,357,397,320
"901050506",529,603,1132,297,362,284
"900841501",422,492,914,265,242,224
"900842101",264,317,581,169,209,156
"901050916",569,614,1183,229,220,213
"901050604",624,669,1293,325,345,322
"900842509",423,462,885,258,275,241
"900630213",491,590,1081,268,262,243
"900701406",624,693,1317,340,333,296
"900070611",533,489,1022,258,290,249
"900841312",313,485,798,339,467,327
"900842019",398,498,896,303,389,270
"900841912",366,477,843,206,273,195
"900841907",413,498,911,296,359,261
"900841905",254,319,573,185,246,171
"900841807",543,581,1124,332,348,277
"900841613",293,335,628,186,216,176
"900841605",587,682,1269,337,324,283
"900841502",562,647,1209,351,389,334
"900840808",634,670,1304,329,290,268
"900841022",433,496,929,257,258,238
"900840815",471,496,967,228,214,209
"900840807",499,517,1016,259,279,245
"900140121",786,872,1658,415,374,357
"900840409",560,544,1104,244,183,181
"900840413",601,583,1184,248,249,234
"900840408",211,219,430,101,89,88
"900840404",660,701,1361,334,327,301
"900840403",528,662,1190,305,289,269
"900840223",363,390,753,205,206,185
"900770119",504,534,1038,262,278,244
"900770116",552,629,1181,321,315,288
"900420109",236,244,480,155,160,131
"900420108",606,640,1246,350,355,320
"900842803",900,986,1886,466,448,412
"900842802",593,666,1259,309,326,283
"900842418",597,613,1210,298,280,265
"900140712",567,554,1121,278,267,248
"901190101",28,25,53,15,14,14
"901120211",9,3,12,5,12,5
"901120208",30,17,47,20,28,20
"901120207",71,49,120,34,50,34
"901120202",28,24,52,19,32,19
"901050103",67,56,123,32,42,31
"900980413",191,182,373,95,240,91
"900980102",140,107,247,57,83,56
"900911202",109,101,210,55,61,54
"900911201",233,197,430,102,130,101
"900911103",110,106,216,54,59,53
"900980103",25,31,56,23,37,20
"900980303",30,24,54,12,43,12
"900910605",52,47,99,25,25,25
"900910307",224,188,412,106,113,99
"900910208",321,268,589,152,190,151
"900770602",460,453,913,200,223,194
"900770208",10,7,17,5,6,5
"900701303",463,473,936,217,230,208
"900701202",116,99,215,66,80,65
"900701203",232,214,446,114,131,112
"900700901",0,0,0,0,5,0
"900700404",366,353,719,182,210,179
"900700401",123,123,246,66,93,66
"900700304",72,64,136,31,34,31
"900700302",101,71,172,35,37,35
"900630405",137,121,258,53,61,51
"900630204",55,42,97,29,91,29
"900561401",142,141,283,72,79,72
"900561202",183,166,349,95,103,80
"900561103",66,66,132,33,53,33
"900560603",424,374,798,193,210,180
"900560801",125,120,245,59,68,56
"900280205",233,268,501,114,121,108
"900210404",140,160,300,67,74,63
"900210402",121,120,241,51,51,48
"900210207",355,326,681,172,194,161
"901050301",19,11,30,12,20,12
"900210208",294,273,567,130,151,125
"900210101",2,0,2,2,10,2
"900141505",162,160,322,79,72,66
"900141401",22,15,37,7,6,6
"900141002",211,190,401,114,133,113
"900140904",165,154,319,75,82,73
"900140903",332,313,645,152,193,148
"900140709",120,149,269,64,67,63
"900140707",86,70,156,35,35,31
"900140706",330,335,665,151,157,138
"900140603",17,8,25,6,10,6
"900140402",115,80,195,57,72,57
"900140205",439,406,845,184,162,156
"900070605",163,160,323,73,57,47
"900070501",149,143,292,73,80,70
"900070402",120,91,211,62,59,54
"900070305",46,62,108,32,48,30
"900140304",149,142,291,66,72,60
"900490401",240,218,458,121,167,117
"900490302",164,155,319,79,99,79
"900350307",136,98,234,50,60,49
"900070707",156,140,296,59,81,58
"900630207",280,237,517,123,108,97
"900560607",149,123,272,64,90,62
"900560605",96,86,182,45,54,45
"900420304",167,158,325,69,73,67
"900420205",155,138,293,61,68,60
"900210106",318,302,620,130,131,127
"900141201",538,584,1122,262,278,251
"900770405",389,366,755,207,250,198
"900630404",784,707,1491,348,300,289
"900070405",515,530,1045,235,343,230
"901050601",394,360,754,188,181,151
"900980409",225,182,407,112,190,110
"900841915",228,267,495,164,177,154
"900842411",384,412,796,217,207,184
"901190503",545,529,1074,266,233,217
"901190419",639,667,1306,332,400,330
"901190414",361,423,784,211,234,209
"901190404",756,703,1459,353,339,299
"901190402",635,620,1255,298,260,246
"901190311",379,366,745,179,172,160
"901050913",729,748,1477,356,345,307
"901050817",490,567,1057,252,254,239
"901051001",563,659,1222,340,322,297
"901050708",569,580,1149,255,237,222
"901050625",423,430,853,220,210,171
"901050607",360,331,691,166,155,147
"900980420",266,255,521,137,358,130
"901050614",266,249,515,118,117,105
"900843010",694,653,1347,271,258,250
"900843008",578,566,1144,266,251,239
"900842914",1176,1297,2473,626,634,582
"900842812",731,758,1489,369,367,341
"900842809",453,506,959,242,237,225
"900842801",829,871,1700,416,437,403
"900842701",468,523,991,255,261,241
"900842517",609,578,1187,275,225,216
"900842401",539,555,1094,255,241,209
"900842313",373,380,753,201,181,169
"900842217",918,930,1848,389,360,351
"900842212",434,457,891,194,168,164
"900842210",523,627,1150,292,247,228
"900842218",386,397,783,164,161,157
"900842118",434,450,884,217,162,158
"900841704",568,601,1169,315,341,287
"900841409",341,368,709,215,260,190
"900840613",247,251,498,160,172,149
"900840609",421,409,830,210,202,187
"900840602",702,776,1478,391,334,293
"900840502",379,421,800,208,236,201
"900840314",261,312,573,160,165,140
"900840313",394,456,850,266,279,249
"900840303",661,747,1408,362,362,332
"900840212",741,787,1528,403,416,371
"900840206",485,551,1036,270,270,254
"900840108",611,671,1282,321,603,315
"900840204",356,397,753,191,178,174
"900770417",625,584,1209,301,314,281
"900840510",357,371,728,177,180,160
"900840124",642,656,1298,346,371,336
"900840507",512,531,1043,228,207,198
"900770121",592,599,1191,307,316,289
"900701419",565,653,1218,346,325,294
"900701417",757,833,1590,413,425,392
"900701404",367,406,773,222,227,210
"900701401",313,355,668,186,193,173
"900840220",314,369,683,211,236,202
"900701414",390,437,827,226,248,216
"900701412",443,469,912,232,243,212
"900700807",937,985,1922,440,474,427
"900700206",623,624,1247,316,355,303
"900630513",661,694,1355,336,306,293
"900630511",629,636,1265,299,301,267
"900630505",587,650,1237,336,334,300
"900630417",421,433,854,216,213,194
"900841303",308,281,589,177,252,161
"900630502",364,442,806,213,213,196
"900630114",667,683,1350,335,337,301
"900630112",514,543,1057,284,281,255
"900630110",753,781,1534,387,390,347
"900561403",343,325,668,154,181,149
"900561108",621,616,1237,293,327,283
"900841218",198,278,476,203,308,196
"900560307",386,394,780,215,222,204
"900560306",714,762,1476,355,360,330
"900560305",847,824,1671,367,377,354
"900141612",406,415,821,213,199,188
"900141506",795,847,1642,386,381,347
"900141410",586,604,1190,267,244,232
"900141617",495,513,1008,258,246,230
"900141224",415,445,860,202,213,200
"900141219",619,674,1293,328,336,304
"900141207",685,750,1435,313,321,293
"900141216",458,506,964,232,232,216
"900841401",630,646,1276,337,319,276
"900841108",689,687,1376,297,274,251
"900841104",220,303,523,198,264,182
"900841016",349,426,775,264,295,241
"900840912",209,247,456,145,170,141
"900840905",418,470,888,252,275,229
"900840820",565,531,1096,274,262,240
"900840709",486,533,1019,304,304,259
"900140611",588,567,1155,267,294,263
"900140207",733,734,1467,353,338,320
"900140113",825,904,1729,420,431,389
"900840707",487,556,1043,304,309,279
"900140120",496,513,1009,237,237,219
"900140117",418,444,862,212,231,210
"900420115",619,679,1298,282,276,265
"900700605",373,386,759,197,213,186
"900280108",657,689,1346,334,335,309
"900280106",410,489,899,231,265,216
"900280101",836,835,1671,375,360,328
"900210613",363,404,767,218,229,204
"900210608",698,705,1403,394,411,365
"900210605",591,722,1313,351,333,318
"900841207",292,377,669,257,332,249
"900141614",676,730,1406,301,272,259
"900140211",546,574,1120,254,236,219
"900840512",301,384,685,218,251,204
"900841211",316,409,725,266,399,261
"900842616",740,766,1506,356,298,284
"900701003",161,172,333,82,71,69
"901120110",252,245,497,142,304,121
"900630416",149,153,302,67,244,67
"900210205",1012,1060,2072,489,532,444
"900841411",466,557,1023,282,282,240
"900842608",374,435,809,245,295,238
"900141105",768,785,1553,357,360,321
"900140905",318,295,613,143,169,139
"900070408",738,702,1440,349,394,332
"900841913",276,357,633,209,245,179
"900841911",324,470,794,364,489,348
"900841609",490,493,983,263,270,238
"900841608",526,594,1120,338,364,314
"900841802",434,485,919,287,383,276
"900841604",718,787,1505,445,474,431
"900841602",364,449,813,248,286,242
"900841023",660,767,1427,402,411,355
"900840814",1106,1104,2210,518,473,459
"900841307",179,191,370,120,175,117
"900840810",453,459,912,254,264,238
"900840412",382,429,811,219,221,193
"900840407",558,632,1190,276,252,239
"900770117",481,529,1010,278,306,269
"900420107",618,675,1293,331,363,311
"900420105",456,505,961,242,248,229
"900141311",853,887,1740,377,342,331
"900842815",715,731,1446,334,348,324
"900842605",677,718,1395,325,292,287
"900141218",534,570,1104,273,252,237
"900842602",523,515,1038,224,193,187
"900842601",771,901,1672,412,349,324
"901120403",215,184,399,88,95,82
"901190102",16,8,24,4,30,4
"901120305",94,100,194,38,56,37
"901120212",47,35,82,23,38,23
"900980407",145,129,274,80,164,78
"900980309",184,196,380,109,183,105
"900980304",175,179,354,90,141,89
"900980104",107,105,212,76,138,73
"900980101",254,226,480,131,159,128
"900911203",30,16,46,13,16,11
"900911102",43,43,86,26,42,25
"900911101",112,81,193,56,62,53
"900910801",77,58,135,34,39,33
"900910701",441,395,836,195,208,194
"900910602",263,219,482,132,153,131
"900910205",225,188,413,112,138,110
"900770601",417,404,821,202,222,201
"900770201",140,144,284,62,61,61
"900701302",261,237,498,127,161,126
"900700902",160,115,275,64,74,64
"900700703",3,0,3,3,3,3
"900700501",306,280,586,142,151,131
"900700407",134,129,263,67,71,64
"900700201",42,27,69,22,34,22
"900561303",69,70,139,41,54,41
"900561301",316,296,612,140,156,136
"900560907",198,201,399,110,135,108
"900560706",229,229,458,103,124,102
"900350201",50,37,87,24,24,24
"900350110",149,137,286,64,67,64
"900350102",71,50,121,33,37,33
"900280310",213,205,418,95,113,90
"900280308",12,7,19,8,24,8
"900210405",54,50,104,24,28,22
"900210304",269,251,520,121,136,120
"900210303",309,299,608,146,157,138
"901120104",51,45,96,24,53,24
"901120102",69,44,113,41,73,41
"901050505",315,308,623,173,202,160
"901050503",464,466,930,223,252,215
"901050206",189,209,398,81,252,77
"900141503",64,63,127,29,41,26
"900141104",335,323,658,168,202,163
"900140901",474,449,923,231,312,231
"900140804",77,79,156,53,71,53
"900140705",135,118,253,56,48,44
"900140605",12,10,22,6,6,6
"900140201",134,122,256,61,72,59
"900140102",611,562,1173,273,272,258
"900071005",508,453,961,217,250,209
"900071004",97,74,171,50,67,50
"900070808",405,371,776,183,213,179
"900070807",648,629,1277,295,311,274
"900070804",69,74,143,37,49,36
"900070801",254,245,499,107,143,107
"900070204",244,195,439,133,153,132
"900070102",40,33,73,19,30,19
"900560406",186,143,329,83,98,68
"900490203",651,604,1255,303,312,278
"900490102",490,470,960,229,193,158
"900420213",229,212,441,108,130,107
"900420201",290,261,551,142,159,140
"900350311",110,98,208,47,56,46
"900350310",233,194,427,97,124,94
"900350303",56,48,104,31,42,31
"900350208",99,76,175,49,53,47
"901120401",52,43,95,24,34,21
"900070608",127,150,277,74,86,69
"900561102",21,8,29,9,22,9
"900420302",447,437,884,199,227,198
"900770407",612,593,1205,278,264,229
"900700702",114,94,208,46,59,46
"900560903",245,257,502,132,170,124
"900490502",251,259,510,124,127,107
"900210209",324,346,670,148,154,140
"900141504",1081,1010,2091,445,435,415
"901190401",479,461,940,206,209,190
"900842404",661,703,1364,391,347,305
"901190510",458,471,929,252,308,249
"901190505",400,409,809,214,242,213
"901190406",687,719,1406,366,383,350
"901190405",736,739,1475,320,280,255
"901190403",713,733,1446,333,276,269
"901190208",511,554,1065,249,236,224
"901190205",417,471,888,223,226,214
"901120214",555,618,1173,299,322,290
"901120115",295,285,580,143,288,126
"901120113",142,175,317,93,424,86
"901190209",579,616,1195,269,236,221
"901051021",614,667,1281,330,319,290
"901051008",239,229,468,110,113,101
"901050706",553,617,1170,286,233,220
"901050703",265,290,555,155,147,132
"901050712",811,893,1704,407,404,362
"901050624",239,253,492,111,122,109
"901050717",3,0,3,3,341,1
"900980106",329,303,632,178,253,164
"900980419",44,53,97,24,291,23
"900910104",707,740,1447,385,416,366
"900910103",733,740,1473,377,392,349
"900843016",781,740,1521,349,426,328
"900910106",457,531,988,249,271,239
"900843011",767,738,1505,362,363,334
"900843002",624,633,1257,309,328,298
"900842906",578,541,1119,254,236,229
"900842904",574,570,1144,278,238,230
"900842902",788,843,1631,397,364,350
"900842819",522,552,1074,273,302,272
"900842818",490,539,1029,278,297,270
"900842810",544,553,1097,271,257,227
"900842808",554,514,1068,275,295,242
"900842711",578,650,1228,286,249,247
"900842710",792,820,1612,382,332,320
"900842709",920,835,1755,369,360,345
"900842518",587,635,1222,288,231,216
"900842507",737,833,1570,407,379,364
"900842506",344,326,670,180,157,142
"900842314",389,424,813,228,185,173
"900842214",815,862,1677,391,341,328
"900842213",673,723,1396,310,270,255
"900842123",5,1,6,0,0,0
"900842119",776,881,1657,393,346,334
"900841705",432,505,937,283,263,236
"900841615",710,742,1452,374,397,357
"900841408",338,407,745,267,280,221
"900841406",462,511,973,287,315,276
"900840302",918,906,1824,409,372,344
"901050815",478,495,973,219,220,208
"900840114",531,635,1166,297,296,283
"900840103",644,680,1324,350,398,342
"900770416",325,272,597,129,143,126
"900770414",813,758,1571,371,381,352
"900840216",301,368,669,199,211,188
"900770123",412,451,863,222,231,215
"900770122",400,441,841,232,237,222
"900770108",366,438,804,243,276,232
"900701420",566,599,1165,291,303,274
"900701408",259,325,584,168,183,158
"900701413",201,276,477,157,176,155
"900701101",180,178,358,76,78,73
"900701411",324,417,741,219,249,210
"900700604",541,533,1074,264,247,229
"900700603",413,380,793,212,257,201
"900700207",406,402,808,183,196,179
"900700204",430,450,880,225,237,211
"900770214",299,311,610,159,172,138
"900840219",421,473,894,281,329,271
"900841302",340,397,737,237,318,229
"900841301",286,336,622,216,249,200
"900141213",669,732,1401,333,315,289
"900842016",234,267,501,233,355,231
"900841102",320,377,697,282,405,278
"900841011",680,734,1414,350,366,345
"900841005",775,772,1547,363,328,303
"900840909",280,306,586,170,185,142
"900840714",369,343,712,217,250,189
"900840701",621,715,1336,320,293,265
"900140404",475,484,959,247,284,230
"900140209",491,471,962,228,221,207
"900842015",272,385,657,291,431,282
"900140129",716,738,1454,314,302,287
"900140126",1118,1151,2269,549,562,497
"900140111",310,330,640,169,201,164
"900840811",478,556,1034,298,309,288
"900842011",162,243,405,178,242,160
"900841217",248,365,613,235,321,227
"900560103",513,548,1061,274,277,252
"900490512",440,471,911,207,238,202
"900350312",623,618,1241,358,475,342
"900280320",438,458,896,196,202,190
"900280103",755,808,1563,382,381,336
"900210720",625,653,1278,288,296,280
"900210716",485,523,1008,272,263,253
"900490510",616,621,1237,310,348,301
"900210604",696,774,1470,378,392,353
"900210411",583,575,1158,272,298,261
"900210409",691,711,1402,328,343,313
"900210408",371,441,812,210,244,197
"900210110",383,363,746,169,203,161
"901120112",159,204,363,82,353,71
"901120111",249,251,500,152,317,139
"900630305",1104,1053,2157,499,514,483
"900420214",427,479,906,239,266,231
"900420110",330,347,677,192,197,180
"900280318",773,760,1533,370,368,339
"900280111",644,709,1353,341,346,313
"900210111",247,219,466,118,118,110
"900141605",554,593,1147,291,280,264
"900841701",511,548,1059,292,289,254
"900841225",222,299,521,290,458,280
"900071007",727,682,1409,315,335,292
"900070712",881,974,1855,417,411,372
"900841512",262,286,548,167,294,156
"900841314",274,402,676,231,321,220
"900841313",91,117,208,105,221,104
"900841910",260,400,660,263,373,237
"900841909",345,479,824,356,494,341
"900841812",282,322,604,273,363,257
"900841607",617,748,1365,388,418,371
"900841805",425,530,955,334,399,304
"900841612",370,410,780,213,216,192
"900841513",270,335,605,192,229,186
"900841508",248,304,552,154,198,147
"900841503",385,438,823,227,242,212
"900841021",151,173,324,94,114,93
"900841020",527,611,1138,303,324,289
"900840819",651,712,1363,333,296,274
"900840806",525,551,1076,273,253,240
"900840410",584,597,1181,247,226,221
"900840406",575,696,1271,286,285,264
"900770120",634,607,1241,299,292,276
"900420106",466,504,970,253,251,230
"900141314",466,418,884,203,168,165
"900141313",541,612,1153,259,249,234
"901051004",931,913,1844,412,346,336
"900842913",753,743,1496,360,314,301
"900842613",361,412,773,198,174,166
"900842603",404,467,871,209,192,181
"900842501",934,958,1892,427,375,370
"900842420",462,509,971,261,274,238
"901120402",109,105,214,45,44,41
"901120303",267,232,499,123,158,112
"901120206",90,77,167,57,98,57
"901120205",527,476,1003,247,282,235
"901120204",147,116,263,68,86,67
"901050204",306,308,614,150,434,144
"900980403",21,16,37,10,19,10
"900980202",3,2,5,4,10,4
"900911004",88,65,153,37,44,34
"900911001",121,102,223,67,70,67
"900910503",231,211,442,122,140,120
"900910502",243,220,463,112,137,109
"900910404",185,185,370,87,94,76
"900910403",260,240,500,118,85,83
"900910305",331,306,637,152,153,149
"900770603",124,123,247,56,57,53
"900770412",179,168,347,74,78,73
"900770409",321,288,609,142,120,89
"900770302",314,278,592,145,178,141
"900701001",4,0,4,3,26,3
"900700903",645,602,1247,298,322,280
"900700403",560,557,1117,305,418,294
"900700303",68,61,129,33,41,32
"900630402",38,41,79,20,18,18
"900630211",94,79,173,38,28,27
"900630101",516,506,1022,253,257,216
"900561209",174,187,361,89,92,87
"900561201",191,189,380,86,99,83
"900561001",325,303,628,145,157,143
"900560906",149,136,285,63,60,56
"900560606",217,198,415,100,116,100
"900560503",250,233,483,118,121,114
"900350107",50,37,87,23,30,23
"900280307",643,597,1240,270,263,236
"900280305",542,592,1134,243,246,219
"900280304",266,225,491,113,115,101
"900210206",431,376,807,188,215,177
"901050801",181,175,356,72,67,61
"901050401",170,156,326,102,152,101
"901050205",342,323,665,178,267,177
"900141502",563,565,1128,247,244,239
"900141102",540,566,1106,286,308,268
"900140906",248,262,510,130,165,124
"900140902",279,275,554,135,153,120
"900140708",473,445,918,223,253,213
"900140701",262,267,529,118,124,111
"900140504",137,106,243,73,81,73
"900140502",221,182,403,101,103,93
"900140204",319,298,617,147,160,143
"900071006",110,95,205,45,53,43
"900070902",199,175,374,84,100,78
"900070803",170,150,320,86,137,83
"900070802",72,63,135,29,35,27
"900070603",80,82,162,41,42,40
"900070303",50,45,95,18,22,18
"900070104",189,160,349,85,171,84
"900070503",181,181,362,88,100,85
"900070407",226,179,405,93,101,93
"900070101",20,29,49,14,20,14
"900070404",155,140,295,78,88,76
"900070506",210,183,393,87,91,85
"900560703",58,58,116,36,49,36
"900560402",454,414,868,227,304,217
"900560401",198,184,382,99,115,98
"900490601",6,4,10,2,5,2
"900490403",282,295,577,141,163,129
"900420301",150,123,273,49,56,47
"900350211",10,4,14,6,11,6
"900350209",70,73,143,37,49,37
"900350308",28,20,48,12,18,12
"900350206",205,186,391,97,95,78
"900490505",23,20,43,8,10,8
"901120301",118,111,229,62,69,62
"900070103",93,74,167,40,58,40
"900490205",170,162,332,70,96,66
"900420203",108,84,192,47,46,46
"900210502",674,659,1333,293,318,283
"900770203",440,431,871,222,245,207
"900630411",316,287,603,128,130,122
"900630103",516,503,1019,248,272,223
"900490501",557,621,1178,284,258,217
"900140103",960,938,1898,419,416,390
"900140301",521,454,975,229,254,222
"900842407",299,330,629,166,180,143
"900842106",468,573,1041,299,304,255
"900842105",256,278,534,159,194,130
"900841918",190,226,416,173,220,171
"900842413",442,456,898,270,313,236
"901190516",587,638,1225,316,348,280
"901190513",769,864,1633,402,463,375
"901190504",457,490,947,222,271,218
"901190421",325,361,686,181,236,176
"901190418",360,388,748,195,226,192
"901190413",373,424,797,210,232,208
"901190411",453,501,954,257,268,245
"901190408",756,785,1541,336,309,296
"901190319",473,512,985,271,309,267
"901190314",507,511,1018,254,335,228
"901190305",314,356,670,193,197,167
"901190207",307,351,658,167,158,149
"901190202",388,406,794,200,205,193
"901190215",513,535,1048,259,285,254
"901051024",739,725,1464,321,329,300
"901051022",559,590,1149,273,250,247
"901051013",446,503,949,262,272,246
"901051006",637,652,1289,320,339,292
"901050907",526,568,1094,306,322,284
"901050711",725,730,1455,385,397,366
"901050705",404,473,877,215,208,193
"901050623",800,907,1707,426,450,410
"901050605",653,685,1338,317,329,291
"901050713",414,431,845,243,291,240
"901050611",609,692,1301,299,293,275
"901050616",384,435,819,205,190,183
"900980415",560,566,1126,265,492,243
"901051003",640,657,1297,297,294,276
"900843009",725,683,1408,299,296,282
"900843001",652,690,1342,320,299,272
"900842901",849,862,1711,412,345,329
"900842813",566,614,1180,271,264,241
"900842811",639,704,1343,314,318,295
"900842705",669,766,1435,348,335,301
"900842704",569,683,1252,323,312,274
"900842516",414,449,863,207,196,187
"900842515",490,508,998,262,240,224
"900842512",769,829,1598,387,334,309
"900842209",478,542,1020,260,236,209
"900842208",575,601,1176,266,257,244
"900842112",320,407,727,235,236,209
"900841620",555,615,1170,317,319,294
"900840614",211,252,463,158,182,156
"900840612",207,222,429,129,125,106
"900840605",582,668,1250,352,357,328
"900840415",1105,1033,2138,448,396,387
"900840306",621,704,1325,350,335,314
"900840301",1042,984,2026,455,411,391
"900840221",797,878,1675,406,401,372
"900840214",417,481,898,258,243,219
"901050812",637,716,1353,374,391,362
"900840122",345,369,714,207,223,196
"900840117",366,369,735,196,163,157
"900840116",500,548,1048,257,246,225
"900840106",760,785,1545,392,413,383
"900840105",578,598,1176,309,332,307
"900770418",312,259,571,150,177,149
"900770210",854,857,1711,372,386,349
"900770115",729,757,1486,355,364,342
"900770114",304,312,616,156,166,153
"900842017",200,288,488,231,435,225
"900700806",418,452,870,223,235,215
"900630503",788,821,1609,389,382,364
"900630108",833,811,1644,387,386,355
"900630107",328,332,660,161,159,152
"900630104",772,788,1560,334,350,321
"900561203",349,359,708,185,214,184
"900841222",152,247,399,170,219,161
"900841219",364,493,857,373,537,368
"900560303",463,473,936,223,228,207
"900141611",460,461,921,236,246,213
"900141409",834,832,1666,393,354,330
"900141407",691,729,1420,328,330,310
"900141301",763,791,1554,346,340,329
"900141223",594,609,1203,322,356,317
"900141209",702,780,1482,337,320,288
"900141106",761,839,1600,391,396,358
"900841203",329,406,735,305,437,289
"900841109",718,764,1482,321,300,283
"900841413",424,548,972,270,270,244
"900841025",167,162,329,86,78,78
"900841308",271,355,626,240,314,224
"900841012",397,466,863,231,249,217
"900841003",525,561,1086,240,235,221
"900840911",441,515,956,292,325,252
"900840908",338,375,713,200,207,186
"900840805",987,1077,2064,488,415,412
"900840803",691,734,1425,340,341,313
"900140208",713,731,1444,363,368,342
"900840812",616,704,1320,351,305,281
"900140127",893,967,1860,434,451,397
"900140123",671,692,1363,332,326,309
"900842014",173,242,415,187,334,181
"900070409",649,656,1305,300,346,292
"900140116",1026,1014,2040,466,508,447
"900842006",180,256,436,191,306,174
"900490508",456,515,971,232,214,196
"900420217",363,356,719,154,152,147
"900280319",764,754,1518,316,308,288
"900700412",537,554,1091,270,327,262
"900210724",512,516,1028,284,336,282
"900210612",529,612,1141,298,315,280
"900210611",600,746,1346,317,372,305
"900210610",717,792,1509,400,388,357
"900210603",752,784,1536,369,316,296
"900210707",467,568,1035,301,326,276
"900210705",409,436,845,212,200,177
"900141616",1136,1182,2318,524,527,481
"900842003",162,264,426,185,301,177
"901190512",741,740,1481,375,470,348
"901190304",550,554,1104,243,235,225
"901120308",226,245,471,116,138,112
"901050910",215,260,475,147,167,143
"900910809",441,439,880,224,264,216
"900843004",416,467,883,231,226,217
"900560309",530,569,1099,288,315,270
"900350113",640,634,1274,324,382,319
"900280208",453,437,890,206,199,195
"900280107",532,527,1059,266,258,233
"900210706",611,727,1338,381,406,352
"900141604",373,403,776,206,194,171
"900701403",286,307,593,174,199,164
"900140118",607,618,1225,296,318,286
"900842104",239,323,562,224,342,211
"900841908",243,313,556,193,237,183
"900841906",207,267,474,174,173,142
"900841610",341,398,739,217,248,206
"900841804",180,233,413,144,187,127
"900841606",332,382,714,211,246,208
"900841024",584,735,1319,352,315,282
"900840813",500,575,1075,271,235,224
"900841506",524,640,1164,328,342,309
"900840816",561,654,1215,329,287,259
"900840414",459,429,888,205,198,185
"900840809",457,499,956,226,202,190
"900840411",364,391,755,200,190,179
"900840405",538,570,1108,288,294,271
"900840511",272,314,586,164,177,150
"900840222",666,721,1387,324,279,271
"900842912",444,446,890,200,184,180
"900842614",726,747,1473,320,333,300
"900842609",417,432,849,214,215,188
"900842610",519,515,1034,241,220,210
"900842417",425,511,936,215,196,190
"900842416",933,988,1921,485,445,423
"901120404",461,396,857,195,228,187
"901120201",69,36,105,27,54,22
"901050104",27,22,49,13,13,13
"900980406",305,297,602,171,319,161
"900980405",306,275,581,142,281,140
"900980402",512,455,967,245,517,221
"900980108",0,0,0,0,5,0
"900980203",35,34,69,14,24,14
"900910808",269,276,545,132,151,127
"900910807",31,16,47,17,22,17
"900910805",118,86,204,56,67,54
"900910702",376,344,720,186,200,171
"900910606",64,54,118,30,42,30
"900910604",96,61,157,42,50,42
"900910601",59,53,112,26,29,25
"900910402",206,166,372,97,110,96
"900910301",165,148,313,76,84,76
"900910207",326,315,641,168,195,165
"900910202",172,144,316,87,94,82
"900910201",341,348,689,161,175,156
"900770605",387,348,735,180,192,177
"900770406",337,337,674,144,154,143
"900700601",4,5,9,3,3,3
"900700408",94,81,175,48,57,48
"900630205",31,39,70,18,21,17
"900630203",34,34,68,18,15,14
"900561205",278,236,514,125,139,123
"900561107",437,393,830,211,226,211
"900561005",212,202,414,109,128,107
"900560910",68,62,130,35,30,25
"900560904",282,322,604,149,155,140
"900560901",146,124,270,71,91,70
"900560604",92,83,175,35,81,35
"900350108",32,14,46,11,13,11
"900350106",100,68,168,39,43,39
"900350103",68,52,120,32,37,32
"900280306",521,473,994,212,168,146
"900280302",156,106,262,76,122,72
"900280207",651,555,1206,251,242,231
"900210718",508,479,987,226,239,210
"900210302",299,277,576,132,137,124
"901050207",124,100,224,48,180,46
"900210102",235,205,440,104,129,99
"900210109",479,474,953,234,237,202
"900141202",385,359,744,184,150,136
"900141001",305,308,613,158,172,147
"900140802",151,143,294,62,82,62
"900071003",117,131,248,65,84,61
"900071002",124,111,235,54,85,54
"900070702",227,204,431,104,119,100
"900070609",287,264,551,131,156,125
"900070502",112,90,202,52,59,51
"900070401",170,125,295,70,73,70
"900140505",186,127,313,70,79,68
"900560405",45,36,81,27,50,27
"900560704",318,292,610,141,153,141
"900560101",52,42,94,29,39,27
"900490701",2,3,5,1,1,1
"900490402",322,348,670,166,188,153
"900420402",184,129,313,99,166,97
"900560505",148,153,301,80,92,80
"900420207",122,94,216,57,64,56
"900420206",128,107,235,47,53,44
"900350301",189,143,332,80,91,79
"900350202",38,25,63,20,22,20
"901050102",53,62,115,18,21,18
"900420305",229,216,445,96,105,91
"900700301",800,801,1601,375,330,272
"900140606",262,277,539,135,153,133
"900070904",485,468,953,202,230,202
"900070607",420,388,808,184,205,173
"900280206",1114,1153,2267,524,540,488
"900210406",385,376,761,180,186,170
"900842204",410,430,840,200,198,193
"900842108",283,332,615,223,320,206
"900841914",256,302,558,193,241,184
"900842415",970,1098,2068,482,433,421
"901190502",462,485,947,235,233,220
"901190313",640,698,1338,355,399,339
"901190310",406,406,812,210,220,190
"901190216",399,449,848,223,231,211
"901120215",294,306,600,162,167,145
"901190211",608,626,1234,309,346,302
"901051020",342,332,674,167,172,153
"901051014",10,6,16,4,4,3
"901051011",555,541,1096,253,231,219
"901050911",263,328,591,186,203,181
"901050909",449,500,949,276,311,261
"901050905",672,655,1327,323,327,304
"901050903",977,1017,1994,477,490,460
"901050710",497,523,1020,207,186,173
"901050709",607,593,1200,273,252,240
"901050707",264,264,528,144,149,137
"901050621",968,1019,1987,427,412,393
"901050606",494,520,1014,230,227,208
"901050613",473,512,985,226,299,202
"900980311",317,314,631,179,336,176
"901050715",278,292,570,153,324,150
"901050612",633,647,1280,275,289,256
"900910105",534,591,1125,293,327,278
"900843018",968,1042,2010,473,479,447
"900842905",478,549,1027,235,209,204
"900842820",429,486,915,232,251,226
"900842806",646,667,1313,294,280,261
"900842805",636,670,1306,295,299,285
"900842714",729,788,1517,396,408,364
"900842702",917,998,1915,455,403,375
"900842511",1037,1067,2104,480,421,405
"900842504",518,565,1083,276,281,265
"900842307",338,446,784,243,235,206
"900842306",731,771,1502,391,385,326
"900842301",360,388,748,220,241,202
"900842223",495,477,972,222,229,214
"900841712",494,573,1067,297,266,250
"900841706",531,551,1082,280,252,230
"900841702",563,656,1219,348,358,322
"900841622",302,307,609,165,154,136
"900842018",434,548,982,375,538,357
"900840611",323,352,675,206,229,184
"900840501",568,624,1192,333,343,306
"900840401",810,877,1687,397,379,355
"900840312",439,398,837,201,173,162
"900840213",360,403,763,221,232,191
"900840211",291,334,625,186,196,181
"900840125",527,570,1097,268,318,264
"900840121",349,405,754,215,229,186
"900840107",646,715,1361,357,385,352
"900770607",780,855,1635,393,360,311
"900840101",430,404,834,187,190,176
"900770109",437,504,941,253,283,245
"900770104",884,903,1787,423,429,405
"900770103",591,604,1195,328,324,291
"900701421",376,418,794,206,194,181
"900701402",478,497,975,230,225,211
"900770212",221,189,410,122,157,122
"900700208",524,500,1024,239,235,213
"900841304",236,354,590,220,331,218
"900630501",658,729,1387,318,309,290
"900630419",787,767,1554,356,340,317
"900630216",564,601,1165,267,266,250
"900630218",628,634,1262,296,291,265
"900561305",532,545,1077,289,304,277
"900700607",553,569,1122,254,258,245
"900141613",780,835,1615,390,385,365
"900141303",775,888,1663,400,330,306
"900141308",458,519,977,243,236,221
"900141215",412,408,820,212,200,186
"900841202",319,422,741,269,406,265
"900841113",383,507,890,243,227,204
"900841110",429,505,934,228,231,211
"900841017",380,438,818,221,220,187
"900841008",799,860,1659,379,323,314
"900841006",663,738,1401,298,258,250
"900840703",498,677,1175,285,264,247
"900140710",690,725,1415,356,390,311
"900140609",556,616,1172,289,274,240
"900140403",443,424,867,214,245,197
"900840706",654,683,1337,357,342,297
"900420116",491,511,1002,225,237,210
"900842010",259,340,599,249,331,236
"900842005",176,263,439,198,281,196
"900560310",540,629,1169,305,320,296
"900420216",283,274,557,148,157,146
"900841212",360,453,813,349,487,335
"900841209",332,446,778,357,474,328
"900210726",604,660,1264,280,279,273
"900210725",824,882,1706,417,445,379
"900210722",617,651,1268,286,296,269
"900210717",670,697,1367,306,286,271
"900210710",584,658,1242,346,362,332
"900210704",334,364,698,191,191,171
"900210618",559,597,1156,268,266,245
"900210602",1062,1129,2191,510,451,426
"900210410",444,458,902,238,260,230
"900841206",204,276,480,169,211,151
"900842009",224,317,541,246,347,232
"900840513",386,424,810,285,333,263
"900842121",239,324,563,209,309,191
"901050402",432,433,865,207,379,190
"900630106",490,569,1059,275,279,258
"900490404",60,63,123,29,33,26
"900350114",543,558,1101,285,391,276
"900770413",352,347,699,171,178,155
"900770101",672,657,1329,331,341,318
"900141221",344,327,671,159,160,150
"900841511",289,324,613,171,188,161
"900841317",285,375,660,242,412,228
"900840111",521,535,1056,254,267,244
"900070509",241,230,471,113,138,110
"900842103",182,264,446,165,238,156
"900841904",192,254,446,184,238,157
"900841611",622,686,1308,352,337,293
"900841603",532,582,1114,310,344,292
"900840817",333,370,703,213,173,161
"900840402",621,717,1338,349,360,322
"901050810",646,667,1313,292,266,259
"901050809",618,660,1278,306,280,259
"900842008",218,348,566,207,294,203
"900842612",488,561,1049,248,191,188
"900141217",730,788,1518,354,317,309
"901120307",265,210,475,147,191,146
"901120209",104,95,199,58,68,57
"901120107",25,17,42,16,35,16
"901050302",283,278,561,125,147,123
"900980201",21,19,40,12,16,11
"900980307",10,2,12,5,7,5
"900910902",169,166,335,76,83,75
"900910804",156,149,305,95,113,94
"900910901",127,124,251,60,69,59
"900910603",121,119,240,75,77,70
"900910401",115,96,211,40,42,39
"900910306",300,298,598,159,174,155
"900910501",347,294,641,154,174,154
"900910203",324,309,633,144,161,133
"900770301",234,193,427,103,134,96
"900701201",3,2,5,3,6,3
"900700803",193,174,367,87,74,59
"900700409",374,408,782,211,235,205
"900700405",245,224,469,121,134,117
"900700305",99,103,202,48,50,47
"900630303",300,298,598,151,147,134
"900630210",76,53,129,26,48,26
"900630202",191,186,377,91,87,56
"900630208",8,11,19,5,8,5
"900630302",1019,990,2009,495,495,430
"900630206",483,451,934,201,231,194
"900561302",195,205,400,89,102,87
"900561210",65,57,122,33,46,29
"900561002",29,25,54,16,23,16
"900560909",114,80,194,48,55,48
"900560908",260,215,475,107,107,105
"900560701",241,194,435,102,107,100
"900350112",362,324,686,154,176,149
"900350101",496,476,972,230,247,226
"900280204",116,106,222,43,64,43
"900210505",46,40,86,21,28,21
"900210504",355,330,685,146,162,145
"901120106",50,28,78,21,36,21
"901120103",90,77,167,41,54,40
"901050901",33,39,72,15,13,13
"900141601",359,375,734,183,147,141
"900140801",175,171,346,77,87,77
"900140604",52,39,91,22,22,20
"900140503",291,251,542,134,190,128
"900140501",65,50,115,32,38,29
"900140206",94,80,174,41,44,40
"900140202",336,295,631,132,119,117
"900140101",251,217,468,122,127,121
"900070905",141,116,257,55,86,52
"900070809",136,121,257,64,76,62
"900070610",235,216,451,110,122,108
"900140506",201,189,390,91,104,90
"900070304",28,32,60,18,19,18
"900070202",55,54,109,26,29,25
"900140401",90,74,164,36,50,36
"900070705",134,120,254,57,65,57
"900560705",192,177,369,87,99,87
"900560403",278,274,552,115,121,108
"900560805",466,442,908,221,228,198
"900560102",86,67,153,34,42,32
"900490602",277,260,537,149,181,146
"900490504",77,50,127,30,37,30
"900490503",26,15,41,12,26,10
"900490202",43,25,68,17,18,17
"900420401",50,41,91,21,32,20
"900420208",345,302,647,170,212,166
"900350304",67,46,113,40,49,40
"900350203",25,16,41,10,13,10
"900070504",140,116,256,67,71,65
"900980305",70,58,128,30,53,30
"900910504",72,56,128,37,43,35
"900070805",365,364,729,186,222,179
"900700802",25,23,48,11,10,9
"900350306",27,18,45,12,15,12
"900350111",377,334,711,154,153,144
"900701002",188,179,367,86,104,84
"900700602",658,667,1325,285,301,278
"900700203",215,221,436,111,134,106
"900141501",582,627,1209,263,291,245
"900070903",308,252,560,150,239,149
"901190201",597,640,1237,292,287,273
"900210104",702,673,1375,311,322,291
"900842410",522,584,1106,325,342,294
"900842405",417,439,856,251,220,191
"900842202",824,820,1644,369,309,299
"900841919",577,766,1343,380,435,334
"901190412",393,436,829,198,216,187
"901190409",962,970,1932,440,439,394
"901190315",497,532,1029,239,273,232
"901190309",431,445,876,239,249,217
"901190307",478,533,1011,262,289,259
"901190306",707,663,1370,280,257,239
"901120213",739,820,1559,416,431,381
"901120116",188,178,366,85,258,82
"901051023",593,628,1221,302,215,196
"901051015",649,635,1284,320,287,269
"901050806",513,548,1061,244,215,205
"901050804",734,773,1507,348,309,293
"901050718",35,45,80,25,284,22
"901050622",236,265,501,123,132,123
"900980410",172,148,320,91,415,89
"900980414",304,315,619,155,500,148
"900910101",915,941,1856,447,460,392
"900843015",886,947,1833,435,450,426
"900842909",695,734,1429,335,320,306
"900842821",405,432,837,221,235,212
"900842817",616,610,1226,285,286,264
"900842703",521,545,1066,283,284,236
"900842615",735,785,1520,388,402,370
"900842513",673,747,1420,403,407,357
"900842510",516,563,1079,264,269,245
"900842505",611,737,1348,352,383,347
"900842402",532,607,1139,338,271,251
"900842309",577,615,1192,317,345,293
"900842304",527,637,1164,328,321,269
"900842206",658,738,1396,333,294,280
"900842115",511,508,1019,234,217,195
"900842111",405,383,788,177,166,165
"900841621",488,530,1018,268,274,238
"900841618",669,701,1370,323,309,273
"900840608",581,623,1204,301,253,224
"900840215",299,366,665,197,211,191
"900840209",496,556,1052,278,273,254
"900840205",920,1000,1920,497,464,428
"900840120",361,412,773,221,230,212
"900840109",421,472,893,247,240,220
"900840217",384,423,807,229,249,217
"900770124",464,482,946,237,262,234
"900701304",636,684,1320,336,378,328
"900701407",301,338,639,187,218,175
"900770113",454,473,927,237,253,222
"900770107",473,511,984,244,246,230
"900700101",234,222,456,109,114,105
"900630509",903,921,1824,441,432,403
"900770112",393,458,851,231,228,215
"900770111",362,459,821,246,253,232
"900630215",656,721,1377,332,309,291
"900630214",329,317,646,169,401,169
"900630217",624,623,1247,275,272,261
"900630113",638,647,1285,307,303,272
"900630109",585,604,1189,292,278,245
"900841226",332,435,767,309,480,294
"900561213",613,613,1226,285,306,284
"900841224",95,125,220,105,137,102
"900841223",275,397,672,235,351,234
"900141608",514,530,1044,272,253,241
"900141603",470,521,991,241,241,212
"900141602",661,791,1452,395,367,346
"900490509",724,767,1491,390,407,365
"900141305",547,593,1140,239,233,224
"900141225",445,441,886,205,409,198
"900141211",631,622,1253,299,295,275
"900141210",884,889,1773,437,420,387
"900841318",477,537,1014,313,381,291
"900841414",497,540,1037,267,266,235
"900841107",698,710,1408,319,278,268
"900841310",255,318,573,258,353,253
"900841101",300,341,641,229,315,219
"900841018",476,528,1004,265,257,246
"900841004",735,824,1559,362,360,351
"900841002",1056,1053,2109,502,441,414
"900840913",151,173,324,158,206,145
"900840904",348,377,725,210,187,170
"900840708",582,744,1326,387,390,332
"900140131",963,973,1936,434,431,405
"900140112",1318,1344,2662,625,668,587
"900140108",455,446,901,219,196,188
"900140107",623,592,1215,273,292,259
"900140106",339,362,701,161,172,151
"900140105",448,480,928,202,187,170
"900700606",436,474,910,240,267,233
"900841215",174,230,404,172,237,163
"900420306",596,609,1205,291,309,274
"900420113",492,552,1044,280,299,263
"900350214",329,371,700,187,223,182
"900841210",301,403,704,293,422,288
"900490511",711,706,1417,357,366,312
"900210723",452,453,905,225,229,214
"900210702",730,782,1512,361,348,312
"900210620",294,347,641,166,216,165
"900210709",599,611,1210,298,262,247
"900210617",357,411,768,183,176,149
"900210711",222,255,477,158,178,143
"901190511",405,430,835,178,198,173
"900980411",133,139,272,74,297,73
"900910704",153,138,291,80,78,77
"900700414",488,498,986,226,228,213
"900560311",820,841,1661,429,446,405
"900350212",434,425,859,233,273,223
"900842122",246,355,601,196,203,153
"900841315",137,260,397,176,300,165
"900842102",374,495,869,329,512,317
"900841902",323,451,774,285,392,280
"900841803",217,279,496,167,152,131
"900841614",455,449,904,253,280,246
"900210715",504,543,1047,273,268,252
"900210714",490,559,1049,267,244,226
"900843013",843,845,1688,402,411,377
"900842816",644,611,1255,289,286,277
"900842607",550,566,1116,280,309,271
"900842604",662,714,1376,340,323,292
"900840915",487,527,1014,306,339,271
"901190501",11,9,20,7,3,3
"901120304",61,46,107,28,37,28
"901120302",499,487,986,228,291,223
"901120210",737,716,1453,326,476,309
"901120203",181,156,337,92,131,92
"900980404",4,4,8,5,8,4
"900980306",0,0,0,0,1,0
"900910803",132,112,244,71,49,45
"900910302",347,304,651,170,179,165
"900980302",17,9,26,7,33,7
"900910209",249,209,458,126,155,125
"900980301",21,10,31,11,21,11
"900770207",147,138,285,61,55,54
"900770206",108,97,205,51,54,50
"900770204",166,139,305,69,74,66
"900700801",104,99,203,37,59,34
"900700502",275,267,542,161,179,158
"900700410",98,85,183,46,54,45
"900630403",328,293,621,143,155,136
"900630409",4,3,7,1,2,1
"900630408",279,320,599,145,148,127
"900630304",102,86,188,37,38,35
"900561306",82,68,150,36,35,30
"900561304",440,392,832,202,221,201
"900561212",195,176,371,96,108,92
"900561211",244,203,447,117,144,116
"900561207",301,295,596,153,178,149
"900561206",242,237,479,126,137,124
"900561003",410,372,782,182,220,181
"900561106",144,114,258,67,73,67
"900560501",144,135,279,74,101,72
"900350104",16,12,28,8,18,8
"900280312",288,238,526,106,113,106
"900280303",74,65,139,33,32,26
"900280301",14,6,20,5,5,5
"900280201",20,12,32,10,10,10
"900560803",254,228,482,117,138,117
"900210501",299,311,610,149,145,139
"900210301",261,230,491,118,135,116
"900210202",177,141,318,80,88,71
"900210103",0,0,0,0,2,0
"900141404",110,95,205,47,49,46
"900141101",133,131,264,68,80,64
"900140805",328,344,672,169,185,163
"900140803",224,199,423,98,116,98
"900070701",235,246,481,112,105,104
"900070602",206,181,387,91,112,89
"900070507",152,130,282,71,90,64
"900560404",86,69,155,35,46,34
"900560202",3,0,3,1,3,1
"900560201",109,94,203,50,60,47
"900560804",235,222,457,101,116,100
"900350305",109,86,195,52,55,52
"900350302",64,58,122,39,41,39
"900350210",12,12,24,5,5,5
"900350207",151,147,298,71,77,71
"900140303",74,41,115,29,32,26
"900070709",138,123,261,63,67,60
"900700904",132,152,284,70,66,62
"900561402",151,150,301,85,95,82
"900140602",31,25,56,14,16,14
"900770411",376,309,685,144,139,119
"900561404",736,797,1533,351,396,335
"900420212",1042,1019,2061,506,592,486
"900210701",841,909,1750,429,472,416
"900141103",111,105,216,46,74,45
"900140601",284,266,550,131,129,125
"900140104",383,386,769,180,173,160
"901190302",332,353,685,190,266,188
"900842219",784,772,1556,341,328,317
"900842203",512,526,1038,229,204,188
"900842002",187,292,479,207,327,205
"900841916",276,326,602,296,392,277
"901190514",693,690,1383,322,328,289
"901190312",316,345,661,173,206,170
"901190206",740,812,1552,369,400,349
"901190214",329,376,705,188,204,170
"901190210",390,437,827,199,230,192
"901051019",430,433,863,195,152,123
"901190217",552,551,1103,266,264,234
"901051009",862,850,1712,416,429,387
"901051005",837,883,1720,440,469,408
"901050917",321,312,633,166,192,158
"901050915",400,523,923,277,310,256
"901050914",639,652,1291,339,302,281
"901050807",543,598,1141,313,319,281
"901050803",624,665,1289,340,308,284
"901050603",729,819,1548,379,399,360
"901050608",288,282,570,132,133,124
"901050615",446,502,948,236,226,204
"900910607",189,210,399,117,145,115
"900843019",217,231,448,117,120,112
"900843014",676,704,1380,329,300,276
"900843012",799,814,1613,375,401,353
"900843005",466,505,971,252,252,221
"900842916",437,438,875,202,170,159
"900842910",528,582,1110,249,230,226
"900842824",821,860,1681,417,459,406
"900842706",748,824,1572,383,364,348
"900842514",627,679,1306,329,309,284
"900842502",351,364,715,163,162,156
"900842312",430,518,948,264,282,249
"900842310",564,643,1207,336,309,277
"900842305",505,606,1111,306,311,271
"900842211",500,503,1003,228,212,193
"900842114",1014,1019,2033,450,436,412
"900842113",738,837,1575,384,325,295
"900841708",611,707,1318,371,374,332
"900841707",329,384,713,187,164,144
"900841703",480,518,998,311,283,255
"900841407",478,514,992,311,400,292
"900840607",460,507,967,255,247,230
"900840604",524,581,1105,294,297,270
"900840601",290,304,594,155,126,118
"900840416",848,880,1728,383,366,342
"900840311",356,388,744,196,178,163
"900840309",396,537,933,217,201,189
"900840308",504,553,1057,293,288,254
"900840305",533,549,1082,272,255,241
"900840210",495,558,1053,316,325,302
"900840119",293,301,594,193,219,189
"900840123",734,840,1574,425,416,378
"900770415",528,515,1043,247,268,242
"900840508",404,428,832,184,147,139
"900770209",694,657,1351,308,311,282
"900770105",807,804,1611,412,428,384
"900770102",645,669,1314,328,313,289
"900701416",422,479,901,252,287,238
"900841305",448,478,926,292,391,270
"900700205",802,736,1538,352,388,343
"900770106",648,700,1348,332,338,310
"900630510",780,797,1577,360,386,345
"900630506",653,718,1371,341,345,312
"900630418",571,551,1122,262,260,239
"900630420",441,458,899,212,233,202
"900630105",742,790,1532,383,402,360
"900561407",575,596,1171,301,308,286
"900560408",277,292,569,153,168,150
"900560302",565,604,1169,308,324,298
"900560301",490,524,1014,248,259,235
"900141609",487,554,1041,261,240,215
"900210712",363,472,835,237,253,197
"900141618",659,689,1348,330,341,313
"900141307",634,677,1311,297,298,270
"900141306",971,987,1958,459,437,415
"900141304",388,415,803,181,185,178
"900141212",481,515,996,265,244,221
"900141208",542,572,1114,251,258,238
"900140713",859,928,1787,439,465,396
"900841204",379,463,842,255,334,249
"900841201",341,416,757,268,362,260
"900841111",543,575,1118,318,305,273
"900841106",769,740,1509,325,291,285
"900841309",292,421,713,310,502,310
"900841015",338,341,679,180,155,143
"900841014",389,468,857,207,188,176
"900840901",316,356,672,193,166,157
"900840801",409,429,838,208,175,165
"900840710",328,350,678,188,221,176
"900140610",757,847,1604,367,363,341
"900140608",352,376,728,174,174,158
"900140125",613,587,1200,274,275,234
"900840705",425,468,893,253,269,238
"900700808",351,363,714,173,169,163
"900420101",589,641,1230,317,335,296
"900280317",670,655,1325,287,282,264
"900280316",542,599,1141,239,231,207
"900700413",750,703,1453,329,341,312
"900280113",539,578,1117,265,275,249
"900280112",986,1017,2003,435,400,378
"900280105",616,643,1259,310,298,268
"900210703",644,458,1102,228,210,194
"900210615",444,522,966,247,251,226
"900841617",646,580,1226,277,262,245
"900911104",110,104,214,55,61,54
"900843017",384,420,804,198,209,190
"900700307",505,524,1029,256,278,242
"900630415",494,509,1003,207,217,202
"900420215",262,270,532,140,206,135
"900280315",7,6,13,3,43,3
"900842120",245,319,564,247,362,232
"900841917",145,213,358,160,222,159
"900840704",595,663,1258,364,384,332
"900840118",236,261,497,162,182,161
"900770118",311,345,656,188,189,169
"900841510",481,575,1056,305,281,233
"900841903",248,348,596,292,447,273
"900841901",255,346,601,233,357,227
"900841811",506,574,1080,321,291,253
"900841810",363,408,771,217,191,167
"900841808",544,643,1187,424,468,363
"900841601",506,540,1046,297,337,284
"900841505",507,571,1078,311,376,301
"900840818",303,359,662,179,197,168
"900141312",787,806,1593,408,377,357
"900842911",818,789,1607,378,358,336
"900842814",423,420,843,200,202,186
"900141310",1065,1085,2150,483,456,437
"900842519",572,617,1189,251,251,241
"901190103",108,97,205,46,80,44
"901050202",18,14,32,11,12,11
"901050201",94,81,175,31,37,30
"900980105",127,79,206,68,91,62
"900911003",236,210,446,116,137,116
"900910802",44,43,87,23,34,23
"900770408",158,156,314,72,80,68
"900770402",12,8,20,8,10,8
"900770401",6,4,10,2,2,2
"900770205",19,19,38,11,25,10
"900701204",386,344,730,183,204,178
"900700406",384,346,730,173,191,169
"900630406",193,200,393,81,87,78
"900630201",106,68,174,42,68,37
"900561101",13,13,26,5,19,5
"900560911",75,66,141,42,50,42
"900560602",285,301,586,142,173,137
"900560601",80,60,140,43,51,43
"900350105",40,36,76,21,31,21
"900280313",11,11,22,2,5,2
"900280309",131,130,261,72,88,70
"900280202",96,58,154,44,52,44
"900280203",118,103,221,59,66,58
"900210601",56,70,126,26,27,26
"900210403",283,293,576,136,140,126
"900210204",403,370,773,192,208,179
"901120105",105,71,176,59,64,47
"901120101",25,15,40,11,23,11
"901050602",573,534,1107,248,273,237
"901050502",52,48,100,27,35,25
"901050501",321,327,648,146,155,139
"901050208",406,377,783,181,248,177
"900560802",70,59,129,33,39,33
"900210107",147,127,274,62,63,61
"900210105",266,286,552,146,161,133
"900141220",52,53,105,27,27,25
"900141203",169,148,317,67,70,64
"900141003",346,323,669,174,214,161
"900140806",148,114,262,67,94,67
"900140704",467,463,930,209,230,204
"900140703",452,452,904,214,222,181
"900140203",74,61,135,33,34,32
"900071001",314,260,574,166,191,160
"900070901",33,36,69,23,30,21
"900070806",139,140,279,70,114,69
"900070703",322,301,623,137,167,134
"900070606",250,252,502,122,125,119
"900070604",328,316,644,136,144,132
"900070302",34,36,70,17,23,17
"900070206",197,177,374,78,89,77
"900070203",35,31,66,21,25,20
"900070406",16,12,28,13,19,13
"900070505",201,195,396,97,109,96
"900560407",42,51,93,25,33,23
"900490507",108,87,195,41,45,40
"900350309",42,43,85,23,26,22
"900350204",101,90,191,40,41,40
"900140302",115,113,228,53,51,43
"900700804",336,299,635,152,194,146
"900350205",162,150,312,81,101,78
"900280311",126,111,237,61,55,54
"900770403",542,473,1015,208,219,202
"900701301",745,777,1522,359,369,332
"900701102",248,247,495,108,120,105
"900700102",254,221,475,109,124,108
"900630413",909,913,1822,422,424,375
"900070710",793,827,1620,360,374,339
"900070105",154,133,287,83,179,76
"900070704",335,335,670,147,163,141
"901190303",294,341,635,149,186,147
"901120109",259,242,501,124,224,116
"901050902",581,590,1171,303,336,284
"900980401",360,320,680,181,284,177
"900842409",631,711,1342,350,339,300
"900842221",786,804,1590,313,312,297
"900842110",504,583,1087,323,293,256
"900842109",342,451,793,253,284,211
"900842001",190,249,439,184,265,183
"900140613",691,740,1431,326,301,285
"901190515",536,591,1127,281,325,278
"901190507",736,788,1524,378,420,371
"901190410",395,488,883,259,276,238
"901190407",957,1016,1973,423,393,366
"901190308",350,386,736,194,213,186
"901190203",400,445,845,211,229,201
"901120114",202,185,387,112,375,109
"901190416",219,245,464,119,129,119
"901051018",861,857,1718,408,305,269
"901050908",501,535,1036,280,290,265
"901050906",704,784,1488,394,378,332
"901050904",654,752,1406,367,354,328
"901051002",476,494,970,218,194,189
"901050802",805,866,1671,414,342,313
"901050610",475,487,962,230,227,209
"901050609",540,529,1069,261,223,210
"901050716",0,0,0,0,288,0
"900980418",217,202,419,109,299,105
"900980417",185,183,368,94,207,84
"900910102",693,769,1462,386,370,342
"900843007",753,825,1578,346,289,283
"900843003",741,720,1461,357,362,323
"900842713",393,447,840,248,269,240
"900842708",667,727,1394,340,295,283
"900842707",848,870,1718,364,353,341
"900842508",786,817,1603,387,326,308
"900842503",550,683,1233,333,319,303
"900842311",619,695,1314,360,319,281
"900842308",359,454,813,242,268,222
"900842302",297,372,669,220,203,162
"900842216",713,685,1398,329,332,307
"900842205",425,440,865,220,225,209
"900842117",278,342,620,169,145,142
"900841711",400,482,882,225,202,188
"900841709",656,704,1360,360,326,293
"900841619",496,521,1017,276,249,237
"900841616",449,485,934,265,341,249
"900841412",538,578,1116,315,366,291
"900841410",382,449,831,234,250,212
"900841405",518,611,1129,348,359,301
"900840610",311,396,707,207,214,195
"900840603",1277,625,1902,251,216,198
"900840307",570,632,1202,334,308,277
"900840201",346,345,691,165,155,139
"901050814",607,655,1262,325,313,287
"900840115",552,601,1153,276,275,258
"900840102",479,466,945,219,208,198
"900770606",667,708,1375,340,356,320
"900770419",394,400,794,176,162,155
"900840509",295,327,622,163,205,161
"900701418",775,762,1537,362,369,340
"900701405",642,686,1328,333,324,309
"900701409",805,874,1679,424,429,386
"900700805",364,370,734,174,195,165
"900630512",687,706,1393,321,312,282
"900770110",518,615,1133,322,375,308
"900630212",809,796,1605,345,352,320
"900561408",546,550,1096,256,254,231
"900560702",662,653,1315,322,354,306
"900560312",750,780,1530,368,396,355
"900560304",306,326,632,162,166,155
"900141507",946,949,1895,464,453,415
"900141408",1084,1161,2245,506,481,460
"900141406",596,544,1140,267,245,237
"900141302",569,622,1191,280,229,216
"900141222",901,944,1845,432,421,368
"900141214",782,798,1580,338,337,308
"900140714",611,612,1223,295,270,257
"900841112",379,425,804,248,305,242
"900841105",587,632,1219,277,260,242
"900841311",151,223,374,146,222,142
"900841103",309,351,660,212,316,202
"900841013",547,577,1124,276,225,201
"900841010",846,900,1746,438,456,406
"900841009",638,690,1328,285,267,256
"900841001",514,543,1057,299,304,280
"900840907",392,438,830,201,169,148
"900840906",327,381,708,178,181,154
"900840804",534,539,1073,241,237,221
"900840713",291,317,608,186,193,163
"900840712",330,411,741,280,341,277
"900840702",282,320,602,155,153,138
"900140614",532,503,1035,246,237,219
"900140130",1179,1143,2322,514,444,405
"900140109",1001,1054,2055,487,495,438
"900842013",235,317,552,205,353,197
"900070306",244,248,492,120,141,118
"900841216",416,544,960,397,523,394
"900841214",346,444,790,283,349,263
"900841213",283,344,627,217,327,215
"900420102",649,693,1342,352,368,332
"900420104",274,332,606,182,227,169
"900280104",599,662,1261,317,315,287
"900210721",522,494,1016,222,222,215
"900210719",1023,986,2009,439,419,402
"900210614",631,731,1362,360,376,341
"900210609",290,344,634,171,172,161
"900210607",589,653,1242,308,299,283
"900210616",548,515,1063,266,283,259
"900140210",467,499,966,249,234,229
"900842007",362,471,833,333,510,321
"900841205",211,257,468,189,330,187
"900980416",377,392,769,203,354,181
"900980310",334,362,696,187,373,187
"900910406",90,97,187,48,61,47
"900700701",179,205,384,92,98,85
"900630414",450,460,910,213,211,194
"900840505",330,361,691,195,204,184
"900280110",423,447,870,214,214,194
"900141606",466,465,931,229,199,184
"900840504",269,335,604,185,177,148
"900840503",470,508,978,286,302,262
"900841316",200,278,478,202,250,199
"901050619",435,459,894,221,217,198
"900841809",412,495,907,318,343,272
"900841509",555,646,1201,373,423,351
"900841507",265,374,639,133,166,127
"900841504",594,659,1253,360,399,325
"900420111",289,320,609,154,160,134
"900280109",411,424,835,221,225,196
"900210713",288,350,638,184,197,170
"901190509",633,635,1268,318,350,307
"900842606",524,524,1048,263,291,252
"900842611",501,596,1097,282,239,222
"900842419",341,374,715,199,189,177
"901190301",5,6,11,1,1,1
"901120306",94,86,180,36,40,36
"901120108",95,78,173,55,72,55
"901050203",137,133,270,58,101,34
"901050101",57,61,118,22,26,22
"900980107",21,13,34,12,36,12
"900910904",46,37,83,26,27,24
"900910903",155,131,286,76,85,75
"900911002",110,97,207,45,48,45
"900910806",82,65,147,49,55,47
"900910703",142,127,269,58,59,56
"900910405",215,217,432,120,141,113
"900910308",96,80,176,46,52,45
"900910304",371,349,720,167,169,164
"900910303",318,297,615,142,165,138
"900910206",209,171,380,88,106,88
"900910204",451,391,842,216,240,211
"900980308",434,424,858,225,374,221
"900770604",108,108,216,55,68,54
"900770501",357,347,704,169,201,161
"900770410",236,204,440,97,90,83
"900700402",194,203,397,84,94,81
"900700202",166,160,326,70,74,69
"900700411",153,142,295,76,77,71
"900630401",16,7,23,8,14,8
"900630410",130,108,238,57,70,56
"900630102",639,655,1294,314,431,302
"900561406",462,452,914,227,239,218
"900561405",247,227,474,109,115,107
"900630301",1144,1150,2294,578,440,288
"900561208",77,71,148,33,37,33
"900561204",311,308,619,165,197,165
"900561105",178,177,355,88,110,88
"900561104",184,164,348,96,101,95
"900561004",223,225,448,117,134,106
"900630209",26,23,49,15,15,15
"900560502",457,458,915,241,282,236
"900350109",81,60,141,43,50,40
"900280314",41,7,48,20,23,20
"900210503",376,320,696,189,233,187
"900210401",218,236,454,110,124,107
"900210203",245,237,482,108,125,107
"900210201",127,127,254,62,89,62
"900210108",409,375,784,177,185,172
"900141403",47,58,105,31,39,29
"900141402",12,9,21,8,8,8
"900141204",936,975,1911,452,360,313
"900140702",24,30,54,10,9,8
"900140607",110,112,222,49,53,47
"900070601",258,257,515,126,146,121
"900070508",177,145,322,87,106,80
"900070301",58,43,101,29,30,26
"900070201",55,49,104,31,54,30
"900070706",33,21,54,16,18,16
"900560504",391,406,797,195,218,195
"900560203",358,343,701,178,231,173
"900490703",344,311,655,162,198,142
"900490702",273,276,549,130,178,121
"900490603",98,102,200,54,59,54
"900490506",207,163,370,85,84,72
"900490301",477,419,896,217,253,208
"900490201",325,299,624,149,167,146
"900490101",260,259,519,140,168,134
"900490204",898,856,1754,368,404,352
"900420303",166,161,327,73,98,72
"900420211",619,645,1264,302,335,287
"900420210",301,334,635,134,141,133
"900420209",642,603,1245,276,300,270
"900420204",122,124,246,48,55,48
"900420202",125,121,246,60,64,56
"900070708",170,149,319,69,83,69
"900980408",414,385,799,198,278,193
"900070711",315,304,619,131,146,128
"900070205",272,280,552,150,179,146
"900630407",67,59,126,27,30,25
"900560905",43,43,86,23,26,23
"900560902",12,7,19,4,9,4
"020130302",312,342,654,270,377,265
"020131101",296,272,568,172,217,170
"020130104",379,384,763,367,524,355
"020130103",286,326,612,258,314,254
"020130102",373,397,770,343,408,340
"020130105",402,433,835,421,674,393
"020130101",316,417,733,296,392,294
"020130104",NA,NA,NA,NA,NA,NA
"020130107",240,269,509,185,254,181
"020130110",341,368,709,314,368,304
"020130106",430,452,882,386,519,356
"020120405",283,323,606,249,298,231
"020130109",220,237,457,217,223,197
"020130111",285,375,660,300,346,259
"020130108",260,278,538,241,302,238
"020120407",476,595,1071,499,653,496
"020120404",467,485,952,295,329,278
"020120402",386,402,788,287,327,268
"020130205",394,392,786,330,482,323
"020130112",255,289,544,246,309,242
"020120401",377,392,769,277,284,245
"020130113",283,339,622,245,306,239
"020130211",305,308,613,293,457,292
"020120406",344,416,760,297,367,290
"020120303",371,453,824,270,312,261
"020130204",322,344,666,239,302,234
"020130202",408,452,860,359,402,329
"020120403",512,576,1088,418,469,383
"020130114",262,385,647,283,353,262
"020130206",465,484,949,470,687,460
"020120302",329,369,698,249,268,225
"020120408",376,410,786,289,355,281
"020130207",322,345,667,300,372,291
"020120301",111,121,232,104,126,104
"020120304",373,432,805,268,303,259
"020130201",497,576,1073,545,707,514
"020130210",494,608,1102,468,562,436
"020120505",300,394,694,348,436,345
"020130203",272,319,591,259,344,255
"020130208",263,355,618,253,324,252
"020131102",344,402,746,241,329,239
"020120504",298,359,657,277,313,275
"020130209",496,559,1055,396,497,390
"020120409",264,330,594,224,279,222
"020120107",533,556,1089,360,370,328
"020130304",509,560,1069,433,754,429
"020120305",368,451,819,292,341,289
"020120108",241,264,505,182,214,178
"020120106",346,414,760,286,330,276
"020120410",312,318,630,243,292,223
"020130303",363,418,781,353,462,331
"020120506",279,356,635,301,424,287
"020130301",375,458,833,377,494,373
"020120308",330,394,724,253,302,250
"020120105",284,304,588,217,249,206
"020120503",656,702,1358,543,665,528
"020120502",302,356,658,283,356,279
"020120309",325,344,669,223,234,204
"020120306",890,930,1820,451,346,335
"020130402",344,433,777,350,438,338
"020120501",298,324,622,212,256,204
"020130305",392,406,798,312,446,309
"020120104",429,456,885,313,315,266
"020131205",334,373,707,218,270,212
"020130401",271,339,610,291,424,284
"020130403",341,338,679,304,380,300
"020130306",294,357,651,271,382,270
"020120310",433,445,878,305,363,286
"020131103",264,315,579,207,259,194
"020120507",348,411,759,327,400,321
"020120307",448,561,1009,378,422,376
"020130404",446,549,995,430,548,423
"020130310",454,518,972,448,641,442
"020130503",539,650,1189,530,744,525
"020120508",433,564,997,421,498,413
"020120509",363,406,769,311,352,302
"020131106",521,560,1081,408,482,373
"020130406",382,497,879,400,517,396
"020130309",461,489,950,354,416,331
"020120109",468,506,974,356,423,349
"020120511",365,428,793,332,377,315
"020120510",327,368,695,284,326,276
"020141001",17,8,25,6,20,6
"020120311",363,422,785,290,345,278
"020131104",245,312,557,229,308,226
"020130504",441,567,1008,478,602,473
"020130408",280,344,624,265,359,264
"020131105",278,313,591,222,262,215
"020120604",436,514,950,349,354,325
"020131107",343,383,726,284,355,265
"020130307",301,362,663,290,357,283
"020130502",496,700,1196,403,495,397
"020130407",351,379,730,296,349,290
"020131003",448,516,964,427,526,401
"020130405",336,422,758,363,476,358
"020120202",325,413,738,316,389,309
"020120111",510,528,1038,374,439,365
"020130506",425,528,953,437,542,418
"020130308",278,347,625,278,361,277
"020131204",404,456,860,352,454,350
"020120110",425,463,888,361,439,350
"020120103",335,352,687,187,200,176
"020130412",632,768,1400,613,793,583
"020120201",458,608,1066,371,386,312
"020130505",406,482,888,359,434,341
"020120603",319,367,686,257,305,253
"020130507",352,425,777,327,438,324
"020120606",442,541,983,380,425,338
"020131202",439,458,897,320,392,312
"020130501",360,384,744,344,410,335
"020130409",331,383,714,341,449,334
"020130411",378,446,824,370,398,316
"020131002",436,464,900,404,527,344
"020120605",481,520,1001,387,475,382
"020131005",270,298,568,252,351,232
"020120602",401,469,870,353,478,348
"020130508",407,476,883,417,550,407
"020120203",393,457,850,394,480,381
"020131004",533,577,1110,417,552,413
"020130601",314,374,688,283,325,282
"020131001",376,422,798,415,569,413
"020130410",186,254,440,237,315,229
"020130804",411,468,879,388,476,378
"020131206",267,303,570,240,329,235
"020130413",305,402,707,337,433,321
"020131203",309,315,624,237,297,236
"020120702",402,434,836,310,338,298
"020130605",412,527,939,454,559,445
"020120607",335,401,736,332,401,329
"020131201",329,374,703,277,418,276
"020130414",319,439,758,327,425,324
"020130604",411,493,904,419,530,397
"020120601",337,452,789,320,386,299
"020130803",427,502,929,411,516,407
"020131210",281,283,564,249,301,244
"020130602",479,582,1061,425,468,396
"020130805",439,516,955,452,655,450
"020130802",248,315,563,275,387,271
"020120609",319,406,725,302,369,301
"020131006",440,460,900,388,464,378
"020130606",364,500,864,368,436,348
"020120204",491,541,1032,379,457,372
"020120208",468,535,1003,345,380,335
"020130603",429,503,932,368,428,359
"020131207",417,479,896,341,418,339
"020120608",343,390,733,288,314,285
"020120701",377,459,836,318,385,313
"020130607",445,532,977,425,497,391
"020130801",268,372,640,314,406,311
"020120703",400,479,879,325,378,315
"020131011",267,349,616,314,489,306
"020131007",292,369,661,321,416,312
"020130806",317,359,676,295,355,291
"020131208",282,347,629,282,373,272
"020120205",460,560,1020,401,442,371
"020130809",309,399,708,326,440,326
"020120610",361,413,774,316,353,296
"020130703",447,569,1016,457,566,453
"020131010",389,504,893,424,549,400
"020120704",444,500,944,359,404,321
"020130807",354,454,808,364,413,338
"020130810",289,361,650,292,382,289
"020130901",307,366,673,287,353,283
"020130704",344,409,753,344,508,340
"020120705",350,395,745,290,353,264
"020131209",473,472,945,384,513,378
"020131303",330,407,737,322,434,319
"020130808",428,565,993,439,513,411
"020130608",354,440,794,339,387,335
"020120801",737,728,1465,548,586,406
"020130906",311,374,685,320,430,318
"020130902",304,395,699,303,434,294
"020131009",297,404,701,325,389,313
"020120206",433,535,968,344,399,335
"020130702",268,318,586,221,272,220
"020130705",438,610,1048,476,664,473
"020130706",372,457,829,381,480,369
"020131305",376,451,827,411,512,406
"020120706",414,494,908,347,440,343
"020130907",318,359,677,296,363,294
"020131302",140,174,314,155,200,147
"020131603",210,299,509,252,405,249
"020130707",382,423,805,346,418,327
"020130905",502,673,1175,488,619,485
"020120802",337,408,745,273,324,269
"020130903",213,293,506,247,354,236
"020130701",335,444,779,271,340,269
"020131304",370,472,842,394,513,370
"020131008",346,564,910,432,607,430
"020130908",337,451,788,344,429,328
"020130708",346,430,776,309,416,304
"020131602",376,500,876,430,549,424
"020131306",118,143,261,132,188,131
"020120207",389,461,850,319,387,316
"020131403",289,371,660,367,534,360
"020130909",357,511,868,363,431,359
"020131301",461,567,1028,376,466,352
"020130904",246,326,572,293,401,292
"020120803",387,481,868,325,384,319
"020131307",295,334,629,305,408,299
"020120907",437,442,879,307,369,298
"020120708",392,482,874,365,445,358
"020131604",308,388,696,368,492,367
"020131402",165,216,381,162,212,162
"020130910",219,318,537,239,335,235
"020131313",588,631,1219,556,685,526
"020131601",365,489,854,392,520,388
"020131605",229,297,526,252,359,251
"020130709",360,458,818,373,433,363
"020131404",327,407,734,291,360,288
"020131401",367,409,776,341,441,327
"020120707",379,443,822,301,386,297
"020131308",277,372,649,249,360,248
"020120102",270,312,582,196,223,192
"020131610",358,481,839,391,581,385
"020131606",189,223,412,183,249,169
"020131405",246,285,531,228,291,228
"020131406",373,473,846,359,439,355
"020131314",330,347,677,348,530,342
"020120806",376,460,836,352,416,343
"020131701",487,578,1065,476,613,471
"020131502",294,418,712,360,498,357
"020120804",376,393,769,262,316,256
"020131411",357,449,806,284,347,268
"020131607",323,442,765,369,467,365
"020120709",558,679,1237,557,749,550
"020120906",452,508,960,377,452,365
"020131501",332,413,745,350,470,350
"020131609",361,466,827,380,461,373
"020131410",317,410,727,298,369,297
"020120903",483,522,1005,385,455,377
"020131702",484,599,1083,472,660,464
"020131309",338,442,780,287,342,273
"020121004",381,377,758,270,307,256
"020131611",299,425,724,381,499,379
"020131312",435,562,997,327,396,324
"020132105",396,454,850,291,378,286
"020131608",281,390,671,352,411,347
"020131409",225,309,534,238,328,234
"020132208",376,421,797,377,543,361
"020131503",293,453,746,349,425,347
"020131310",388,531,919,358,456,346
"020120710",498,594,1092,476,616,469
"020131612",315,415,730,347,425,339
"020120101",263,318,581,191,216,188
"020132104",388,473,861,319,403,319
"020120905",469,496,965,358,456,354
"020120807",384,487,871,364,439,359
"020131408",282,322,604,254,408,249
"020121003",337,393,730,287,338,282
"020132209",243,308,551,220,289,210
"020131509",357,510,867,416,614,403
"020131703",389,428,817,389,555,358
"020131705",296,411,707,345,367,281
"020131311",278,325,603,215,278,212
"020132206",510,612,1122,391,485,385
"020132106",333,426,759,312,387,308
"020131613",259,293,552,223,257,221
"020132103",234,303,537,233,312,226
"020131407",172,212,384,165,224,163
"020120901",414,523,937,331,402,315
"020120805",280,322,602,344,441,340
"020140203",372,494,866,349,447,339
"020140208",390,542,932,402,536,399
"020120904",498,563,1061,392,468,383
"020131504",197,295,492,199,286,196
"020132107",497,628,1125,450,550,443
"020131709",434,572,1006,403,531,399
"020132102",132,177,309,149,206,148
"020120808",440,487,927,415,503,408
"020132207",493,608,1101,455,600,453
"020131704",243,309,552,247,303,243
"020132205",500,684,1184,394,483,390
"020131508",324,389,713,372,457,363
"020121001",462,532,994,366,381,321
"020132110",382,534,916,342,430,335
"020131505",361,441,802,391,530,384
"020140202",246,294,540,271,429,270
"020140204",283,375,658,320,441,319
"020132108",329,406,735,345,431,338
"020132101",257,344,601,244,366,232
"020120809",462,513,975,396,473,387
"020131803",423,517,940,397,500,390
"020131510",244,388,632,331,451,330
"020132204",395,500,895,327,422,322
"020120810",328,403,731,290,323,269
"020131507",346,457,803,383,475,376
"020131706",338,430,768,360,414,344
"020121002",465,529,994,390,490,378
"020131710",431,513,944,398,498,393
"020121005",347,391,738,298,368,292
"020140201",508,664,1172,505,635,492
"020140209",398,511,909,380,486,371
"020120902",541,586,1127,420,465,400
"020140207",309,395,704,317,422,308
"020132005",250,352,602,312,421,300
"020131708",353,386,739,316,389,314
"020131511",305,430,735,369,522,367
"020121006",404,470,874,353,423,342
"020140205",310,410,720,340,445,324
"020131506",294,365,659,281,358,279
"020131802",391,476,867,407,521,402
"020132109",404,438,842,360,541,358
"020140108",415,537,952,299,390,291
"020121704",356,440,796,306,368,300
"020121701",470,540,1010,355,421,343
"020140304",347,434,781,297,415,297
"020131512",272,382,654,328,410,323
"020131707",373,467,840,386,484,382
"020140210",521,614,1135,474,627,470
"020131903",314,385,699,295,371,285
"020140206",298,375,673,268,448,265
"020140109",439,573,1012,398,465,378
"020132006",327,488,815,428,609,424
"020131711",239,331,570,247,314,245
"020132004",267,418,685,316,412,312
"020121007",353,415,768,295,313,247
"020120811",286,356,642,262,300,242
"020132001",282,364,646,301,414,301
"020132202",228,292,520,221,287,218
"020140305",368,494,862,407,564,401
"020121011",420,463,883,345,395,322
"020131902",427,506,933,397,498,393
"020121802",440,484,924,323,355,308
"020140301",719,900,1619,758,1018,727
"020140303",188,238,426,226,354,225
"020121705",537,596,1133,437,512,427
"020140104",424,520,944,362,455,355
"020140110",531,679,1210,462,561,444
"020132003",190,222,412,175,232,171
"020132203",218,253,471,222,324,217
"020132201",231,358,589,251,341,249
"020132012",232,332,564,277,440,270
"020131904",230,270,500,227,314,226
"020121702",491,561,1052,380,425,346
"020140312",302,375,677,305,454,299
"020131807",464,507,971,383,480,380
"020131901",351,454,805,340,416,335
"020121009",415,427,842,318,386,307
"020132007",370,465,835,372,503,366
"020131801",403,485,888,334,431,332
"020131804",324,395,719,294,367,293
"020132002",406,537,943,394,471,381
"020140306",190,220,410,164,229,162
"020132305",226,268,494,236,348,212
"020121109",398,471,869,373,468,370
"020131905",406,523,929,366,480,359
"020132011",271,327,598,261,341,251
"020140302",235,263,498,226,366,222
"020140402",282,328,610,220,273,220
"020132306",326,436,762,368,461,353
"020140906",320,374,694,296,427,295
"020121708",590,662,1252,557,701,545
"020121806",420,469,889,312,358,300
"020131909",277,384,661,332,421,327
"020121108",442,480,922,344,411,325
"020140311",308,400,708,347,464,346
"020131805",315,387,702,282,356,280
"020132010",237,327,564,272,369,268
"020121703",444,473,917,333,389,322
"020121010",349,466,815,299,307,255
"020140307",279,359,638,297,384,289
"020132008",341,442,783,386,584,383
"020132311",333,486,819,424,629,409
"020132304",250,354,604,294,413,289
"020140103",375,487,862,400,495,388
"020140907",284,370,654,264,378,257
"020121803",379,485,864,318,363,313
"020121801",289,342,631,231,294,228
"020140105",612,744,1356,585,774,574
"020131908",317,427,744,329,404,322
"020132009",234,317,551,258,389,255
"020140101",186,243,429,210,304,208
"020140905",173,225,398,198,255,193
"020132702",359,497,856,399,555,396
"020121106",403,455,858,319,373,307
"020121107",353,425,778,330,391,319
"020131910",315,378,693,312,418,311
"020121008",543,623,1166,477,579,469
"020132303",480,619,1099,538,707,534
"020140403",262,323,585,218,312,214
"020140106",455,545,1000,446,562,443
"020131806",346,393,739,302,409,301
"020140310",260,371,631,308,441,307
"020132307",222,307,529,257,325,252
"020140908",364,420,784,391,555,377
"020140904",551,666,1217,537,766,533
"020140102",244,318,562,255,333,245
"020121706",479,527,1006,414,477,388
"020121102",309,336,645,267,320,259
"020121606",648,758,1406,647,863,629
"020132703",417,626,1043,440,597,434
"020131911",199,206,405,193,224,160
"020140913",305,378,683,349,526,340
"020121804",383,434,817,308,347,296
"020132302",241,274,515,270,329,243
"020140308",359,480,839,430,585,400
"020121604",532,611,1143,521,616,448
"020140107",371,478,849,367,472,339
"020140902",392,484,876,303,423,301
"020132310",249,313,562,243,307,239
"020131912",323,430,753,268,354,266
"020131906",222,275,497,215,252,211
"020132706",473,647,1120,529,713,521
"020140309",352,541,893,456,618,441
"020132308",460,584,1044,505,674,502
"020132301",536,656,1192,545,681,535
"020140405",377,485,862,384,476,368
"020121901",403,510,913,352,404,345
"020131808",339,462,801,280,359,275
"020121103",248,320,568,254,301,243
"020131907",319,414,733,257,277,221
"020132701",183,239,422,175,215,174
"020121805",405,508,913,301,342,290
"020121101",343,417,760,328,388,319
"020140903",522,580,1102,525,734,502
"020121605",651,688,1339,618,687,470
"020132309",455,569,1024,429,494,363
"020132707",466,592,1058,497,697,494
"020121302",390,482,872,389,483,388
"020132704",381,471,852,387,546,384
"020132709",371,497,868,407,536,398
"020131809",228,297,525,170,208,166
"020121707",469,523,992,373,431,355
"020121603",428,480,908,359,399,308
"020140406",619,684,1303,454,649,451
"020140401",374,506,880,413,526,405
"020020101",63,42,105,21,9,9
"020132802",193,248,441,213,273,209
"020121807",429,465,894,336,373,328
"020132404",370,452,822,364,483,364
"020132705",262,354,616,311,393,304
"020140901",582,608,1190,491,731,481
"020121110",411,449,860,283,346,266
"020121602",399,474,873,363,431,345
"020140404",289,362,651,293,386,292
"020020102",268,250,518,133,124,119
"020132803",303,364,667,318,379,292
"020132405",354,372,726,286,353,282
"020121303",706,858,1564,721,962,711
"020121105",450,470,920,307,346,284
"020140909",361,432,793,363,579,362
"020121608",488,575,1063,528,690,518
"020121607",NA,NA,NA,NA,NA,NA
"020131810",368,444,812,274,363,270
"020132410",356,449,805,283,358,278
"020132809",341,429,770,393,582,381
"020121907",465,533,998,346,386,339
"020132708",371,443,814,368,433,359
"020121808",444,536,980,328,380,314
"020121304",582,675,1257,526,623,489
"020121104",405,483,888,343,420,325
"020121301",403,495,898,407,536,402
"020121609",382,456,838,362,427,358
"020121601",537,573,1110,395,447,379
"020132408",377,470,847,339,393,328
"020140910",408,504,912,462,633,401
"020132801",239,288,527,268,358,262
"020121809",372,422,794,290,291,263
"020140912",533,502,1035,418,510,345
"020132403",308,360,668,283,316,256
"020132808",379,557,936,451,577,448
"020141102",469,486,955,468,760,464
"020132603",343,428,771,288,325,280
"020132810",280,344,624,273,358,268
"020140911",334,433,767,395,591,389
"020132804",170,219,389,201,272,199
"020121111",360,414,774,278,343,272
"020121607",335,419,754,338,386,316
"020121610",306,357,663,330,459,327
"020121203",571,638,1209,509,627,485
"020121902",267,326,593,225,233,218
"020143101",371,350,721,217,406,217
"020121811",316,392,708,238,284,233
"020141103",225,282,507,237,334,230
"020140504",240,314,554,284,368,264
"020132806",374,449,823,356,461,346
"020150307",387,425,812,251,309,244
"020121305",467,610,1077,475,576,456
"020132406",323,411,734,318,384,305
"020121903",349,415,764,283,278,250
"020132602",351,460,811,325,376,320
"020132409",438,532,970,381,447,376
"020132807",307,386,693,329,401,326
"020132402",231,337,568,252,355,245
"020132805",226,322,548,217,279,215
"020121614",152,201,353,175,199,170
"020140407",397,532,929,432,603,430
"020121307",198,295,493,249,299,221
"020132610",420,518,938,436,531,428
"020141104",300,410,710,279,387,271
"020121810",361,386,747,284,360,272
"020121611",374,422,796,334,384,333
"020140505",441,605,1046,507,642,482
"020132604",445,522,967,419,467,385
"020121202",493,605,1098,501,619,494
"020132611",292,353,645,281,365,280
"020121504",454,520,974,418,536,415
"020140503",442,530,972,412,527,407
"020132401",211,260,471,198,250,196
"020141113",344,432,776,399,673,393
"020121204",417,494,911,356,437,349
"020141105",375,424,799,379,553,375
"020121306",428,483,911,395,497,390
"020140510",550,718,1268,546,660,517
"020121612",311,403,714,316,383,311
"020140409",373,429,802,433,587,401
"020132905",257,318,575,280,346,274
"020150306",349,382,731,272,324,264
"020121205",360,443,803,328,396,322
"020140506",280,351,631,277,387,275
"020121402",402,512,914,400,510,395
"020121906",497,581,1078,356,398,348
"020132407",443,500,943,367,402,344
"020121908",476,487,963,351,360,302
"020132501",283,308,591,262,289,242
"020132605",346,405,751,317,374,301
"020150305",375,426,801,242,274,230
"020140509",582,631,1213,502,601,495
"020141106",435,476,911,353,504,350
"020121201",285,376,661,272,351,270
"020121613",230,268,498,202,252,195
"020121401",393,607,1000,373,483,369
"020140408",490,633,1123,482,599,475
"020121812",534,629,1163,436,540,426
"020132601",413,440,853,316,449,313
"020141114",238,285,523,231,333,211
"020140507",258,295,553,236,281,215
"020143108",340,398,738,269,525,267
"020132906",338,425,763,330,418,327
"020132904",396,448,844,382,439,374
"020141101",484,563,1047,284,402,281
"020150308",446,471,917,329,380,315
"020132502",310,391,701,279,348,270
"020121905",502,587,1089,406,459,366
"020121909",339,450,789,316,372,311
"020140410",645,837,1482,697,869,671
"020132609",237,278,515,202,272,200
"020140502",446,509,955,370,414,356
"020121208",331,385,716,267,325,263
"020140601",468,523,991,512,699,482
"020140501",352,436,788,357,408,351
"020121407",480,577,1057,432,569,428
"020150304",377,423,800,269,302,257
"020121813",327,429,756,306,347,305
"020121206",234,319,553,260,358,243
"020141107",259,302,561,267,426,265
"020121403",360,418,778,308,403,304
"020141601",575,731,1306,591,737,575
"020132503",418,457,875,392,477,383
"020121910",507,573,1080,360,391,348
"020140605",333,461,794,387,461,368
"020121503",438,559,997,420,568,405
"020143102",393,444,837,327,439,317
"020150309",409,468,877,349,439,347
"020121505",397,516,913,393,496,391
"020141108",479,566,1045,529,745,522
"020140508",222,234,456,190,230,180
"020132504",311,357,668,269,319,264
"020132606",329,456,785,265,301,234
"020121404",375,491,866,407,602,398
"020132903",249,293,542,247,315,245
"020132911",392,398,790,327,508,306
"020121207",400,458,858,386,521,375
"020132908",517,586,1103,420,501,409
"020140606",522,605,1127,511,604,470
"020141112",344,383,727,362,513,357
"020141605",424,505,929,374,521,359
"020132505",270,324,594,221,239,193
"020150313",364,406,770,291,338,259
"020140604",354,368,722,361,498,349
"020132608",214,253,467,214,274,213
"020132506",358,372,730,274,308,255
"020121405",468,518,986,421,513,418
"020150310",386,482,868,340,427,336
"020143103",278,338,616,279,413,279
"020121904",488,594,1082,367,417,363
"020121913",306,407,713,286,321,272
"020132907",399,489,888,355,432,351
"020140610",172,223,395,213,284,212
"020150301",335,387,722,289,356,286
"020121502",366,478,844,422,547,419
"020141606",135,164,299,122,179,122
"020140602",397,424,821,401,588,345
"020150403",442,513,955,401,514,389
"020121408",448,523,971,469,633,463
"020141109",322,372,694,412,607,395
"020143106",551,669,1220,406,609,376
"020121506",377,452,829,343,423,339
"020140609",357,427,784,402,524,385
"020121501",394,490,884,378,508,365
"020140607",334,454,788,359,454,355
"020140805",429,558,987,482,644,459
"020141706",272,403,675,274,383,271
"020121912",388,445,833,333,392,315
"020121406",371,407,778,318,393,314
"020132607",216,275,491,189,236,183
"020132901",303,395,698,274,313,271
"020141604",457,488,945,397,611,397
"020140806",398,529,927,469,629,451
"020121507",397,524,921,383,482,379
"020150303",414,504,918,382,417,369
"020121911",509,573,1082,372,370,334
"020143104",274,372,646,250,346,249
"020140603",453,490,943,380,438,339
"020143109",292,357,649,225,338,224
"020132508",352,431,783,364,438,358
"020132902",301,333,634,281,341,280
"020121410",474,549,1023,441,534,423
"020141110",210,234,444,208,313,204
"020140804",203,252,455,245,316,241
"020132507",510,646,1156,504,540,456
"020140608",249,281,530,253,324,237
"020121508",409,529,938,364,456,359
"020141607",320,401,721,324,429,321
"020150312",563,647,1210,411,457,396
"020150311",345,410,755,340,400,335
"020151001",336,383,719,348,404,300
"020140807",297,335,632,301,391,289
"020143107",391,506,897,315,418,314
"020151002",579,528,1107,341,407,333
"020150402",318,373,691,256,328,240
"020150302",418,523,941,399,478,387
"020150404",275,289,564,206,235,204
"020143001",366,445,811,327,515,321
"020143105",275,332,607,251,319,239
"020141705",333,396,729,328,511,324
"020141201",187,247,434,230,315,218
"020121513",301,389,690,262,281,245
"020121409",375,425,800,324,420,319
"020151003",503,594,1097,409,470,396
"020122008",451,486,937,365,436,309
"020141111",233,293,526,316,467,306
"020141603",515,586,1101,524,747,517
"020140705",359,386,745,260,423,255
"020121509",455,540,995,426,552,422
"020150205",246,271,517,208,242,198
"020150501",367,412,779,303,396,297
"020140808",319,377,696,306,388,296
"020143110",237,308,545,195,280,189
"020010201",232,246,478,161,148,134
"020140803",166,190,356,169,226,169
"020141707",327,435,762,316,435,311
"020140802",287,305,592,290,412,282
"020010301",322,272,594,191,168,158
"020010204",297,305,602,163,120,110
"020150401",394,458,852,337,423,329
"020010202",188,213,401,128,124,114
"020122007",393,494,887,346,417,342
"020141702",390,510,900,390,558,369
"020151005",319,406,725,277,338,272
"020150405",298,338,636,230,264,210
"020140704",487,534,1021,402,577,399
"020143003",378,462,840,407,626,383
"020150406",357,444,801,270,324,266
"020010101",212,124,336,65,80,38
"020020203",265,307,572,229,303,224
"020122005",474,519,993,382,417,351
"020143002",423,553,976,429,626,413
"020141205",353,476,829,380,500,366
"020141704",189,231,420,208,371,197
"020121512",377,421,798,284,311,267
"020151006",216,269,485,216,281,213
"020140809",570,607,1177,476,779,459
"020141602",353,437,790,331,556,329
"020143004",272,302,574,305,539,300
"020010302",283,281,564,161,154,145
"020150502",458,537,995,358,397,325
"020150204",255,299,554,208,245,202
"020141206",228,323,551,264,356,260
"020121510",426,422,848,297,368,293
"020141202",381,460,841,382,524,374
"020151007",386,460,846,402,508,382
"020122004",495,539,1034,391,459,386
"020140801",427,416,843,366,489,297
"020010203",170,167,337,104,104,98
"020122104",471,544,1015,421,529,416
"020143005",410,542,952,378,534,375
"020122202",444,510,954,362,416,355
"020150407",400,427,827,308,365,292
"020142901",239,306,545,277,407,269
"020110101",472,560,1032,324,369,320
"020141703",348,472,820,338,439,329
"020151010",270,312,582,257,342,242
"020010322",359,311,670,205,197,188
"020150408",336,419,755,297,344,272
"020010323",424,413,837,267,280,260
"020121511",377,467,844,272,322,265
"020010303",314,345,659,200,174,162
"020122201",364,424,788,294,330,284
"020141204",290,477,767,344,460,343
"020132910",384,402,786,258,292,252
"020141211",285,321,606,274,355,269
"020150503",361,401,762,278,320,271
"020010205",174,133,307,95,82,81
"020141708",572,763,1335,623,818,611
"020010212",636,589,1225,366,341,320
"020150206",338,371,709,268,307,267
"020150504",274,308,582,235,283,225
"020142902",381,543,924,280,394,280
"020141701",373,436,809,352,454,338
"020141203",312,321,633,329,559,321
"020140703",397,418,815,289,400,283
"020141801",327,414,741,355,518,354
"020150203",405,423,828,292,335,279
"020122006",447,567,1014,407,524,402
"020151101",380,409,789,308,423,291
"020151004",383,416,799,337,432,330
"020141302",331,345,676,313,445,309
"020140706",316,411,727,301,377,289
"020141207",149,175,324,145,186,144
"020142907",371,467,838,379,617,367
"020020202",390,488,878,362,523,361
"020132909",276,295,571,208,227,208
"020150412",377,435,812,353,376,288
"020122001",405,446,851,317,401,313
"020122103",441,479,920,360,437,341
"020141503",280,399,679,350,488,343
"020010206",366,366,732,215,180,174
"020010304",226,202,428,132,133,118
"020122203",347,439,786,299,343,289
"020122003",485,541,1026,411,484,398
"020151009",345,421,766,297,352,286
"020142903",239,278,517,270,453,262
"020150505",356,419,775,301,362,294
"020141210",341,402,743,352,604,351
"020010319",536,481,1017,343,311,297
"020140707",309,352,661,240,341,226
"020140702",442,476,918,411,579,407
"020143008",717,915,1632,675,889,667
"020142906",357,469,826,448,678,441
"020150202",387,430,817,300,328,290
"020151008",316,404,720,324,358,278
"020151102",383,381,764,358,589,324
"020143006",201,275,476,233,317,229
"020141804",387,513,900,391,514,370
"020142905",185,289,474,280,494,276
"020010207",217,221,438,151,77,67
"020141504",331,483,814,379,510,373
"020010320",203,194,397,115,109,104
"020141208",145,187,332,188,281,186
"020122204",419,466,885,299,338,292
"020141805",437,559,996,466,716,463
"020143009",540,740,1280,579,807,571
"020122105",383,430,813,297,220,191
"020010305",688,595,1283,412,232,206
"020010321",150,150,300,109,108,97
"020141502",324,425,749,351,527,343
"020142908",261,348,609,267,375,266
"020150507",318,385,703,281,329,272
"020142904",323,427,750,358,527,352
"020010306",506,521,1027,341,252,245
"020143111",160,231,391,214,326,214
"020141209",313,358,671,327,394,318
"020141303",357,392,749,406,591,386
"020141508",831,1073,1904,886,1155,838
"020142909",317,407,724,336,456,335
"020150409",298,344,642,264,304,240
"020150908",1140,1184,2324,727,668,585
"020150411",380,391,771,296,331,279
"020122102",482,592,1074,476,529,409
"020140709",280,336,616,275,404,254
"020141803",468,613,1081,476,587,454
"020151011",285,371,656,253,316,246
"020143007",166,217,383,204,314,203
"020010208",266,220,486,145,135,132
"020150207",310,356,666,279,306,260
"020122106",420,449,869,326,377,319
"020143112",217,358,575,260,383,258
"020150506",360,419,779,282,331,276
"020142911",270,370,640,281,432,280
"020010211",308,303,611,200,172,169
"020141505",394,521,915,443,606,441
"020140701",422,457,879,375,478,352
"020010317",277,294,571,182,187,164
"020150201",344,412,756,280,330,271
"020151103",347,389,736,305,375,302
"020141501",302,402,704,319,415,284
"020150413",331,437,768,328,414,312
"020010318",411,372,783,231,175,172
"020010307",201,202,403,148,108,106
"020010213",234,242,476,162,122,119
"020141401",390,488,878,460,611,454
"020141802",305,436,741,314,411,300
"020141507",272,365,637,348,489,344
"020122110",299,365,664,258,340,258
"020141304",275,320,595,242,315,239
"020010210",145,182,327,88,59,56
"020142910",331,456,787,366,502,359
"020151104",392,429,821,308,337,285
"020150208",315,353,668,236,272,227
"020122002",587,699,1286,559,696,514
"020122205",575,632,1207,435,422,360
"020150410",297,346,643,257,301,226
"020141806",360,468,828,354,454,341
"020110104",399,447,846,316,371,312
"020141905",605,821,1426,652,829,631
"020021102",245,319,564,241,307,228
"020021103",701,942,1643,672,970,644
"020110103",325,395,720,247,286,239
"020150509",433,483,916,258,275,239
"020021106",238,289,527,305,499,302
"020010316",385,341,726,254,202,198
"020010209",259,252,511,156,99,97
"020141506",424,519,943,440,570,410
"020010314",249,222,471,147,133,130
"020010315",440,403,843,310,263,244
"020010214",331,357,688,261,168,165
"020010313",205,176,381,118,91,91
"020122101",479,573,1052,467,588,456
"020141402",271,325,596,290,435,287
"020140708",254,332,586,239,367,228
"020020201",267,320,587,252,333,229
"020141901",235,307,542,276,363,272
"020151012",363,419,782,338,396,310
"020150111",295,292,587,220,272,214
"020010218",239,241,480,148,126,122
"020021101",495,701,1196,621,900,600
"020122107",459,498,957,340,437,330
"020141305",332,391,723,301,432,299
"020141807",276,330,606,282,381,278
"020142803",283,393,676,288,369,284
"020010215",377,380,757,278,154,144
"020151105",320,381,701,245,320,226
"020122206",517,602,1119,448,555,433
"020110102",420,513,933,339,392,314
"020010217",347,365,712,227,162,150
"020010219",277,270,547,200,99,93
"020150209",268,313,581,212,268,206
"020010309",528,564,1092,380,372,339
"020150512",335,383,718,272,312,242
"020142003",398,559,957,470,635,453
"020141904",526,698,1224,628,901,615
"020141902",419,550,969,529,758,516
"020151109",494,598,1092,382,453,358
"020010308",374,423,797,257,286,233
"020141808",356,556,912,489,678,473
"020141403",328,398,726,358,541,355
"020150508",437,470,907,334,395,315
"020010216",570,558,1128,444,376,363
"020150902",228,267,495,209,248,204
"020142802",270,347,617,266,355,263
"020142804",287,406,693,314,395,306
"020141404",195,222,417,194,250,194
"020021104",600,793,1393,668,882,657
"020010312",269,292,561,181,170,159
"020122109",372,429,801,286,322,270
"020150110",441,498,939,340,396,332
"020010310",367,378,745,261,261,228
"020151013",457,602,1059,364,445,361
"020021202",334,484,818,402,568,387
"020020208",303,394,697,282,427,278
"020110105",272,315,587,221,268,216
"020020303",114,152,266,100,111,87
"020150414",446,451,897,318,324,261
"020150210",286,317,603,233,284,229
"020141301",319,378,697,267,299,249
"020142004",336,464,800,374,448,345
"020142801",269,361,630,299,361,280
"020141405",194,222,416,197,241,159
"020122209",420,500,920,365,447,356
"020151108",341,385,726,276,331,264
"020142002",550,756,1306,661,956,653
"020021003",202,239,441,209,326,206
"020141903",463,597,1060,546,757,528
"020142810",379,464,843,381,583,377
"020142805",259,296,555,228,300,228
"020020403",144,221,365,149,259,146
"020141408",408,534,942,462,607,454
"020010311",377,368,745,267,223,204
"020020204",232,308,540,205,240,185
"020150109",472,516,988,342,394,332
"020020206",207,265,472,197,289,190
"020142811",446,534,980,392,493,389
"020021203",391,552,943,457,595,414
"020150901",239,279,518,228,290,224
"020021105",133,176,309,169,231,152
"020021201",402,568,970,435,591,431
"020020401",356,467,823,313,472,307
"020141306",281,303,584,278,407,273
"020142806",390,546,936,413,552,405
"020142601",432,614,1046,526,731,518
"020141406",218,249,467,202,270,200
"020142809",253,326,579,263,383,258
"020020205",256,344,600,259,361,259
"020110106",384,418,802,278,322,270
"020141308",308,354,662,275,350,264
"020021004",351,434,785,344,491,341
"020150112",357,380,737,283,334,283
"020150513",364,378,742,289,364,276
"020142001",577,688,1265,604,734,566
"020142005",339,426,765,375,503,372
"020141409",445,537,982,483,712,476
"020021002",266,371,637,366,552,353
"020122108",367,436,803,319,397,294
"020141407",254,269,523,210,275,169
"020150108",330,386,716,276,315,265
"020020207",136,165,301,141,196,129
"020020408",465,532,997,427,715,424
"020142807",312,428,740,374,585,362
"020142602",322,406,728,357,467,351
"020021204",529,721,1250,704,1003,684
"020151106",384,414,798,266,288,232
"020021206",427,556,983,498,655,471
"020151111",540,624,1164,531,680,516
"020142812",233,345,578,270,429,267
"020150514",347,375,722,261,290,247
"020020302",327,418,745,411,735,398
"020022301",443,636,1079,435,629,429
"020110108",336,339,675,295,367,268
"020021001",437,538,975,519,736,515
"020142501",377,472,849,383,516,370
"020021005",371,441,812,426,672,421
"020150701",446,454,900,300,329,285
"020122207",503,618,1121,459,549,434
"020021009",285,326,611,299,407,277
"020020402",112,121,233,109,251,109
"020142808",200,325,525,302,475,298
"020142006",221,286,507,275,407,274
"020141410",298,386,684,349,463,340
"020142106",266,293,559,246,345,238
"020150510",318,343,661,224,248,204
"020151110",311,359,670,268,333,261
"020020409",365,447,812,333,529,314
"020142606",406,533,939,387,521,379
"020142603",183,228,411,184,255,183
"020151107",317,362,679,258,305,245
"020020407",273,344,617,235,445,226
"020141307",170,215,385,147,188,138
"020020301",362,533,895,399,610,397
"020021006",322,373,695,321,402,315
"020150107",327,372,699,290,343,289
"020141309",332,437,769,337,431,304
"020142007",133,187,320,168,220,163
"020021205",551,691,1242,615,828,567
"020022302",421,604,1025,512,797,509
"020142604",732,1000,1732,850,1032,784
"020021008",358,498,856,443,624,429
"020021302",386,504,890,418,573,409
"020020410",365,519,884,430,721,414
"020122210",457,507,964,370,404,355
"020142502",192,251,443,216,308,215
"020150511",366,383,749,274,305,247
"020142607",508,662,1170,532,781,525
"020022306",178,228,406,203,312,198
"020020902",227,454,681,218,317,215
"020142107",316,380,696,309,400,302
"020141411",352,481,833,411,529,402
"020142105",173,236,409,158,249,157
"020021007",366,502,868,483,713,474
"020110107",323,397,720,252,335,248
"020020501",350,360,710,256,405,256
"020141311",262,359,621,260,323,236
"020110202",450,523,973,361,404,321
"020020406",226,313,539,212,301,186
"020021303",409,564,973,516,718,494
"020142504",229,295,524,285,402,282
"020020404",210,289,499,195,321,193
"020022303",384,544,928,441,712,433
"020010401",656,816,1472,663,1244,588
"020020304",159,210,369,188,267,187
"020142703",248,339,587,284,447,283
"020142108",286,401,687,323,424,321
"020142503",336,445,781,353,515,349
"020142605",435,509,944,458,609,434
"020021301",526,670,1196,595,886,558
"020022305",283,367,650,295,441,293
"020150103",309,382,691,268,338,266
"020151113",442,481,923,364,450,354
"020022307",192,264,456,237,371,228
"020150106",366,374,740,257,279,255
"020110109",356,425,781,304,401,301
"020122208",465,517,982,365,386,332
"020151201",389,392,781,277,272,221
"020142505",200,266,466,239,298,235
"020142704",321,470,791,396,675,394
"020141310",326,409,735,294,364,271
"020020306",288,390,678,274,552,272
"020151202",365,400,765,283,345,278
"020020903",386,479,865,451,682,446
"020020405",317,385,702,284,459,281
"020010402",584,715,1299,616,938,513
"020021306",453,599,1052,382,563,378
"020020503",284,377,661,255,337,248
"020021304",502,610,1112,555,742,529
"020142701",537,693,1230,616,855,602
"020020901",306,459,765,399,592,372
"020022308",195,250,445,187,251,181
"020020305",331,383,714,293,501,288
"020142506",212,248,460,277,400,266
"020151112",399,466,865,376,457,372
"020022304",356,493,849,381,515,377
"020022203",192,247,439,205,305,203
"020150105",364,418,782,268,306,259
"020022402",348,439,787,377,529,371
"020142403",217,297,514,269,355,256
"020142103",136,196,332,145,220,142
"020141312",248,311,559,247,320,238
"020010404",658,887,1545,604,659,436
"020142507",332,389,721,373,498,371
"020020904",451,570,1021,461,617,455
"020142104",246,283,529,254,340,251
"020142702",471,654,1125,570,865,558
"020020502",394,493,887,319,432,276
"020022309",395,548,943,463,660,446
"020021305",597,774,1371,647,888,605
"020020504",233,311,544,226,413,224
"020020307",368,517,885,353,511,331
"020142509",279,396,675,405,543,390
"020110201",403,433,836,286,340,273
"020142203",212,282,494,233,309,233
"020110203",348,391,739,286,354,284
"020020803",397,503,900,457,713,451
"020022403",350,445,795,335,450,331
"020142109",283,285,568,266,340,261
"020150101",485,538,1023,417,527,409
"020150104",297,347,644,237,275,227
"020022204",397,562,959,483,694,475
"020142402",204,258,462,232,315,214
"020010601",444,504,948,326,509,324
"020150903",261,256,517,230,280,221
"020022202",233,301,534,281,378,279
"020122211",422,533,955,371,464,365
"020142102",301,380,681,303,369,265
"020142705",389,534,923,487,700,475
"020142508",314,401,715,355,453,349
"020110110",385,437,822,340,416,320
"020150702",326,379,705,244,246,213
"020142204",257,319,576,240,321,236
"020010403",522,667,1189,469,541,316
"020021307",516,695,1211,634,888,592
"020020905",431,597,1028,488,713,461
"020010405",500,569,1069,384,483,293
"020022201",298,401,699,368,555,364
"020142401",296,377,673,301,433,293
"020022406",395,573,968,468,621,459
"020020505",327,450,777,324,523,318
"020020507",358,470,828,329,471,320
"020020804",459,646,1105,478,676,474
"020150102",425,521,946,344,411,341
"020020308",267,339,606,234,346,229
"020020909",497,653,1150,550,781,519
"020022401",424,588,1012,450,610,444
"020020802",297,405,702,306,456,302
"020142101",412,538,950,399,567,391
"020022205",473,620,1093,528,744,522
"020110204",262,293,555,223,280,221
"020110112",301,375,676,266,350,266
"020021401",341,419,760,248,370,246
"020150905",375,385,760,249,296,230
"020142707",200,233,433,217,311,217
"020142404",169,225,394,210,271,199
"020010603",543,617,1160,426,684,408
"020151301",423,426,849,304,390,294
"020110205",513,553,1066,389,468,377
"020151205",409,518,927,333,403,331
"020142202",421,454,875,407,493,393
"020142301",283,316,599,281,362,266
"020151203",347,405,752,309,369,290
"020020906",369,531,900,441,678,437
"020010406",480,791,1271,486,516,363
"020022404",446,604,1050,464,641,451
"020022101",458,600,1058,462,658,445
"020022206",420,596,1016,557,918,556
"020020908",604,773,1377,649,898,636
"020142706",175,244,419,212,317,212
"020142405",356,451,807,436,589,422
"020142407",286,404,690,331,443,322
"020010408",469,659,1128,451,499,337
"020020805",409,498,907,413,653,397
"020020506",339,472,811,328,524,326
"020020508",304,396,700,328,523,322
"020151206",338,388,726,308,396,294
"020020808",363,485,848,357,493,350
"020021402",230,345,575,306,425,294
"020150703",316,331,647,230,254,226
"020022405",371,551,922,506,730,494
"020142110",248,297,545,252,329,245
"020020801",304,409,713,347,538,335
"020150704",459,483,942,216,239,192
"020142302",198,270,468,218,289,216
"020142205",449,477,926,423,510,402
"020010604",350,439,789,397,704,392
"020150606",243,273,516,183,188,171
"020010702",430,340,770,117,277,110
"020142408",232,295,527,267,372,264
"020020907",393,556,949,472,713,458
"020021501",266,335,601,266,365,264
"020142406",304,410,714,343,442,319
"020022102",393,566,959,442,605,431
"020022501",237,333,570,312,458,309
"020022103",352,423,775,369,473,358
"020150605",247,279,526,192,233,182
"020151302",330,412,742,257,347,252
"020150904",374,360,734,253,279,226
"020010407",635,758,1393,549,670,419
"020021403",141,214,355,175,261,174
"020021407",282,366,648,348,489,337
"020010602",291,350,641,210,423,210
"020010501",261,370,631,257,362,236
"020151204",310,383,693,324,415,308
"020142111",324,381,705,284,350,262
"020020601",186,246,432,175,238,167
"020020509",246,370,616,271,393,249
"020020806",514,733,1247,625,890,618
"020020701",591,828,1419,573,807,560
"020020807",613,882,1495,707,990,681
"020142206",482,576,1058,415,457,349
"020151502",353,406,759,235,257,226
"020021502",336,462,798,388,588,383
"020022502",272,375,647,349,492,344
"020021404",320,423,743,369,539,356
"020110111",390,505,895,402,494,396
"020010713",922,503,1425,64,249,64
"020151207",217,280,497,235,275,231
"020022504",294,463,757,427,632,425
"020010605",146,186,332,169,330,167
"020151304",293,393,686,262,343,255
"020142409",329,391,720,348,457,346
"020151208",344,397,741,373,458,331
"020150604",340,382,722,250,300,246
"020152012",314,424,738,342,452,320
"020150705",448,440,888,293,329,277
"020142201",371,486,857,368,485,365
"020021406",424,607,1031,532,734,522
"020150603",303,338,641,286,341,271
"020021408",272,423,695,380,566,373
"020021503",618,775,1393,630,931,625
"020142303",254,293,547,243,284,234
"020021505",230,325,555,267,416,264
"020142304",325,401,726,368,463,337
"020150601",310,368,678,291,354,289
"020110206",466,515,981,358,393,330
"020022104",436,610,1046,530,773,508
"020020702",470,603,1073,493,773,473
"020022503",293,450,743,177,239,177
"020152011",319,409,728,344,421,327
"020151501",326,370,696,293,363,290
"020150906",296,316,612,213,260,210
"020021405",496,628,1124,499,621,455
"020022505",411,519,930,469,619,453
"020021601",344,463,807,321,494,317
"020021504",285,343,628,310,457,309
"020022105",417,567,984,508,651,465
"020020602",580,766,1346,572,842,560
"020010504",497,703,1200,490,697,483
"020010503",362,566,928,405,640,385
"020010502",232,301,533,240,430,239
"020010609",462,584,1046,419,602,410
"020021602",306,406,712,308,433,288
"020010608",354,376,730,296,505,292
"020150602",300,381,681,285,348,266
"020010606",245,324,569,252,396,235
"020142207",343,417,760,322,367,298
"020110303",307,380,687,240,303,233
"020021409",682,793,1475,605,893,571
"020021506",273,332,605,286,441,284
"020110306",358,397,755,287,349,286
"020152009",233,258,491,225,265,218
"020110308",320,437,757,299,379,295
"020151305",188,238,426,212,243,209
"020021603",329,369,698,305,506,301
"020022106",373,553,926,481,668,455
"020022506",331,428,759,355,453,348
"020151209",235,285,520,245,309,244
"020151306",217,281,498,238,290,233
"020021604",227,307,534,284,678,278
"020021507",334,422,756,367,523,362
"020022001",422,537,959,457,595,441
"020151303",292,342,634,298,364,298
"020142305",469,554,1023,516,745,504
"020022507",356,412,768,386,528,373
"020142306",210,233,443,212,274,188
"020142307",329,365,694,341,382,292
"020142208",339,428,767,340,411,325
"020142210",291,381,672,336,430,312
"020020704",304,368,672,267,390,264
"020150907",362,368,730,270,332,245
"020110302",367,433,800,292,372,292
"020010703",142,119,261,126,293,124
"020151310",291,361,652,297,370,295
"020021410",418,588,1006,537,814,523
"020110307",376,413,789,283,319,263
"020020703",373,549,922,361,547,355
"020152008",276,383,659,268,308,242
"020021901",382,472,854,393,570,391
"020021508",309,399,708,339,487,329
"020151401",412,436,848,364,414,339
"020021607",327,443,770,359,453,337
"020152010",380,424,804,319,387,308
"020022002",358,464,822,449,651,445
"020010610",184,231,415,193,352,182
"020010607",220,278,498,227,387,224
"020151504",494,494,988,352,379,313
"020021801",398,493,891,458,658,441
"020020604",363,472,835,333,482,315
"020110211",400,437,837,328,402,322
"020010507",253,344,597,270,563,270
"020152103",293,338,631,293,343,264
"020021606",267,408,675,318,466,317
"020151505",413,436,849,297,360,286
"020010506",435,453,888,365,638,353
"020021605",350,472,822,386,572,358
"020021902",302,373,675,306,425,297
"020010505",275,362,637,242,387,237
"020021802",493,695,1188,548,868,518
"020021608",187,238,425,196,394,196
"020020603",295,343,638,226,316,220
"020150607",297,359,656,255,299,238
"020022003",278,473,751,372,512,370
"020110207",404,437,841,312,388,303
"020151402",415,484,899,386,473,385
"020151309",487,565,1052,462,568,458
"020020705",232,292,524,244,445,241
"020022006",287,350,637,356,426,323
"020110304",280,339,619,210,269,208
"020020706",257,333,590,271,560,271
"020151503",461,583,1044,401,434,394
"020142308",514,581,1095,482,551,436
"020021803",322,465,787,397,731,391
"020152104",302,424,726,343,402,323
"020021903",307,410,717,305,400,303
"020151307",317,369,686,292,340,282
"020110301",328,365,693,264,337,262
"020142309",448,506,954,492,620,423
"020022508",586,636,1222,523,743,505
"020021906",327,418,745,424,572,418
"020150706",508,523,1031,321,327,281
"020010701",326,343,669,264,618,260
"020022509",340,435,775,411,677,405
"020021701",542,675,1217,571,867,564
"020152005",275,320,595,274,350,267
"020021905",334,456,790,361,523,352
"020010804",249,343,592,295,703,292
"020110309",340,394,734,298,359,294
"020022005",220,284,504,251,302,243
"020110907",318,470,788,312,383,302
"020021702",371,467,838,382,564,366
"020150802",352,368,720,237,249,205
"020010803",520,584,1104,448,812,438
"020150801",473,501,974,336,336,259
"020011314",1008,952,1960,659,855,561
"020152007",328,401,729,289,341,279
"020151408",387,454,841,326,391,303
"020110908",370,496,866,331,354,307
"020111001",324,400,724,315,371,293
"020021805",234,315,549,250,334,243
"020021703",396,535,931,454,764,445
"020010802",599,725,1324,567,907,562
"020151403",324,398,722,302,375,276
"020151308",186,253,439,194,247,189
"020152113",405,490,895,389,496,382
"020142209",613,762,1375,500,744,495
"020010801",148,204,352,188,363,187
"020021704",136,203,339,168,393,162
"020111002",434,522,956,384,473,368
"020020606",299,381,680,320,603,313
"020020605",223,265,488,183,285,178
"020020707",412,521,933,409,692,400
"020110208",417,466,883,302,337,292
"020020708",174,261,435,172,311,154
"020110404",407,541,948,296,377,289
"020021904",436,561,997,499,690,487
"020152102",379,443,822,374,453,361
"020022004",389,452,841,386,526,369
"020022007",250,319,569,247,378,243
"020152004",283,352,635,278,334,262
"020110906",264,315,579,248,337,244
"020111006",445,537,982,458,570,453
"020142310",350,400,750,378,540,372
"020150804",433,509,942,330,370,306
"020021804",501,684,1185,267,445,262
"020152112",235,275,510,217,276,215
"020152006",317,396,713,321,388,307
"020142311",386,504,890,462,655,451
"020111008",322,426,748,318,403,313
"020151409",425,437,862,347,380,321
"020110305",247,318,565,233,311,227
"020022510",275,330,605,299,435,297
"020021806",314,430,744,367,516,358
"020010704",265,295,560,278,595,268
"020021907",310,372,682,324,451,313
"020010706",148,152,300,80,398,80
"020010705",200,203,403,147,455,147
"020022511",474,563,1037,501,657,431
"020010707",264,328,592,249,639,243
"020111003",314,401,715,317,406,314
"020010708",281,316,597,240,467,236
"020151405",422,530,952,421,506,413
"020151404",326,388,714,308,379,305
"020152001",408,450,858,347,417,340
"020010805",266,323,589,214,456,214
"020022008",304,367,671,301,405,284
"020111005",423,519,942,386,494,383
"020151506",415,466,881,311,329,277
"020152105",213,259,472,201,232,196
"020111007",454,528,982,401,417,331
"020110905",334,403,737,308,368,291
"020152003",336,455,791,346,460,336
"020152111",339,358,697,335,438,324
"020110310",356,417,773,317,368,296
"020010806",512,632,1144,572,1022,564
"020110210",470,552,1022,348,430,342
"020021908",357,474,831,377,514,366
"020010807",543,791,1334,561,952,546
"020111010",344,369,713,281,324,247
"020020607",179,213,392,175,333,174
"020021707",473,648,1121,577,939,520
"020020608",242,327,569,219,329,219
"020021705",233,299,532,290,592,275
"020020709",220,310,530,278,429,276
"020021706",442,544,986,452,690,441
"020152101",342,380,722,320,383,316
"020050106",185,313,498,209,305,205
"020050104",307,376,683,314,396,307
"020050105",483,620,1103,472,645,448
"020151407",406,477,883,392,486,388
"020021807",228,367,595,277,361,263
"020050103",366,409,775,361,447,325
"020050201",371,504,875,336,432,320
"020152106",490,555,1045,418,494,402
"020050102",388,491,879,411,475,370
"020110911",256,330,586,258,332,245
"020151803",300,414,714,310,420,301
"020050203",334,389,723,325,409,297
"020152002",351,454,805,366,535,361
"020010712",268,239,507,175,400,173
"020050204",422,519,941,461,565,427
"020152110",269,344,613,278,387,274
"020021808",373,539,912,335,548,328
"020010711",110,103,213,140,362,135
"020050205",215,353,568,222,286,220
"020110904",312,347,659,255,305,250
"020110909",228,301,529,246,300,244
"020030101",453,573,1026,488,667,474
"020010710",179,205,384,232,852,229
"020050107",283,342,625,302,376,302
"020150808",434,497,931,323,361,317
"020010709",147,183,330,183,570,183
"020150803",451,557,1008,373,444,364
"020030102",410,493,903,419,535,409
"020111004",423,533,956,364,427,327
"020030103",395,565,960,467,621,443
"020030201",332,410,742,323,444,320
"020030202",320,394,714,333,438,331
"020030301",485,616,1101,476,657,452
"020151507",405,453,858,361,434,351
"020010810",215,230,445,186,392,181
"020151903",305,380,685,310,375,284
"020050101",228,325,553,253,319,250
"020110903",471,537,1008,379,481,371
"020150708",466,514,980,328,325,294
"020111009",376,381,757,319,401,313
"020110405",360,417,777,308,375,302
"020010809",270,421,691,257,477,257
"020151410",314,370,684,272,345,266
"020110912",286,372,658,297,387,294
"020151406",223,299,522,286,342,276
"020010808",194,252,446,189,345,188
"020152109",390,473,863,392,508,379
"020030302",398,462,860,373,528,367
"020151801",254,316,570,257,330,257
"020020610",235,280,515,228,513,226
"020020609",223,278,501,276,527,269
"020011301",364,222,586,163,402,162
"020110403",308,431,739,221,276,218
"020110910",303,368,671,352,400,326
"020021708",380,533,913,489,724,470
"020151411",486,539,1025,376,383,342
"020050109",308,383,691,349,428,344
"020050202",288,328,616,270,333,262
"020150707",480,544,1024,351,405,340
"020010913",307,283,590,201,449,191
"020151902",351,443,794,335,440,327
"020110311",325,415,740,254,316,252
"020030303",271,343,614,260,348,244
"020021709",315,426,741,366,560,356
"020010911",242,180,422,116,380,116
"020151508",340,326,666,260,340,254
"020010910",185,184,369,108,360,106
"020151904",348,409,757,343,429,338
"020110209",312,353,665,238,283,233
"020050206",287,323,610,258,300,225
"020150810",393,495,888,382,467,375
"020010909",347,281,628,237,848,224
"020152107",183,228,411,175,217,171
"020050108",347,395,742,323,373,316
"020030401",317,419,736,354,449,308
"020010908",132,129,261,149,405,145
"020010907",282,306,588,288,864,280
"020150709",388,413,801,283,313,262
"020151701",330,402,732,323,365,312
"020010904",119,137,256,134,567,133
"020010903",251,198,449,195,713,189
"020151510",416,518,934,413,473,393
"020050211",375,466,841,394,486,383
"020151802",241,259,500,213,232,201
"020151804",210,257,467,209,235,206
"020050501",336,448,784,348,414,335
"020030104",220,270,490,248,345,241
"020111104",141,153,294,102,119,93
"020050209",399,438,837,339,401,324
"020050504",322,405,727,288,385,287
"020010901",125,167,292,161,410,161
"020011302",60,68,128,60,183,59
"020011001",132,186,318,120,523,118
"020030403",293,388,681,279,416,273
"020030204",341,393,734,288,361,283
"020011002",220,284,504,278,568,273
"020030203",296,380,676,336,426,316
"020151905",376,465,841,383,492,377
"020011003",448,532,980,515,838,506
"020111101",376,451,827,293,295,260
"020111103",471,482,953,325,332,307
"020030501",380,422,802,373,583,369
"020011004",171,256,427,223,422,222
"020150807",462,534,996,357,447,348
"020111301",291,418,709,346,429,343
"020030306",363,460,823,302,388,293
"020030507",332,436,768,368,608,350
"020050210",326,349,675,301,359,291
"020050506",317,399,716,315,392,313
"020030506",198,243,441,215,377,203
"020151911",364,442,806,383,488,380
"020050110",283,390,673,312,381,300
"020030505",256,354,610,330,524,324
"020050207",250,322,572,246,298,240
"020151901",212,253,465,230,290,229
"020151602",406,442,848,327,353,279
"020111203",484,525,1009,360,424,343
"020030305",275,304,579,245,354,234
"020050507",386,504,890,422,506,419
"020152108",241,333,574,261,320,256
"020010912",196,182,378,76,234,74
"020030304",230,286,516,213,273,205
"020111201",261,319,580,233,279,229
"020150710",480,504,984,379,447,371
"020151702",249,335,584,271,316,250
"020030402",224,275,499,216,269,208
"020050401",428,602,1030,420,494,409
"020030106",358,357,715,262,371,252
"020151805",218,272,490,215,278,208
"020151808",236,333,569,218,259,217
"020111202",259,328,587,236,263,217
"020110902",378,429,807,312,355,293
"020151906",329,436,765,338,408,334
"020010906",168,186,354,175,556,173
"020111303",297,420,717,321,409,311
"020110901",401,472,873,315,364,307
"020030105",403,506,909,374,493,361
"020010905",205,204,409,192,455,187
"020050402",317,409,726,347,457,342
"020050502",608,745,1353,592,716,563
"020111302",360,459,819,387,454,381
"020030205",399,473,872,369,472,336
"020110804",285,439,724,329,402,327
"020151603",483,582,1065,388,454,361
"020050403",318,385,703,319,368,283
"020150809",466,559,1025,433,482,390
"020150712",475,496,971,348,361,309
"020151910",423,541,964,412,450,380
"020050503",323,420,743,370,439,350
"020110312",371,404,775,282,326,280
"020150805",341,408,749,285,324,271
"020010902",169,219,388,193,742,189
"020151703",381,473,854,368,439,362
"020030307",355,447,802,308,390,300
"020050404",317,382,699,341,371,275
"020111102",425,463,888,309,361,302
"020011008",140,139,279,153,716,152
"020151806",257,260,517,210,253,209
"020110803",238,281,519,210,259,209
"020151807",354,417,771,316,326,276
"020011007",149,163,312,159,442,126
"020030308",319,407,726,263,358,260
"020011006",256,285,541,265,605,265
"020010914",128,125,253,148,435,121
"020011005",237,270,507,236,455,233
"020110406",294,350,644,241,296,235
"020011303",27,18,45,20,472,20
"020151809",200,292,492,222,267,222
"020030309",136,149,285,159,190,154
"020050208",523,544,1067,433,613,431
"020050505",257,336,593,244,307,240
"020112101",342,452,794,323,376,316
"020030504",232,310,542,262,374,248
"020030206",397,530,927,367,455,349
"020030404",359,413,772,326,404,286
"020151907",297,446,743,374,468,370
"020030503",432,538,970,469,672,449
"020030502",281,367,648,291,418,283
"020111305",378,514,892,393,449,385
"020050508",322,388,710,324,427,322
"020110409",379,449,828,309,428,307
"020030107",430,417,847,347,371,328
"020151909",294,367,661,286,370,283
"020111105",450,502,952,335,373,323
"020010915",124,114,238,118,607,100
"020050301",348,409,757,320,398,313
"020150806",324,396,720,260,324,243
"020050409",341,437,778,337,439,330
"020110802",434,462,896,338,405,329
"020010916",513,484,997,337,636,276
"020150711",406,485,891,329,382,315
"020111109",397,509,906,296,313,238
"020151509",482,555,1037,430,531,408
"020111204",282,340,622,272,336,269
"020050408",492,602,1094,516,597,495
"020110402",364,422,786,297,374,256
"020110401",394,435,829,284,331,276
"020151704",455,551,1006,409,443,367
"020030207",456,565,1021,420,550,394
"020050302",559,586,1145,507,671,479
"020110502",426,441,867,316,372,304
"020050407",242,311,553,253,322,250
"020050601",330,410,740,304,361,301
"020151707",323,415,738,333,411,330
"020050602",452,539,991,437,507,405
"020151810",263,319,582,240,278,237
"020112103",432,565,997,423,469,405
"020111304",335,428,763,345,447,344
"020151812",256,304,560,244,317,232
"020050603",369,508,877,438,553,435
"020050406",477,550,1027,504,658,501
"020110413",366,429,795,327,398,306
"020151908",268,331,599,294,388,291
"020050604",677,804,1481,660,824,647
"020011009",170,171,341,161,659,160
"020030109",247,283,530,227,291,217
"020030310",470,480,950,393,338,263
"020011010",304,376,680,296,617,287
"020050405",327,396,723,331,408,330
"020112104",333,423,756,318,373,311
"020111306",384,571,955,373,433,352
"020011011",269,343,612,351,725,345
"020112002",392,464,856,317,394,312
"020050605",494,640,1134,558,692,542
"020030405",327,356,683,288,407,266
"020030603",288,329,617,312,503,293
"020151708",260,334,594,270,333,269
"020050702",227,311,538,222,237,208
"020030602",169,182,351,175,224,141
"020030406",303,352,655,308,424,295
"020030601",310,406,716,354,624,351
"020151607",398,450,848,316,369,297
"020060701",264,329,593,280,332,280
"020151601",404,459,863,355,382,311
"020010919",55,64,119,61,405,58
"020111206",424,457,881,320,369,313
"020110412",414,469,883,352,437,342
"020050701",531,675,1206,529,657,514
"020151604",336,409,745,293,362,284
"020030108",247,244,491,188,241,169
"020110501",347,357,704,242,297,239
"020110801",391,495,886,347,434,336
"020110805",296,362,658,265,331,261
"020060703",438,516,954,278,335,277
"020050801",525,646,1171,547,656,545
"020151811",291,366,657,294,338,290
"020151813",242,304,546,254,304,250
"020010918",209,186,395,169,725,161
"020112102",364,401,765,271,306,258
"020151711",384,438,822,356,418,339
"020010917",170,190,360,207,516,206
"020111106",472,545,1017,396,417,356
"020050802",307,396,703,320,436,317
"020050303",176,193,369,177,156,138
"020151608",384,455,839,354,456,348
"020112105",410,512,922,391,475,383
"020111108",385,482,867,315,372,301
"020030210",174,253,427,193,234,168
"020110410",309,382,691,281,342,275
"020110408",339,361,700,282,346,278
"020110407",359,368,727,279,337,275
"020050803",524,656,1180,504,634,493
"020151705",406,473,879,349,436,349
"020151706",295,416,711,308,356,295
"020030209",378,458,836,311,393,275
"020011014",109,109,218,111,537,110
"020111308",327,385,712,281,344,276
"020151709",306,372,678,266,310,262
"020050703",274,366,640,276,343,269
"020050901",475,607,1082,472,568,451
"020011013",300,378,678,339,795,334
"020112106",450,519,969,385,426,351
"020030208",391,475,866,354,595,338
"020011012",271,313,584,291,605,275
"020050902",255,346,601,287,366,275
"020030604",274,336,610,320,445,297
"020151712",332,398,730,302,352,284
"020011211",294,234,528,136,370,132
"020030311",345,524,869,305,405,305
"020030605",376,490,866,329,474,303
"020030607",300,383,683,312,435,304
"020030606",226,296,522,255,413,250
"020030407",315,359,674,270,422,264
"020030408",353,371,724,271,371,234
"020050306",300,369,669,303,365,297
"020110809",349,474,823,365,456,359
"020151606",353,441,794,308,379,302
"020060702",359,444,803,343,430,335
"020050608",424,498,922,385,491,376
"020050305",344,383,727,336,399,318
"020112107",323,388,711,270,325,260
"020151605",279,363,642,276,336,256
"020050606",428,479,907,407,473,364
"020111205",307,348,655,245,289,230
"020011210",162,134,296,101,627,97
"020111307",344,469,813,299,355,296
"020112001",395,500,895,356,403,344
"020060103",400,488,888,347,428,337
"020060104",316,382,698,274,331,267
"020011212",255,244,499,90,466,89
"020110503",472,505,977,353,380,314
"020060706",323,359,682,260,326,256
"020050304",242,340,582,235,292,227
"020110808",455,518,973,355,407,349
"020050704",602,762,1364,605,736,591
"020030110",211,227,438,192,195,174
"020030111",226,236,462,230,287,222
"020011209",650,706,1356,342,885,327
"020110707",370,426,796,273,331,267
"020151610",385,420,805,337,435,327
"020050705",556,739,1295,618,822,598
"020011203",374,349,723,314,739,310
"020111207",301,363,664,259,289,250
"020030211",297,305,602,257,306,253
"020151710",382,530,912,342,423,319
"020110806",470,522,992,379,433,363
"020151609",323,412,735,306,394,303
"020011202",101,128,229,129,445,129
"020050904",216,310,526,232,297,231
"020011201",184,157,341,116,361,114
"020111107",401,477,878,305,345,296
"020110411",414,517,931,313,406,309
"020030212",384,461,845,365,423,298
"020011104",323,344,667,336,982,306
"020050706",268,359,627,300,360,291
"020112108",344,368,712,256,313,249
"020112003",549,587,1136,389,408,359
"020011103",187,167,354,198,320,195
"020050903",259,316,575,268,341,265
"020011102",203,225,428,284,655,258
"020050805",192,209,401,175,220,172
"020060102",384,440,824,345,386,305
"020011101",239,273,512,219,379,202
"020060105",499,625,1124,431,549,422
"020030801",294,353,647,321,482,314
"020050607",418,476,894,418,535,394
"020111208",352,404,756,272,302,264
"020030704",412,502,914,369,658,356
"020030703",450,517,967,453,622,432
"020030702",388,476,864,415,616,384
"020030803",384,455,839,341,445,329
"020030701",138,172,310,136,177,133
"020050804",418,572,990,454,549,446
"020050307",234,329,563,297,414,293
"020030805",237,259,496,216,349,197
"020030804",242,296,538,217,369,210
"020050308",165,192,357,163,221,162
"020050905",268,308,576,260,335,257
"020112111",416,525,941,374,427,365
"020110807",478,514,992,345,398,330
"020151611",335,428,763,307,359,305
"020030901",375,485,860,388,486,380
"020030902",221,265,486,206,272,199
"020111901",266,302,568,221,259,210
"020110601",292,406,698,317,337,285
"020050906",266,306,572,245,311,240
"020060505",436,503,939,392,471,375
"020011306",103,89,192,100,260,95
"020030903",341,421,762,342,435,329
"020011304",449,276,725,136,640,136
"020111402",384,435,819,332,414,329
"020060106",439,499,938,348,427,340
"020110505",393,461,854,339,424,333
"020030904",482,544,1026,414,468,375
"020060107",316,376,692,260,301,244
"020050907",215,270,485,220,307,218
"020111309",464,530,994,371,460,361
"020011204",168,225,393,209,339,166
"020030905",284,310,594,222,270,206
"020011205",264,336,600,275,504,257
"020112004",406,487,893,303,338,281
"020050310",240,295,535,241,284,225
"020110708",342,349,691,249,303,240
"020060307",396,480,876,370,439,360
"020030802",245,307,552,212,290,206
"020111902",396,475,871,322,396,316
"020011105",254,275,529,251,480,210
"020060704",390,479,869,372,419,359
"020051102",417,477,894,389,463,377
"020051101",511,633,1144,536,679,514
"020050707",417,477,894,196,260,196
"020011106",199,248,447,209,520,206
"020011107",253,272,525,296,497,282
"020050309",285,325,610,309,401,303
"020110706",369,422,791,291,332,287
"020060503",344,430,774,372,476,366
"020050806",364,532,896,394,472,385
"020112109",246,291,537,218,268,218
"020050807",362,493,855,399,495,393
"020060302",393,481,874,303,386,297
"020030705",271,308,579,268,495,264
"020111310",300,356,656,250,292,248
"020060101",322,355,677,242,253,202
"020060108",379,492,871,310,368,307
"020111210",273,331,604,261,312,256
"020110506",424,452,876,319,381,312
"020030706",263,321,584,283,466,279
"020060308",313,419,732,305,367,297
"020030707",416,506,922,504,668,468
"020110603",366,453,819,347,457,344
"020110504",268,356,624,252,306,249
"020030908",365,375,740,312,299,210
"020110602",461,506,967,351,443,350
"020060504",308,329,637,293,348,291
"020110709",382,426,808,296,349,295
"020030708",162,233,395,159,202,159
"020111209",259,337,596,240,299,228
"020030709",397,534,931,404,664,390
"020060502",446,569,1015,453,689,449
"020030806",215,263,478,203,264,197
"020030807",194,233,427,166,226,165
"020030808",246,278,524,207,280,197
"020112009",376,444,820,260,299,256
"020060309",530,612,1142,451,510,426
"020030809",333,385,718,304,377,295
"020011206",220,252,472,202,502,184
"020030907",393,383,776,292,268,214
"020030810",252,295,547,256,272,214
"020030906",238,259,497,196,266,193
"020111403",490,518,1008,365,413,360
"020112005",416,447,863,328,378,314
"020050909",439,485,924,438,524,424
"020112110",400,429,829,292,336,278
"020011111",111,155,266,126,180,115
"020060705",356,428,784,359,442,357
"020051103",324,370,694,281,323,272
"020050908",416,525,941,454,549,453
"020011110",308,313,621,272,449,267
"020060306",399,481,880,356,433,347
"020111903",308,402,710,279,338,278
"020050311",399,440,839,386,507,383
"020060310",407,457,864,393,475,383
"020011109",209,246,455,219,431,193
"020111401",451,521,972,364,421,358
"020011108",382,435,817,353,608,348
"020060109",353,362,715,227,229,199
"020031104",556,657,1213,386,628,360
"020011402",627,469,1096,226,378,210
"020050708",393,516,909,394,473,370
"020110705",433,532,965,349,413,345
"020050809",326,441,767,333,400,326
"020050808",375,459,834,353,448,348
"020050910",361,445,806,341,390,333
"020110507",360,394,754,280,340,273
"020111507",287,385,672,281,367,280
"020031103",399,499,898,384,454,338
"020111311",394,452,846,336,399,327
"020060501",300,441,741,383,475,375
"020060507",324,425,749,334,403,303
"020031102",420,514,934,454,567,432
"020060506",327,362,689,304,379,300
"020031101",355,454,809,367,456,345
"020112010",364,406,770,292,332,285
"020031004",331,402,733,298,416,278
"020111405",420,550,970,328,403,313
"020111904",441,581,1022,339,400,327
"020112008",240,262,502,191,234,189
"020031003",449,503,952,257,313,231
"020110508",413,449,862,307,348,298
"020110604",457,459,916,333,392,326
"020031002",379,441,820,323,435,320
"020031001",341,445,786,377,518,376
"020011208",162,167,329,129,269,129
"020112201",402,502,904,345,378,299
"020060301",427,535,962,367,445,348
"020011207",381,405,786,347,542,342
"020011112",414,519,933,407,533,375
"020111506",444,443,887,313,329,302
"020110704",433,503,936,325,371,316
"020100607",394,437,831,284,349,282
"020011113",324,342,666,291,433,284
"020110710",372,445,817,292,356,282
"020051006",365,426,791,314,350,305
"020060303",445,464,909,349,447,315
"020060508",212,254,466,205,279,203
"020011114",322,452,774,289,503,286
"020111508",403,440,843,372,421,348
"020031105",315,389,704,316,452,314
"020060111",309,366,675,253,316,245
"020060305",346,374,720,260,309,256
"020031106",424,492,916,415,533,396
"020060511",407,529,936,416,485,403
"020060512",156,213,369,159,180,158
"020051003",187,229,416,164,189,154
"020051004",255,302,557,254,290,242
"020060707",515,636,1151,399,491,390
"020060710",352,426,778,326,392,312
"020051002",477,605,1082,548,694,530
"020011401",325,297,622,247,530,193
"020051005",330,419,749,269,359,264
"020051001",508,652,1160,538,636,521
"020051107",460,599,1059,470,560,453
"020060711",296,317,613,293,311,259
"020031107",337,506,843,437,584,426
"020060712",296,356,652,286,332,260
"020051104",296,386,682,331,442,317
"020051106",349,398,747,315,428,310
"020051105",358,406,764,321,437,296
"020111510",409,508,917,331,360,324
"020031108",254,330,584,284,369,265
"020060404",344,429,773,319,417,312
"020112011",303,395,698,252,301,246
"020011502",322,340,662,249,498,242
"020110509",381,461,842,292,324,279
"020031005",192,277,469,202,300,199
"020011501",345,352,697,170,420,165
"020111509",381,435,816,337,418,330
"020031006",445,531,976,390,509,371
"020060510",463,515,978,407,495,383
"020112007",295,358,653,232,259,225
"020011305",140,155,295,154,302,150
"020031007",324,418,742,340,415,329
"020031008",300,358,658,274,330,270
"020011601",274,264,538,189,339,186
"020060110",272,348,620,145,178,142
"020112209",358,405,763,269,318,259
"020110703",373,413,786,297,371,293
"020111905",353,438,791,306,336,286
"020060304",281,354,635,243,293,243
"020030910",360,427,787,326,376,291
"020011603",466,479,945,413,673,404
"020060709",354,415,769,320,405,317
"020111505",379,415,794,329,384,319
"020111406",476,569,1045,409,487,396
"020060509",255,314,569,237,300,236
"020111604",303,364,667,252,316,246
"020030909",368,435,803,371,459,355
"020011607",489,585,1074,475,685,447
"020112202",488,489,977,358,401,348
"020100604",400,468,868,319,386,312
"020112006",336,375,711,267,291,235
"020060403",391,440,831,339,394,328
"020011609",176,206,382,160,203,156
"020051007",566,659,1225,548,654,538
"020100101",301,340,641,250,300,246
"020031206",149,120,269,66,85,49
"020051008",279,381,660,309,392,297
"020031205",411,560,971,491,674,473
"020051009",323,462,785,344,426,316
"020060406",365,409,774,322,400,308
"020111504",468,504,972,356,413,346
"020051010",245,295,540,256,329,252
"020031204",253,238,491,249,287,227
"020011604",287,286,573,348,608,331
"020110702",424,460,884,328,377,318
"020051207",437,460,897,336,384,324
"020031203",221,357,578,310,368,264
"020060405",343,388,731,288,341,285
"020100606",419,432,851,298,351,283
"020031202",380,524,904,428,545,396
"020110605",331,401,732,304,417,297
"020111404",334,365,699,279,335,275
"020110711",367,440,807,323,415,318
"020031201",294,385,679,350,513,350
"020111906",443,478,921,341,390,325
"020060713",212,279,491,236,289,231
"020031509",102,173,275,116,150,113
"020051108",369,422,791,321,420,316
"020060708",331,409,740,307,348,285
"020031506",371,434,805,362,486,352
"020011307",262,243,505,241,561,236
"020031505",364,391,755,382,506,370
"020060603",489,618,1107,509,629,502
"020110510",355,456,811,334,412,329
"020031504",361,427,788,334,473,322
"020011602",164,162,326,164,291,163
"020060203",275,316,591,243,280,232
"020111511",519,538,1057,434,429,384
"020011605",202,275,477,208,291,200
"020111605",355,414,769,288,333,278
"020111503",469,556,1025,368,416,352
"020060801",399,433,832,355,443,352
"020031501",314,369,683,282,386,268
"020011606",263,296,559,228,240,194
"020051109",461,565,1026,459,569,451
"020060402",308,350,658,227,272,223
"020031604",217,247,464,178,250,174
"020011608",252,294,546,220,297,215
"020110701",1944,274,2218,171,187,154
"020060602",831,1005,1836,792,939,781
"020031603",406,475,881,388,416,338
"020111603",319,359,678,267,331,257
"020031602",525,596,1121,504,608,486
"020031601",383,508,891,375,468,366
"020112203",485,511,996,360,419,348
"020060112",273,349,622,292,325,248
"020060809",232,279,511,266,313,253
"020031207",425,503,928,466,603,431
"020110606",378,477,855,306,348,298
"020051501",500,604,1104,521,595,488
"020051206",680,895,1575,769,907,727
"020031208",226,320,546,291,379,285
"020060401",257,297,554,208,245,199
"020051502",449,650,1099,530,631,507
"020031209",231,247,478,214,280,205
"020051201",300,306,606,293,323,250
"020051503",264,322,586,267,284,238
"020031210",377,468,845,363,390,298
"020111607",371,467,838,350,425,344
"020060802",476,547,1023,457,542,447
"020111407",735,914,1649,696,797,680
"020051404",399,532,931,421,506,415
"020060601",508,610,1118,546,672,537
"020112208",414,451,865,269,344,264
"020051403",494,659,1153,540,696,532
"020031508",555,726,1281,617,843,587
"020100608",388,478,866,339,392,334
"020011503",176,242,418,200,435,199
"020112210",369,408,777,307,394,298
"020031507",565,683,1248,600,760,586
"020011308",153,155,308,156,347,155
"020111602",400,489,889,359,486,352
"020112204",324,370,694,265,327,259
"020011702",328,329,657,303,467,281
"020060202",437,462,899,334,377,326
"020060808",565,768,1333,509,517,391
"020011701",457,431,888,389,543,356
"020031503",304,362,666,271,333,269
"020051402",274,398,672,347,484,342
"020051110",371,484,855,354,394,347
"020051205",165,270,435,198,277,187
"020110607",411,484,895,308,333,286
"020031502",407,502,909,399,485,367
"020100605",411,465,876,353,394,339
"020060408",391,492,883,370,479,354
"020011612",162,202,364,139,203,132
"020031605",348,316,664,267,293,235
"020051505",388,534,922,454,547,450
"020100102",384,499,883,353,404,323
"020031606",380,361,741,275,347,262
"020011611",207,257,464,217,299,213
"020060810",297,380,677,334,409,325
"020060205",299,335,634,226,258,220
"020011610",252,339,591,291,438,281
"020060803",290,350,640,260,291,234
"020031307",267,355,622,251,319,248
"020100201",434,496,930,353,402,320
"020011403",185,198,383,196,345,175
"020051504",537,649,1186,568,647,548
"020011310",312,302,614,235,641,229
"020111601",423,474,897,319,374,310
"020111501",477,513,990,349,437,342
"020031306",326,409,735,323,438,313
"020031607",383,404,787,312,367,306
"020060407",333,340,673,242,304,234
"020011404",28,42,70,39,148,37
"020031305",275,358,633,329,433,321
"020051401",289,370,659,274,323,268
"020111907",444,472,916,319,361,305
"020051204",331,404,735,328,407,307
"020011405",253,231,484,226,289,193
"020100603",480,591,1071,388,429,372
"020031304",249,267,516,208,252,206
"020011504",366,393,759,335,684,319
"020031303",370,447,817,393,466,369
"020110712",410,444,854,306,323,291
"020060604",208,274,482,226,301,225
"020031302",348,423,771,356,410,327
"020060606",360,426,786,333,437,329
"020111606",391,419,810,335,387,308
"020112205",421,472,893,310,377,301
"020060204",309,358,667,247,283,244
"020011309",211,215,426,157,251,154
"020031405",387,457,844,365,428,361
"020011703",329,391,720,324,422,294
"020100609",442,523,965,357,459,354
"020031404",371,431,802,299,400,286
"020112211",334,367,701,248,283,236
"020011704",252,334,586,287,377,280
"020051405",691,901,1592,787,886,697
"020051303",329,430,759,365,444,348
"020060605",293,384,677,201,257,199
"020051203",414,535,949,426,524,405
"020060804",271,355,626,300,351,288
"020031403",484,568,1052,454,575,446
"020011706",355,404,759,367,455,350
"020100103",454,473,927,341,397,334
"020111608",458,558,1016,393,458,378
"020031402",439,509,948,418,508,385
"020060409",433,647,1080,322,379,313
"020051506",393,470,863,330,341,275
"020011707",294,321,615,323,477,318
"020031401",424,456,880,346,411,335
"020011313",226,132,358,104,262,102
"020011803",314,328,642,292,352,278
"020031608",368,406,774,339,396,322
"020060807",296,368,664,319,375,304
"020051406",531,698,1229,538,648,512
"020111502",453,461,914,324,371,321
"020011407",232,244,476,215,363,208
"020011802",318,417,735,357,487,348
"020060201",527,554,1081,387,449,373
"020011801",406,436,842,442,495,349
"020110610",372,427,799,271,317,261
"020031308",230,268,498,241,334,238
"020031309",303,420,723,369,472,345
"020051302",327,383,710,321,430,319
"020051202",786,1035,1821,840,1038,823
"020051407",196,258,454,168,203,165
"020011406",344,354,698,293,423,289
"020060806",597,723,1320,533,607,500
"020060910",326,409,735,324,391,319
"020111908",390,447,837,301,359,293
"020031310",345,348,693,315,204,162
"020111702",388,427,815,286,329,279
"020031311",411,485,896,267,385,260
"020111609",295,351,646,256,358,252
"020111806",647,701,1348,521,704,506
"020070403",450,562,1012,450,549,401
"020051507",321,402,723,313,359,285
"020011505",232,232,464,187,220,155
"020100705",380,463,843,366,444,357
"020031301",352,392,744,305,366,298
"020031406",513,601,1114,514,633,505
"020110608",336,404,740,284,349,278
"020100602",328,354,682,247,299,236
"020051304",320,411,731,330,364,276
"020031407",288,345,633,259,322,246
"020031408",322,398,720,316,396,308
"020031409",48,55,103,43,55,32
"020051301",365,491,856,396,518,392
"020100610",492,608,1100,422,450,369
"020060411",343,419,762,345,419,342
"020060805",219,292,511,251,310,226
"020011705",261,316,577,256,318,251
"020111701",391,430,821,290,340,284
"020031410",404,494,898,313,392,303
"020112207",371,485,856,345,405,340
"020060608",450,559,1009,408,505,405
"020011708",248,349,597,267,313,243
"020051409",404,503,907,426,470,358
"020112206",487,545,1032,409,488,383
"020111805",371,433,804,318,395,309
"020011804",316,414,730,341,434,337
"020100706",452,508,960,342,411,338
"020011408",229,182,411,196,374,188
"020060609",326,435,761,356,439,352
"020060907",232,308,540,249,287,246
"020011805",296,402,698,274,359,265
"020100611",356,430,786,280,317,254
"020031609",555,598,1153,507,596,492
"020110609",392,473,865,302,322,278
"020032003",267,346,613,315,445,312
"020051509",192,214,406,168,214,161
"020060410",391,413,804,339,426,336
"020011409",246,275,521,246,354,246
"020070404",571,731,1302,560,683,525
"020060909",363,475,838,362,443,360
"020070402",356,414,770,334,381,304
"020032002",375,505,880,444,480,404
"020051408",289,361,650,275,309,267
"020111610",318,348,666,236,276,228
"020051508",356,419,775,331,285,212
"020032001",272,331,603,318,341,275
"020100202",273,327,600,257,291,244
"020031903",287,378,665,310,405,293
"020060607",322,419,741,350,438,348
"020011507",287,290,577,270,364,245
"020031902",140,161,301,152,166,138
"020011506",415,389,804,305,475,300
"020031901",528,653,1181,516,625,473
"020031805",179,217,396,171,209,169
"020070401",496,573,1069,534,651,513
"020111802",412,401,813,303,357,284
"020111703",412,472,884,336,378,320
"020031804",385,445,830,377,473,354
"020100601",312,350,662,231,270,223
"020051306",378,472,850,377,454,363
"020011711",213,261,474,218,274,215
"020060908",159,242,401,196,232,193
"020051307",326,413,739,323,418,316
"020031803",222,264,486,189,246,186
"020011710",264,310,574,279,363,274
"020051308",409,531,940,421,521,417
"020060906",395,469,864,381,505,377
"020061807",495,658,1153,526,622,495
"020031802",362,399,761,302,355,289
"020011709",204,235,439,239,309,238
"020031703",190,262,452,208,256,202
"020100104",380,457,837,294,343,272
"020031904",325,402,727,295,360,289
"020100203",337,365,702,245,279,230
"020070303",519,615,1134,477,579,458
"020060206",395,510,905,342,390,329
"020031702",399,423,822,325,390,320
"020060209",291,369,660,252,295,250
"020032004",269,347,616,290,378,286
"020061101",478,575,1053,429,477,421
"020060905",160,278,438,170,211,168
"020060207",305,432,737,346,417,345
"020032005",205,277,482,232,268,225
"020110611",415,444,859,314,357,297
"020061102",263,287,550,242,295,234
"020070405",364,469,833,397,489,278
"020061806",503,580,1083,454,526,425
"020031905",407,405,812,344,361,298
"020011410",207,224,431,220,341,212
"020031701",349,389,738,267,326,257
"020100612",324,393,717,266,315,259
"020011411",254,268,522,253,412,253
"020032006",247,238,485,189,236,185
"020061103",413,463,876,368,449,365
"020011312",150,142,292,138,250,138
"020011412",241,270,511,217,307,216
"020051604",449,576,1025,389,451,372
"020100504",409,512,921,323,363,304
"020011508",394,424,818,310,418,306
"020051603",296,336,632,214,244,205
"020061106",337,390,727,309,384,299
"020061108",351,428,779,369,460,364
"020011509",389,483,872,352,526,330
"020061105",280,301,581,249,315,247
"020100707",697,817,1514,515,555,506
"020031807",341,368,709,275,336,272
"020031806",297,347,644,255,299,242
"020061003",352,439,791,383,465,376
"020051602",278,350,628,286,328,273
"020060901",239,361,600,297,365,295
"020070302",426,527,953,381,442,342
"020111803",406,474,880,310,351,270
"020051601",408,425,833,404,428,333
"020051305",354,441,795,332,383,302
"020051701",324,382,706,290,356,282
"020111909",387,502,889,348,398,322
"020100704",511,622,1133,434,531,424
"020011905",293,350,643,271,363,251
"020101002",452,675,1127,350,423,345
"020011904",356,364,720,303,399,287
"020061805",336,476,812,390,506,380
"020011903",172,202,374,145,178,140
"020060904",442,570,1012,430,606,427
"020011902",485,581,1066,498,640,488
"020011901",412,480,892,424,493,419
"020011807",331,403,734,317,416,308
"020011806",511,669,1180,507,616,476
"020031808",245,293,538,254,313,245
"020061107",354,401,755,357,405,325
"020100613",476,567,1043,395,478,385
"020100106",377,434,811,309,315,257
"020032008",381,422,803,380,321,253
"020070406",550,624,1174,436,439,286
"020032007",366,436,802,349,431,333
"020060902",261,337,598,260,306,258
"020061104",359,423,782,343,408,341
"020061804",320,402,722,309,428,306
"020031801",267,306,573,256,291,249
"020111705",408,430,838,297,302,249
"020031907",456,493,949,413,398,309
"020111704",441,492,933,324,369,306
"020012402",140,147,287,145,236,141
"020060210",458,459,917,334,364,319
"020060208",497,592,1089,368,445,354
"020111807",462,547,1009,324,414,303
"020012401",125,123,248,113,214,113
"020061109",324,399,723,288,329,275
"020100204",433,442,875,303,338,293
"020031704",440,465,905,332,361,325
"020100105",349,346,695,258,279,236
"020012304",174,196,370,131,168,131
"020012305",246,255,501,228,250,219
"020111801",380,474,854,279,263,228
"020031705",392,419,811,324,310,261
"020070301",319,370,689,301,371,296
"020051702",382,433,815,353,428,345
"020051607",296,308,604,249,273,231
"020012303",388,402,790,373,505,369
"020031906",359,422,781,336,416,323
"020031706",321,405,726,327,390,318
"020111804",397,506,903,370,386,324
"020012301",275,332,607,272,361,261
"020031810",268,313,581,208,256,194
"020100107",362,392,754,258,306,248
"020011311",146,146,292,142,382,137
"020011511",276,278,554,281,270,237
"020060903",289,364,653,293,378,278
"020011510",282,343,625,291,383,270
"020051309",465,557,1022,422,536,412
"020061004",305,407,712,337,414,325
"020070202",467,522,989,370,428,355
"020070408",429,522,951,396,338,267
"020011906",214,217,431,216,228,202
"020060211",622,705,1327,508,570,415
"020061808",470,601,1071,512,684,504
"020011907",370,376,746,325,400,317
"020011909",221,286,507,223,291,219
"020011908",240,210,450,160,184,156
"020061809",362,457,819,395,487,392
"020011808",324,350,674,301,367,297
"020011809",307,343,650,303,528,297
"020061201",235,287,522,256,326,256
"020051605",380,466,846,376,466,357
"020100505",374,452,826,299,345,291
"020031809",410,485,895,395,499,381
"020032009",425,549,974,458,550,453
"020100708",490,557,1047,384,418,347
"020100503",432,504,936,355,425,343
"020032010",270,356,626,287,368,286
"020051606",315,400,715,309,360,292
"020061005",421,538,959,461,565,450
"020032011",195,284,479,239,307,238
"020070304",553,621,1174,395,393,345
"020031908",530,630,1160,499,604,453
"020061203",286,343,629,288,372,279
"020101005",412,477,889,313,349,299
"020061110",238,298,536,240,297,227
"020012403",296,238,534,200,252,159
"020100206",526,582,1108,393,458,379
"020031909",334,355,689,304,365,292
"020051703",339,415,754,317,331,273
"020031709",326,381,707,281,323,242
"020031910",245,275,520,236,279,231
"020070306",408,516,924,338,369,311
"020051704",404,438,842,298,342,285
"020100108",466,510,976,353,442,341
"020012307",282,286,568,265,314,249
"020012306",210,274,484,214,273,208
"020012302",258,267,525,219,312,210
"020031811",262,335,597,249,353,240
"020061006",400,556,956,455,591,449
"020061001",256,348,604,303,391,299
"020061002",222,342,564,288,382,285
"020031708",548,634,1182,383,436,349
"020012202",352,458,810,422,563,417
"020051705",317,430,747,309,389,306
"020061801",250,373,623,263,346,259
"020012201",265,302,567,261,367,228
"020070407",561,630,1191,472,501,345
"020101001",358,387,745,281,333,275
"020100703",519,704,1223,471,521,451
"020051610",430,493,923,388,486,384
"020012102",317,323,640,266,319,249
"020061904",443,567,1010,453,557,432
"020070409",292,320,612,223,264,210
"020101003",462,505,967,318,342,297
"020012101",275,352,627,266,324,265
"020111707",425,491,916,331,376,308
"020012002",331,407,738,298,370,296
"020061903",606,814,1420,603,768,597
"020100508",466,496,962,357,407,350
"020051609",409,509,918,394,454,377
"020111808",425,482,907,346,366,328
"020061007",243,349,592,335,478,307
"020012001",285,342,627,259,343,255
"020041801",70,4,74,45,45,42
"020070201",387,441,828,289,343,274
"020032101",444,515,959,376,477,374
"020061902",630,838,1468,641,806,632
"020011315",0,0,0,0,6,0
"020032202",305,353,658,294,351,291
"020061703",311,397,708,309,462,304
"020070203",401,423,824,303,346,288
"020051608",485,545,1030,376,432,370
"020032201",345,442,787,342,385,289
"020100709",453,506,959,339,395,312
"020061901",377,510,887,385,474,381
"020032302",347,456,803,347,408,329
"020051708",441,497,938,385,427,334
"020032301",356,443,799,330,355,303
"020031707",412,468,880,344,409,338
"020032403",275,376,651,276,362,272
"020061803",292,356,648,313,356,252
"020111706",545,630,1175,408,469,384
"020051707",415,491,906,329,378,325
"020070307",558,612,1170,448,501,438
"020032402",388,463,851,336,337,289
"020100502",331,392,723,292,348,285
"020061008",540,703,1243,568,728,553
"020012103",192,208,400,170,182,126
"020032401",307,385,692,303,367,292
"020012405",153,192,345,168,232,161
"020012203",370,447,817,371,461,354
"020012104",552,608,1160,500,548,462
"020012404",169,159,328,168,259,166
"020100205",390,449,839,297,350,287
"020012105",354,370,724,275,372,271
"020012310",177,185,362,150,190,145
"020012308",326,355,681,315,363,286
"020012309",423,475,898,405,508,400
"020012106",274,328,602,264,317,257
"020061802",259,352,611,256,308,242
"020061702",365,534,899,419,586,417
"020051706",345,430,775,341,435,325
"020012003",254,313,567,238,311,234
"020012004",313,456,769,343,447,342
"020101011",380,430,810,304,342,287
"020061905",315,433,748,305,386,303
"020061204",153,207,360,193,267,191
"020032503",255,294,549,207,245,176
"020012005",304,396,700,352,469,346
"020070305",369,418,787,309,390,303
"020032103",328,411,739,308,382,284
"020061906",447,570,1017,439,546,432
"020070410",428,500,928,365,483,359
"020100509",322,371,693,263,313,250
"020061009",236,265,501,246,323,245
"020070209",462,536,998,394,447,382
"020100506",378,475,853,339,399,319
"020061907",412,554,966,444,513,440
"020051611",487,576,1063,424,486,400
"020100710",531,584,1115,402,439,385
"020061704",313,434,747,360,439,355
"020070102",406,485,891,306,321,284
"020061202",257,299,556,228,255,203
"020012406",331,389,720,365,539,346
"020100501",307,393,700,243,263,226
"020032102",419,493,912,397,490,386
"020032203",193,214,407,181,219,173
"020061010",399,544,943,463,616,457
"020101004",377,403,780,284,328,269
"020061908",403,504,907,431,543,422
"020032502",341,368,709,295,337,259
"020032303",382,428,810,367,427,344
"020111809",396,419,815,304,353,286
"020061705",750,980,1730,839,1062,800
"020032404",328,373,701,311,374,301
"020012407",281,285,566,261,509,256
"020062005",352,484,836,384,528,375
"020012503",225,288,513,221,334,221
"020051709",268,290,558,253,309,247
"020012502",190,198,388,179,296,174
"020051710",369,388,757,280,350,272
"020062004",243,289,532,256,343,255
"020061205",359,482,841,384,502,382
"020012501",198,226,424,175,236,171
"020012110",391,425,816,376,544,357
"020012205",178,269,447,186,251,184
"020012602",289,388,677,320,405,298
"020012108",243,310,553,240,329,238
"020012204",203,243,446,207,267,196
"020012601",312,327,639,249,286,241
"020070204",859,918,1777,660,706,592
"020012107",375,410,785,332,389,325
"020100904",390,450,840,310,358,306
"020051711",417,462,879,428,502,389
"020012008",249,314,563,218,331,216
"020032504",323,373,696,272,327,258
"020032501",548,673,1221,510,654,507
"020012007",211,270,481,207,320,205
"020012006",349,436,785,336,387,311
"020061701",351,487,838,416,590,416
"020061206",251,320,571,243,301,241
"020062010",356,508,864,385,485,379
"020032104",353,415,768,347,409,339
"020070101",287,314,601,223,266,197
"020100512",348,419,767,265,305,254
"020062009",351,419,770,317,371,315
"020111708",409,438,847,322,341,297
"020051906",371,437,808,330,381,321
"020070505",527,602,1129,462,544,451
"020100208",411,457,868,316,362,304
"020101006",425,483,908,314,338,307
"020070308",302,434,736,307,362,295
"020062008",525,669,1194,483,575,475
"020062001",226,265,491,214,273,208
"020061502",708,959,1667,770,983,751
"020051904",435,559,994,397,476,387
"020100702",490,578,1068,407,521,397
"020032204",252,261,513,246,268,208
"020061207",296,389,685,349,494,337
"020062007",273,330,603,254,315,254
"020032205",365,444,809,359,461,357
"020062006",368,456,824,380,484,358
"020051903",415,514,929,407,502,395
"020032505",386,443,829,296,202,202
"020062003",430,540,970,447,650,444
"020032304",211,237,448,191,213,185
"020070205",472,513,985,358,454,351
"020051901",400,456,856,344,405,335
"020032405",233,284,517,225,277,220
"020100905",460,541,1001,302,350,286
"020051806",303,381,684,242,272,239
"020032406",476,598,1074,375,470,359
"020070309",338,373,711,273,323,268
"020051805",379,449,828,336,417,328
"020012505",216,261,477,226,318,220
"020061707",263,343,606,277,359,273
"020061208",335,406,741,303,409,301
"020012603",189,251,440,217,308,213
"020100511",345,358,703,248,296,242
"020100507",404,451,855,306,365,301
"020012207",283,279,562,268,332,257
"020012604",249,304,553,244,291,239
"020012206",247,331,578,259,353,242
"020051803",410,442,852,343,412,337
"020061706",433,614,1047,507,649,507
"020012109",319,390,709,328,429,322
"020070507",290,370,660,269,311,264
"020061501",304,367,671,284,384,282
"020100207",464,509,973,340,395,331
"020101007",387,437,824,308,349,298
"020051801",431,512,943,423,527,404
"020101105",438,506,944,301,310,256
"020032506",444,515,959,337,348,317
"020012009",275,297,572,247,316,237
"020101010",318,408,726,262,292,255
"020062002",242,316,558,258,344,253
"020061209",346,427,773,362,461,348
"020012010",398,462,860,316,382,306
"020101012",410,490,900,346,438,336
"020070208",356,356,712,296,343,292
"020100903",396,435,831,303,349,285
"020032105",234,273,507,219,236,208
"020062106",221,302,523,231,292,229
"020032106",349,448,797,387,429,366
"020032206",351,402,753,302,288,221
"020070310",474,588,1062,425,526,419
"020101008",328,405,733,254,285,253
"020061404",471,588,1059,531,699,525
"020032306",289,321,610,242,263,224
"020070508",300,440,740,345,415,337
"020051905",346,422,768,334,415,320
"020032305",268,346,614,291,363,291
"020062105",362,422,784,330,411,325
"020100401",472,564,1036,370,427,357
"020100510",377,428,805,296,326,257
"020061210",247,289,536,236,311,235
"020070207",324,400,724,245,282,239
"020032409",215,243,458,185,216,183
"020100513",388,432,820,288,333,278
"020062104",278,336,614,262,353,260
"020032408",337,416,753,320,366,299
"020012504",449,463,912,430,510,409
"020070601",410,517,927,372,456,370
"020070103",393,485,878,316,395,302
"020061503",367,449,816,358,451,356
"020070506",281,359,640,269,323,267
"020012606",194,271,465,214,288,214
"020032601",384,516,900,398,461,362
"020061601",292,380,672,283,321,281
"020012605",316,367,683,310,391,299
"020100701",509,633,1142,381,436,347
"020062103",465,562,1027,454,564,446
"020051902",309,383,692,282,345,275
"020012208",254,279,533,276,358,272
"020061603",432,513,945,393,520,384
"020061403",394,456,850,384,493,375
"020012209",413,467,880,377,441,368
"020032407",323,351,674,297,391,292
"020012807",348,379,727,314,347,293
"020051911",498,548,1046,437,402,326
"020012805",373,432,805,354,460,348
"020061211",363,451,814,372,502,365
"020061604",317,379,696,310,393,303
"020032602",572,590,1162,440,466,405
"020012804",281,380,661,280,320,271
"020100301",282,330,612,222,278,215
"020062102",431,561,992,452,556,450
"020061605",440,536,976,393,463,359
"020051804",375,413,788,277,293,254
"020012801",226,286,512,220,275,214
"020070104",352,386,738,255,310,236
"020032507",252,275,527,228,269,223
"020061401",383,513,896,382,473,377
"020100902",413,486,899,321,363,306
"020101104",497,524,1021,394,427,346
"020100909",337,348,685,250,286,247
"020032107",173,232,405,199,239,198
"020100801",503,582,1085,406,468,382
"020070602",355,446,801,299,298,240
"020032508",665,888,1553,716,862,694
"020032207",328,409,737,330,412,305
"020051802",407,493,900,375,382,319
"020032208",443,488,931,375,453,363
"020101103",386,470,856,354,425,338
"020101009",425,532,957,350,404,338
"020032307",308,353,661,274,315,243
"020032509",331,415,746,319,371,312
"020051909",271,334,605,294,372,291
"020101106",241,269,510,183,262,181
"020061405",468,563,1031,407,516,401
"020012408",202,226,428,184,246,179
"020062107",427,536,963,378,443,369
"020032308",400,480,880,336,400,332
"020070509",501,597,1098,460,492,430
"020061602",299,379,678,284,347,276
"020012507",187,231,418,193,270,191
"020100906",469,523,992,343,384,331
"020101301",333,385,718,226,248,212
"020061504",318,364,682,270,347,266
"020070603",301,330,631,243,283,232
"020061302",557,745,1302,586,702,584
"020070503",377,489,866,328,455,299
"020061212",225,294,519,208,254,201
"020100302",408,428,836,290,340,281
"020032703",445,461,906,355,387,322
"020012506",365,387,752,351,404,336
"020061505",338,422,760,320,417,320
"020062108",572,651,1223,465,573,454
"020012607",128,185,313,142,202,141
"020061402",269,356,625,250,320,249
"020012806",304,328,632,281,320,273
"020100803",363,437,800,319,362,285
"020032702",396,446,842,330,318,286
"020012210",601,630,1231,582,737,574
"020070704",301,338,639,266,285,234
"020100514",358,379,737,269,332,260
"020051907",212,234,446,199,280,195
"020070206",503,597,1100,396,490,374
"020051910",363,435,798,364,473,351
"020062109",345,395,740,294,364,289
"020100901",389,449,838,329,403,321
"020012803",308,369,677,241,260,232
"020062101",266,354,620,293,385,289
"020051908",417,505,922,429,484,406
"020070605",396,503,899,414,492,410
"020061606",449,530,979,415,513,411
"020032108",298,392,690,314,400,304
"020012802",365,388,753,345,371,340
"020061406",544,617,1161,484,618,483
"020070502",260,388,648,243,311,218
"020032701",443,523,966,400,465,374
"020061301",291,398,689,307,418,303
"020070703",425,533,958,409,464,408
"020032605",382,452,834,341,396,322
"020041701",273,304,577,221,249,217
"020061608",674,732,1406,560,653,507
"020070504",444,580,1024,457,614,452
"020061303",338,426,764,302,364,293
"020051807",328,396,724,309,370,304
"020070604",391,443,834,305,329,274
"020100908",355,382,737,259,299,246
"020032604",244,273,517,227,295,223
"020051808",198,210,408,149,181,147
"020100402",519,586,1105,402,477,381
"020101303",354,371,725,261,322,258
"020101102",531,582,1113,433,503,406
"020100910",394,407,801,279,298,234
"020061506",361,442,803,283,351,279
"020012508",285,327,612,321,419,316
"020051809",331,358,689,267,311,266
"020101108",394,445,839,344,390,338
"020012509",332,326,658,212,187,150
"020051810",349,469,818,344,406,321
"020032603",346,457,803,334,408,327
"020070702",268,318,586,204,237,196
"020100804",509,512,1021,367,457,355
"020012510",254,288,542,227,246,211
"020061407",243,296,539,237,277,232
"020062111",453,555,1008,387,471,378
"020012608",209,240,449,213,281,212
"020052002",439,491,930,410,497,399
"020070606",414,494,908,394,435,346
"020070705",302,335,637,287,291,260
"020012808",161,145,306,110,93,93
"020032704",402,432,834,313,391,304
"020012809",376,365,741,262,300,255
"020012810",435,474,909,353,412,337
"020101101",416,434,850,309,406,299
"020071101",370,485,855,315,429,304
"020012811",310,300,610,249,250,236
"020012812",276,297,573,235,263,229
"020101107",505,574,1079,377,410,330
"020070701",285,356,641,245,313,244
"020052001",351,413,764,316,418,308
"020070501",324,422,746,341,444,332
"020012813",330,322,652,261,276,241
"020052105",285,355,640,266,337,264
"020061304",540,700,1240,497,576,456
"020070706",455,504,959,365,450,353
"020032110",438,534,972,416,501,400
"020100403",393,486,879,300,339,291
"020061307",392,470,862,369,463,363
"020101302",346,407,753,255,315,246
"020032109",177,239,416,188,256,186
"020012710",242,271,513,248,366,241
"020061611",391,495,886,390,499,384
"020052104",429,485,914,370,453,335
"020071102",367,496,863,402,534,399
"020032209",441,498,939,373,464,368
"020070106",339,410,749,269,287,217
"020051811",291,427,718,315,404,304
"020061607",489,551,1040,388,497,381
"020032705",358,423,781,317,380,296
"020070607",390,479,869,379,499,377
"020100303",371,432,803,293,345,288
"020012511",271,286,557,252,308,249
"020041601",309,372,681,259,290,253
"020032310",497,547,1044,397,428,362
"020061408",253,287,540,218,275,216
"020062110",389,436,825,368,470,362
"020101111",297,348,645,251,291,244
"020052103",228,303,531,209,271,208
"020032309",477,495,972,342,374,314
"020061306",212,323,535,267,364,266
"020101304",287,318,605,248,287,239
"020012609",325,414,739,316,398,311
"020071103",366,484,850,367,459,361
"020012709",353,370,723,324,344,300
"020052102",396,461,857,350,407,338
"020070707",301,364,665,248,275,216
"020061507",402,457,859,335,419,330
"020070609",282,405,687,289,351,270
"020032606",282,323,605,246,292,221
"020071105",254,294,548,229,281,225
"020100802",578,630,1208,428,487,408
"020070105",219,231,450,172,234,162
"020101402",449,476,925,315,376,304
"020061508",438,521,959,445,560,439
"020101109",529,556,1085,381,389,345
"020100805",403,445,848,302,327,260
"020061305",378,495,873,361,525,354
"020052101",390,470,860,378,512,372
"020052003",487,578,1065,385,399,360
"020071003",248,340,588,254,321,252
"020061509",250,267,517,227,295,224
"020070608",202,237,439,185,239,183
"020061610",531,624,1155,499,612,489
"020101206",279,322,601,214,242,191
"020100907",407,478,885,312,361,301
"020070107",230,257,487,185,242,169
"020100405",387,402,789,286,334,269
"020101305",391,419,810,315,376,301
"020101110",295,383,678,296,354,263
"020071104",420,519,939,380,484,375
"020012708",332,362,694,255,357,244
"020061409",376,418,794,309,411,305
"020072304",275,358,633,272,331,265
"020070708",231,275,506,220,282,217
"020052106",319,398,717,337,467,324
"020041704",286,389,675,296,340,291
"020101205",291,314,605,189,238,151
"020061609",520,567,1087,418,525,409
"020071002",160,220,380,185,239,178
"020072303",324,404,728,318,379,314
"020052107",366,353,719,257,308,241
"020100807",539,615,1154,425,485,402
"020100304",272,316,588,218,246,206
"020072302",449,535,984,388,449,371
"020041403",318,327,645,277,360,273
"020041702",268,322,590,240,297,237
"020032608",276,310,586,246,288,240
"020041402",269,319,588,259,313,255
"020041705",343,416,759,328,394,328
"020071001",316,417,733,303,396,301
"020032707",426,506,932,367,405,318
"020012701",257,339,596,234,307,230
"020070711",244,369,613,282,354,280
"020012702",429,351,780,275,188,138
"020101204",282,347,629,243,299,235
"020100305",382,424,806,283,322,261
"020052109",355,371,726,236,277,231
"020012902",312,312,624,266,250,226
"020101306",382,458,840,278,320,265
"020061308",572,649,1221,497,638,469
"020032607",388,427,815,312,405,296
"020041602",866,1067,1933,929,1405,879
"020012901",524,599,1123,420,453,395
"020040711",496,781,1277,212,232,188
"020040712",461,405,866,272,301,234
"020072301",386,436,822,303,354,285
"020070709",418,518,936,410,521,377
"020061309",420,476,896,426,552,409
"020061510",349,367,716,305,375,299
"020070710",354,435,789,355,430,349
"020100404",372,442,814,288,332,285
"020100406",329,326,655,235,253,218
"020041710",425,456,881,280,301,261
"020072208",258,311,569,235,275,232
"020052110",262,337,599,253,286,228
"020041401",320,315,635,272,340,263
"020041706",271,336,607,280,342,276
"020072207",266,295,561,221,267,213
"020032706",410,428,838,306,303,256
"020071004",302,388,690,295,347,289
"020101203",371,436,807,309,294,260
"020061410",423,489,912,392,576,386
"020072206",420,483,903,365,419,329
"020071106",375,426,801,267,359,266
"020072305",320,415,735,290,307,268
"020101401",420,482,902,334,389,314
"020072205",466,534,1000,386,500,374
"020032609",376,414,790,292,315,264
"020070908",441,531,972,397,470,377
"020012707",440,426,866,265,249,228
"020071006",349,411,760,351,459,347
"020012706",437,492,929,359,383,354
"020101202",402,473,875,370,442,364
"020040703",430,508,938,302,264,238
"020072306",348,412,760,276,346,273
"020041407",351,406,757,289,335,281
"020041709",332,425,757,337,438,331
"020071108",463,542,1005,452,638,444
"020072202",449,474,923,365,501,342
"020101308",357,428,785,290,331,284
"020101403",371,442,813,322,408,317
"020041707",281,328,609,255,303,255
"020012703",413,475,888,293,333,271
"020100308",466,540,1006,344,433,334
"020071007",292,418,710,339,448,335
"020070909",318,367,685,298,361,278
"020101201",462,544,1006,347,411,331
"020100808",504,617,1121,408,468,395
"020041703",273,311,584,217,261,215
"020070109",328,352,680,291,323,267
"020041404",502,608,1110,495,654,493
"020070108",313,408,721,319,406,298
"020040702",356,400,756,290,325,263
"020052004",375,429,804,314,373,306
"020101207",294,365,659,238,282,225
"020071005",284,356,640,240,290,239
"020041408",460,532,992,410,440,353
"020100307",432,478,910,342,428,337
"020100806",421,461,882,290,326,284
"020072201",284,350,634,297,347,285
"020040701",454,448,902,304,364,294
"020052111",326,368,694,245,299,241
"020041604",277,369,646,267,299,247
"020072102",499,622,1121,466,560,442
"020070910",303,389,692,307,387,301
"020040607",351,415,766,310,312,286
"020100408",348,369,717,264,324,262
"020071008",467,605,1072,428,566,423
"020012903",391,426,817,276,299,273
"020071107",489,634,1123,496,599,489
"020041301",428,479,907,357,499,348
"020012904",341,382,723,272,294,242
"020052108",360,368,728,248,286,240
"020100407",349,426,775,301,352,287
"020052006",406,440,846,288,321,274
"020041708",496,498,994,358,409,346
"020070802",388,491,879,356,456,339
"020101903",491,609,1100,355,361,298
"020012905",385,419,804,306,334,258
"020040603",351,400,751,285,309,258
"020101309",323,403,726,281,326,276
"020101307",307,415,722,254,296,244
"020101405",330,389,719,262,312,256
"020040601",492,598,1090,431,517,404
"020041608",297,314,611,219,258,212
"020070801",295,387,682,326,403,302
"020072101",486,652,1138,424,477,396
"020040704",898,1261,2159,814,917,750
"020072103",438,521,959,433,512,419
"020072203",386,488,874,361,424,355
"020041405",294,375,669,302,344,288
"020071010",382,550,932,332,392,317
"020101404",400,432,832,296,364,280
"020071109",408,579,987,366,441,363
"020101210",277,335,612,246,306,239
"020041603",557,688,1245,438,470,426
"020070110",480,645,1125,419,481,365
"020101208",352,401,753,311,352,291
"020041501",295,344,639,259,328,255
"020101311",264,355,619,287,344,276
"020072104",263,302,565,240,288,237
"020052204",437,499,936,362,435,351
"020071201",467,553,1020,422,510,417
"020071009",292,390,682,307,384,299
"020072209",288,318,606,224,255,219
"020012704",360,442,802,325,359,316
"020070911",257,320,577,263,292,224
"020072307",358,463,821,313,361,296
"020040608",417,503,920,317,356,301
"020012909",434,489,923,376,432,342
"020052203",276,353,629,260,311,232
"020101209",323,414,737,308,390,307
"020052005",441,460,901,332,392,320
"020012908",300,348,648,260,279,224
"020041409",326,338,664,262,363,250
"020052202",390,437,827,292,358,284
"020100409",363,411,774,305,355,265
"020071110",277,368,645,249,285,241
"020101902",518,576,1094,436,474,408
"020072105",343,343,686,250,292,238
"020072108",186,246,432,175,201,172
"020072308",372,442,814,322,326,257
"020070907",333,420,753,329,412,321
"020101502",403,515,918,347,417,343
"020072204",426,506,932,378,448,370
"020101310",290,303,593,230,281,229
"020040606",408,521,929,375,429,369
"020041406",231,266,497,208,297,207
"020041610",361,425,786,280,317,273
"020040705",349,414,763,297,349,293
"020072309",342,393,735,289,285,268
"020040602",361,426,787,320,356,292
"020052201",347,391,738,260,309,248
"020071304",252,310,562,216,264,213
"020101904",361,427,788,340,416,325
"020070906",404,489,893,356,445,348
"020070803",239,344,583,247,310,246
"020100809",360,440,800,264,327,257
"020041904",526,608,1134,375,375,332
"020101312",254,347,601,267,316,262
"020071203",387,385,772,278,305,274
"020012705",298,343,641,288,364,282
"020041605",432,538,970,412,462,381
"020070901",309,358,667,259,292,247
"020041201",304,300,604,229,171,141
"020041502",580,712,1292,624,793,616
"020040609",319,388,707,274,309,269
"020070804",358,463,821,358,457,347
"020090102",204,240,444,184,211,180
"020072210",384,394,778,268,312,260
"020101503",265,292,557,202,247,198
"020041306",285,291,576,204,201,170
"020100306",310,407,717,278,327,265
"020072106",430,497,927,423,505,411
"020101901",247,316,563,265,310,241
"020012906",493,497,990,323,349,319
"020101501",289,344,633,263,304,246
"020090101",234,296,530,206,238,204
"020052007",443,469,912,315,341,279
"020041609",491,573,1064,431,514,424
"020040605",340,393,733,275,315,256
"020041303",289,349,638,253,298,245
"020101406",283,310,593,205,243,199
"020040706",404,457,861,287,343,273
"020101905",381,441,822,348,420,341
"020052206",457,481,938,332,306,276
"020070902",290,335,625,276,344,273
"020072211",348,405,753,286,336,280
"020070905",221,273,494,197,291,196
"020040604",430,525,955,320,366,297
"020041908",768,752,1520,459,277,241
"020071303",451,549,1000,415,539,390
"020101407",385,450,835,291,301,266
"020071305",361,458,819,329,399,326
"020041202",239,301,540,216,205,188
"020041607",188,213,401,156,186,147
"020070805",485,555,1040,392,470,363
"020041503",476,588,1064,483,579,481
"020041903",425,479,904,323,351,321
"020070903",225,318,543,226,275,223
"020072404",488,548,1036,379,471,371
"020070807",297,381,678,319,390,314
"020101906",416,442,858,347,350,264
"020101806",259,347,606,280,362,276
"020101910",440,568,1008,400,478,378
"020072403",567,647,1214,384,417,346
"020090107",304,379,683,257,316,249
"020072107",334,388,722,303,361,296
"020070904",374,452,826,415,478,328
"020070806",414,482,896,373,466,364
"020101907",324,451,775,328,419,322
"020071202",265,313,578,216,267,213
"020101504",313,363,676,247,301,241
"020041302",294,324,618,240,300,240
"020101805",337,442,779,277,349,275
"020041901",295,379,674,255,287,243
"020052205",378,423,801,277,322,274
"020012907",405,511,916,328,386,324
"020071204",349,448,797,319,347,312
"020071302",322,391,713,294,376,290
"020072212",259,323,582,256,298,253
"020040710",267,343,610,287,356,274
"020052008",439,468,907,317,333,265
"020071315",220,283,503,185,216,182
"020072402",443,470,913,318,331,277
"020101505",425,395,820,298,357,293
"020072213",349,404,753,289,343,283
"020071306",351,393,744,265,299,260
"020101809",575,709,1284,458,466,360
"020101909",354,375,729,276,325,272
"020041606",256,301,557,248,289,242
"020101409",407,480,887,337,388,320
"020041504",335,397,732,297,352,291
"020040709",322,422,744,273,289,243
"020041304",227,259,486,226,274,219
"020101807",347,438,785,365,428,359
"020040504",341,374,715,279,303,250
"020071301",344,377,721,320,373,313
"020042007",399,450,849,290,324,281
"020052207",722,874,1596,724,891,711
"020090108",338,345,683,278,346,260
"020040610",312,418,730,215,254,211
"020071314",320,389,709,220,254,204
"020070808",373,445,818,368,500,354
"020071205",311,429,740,297,333,292
"020041902",357,378,735,259,295,240
"020040708",314,375,689,286,348,281
"020101804",491,623,1114,396,465,373
"020071310",230,267,497,193,231,192
"020071402",359,458,817,298,380,296
"020101911",450,469,919,344,399,329
"020041305",419,537,956,391,462,358
"020072401",432,462,894,345,413,341
"020040502",292,347,639,260,283,238
"020072405",441,490,931,344,396,333
"020041905",369,436,805,286,312,256
"020042006",413,455,868,305,332,301
"020041308",180,229,409,174,196,174
"020040707",355,430,785,314,375,312
"020101908",230,282,512,215,260,201
"020101408",282,317,599,253,310,247
"020052210",393,465,858,296,305,266
"020041203",341,380,721,302,337,301
"020041907",456,477,933,287,272,265
"020041506",273,321,594,240,315,238
"020052012",455,450,905,297,322,238
"020101411",339,370,709,267,301,259
"020101803",329,451,780,337,397,319
"020052009",408,453,861,326,355,305
"020041505",251,291,542,219,258,216
"020101508",517,556,1073,375,383,333
"020071206",346,409,755,302,376,295
"020072001",491,530,1021,380,433,367
"020052209",417,484,901,278,318,264
"020090106",409,400,809,291,293,238
"020040806",321,389,710,274,330,273
"020071307",240,309,549,202,256,196
"020101808",278,318,596,184,239,178
"020071309",245,248,493,166,186,161
"020071311",353,397,750,253,277,248
"020041906",573,574,1147,363,377,343
"020101410",379,460,839,341,439,331
"020040501",409,482,891,369,440,360
"020071403",327,398,725,257,290,236
"020040503",345,452,797,331,388,319
"020071401",410,423,833,313,341,288
"020090109",359,392,751,344,487,341
"020101507",254,272,526,225,285,218
"020042001",467,464,931,324,321,272
"020101912",517,620,1137,429,510,402
"020072111",361,450,811,339,352,294
"020042008",376,421,797,243,266,241
"020041307",387,511,898,400,530,396
"020040805",270,324,594,268,349,266
"020072110",406,505,911,376,443,351
"020040611",297,357,654,246,272,239
"020101506",273,340,613,248,323,238
"020101810",239,277,516,191,212,175
"020052010",446,516,962,380,457,376
"020072406",502,557,1059,371,456,354
"020041204",459,516,975,371,266,233
"020041507",292,352,644,274,317,268
"020101601",308,363,671,270,302,264
"020101802",352,403,755,270,292,265
"020090105",352,385,737,294,365,278
"020041309",175,232,407,170,209,169
"020040505",203,250,453,203,228,198
"020072109",326,383,709,307,368,286
"020072006",374,441,815,283,313,269
"020040807",1192,1272,2464,837,993,774
"020042004",296,307,603,221,239,219
"020071207",302,310,612,218,251,211
"020042009",406,443,849,293,320,283
"020041909",570,559,1129,339,339,307
"020052208",332,381,713,246,242,210
"020040804",405,395,800,293,308,253
"020072407",416,436,852,289,294,261
"020091104",484,571,1055,370,411,344
"020071404",323,373,696,258,279,244
"020071405",425,504,929,295,321,263
"020072112",412,505,917,313,294,256
"020071313",287,278,565,196,229,191
"020101602",492,585,1077,408,482,386
"020101509",566,657,1223,459,544,454
"020101801",349,387,736,280,311,253
"020040506",442,494,936,349,419,343
"020052011",398,432,830,302,320,272
"020090103",268,345,613,261,333,247
"020101703",437,507,944,360,436,353
"020091102",526,556,1082,355,410,344
"020052211",424,470,894,320,341,293
"020101702",405,439,844,372,456,351
"020042010",513,612,1125,364,390,341
"020040803",302,328,630,240,305,237
"020041508",298,373,671,270,340,270
"020090104",350,399,749,269,326,253
"020071407",443,496,939,272,311,257
"020072408",406,471,877,331,369,314
"020071308",268,292,560,194,257,187
"020041311",507,632,1139,448,545,445
"020041310",224,267,491,202,255,200
"020040802",336,431,767,311,400,306
"020101701",336,412,748,313,391,310
"020072002",259,293,552,192,213,184
"020101706",405,467,872,308,372,292
"020091101",534,617,1151,430,499,402
"020052213",295,383,678,218,263,211
"020071209",396,427,823,290,327,282
"020071312",331,361,692,222,244,210
"020041910",313,331,644,263,290,257
"020042002",337,368,705,257,286,244
"020042005",346,410,756,211,250,210
"020101705",497,564,1061,367,368,296
"020101603",361,417,778,282,330,247
"020071411",448,474,922,323,349,300
"020071604",335,391,726,241,225,182
"020091105",584,640,1224,397,434,369
"020041510",246,281,527,188,204,181
"020071406",525,600,1125,379,399,342
"020052212",424,485,909,326,323,278
"020101811",303,360,663,224,246,210
"020041509",316,347,663,254,290,243
"020040507",356,478,834,251,291,232
"020101704",519,564,1083,378,445,378
"020041205",292,323,615,231,256,215
"020072003",349,373,722,259,287,240
"020042011",418,495,913,323,376,317
"020040808",215,190,405,97,114,96
"020072410",442,520,962,323,374,303
"020090305",223,323,546,271,404,255
"020072005",384,422,806,278,302,263
"020090306",334,415,749,298,412,292
"020101812",362,446,808,297,325,290
"020090304",306,335,641,242,323,232
"020090201",377,447,824,349,474,346
"020042003",423,426,849,281,285,254
"020090303",276,325,601,239,313,224
"020101604",403,470,873,344,413,332
"020091103",398,448,846,292,338,271
"020090302",306,370,676,255,334,243
"020090202",353,414,767,301,375,294
"020090301",318,328,646,263,380,245
"020040508",481,601,1082,247,298,241
"020090203",388,431,819,330,434,321
"020090204",436,546,982,414,545,413
"020040809",543,550,1093,350,321,272
"020071412",438,486,924,339,358,307
"020091009",214,245,459,170,221,167
"020072007",379,437,816,279,255,204
"020040801",313,392,705,304,380,297
"020040403",414,488,902,320,390,301
"020101605",460,591,1051,389,499,380
"020072411",495,545,1040,371,425,354
"020071602",371,425,796,253,255,231
"020042012",521,648,1169,471,548,457
"020042201",284,305,589,257,317,246
"020071605",411,384,795,274,315,258
"020041208",183,220,403,184,255,182
"020040810",371,392,763,238,247,206
"020091107",537,587,1124,385,400,357
"020041207",248,236,484,157,145,113
"020071208",303,292,595,213,241,200
"020042103",251,310,561,207,232,196
"020091008",434,497,931,322,366,313
"020042202",345,400,745,297,350,289
"020072004",266,275,541,190,218,180
"020101607",374,408,782,289,347,288
"020040402",318,420,738,295,355,293
"020090205",526,617,1143,428,527,402
"020041206",379,417,796,249,238,197
"020071408",466,470,936,300,320,272
"020040401",315,353,668,236,282,233
"020071413",365,382,747,251,274,223
"020072409",443,507,950,341,383,325
"020101606",488,518,1006,356,428,338
"020091106",449,510,959,327,357,297
"020101707",410,465,875,289,345,269
"020041209",316,423,739,312,388,302
"020071410",349,417,766,233,257,225
"020071603",381,434,815,264,256,229
"020091108",415,493,908,311,322,275
"020090206",327,389,716,255,301,244
"020042102",381,418,799,263,273,241
"020040811",431,468,899,281,324,254
"020042101",337,366,703,245,259,237
"020091010",343,417,760,304,358,302
"020072008",576,613,1189,441,495,417
"020101708",319,375,694,246,286,218
"020072009",417,492,909,302,307,263
"020091007",313,356,669,249,284,232
"020040308",416,428,844,275,304,263
"020090209",388,473,861,358,442,353
"020101709",306,332,638,239,258,215
"020071601",342,380,722,248,276,242
"020041210",427,457,884,284,299,265
"020090307",361,458,819,316,390,305
"020090210",356,398,754,305,389,293
"020071606",481,526,1007,352,378,303
"020042203",407,479,886,352,410,346
"020040307",348,338,686,229,257,212
"020042104",386,381,767,249,257,235
"020071609",498,559,1057,335,351,297
"020090509",361,431,792,330,408,324
"020040404",523,518,1041,330,365,320
"020040405",497,519,1016,366,439,358
"020091202",276,270,546,191,211,168
"020101609",442,511,953,338,400,327
"020040306",421,481,902,296,321,272
"020041001",29,44,73,23,11,11
"020071504",311,344,655,232,272,222
"020091111",449,520,969,329,369,304
"020040305",502,559,1061,361,365,319
"020091006",403,407,810,282,273,230
"020041211",277,355,632,260,296,256
"020042105",304,351,655,238,271,236
"020101608",401,452,853,312,370,298
"020042205",355,410,765,284,331,265
"020091109",457,625,1082,314,328,274
"020040309",265,310,575,183,200,172
"020071607",473,474,947,320,336,292
"020040301",432,542,974,342,367,319
"020090510",408,439,847,319,369,310
"020071409",400,456,856,289,329,270
"020090207",382,418,800,300,379,294
"020090211",449,609,1058,341,425,337
"020091011",262,324,586,245,285,240
"020090310",390,419,809,283,332,272
"020071901",421,457,878,274,198,171
"020042106",351,381,732,270,309,262
"020091004",287,339,626,237,288,229
"020101710",346,395,741,269,326,264
"020090313",435,511,946,313,333,255
"020072012",318,341,659,223,244,205
"020091012",233,287,520,224,261,222
"020091005",408,475,883,342,406,333
"020071503",450,510,960,316,329,296
"020090208",329,357,686,245,303,239
"020040406",370,425,795,286,311,273
"020091110",432,491,923,306,327,285
"020072011",510,579,1089,363,364,309
"020071505",335,370,705,233,255,223
"020042204",583,722,1305,495,566,486
"020071502",509,558,1067,360,302,253
"020090308",346,432,778,279,314,267
"020091003",486,645,1131,328,361,312
"020040310",377,445,822,293,327,271
"020040509",1028,1134,2162,634,665,590
"020042109",416,419,835,253,250,234
"020090311",394,439,833,294,327,275
"020090212",292,333,625,223,288,217
"020090608",382,403,785,281,350,273
"020042108",470,511,981,294,300,290
"020090508",398,436,834,292,324,270
"020071608",535,571,1106,352,382,338
"020072010",622,705,1327,368,367,328
"020040407",422,464,886,329,400,321
"020091302",530,582,1112,404,452,375
"020071506",509,601,1110,334,372,330
"020042206",267,332,599,255,293,254
"020041212",274,299,573,223,270,210
"020090609",445,445,890,373,452,359
"020090511",435,465,900,317,380,292
"020091112",609,651,1260,414,406,365
"020042107",396,442,838,275,282,246
"020040304",440,464,904,298,328,290
"020071902",829,830,1659,507,267,258
"020071904",769,784,1553,455,288,277
"020040408",377,403,780,288,342,261
"020090501",414,465,879,310,331,291
"020042110",371,362,733,234,230,225
"020040311",430,490,920,307,352,291
"020040409",386,464,850,285,321,255
"020072013",768,849,1617,575,653,562
"020042208",463,524,987,363,426,348
"020040302",416,433,849,297,309,281
"020090503",468,593,1061,261,312,254
"020090606",325,384,709,259,288,250
"020090610",404,495,899,345,380,316
"020091001",385,440,825,298,334,288
"020042207",411,492,903,402,483,378
"020071701",822,783,1605,439,346,328
"020091002",488,580,1068,336,377,318
"020042305",247,296,543,227,244,212
"020071507",337,377,714,285,334,280
"020091301",481,491,972,315,309,264
"020090309",306,391,697,257,289,246
"020071903",659,680,1339,363,238,232
"020042111",462,450,912,281,287,254
"020091201",481,561,1042,338,380,324
"020090312",288,297,585,213,224,188
"020040312",516,549,1065,341,359,321
"020040510",609,649,1258,397,399,357
"020090607",456,543,999,374,450,364
"020040303",298,345,643,221,229,206
"020090506",391,450,841,315,362,304
"020071508",371,426,797,293,292,233
"020090507",393,405,798,314,382,302
"020091303",606,587,1193,402,418,360
"020040511",503,513,1016,340,359,304
"020042304",385,442,827,265,312,258
"020040101",360,410,770,247,231,184
"020071509",566,652,1218,397,386,353
"020071510",504,519,1023,327,324,287
"020040411",439,521,960,344,333,277
"020090605",523,586,1109,412,444,372
"020042112",261,296,557,190,201,185
"020090502",386,446,832,322,382,298
"020091203",401,457,858,283,297,263
"020090611",383,440,823,309,302,274
"020042209",311,374,685,259,268,239
"020042303",390,429,819,258,300,243
"020071501",340,348,688,225,194,165
"020042301",401,433,834,272,295,261
"020071905",674,733,1407,392,310,295
"020071706",635,678,1313,375,364,352
"020090907",445,519,964,359,388,294
"020071807",579,637,1216,286,267,255
"020091304",401,421,822,250,266,227
"020090404",429,502,931,329,378,316
"020090403",411,499,910,342,405,335
"020090604",438,467,905,341,424,337
"020090402",431,492,923,325,372,304
"020090401",410,516,926,361,398,336
"020071702",750,837,1587,500,312,297
"020071808",508,502,1010,246,224,219
"020041101",408,454,862,293,255,209
"020090411",452,481,933,341,403,330
"020091208",491,526,1017,320,355,312
"020091204",384,426,810,296,317,271
"020042210",252,311,563,229,294,226
"020040313",279,311,590,197,192,170
"020040102",393,402,795,263,241,196
"020090601",506,605,1111,408,482,397
"020040103",304,331,635,215,183,160
"020071906",935,992,1927,440,448,422
"020090505",445,561,1006,384,464,374
"020090612",404,426,830,286,324,266
"020071705",429,462,891,268,104,100
"020041002",927,1008,1935,661,551,533
"020091207",355,364,719,250,288,242
"020040410",318,343,661,273,327,261
"020090908",292,297,589,205,218,179
"020042603",592,627,1219,340,210,189
"020071805",503,500,1003,292,106,105
"020042211",348,380,728,290,353,254
"020041005",796,863,1659,519,459,436
"020071707",1200,1216,2416,764,466,454
"020071804",400,413,813,254,124,119
"020040210",513,538,1051,316,310,273
"020042306",319,376,695,304,412,299
"020071511",537,611,1148,367,354,316
"020042302",429,444,873,288,339,275
"020091212",353,373,726,232,237,205
"020090602",366,468,834,259,311,250
"020071809",594,609,1203,377,274,258
"020071703",679,695,1374,416,220,207
"020071708",517,586,1103,338,155,150
"020071704",827,818,1645,509,252,246
"020090909",376,433,809,256,274,240
"020071806",823,851,1674,485,301,280
"020042212",300,305,605,218,255,196
"020071802",241,246,487,124,134,119
"020090901",350,442,792,282,317,261
"020042308",392,453,845,288,346,286
"020071709",865,981,1846,618,341,329
"020090410",352,419,771,290,308,235
"020090504",377,471,848,303,377,290
"020091205",386,417,803,290,288,255
"020041102",384,463,847,327,384,306
"020042307",297,356,653,233,266,225
"020041003",812,841,1653,507,491,466
"020090603",419,510,929,373,442,364
"020090708",348,389,737,275,313,269
"020091306",489,488,977,300,206,184
"020040207",438,461,899,314,375,293
"020071803",474,468,942,288,235,230
"020090906",412,469,881,304,332,296
"020041105",215,241,456,185,210,161
"020090405",469,523,992,355,370,302
"020091206",478,538,1016,338,360,316
"020091305",452,524,976,303,340,288
"020071811",685,640,1325,403,223,199
"020091209",401,470,871,292,324,280
"020090910",408,431,839,285,313,270
"020071810",723,770,1493,414,393,332
"020071801",758,787,1545,395,437,342
"020071710",733,774,1507,500,221,214
"020090914",452,519,971,310,344,306
"020042311",291,282,573,206,197,181
"020040209",295,326,621,209,218,204
"020090902",334,386,720,268,279,242
"020040108",337,348,685,225,252,218
"020040208",258,262,520,189,209,176
"020090408",319,416,735,270,297,254
"020091211",427,432,859,310,333,293
"020040203",478,571,1049,383,455,357
"020071711",270,290,560,190,93,87
"020040201",344,409,753,274,316,269
"020091210",526,537,1063,343,367,333
"020090707",264,336,600,232,271,219
"020041104",283,360,643,250,317,247
"020040904",222,281,503,176,187,145
"020042602",604,624,1228,283,252,245
"020090409",342,365,707,256,285,243
"020041004",229,235,464,124,117,105
"020090709",389,449,838,313,339,295
"020040104",399,402,801,236,196,175
"020090903",487,546,1033,396,477,373
"020090911",341,412,753,275,293,247
"020081404",1310,1395,2705,793,669,610
"020091307",575,571,1146,358,397,347
"020041103",370,415,785,282,346,274
"020081405",595,578,1173,385,358,318
"020042503",2012,1933,3945,1093,841,804
"020090706",402,451,853,308,338,270
"020042310",385,419,804,259,253,226
"020040206",313,370,683,257,292,248
"020090407",308,372,680,271,321,255
"020042601",503,505,1008,261,131,117
"020090714",375,486,861,297,335,283
"020091504",413,452,865,272,304,240
"020040109",316,334,650,224,220,176
"020040202",363,463,826,282,341,272
"020041008",794,808,1602,492,430,402
"020041007",433,468,901,273,249,232
"020042309",226,245,471,150,129,121
"020090710",307,362,669,245,270,234
"020090913",299,341,640,209,214,195
"020090705",332,377,709,257,298,252
"020041006",479,525,1004,306,277,259
"020041106",467,497,964,320,325,267
"020040105",408,416,824,234,170,163
"020040903",262,274,536,186,176,159
"020090406",292,334,626,251,275,241
"020090912",318,371,689,227,278,218
"020091401",537,572,1109,388,427,341
"020090905",332,381,713,261,281,244
"020040110",243,248,491,157,201,148
"020042504",1065,963,2028,573,469,440
"020090713",379,450,829,324,374,314
"020040205",343,395,738,231,274,212
"020090704",298,371,669,242,285,237
"020090808",506,576,1082,335,387,321
"020090711",362,405,767,278,324,271
"020041108",466,456,922,313,349,285
"020042402",949,903,1852,538,537,493
"020041107",506,543,1049,328,361,296
"020041009",1034,1057,2091,624,588,559
"020090904",302,326,628,211,231,186
"020081409",499,512,1011,336,257,229
"020040204",376,420,796,273,263,239
"020090703",259,309,568,220,256,213
"020042312",377,403,780,232,224,201
"020091505",468,481,949,319,375,312
"020091503",407,456,863,290,312,267
"020040107",233,285,518,168,162,151
"020040111",275,318,593,200,206,167
"020040106",354,371,725,206,126,118
"020090712",487,527,1014,315,371,299
"020040905",249,288,537,189,233,189
"020081403",981,1052,2033,518,330,300
"020042401",684,712,1396,415,375,371
"020091402",452,465,917,307,296,270
"020090701",352,413,765,269,312,261
"020040112",251,278,529,183,214,171
"020091404",408,438,846,249,197,184
"020091502",433,442,875,290,272,226
"020091403",363,410,773,263,258,231
"020040902",359,406,765,254,263,225
"020041109",435,450,885,269,277,230
"020090801",369,401,770,287,335,264
"020042502",1099,1116,2215,624,485,474
"020081410",477,502,979,313,287,233
"020040901",740,755,1495,463,312,260
"020042403",598,622,1220,373,329,305
"020090702",402,440,842,300,359,296
"020091506",526,523,1049,336,359,304
"020090807",510,556,1066,330,359,300
"020081307",332,396,728,253,271,226
"020091501",279,300,579,217,238,198
"020081402",708,765,1473,382,255,250
"020091508",413,430,843,283,290,256
"020040114",352,397,749,236,221,204
"020091405",907,973,1880,457,333,324
"020040906",373,466,839,279,318,276
"020090809",368,396,764,250,276,232
"020081407",434,515,949,297,301,271
"020040113",190,215,405,136,168,127
"020081401",876,929,1805,464,330,318
"020091507",520,539,1059,348,378,319
"020090802",353,380,733,294,375,277
"020040907",372,410,782,263,293,249
"020081505",1673,1712,3385,877,639,613
"020042404",974,955,1929,534,483,467
"020081501",1401,1396,2797,852,499,463
"020091406",1261,1297,2558,659,555,543
"020042405",654,696,1350,406,207,189
"020091408",829,855,1684,426,341,333
"020081408",377,421,798,259,298,241
"020091509",366,435,801,293,318,257
"020090806",502,492,994,353,404,343
"020081705",206,242,448,173,246,170
"020090803",369,463,832,293,354,282
"020081507",455,474,929,259,225,217
"020080502",378,398,776,263,299,251
"020081506",477,404,881,233,188,182
"020091604",373,356,729,247,276,225
"020091409",435,470,905,252,201,180
"020091410",897,907,1804,489,406,400
"020091407",676,698,1374,351,262,253
"020042501",1193,1164,2357,688,608,580
"020081701",267,309,576,223,250,196
"020090805",433,476,909,329,395,323
"020081504",476,455,931,231,101,97
"020081306",302,355,657,221,223,194
"020090810",448,457,905,326,360,298
"020080501",387,420,807,277,333,267
"020042406",691,726,1417,377,347,340
"020080503",389,432,821,270,290,245
"020091511",452,476,928,311,334,283
"020081308",425,468,893,297,316,270
"020081503",1184,1247,2431,667,147,123
"020081508",648,709,1357,358,298,274
"020081704",362,418,780,290,324,288
"020081304",502,562,1064,333,317,266
"020081509",800,922,1722,519,272,260
"020081305",457,506,963,315,315,278
"020091510",345,337,682,229,251,208
"020081510",596,668,1264,389,377,341
"020081406",391,402,793,250,219,199
"020080404",333,330,663,224,254,214
"020080507",492,532,1024,336,368,319
"020090811",437,468,905,323,367,289
"020081502",1201,1227,2428,655,495,485
"020090804",324,379,703,286,347,280
"020081703",290,376,666,327,419,313
"020091603",268,345,613,228,217,181
"020080504",398,474,872,291,327,282
"020080508",292,332,624,254,253,204
"020081302",174,191,365,118,100,96
"020091602",404,459,863,314,360,294
"020081303",489,509,998,311,340,248
"020080402",289,333,622,214,218,173
"020081702",295,325,620,221,265,221
"020080506",389,442,831,282,318,262
"020080403",312,351,663,220,245,202
"020080601",417,509,926,302,349,298
"020090812",463,491,954,331,401,315
"020091605",425,462,887,283,252,225
"020080405",451,509,960,332,359,309
"020080401",426,473,899,287,299,246
"020080505",292,325,617,201,194,170
"020090813",315,335,650,207,232,198
"020080406",509,575,1084,350,402,338
"020080509",428,482,910,298,313,268
"020080602",531,666,1197,397,441,389
"020091601",442,483,925,309,359,282
"020081603",519,599,1118,289,316,280
"020080603",568,651,1219,402,435,397
"020081602",281,336,617,183,185,165
"020091611",369,379,748,247,255,238
"020080606",491,512,1003,320,252,214
"020080510",495,642,1137,411,472,408
"020080108",581,602,1183,374,384,338
"020080410",409,474,883,306,347,296
"020081610",440,494,934,279,272,248
"020081301",29,16,45,20,11,11
"020091606",459,527,986,326,362,306
"020081601",501,544,1045,299,309,285
"020091610",385,477,862,297,322,285
"020081604",438,504,942,266,309,256
"020080407",394,442,836,278,300,253
"020080107",645,806,1451,460,360,360
"020080511",412,515,927,319,360,315
"020080607",297,315,612,208,246,196
"020091612",376,417,793,259,284,254
"020080605",484,515,999,320,352,308
"020081605",461,515,976,294,348,268
"020091607",478,490,968,336,370,309
"020080411",362,381,743,252,259,226
"020080106",1097,1158,2255,627,429,408
"020081609",440,475,915,280,318,268
"020080409",353,417,770,258,291,244
"020081606",378,452,830,267,271,255
"020080104",966,928,1894,482,403,399
"020081608",359,445,804,236,237,204
"020091609",462,561,1023,340,382,320
"020080301",452,499,951,334,317,261
"020080105",838,924,1762,449,411,379
"020081607",481,560,1041,276,287,256
"020091613",392,392,784,296,329,284
"020080109",1325,1346,2671,810,629,572
"020080604",336,406,742,233,225,183
"020080110",758,756,1514,440,396,392
"020080408",416,443,859,278,317,265
"020080305",324,404,728,238,263,215
"020091608",417,513,930,301,308,273
"020080111",338,327,665,182,71,67
"020080102",808,817,1625,517,475,428
"020080608",374,390,764,241,271,231
"020080302",386,405,791,256,292,248
"020080103",702,619,1321,351,266,257
"020080714",1037,1025,2062,574,259,235
"020080112",1703,1701,3404,1019,902,874
"020080705",874,833,1707,543,464,453
"020080703",798,865,1663,493,363,348
"020080704",732,789,1521,446,308,302
"020080609",401,468,869,284,307,264
"020080303",286,294,580,187,202,172
"020080706",717,675,1392,395,238,238
"020080610",293,347,640,219,241,189
"020080702",815,814,1629,478,383,368
"020080805",287,326,613,240,298,234
"020080707",1086,1073,2159,661,494,475
"020080708",916,969,1885,457,381,374
"020080611",338,313,651,203,165,161
"020081008",579,617,1196,320,369,309
"020080205",268,293,561,174,194,173
"020080806",393,552,945,321,414,299
"020080709",1558,1530,3088,814,494,479
"020080710",518,517,1035,285,161,160
"020080304",380,411,791,250,261,229
"020080701",652,687,1339,359,311,291
"020080202",259,276,535,168,183,161
"020080711",759,811,1570,411,324,321
"020080306",198,199,397,144,137,120
"020080206",313,385,698,249,261,240
"020080101",578,569,1147,331,271,260
"020080207",567,659,1226,404,456,396
"020080201",573,709,1282,387,411,367
"020080807",394,462,856,308,333,280
"020080712",819,886,1705,395,322,317
"020080204",385,415,800,249,292,243
"020080208",412,498,910,307,337,282
"020080307",370,394,764,245,245,205
"020080203",238,277,515,161,182,154
"020080804",378,431,809,300,372,299
"020080713",742,771,1513,391,254,253
"020080810",431,468,899,289,293,250
"020080210",251,289,540,188,191,175
"020080209",410,419,829,271,302,260
"020080308",986,915,1901,547,448,422
"020080803",313,369,682,235,264,217
"020080808",299,341,640,206,222,182
"020081003",448,561,1009,380,444,375
"020080809",358,377,735,232,243,195
"020081006",732,869,1601,579,655,531
"020081207",408,418,826,278,272,241
"020080802",437,487,924,309,319,270
"020080811",433,494,927,338,382,331
"020080309",988,1019,2007,569,374,365
"020080903",490,538,1028,352,429,346
"020081004",1020,1182,2202,719,830,699
"020081007",739,888,1627,543,644,533
"020080310",828,868,1696,478,308,303
"020081002",372,387,759,237,232,221
"020080801",407,457,864,281,307,262
"020080902",418,465,883,298,319,272
"020081005",1105,1296,2401,842,958,805
"020080904",240,273,513,186,193,161
"020081103",1330,1639,2969,1057,1118,998
"020080909",418,504,922,315,328,291
"020081101",1326,1559,2885,910,910,815
"020081105",566,724,1290,449,498,444
"020081104",896,1019,1915,643,711,614
"020081001",424,452,876,278,257,242
"020080905",428,512,940,385,436,319
"020081102",912,1136,2048,718,817,671
"020081203",488,515,1003,331,361,316
"020080901",354,447,801,271,301,259
"020080908",364,392,756,258,285,216
"020081204",488,491,979,302,270,226
"020080906",469,551,1020,294,305,276
"020081202",461,543,1004,356,378,330
"020080907",330,442,772,260,297,243
"020081205",475,503,978,341,397,314
"020081201",427,488,915,306,354,293
"020081206",349,395,744,249,284,240
